InvoiceNo,InvoiceDate,StockCode,Description,Cost_Price,UnitPrice,Profit,Quantity,CustomerID,Country
875469,2023-02-20,204,strawberry yogurt,50,60,10,1,00001,India
875469,2023-02-20,206,yakult,360,400,40,1,00001,India
875469,2023-02-20,208,sprite,75,100,25,1,00001,India
875469,2023-02-20,211,red bull,90,125,35,1,00001,India
388522,2023-02-20,201,paneer,210,340,130,1,00002,India
388522,2023-02-20,208,sprite,75,100,25,1,00002,India
388522,2023-02-20,212,amul cheese,250,315,65,1,00002,India
390543,2023-02-20,206,yakult,360,400,40,1,00003,India
390543,2023-02-20,204,strawberry yogurt,50,60,10,1,00003,India
390543,2023-02-20,202,milk,12,27,15,1,00003,India
220303,2023-02-20,205,classic yogurt,45,60,15,1,00004,India
220303,2023-02-20,210,mountain dew,75,100,25,1,00004,India
220303,2023-02-20,213,bisleri,6,15,9,1,00004,India
220303,2023-02-20,201,paneer,210,340,130,1,00004,India
220303,2023-02-20,209,pepsi,75,100,25,1,00004,India
929892,2023-02-20,202,milk,12,27,15,1,00005,India
349750,2023-02-20,209,pepsi,75,100,25,1,00006,India
349750,2023-02-20,201,paneer,210,340,130,1,00006,India
349750,2023-02-20,210,mountain dew,75,100,25,1,00006,India
511750,2023-02-20,204,strawberry yogurt,50,60,10,1,00007,India
511750,2023-02-20,202,milk,12,27,15,1,00007,India
511750,2023-02-20,212,amul cheese,250,315,65,1,00007,India
511750,2023-02-20,213,bisleri,6,15,9,1,00007,India
511750,2023-02-20,201,paneer,210,340,130,1,00007,India
742152,2023-02-20,206,yakult,360,400,40,1,00008,India
742152,2023-02-20,211,red bull,90,125,35,1,00008,India
742152,2023-02-20,202,milk,12,27,15,1,00008,India
834290,2023-02-20,204,strawberry yogurt,50,60,10,1,00009,India
834290,2023-02-20,209,pepsi,75,100,25,1,00009,India
469623,2023-02-20,207,coca cola,75,100,25,1,00010,India
469623,2023-02-20,206,yakult,360,400,40,1,00010,India
194471,2023-02-20,201,paneer,210,340,130,1,00011,India
194471,2023-02-20,206,yakult,360,400,40,1,00011,India
194471,2023-02-20,209,pepsi,75,100,25,1,00011,India
194471,2023-02-20,211,red bull,90,125,35,1,00011,India
194471,2023-02-20,207,coca cola,75,100,25,1,00011,India
364185,2023-02-20,204,strawberry yogurt,50,60,10,1,00012,India
364185,2023-02-20,211,red bull,90,125,35,1,00012,India
364185,2023-02-20,202,milk,12,27,15,1,00012,India
514269,2023-02-20,211,red bull,90,125,35,1,00013,India
514269,2023-02-20,209,pepsi,75,100,25,1,00013,India
514269,2023-02-20,202,milk,12,27,15,1,00013,India
803407,2023-02-20,201,paneer,210,340,130,1,00014,India
803407,2023-02-20,208,sprite,75,100,25,1,00014,India
803407,2023-02-20,203,mango yogurt,50,60,10,1,00014,India
803407,2023-02-20,209,pepsi,75,100,25,1,00014,India
803407,2023-02-20,212,amul cheese,250,315,65,1,00014,India
437403,2023-02-20,203,mango yogurt,50,60,10,1,00015,India
437403,2023-02-20,208,sprite,75,100,25,1,00015,India
437403,2023-02-20,206,yakult,360,400,40,1,00015,India
437403,2023-02-20,213,bisleri,6,15,9,1,00015,India
542215,2023-02-20,212,amul cheese,250,315,65,1,00016,India
542215,2023-02-20,209,pepsi,75,100,25,1,00016,India
542215,2023-02-20,210,mountain dew,75,100,25,1,00016,India
302457,2023-02-20,207,coca cola,75,100,25,1,00017,India
302457,2023-02-20,208,sprite,75,100,25,1,00017,India
302457,2023-02-20,204,strawberry yogurt,50,60,10,1,00017,India
302457,2023-02-20,201,paneer,210,340,130,1,00017,India
170679,2023-02-20,204,strawberry yogurt,50,60,10,1,00018,India
170679,2023-02-20,203,mango yogurt,50,60,10,1,00018,India
689718,2023-02-20,201,paneer,210,340,130,1,00019,India
689718,2023-02-20,204,strawberry yogurt,50,60,10,1,00019,India
689718,2023-02-20,213,bisleri,6,15,9,1,00019,India
689718,2023-02-20,205,classic yogurt,45,60,15,1,00019,India
873191,2023-02-20,203,mango yogurt,50,60,10,1,00020,India
164036,2023-02-20,209,pepsi,75,100,25,1,00021,India
164036,2023-02-20,212,amul cheese,250,315,65,1,00021,India
164036,2023-02-20,201,paneer,210,340,130,1,00021,India
164036,2023-02-20,208,sprite,75,100,25,1,00021,India
591602,2023-02-20,203,mango yogurt,50,60,10,1,00022,India
591602,2023-02-20,206,yakult,360,400,40,1,00022,India
591602,2023-02-20,204,strawberry yogurt,50,60,10,1,00022,India
591602,2023-02-20,202,milk,12,27,15,1,00022,India
804565,2023-02-20,209,pepsi,75,100,25,1,00023,India
804565,2023-02-20,206,yakult,360,400,40,1,00023,India
311119,2023-02-20,202,milk,12,27,15,1,00024,India
311119,2023-02-20,209,pepsi,75,100,25,1,00024,India
311119,2023-02-20,210,mountain dew,75,100,25,1,00024,India
311119,2023-02-20,212,amul cheese,250,315,65,1,00024,India
146664,2023-02-20,212,amul cheese,250,315,65,1,00025,India
146664,2023-02-20,210,mountain dew,75,100,25,1,00025,India
146664,2023-02-20,203,mango yogurt,50,60,10,1,00025,India
146664,2023-02-20,211,red bull,90,125,35,1,00025,India
509357,2023-02-20,209,pepsi,75,100,25,1,00026,India
509357,2023-02-20,212,amul cheese,250,315,65,1,00026,India
509357,2023-02-20,207,coca cola,75,100,25,1,00026,India
509357,2023-02-20,213,bisleri,6,15,9,1,00026,India
316355,2023-02-20,205,classic yogurt,45,60,15,1,00027,India
429609,2023-02-20,209,pepsi,75,100,25,1,00028,India
380467,2023-02-20,211,red bull,90,125,35,1,00029,India
380467,2023-02-20,208,sprite,75,100,25,1,00029,India
380467,2023-02-20,206,yakult,360,400,40,1,00029,India
713086,2023-02-20,209,pepsi,75,100,25,1,00030,India
713086,2023-02-20,207,coca cola,75,100,25,1,00030,India
132564,2023-02-20,211,red bull,90,125,35,1,00031,India
132564,2023-02-20,201,paneer,210,340,130,1,00031,India
714699,2023-02-20,201,paneer,210,340,130,1,00032,India
714699,2023-02-20,209,pepsi,75,100,25,1,00032,India
275627,2023-02-20,205,classic yogurt,45,60,15,1,00033,India
275627,2023-02-20,202,milk,12,27,15,1,00033,India
275627,2023-02-20,209,pepsi,75,100,25,1,00033,India
666888,2023-02-20,206,yakult,360,400,40,1,00034,India
265435,2023-02-20,212,amul cheese,250,315,65,1,00035,India
265435,2023-02-20,209,pepsi,75,100,25,1,00035,India
440344,2023-02-20,207,coca cola,75,100,25,1,00036,India
440344,2023-02-20,208,sprite,75,100,25,1,00036,India
534668,2023-02-20,206,yakult,360,400,40,1,00037,India
534668,2023-02-20,207,coca cola,75,100,25,1,00037,India
534668,2023-02-20,204,strawberry yogurt,50,60,10,1,00037,India
534668,2023-02-20,213,bisleri,6,15,9,1,00037,India
768747,2023-02-20,212,amul cheese,250,315,65,1,00038,India
768747,2023-02-20,201,paneer,210,340,130,1,00038,India
768747,2023-02-20,209,pepsi,75,100,25,1,00038,India
898945,2023-02-20,210,mountain dew,75,100,25,1,00039,India
898945,2023-02-20,203,mango yogurt,50,60,10,1,00039,India
898945,2023-02-20,202,milk,12,27,15,1,00039,India
540500,2023-02-20,202,milk,12,27,15,1,00040,India
121694,2023-02-20,208,sprite,75,100,25,1,00041,India
121694,2023-02-20,202,milk,12,27,15,1,00041,India
121694,2023-02-20,203,mango yogurt,50,60,10,1,00041,India
121694,2023-02-20,206,yakult,360,400,40,1,00041,India
431308,2023-02-20,212,amul cheese,250,315,65,1,00042,India
792710,2023-02-20,201,paneer,210,340,130,1,00043,India
792710,2023-02-20,213,bisleri,6,15,9,1,00043,India
792710,2023-02-20,210,mountain dew,75,100,25,1,00043,India
792710,2023-02-20,202,milk,12,27,15,1,00043,India
255374,2023-02-20,210,mountain dew,75,100,25,1,00044,India
255374,2023-02-20,209,pepsi,75,100,25,1,00044,India
255374,2023-02-20,208,sprite,75,100,25,1,00044,India
255374,2023-02-20,207,coca cola,75,100,25,1,00044,India
837475,2023-02-20,206,yakult,360,400,40,1,00045,India
837475,2023-02-20,205,classic yogurt,45,60,15,1,00045,India
837475,2023-02-20,207,coca cola,75,100,25,1,00045,India
837475,2023-02-20,210,mountain dew,75,100,25,1,00045,India
672692,2023-02-20,210,mountain dew,75,100,25,1,00046,India
672692,2023-02-20,207,coca cola,75,100,25,1,00046,India
672692,2023-02-20,208,sprite,75,100,25,1,00046,India
594663,2023-02-20,206,yakult,360,400,40,1,00047,India
594663,2023-02-20,207,coca cola,75,100,25,1,00047,India
594663,2023-02-20,201,paneer,210,340,130,1,00047,India
198837,2023-02-20,203,mango yogurt,50,60,10,1,00048,India
198837,2023-02-20,202,milk,12,27,15,1,00048,India
198837,2023-02-20,204,strawberry yogurt,50,60,10,1,00048,India
198837,2023-02-20,208,sprite,75,100,25,1,00048,India
572767,2023-02-20,202,milk,12,27,15,1,00049,India
572767,2023-02-20,203,mango yogurt,50,60,10,1,00049,India
572767,2023-02-20,210,mountain dew,75,100,25,1,00049,India
572767,2023-02-20,205,classic yogurt,45,60,15,1,00049,India
597960,2023-02-20,212,amul cheese,250,315,65,1,00050,India
597960,2023-02-20,209,pepsi,75,100,25,1,00050,India
597960,2023-02-20,201,paneer,210,340,130,1,00050,India
597960,2023-02-20,207,coca cola,75,100,25,1,00050,India
113906,2023-02-20,205,classic yogurt,45,60,15,1,00051,India
113906,2023-02-20,206,yakult,360,400,40,1,00051,India
113906,2023-02-20,201,paneer,210,340,130,1,00051,India
113906,2023-02-20,213,bisleri,6,15,9,1,00051,India
113906,2023-02-20,212,amul cheese,250,315,65,1,00051,India
121727,2023-02-20,203,mango yogurt,50,60,10,1,00052,India
331656,2023-02-20,201,paneer,210,340,130,1,00053,India
331656,2023-02-20,206,yakult,360,400,40,1,00053,India
746428,2023-02-20,201,paneer,210,340,130,1,00054,India
825512,2023-02-20,210,mountain dew,75,100,25,1,00055,India
825512,2023-02-20,203,mango yogurt,50,60,10,1,00055,India
743964,2023-02-20,212,amul cheese,250,315,65,1,00056,India
743964,2023-02-20,202,milk,12,27,15,1,00056,India
743964,2023-02-20,204,strawberry yogurt,50,60,10,1,00056,India
911970,2023-02-20,203,mango yogurt,50,60,10,1,00057,India
372358,2023-02-20,209,pepsi,75,100,25,1,00058,India
372358,2023-02-20,210,mountain dew,75,100,25,1,00058,India
372358,2023-02-20,206,yakult,360,400,40,1,00058,India
372358,2023-02-20,204,strawberry yogurt,50,60,10,1,00058,India
647836,2023-02-20,210,mountain dew,75,100,25,1,00059,India
647836,2023-02-20,212,amul cheese,250,315,65,1,00059,India
647836,2023-02-20,204,strawberry yogurt,50,60,10,1,00059,India
647836,2023-02-20,205,classic yogurt,45,60,15,1,00059,India
647836,2023-02-20,211,red bull,90,125,35,1,00059,India
252053,2023-02-20,210,mountain dew,75,100,25,1,00060,India
478638,2023-02-20,202,milk,12,27,15,1,00061,India
478638,2023-02-20,208,sprite,75,100,25,1,00061,India
478638,2023-02-20,209,pepsi,75,100,25,1,00061,India
149795,2023-02-20,208,sprite,75,100,25,1,00062,India
832229,2023-02-20,210,mountain dew,75,100,25,1,00063,India
518301,2023-02-20,210,mountain dew,75,100,25,1,00064,India
518301,2023-02-20,208,sprite,75,100,25,1,00064,India
518301,2023-02-20,202,milk,12,27,15,1,00064,India
518301,2023-02-20,206,yakult,360,400,40,1,00064,India
495178,2023-02-20,203,mango yogurt,50,60,10,1,00065,India
495178,2023-02-20,212,amul cheese,250,315,65,1,00065,India
495178,2023-02-20,210,mountain dew,75,100,25,1,00065,India
493361,2023-02-20,205,classic yogurt,45,60,15,1,00066,India
534529,2023-02-20,204,strawberry yogurt,50,60,10,1,00067,India
534529,2023-02-20,201,paneer,210,340,130,1,00067,India
534529,2023-02-20,206,yakult,360,400,40,1,00067,India
534529,2023-02-20,212,amul cheese,250,315,65,1,00067,India
149148,2023-02-20,209,pepsi,75,100,25,1,00068,India
849154,2023-02-20,208,sprite,75,100,25,1,00069,India
552519,2023-02-20,210,mountain dew,75,100,25,1,00070,India
663914,2023-02-20,203,mango yogurt,50,60,10,1,00071,India
663914,2023-02-20,201,paneer,210,340,130,1,00071,India
663914,2023-02-20,209,pepsi,75,100,25,1,00071,India
882147,2023-02-20,208,sprite,75,100,25,1,00072,India
583517,2023-02-20,202,milk,12,27,15,1,00073,India
689344,2023-02-20,206,yakult,360,400,40,1,00074,India
689344,2023-02-20,210,mountain dew,75,100,25,1,00074,India
689344,2023-02-20,203,mango yogurt,50,60,10,1,00074,India
161374,2023-02-20,206,yakult,360,400,40,1,00075,India
161374,2023-02-20,208,sprite,75,100,25,1,00075,India
122611,2023-02-20,213,bisleri,6,15,9,1,00076,India
122611,2023-02-20,208,sprite,75,100,25,1,00076,India
122611,2023-02-20,201,paneer,210,340,130,1,00076,India
122611,2023-02-20,211,red bull,90,125,35,1,00076,India
122611,2023-02-20,206,yakult,360,400,40,1,00076,India
182962,2023-02-21,208,sprite,75,100,25,1,00077,India
182962,2023-02-21,213,bisleri,6,15,9,1,00077,India
182962,2023-02-21,203,mango yogurt,50,60,10,1,00077,India
206613,2023-02-21,201,paneer,210,340,130,1,00078,India
226995,2023-02-21,210,mountain dew,75,100,25,1,00079,India
226995,2023-02-21,204,strawberry yogurt,50,60,10,1,00079,India
226995,2023-02-21,202,milk,12,27,15,1,00079,India
226995,2023-02-21,213,bisleri,6,15,9,1,00079,India
587089,2023-02-21,202,milk,12,27,15,1,00080,India
587089,2023-02-21,210,mountain dew,75,100,25,1,00080,India
344117,2023-02-21,205,classic yogurt,45,60,15,1,00081,India
344117,2023-02-21,203,mango yogurt,50,60,10,1,00081,India
463231,2023-02-21,213,bisleri,6,15,9,1,00082,India
463231,2023-02-21,208,sprite,75,100,25,1,00082,India
548508,2023-02-21,208,sprite,75,100,25,1,00083,India
778636,2023-02-21,203,mango yogurt,50,60,10,1,00084,India
774161,2023-02-21,203,mango yogurt,50,60,10,1,00085,India
774161,2023-02-21,213,bisleri,6,15,9,1,00085,India
774161,2023-02-21,210,mountain dew,75,100,25,1,00085,India
918407,2023-02-21,206,yakult,360,400,40,1,00086,India
918407,2023-02-21,211,red bull,90,125,35,1,00086,India
134833,2023-02-21,211,red bull,90,125,35,1,00087,India
274120,2023-02-21,207,coca cola,75,100,25,1,00088,India
881229,2023-02-21,203,mango yogurt,50,60,10,1,00089,India
881229,2023-02-21,205,classic yogurt,45,60,15,1,00089,India
881229,2023-02-21,201,paneer,210,340,130,1,00089,India
881229,2023-02-21,204,strawberry yogurt,50,60,10,1,00089,India
169355,2023-02-21,211,red bull,90,125,35,1,00090,India
169355,2023-02-21,208,sprite,75,100,25,1,00090,India
169355,2023-02-21,207,coca cola,75,100,25,1,00090,India
169355,2023-02-21,202,milk,12,27,15,1,00090,India
341300,2023-02-21,207,coca cola,75,100,25,1,00091,India
341300,2023-02-21,212,amul cheese,250,315,65,1,00091,India
341300,2023-02-21,211,red bull,90,125,35,1,00091,India
232209,2023-02-21,209,pepsi,75,100,25,1,00092,India
232209,2023-02-21,210,mountain dew,75,100,25,1,00092,India
232209,2023-02-21,206,yakult,360,400,40,1,00092,India
232209,2023-02-21,213,bisleri,6,15,9,1,00092,India
547936,2023-02-21,208,sprite,75,100,25,1,00093,India
547936,2023-02-21,204,strawberry yogurt,50,60,10,1,00093,India
547936,2023-02-21,210,mountain dew,75,100,25,1,00093,India
589470,2023-02-21,201,paneer,210,340,130,1,00094,India
317400,2023-02-21,210,mountain dew,75,100,25,1,00095,India
317400,2023-02-21,207,coca cola,75,100,25,1,00095,India
619277,2023-02-21,206,yakult,360,400,40,1,00096,India
619277,2023-02-21,213,bisleri,6,15,9,1,00096,India
619277,2023-02-21,202,milk,12,27,15,1,00096,India
619277,2023-02-21,201,paneer,210,340,130,1,00096,India
254506,2023-02-21,206,yakult,360,400,40,1,00097,India
254506,2023-02-21,212,amul cheese,250,315,65,1,00097,India
254506,2023-02-21,204,strawberry yogurt,50,60,10,1,00097,India
254506,2023-02-21,208,sprite,75,100,25,1,00097,India
423479,2023-02-21,212,amul cheese,250,315,65,1,00098,India
423479,2023-02-21,204,strawberry yogurt,50,60,10,1,00098,India
423479,2023-02-21,202,milk,12,27,15,1,00098,India
899134,2023-02-21,206,yakult,360,400,40,1,00099,India
899134,2023-02-21,203,mango yogurt,50,60,10,1,00099,India
899134,2023-02-21,205,classic yogurt,45,60,15,1,00099,India
899134,2023-02-21,212,amul cheese,250,315,65,1,00099,India
899134,2023-02-21,207,coca cola,75,100,25,1,00099,India
359702,2023-02-21,203,mango yogurt,50,60,10,1,00100,India
359702,2023-02-21,201,paneer,210,340,130,1,00100,India
809423,2023-02-21,212,amul cheese,250,315,65,1,00101,India
809423,2023-02-21,207,coca cola,75,100,25,1,00101,India
809423,2023-02-21,210,mountain dew,75,100,25,1,00101,India
674563,2023-02-21,206,yakult,360,400,40,1,00102,India
674563,2023-02-21,210,mountain dew,75,100,25,1,00102,India
345538,2023-02-21,212,amul cheese,250,315,65,1,00103,India
633381,2023-02-21,201,paneer,210,340,130,1,00104,India
255467,2023-02-21,203,mango yogurt,50,60,10,1,00105,India
255467,2023-02-21,204,strawberry yogurt,50,60,10,1,00105,India
255467,2023-02-21,202,milk,12,27,15,1,00105,India
255467,2023-02-21,212,amul cheese,250,315,65,1,00105,India
255467,2023-02-21,211,red bull,90,125,35,1,00105,India
455279,2023-02-21,205,classic yogurt,45,60,15,1,00106,India
130277,2023-02-21,201,paneer,210,340,130,1,00107,India
130277,2023-02-21,203,mango yogurt,50,60,10,1,00107,India
130277,2023-02-21,207,coca cola,75,100,25,1,00107,India
423200,2023-02-21,211,red bull,90,125,35,1,00108,India
423200,2023-02-21,210,mountain dew,75,100,25,1,00108,India
423200,2023-02-21,201,paneer,210,340,130,1,00108,India
769920,2023-02-21,205,classic yogurt,45,60,15,1,00109,India
769920,2023-02-21,206,yakult,360,400,40,1,00109,India
661225,2023-02-21,202,milk,12,27,15,1,00110,India
453988,2023-02-21,209,pepsi,75,100,25,1,00111,India
453988,2023-02-21,205,classic yogurt,45,60,15,1,00111,India
453988,2023-02-21,207,coca cola,75,100,25,1,00111,India
138605,2023-02-21,201,paneer,210,340,130,1,00112,India
138605,2023-02-21,211,red bull,90,125,35,1,00112,India
138605,2023-02-21,209,pepsi,75,100,25,1,00112,India
138605,2023-02-21,205,classic yogurt,45,60,15,1,00112,India
671840,2023-02-21,210,mountain dew,75,100,25,1,00113,India
671840,2023-02-21,203,mango yogurt,50,60,10,1,00113,India
671840,2023-02-21,212,amul cheese,250,315,65,1,00113,India
671840,2023-02-21,207,coca cola,75,100,25,1,00113,India
677107,2023-02-21,208,sprite,75,100,25,1,00114,India
677107,2023-02-21,202,milk,12,27,15,1,00114,India
677107,2023-02-21,203,mango yogurt,50,60,10,1,00114,India
677107,2023-02-21,213,bisleri,6,15,9,1,00114,India
677107,2023-02-21,207,coca cola,75,100,25,1,00114,India
768870,2023-02-21,205,classic yogurt,45,60,15,1,00115,India
768870,2023-02-21,208,sprite,75,100,25,1,00115,India
154116,2023-02-21,210,mountain dew,75,100,25,1,00116,India
154116,2023-02-21,203,mango yogurt,50,60,10,1,00116,India
154116,2023-02-21,207,coca cola,75,100,25,1,00116,India
154116,2023-02-21,204,strawberry yogurt,50,60,10,1,00116,India
154116,2023-02-21,206,yakult,360,400,40,1,00116,India
705314,2023-02-21,213,bisleri,6,15,9,1,00117,India
705314,2023-02-21,201,paneer,210,340,130,1,00117,India
953658,2023-02-21,202,milk,12,27,15,1,00118,India
953658,2023-02-21,211,red bull,90,125,35,1,00118,India
953658,2023-02-21,208,sprite,75,100,25,1,00118,India
953658,2023-02-21,205,classic yogurt,45,60,15,1,00118,India
432448,2023-02-21,203,mango yogurt,50,60,10,1,00119,India
432448,2023-02-21,212,amul cheese,250,315,65,1,00119,India
432448,2023-02-21,202,milk,12,27,15,1,00119,India
432448,2023-02-21,207,coca cola,75,100,25,1,00119,India
902183,2023-02-21,208,sprite,75,100,25,1,00120,India
902183,2023-02-21,211,red bull,90,125,35,1,00120,India
821401,2023-02-21,213,bisleri,6,15,9,1,00121,India
821401,2023-02-21,204,strawberry yogurt,50,60,10,1,00121,India
950788,2023-02-21,211,red bull,90,125,35,1,00122,India
323053,2023-02-21,209,pepsi,75,100,25,1,00123,India
323053,2023-02-21,208,sprite,75,100,25,1,00123,India
323053,2023-02-21,201,paneer,210,340,130,1,00123,India
220776,2023-02-21,205,classic yogurt,45,60,15,1,00124,India
220776,2023-02-21,212,amul cheese,250,315,65,1,00124,India
220776,2023-02-21,202,milk,12,27,15,1,00124,India
970086,2023-02-21,201,paneer,210,340,130,1,00125,India
970086,2023-02-21,205,classic yogurt,45,60,15,1,00125,India
970086,2023-02-21,204,strawberry yogurt,50,60,10,1,00125,India
666454,2023-02-21,212,amul cheese,250,315,65,1,00126,India
716193,2023-02-21,210,mountain dew,75,100,25,1,00127,India
716193,2023-02-21,201,paneer,210,340,130,1,00127,India
716193,2023-02-21,212,amul cheese,250,315,65,1,00127,India
305151,2023-02-21,211,red bull,90,125,35,1,00128,India
274714,2023-02-21,202,milk,12,27,15,1,00129,India
274714,2023-02-21,209,pepsi,75,100,25,1,00129,India
274714,2023-02-21,207,coca cola,75,100,25,1,00129,India
274714,2023-02-21,210,mountain dew,75,100,25,1,00129,India
274714,2023-02-21,212,amul cheese,250,315,65,1,00129,India
416642,2023-02-21,209,pepsi,75,100,25,1,00130,India
416642,2023-02-21,201,paneer,210,340,130,1,00130,India
763984,2023-02-21,209,pepsi,75,100,25,1,00131,India
394681,2023-02-21,211,red bull,90,125,35,1,00132,India
394681,2023-02-21,213,bisleri,6,15,9,1,00132,India
280146,2023-02-21,209,pepsi,75,100,25,1,00133,India
327662,2023-02-21,201,paneer,210,340,130,1,00134,India
677336,2023-02-21,211,red bull,90,125,35,1,00135,India
677336,2023-02-21,207,coca cola,75,100,25,1,00135,India
677336,2023-02-21,206,yakult,360,400,40,1,00135,India
677336,2023-02-21,212,amul cheese,250,315,65,1,00135,India
677336,2023-02-21,208,sprite,75,100,25,1,00135,India
419695,2023-02-21,201,paneer,210,340,130,1,00136,India
277269,2023-02-21,203,mango yogurt,50,60,10,1,00137,India
277269,2023-02-21,206,yakult,360,400,40,1,00137,India
277269,2023-02-21,211,red bull,90,125,35,1,00137,India
277269,2023-02-21,201,paneer,210,340,130,1,00137,India
277269,2023-02-21,210,mountain dew,75,100,25,1,00137,India
744534,2023-02-21,205,classic yogurt,45,60,15,1,00138,India
744534,2023-02-21,208,sprite,75,100,25,1,00138,India
744534,2023-02-21,201,paneer,210,340,130,1,00138,India
744534,2023-02-21,211,red bull,90,125,35,1,00138,India
744534,2023-02-21,204,strawberry yogurt,50,60,10,1,00138,India
364274,2023-02-21,205,classic yogurt,45,60,15,1,00139,India
364274,2023-02-21,209,pepsi,75,100,25,1,00139,India
364274,2023-02-21,204,strawberry yogurt,50,60,10,1,00139,India
364274,2023-02-21,202,milk,12,27,15,1,00139,India
874319,2023-02-21,207,coca cola,75,100,25,1,00140,India
874319,2023-02-21,209,pepsi,75,100,25,1,00140,India
999972,2023-02-21,211,red bull,90,125,35,1,00141,India
999972,2023-02-21,208,sprite,75,100,25,1,00141,India
999972,2023-02-21,201,paneer,210,340,130,1,00141,India
945036,2023-02-21,204,strawberry yogurt,50,60,10,1,00142,India
945036,2023-02-21,212,amul cheese,250,315,65,1,00142,India
945036,2023-02-21,210,mountain dew,75,100,25,1,00142,India
549520,2023-02-21,209,pepsi,75,100,25,1,00143,India
549520,2023-02-21,210,mountain dew,75,100,25,1,00143,India
549520,2023-02-21,202,milk,12,27,15,1,00143,India
549520,2023-02-21,203,mango yogurt,50,60,10,1,00143,India
934044,2023-02-21,207,coca cola,75,100,25,1,00144,India
934044,2023-02-21,210,mountain dew,75,100,25,1,00144,India
886821,2023-02-21,209,pepsi,75,100,25,1,00145,India
491079,2023-02-21,202,milk,12,27,15,1,00146,India
491079,2023-02-21,201,paneer,210,340,130,1,00146,India
385433,2023-02-21,201,paneer,210,340,130,1,00147,India
385433,2023-02-21,202,milk,12,27,15,1,00147,India
118851,2023-02-21,210,mountain dew,75,100,25,1,00148,India
118851,2023-02-21,212,amul cheese,250,315,65,1,00148,India
118851,2023-02-21,206,yakult,360,400,40,1,00148,India
118851,2023-02-21,207,coca cola,75,100,25,1,00148,India
880819,2023-02-21,210,mountain dew,75,100,25,1,00149,India
880819,2023-02-21,205,classic yogurt,45,60,15,1,00149,India
880819,2023-02-21,213,bisleri,6,15,9,1,00149,India
880819,2023-02-21,202,milk,12,27,15,1,00149,India
904099,2023-02-21,201,paneer,210,340,130,1,00150,India
904099,2023-02-21,211,red bull,90,125,35,1,00150,India
907312,2023-02-21,208,sprite,75,100,25,1,00151,India
907312,2023-02-21,210,mountain dew,75,100,25,1,00151,India
749910,2023-02-21,205,classic yogurt,45,60,15,1,00152,India
749910,2023-02-21,206,yakult,360,400,40,1,00152,India
749910,2023-02-21,208,sprite,75,100,25,1,00152,India
749910,2023-02-21,202,milk,12,27,15,1,00152,India
725468,2023-02-21,211,red bull,90,125,35,1,00153,India
725468,2023-02-21,206,yakult,360,400,40,1,00153,India
725468,2023-02-21,209,pepsi,75,100,25,1,00153,India
725468,2023-02-21,203,mango yogurt,50,60,10,1,00153,India
725468,2023-02-21,212,amul cheese,250,315,65,1,00153,India
536156,2023-02-21,205,classic yogurt,45,60,15,1,00154,India
536156,2023-02-21,206,yakult,360,400,40,1,00154,India
650987,2023-02-21,207,coca cola,75,100,25,1,00155,India
650987,2023-02-21,208,sprite,75,100,25,1,00155,India
650987,2023-02-21,205,classic yogurt,45,60,15,1,00155,India
650987,2023-02-21,210,mountain dew,75,100,25,1,00155,India
650987,2023-02-21,201,paneer,210,340,130,1,00155,India
717545,2023-02-21,202,milk,12,27,15,1,00156,India
717545,2023-02-21,211,red bull,90,125,35,1,00156,India
717545,2023-02-21,213,bisleri,6,15,9,1,00156,India
717545,2023-02-21,205,classic yogurt,45,60,15,1,00156,India
245687,2023-02-21,201,paneer,210,340,130,1,00157,India
585711,2023-02-21,211,red bull,90,125,35,1,00158,India
585711,2023-02-21,204,strawberry yogurt,50,60,10,1,00158,India
585711,2023-02-21,208,sprite,75,100,25,1,00158,India
585711,2023-02-21,210,mountain dew,75,100,25,1,00158,India
452058,2023-02-21,203,mango yogurt,50,60,10,1,00159,India
452058,2023-02-21,204,strawberry yogurt,50,60,10,1,00159,India
158046,2023-02-21,213,bisleri,6,15,9,1,00160,India
158046,2023-02-21,212,amul cheese,250,315,65,1,00160,India
738890,2023-02-21,212,amul cheese,250,315,65,1,00161,India
738890,2023-02-21,206,yakult,360,400,40,1,00161,India
738890,2023-02-21,201,paneer,210,340,130,1,00161,India
744917,2023-02-21,213,bisleri,6,15,9,1,00162,India
744917,2023-02-21,201,paneer,210,340,130,1,00162,India
744917,2023-02-21,209,pepsi,75,100,25,1,00162,India
562330,2023-02-21,208,sprite,75,100,25,1,00163,India
562330,2023-02-21,209,pepsi,75,100,25,1,00163,India
562330,2023-02-21,205,classic yogurt,45,60,15,1,00163,India
562330,2023-02-21,204,strawberry yogurt,50,60,10,1,00163,India
364715,2023-02-21,205,classic yogurt,45,60,15,1,00164,India
364715,2023-02-21,206,yakult,360,400,40,1,00164,India
364715,2023-02-21,213,bisleri,6,15,9,1,00164,India
364715,2023-02-21,208,sprite,75,100,25,1,00164,India
947963,2023-02-21,212,amul cheese,250,315,65,1,00165,India
630277,2023-02-22,213,bisleri,6,15,9,1,00166,India
934842,2023-02-22,201,paneer,210,340,130,1,00167,India
467805,2023-02-22,212,amul cheese,250,315,65,1,00168,India
627034,2023-02-22,210,mountain dew,75,100,25,1,00169,India
627034,2023-02-22,201,paneer,210,340,130,1,00169,India
627034,2023-02-22,202,milk,12,27,15,1,00169,India
627034,2023-02-22,209,pepsi,75,100,25,1,00169,India
984861,2023-02-22,213,bisleri,6,15,9,1,00170,India
984861,2023-02-22,212,amul cheese,250,315,65,1,00170,India
182740,2023-02-22,206,yakult,360,400,40,1,00171,India
512629,2023-02-22,205,classic yogurt,45,60,15,1,00172,India
356404,2023-02-22,209,pepsi,75,100,25,1,00173,India
356404,2023-02-22,203,mango yogurt,50,60,10,1,00173,India
356404,2023-02-22,201,paneer,210,340,130,1,00173,India
356404,2023-02-22,210,mountain dew,75,100,25,1,00173,India
416894,2023-02-22,212,amul cheese,250,315,65,1,00174,India
416894,2023-02-22,211,red bull,90,125,35,1,00174,India
416894,2023-02-22,204,strawberry yogurt,50,60,10,1,00174,India
132707,2023-02-22,209,pepsi,75,100,25,1,00175,India
746301,2023-02-22,201,paneer,210,340,130,1,00176,India
746301,2023-02-22,203,mango yogurt,50,60,10,1,00176,India
746301,2023-02-22,204,strawberry yogurt,50,60,10,1,00176,India
739799,2023-02-22,205,classic yogurt,45,60,15,1,00177,India
739799,2023-02-22,203,mango yogurt,50,60,10,1,00177,India
739799,2023-02-22,211,red bull,90,125,35,1,00177,India
739799,2023-02-22,212,amul cheese,250,315,65,1,00177,India
739799,2023-02-22,201,paneer,210,340,130,1,00177,India
998479,2023-02-22,210,mountain dew,75,100,25,1,00178,India
269585,2023-02-22,202,milk,12,27,15,1,00179,India
269585,2023-02-22,205,classic yogurt,45,60,15,1,00179,India
984270,2023-02-22,201,paneer,210,340,130,1,00180,India
984270,2023-02-22,204,strawberry yogurt,50,60,10,1,00180,India
984270,2023-02-22,212,amul cheese,250,315,65,1,00180,India
984270,2023-02-22,202,milk,12,27,15,1,00180,India
278696,2023-02-22,205,classic yogurt,45,60,15,1,00181,India
278696,2023-02-22,203,mango yogurt,50,60,10,1,00181,India
278696,2023-02-22,202,milk,12,27,15,1,00181,India
278696,2023-02-22,207,coca cola,75,100,25,1,00181,India
912186,2023-02-22,202,milk,12,27,15,1,00182,India
912186,2023-02-22,209,pepsi,75,100,25,1,00182,India
796283,2023-02-22,202,milk,12,27,15,1,00183,India
796283,2023-02-22,210,mountain dew,75,100,25,1,00183,India
796283,2023-02-22,206,yakult,360,400,40,1,00183,India
796283,2023-02-22,205,classic yogurt,45,60,15,1,00183,India
611019,2023-02-22,203,mango yogurt,50,60,10,1,00184,India
938125,2023-02-22,205,classic yogurt,45,60,15,1,00185,India
156436,2023-02-22,205,classic yogurt,45,60,15,1,00186,India
156436,2023-02-22,202,milk,12,27,15,1,00186,India
304416,2023-02-22,211,red bull,90,125,35,1,00187,India
304416,2023-02-22,209,pepsi,75,100,25,1,00187,India
304416,2023-02-22,202,milk,12,27,15,1,00187,India
304416,2023-02-22,205,classic yogurt,45,60,15,1,00187,India
834324,2023-02-22,201,paneer,210,340,130,1,00188,India
834324,2023-02-22,206,yakult,360,400,40,1,00188,India
834324,2023-02-22,211,red bull,90,125,35,1,00188,India
834324,2023-02-22,210,mountain dew,75,100,25,1,00188,India
636774,2023-02-22,203,mango yogurt,50,60,10,1,00189,India
636774,2023-02-22,210,mountain dew,75,100,25,1,00189,India
636774,2023-02-22,202,milk,12,27,15,1,00189,India
636774,2023-02-22,213,bisleri,6,15,9,1,00189,India
636774,2023-02-22,205,classic yogurt,45,60,15,1,00189,India
947240,2023-02-22,201,paneer,210,340,130,1,00190,India
947240,2023-02-22,208,sprite,75,100,25,1,00190,India
947240,2023-02-22,203,mango yogurt,50,60,10,1,00190,India
947240,2023-02-22,202,milk,12,27,15,1,00190,India
615608,2023-02-22,206,yakult,360,400,40,1,00191,India
552538,2023-02-22,211,red bull,90,125,35,1,00192,India
552538,2023-02-22,201,paneer,210,340,130,1,00192,India
552538,2023-02-22,213,bisleri,6,15,9,1,00192,India
552538,2023-02-22,207,coca cola,75,100,25,1,00192,India
552538,2023-02-22,212,amul cheese,250,315,65,1,00192,India
353217,2023-02-22,210,mountain dew,75,100,25,1,00193,India
894791,2023-02-22,210,mountain dew,75,100,25,1,00194,India
894791,2023-02-22,213,bisleri,6,15,9,1,00194,India
276980,2023-02-22,202,milk,12,27,15,1,00195,India
808467,2023-02-22,204,strawberry yogurt,50,60,10,1,00196,India
808467,2023-02-22,206,yakult,360,400,40,1,00196,India
808467,2023-02-22,205,classic yogurt,45,60,15,1,00196,India
808467,2023-02-22,208,sprite,75,100,25,1,00196,India
357519,2023-02-22,213,bisleri,6,15,9,1,00197,India
357519,2023-02-22,202,milk,12,27,15,1,00197,India
357519,2023-02-22,211,red bull,90,125,35,1,00197,India
357519,2023-02-22,201,paneer,210,340,130,1,00197,India
357519,2023-02-22,204,strawberry yogurt,50,60,10,1,00197,India
106153,2023-02-22,210,mountain dew,75,100,25,1,00198,India
106153,2023-02-22,212,amul cheese,250,315,65,1,00198,India
106153,2023-02-22,208,sprite,75,100,25,1,00198,India
106153,2023-02-22,211,red bull,90,125,35,1,00198,India
106153,2023-02-22,203,mango yogurt,50,60,10,1,00198,India
991638,2023-02-22,206,yakult,360,400,40,1,00199,India
991638,2023-02-22,213,bisleri,6,15,9,1,00199,India
991638,2023-02-22,210,mountain dew,75,100,25,1,00199,India
991638,2023-02-22,212,amul cheese,250,315,65,1,00199,India
729358,2023-02-22,213,bisleri,6,15,9,1,00200,India
729358,2023-02-22,208,sprite,75,100,25,1,00200,India
729358,2023-02-22,207,coca cola,75,100,25,1,00200,India
729358,2023-02-22,211,red bull,90,125,35,1,00200,India
729358,2023-02-22,206,yakult,360,400,40,1,00200,India
296282,2023-02-22,205,classic yogurt,45,60,15,1,00201,India
231295,2023-02-22,204,strawberry yogurt,50,60,10,1,00202,India
231295,2023-02-22,213,bisleri,6,15,9,1,00202,India
231295,2023-02-22,203,mango yogurt,50,60,10,1,00202,India
231295,2023-02-22,205,classic yogurt,45,60,15,1,00202,India
231295,2023-02-22,207,coca cola,75,100,25,1,00202,India
328444,2023-02-22,209,pepsi,75,100,25,1,00203,India
328444,2023-02-22,202,milk,12,27,15,1,00203,India
328444,2023-02-22,207,coca cola,75,100,25,1,00203,India
328444,2023-02-22,210,mountain dew,75,100,25,1,00203,India
244166,2023-02-22,211,red bull,90,125,35,1,00204,India
244166,2023-02-22,207,coca cola,75,100,25,1,00204,India
181561,2023-02-22,204,strawberry yogurt,50,60,10,1,00205,India
181561,2023-02-22,207,coca cola,75,100,25,1,00205,India
425577,2023-02-22,212,amul cheese,250,315,65,1,00206,India
425577,2023-02-22,213,bisleri,6,15,9,1,00206,India
648301,2023-02-22,207,coca cola,75,100,25,1,00207,India
648301,2023-02-22,210,mountain dew,75,100,25,1,00207,India
648301,2023-02-22,202,milk,12,27,15,1,00207,India
978041,2023-02-22,210,mountain dew,75,100,25,1,00208,India
978041,2023-02-22,203,mango yogurt,50,60,10,1,00208,India
978041,2023-02-22,201,paneer,210,340,130,1,00208,India
293502,2023-02-22,213,bisleri,6,15,9,1,00209,India
349197,2023-02-22,206,yakult,360,400,40,1,00210,India
349197,2023-02-22,211,red bull,90,125,35,1,00210,India
874771,2023-02-22,202,milk,12,27,15,1,00211,India
874771,2023-02-22,206,yakult,360,400,40,1,00211,India
874771,2023-02-22,204,strawberry yogurt,50,60,10,1,00211,India
688753,2023-02-22,212,amul cheese,250,315,65,1,00212,India
688753,2023-02-22,203,mango yogurt,50,60,10,1,00212,India
688753,2023-02-22,209,pepsi,75,100,25,1,00212,India
688753,2023-02-22,204,strawberry yogurt,50,60,10,1,00212,India
688753,2023-02-22,206,yakult,360,400,40,1,00212,India
242147,2023-02-22,202,milk,12,27,15,1,00213,India
242147,2023-02-22,207,coca cola,75,100,25,1,00213,India
484429,2023-02-22,206,yakult,360,400,40,1,00214,India
484429,2023-02-22,211,red bull,90,125,35,1,00214,India
109580,2023-02-22,209,pepsi,75,100,25,1,00215,India
782835,2023-02-22,207,coca cola,75,100,25,1,00216,India
782835,2023-02-22,212,amul cheese,250,315,65,1,00216,India
782835,2023-02-22,209,pepsi,75,100,25,1,00216,India
492547,2023-02-22,201,paneer,210,340,130,1,00217,India
492547,2023-02-22,208,sprite,75,100,25,1,00217,India
492547,2023-02-22,202,milk,12,27,15,1,00217,India
108062,2023-02-22,213,bisleri,6,15,9,1,00218,India
108062,2023-02-22,203,mango yogurt,50,60,10,1,00218,India
108062,2023-02-22,209,pepsi,75,100,25,1,00218,India
108062,2023-02-22,210,mountain dew,75,100,25,1,00218,India
108062,2023-02-22,211,red bull,90,125,35,1,00218,India
418667,2023-02-22,210,mountain dew,75,100,25,1,00219,India
830751,2023-02-22,212,amul cheese,250,315,65,1,00220,India
695168,2023-02-22,209,pepsi,75,100,25,1,00221,India
695168,2023-02-22,207,coca cola,75,100,25,1,00221,India
695168,2023-02-22,210,mountain dew,75,100,25,1,00221,India
108529,2023-02-22,205,classic yogurt,45,60,15,1,00222,India
108529,2023-02-22,209,pepsi,75,100,25,1,00222,India
108529,2023-02-22,203,mango yogurt,50,60,10,1,00222,India
108529,2023-02-22,211,red bull,90,125,35,1,00222,India
129344,2023-02-22,210,mountain dew,75,100,25,1,00223,India
129344,2023-02-22,209,pepsi,75,100,25,1,00223,India
327662,2023-02-22,206,yakult,360,400,40,1,00134,India
327662,2023-02-22,205,classic yogurt,45,60,15,1,00134,India
327662,2023-02-22,213,bisleri,6,15,9,1,00134,India
327662,2023-02-22,210,mountain dew,75,100,25,1,00134,India
589322,2023-02-22,203,mango yogurt,50,60,10,1,00224,India
589322,2023-02-22,213,bisleri,6,15,9,1,00224,India
589322,2023-02-22,204,strawberry yogurt,50,60,10,1,00224,India
589322,2023-02-22,211,red bull,90,125,35,1,00224,India
589322,2023-02-22,210,mountain dew,75,100,25,1,00224,India
407289,2023-02-22,203,mango yogurt,50,60,10,1,00225,India
407289,2023-02-22,208,sprite,75,100,25,1,00225,India
523694,2023-02-22,208,sprite,75,100,25,1,00226,India
523694,2023-02-22,205,classic yogurt,45,60,15,1,00226,India
523694,2023-02-22,201,paneer,210,340,130,1,00226,India
523694,2023-02-22,213,bisleri,6,15,9,1,00226,India
523694,2023-02-22,206,yakult,360,400,40,1,00226,India
944549,2023-02-22,208,sprite,75,100,25,1,00227,India
944549,2023-02-22,203,mango yogurt,50,60,10,1,00227,India
337144,2023-02-22,206,yakult,360,400,40,1,00228,India
337144,2023-02-22,207,coca cola,75,100,25,1,00228,India
337144,2023-02-22,210,mountain dew,75,100,25,1,00228,India
852358,2023-02-22,213,bisleri,6,15,9,1,00229,India
852358,2023-02-22,204,strawberry yogurt,50,60,10,1,00229,India
852358,2023-02-22,207,coca cola,75,100,25,1,00229,India
852358,2023-02-22,212,amul cheese,250,315,65,1,00229,India
637102,2023-02-22,205,classic yogurt,45,60,15,1,00230,India
675109,2023-02-22,211,red bull,90,125,35,1,00231,India
675109,2023-02-22,205,classic yogurt,45,60,15,1,00231,India
675109,2023-02-22,207,coca cola,75,100,25,1,00231,India
728785,2023-02-22,204,strawberry yogurt,50,60,10,1,00232,India
174627,2023-02-22,213,bisleri,6,15,9,1,00233,India
174627,2023-02-22,207,coca cola,75,100,25,1,00233,India
174627,2023-02-22,204,strawberry yogurt,50,60,10,1,00233,India
174627,2023-02-22,209,pepsi,75,100,25,1,00233,India
793681,2023-02-23,212,amul cheese,250,315,65,1,00234,India
793681,2023-02-23,210,mountain dew,75,100,25,1,00234,India
793681,2023-02-23,203,mango yogurt,50,60,10,1,00234,India
793681,2023-02-23,204,strawberry yogurt,50,60,10,1,00234,India
692453,2023-02-23,202,milk,12,27,15,1,00235,India
692453,2023-02-23,212,amul cheese,250,315,65,1,00235,India
692453,2023-02-23,201,paneer,210,340,130,1,00235,India
692453,2023-02-23,211,red bull,90,125,35,1,00235,India
856669,2023-02-23,205,classic yogurt,45,60,15,1,00236,India
856669,2023-02-23,213,bisleri,6,15,9,1,00236,India
856669,2023-02-23,201,paneer,210,340,130,1,00236,India
856669,2023-02-23,211,red bull,90,125,35,1,00236,India
607778,2023-02-23,211,red bull,90,125,35,1,00237,India
607778,2023-02-23,209,pepsi,75,100,25,1,00237,India
767022,2023-02-23,212,amul cheese,250,315,65,1,00238,India
767022,2023-02-23,213,bisleri,6,15,9,1,00238,India
775434,2023-02-23,207,coca cola,75,100,25,1,00239,India
775434,2023-02-23,205,classic yogurt,45,60,15,1,00239,India
775434,2023-02-23,203,mango yogurt,50,60,10,1,00239,India
680905,2023-02-23,211,red bull,90,125,35,1,00240,India
499381,2023-02-23,204,strawberry yogurt,50,60,10,1,00241,India
499381,2023-02-23,209,pepsi,75,100,25,1,00241,India
499381,2023-02-23,211,red bull,90,125,35,1,00241,India
557860,2023-02-23,210,mountain dew,75,100,25,1,00242,India
557860,2023-02-23,203,mango yogurt,50,60,10,1,00242,India
557860,2023-02-23,201,paneer,210,340,130,1,00242,India
557860,2023-02-23,209,pepsi,75,100,25,1,00242,India
557860,2023-02-23,206,yakult,360,400,40,1,00242,India
144978,2023-02-23,210,mountain dew,75,100,25,1,00243,India
144978,2023-02-23,213,bisleri,6,15,9,1,00243,India
407368,2023-02-23,208,sprite,75,100,25,1,00244,India
749397,2023-02-23,213,bisleri,6,15,9,1,00245,India
749397,2023-02-23,201,paneer,210,340,130,1,00245,India
749397,2023-02-23,204,strawberry yogurt,50,60,10,1,00245,India
501387,2023-02-23,211,red bull,90,125,35,1,00246,India
501387,2023-02-23,205,classic yogurt,45,60,15,1,00246,India
501387,2023-02-23,203,mango yogurt,50,60,10,1,00246,India
501387,2023-02-23,206,yakult,360,400,40,1,00246,India
230738,2023-02-23,213,bisleri,6,15,9,1,00247,India
230738,2023-02-23,207,coca cola,75,100,25,1,00247,India
522818,2023-02-23,207,coca cola,75,100,25,1,00248,India
932876,2023-02-23,212,amul cheese,250,315,65,1,00249,India
932876,2023-02-23,211,red bull,90,125,35,1,00249,India
932876,2023-02-23,208,sprite,75,100,25,1,00249,India
609337,2023-02-23,209,pepsi,75,100,25,1,00250,India
609337,2023-02-23,208,sprite,75,100,25,1,00250,India
146609,2023-02-23,203,mango yogurt,50,60,10,1,00251,India
146609,2023-02-23,206,yakult,360,400,40,1,00251,India
615006,2023-02-23,202,milk,12,27,15,1,00252,India
445041,2023-02-23,208,sprite,75,100,25,1,00253,India
445041,2023-02-23,203,mango yogurt,50,60,10,1,00253,India
445041,2023-02-23,207,coca cola,75,100,25,1,00253,India
445041,2023-02-23,204,strawberry yogurt,50,60,10,1,00253,India
360864,2023-02-23,210,mountain dew,75,100,25,1,00254,India
360864,2023-02-23,203,mango yogurt,50,60,10,1,00254,India
360864,2023-02-23,201,paneer,210,340,130,1,00254,India
300143,2023-02-23,212,amul cheese,250,315,65,1,00255,India
300143,2023-02-23,201,paneer,210,340,130,1,00255,India
300143,2023-02-23,206,yakult,360,400,40,1,00255,India
300143,2023-02-23,205,classic yogurt,45,60,15,1,00255,India
386740,2023-02-23,213,bisleri,6,15,9,1,00256,India
386740,2023-02-23,211,red bull,90,125,35,1,00256,India
198895,2023-02-23,209,pepsi,75,100,25,1,00257,India
198895,2023-02-23,208,sprite,75,100,25,1,00257,India
198895,2023-02-23,204,strawberry yogurt,50,60,10,1,00257,India
910595,2023-02-23,212,amul cheese,250,315,65,1,00258,India
910595,2023-02-23,210,mountain dew,75,100,25,1,00258,India
566295,2023-02-23,210,mountain dew,75,100,25,1,00259,India
566295,2023-02-23,204,strawberry yogurt,50,60,10,1,00259,India
908577,2023-02-23,202,milk,12,27,15,1,00260,India
908577,2023-02-23,206,yakult,360,400,40,1,00260,India
908577,2023-02-23,212,amul cheese,250,315,65,1,00260,India
908577,2023-02-23,210,mountain dew,75,100,25,1,00260,India
789059,2023-02-23,206,yakult,360,400,40,1,00261,India
789059,2023-02-23,213,bisleri,6,15,9,1,00261,India
789059,2023-02-23,208,sprite,75,100,25,1,00261,India
595181,2023-02-23,213,bisleri,6,15,9,1,00262,India
281436,2023-02-23,202,milk,12,27,15,1,00263,India
281436,2023-02-23,204,strawberry yogurt,50,60,10,1,00263,India
579989,2023-02-23,205,classic yogurt,45,60,15,1,00264,India
971378,2023-02-23,204,strawberry yogurt,50,60,10,1,00265,India
971378,2023-02-23,207,coca cola,75,100,25,1,00265,India
971378,2023-02-23,208,sprite,75,100,25,1,00265,India
150005,2023-02-23,208,sprite,75,100,25,1,00266,India
150005,2023-02-23,211,red bull,90,125,35,1,00266,India
150005,2023-02-23,207,coca cola,75,100,25,1,00266,India
770231,2023-02-23,206,yakult,360,400,40,1,00267,India
837035,2023-02-23,213,bisleri,6,15,9,1,00268,India
283255,2023-02-23,202,milk,12,27,15,1,00269,India
936641,2023-02-23,212,amul cheese,250,315,65,1,00270,India
936641,2023-02-23,206,yakult,360,400,40,1,00270,India
468845,2023-02-23,209,pepsi,75,100,25,1,00271,India
468845,2023-02-23,212,amul cheese,250,315,65,1,00271,India
468845,2023-02-23,208,sprite,75,100,25,1,00271,India
468845,2023-02-23,206,yakult,360,400,40,1,00271,India
468845,2023-02-23,211,red bull,90,125,35,1,00271,India
472078,2023-02-23,211,red bull,90,125,35,1,00272,India
472078,2023-02-23,213,bisleri,6,15,9,1,00272,India
472078,2023-02-23,208,sprite,75,100,25,1,00272,India
472078,2023-02-23,207,coca cola,75,100,25,1,00272,India
300813,2023-02-23,204,strawberry yogurt,50,60,10,1,00273,India
300813,2023-02-23,207,coca cola,75,100,25,1,00273,India
300813,2023-02-23,213,bisleri,6,15,9,1,00273,India
464312,2023-02-23,201,paneer,210,340,130,1,00274,India
464312,2023-02-23,207,coca cola,75,100,25,1,00274,India
464312,2023-02-23,211,red bull,90,125,35,1,00274,India
593969,2023-02-23,209,pepsi,75,100,25,1,00275,India
199929,2023-02-23,202,milk,12,27,15,1,00276,India
199929,2023-02-23,201,paneer,210,340,130,1,00276,India
199929,2023-02-23,206,yakult,360,400,40,1,00276,India
843668,2023-02-23,202,milk,12,27,15,1,00277,India
843668,2023-02-23,209,pepsi,75,100,25,1,00277,India
843668,2023-02-23,207,coca cola,75,100,25,1,00277,India
843668,2023-02-23,208,sprite,75,100,25,1,00277,India
926063,2023-02-23,201,paneer,210,340,130,1,00278,India
926063,2023-02-23,202,milk,12,27,15,1,00278,India
926063,2023-02-23,205,classic yogurt,45,60,15,1,00278,India
926063,2023-02-23,204,strawberry yogurt,50,60,10,1,00278,India
593294,2023-02-23,212,amul cheese,250,315,65,1,00279,India
593294,2023-02-23,205,classic yogurt,45,60,15,1,00279,India
593294,2023-02-23,203,mango yogurt,50,60,10,1,00279,India
593294,2023-02-23,202,milk,12,27,15,1,00279,India
593294,2023-02-23,204,strawberry yogurt,50,60,10,1,00279,India
949829,2023-02-23,204,strawberry yogurt,50,60,10,1,00280,India
949829,2023-02-23,205,classic yogurt,45,60,15,1,00280,India
531861,2023-02-23,204,strawberry yogurt,50,60,10,1,00281,India
531861,2023-02-23,213,bisleri,6,15,9,1,00281,India
531861,2023-02-23,202,milk,12,27,15,1,00281,India
906531,2023-02-23,203,mango yogurt,50,60,10,1,00282,India
906531,2023-02-23,202,milk,12,27,15,1,00282,India
906531,2023-02-23,213,bisleri,6,15,9,1,00282,India
906531,2023-02-23,211,red bull,90,125,35,1,00282,India
431243,2023-02-23,207,coca cola,75,100,25,1,00283,India
431243,2023-02-23,206,yakult,360,400,40,1,00283,India
431243,2023-02-23,211,red bull,90,125,35,1,00283,India
431243,2023-02-23,209,pepsi,75,100,25,1,00283,India
762348,2023-02-23,202,milk,12,27,15,1,00284,India
762348,2023-02-23,206,yakult,360,400,40,1,00284,India
725146,2023-02-23,210,mountain dew,75,100,25,1,00285,India
725146,2023-02-23,209,pepsi,75,100,25,1,00285,India
725146,2023-02-23,201,paneer,210,340,130,1,00285,India
642326,2023-02-23,212,amul cheese,250,315,65,1,00286,India
642326,2023-02-23,210,mountain dew,75,100,25,1,00286,India
496496,2023-02-23,207,coca cola,75,100,25,1,00287,India
496496,2023-02-23,211,red bull,90,125,35,1,00287,India
496496,2023-02-23,208,sprite,75,100,25,1,00287,India
714148,2023-02-23,206,yakult,360,400,40,1,00288,India
714148,2023-02-23,208,sprite,75,100,25,1,00288,India
714148,2023-02-23,201,paneer,210,340,130,1,00288,India
714148,2023-02-23,207,coca cola,75,100,25,1,00288,India
518333,2023-02-23,202,milk,12,27,15,1,00289,India
518333,2023-02-23,204,strawberry yogurt,50,60,10,1,00289,India
518333,2023-02-23,210,mountain dew,75,100,25,1,00289,India
518333,2023-02-23,213,bisleri,6,15,9,1,00289,India
518333,2023-02-23,208,sprite,75,100,25,1,00289,India
124121,2023-02-23,210,mountain dew,75,100,25,1,00290,India
287317,2023-02-23,206,yakult,360,400,40,1,00291,India
287317,2023-02-23,205,classic yogurt,45,60,15,1,00291,India
278431,2023-02-23,209,pepsi,75,100,25,1,00292,India
372356,2023-02-23,213,bisleri,6,15,9,1,00293,India
372356,2023-02-23,202,milk,12,27,15,1,00293,India
372356,2023-02-23,207,coca cola,75,100,25,1,00293,India
372356,2023-02-23,208,sprite,75,100,25,1,00293,India
312765,2023-02-23,211,red bull,90,125,35,1,00294,India
312765,2023-02-23,212,amul cheese,250,315,65,1,00294,India
312765,2023-02-23,204,strawberry yogurt,50,60,10,1,00294,India
312765,2023-02-23,210,mountain dew,75,100,25,1,00294,India
312765,2023-02-23,201,paneer,210,340,130,1,00294,India
664018,2023-02-23,207,coca cola,75,100,25,1,00295,India
664018,2023-02-23,211,red bull,90,125,35,1,00295,India
664018,2023-02-23,212,amul cheese,250,315,65,1,00295,India
664018,2023-02-23,201,paneer,210,340,130,1,00295,India
653682,2023-02-23,208,sprite,75,100,25,1,00296,India
653682,2023-02-23,211,red bull,90,125,35,1,00296,India
653682,2023-02-23,213,bisleri,6,15,9,1,00296,India
833197,2023-02-23,213,bisleri,6,15,9,1,00297,India
833197,2023-02-23,201,paneer,210,340,130,1,00297,India
453579,2023-02-23,201,paneer,210,340,130,1,00298,India
296068,2023-02-23,203,mango yogurt,50,60,10,1,00299,India
296068,2023-02-23,201,paneer,210,340,130,1,00299,India
250754,2023-02-24,206,yakult,360,400,40,1,00300,India
250754,2023-02-24,213,bisleri,6,15,9,1,00300,India
250754,2023-02-24,210,mountain dew,75,100,25,1,00300,India
372685,2023-02-24,210,mountain dew,75,100,25,1,00301,India
372685,2023-02-24,212,amul cheese,250,315,65,1,00301,India
372685,2023-02-24,203,mango yogurt,50,60,10,1,00301,India
372685,2023-02-24,208,sprite,75,100,25,1,00301,India
144999,2023-02-24,203,mango yogurt,50,60,10,1,00302,India
144999,2023-02-24,209,pepsi,75,100,25,1,00302,India
529284,2023-02-24,213,bisleri,6,15,9,1,00303,India
529284,2023-02-24,208,sprite,75,100,25,1,00303,India
529284,2023-02-24,206,yakult,360,400,40,1,00303,India
187464,2023-02-24,204,strawberry yogurt,50,60,10,1,00304,India
187464,2023-02-24,207,coca cola,75,100,25,1,00304,India
187464,2023-02-24,202,milk,12,27,15,1,00304,India
187464,2023-02-24,205,classic yogurt,45,60,15,1,00304,India
187464,2023-02-24,211,red bull,90,125,35,1,00304,India
250201,2023-02-24,209,pepsi,75,100,25,1,00305,India
250201,2023-02-24,210,mountain dew,75,100,25,1,00305,India
657812,2023-02-24,203,mango yogurt,50,60,10,1,00306,India
657812,2023-02-24,202,milk,12,27,15,1,00306,India
657812,2023-02-24,205,classic yogurt,45,60,15,1,00306,India
657812,2023-02-24,210,mountain dew,75,100,25,1,00306,India
212212,2023-02-24,207,coca cola,75,100,25,1,00307,India
490126,2023-02-24,209,pepsi,75,100,25,1,00308,India
585397,2023-02-24,202,milk,12,27,15,1,00309,India
585397,2023-02-24,207,coca cola,75,100,25,1,00309,India
991604,2023-02-24,201,paneer,210,340,130,1,00310,India
991604,2023-02-24,212,amul cheese,250,315,65,1,00310,India
754435,2023-02-24,212,amul cheese,250,315,65,1,00311,India
955153,2023-02-24,208,sprite,75,100,25,1,00312,India
333357,2023-02-24,212,amul cheese,250,315,65,1,00313,India
333357,2023-02-24,213,bisleri,6,15,9,1,00313,India
517424,2023-02-24,207,coca cola,75,100,25,1,00314,India
517424,2023-02-24,212,amul cheese,250,315,65,1,00314,India
517424,2023-02-24,209,pepsi,75,100,25,1,00314,India
992751,2023-02-24,210,mountain dew,75,100,25,1,00315,India
992751,2023-02-24,208,sprite,75,100,25,1,00315,India
992751,2023-02-24,203,mango yogurt,50,60,10,1,00315,India
153135,2023-02-24,211,red bull,90,125,35,1,00316,India
153135,2023-02-24,202,milk,12,27,15,1,00316,India
218986,2023-02-24,203,mango yogurt,50,60,10,1,00317,India
887998,2023-02-24,206,yakult,360,400,40,1,00318,India
887998,2023-02-24,208,sprite,75,100,25,1,00318,India
887998,2023-02-24,207,coca cola,75,100,25,1,00318,India
887998,2023-02-24,213,bisleri,6,15,9,1,00318,India
824556,2023-02-24,201,paneer,210,340,130,1,00319,India
824556,2023-02-24,209,pepsi,75,100,25,1,00319,India
824556,2023-02-24,206,yakult,360,400,40,1,00319,India
824556,2023-02-24,213,bisleri,6,15,9,1,00319,India
482761,2023-02-24,209,pepsi,75,100,25,1,00320,India
482761,2023-02-24,213,bisleri,6,15,9,1,00320,India
482761,2023-02-24,203,mango yogurt,50,60,10,1,00320,India
510091,2023-02-24,209,pepsi,75,100,25,1,00321,India
510091,2023-02-24,208,sprite,75,100,25,1,00321,India
510091,2023-02-24,203,mango yogurt,50,60,10,1,00321,India
510091,2023-02-24,202,milk,12,27,15,1,00321,India
775375,2023-02-24,202,milk,12,27,15,1,00322,India
775375,2023-02-24,211,red bull,90,125,35,1,00322,India
775375,2023-02-24,208,sprite,75,100,25,1,00322,India
775375,2023-02-24,207,coca cola,75,100,25,1,00322,India
775375,2023-02-24,205,classic yogurt,45,60,15,1,00322,India
600091,2023-02-24,203,mango yogurt,50,60,10,1,00323,India
998049,2023-02-24,205,classic yogurt,45,60,15,1,00324,India
998049,2023-02-24,211,red bull,90,125,35,1,00324,India
998049,2023-02-24,210,mountain dew,75,100,25,1,00324,India
998049,2023-02-24,204,strawberry yogurt,50,60,10,1,00324,India
998049,2023-02-24,208,sprite,75,100,25,1,00324,India
261589,2023-02-24,213,bisleri,6,15,9,1,00325,India
785487,2023-02-24,213,bisleri,6,15,9,1,00326,India
785487,2023-02-24,204,strawberry yogurt,50,60,10,1,00326,India
785487,2023-02-24,211,red bull,90,125,35,1,00326,India
225598,2023-02-24,201,paneer,210,340,130,1,00327,India
225598,2023-02-24,206,yakult,360,400,40,1,00327,India
124322,2023-02-24,201,paneer,210,340,130,1,00328,India
124322,2023-02-24,205,classic yogurt,45,60,15,1,00328,India
124322,2023-02-24,203,mango yogurt,50,60,10,1,00328,India
124322,2023-02-24,204,strawberry yogurt,50,60,10,1,00328,India
619750,2023-02-24,204,strawberry yogurt,50,60,10,1,00329,India
619750,2023-02-24,201,paneer,210,340,130,1,00329,India
619750,2023-02-24,203,mango yogurt,50,60,10,1,00329,India
619750,2023-02-24,206,yakult,360,400,40,1,00329,India
690401,2023-02-24,203,mango yogurt,50,60,10,1,00330,India
690401,2023-02-24,206,yakult,360,400,40,1,00330,India
690401,2023-02-24,210,mountain dew,75,100,25,1,00330,India
690401,2023-02-24,212,amul cheese,250,315,65,1,00330,India
690401,2023-02-24,208,sprite,75,100,25,1,00330,India
688331,2023-02-24,210,mountain dew,75,100,25,1,00331,India
688331,2023-02-24,201,paneer,210,340,130,1,00331,India
688331,2023-02-24,213,bisleri,6,15,9,1,00331,India
688331,2023-02-24,202,milk,12,27,15,1,00331,India
688331,2023-02-24,209,pepsi,75,100,25,1,00331,India
907615,2023-02-24,204,strawberry yogurt,50,60,10,1,00332,India
576969,2023-02-24,210,mountain dew,75,100,25,1,00333,India
576969,2023-02-24,203,mango yogurt,50,60,10,1,00333,India
576969,2023-02-24,211,red bull,90,125,35,1,00333,India
576969,2023-02-24,208,sprite,75,100,25,1,00333,India
469472,2023-02-24,201,paneer,210,340,130,1,00334,India
469472,2023-02-24,210,mountain dew,75,100,25,1,00334,India
495398,2023-02-24,213,bisleri,6,15,9,1,00335,India
495398,2023-02-24,201,paneer,210,340,130,1,00335,India
350846,2023-02-24,206,yakult,360,400,40,1,00336,India
350846,2023-02-24,204,strawberry yogurt,50,60,10,1,00336,India
262442,2023-02-24,204,strawberry yogurt,50,60,10,1,00337,India
262442,2023-02-24,203,mango yogurt,50,60,10,1,00337,India
262442,2023-02-24,206,yakult,360,400,40,1,00337,India
262442,2023-02-24,207,coca cola,75,100,25,1,00337,India
262442,2023-02-24,211,red bull,90,125,35,1,00337,India
506491,2023-02-24,209,pepsi,75,100,25,1,00338,India
506491,2023-02-24,204,strawberry yogurt,50,60,10,1,00338,India
506491,2023-02-24,208,sprite,75,100,25,1,00338,India
574649,2023-02-24,212,amul cheese,250,315,65,1,00339,India
574649,2023-02-24,202,milk,12,27,15,1,00339,India
663155,2023-02-24,203,mango yogurt,50,60,10,1,00340,India
663155,2023-02-24,206,yakult,360,400,40,1,00340,India
750348,2023-02-24,211,red bull,90,125,35,1,00341,India
750348,2023-02-24,206,yakult,360,400,40,1,00341,India
750348,2023-02-24,213,bisleri,6,15,9,1,00341,India
750348,2023-02-24,209,pepsi,75,100,25,1,00341,India
923555,2023-02-24,211,red bull,90,125,35,1,00342,India
923555,2023-02-24,206,yakult,360,400,40,1,00342,India
923555,2023-02-24,208,sprite,75,100,25,1,00342,India
923555,2023-02-24,204,strawberry yogurt,50,60,10,1,00342,India
923555,2023-02-24,202,milk,12,27,15,1,00342,India
542480,2023-02-24,201,paneer,210,340,130,1,00343,India
542480,2023-02-24,206,yakult,360,400,40,1,00343,India
454953,2023-02-24,207,coca cola,75,100,25,1,00344,India
454953,2023-02-24,202,milk,12,27,15,1,00344,India
101770,2023-02-24,204,strawberry yogurt,50,60,10,1,00345,India
101770,2023-02-24,203,mango yogurt,50,60,10,1,00345,India
101770,2023-02-24,209,pepsi,75,100,25,1,00345,India
156054,2023-02-24,211,red bull,90,125,35,1,00346,India
916680,2023-02-24,202,milk,12,27,15,1,00347,India
916680,2023-02-24,207,coca cola,75,100,25,1,00347,India
916680,2023-02-24,210,mountain dew,75,100,25,1,00347,India
916680,2023-02-24,212,amul cheese,250,315,65,1,00347,India
951047,2023-02-24,202,milk,12,27,15,1,00348,India
951047,2023-02-24,205,classic yogurt,45,60,15,1,00348,India
951047,2023-02-24,210,mountain dew,75,100,25,1,00348,India
951047,2023-02-24,201,paneer,210,340,130,1,00348,India
990966,2023-02-24,209,pepsi,75,100,25,1,00349,India
990966,2023-02-24,208,sprite,75,100,25,1,00349,India
990966,2023-02-24,205,classic yogurt,45,60,15,1,00349,India
990966,2023-02-24,207,coca cola,75,100,25,1,00349,India
990966,2023-02-24,203,mango yogurt,50,60,10,1,00349,India
471762,2023-02-24,207,coca cola,75,100,25,1,00350,India
471762,2023-02-24,206,yakult,360,400,40,1,00350,India
471762,2023-02-24,203,mango yogurt,50,60,10,1,00350,India
471762,2023-02-24,209,pepsi,75,100,25,1,00350,India
996831,2023-02-24,212,amul cheese,250,315,65,1,00351,India
996831,2023-02-24,204,strawberry yogurt,50,60,10,1,00351,India
996831,2023-02-24,210,mountain dew,75,100,25,1,00351,India
849321,2023-02-24,201,paneer,210,340,130,1,00352,India
849321,2023-02-24,207,coca cola,75,100,25,1,00352,India
849321,2023-02-24,208,sprite,75,100,25,1,00352,India
849321,2023-02-24,209,pepsi,75,100,25,1,00352,India
441299,2023-02-24,210,mountain dew,75,100,25,1,00353,India
441299,2023-02-24,211,red bull,90,125,35,1,00353,India
441299,2023-02-24,206,yakult,360,400,40,1,00353,India
441299,2023-02-24,209,pepsi,75,100,25,1,00353,India
718670,2023-02-24,205,classic yogurt,45,60,15,1,00354,India
718670,2023-02-24,206,yakult,360,400,40,1,00354,India
718670,2023-02-24,212,amul cheese,250,315,65,1,00354,India
718670,2023-02-24,203,mango yogurt,50,60,10,1,00354,India
648214,2023-02-24,204,strawberry yogurt,50,60,10,1,00355,India
648214,2023-02-24,207,coca cola,75,100,25,1,00355,India
648214,2023-02-24,206,yakult,360,400,40,1,00355,India
912140,2023-02-24,213,bisleri,6,15,9,1,00356,India
912140,2023-02-24,201,paneer,210,340,130,1,00356,India
283278,2023-02-24,204,strawberry yogurt,50,60,10,1,00357,India
283278,2023-02-24,207,coca cola,75,100,25,1,00357,India
283278,2023-02-24,211,red bull,90,125,35,1,00357,India
283278,2023-02-24,202,milk,12,27,15,1,00357,India
947600,2023-02-24,205,classic yogurt,45,60,15,1,00358,India
515115,2023-02-24,204,strawberry yogurt,50,60,10,1,00359,India
531712,2023-02-24,206,yakult,360,400,40,1,00360,India
119289,2023-02-24,209,pepsi,75,100,25,1,00361,India
119289,2023-02-24,204,strawberry yogurt,50,60,10,1,00361,India
119289,2023-02-24,207,coca cola,75,100,25,1,00361,India
594313,2023-02-24,207,coca cola,75,100,25,1,00362,India
609592,2023-02-24,212,amul cheese,250,315,65,1,00363,India
609592,2023-02-24,203,mango yogurt,50,60,10,1,00363,India
609592,2023-02-24,207,coca cola,75,100,25,1,00363,India
609592,2023-02-24,205,classic yogurt,45,60,15,1,00363,India
715685,2023-02-24,210,mountain dew,75,100,25,1,00364,India
715685,2023-02-24,213,bisleri,6,15,9,1,00364,India
715685,2023-02-24,201,paneer,210,340,130,1,00364,India
230443,2023-02-24,211,red bull,90,125,35,1,00365,India
230443,2023-02-24,205,classic yogurt,45,60,15,1,00365,India
230443,2023-02-24,206,yakult,360,400,40,1,00365,India
955637,2023-02-24,206,yakult,360,400,40,1,00366,India
955637,2023-02-24,213,bisleri,6,15,9,1,00366,India
955637,2023-02-24,202,milk,12,27,15,1,00366,India
712993,2023-02-24,201,paneer,210,340,130,1,00367,India
712993,2023-02-24,205,classic yogurt,45,60,15,1,00367,India
712993,2023-02-24,208,sprite,75,100,25,1,00367,India
712993,2023-02-24,212,amul cheese,250,315,65,1,00367,India
164197,2023-02-24,205,classic yogurt,45,60,15,1,00368,India
164197,2023-02-24,202,milk,12,27,15,1,00368,India
269703,2023-02-24,201,paneer,210,340,130,1,00369,India
269703,2023-02-24,210,mountain dew,75,100,25,1,00369,India
450289,2023-02-24,211,red bull,90,125,35,1,00370,India
450289,2023-02-24,208,sprite,75,100,25,1,00370,India
940509,2023-02-25,212,amul cheese,250,315,65,1,00371,India
940509,2023-02-25,201,paneer,210,340,130,1,00371,India
940509,2023-02-25,203,mango yogurt,50,60,10,1,00371,India
940509,2023-02-25,209,pepsi,75,100,25,1,00371,India
414828,2023-02-25,205,classic yogurt,45,60,15,1,00372,India
414828,2023-02-25,211,red bull,90,125,35,1,00372,India
681944,2023-02-25,206,yakult,360,400,40,1,00373,India
681944,2023-02-25,207,coca cola,75,100,25,1,00373,India
681944,2023-02-25,205,classic yogurt,45,60,15,1,00373,India
681944,2023-02-25,211,red bull,90,125,35,1,00373,India
412809,2023-02-25,210,mountain dew,75,100,25,1,00374,India
211607,2023-02-25,211,red bull,90,125,35,1,00375,India
211607,2023-02-25,205,classic yogurt,45,60,15,1,00375,India
211607,2023-02-25,213,bisleri,6,15,9,1,00375,India
211607,2023-02-25,204,strawberry yogurt,50,60,10,1,00375,India
762378,2023-02-25,206,yakult,360,400,40,1,00376,India
762378,2023-02-25,202,milk,12,27,15,1,00376,India
322988,2023-02-25,205,classic yogurt,45,60,15,1,00377,India
322988,2023-02-25,206,yakult,360,400,40,1,00377,India
322988,2023-02-25,211,red bull,90,125,35,1,00377,India
322988,2023-02-25,208,sprite,75,100,25,1,00377,India
977266,2023-02-25,207,coca cola,75,100,25,1,00378,India
977266,2023-02-25,205,classic yogurt,45,60,15,1,00378,India
977266,2023-02-25,201,paneer,210,340,130,1,00378,India
977266,2023-02-25,204,strawberry yogurt,50,60,10,1,00378,India
626414,2023-02-25,205,classic yogurt,45,60,15,1,00379,India
626414,2023-02-25,202,milk,12,27,15,1,00379,India
340863,2023-02-25,207,coca cola,75,100,25,1,00380,India
830632,2023-02-25,210,mountain dew,75,100,25,1,00381,India
830632,2023-02-25,209,pepsi,75,100,25,1,00381,India
830632,2023-02-25,204,strawberry yogurt,50,60,10,1,00381,India
830632,2023-02-25,213,bisleri,6,15,9,1,00381,India
991002,2023-02-25,204,strawberry yogurt,50,60,10,1,00382,India
429803,2023-02-25,204,strawberry yogurt,50,60,10,1,00383,India
429803,2023-02-25,203,mango yogurt,50,60,10,1,00383,India
794618,2023-02-25,202,milk,12,27,15,1,00384,India
794618,2023-02-25,211,red bull,90,125,35,1,00384,India
794618,2023-02-25,203,mango yogurt,50,60,10,1,00384,India
794618,2023-02-25,204,strawberry yogurt,50,60,10,1,00384,India
515548,2023-02-25,209,pepsi,75,100,25,1,00385,India
515548,2023-02-25,213,bisleri,6,15,9,1,00385,India
515548,2023-02-25,201,paneer,210,340,130,1,00385,India
549112,2023-02-25,205,classic yogurt,45,60,15,1,00386,India
549112,2023-02-25,210,mountain dew,75,100,25,1,00386,India
549112,2023-02-25,209,pepsi,75,100,25,1,00386,India
668077,2023-02-25,208,sprite,75,100,25,1,00387,India
668077,2023-02-25,212,amul cheese,250,315,65,1,00387,India
668077,2023-02-25,206,yakult,360,400,40,1,00387,India
452793,2023-02-25,206,yakult,360,400,40,1,00388,India
452793,2023-02-25,203,mango yogurt,50,60,10,1,00388,India
717698,2023-02-25,202,milk,12,27,15,1,00389,India
717698,2023-02-25,203,mango yogurt,50,60,10,1,00389,India
717698,2023-02-25,207,coca cola,75,100,25,1,00389,India
717698,2023-02-25,210,mountain dew,75,100,25,1,00389,India
427631,2023-02-25,212,amul cheese,250,315,65,1,00390,India
427631,2023-02-25,206,yakult,360,400,40,1,00390,India
427631,2023-02-25,213,bisleri,6,15,9,1,00390,India
427631,2023-02-25,208,sprite,75,100,25,1,00390,India
764284,2023-02-25,210,mountain dew,75,100,25,1,00391,India
764284,2023-02-25,209,pepsi,75,100,25,1,00391,India
764284,2023-02-25,205,classic yogurt,45,60,15,1,00391,India
764284,2023-02-25,213,bisleri,6,15,9,1,00391,India
979285,2023-02-25,201,paneer,210,340,130,1,00392,India
979285,2023-02-25,208,sprite,75,100,25,1,00392,India
979285,2023-02-25,212,amul cheese,250,315,65,1,00392,India
979285,2023-02-25,211,red bull,90,125,35,1,00392,India
684741,2023-02-25,211,red bull,90,125,35,1,00393,India
684741,2023-02-25,202,milk,12,27,15,1,00393,India
684741,2023-02-25,209,pepsi,75,100,25,1,00393,India
684741,2023-02-25,210,mountain dew,75,100,25,1,00393,India
285119,2023-02-25,203,mango yogurt,50,60,10,1,00394,India
285119,2023-02-25,208,sprite,75,100,25,1,00394,India
285119,2023-02-25,209,pepsi,75,100,25,1,00394,India
285119,2023-02-25,213,bisleri,6,15,9,1,00394,India
285119,2023-02-25,206,yakult,360,400,40,1,00394,India
770498,2023-02-25,206,yakult,360,400,40,1,00395,India
976504,2023-02-25,207,coca cola,75,100,25,1,00396,India
976504,2023-02-25,209,pepsi,75,100,25,1,00396,India
745981,2023-02-25,206,yakult,360,400,40,1,00397,India
745981,2023-02-25,201,paneer,210,340,130,1,00397,India
924646,2023-02-25,209,pepsi,75,100,25,1,00398,India
924646,2023-02-25,213,bisleri,6,15,9,1,00398,India
924646,2023-02-25,207,coca cola,75,100,25,1,00398,India
890352,2023-02-25,203,mango yogurt,50,60,10,1,00399,India
890352,2023-02-25,201,paneer,210,340,130,1,00399,India
890352,2023-02-25,210,mountain dew,75,100,25,1,00399,India
720201,2023-02-25,213,bisleri,6,15,9,1,00400,India
720201,2023-02-25,204,strawberry yogurt,50,60,10,1,00400,India
720201,2023-02-25,203,mango yogurt,50,60,10,1,00400,India
594788,2023-02-25,207,coca cola,75,100,25,1,00401,India
978266,2023-02-25,210,mountain dew,75,100,25,1,00402,India
978266,2023-02-25,204,strawberry yogurt,50,60,10,1,00402,India
978266,2023-02-25,203,mango yogurt,50,60,10,1,00402,India
978266,2023-02-25,213,bisleri,6,15,9,1,00402,India
470724,2023-02-25,206,yakult,360,400,40,1,00403,India
470724,2023-02-25,204,strawberry yogurt,50,60,10,1,00403,India
470724,2023-02-25,208,sprite,75,100,25,1,00403,India
470724,2023-02-25,207,coca cola,75,100,25,1,00403,India
909362,2023-02-25,203,mango yogurt,50,60,10,1,00404,India
108359,2023-02-25,202,milk,12,27,15,1,00405,India
188813,2023-02-25,207,coca cola,75,100,25,1,00406,India
180051,2023-02-25,206,yakult,360,400,40,1,00407,India
426663,2023-02-25,208,sprite,75,100,25,1,00408,India
255178,2023-02-25,210,mountain dew,75,100,25,1,00409,India
255178,2023-02-25,204,strawberry yogurt,50,60,10,1,00409,India
255178,2023-02-25,201,paneer,210,340,130,1,00409,India
255178,2023-02-25,209,pepsi,75,100,25,1,00409,India
506209,2023-02-25,205,classic yogurt,45,60,15,1,00410,India
506209,2023-02-25,207,coca cola,75,100,25,1,00410,India
845696,2023-02-25,204,strawberry yogurt,50,60,10,1,00411,India
845696,2023-02-25,207,coca cola,75,100,25,1,00411,India
845696,2023-02-25,202,milk,12,27,15,1,00411,India
845696,2023-02-25,203,mango yogurt,50,60,10,1,00411,India
845696,2023-02-25,206,yakult,360,400,40,1,00411,India
105932,2023-02-25,208,sprite,75,100,25,1,00412,India
883234,2023-02-25,210,mountain dew,75,100,25,1,00413,India
883234,2023-02-25,202,milk,12,27,15,1,00413,India
883234,2023-02-25,212,amul cheese,250,315,65,1,00413,India
883234,2023-02-25,205,classic yogurt,45,60,15,1,00413,India
803968,2023-02-25,203,mango yogurt,50,60,10,1,00414,India
803968,2023-02-25,202,milk,12,27,15,1,00414,India
803968,2023-02-25,207,coca cola,75,100,25,1,00414,India
803968,2023-02-25,211,red bull,90,125,35,1,00414,India
914461,2023-02-25,210,mountain dew,75,100,25,1,00415,India
914461,2023-02-25,202,milk,12,27,15,1,00415,India
914461,2023-02-25,209,pepsi,75,100,25,1,00415,India
914461,2023-02-25,212,amul cheese,250,315,65,1,00415,India
654951,2023-02-25,204,strawberry yogurt,50,60,10,1,00416,India
654951,2023-02-25,210,mountain dew,75,100,25,1,00416,India
674570,2023-02-25,212,amul cheese,250,315,65,1,00417,India
674570,2023-02-25,203,mango yogurt,50,60,10,1,00417,India
674570,2023-02-25,202,milk,12,27,15,1,00417,India
674570,2023-02-25,201,paneer,210,340,130,1,00417,India
383915,2023-02-25,201,paneer,210,340,130,1,00418,India
383915,2023-02-25,204,strawberry yogurt,50,60,10,1,00418,India
958244,2023-02-25,202,milk,12,27,15,1,00419,India
958244,2023-02-25,211,red bull,90,125,35,1,00419,India
958244,2023-02-25,206,yakult,360,400,40,1,00419,India
781473,2023-02-25,212,amul cheese,250,315,65,1,00420,India
781473,2023-02-25,213,bisleri,6,15,9,1,00420,India
394833,2023-02-25,201,paneer,210,340,130,1,00421,India
394833,2023-02-25,209,pepsi,75,100,25,1,00421,India
394833,2023-02-25,212,amul cheese,250,315,65,1,00421,India
394833,2023-02-25,211,red bull,90,125,35,1,00421,India
394833,2023-02-25,203,mango yogurt,50,60,10,1,00421,India
237963,2023-02-25,212,amul cheese,250,315,65,1,00422,India
237963,2023-02-25,202,milk,12,27,15,1,00422,India
237963,2023-02-25,211,red bull,90,125,35,1,00422,India
237963,2023-02-25,201,paneer,210,340,130,1,00422,India
859103,2023-02-25,206,yakult,360,400,40,1,00423,India
859103,2023-02-25,212,amul cheese,250,315,65,1,00423,India
859103,2023-02-25,213,bisleri,6,15,9,1,00423,India
859103,2023-02-25,210,mountain dew,75,100,25,1,00423,India
859103,2023-02-25,204,strawberry yogurt,50,60,10,1,00423,India
402284,2023-02-25,201,paneer,210,340,130,1,00424,India
402284,2023-02-25,213,bisleri,6,15,9,1,00424,India
402284,2023-02-25,209,pepsi,75,100,25,1,00424,India
402284,2023-02-25,208,sprite,75,100,25,1,00424,India
402284,2023-02-25,205,classic yogurt,45,60,15,1,00424,India
483630,2023-02-25,206,yakult,360,400,40,1,00425,India
483630,2023-02-25,211,red bull,90,125,35,1,00425,India
333005,2023-02-25,213,bisleri,6,15,9,1,00426,India
333005,2023-02-25,205,classic yogurt,45,60,15,1,00426,India
656102,2023-02-25,210,mountain dew,75,100,25,1,00427,India
656102,2023-02-25,203,mango yogurt,50,60,10,1,00427,India
977265,2023-02-25,209,pepsi,75,100,25,1,00428,India
977265,2023-02-25,210,mountain dew,75,100,25,1,00428,India
977265,2023-02-25,212,amul cheese,250,315,65,1,00428,India
977265,2023-02-25,205,classic yogurt,45,60,15,1,00428,India
443106,2023-02-25,203,mango yogurt,50,60,10,1,00429,India
443106,2023-02-25,206,yakult,360,400,40,1,00429,India
966027,2023-02-25,212,amul cheese,250,315,65,1,00430,India
966027,2023-02-25,213,bisleri,6,15,9,1,00430,India
966027,2023-02-25,203,mango yogurt,50,60,10,1,00430,India
966027,2023-02-25,204,strawberry yogurt,50,60,10,1,00430,India
827769,2023-02-25,209,pepsi,75,100,25,1,00431,India
827769,2023-02-25,206,yakult,360,400,40,1,00431,India
827769,2023-02-25,210,mountain dew,75,100,25,1,00431,India
827769,2023-02-25,211,red bull,90,125,35,1,00431,India
392761,2023-02-25,202,milk,12,27,15,1,00432,India
599359,2023-02-25,202,milk,12,27,15,1,00433,India
599359,2023-02-25,203,mango yogurt,50,60,10,1,00433,India
599359,2023-02-25,210,mountain dew,75,100,25,1,00433,India
599359,2023-02-25,211,red bull,90,125,35,1,00433,India
377119,2023-02-25,211,red bull,90,125,35,1,00434,India
377119,2023-02-25,212,amul cheese,250,315,65,1,00434,India
377119,2023-02-25,207,coca cola,75,100,25,1,00434,India
377119,2023-02-25,205,classic yogurt,45,60,15,1,00434,India
939442,2023-02-25,213,bisleri,6,15,9,1,00435,India
939442,2023-02-25,204,strawberry yogurt,50,60,10,1,00435,India
939442,2023-02-25,206,yakult,360,400,40,1,00435,India
939442,2023-02-25,211,red bull,90,125,35,1,00435,India
836827,2023-02-25,202,milk,12,27,15,1,00436,India
413508,2023-02-25,207,coca cola,75,100,25,1,00437,India
413508,2023-02-25,209,pepsi,75,100,25,1,00437,India
413508,2023-02-25,211,red bull,90,125,35,1,00437,India
366693,2023-02-25,208,sprite,75,100,25,1,00438,India
366693,2023-02-25,205,classic yogurt,45,60,15,1,00438,India
366693,2023-02-25,209,pepsi,75,100,25,1,00438,India
366693,2023-02-25,211,red bull,90,125,35,1,00438,India
383162,2023-02-25,204,strawberry yogurt,50,60,10,1,00439,India
383162,2023-02-25,202,milk,12,27,15,1,00439,India
737054,2023-02-25,208,sprite,75,100,25,1,00440,India
737054,2023-02-25,202,milk,12,27,15,1,00440,India
737054,2023-02-25,210,mountain dew,75,100,25,1,00440,India
416879,2023-02-25,209,pepsi,75,100,25,1,00441,India
223633,2023-02-25,211,red bull,90,125,35,1,00442,India
223633,2023-02-25,209,pepsi,75,100,25,1,00442,India
223633,2023-02-25,202,milk,12,27,15,1,00442,India
537870,2023-02-25,208,sprite,75,100,25,1,00443,India
537870,2023-02-25,204,strawberry yogurt,50,60,10,1,00443,India
687719,2023-02-25,204,strawberry yogurt,50,60,10,1,00444,India
537050,2023-02-25,206,yakult,360,400,40,1,00445,India
176131,2023-02-26,209,pepsi,75,100,25,1,00446,India
176131,2023-02-26,213,bisleri,6,15,9,1,00446,India
278795,2023-02-26,211,red bull,90,125,35,1,00447,India
833583,2023-02-26,212,amul cheese,250,315,65,1,00448,India
219571,2023-02-26,212,amul cheese,250,315,65,1,00449,India
219571,2023-02-26,204,strawberry yogurt,50,60,10,1,00449,India
219571,2023-02-26,203,mango yogurt,50,60,10,1,00449,India
829105,2023-02-26,209,pepsi,75,100,25,1,00450,India
829105,2023-02-26,205,classic yogurt,45,60,15,1,00450,India
829105,2023-02-26,204,strawberry yogurt,50,60,10,1,00450,India
829105,2023-02-26,208,sprite,75,100,25,1,00450,India
344758,2023-02-26,210,mountain dew,75,100,25,1,00451,India
344758,2023-02-26,204,strawberry yogurt,50,60,10,1,00451,India
119097,2023-02-26,201,paneer,210,340,130,1,00452,India
390884,2023-02-26,208,sprite,75,100,25,1,00453,India
390884,2023-02-26,206,yakult,360,400,40,1,00453,India
390884,2023-02-26,201,paneer,210,340,130,1,00453,India
390884,2023-02-26,211,red bull,90,125,35,1,00453,India
390884,2023-02-26,205,classic yogurt,45,60,15,1,00453,India
129384,2023-02-26,210,mountain dew,75,100,25,1,00454,India
129384,2023-02-26,213,bisleri,6,15,9,1,00454,India
129384,2023-02-26,207,coca cola,75,100,25,1,00454,India
952870,2023-02-26,201,paneer,210,340,130,1,00455,India
952870,2023-02-26,213,bisleri,6,15,9,1,00455,India
796022,2023-02-26,206,yakult,360,400,40,1,00456,India
796022,2023-02-26,212,amul cheese,250,315,65,1,00456,India
796022,2023-02-26,209,pepsi,75,100,25,1,00456,India
996426,2023-02-26,211,red bull,90,125,35,1,00457,India
996426,2023-02-26,201,paneer,210,340,130,1,00457,India
511531,2023-02-26,206,yakult,360,400,40,1,00458,India
511531,2023-02-26,202,milk,12,27,15,1,00458,India
511531,2023-02-26,204,strawberry yogurt,50,60,10,1,00458,India
511531,2023-02-26,213,bisleri,6,15,9,1,00458,India
612314,2023-02-26,212,amul cheese,250,315,65,1,00459,India
612314,2023-02-26,203,mango yogurt,50,60,10,1,00459,India
612314,2023-02-26,202,milk,12,27,15,1,00459,India
612314,2023-02-26,211,red bull,90,125,35,1,00459,India
233949,2023-02-26,208,sprite,75,100,25,1,00460,India
233949,2023-02-26,210,mountain dew,75,100,25,1,00460,India
233949,2023-02-26,212,amul cheese,250,315,65,1,00460,India
233949,2023-02-26,209,pepsi,75,100,25,1,00460,India
139496,2023-02-26,205,classic yogurt,45,60,15,1,00461,India
139496,2023-02-26,212,amul cheese,250,315,65,1,00461,India
139496,2023-02-26,210,mountain dew,75,100,25,1,00461,India
139496,2023-02-26,207,coca cola,75,100,25,1,00461,India
139496,2023-02-26,208,sprite,75,100,25,1,00461,India
422702,2023-02-26,203,mango yogurt,50,60,10,1,00462,India
422702,2023-02-26,208,sprite,75,100,25,1,00462,India
422702,2023-02-26,201,paneer,210,340,130,1,00462,India
422702,2023-02-26,210,mountain dew,75,100,25,1,00462,India
662620,2023-02-26,208,sprite,75,100,25,1,00463,India
662620,2023-02-26,204,strawberry yogurt,50,60,10,1,00463,India
662620,2023-02-26,207,coca cola,75,100,25,1,00463,India
662620,2023-02-26,213,bisleri,6,15,9,1,00463,India
662620,2023-02-26,211,red bull,90,125,35,1,00463,India
680678,2023-02-26,204,strawberry yogurt,50,60,10,1,00464,India
680678,2023-02-26,209,pepsi,75,100,25,1,00464,India
680678,2023-02-26,201,paneer,210,340,130,1,00464,India
773595,2023-02-26,203,mango yogurt,50,60,10,1,00465,India
773595,2023-02-26,204,strawberry yogurt,50,60,10,1,00465,India
773595,2023-02-26,201,paneer,210,340,130,1,00465,India
605778,2023-02-26,213,bisleri,6,15,9,1,00466,India
881377,2023-02-26,203,mango yogurt,50,60,10,1,00467,India
881377,2023-02-26,208,sprite,75,100,25,1,00467,India
927244,2023-02-26,212,amul cheese,250,315,65,1,00468,India
927244,2023-02-26,202,milk,12,27,15,1,00468,India
927244,2023-02-26,208,sprite,75,100,25,1,00468,India
927244,2023-02-26,211,red bull,90,125,35,1,00468,India
927244,2023-02-26,205,classic yogurt,45,60,15,1,00468,India
908547,2023-02-26,205,classic yogurt,45,60,15,1,00469,India
908547,2023-02-26,203,mango yogurt,50,60,10,1,00469,India
908547,2023-02-26,201,paneer,210,340,130,1,00469,India
908547,2023-02-26,213,bisleri,6,15,9,1,00469,India
794808,2023-02-26,204,strawberry yogurt,50,60,10,1,00470,India
794808,2023-02-26,207,coca cola,75,100,25,1,00470,India
470028,2023-02-26,203,mango yogurt,50,60,10,1,00471,India
470028,2023-02-26,201,paneer,210,340,130,1,00471,India
470028,2023-02-26,208,sprite,75,100,25,1,00471,India
470028,2023-02-26,211,red bull,90,125,35,1,00471,India
314570,2023-02-26,206,yakult,360,400,40,1,00472,India
743760,2023-02-26,205,classic yogurt,45,60,15,1,00473,India
743760,2023-02-26,210,mountain dew,75,100,25,1,00473,India
743760,2023-02-26,212,amul cheese,250,315,65,1,00473,India
743760,2023-02-26,203,mango yogurt,50,60,10,1,00473,India
263953,2023-02-26,204,strawberry yogurt,50,60,10,1,00474,India
579988,2023-02-26,209,pepsi,75,100,25,1,00475,India
579988,2023-02-26,204,strawberry yogurt,50,60,10,1,00475,India
579988,2023-02-26,206,yakult,360,400,40,1,00475,India
232319,2023-02-26,211,red bull,90,125,35,1,00476,India
232319,2023-02-26,207,coca cola,75,100,25,1,00476,India
232319,2023-02-26,209,pepsi,75,100,25,1,00476,India
232319,2023-02-26,204,strawberry yogurt,50,60,10,1,00476,India
281993,2023-02-26,201,paneer,210,340,130,1,00477,India
281993,2023-02-26,204,strawberry yogurt,50,60,10,1,00477,India
281993,2023-02-26,210,mountain dew,75,100,25,1,00477,India
283030,2023-02-26,208,sprite,75,100,25,1,00478,India
283030,2023-02-26,206,yakult,360,400,40,1,00478,India
283030,2023-02-26,204,strawberry yogurt,50,60,10,1,00478,India
283030,2023-02-26,212,amul cheese,250,315,65,1,00478,India
861736,2023-02-26,213,bisleri,6,15,9,1,00479,India
861736,2023-02-26,205,classic yogurt,45,60,15,1,00479,India
861736,2023-02-26,206,yakult,360,400,40,1,00479,India
861736,2023-02-26,203,mango yogurt,50,60,10,1,00479,India
861736,2023-02-26,212,amul cheese,250,315,65,1,00479,India
784673,2023-02-26,207,coca cola,75,100,25,1,00480,India
784673,2023-02-26,211,red bull,90,125,35,1,00480,India
784673,2023-02-26,213,bisleri,6,15,9,1,00480,India
784673,2023-02-26,201,paneer,210,340,130,1,00480,India
871305,2023-02-26,202,milk,12,27,15,1,00481,India
871305,2023-02-26,213,bisleri,6,15,9,1,00481,India
871305,2023-02-26,211,red bull,90,125,35,1,00481,India
871305,2023-02-26,204,strawberry yogurt,50,60,10,1,00481,India
787174,2023-02-26,203,mango yogurt,50,60,10,1,00482,India
787174,2023-02-26,208,sprite,75,100,25,1,00482,India
787174,2023-02-26,209,pepsi,75,100,25,1,00482,India
649120,2023-02-26,209,pepsi,75,100,25,1,00483,India
649120,2023-02-26,203,mango yogurt,50,60,10,1,00483,India
649120,2023-02-26,207,coca cola,75,100,25,1,00483,India
873237,2023-02-26,205,classic yogurt,45,60,15,1,00484,India
873237,2023-02-26,208,sprite,75,100,25,1,00484,India
965910,2023-02-26,211,red bull,90,125,35,1,00485,India
965910,2023-02-26,206,yakult,360,400,40,1,00485,India
831747,2023-02-26,202,milk,12,27,15,1,00486,India
831747,2023-02-26,206,yakult,360,400,40,1,00486,India
831747,2023-02-26,211,red bull,90,125,35,1,00486,India
831747,2023-02-26,207,coca cola,75,100,25,1,00486,India
188128,2023-02-26,212,amul cheese,250,315,65,1,00487,India
188128,2023-02-26,208,sprite,75,100,25,1,00487,India
188128,2023-02-26,207,coca cola,75,100,25,1,00487,India
164228,2023-02-26,213,bisleri,6,15,9,1,00488,India
164228,2023-02-26,209,pepsi,75,100,25,1,00488,India
164228,2023-02-26,206,yakult,360,400,40,1,00488,India
164228,2023-02-26,205,classic yogurt,45,60,15,1,00488,India
162386,2023-02-26,211,red bull,90,125,35,1,00489,India
162386,2023-02-26,209,pepsi,75,100,25,1,00489,India
385604,2023-02-26,207,coca cola,75,100,25,1,00490,India
385604,2023-02-26,210,mountain dew,75,100,25,1,00490,India
385604,2023-02-26,211,red bull,90,125,35,1,00490,India
385604,2023-02-26,206,yakult,360,400,40,1,00490,India
200229,2023-02-26,201,paneer,210,340,130,1,00491,India
843087,2023-02-26,205,classic yogurt,45,60,15,1,00492,India
843087,2023-02-26,210,mountain dew,75,100,25,1,00492,India
843087,2023-02-26,213,bisleri,6,15,9,1,00492,India
562730,2023-02-26,210,mountain dew,75,100,25,1,00493,India
562730,2023-02-26,209,pepsi,75,100,25,1,00493,India
562730,2023-02-26,203,mango yogurt,50,60,10,1,00493,India
562730,2023-02-26,208,sprite,75,100,25,1,00493,India
194112,2023-02-26,205,classic yogurt,45,60,15,1,00494,India
194112,2023-02-26,201,paneer,210,340,130,1,00494,India
194112,2023-02-26,213,bisleri,6,15,9,1,00494,India
288192,2023-02-26,206,yakult,360,400,40,1,00495,India
288192,2023-02-26,210,mountain dew,75,100,25,1,00495,India
741430,2023-02-26,213,bisleri,6,15,9,1,00496,India
741430,2023-02-26,204,strawberry yogurt,50,60,10,1,00496,India
297976,2023-02-26,204,strawberry yogurt,50,60,10,1,00497,India
297976,2023-02-26,208,sprite,75,100,25,1,00497,India
567373,2023-02-26,201,paneer,210,340,130,1,00498,India
567373,2023-02-26,211,red bull,90,125,35,1,00498,India
567373,2023-02-26,212,amul cheese,250,315,65,1,00498,India
680607,2023-02-27,206,yakult,360,400,40,1,00499,India
680607,2023-02-27,202,milk,12,27,15,1,00499,India
461083,2023-02-27,202,milk,12,27,15,1,00500,India
461083,2023-02-27,210,mountain dew,75,100,25,1,00500,India
461083,2023-02-27,205,classic yogurt,45,60,15,1,00500,India
461083,2023-02-27,201,paneer,210,340,130,1,00500,India
461083,2023-02-27,204,strawberry yogurt,50,60,10,1,00500,India
754386,2023-02-27,211,red bull,90,125,35,1,00388,India
754386,2023-02-27,212,amul cheese,250,315,65,1,00388,India
754386,2023-02-27,205,classic yogurt,45,60,15,1,00388,India
838718,2023-02-27,202,milk,12,27,15,1,00056,India
947852,2023-02-27,206,yakult,360,400,40,1,00359,India
597262,2023-02-27,208,sprite,75,100,25,1,00037,India
617812,2023-02-27,212,amul cheese,250,315,65,1,00149,India
617812,2023-02-27,210,mountain dew,75,100,25,1,00149,India
617812,2023-02-27,201,paneer,210,340,130,1,00149,India
617812,2023-02-27,205,classic yogurt,45,60,15,1,00149,India
617812,2023-02-27,208,sprite,75,100,25,1,00149,India
196198,2023-02-27,203,mango yogurt,50,60,10,1,00312,India
619404,2023-02-27,207,coca cola,75,100,25,1,00220,India
619404,2023-02-27,212,amul cheese,250,315,65,1,00220,India
619404,2023-02-27,206,yakult,360,400,40,1,00220,India
619404,2023-02-27,209,pepsi,75,100,25,1,00220,India
619404,2023-02-27,202,milk,12,27,15,1,00220,India
833358,2023-02-27,211,red bull,90,125,35,1,00353,India
833358,2023-02-27,210,mountain dew,75,100,25,1,00353,India
853219,2023-02-27,204,strawberry yogurt,50,60,10,1,00158,India
853219,2023-02-27,209,pepsi,75,100,25,1,00158,India
226800,2023-02-27,202,milk,12,27,15,1,00291,India
161658,2023-02-27,209,pepsi,75,100,25,1,00296,India
587304,2023-02-27,210,mountain dew,75,100,25,1,00153,India
587304,2023-02-27,208,sprite,75,100,25,1,00153,India
587304,2023-02-27,205,classic yogurt,45,60,15,1,00153,India
240451,2023-02-27,208,sprite,75,100,25,1,00408,India
240451,2023-02-27,203,mango yogurt,50,60,10,1,00408,India
240451,2023-02-27,201,paneer,210,340,130,1,00408,India
240451,2023-02-27,213,bisleri,6,15,9,1,00408,India
615591,2023-02-27,201,paneer,210,340,130,1,00382,India
615591,2023-02-27,208,sprite,75,100,25,1,00382,India
615591,2023-02-27,206,yakult,360,400,40,1,00382,India
615591,2023-02-27,202,milk,12,27,15,1,00382,India
366886,2023-02-27,211,red bull,90,125,35,1,00019,India
369500,2023-02-27,210,mountain dew,75,100,25,1,00400,India
369500,2023-02-27,203,mango yogurt,50,60,10,1,00400,India
369500,2023-02-27,202,milk,12,27,15,1,00400,India
605676,2023-02-27,209,pepsi,75,100,25,1,00435,India
605676,2023-02-27,211,red bull,90,125,35,1,00435,India
605676,2023-02-27,204,strawberry yogurt,50,60,10,1,00435,India
605676,2023-02-27,206,yakult,360,400,40,1,00435,India
605676,2023-02-27,207,coca cola,75,100,25,1,00435,India
570164,2023-02-27,210,mountain dew,75,100,25,1,00066,India
884835,2023-02-27,208,sprite,75,100,25,1,00276,India
120591,2023-02-27,212,amul cheese,250,315,65,1,00404,India
120591,2023-02-27,209,pepsi,75,100,25,1,00404,India
120591,2023-02-27,210,mountain dew,75,100,25,1,00404,India
120591,2023-02-27,207,coca cola,75,100,25,1,00404,India
596890,2023-02-27,211,red bull,90,125,35,1,00265,India
596890,2023-02-27,210,mountain dew,75,100,25,1,00265,India
745812,2023-02-27,210,mountain dew,75,100,25,1,00429,India
745812,2023-02-27,203,mango yogurt,50,60,10,1,00429,India
393391,2023-02-27,212,amul cheese,250,315,65,1,00017,India
393391,2023-02-27,211,red bull,90,125,35,1,00017,India
393391,2023-02-27,209,pepsi,75,100,25,1,00017,India
628020,2023-02-27,210,mountain dew,75,100,25,1,00291,India
144594,2023-02-27,206,yakult,360,400,40,1,00042,India
144594,2023-02-27,201,paneer,210,340,130,1,00042,India
144594,2023-02-27,211,red bull,90,125,35,1,00042,India
225863,2023-02-27,206,yakult,360,400,40,1,00117,India
615573,2023-02-27,208,sprite,75,100,25,1,00336,India
730290,2023-02-27,212,amul cheese,250,315,65,1,00337,India
730290,2023-02-27,202,milk,12,27,15,1,00337,India
463709,2023-02-27,208,sprite,75,100,25,1,00010,India
463709,2023-02-27,207,coca cola,75,100,25,1,00010,India
463709,2023-02-27,204,strawberry yogurt,50,60,10,1,00010,India
856911,2023-02-27,213,bisleri,6,15,9,1,00329,India
856911,2023-02-27,211,red bull,90,125,35,1,00329,India
926774,2023-02-27,202,milk,12,27,15,1,00440,India
926774,2023-02-27,201,paneer,210,340,130,1,00440,India
926774,2023-02-27,203,mango yogurt,50,60,10,1,00440,India
663664,2023-02-27,210,mountain dew,75,100,25,1,00111,India
663664,2023-02-27,203,mango yogurt,50,60,10,1,00111,India
593817,2023-02-27,207,coca cola,75,100,25,1,00429,India
593817,2023-02-27,212,amul cheese,250,315,65,1,00429,India
571500,2023-02-27,204,strawberry yogurt,50,60,10,1,00027,India
571500,2023-02-27,213,bisleri,6,15,9,1,00027,India
571500,2023-02-27,205,classic yogurt,45,60,15,1,00027,India
571500,2023-02-27,212,amul cheese,250,315,65,1,00027,India
188313,2023-02-27,211,red bull,90,125,35,1,00386,India
188313,2023-02-27,206,yakult,360,400,40,1,00386,India
188313,2023-02-27,205,classic yogurt,45,60,15,1,00386,India
885458,2023-02-27,210,mountain dew,75,100,25,1,00023,India
885458,2023-02-27,205,classic yogurt,45,60,15,1,00023,India
885458,2023-02-27,213,bisleri,6,15,9,1,00023,India
885458,2023-02-27,206,yakult,360,400,40,1,00023,India
885458,2023-02-27,201,paneer,210,340,130,1,00023,India
942511,2023-02-27,201,paneer,210,340,130,1,00165,India
942511,2023-02-27,213,bisleri,6,15,9,1,00165,India
883835,2023-02-27,210,mountain dew,75,100,25,1,00269,India
883835,2023-02-27,206,yakult,360,400,40,1,00269,India
658000,2023-02-27,206,yakult,360,400,40,1,00318,India
658000,2023-02-27,201,paneer,210,340,130,1,00318,India
386666,2023-02-27,208,sprite,75,100,25,1,00265,India
386666,2023-02-27,209,pepsi,75,100,25,1,00265,India
386666,2023-02-27,205,classic yogurt,45,60,15,1,00265,India
386666,2023-02-27,203,mango yogurt,50,60,10,1,00265,India
386666,2023-02-27,201,paneer,210,340,130,1,00265,India
588290,2023-02-27,204,strawberry yogurt,50,60,10,1,00088,India
588290,2023-02-27,203,mango yogurt,50,60,10,1,00088,India
788326,2023-02-27,210,mountain dew,75,100,25,1,00338,India
870280,2023-02-27,207,coca cola,75,100,25,1,00488,India
870280,2023-02-27,213,bisleri,6,15,9,1,00488,India
870280,2023-02-27,209,pepsi,75,100,25,1,00488,India
870280,2023-02-27,205,classic yogurt,45,60,15,1,00488,India
870280,2023-02-27,210,mountain dew,75,100,25,1,00488,India
624765,2023-02-27,201,paneer,210,340,130,1,00309,India
624765,2023-02-27,209,pepsi,75,100,25,1,00309,India
624765,2023-02-27,212,amul cheese,250,315,65,1,00309,India
624765,2023-02-27,213,bisleri,6,15,9,1,00309,India
357075,2023-02-27,205,classic yogurt,45,60,15,1,00141,India
357075,2023-02-27,201,paneer,210,340,130,1,00141,India
357075,2023-02-27,202,milk,12,27,15,1,00141,India
357075,2023-02-27,211,red bull,90,125,35,1,00141,India
200875,2023-02-27,208,sprite,75,100,25,1,00143,India
200875,2023-02-27,206,yakult,360,400,40,1,00143,India
609549,2023-02-27,204,strawberry yogurt,50,60,10,1,00449,India
609549,2023-02-27,208,sprite,75,100,25,1,00449,India
455406,2023-02-27,204,strawberry yogurt,50,60,10,1,00465,India
126669,2023-02-27,203,mango yogurt,50,60,10,1,00266,India
126669,2023-02-27,210,mountain dew,75,100,25,1,00266,India
711244,2023-02-27,201,paneer,210,340,130,1,00108,India
711244,2023-02-27,209,pepsi,75,100,25,1,00108,India
711244,2023-02-27,204,strawberry yogurt,50,60,10,1,00108,India
711244,2023-02-27,207,coca cola,75,100,25,1,00108,India
643265,2023-02-27,212,amul cheese,250,315,65,1,00260,India
643265,2023-02-27,209,pepsi,75,100,25,1,00260,India
650785,2023-02-27,211,red bull,90,125,35,1,00232,India
650785,2023-02-27,208,sprite,75,100,25,1,00232,India
650785,2023-02-27,207,coca cola,75,100,25,1,00232,India
650785,2023-02-27,210,mountain dew,75,100,25,1,00232,India
156688,2023-02-27,202,milk,12,27,15,1,00216,India
156688,2023-02-27,206,yakult,360,400,40,1,00216,India
156688,2023-02-27,204,strawberry yogurt,50,60,10,1,00216,India
285763,2023-02-27,211,red bull,90,125,35,1,00079,India
285763,2023-02-27,205,classic yogurt,45,60,15,1,00079,India
285763,2023-02-27,202,milk,12,27,15,1,00079,India
294242,2023-02-27,201,paneer,210,340,130,1,00409,India
882397,2023-02-27,201,paneer,210,340,130,1,00375,India
882397,2023-02-27,203,mango yogurt,50,60,10,1,00375,India
882397,2023-02-27,213,bisleri,6,15,9,1,00375,India
882397,2023-02-27,209,pepsi,75,100,25,1,00375,India
201745,2023-02-27,208,sprite,75,100,25,1,00051,India
201745,2023-02-27,203,mango yogurt,50,60,10,1,00051,India
201745,2023-02-27,213,bisleri,6,15,9,1,00051,India
189071,2023-02-27,208,sprite,75,100,25,1,00454,India
189071,2023-02-27,211,red bull,90,125,35,1,00454,India
189071,2023-02-27,213,bisleri,6,15,9,1,00454,India
189071,2023-02-27,207,coca cola,75,100,25,1,00454,India
374971,2023-02-27,206,yakult,360,400,40,1,00005,India
799116,2023-02-27,204,strawberry yogurt,50,60,10,1,00275,India
799116,2023-02-27,210,mountain dew,75,100,25,1,00275,India
799116,2023-02-27,211,red bull,90,125,35,1,00275,India
194485,2023-02-27,208,sprite,75,100,25,1,00395,India
194485,2023-02-27,209,pepsi,75,100,25,1,00395,India
927955,2023-02-27,210,mountain dew,75,100,25,1,00011,India
632534,2023-02-27,207,coca cola,75,100,25,1,00405,India
632534,2023-02-27,206,yakult,360,400,40,1,00405,India
632534,2023-02-27,205,classic yogurt,45,60,15,1,00405,India
387570,2023-02-27,208,sprite,75,100,25,1,00268,India
387570,2023-02-27,207,coca cola,75,100,25,1,00268,India
387570,2023-02-27,210,mountain dew,75,100,25,1,00268,India
387570,2023-02-27,201,paneer,210,340,130,1,00268,India
387570,2023-02-27,204,strawberry yogurt,50,60,10,1,00268,India
888302,2023-02-27,203,mango yogurt,50,60,10,1,00371,India
888302,2023-02-27,201,paneer,210,340,130,1,00371,India
888302,2023-02-27,208,sprite,75,100,25,1,00371,India
794773,2023-02-27,204,strawberry yogurt,50,60,10,1,00132,India
794773,2023-02-27,205,classic yogurt,45,60,15,1,00132,India
794773,2023-02-27,213,bisleri,6,15,9,1,00132,India
582077,2023-02-27,210,mountain dew,75,100,25,1,00470,India
582077,2023-02-27,207,coca cola,75,100,25,1,00470,India
582077,2023-02-27,204,strawberry yogurt,50,60,10,1,00470,India
582077,2023-02-27,212,amul cheese,250,315,65,1,00470,India
163169,2023-02-27,205,classic yogurt,45,60,15,1,00397,India
163169,2023-02-27,207,coca cola,75,100,25,1,00397,India
163169,2023-02-27,203,mango yogurt,50,60,10,1,00397,India
163169,2023-02-27,208,sprite,75,100,25,1,00397,India
745828,2023-02-27,202,milk,12,27,15,1,00332,India
745828,2023-02-27,201,paneer,210,340,130,1,00332,India
745828,2023-02-27,211,red bull,90,125,35,1,00332,India
775753,2023-02-27,210,mountain dew,75,100,25,1,00264,India
775753,2023-02-27,204,strawberry yogurt,50,60,10,1,00264,India
775753,2023-02-27,206,yakult,360,400,40,1,00264,India
775753,2023-02-27,213,bisleri,6,15,9,1,00264,India
261883,2023-02-27,207,coca cola,75,100,25,1,00252,India
261883,2023-02-27,206,yakult,360,400,40,1,00252,India
385592,2023-02-27,210,mountain dew,75,100,25,1,00212,India
900803,2023-02-27,211,red bull,90,125,35,1,00426,India
382637,2023-02-27,213,bisleri,6,15,9,1,00115,India
218869,2023-02-27,207,coca cola,75,100,25,1,00102,India
218869,2023-02-27,211,red bull,90,125,35,1,00102,India
218869,2023-02-27,205,classic yogurt,45,60,15,1,00102,India
919214,2023-02-27,201,paneer,210,340,130,1,00207,India
919214,2023-02-27,208,sprite,75,100,25,1,00207,India
919214,2023-02-27,209,pepsi,75,100,25,1,00207,India
919214,2023-02-27,202,milk,12,27,15,1,00207,India
997999,2023-02-27,206,yakult,360,400,40,1,00124,India
997999,2023-02-27,205,classic yogurt,45,60,15,1,00124,India
997999,2023-02-27,201,paneer,210,340,130,1,00124,India
713314,2023-02-27,207,coca cola,75,100,25,1,00304,India
274539,2023-02-27,205,classic yogurt,45,60,15,1,00499,India
274539,2023-02-27,212,amul cheese,250,315,65,1,00499,India
274539,2023-02-27,206,yakult,360,400,40,1,00499,India
939809,2023-02-27,209,pepsi,75,100,25,1,00281,India
939809,2023-02-27,207,coca cola,75,100,25,1,00281,India
939809,2023-02-27,206,yakult,360,400,40,1,00281,India
939809,2023-02-27,210,mountain dew,75,100,25,1,00281,India
175913,2023-02-27,206,yakult,360,400,40,1,00100,India
175913,2023-02-27,210,mountain dew,75,100,25,1,00100,India
175913,2023-02-27,211,red bull,90,125,35,1,00100,India
175913,2023-02-27,204,strawberry yogurt,50,60,10,1,00100,India
121667,2023-02-27,203,mango yogurt,50,60,10,1,00358,India
121667,2023-02-27,201,paneer,210,340,130,1,00358,India
846036,2023-02-27,205,classic yogurt,45,60,15,1,00129,India
846036,2023-02-27,204,strawberry yogurt,50,60,10,1,00129,India
697798,2023-02-27,210,mountain dew,75,100,25,1,00206,India
697798,2023-02-27,206,yakult,360,400,40,1,00206,India
273249,2023-02-27,203,mango yogurt,50,60,10,1,00177,India
300926,2023-02-27,202,milk,12,27,15,1,00449,India
300926,2023-02-27,211,red bull,90,125,35,1,00449,India
300926,2023-02-27,207,coca cola,75,100,25,1,00449,India
300926,2023-02-27,201,paneer,210,340,130,1,00449,India
585521,2023-02-27,213,bisleri,6,15,9,1,00303,India
585521,2023-02-27,202,milk,12,27,15,1,00303,India
585521,2023-02-27,203,mango yogurt,50,60,10,1,00303,India
585521,2023-02-27,207,coca cola,75,100,25,1,00303,India
704821,2023-02-27,210,mountain dew,75,100,25,1,00145,India
704821,2023-02-27,201,paneer,210,340,130,1,00145,India
704821,2023-02-27,212,amul cheese,250,315,65,1,00145,India
181310,2023-02-27,203,mango yogurt,50,60,10,1,00498,India
181310,2023-02-27,205,classic yogurt,45,60,15,1,00498,India
405334,2023-02-27,204,strawberry yogurt,50,60,10,1,00245,India
405334,2023-02-27,201,paneer,210,340,130,1,00245,India
405334,2023-02-27,203,mango yogurt,50,60,10,1,00245,India
405334,2023-02-27,208,sprite,75,100,25,1,00245,India
203489,2023-02-27,211,red bull,90,125,35,1,00330,India
203489,2023-02-27,210,mountain dew,75,100,25,1,00330,India
203489,2023-02-27,213,bisleri,6,15,9,1,00330,India
665204,2023-02-28,209,pepsi,75,100,25,1,00423,India
665204,2023-02-28,201,paneer,210,340,130,1,00423,India
665204,2023-02-28,208,sprite,75,100,25,1,00423,India
645645,2023-02-28,206,yakult,360,400,40,1,00382,India
645645,2023-02-28,202,milk,12,27,15,1,00382,India
645645,2023-02-28,211,red bull,90,125,35,1,00382,India
507040,2023-02-28,212,amul cheese,250,315,65,1,00061,India
507040,2023-02-28,201,paneer,210,340,130,1,00061,India
944355,2023-02-28,204,strawberry yogurt,50,60,10,1,00149,India
944355,2023-02-28,206,yakult,360,400,40,1,00149,India
142008,2023-02-28,208,sprite,75,100,25,1,00449,India
142008,2023-02-28,210,mountain dew,75,100,25,1,00449,India
142008,2023-02-28,201,paneer,210,340,130,1,00449,India
142008,2023-02-28,203,mango yogurt,50,60,10,1,00449,India
213757,2023-02-28,212,amul cheese,250,315,65,1,00389,India
129049,2023-02-28,209,pepsi,75,100,25,1,00469,India
129049,2023-02-28,210,mountain dew,75,100,25,1,00469,India
653484,2023-02-28,206,yakult,360,400,40,1,00302,India
653484,2023-02-28,203,mango yogurt,50,60,10,1,00302,India
653484,2023-02-28,202,milk,12,27,15,1,00302,India
653484,2023-02-28,205,classic yogurt,45,60,15,1,00302,India
679341,2023-02-28,207,coca cola,75,100,25,1,00267,India
679341,2023-02-28,212,amul cheese,250,315,65,1,00267,India
679341,2023-02-28,208,sprite,75,100,25,1,00267,India
679341,2023-02-28,211,red bull,90,125,35,1,00267,India
295566,2023-02-28,205,classic yogurt,45,60,15,1,00414,India
295566,2023-02-28,209,pepsi,75,100,25,1,00414,India
650861,2023-02-28,210,mountain dew,75,100,25,1,00080,India
650861,2023-02-28,201,paneer,210,340,130,1,00080,India
650861,2023-02-28,206,yakult,360,400,40,1,00080,India
650861,2023-02-28,207,coca cola,75,100,25,1,00080,India
999529,2023-02-28,201,paneer,210,340,130,1,00380,India
999529,2023-02-28,202,milk,12,27,15,1,00380,India
605756,2023-02-28,213,bisleri,6,15,9,1,00499,India
477436,2023-02-28,207,coca cola,75,100,25,1,00490,India
477436,2023-02-28,208,sprite,75,100,25,1,00490,India
477436,2023-02-28,205,classic yogurt,45,60,15,1,00490,India
477436,2023-02-28,212,amul cheese,250,315,65,1,00490,India
743675,2023-02-28,212,amul cheese,250,315,65,1,00042,India
171998,2023-02-28,207,coca cola,75,100,25,1,00220,India
171998,2023-02-28,206,yakult,360,400,40,1,00220,India
171998,2023-02-28,212,amul cheese,250,315,65,1,00220,India
171998,2023-02-28,213,bisleri,6,15,9,1,00220,India
227327,2023-02-28,207,coca cola,75,100,25,1,00162,India
227327,2023-02-28,208,sprite,75,100,25,1,00162,India
227327,2023-02-28,210,mountain dew,75,100,25,1,00162,India
262519,2023-02-28,210,mountain dew,75,100,25,1,00019,India
262519,2023-02-28,211,red bull,90,125,35,1,00019,India
621523,2023-02-28,201,paneer,210,340,130,1,00229,India
621523,2023-02-28,211,red bull,90,125,35,1,00229,India
621523,2023-02-28,207,coca cola,75,100,25,1,00229,India
621523,2023-02-28,204,strawberry yogurt,50,60,10,1,00229,India
621523,2023-02-28,203,mango yogurt,50,60,10,1,00229,India
325029,2023-02-28,201,paneer,210,340,130,1,00341,India
325029,2023-02-28,209,pepsi,75,100,25,1,00341,India
325029,2023-02-28,205,classic yogurt,45,60,15,1,00341,India
627121,2023-02-28,205,classic yogurt,45,60,15,1,00248,India
627121,2023-02-28,212,amul cheese,250,315,65,1,00248,India
627121,2023-02-28,211,red bull,90,125,35,1,00248,India
627121,2023-02-28,207,coca cola,75,100,25,1,00248,India
258340,2023-02-28,201,paneer,210,340,130,1,00360,India
258340,2023-02-28,208,sprite,75,100,25,1,00360,India
258340,2023-02-28,211,red bull,90,125,35,1,00360,India
286672,2023-02-28,205,classic yogurt,45,60,15,1,00003,India
286672,2023-02-28,209,pepsi,75,100,25,1,00003,India
286672,2023-02-28,207,coca cola,75,100,25,1,00003,India
324725,2023-02-28,209,pepsi,75,100,25,1,00120,India
224372,2023-02-28,208,sprite,75,100,25,1,00396,India
224372,2023-02-28,206,yakult,360,400,40,1,00396,India
224372,2023-02-28,201,paneer,210,340,130,1,00396,India
153570,2023-02-28,213,bisleri,6,15,9,1,00389,India
570786,2023-02-28,209,pepsi,75,100,25,1,00135,India
974551,2023-02-28,205,classic yogurt,45,60,15,1,00270,India
434275,2023-02-28,206,yakult,360,400,40,1,00178,India
434275,2023-02-28,209,pepsi,75,100,25,1,00178,India
546296,2023-02-28,209,pepsi,75,100,25,1,00420,India
546296,2023-02-28,207,coca cola,75,100,25,1,00420,India
992433,2023-02-28,213,bisleri,6,15,9,1,00294,India
215876,2023-02-28,211,red bull,90,125,35,1,00324,India
215876,2023-02-28,203,mango yogurt,50,60,10,1,00324,India
215876,2023-02-28,204,strawberry yogurt,50,60,10,1,00324,India
215876,2023-02-28,210,mountain dew,75,100,25,1,00324,India
836267,2023-02-28,208,sprite,75,100,25,1,00155,India
836267,2023-02-28,212,amul cheese,250,315,65,1,00155,India
836267,2023-02-28,203,mango yogurt,50,60,10,1,00155,India
117500,2023-02-28,201,paneer,210,340,130,1,00403,India
117500,2023-02-28,203,mango yogurt,50,60,10,1,00403,India
117500,2023-02-28,208,sprite,75,100,25,1,00403,India
117500,2023-02-28,206,yakult,360,400,40,1,00403,India
258504,2023-02-28,209,pepsi,75,100,25,1,00125,India
256700,2023-02-28,209,pepsi,75,100,25,1,00286,India
256700,2023-02-28,212,amul cheese,250,315,65,1,00286,India
256700,2023-02-28,202,milk,12,27,15,1,00286,India
425300,2023-02-28,202,milk,12,27,15,1,00178,India
425300,2023-02-28,207,coca cola,75,100,25,1,00178,India
988168,2023-02-28,201,paneer,210,340,130,1,00158,India
988168,2023-02-28,211,red bull,90,125,35,1,00158,India
988168,2023-02-28,210,mountain dew,75,100,25,1,00158,India
614263,2023-02-28,208,sprite,75,100,25,1,00188,India
614263,2023-02-28,202,milk,12,27,15,1,00188,India
693950,2023-02-28,208,sprite,75,100,25,1,00475,India
659105,2023-02-28,213,bisleri,6,15,9,1,00190,India
644869,2023-02-28,204,strawberry yogurt,50,60,10,1,00172,India
644869,2023-02-28,210,mountain dew,75,100,25,1,00172,India
644869,2023-02-28,201,paneer,210,340,130,1,00172,India
644869,2023-02-28,202,milk,12,27,15,1,00172,India
897234,2023-02-28,208,sprite,75,100,25,1,00473,India
897234,2023-02-28,213,bisleri,6,15,9,1,00473,India
897234,2023-02-28,203,mango yogurt,50,60,10,1,00473,India
924849,2023-02-28,209,pepsi,75,100,25,1,00290,India
924849,2023-02-28,203,mango yogurt,50,60,10,1,00290,India
904184,2023-02-28,210,mountain dew,75,100,25,1,00308,India
235906,2023-02-28,210,mountain dew,75,100,25,1,00173,India
235906,2023-02-28,202,milk,12,27,15,1,00173,India
235906,2023-02-28,203,mango yogurt,50,60,10,1,00173,India
235906,2023-02-28,206,yakult,360,400,40,1,00173,India
786691,2023-02-28,205,classic yogurt,45,60,15,1,00177,India
786691,2023-02-28,203,mango yogurt,50,60,10,1,00177,India
650582,2023-02-28,204,strawberry yogurt,50,60,10,1,00258,India
650582,2023-02-28,210,mountain dew,75,100,25,1,00258,India
650582,2023-02-28,206,yakult,360,400,40,1,00258,India
898079,2023-02-28,206,yakult,360,400,40,1,00248,India
898079,2023-02-28,212,amul cheese,250,315,65,1,00248,India
974866,2023-02-28,212,amul cheese,250,315,65,1,00340,India
181040,2023-02-28,213,bisleri,6,15,9,1,00310,India
181040,2023-02-28,208,sprite,75,100,25,1,00310,India
181040,2023-02-28,205,classic yogurt,45,60,15,1,00310,India
949045,2023-02-28,202,milk,12,27,15,1,00246,India
949045,2023-02-28,213,bisleri,6,15,9,1,00246,India
949045,2023-02-28,209,pepsi,75,100,25,1,00246,India
888197,2023-02-28,213,bisleri,6,15,9,1,00144,India
888197,2023-02-28,202,milk,12,27,15,1,00144,India
888197,2023-02-28,208,sprite,75,100,25,1,00144,India
434597,2023-02-28,201,paneer,210,340,130,1,00176,India
434597,2023-02-28,205,classic yogurt,45,60,15,1,00176,India
488999,2023-02-28,207,coca cola,75,100,25,1,00496,India
691296,2023-02-28,210,mountain dew,75,100,25,1,00318,India
691296,2023-02-28,213,bisleri,6,15,9,1,00318,India
691296,2023-02-28,212,amul cheese,250,315,65,1,00318,India
691296,2023-02-28,206,yakult,360,400,40,1,00318,India
661822,2023-02-28,201,paneer,210,340,130,1,00044,India
877996,2023-02-28,204,strawberry yogurt,50,60,10,1,00046,India
877996,2023-02-28,209,pepsi,75,100,25,1,00046,India
877996,2023-02-28,201,paneer,210,340,130,1,00046,India
602976,2023-02-28,201,paneer,210,340,130,1,00015,India
602976,2023-02-28,204,strawberry yogurt,50,60,10,1,00015,India
274543,2023-02-28,211,red bull,90,125,35,1,00144,India
274543,2023-02-28,201,paneer,210,340,130,1,00144,India
274543,2023-02-28,212,amul cheese,250,315,65,1,00144,India
598322,2023-02-28,205,classic yogurt,45,60,15,1,00207,India
598322,2023-02-28,208,sprite,75,100,25,1,00207,India
328940,2023-02-28,202,milk,12,27,15,1,00325,India
328940,2023-02-28,211,red bull,90,125,35,1,00325,India
328940,2023-02-28,213,bisleri,6,15,9,1,00325,India
328940,2023-02-28,205,classic yogurt,45,60,15,1,00325,India
328940,2023-02-28,207,coca cola,75,100,25,1,00325,India
747536,2023-02-28,211,red bull,90,125,35,1,00187,India
650155,2023-02-28,210,mountain dew,75,100,25,1,00295,India
240613,2023-02-28,205,classic yogurt,45,60,15,1,00236,India
348344,2023-02-28,210,mountain dew,75,100,25,1,00242,India
348344,2023-02-28,205,classic yogurt,45,60,15,1,00242,India
348344,2023-02-28,213,bisleri,6,15,9,1,00242,India
768533,2023-02-28,208,sprite,75,100,25,1,00416,India
558207,2023-02-28,213,bisleri,6,15,9,1,00171,India
558207,2023-02-28,204,strawberry yogurt,50,60,10,1,00171,India
351944,2023-02-28,207,coca cola,75,100,25,1,00152,India
351944,2023-02-28,204,strawberry yogurt,50,60,10,1,00152,India
351944,2023-02-28,205,classic yogurt,45,60,15,1,00152,India
291059,2023-02-28,208,sprite,75,100,25,1,00355,India
291059,2023-02-28,202,milk,12,27,15,1,00355,India
840338,2023-02-28,205,classic yogurt,45,60,15,1,00288,India
840338,2023-02-28,204,strawberry yogurt,50,60,10,1,00288,India
118934,2023-02-28,201,paneer,210,340,130,1,00272,India
118934,2023-02-28,208,sprite,75,100,25,1,00272,India
263406,2023-02-28,209,pepsi,75,100,25,1,00067,India
263406,2023-02-28,213,bisleri,6,15,9,1,00067,India
263406,2023-02-28,207,coca cola,75,100,25,1,00067,India
263406,2023-02-28,211,red bull,90,125,35,1,00067,India
440472,2023-02-28,213,bisleri,6,15,9,1,00197,India
440472,2023-02-28,210,mountain dew,75,100,25,1,00197,India
440472,2023-02-28,212,amul cheese,250,315,65,1,00197,India
440472,2023-02-28,208,sprite,75,100,25,1,00197,India
352964,2023-02-28,213,bisleri,6,15,9,1,00441,India
352964,2023-02-28,212,amul cheese,250,315,65,1,00441,India
352964,2023-02-28,210,mountain dew,75,100,25,1,00441,India
937404,2023-02-28,201,paneer,210,340,130,1,00461,India
937404,2023-02-28,213,bisleri,6,15,9,1,00461,India
937404,2023-02-28,204,strawberry yogurt,50,60,10,1,00461,India
937404,2023-02-28,209,pepsi,75,100,25,1,00461,India
911437,2023-03-01,213,bisleri,6,15,9,2,00324,India
911437,2023-03-01,207,coca cola,75,100,25,2,00324,India
900352,2023-03-01,208,sprite,75,100,25,2,00378,India
203707,2023-03-01,205,classic yogurt,45,60,15,2,00125,India
203707,2023-03-01,201,paneer,210,340,130,1,00125,India
203707,2023-03-01,203,mango yogurt,50,60,10,2,00125,India
203707,2023-03-01,204,strawberry yogurt,50,60,10,2,00125,India
439915,2023-03-01,210,mountain dew,75,100,25,2,00290,India
439915,2023-03-01,211,red bull,90,125,35,2,00290,India
439915,2023-03-01,205,classic yogurt,45,60,15,2,00290,India
928331,2023-03-01,210,mountain dew,75,100,25,2,00312,India
928331,2023-03-01,207,coca cola,75,100,25,2,00312,India
396729,2023-03-01,209,pepsi,75,100,25,2,00017,India
396729,2023-03-01,210,mountain dew,75,100,25,2,00017,India
341789,2023-03-01,201,paneer,210,340,130,1,00279,India
341789,2023-03-01,210,mountain dew,75,100,25,2,00279,India
341789,2023-03-01,202,milk,12,27,15,1,00279,India
341789,2023-03-01,204,strawberry yogurt,50,60,10,2,00279,India
472198,2023-03-01,205,classic yogurt,45,60,15,2,00236,India
472198,2023-03-01,209,pepsi,75,100,25,2,00236,India
472198,2023-03-01,206,yakult,360,400,40,2,00236,India
472198,2023-03-01,201,paneer,210,340,130,1,00236,India
472198,2023-03-01,208,sprite,75,100,25,2,00236,India
406075,2023-03-01,213,bisleri,6,15,9,2,00018,India
146290,2023-03-01,205,classic yogurt,45,60,15,2,00194,India
516544,2023-03-01,205,classic yogurt,45,60,15,2,00116,India
516544,2023-03-01,202,milk,12,27,15,1,00116,India
516544,2023-03-01,212,amul cheese,250,315,65,1,00116,India
516544,2023-03-01,207,coca cola,75,100,25,2,00116,India
772739,2023-03-01,203,mango yogurt,50,60,10,2,00452,India
772739,2023-03-01,210,mountain dew,75,100,25,2,00452,India
772739,2023-03-01,205,classic yogurt,45,60,15,2,00452,India
162836,2023-03-01,209,pepsi,75,100,25,2,00400,India
162836,2023-03-01,213,bisleri,6,15,9,2,00400,India
463910,2023-03-01,210,mountain dew,75,100,25,2,00082,India
463910,2023-03-01,208,sprite,75,100,25,2,00082,India
463910,2023-03-01,212,amul cheese,250,315,65,1,00082,India
463910,2023-03-01,201,paneer,210,340,130,1,00082,India
463910,2023-03-01,206,yakult,360,400,40,2,00082,India
300139,2023-03-01,207,coca cola,75,100,25,2,00207,India
300139,2023-03-01,212,amul cheese,250,315,65,1,00207,India
300139,2023-03-01,202,milk,12,27,15,1,00207,India
679548,2023-03-01,203,mango yogurt,50,60,10,2,00460,India
679548,2023-03-01,213,bisleri,6,15,9,2,00460,India
679548,2023-03-01,211,red bull,90,125,35,2,00460,India
679548,2023-03-01,202,milk,12,27,15,1,00460,India
291951,2023-03-01,211,red bull,90,125,35,2,00098,India
104189,2023-03-01,211,red bull,90,125,35,2,00148,India
390638,2023-03-01,203,mango yogurt,50,60,10,2,00015,India
627769,2023-03-01,203,mango yogurt,50,60,10,2,00212,India
319221,2023-03-01,204,strawberry yogurt,50,60,10,2,00089,India
319221,2023-03-01,212,amul cheese,250,315,65,1,00089,India
188621,2023-03-01,211,red bull,90,125,35,2,00200,India
188621,2023-03-01,208,sprite,75,100,25,2,00200,India
188621,2023-03-01,207,coca cola,75,100,25,2,00200,India
971175,2023-03-01,213,bisleri,6,15,9,2,00062,India
971175,2023-03-01,201,paneer,210,340,130,1,00062,India
971175,2023-03-01,202,milk,12,27,15,1,00062,India
963568,2023-03-01,207,coca cola,75,100,25,2,00377,India
963568,2023-03-01,206,yakult,360,400,40,2,00377,India
963568,2023-03-01,212,amul cheese,250,315,65,1,00377,India
799872,2023-03-01,202,milk,12,27,15,1,00099,India
799872,2023-03-01,203,mango yogurt,50,60,10,2,00099,India
799872,2023-03-01,205,classic yogurt,45,60,15,2,00099,India
799872,2023-03-01,211,red bull,90,125,35,2,00099,India
239038,2023-03-01,201,paneer,210,340,130,1,00499,India
239038,2023-03-01,203,mango yogurt,50,60,10,2,00499,India
239038,2023-03-01,206,yakult,360,400,40,2,00499,India
503233,2023-03-01,202,milk,12,27,15,1,00105,India
503233,2023-03-01,212,amul cheese,250,315,65,1,00105,India
503233,2023-03-01,205,classic yogurt,45,60,15,2,00105,India
326638,2023-03-01,205,classic yogurt,45,60,15,2,00123,India
327824,2023-03-01,205,classic yogurt,45,60,15,2,00432,India
327824,2023-03-01,202,milk,12,27,15,1,00432,India
327824,2023-03-01,204,strawberry yogurt,50,60,10,2,00432,India
327824,2023-03-01,213,bisleri,6,15,9,2,00432,India
386530,2023-03-01,203,mango yogurt,50,60,10,2,00297,India
386530,2023-03-01,206,yakult,360,400,40,2,00297,India
386530,2023-03-01,212,amul cheese,250,315,65,1,00297,India
884249,2023-03-01,204,strawberry yogurt,50,60,10,2,00003,India
884249,2023-03-01,208,sprite,75,100,25,2,00003,India
884249,2023-03-01,203,mango yogurt,50,60,10,2,00003,India
884249,2023-03-01,202,milk,12,27,15,1,00003,India
641028,2023-03-01,202,milk,12,27,15,1,00056,India
641028,2023-03-01,206,yakult,360,400,40,2,00056,India
641028,2023-03-01,204,strawberry yogurt,50,60,10,2,00056,India
544125,2023-03-01,206,yakult,360,400,40,2,00379,India
544125,2023-03-01,201,paneer,210,340,130,1,00379,India
485627,2023-03-01,201,paneer,210,340,130,1,00051,India
135117,2023-03-01,211,red bull,90,125,35,2,00166,India
701618,2023-03-01,202,milk,12,27,15,1,00236,India
701618,2023-03-01,204,strawberry yogurt,50,60,10,2,00236,India
837621,2023-03-01,202,milk,12,27,15,1,00317,India
837621,2023-03-01,211,red bull,90,125,35,2,00317,India
966071,2023-03-01,204,strawberry yogurt,50,60,10,2,00121,India
459649,2023-03-01,209,pepsi,75,100,25,2,00441,India
459649,2023-03-01,211,red bull,90,125,35,2,00441,India
459649,2023-03-01,206,yakult,360,400,40,2,00441,India
459649,2023-03-01,203,mango yogurt,50,60,10,2,00441,India
155930,2023-03-01,205,classic yogurt,45,60,15,2,00275,India
409424,2023-03-01,207,coca cola,75,100,25,2,00440,India
385781,2023-03-01,201,paneer,210,340,130,1,00371,India
385781,2023-03-01,211,red bull,90,125,35,2,00371,India
385781,2023-03-01,204,strawberry yogurt,50,60,10,2,00371,India
385781,2023-03-01,203,mango yogurt,50,60,10,2,00371,India
747954,2023-03-01,208,sprite,75,100,25,2,00145,India
747954,2023-03-01,203,mango yogurt,50,60,10,2,00145,India
478572,2023-03-01,203,mango yogurt,50,60,10,2,00004,India
478572,2023-03-01,202,milk,12,27,15,1,00004,India
985829,2023-03-01,211,red bull,90,125,35,2,00067,India
985829,2023-03-01,204,strawberry yogurt,50,60,10,2,00067,India
985829,2023-03-01,205,classic yogurt,45,60,15,2,00067,India
985829,2023-03-01,212,amul cheese,250,315,65,1,00067,India
303288,2023-03-01,213,bisleri,6,15,9,2,00031,India
303288,2023-03-01,202,milk,12,27,15,1,00031,India
303288,2023-03-01,210,mountain dew,75,100,25,2,00031,India
303288,2023-03-01,211,red bull,90,125,35,2,00031,India
186850,2023-03-01,206,yakult,360,400,40,2,00022,India
204909,2023-03-01,202,milk,12,27,15,1,00499,India
204909,2023-03-01,213,bisleri,6,15,9,2,00499,India
204909,2023-03-01,212,amul cheese,250,315,65,1,00499,India
204909,2023-03-01,206,yakult,360,400,40,2,00499,India
363694,2023-03-01,206,yakult,360,400,40,2,00377,India
363694,2023-03-01,213,bisleri,6,15,9,2,00377,India
363694,2023-03-01,208,sprite,75,100,25,2,00377,India
100672,2023-03-01,202,milk,12,27,15,1,00219,India
100672,2023-03-01,207,coca cola,75,100,25,2,00219,India
100672,2023-03-01,206,yakult,360,400,40,2,00219,India
100672,2023-03-01,208,sprite,75,100,25,2,00219,India
182914,2023-03-01,204,strawberry yogurt,50,60,10,2,00085,India
182914,2023-03-01,213,bisleri,6,15,9,2,00085,India
182914,2023-03-01,201,paneer,210,340,130,1,00085,India
182914,2023-03-01,209,pepsi,75,100,25,2,00085,India
353305,2023-03-01,201,paneer,210,340,130,1,00114,India
353305,2023-03-01,212,amul cheese,250,315,65,1,00114,India
353305,2023-03-01,204,strawberry yogurt,50,60,10,2,00114,India
353305,2023-03-01,207,coca cola,75,100,25,2,00114,India
233245,2023-03-01,212,amul cheese,250,315,65,1,00446,India
233245,2023-03-01,211,red bull,90,125,35,2,00446,India
233245,2023-03-01,210,mountain dew,75,100,25,2,00446,India
233245,2023-03-01,204,strawberry yogurt,50,60,10,2,00446,India
233245,2023-03-01,206,yakult,360,400,40,2,00446,India
552323,2023-03-01,209,pepsi,75,100,25,2,00133,India
552323,2023-03-01,204,strawberry yogurt,50,60,10,2,00133,India
552323,2023-03-01,207,coca cola,75,100,25,2,00133,India
552323,2023-03-01,205,classic yogurt,45,60,15,2,00133,India
165240,2023-03-01,205,classic yogurt,45,60,15,2,00418,India
165240,2023-03-01,211,red bull,90,125,35,2,00418,India
165240,2023-03-01,204,strawberry yogurt,50,60,10,2,00418,India
165240,2023-03-01,212,amul cheese,250,315,65,1,00418,India
165240,2023-03-01,213,bisleri,6,15,9,2,00418,India
429234,2023-03-01,211,red bull,90,125,35,2,00352,India
703513,2023-03-01,204,strawberry yogurt,50,60,10,2,00158,India
127395,2023-03-01,210,mountain dew,75,100,25,2,00012,India
127395,2023-03-01,205,classic yogurt,45,60,15,2,00012,India
127395,2023-03-01,202,milk,12,27,15,1,00012,India
540775,2023-03-01,209,pepsi,75,100,25,2,00196,India
656185,2023-03-01,206,yakult,360,400,40,2,00283,India
656185,2023-03-01,211,red bull,90,125,35,2,00283,India
656185,2023-03-01,201,paneer,210,340,130,1,00283,India
656185,2023-03-01,204,strawberry yogurt,50,60,10,2,00283,India
460480,2023-03-01,201,paneer,210,340,130,1,00291,India
460480,2023-03-01,213,bisleri,6,15,9,2,00291,India
426613,2023-03-01,202,milk,12,27,15,1,00398,India
426613,2023-03-01,207,coca cola,75,100,25,2,00398,India
193574,2023-03-01,212,amul cheese,250,315,65,1,00020,India
193574,2023-03-01,206,yakult,360,400,40,2,00020,India
193574,2023-03-01,204,strawberry yogurt,50,60,10,2,00020,India
193574,2023-03-01,208,sprite,75,100,25,2,00020,India
461001,2023-03-01,206,yakult,360,400,40,2,00020,India
461001,2023-03-01,205,classic yogurt,45,60,15,2,00020,India
461001,2023-03-01,203,mango yogurt,50,60,10,2,00020,India
461001,2023-03-01,210,mountain dew,75,100,25,2,00020,India
461001,2023-03-01,211,red bull,90,125,35,2,00020,India
614859,2023-03-01,201,paneer,210,340,130,1,00486,India
614859,2023-03-01,208,sprite,75,100,25,2,00486,India
614859,2023-03-01,207,coca cola,75,100,25,2,00486,India
614859,2023-03-01,210,mountain dew,75,100,25,2,00486,India
627349,2023-03-01,203,mango yogurt,50,60,10,2,00318,India
627349,2023-03-01,211,red bull,90,125,35,2,00318,India
627349,2023-03-01,212,amul cheese,250,315,65,1,00318,India
627349,2023-03-01,205,classic yogurt,45,60,15,2,00318,India
544695,2023-03-01,202,milk,12,27,15,1,00223,India
544695,2023-03-01,204,strawberry yogurt,50,60,10,2,00223,India
544695,2023-03-01,203,mango yogurt,50,60,10,2,00223,India
544695,2023-03-01,201,paneer,210,340,130,1,00223,India
346169,2023-03-01,208,sprite,75,100,25,2,00047,India
346169,2023-03-01,205,classic yogurt,45,60,15,2,00047,India
112442,2023-03-01,202,milk,12,27,15,1,00436,India
112442,2023-03-01,206,yakult,360,400,40,2,00436,India
244520,2023-03-01,203,mango yogurt,50,60,10,2,00111,India
244520,2023-03-01,209,pepsi,75,100,25,2,00111,India
244520,2023-03-01,211,red bull,90,125,35,2,00111,India
244520,2023-03-01,204,strawberry yogurt,50,60,10,2,00111,India
122722,2023-03-01,202,milk,12,27,15,1,00236,India
506799,2023-03-01,212,amul cheese,250,315,65,1,00265,India
540689,2023-03-01,202,milk,12,27,15,1,00163,India
110941,2023-03-01,208,sprite,75,100,25,2,00036,India
433664,2023-03-01,212,amul cheese,250,315,65,1,00362,India
604809,2023-03-01,201,paneer,210,340,130,1,00066,India
604809,2023-03-01,203,mango yogurt,50,60,10,2,00066,India
604809,2023-03-01,207,coca cola,75,100,25,2,00066,India
604809,2023-03-01,211,red bull,90,125,35,2,00066,India
912861,2023-03-01,202,milk,12,27,15,1,00201,India
912861,2023-03-01,206,yakult,360,400,40,2,00201,India
912861,2023-03-01,205,classic yogurt,45,60,15,2,00201,India
912861,2023-03-01,208,sprite,75,100,25,2,00201,India
912861,2023-03-01,201,paneer,210,340,130,1,00201,India
593079,2023-03-01,203,mango yogurt,50,60,10,2,00119,India
593079,2023-03-01,206,yakult,360,400,40,2,00119,India
593079,2023-03-01,210,mountain dew,75,100,25,2,00119,India
593079,2023-03-01,213,bisleri,6,15,9,2,00119,India
664539,2023-03-01,211,red bull,90,125,35,2,00115,India
664539,2023-03-01,212,amul cheese,250,315,65,1,00115,India
664539,2023-03-01,206,yakult,360,400,40,2,00115,India
664539,2023-03-01,202,milk,12,27,15,1,00115,India
161862,2023-03-01,211,red bull,90,125,35,2,00391,India
792194,2023-03-01,211,red bull,90,125,35,2,00031,India
305264,2023-03-01,210,mountain dew,75,100,25,2,00166,India
305264,2023-03-01,202,milk,12,27,15,1,00166,India
305264,2023-03-01,203,mango yogurt,50,60,10,2,00166,India
477284,2023-03-02,203,mango yogurt,50,60,10,2,00204,India
477284,2023-03-02,205,classic yogurt,45,60,15,2,00204,India
905174,2023-03-02,205,classic yogurt,45,60,15,2,00455,India
905174,2023-03-02,202,milk,12,27,15,1,00455,India
905174,2023-03-02,213,bisleri,6,15,9,2,00455,India
152808,2023-03-02,209,pepsi,75,100,25,2,00386,India
974269,2023-03-02,201,paneer,210,340,130,1,00131,India
974269,2023-03-02,213,bisleri,6,15,9,2,00131,India
974269,2023-03-02,202,milk,12,27,15,1,00131,India
974269,2023-03-02,209,pepsi,75,100,25,2,00131,India
974269,2023-03-02,207,coca cola,75,100,25,2,00131,India
858563,2023-03-02,205,classic yogurt,45,60,15,2,00007,India
858563,2023-03-02,211,red bull,90,125,35,2,00007,India
858563,2023-03-02,210,mountain dew,75,100,25,2,00007,India
679860,2023-03-02,202,milk,12,27,15,1,00079,India
890775,2023-03-02,202,milk,12,27,15,1,00205,India
241052,2023-03-02,205,classic yogurt,45,60,15,2,00004,India
241052,2023-03-02,203,mango yogurt,50,60,10,2,00004,India
241052,2023-03-02,201,paneer,210,340,130,1,00004,India
837309,2023-03-02,206,yakult,360,400,40,2,00219,India
837309,2023-03-02,205,classic yogurt,45,60,15,2,00219,India
837309,2023-03-02,204,strawberry yogurt,50,60,10,2,00219,India
837309,2023-03-02,203,mango yogurt,50,60,10,2,00219,India
179735,2023-03-02,202,milk,12,27,15,1,00375,India
179735,2023-03-02,206,yakult,360,400,40,2,00375,India
179735,2023-03-02,213,bisleri,6,15,9,2,00375,India
374451,2023-03-02,207,coca cola,75,100,25,2,00274,India
374451,2023-03-02,202,milk,12,27,15,1,00274,India
113900,2023-03-02,209,pepsi,75,100,25,2,00003,India
222911,2023-03-02,210,mountain dew,75,100,25,2,00271,India
222911,2023-03-02,203,mango yogurt,50,60,10,2,00271,India
642907,2023-03-02,202,milk,12,27,15,1,00009,India
642907,2023-03-02,203,mango yogurt,50,60,10,2,00009,India
642907,2023-03-02,213,bisleri,6,15,9,2,00009,India
213482,2023-03-02,213,bisleri,6,15,9,2,00252,India
213482,2023-03-02,206,yakult,360,400,40,2,00252,India
213482,2023-03-02,212,amul cheese,250,315,65,1,00252,India
355523,2023-03-02,210,mountain dew,75,100,25,2,00041,India
534032,2023-03-02,209,pepsi,75,100,25,2,00195,India
534032,2023-03-02,201,paneer,210,340,130,1,00195,India
534032,2023-03-02,203,mango yogurt,50,60,10,2,00195,India
534032,2023-03-02,212,amul cheese,250,315,65,1,00195,India
225424,2023-03-02,210,mountain dew,75,100,25,2,00011,India
225424,2023-03-02,205,classic yogurt,45,60,15,2,00011,India
391544,2023-03-02,209,pepsi,75,100,25,2,00111,India
391544,2023-03-02,212,amul cheese,250,315,65,1,00111,India
391544,2023-03-02,205,classic yogurt,45,60,15,2,00111,India
178442,2023-03-02,210,mountain dew,75,100,25,2,00041,India
178442,2023-03-02,202,milk,12,27,15,1,00041,India
178442,2023-03-02,209,pepsi,75,100,25,2,00041,India
178442,2023-03-02,206,yakult,360,400,40,2,00041,India
178442,2023-03-02,201,paneer,210,340,130,1,00041,India
381852,2023-03-02,205,classic yogurt,45,60,15,2,00356,India
381852,2023-03-02,211,red bull,90,125,35,2,00356,India
343543,2023-03-02,213,bisleri,6,15,9,2,00445,India
343543,2023-03-02,209,pepsi,75,100,25,2,00445,India
948582,2023-03-02,213,bisleri,6,15,9,2,00249,India
948582,2023-03-02,208,sprite,75,100,25,2,00249,India
948582,2023-03-02,202,milk,12,27,15,1,00249,India
713025,2023-03-02,203,mango yogurt,50,60,10,2,00345,India
467374,2023-03-02,213,bisleri,6,15,9,2,00391,India
467374,2023-03-02,209,pepsi,75,100,25,2,00391,India
467374,2023-03-02,211,red bull,90,125,35,2,00391,India
467374,2023-03-02,206,yakult,360,400,40,2,00391,India
467374,2023-03-02,204,strawberry yogurt,50,60,10,2,00391,India
134286,2023-03-02,202,milk,12,27,15,1,00248,India
134286,2023-03-02,209,pepsi,75,100,25,2,00248,India
312287,2023-03-02,204,strawberry yogurt,50,60,10,2,00368,India
312287,2023-03-02,208,sprite,75,100,25,2,00368,India
312287,2023-03-02,205,classic yogurt,45,60,15,2,00368,India
312287,2023-03-02,212,amul cheese,250,315,65,1,00368,India
225766,2023-03-02,211,red bull,90,125,35,2,00295,India
225766,2023-03-02,207,coca cola,75,100,25,2,00295,India
225766,2023-03-02,203,mango yogurt,50,60,10,2,00295,India
225766,2023-03-02,212,amul cheese,250,315,65,1,00295,India
306592,2023-03-02,203,mango yogurt,50,60,10,2,00377,India
196158,2023-03-02,210,mountain dew,75,100,25,2,00488,India
196158,2023-03-02,213,bisleri,6,15,9,2,00488,India
196158,2023-03-02,203,mango yogurt,50,60,10,2,00488,India
196158,2023-03-02,211,red bull,90,125,35,2,00488,India
584702,2023-03-02,213,bisleri,6,15,9,2,00368,India
264468,2023-03-02,206,yakult,360,400,40,2,00201,India
264468,2023-03-02,204,strawberry yogurt,50,60,10,2,00201,India
264468,2023-03-02,212,amul cheese,250,315,65,1,00201,India
264468,2023-03-02,208,sprite,75,100,25,2,00201,India
792597,2023-03-02,204,strawberry yogurt,50,60,10,2,00338,India
792597,2023-03-02,211,red bull,90,125,35,2,00338,India
142709,2023-03-02,211,red bull,90,125,35,2,00467,India
142709,2023-03-02,204,strawberry yogurt,50,60,10,2,00467,India
142709,2023-03-02,203,mango yogurt,50,60,10,2,00467,India
142709,2023-03-02,202,milk,12,27,15,1,00467,India
916905,2023-03-02,210,mountain dew,75,100,25,2,00026,India
916905,2023-03-02,201,paneer,210,340,130,1,00026,India
271359,2023-03-02,211,red bull,90,125,35,2,00318,India
907987,2023-03-02,210,mountain dew,75,100,25,2,00303,India
907987,2023-03-02,201,paneer,210,340,130,1,00303,India
306448,2023-03-02,207,coca cola,75,100,25,2,00219,India
306448,2023-03-02,209,pepsi,75,100,25,2,00219,India
306448,2023-03-02,211,red bull,90,125,35,2,00219,India
306448,2023-03-02,206,yakult,360,400,40,2,00219,India
332337,2023-03-02,210,mountain dew,75,100,25,2,00125,India
332337,2023-03-02,201,paneer,210,340,130,1,00125,India
572273,2023-03-02,208,sprite,75,100,25,2,00499,India
228740,2023-03-02,209,pepsi,75,100,25,2,00244,India
228740,2023-03-02,201,paneer,210,340,130,1,00244,India
228740,2023-03-02,212,amul cheese,250,315,65,1,00244,India
228740,2023-03-02,205,classic yogurt,45,60,15,2,00244,India
228740,2023-03-02,206,yakult,360,400,40,2,00244,India
291918,2023-03-02,212,amul cheese,250,315,65,1,00004,India
291918,2023-03-02,209,pepsi,75,100,25,2,00004,India
980205,2023-03-02,208,sprite,75,100,25,2,00429,India
469991,2023-03-02,206,yakult,360,400,40,2,00049,India
469991,2023-03-02,213,bisleri,6,15,9,2,00049,India
472833,2023-03-02,207,coca cola,75,100,25,2,00485,India
472833,2023-03-02,213,bisleri,6,15,9,2,00485,India
472833,2023-03-02,203,mango yogurt,50,60,10,2,00485,India
398946,2023-03-02,204,strawberry yogurt,50,60,10,2,00500,India
398946,2023-03-02,201,paneer,210,340,130,1,00500,India
398946,2023-03-02,211,red bull,90,125,35,2,00500,India
398946,2023-03-02,212,amul cheese,250,315,65,1,00500,India
895887,2023-03-02,203,mango yogurt,50,60,10,2,00329,India
981556,2023-03-02,210,mountain dew,75,100,25,2,00390,India
981556,2023-03-02,212,amul cheese,250,315,65,1,00390,India
981556,2023-03-02,202,milk,12,27,15,1,00390,India
981556,2023-03-02,209,pepsi,75,100,25,2,00390,India
981556,2023-03-02,204,strawberry yogurt,50,60,10,2,00390,India
324751,2023-03-02,208,sprite,75,100,25,2,00272,India
324751,2023-03-02,210,mountain dew,75,100,25,2,00272,India
460436,2023-03-02,202,milk,12,27,15,1,00211,India
460436,2023-03-02,209,pepsi,75,100,25,2,00211,India
411538,2023-03-02,201,paneer,210,340,130,1,00342,India
411538,2023-03-02,207,coca cola,75,100,25,2,00342,India
203035,2023-03-02,201,paneer,210,340,130,1,00006,India
530097,2023-03-02,211,red bull,90,125,35,2,00470,India
182167,2023-03-02,212,amul cheese,250,315,65,1,00410,India
220311,2023-03-02,207,coca cola,75,100,25,2,00341,India
220311,2023-03-02,208,sprite,75,100,25,2,00341,India
210921,2023-03-02,205,classic yogurt,45,60,15,2,00238,India
210921,2023-03-02,208,sprite,75,100,25,2,00238,India
417561,2023-03-02,208,sprite,75,100,25,2,00018,India
417561,2023-03-02,210,mountain dew,75,100,25,2,00018,India
417561,2023-03-02,213,bisleri,6,15,9,2,00018,India
337264,2023-03-03,208,sprite,75,100,25,2,00468,India
337264,2023-03-03,210,mountain dew,75,100,25,2,00468,India
401474,2023-03-03,205,classic yogurt,45,60,15,2,00223,India
441555,2023-03-03,209,pepsi,75,100,25,2,00005,India
441555,2023-03-03,207,coca cola,75,100,25,2,00005,India
449014,2023-03-03,202,milk,12,27,15,1,00002,India
449014,2023-03-03,203,mango yogurt,50,60,10,2,00002,India
449014,2023-03-03,205,classic yogurt,45,60,15,2,00002,India
216555,2023-03-03,202,milk,12,27,15,1,00103,India
216555,2023-03-03,209,pepsi,75,100,25,2,00103,India
216555,2023-03-03,213,bisleri,6,15,9,2,00103,India
930838,2023-03-03,204,strawberry yogurt,50,60,10,2,00316,India
930838,2023-03-03,212,amul cheese,250,315,65,1,00316,India
967042,2023-03-03,213,bisleri,6,15,9,2,00391,India
202541,2023-03-03,201,paneer,210,340,130,1,00331,India
202541,2023-03-03,211,red bull,90,125,35,2,00331,India
858903,2023-03-03,210,mountain dew,75,100,25,2,00473,India
858903,2023-03-03,201,paneer,210,340,130,1,00473,India
858903,2023-03-03,211,red bull,90,125,35,2,00473,India
858903,2023-03-03,207,coca cola,75,100,25,2,00473,India
758229,2023-03-03,205,classic yogurt,45,60,15,2,00237,India
480853,2023-03-03,211,red bull,90,125,35,2,00213,India
480853,2023-03-03,203,mango yogurt,50,60,10,2,00213,India
480853,2023-03-03,204,strawberry yogurt,50,60,10,2,00213,India
480853,2023-03-03,201,paneer,210,340,130,1,00213,India
480853,2023-03-03,206,yakult,360,400,40,2,00213,India
753950,2023-03-03,206,yakult,360,400,40,2,00063,India
753950,2023-03-03,208,sprite,75,100,25,2,00063,India
753950,2023-03-03,213,bisleri,6,15,9,2,00063,India
807787,2023-03-03,201,paneer,210,340,130,1,00360,India
716488,2023-03-03,210,mountain dew,75,100,25,2,00211,India
716488,2023-03-03,206,yakult,360,400,40,2,00211,India
716488,2023-03-03,211,red bull,90,125,35,2,00211,India
949989,2023-03-03,203,mango yogurt,50,60,10,2,00403,India
949989,2023-03-03,213,bisleri,6,15,9,2,00403,India
949989,2023-03-03,202,milk,12,27,15,1,00403,India
949989,2023-03-03,206,yakult,360,400,40,2,00403,India
315692,2023-03-03,209,pepsi,75,100,25,2,00243,India
315692,2023-03-03,205,classic yogurt,45,60,15,2,00243,India
315692,2023-03-03,203,mango yogurt,50,60,10,2,00243,India
361405,2023-03-03,206,yakult,360,400,40,2,00037,India
361405,2023-03-03,210,mountain dew,75,100,25,2,00037,India
936006,2023-03-03,206,yakult,360,400,40,2,00453,India
936006,2023-03-03,210,mountain dew,75,100,25,2,00453,India
936006,2023-03-03,203,mango yogurt,50,60,10,2,00453,India
936006,2023-03-03,205,classic yogurt,45,60,15,2,00453,India
367779,2023-03-03,201,paneer,210,340,130,1,00222,India
367779,2023-03-03,212,amul cheese,250,315,65,1,00222,India
367779,2023-03-03,202,milk,12,27,15,1,00222,India
367779,2023-03-03,203,mango yogurt,50,60,10,2,00222,India
142883,2023-03-03,206,yakult,360,400,40,2,00192,India
805437,2023-03-03,205,classic yogurt,45,60,15,2,00477,India
805437,2023-03-03,202,milk,12,27,15,1,00477,India
805437,2023-03-03,210,mountain dew,75,100,25,2,00477,India
805437,2023-03-03,206,yakult,360,400,40,2,00477,India
380651,2023-03-03,208,sprite,75,100,25,2,00322,India
380651,2023-03-03,211,red bull,90,125,35,2,00322,India
380651,2023-03-03,201,paneer,210,340,130,1,00322,India
542677,2023-03-03,209,pepsi,75,100,25,2,00057,India
542677,2023-03-03,201,paneer,210,340,130,1,00057,India
542677,2023-03-03,213,bisleri,6,15,9,2,00057,India
542677,2023-03-03,211,red bull,90,125,35,2,00057,India
154923,2023-03-03,207,coca cola,75,100,25,2,00025,India
154923,2023-03-03,205,classic yogurt,45,60,15,2,00025,India
410850,2023-03-03,212,amul cheese,250,315,65,1,00188,India
944765,2023-03-03,210,mountain dew,75,100,25,2,00388,India
671577,2023-03-03,202,milk,12,27,15,1,00106,India
671577,2023-03-03,205,classic yogurt,45,60,15,2,00106,India
685271,2023-03-03,208,sprite,75,100,25,2,00420,India
685271,2023-03-03,205,classic yogurt,45,60,15,2,00420,India
380236,2023-03-03,212,amul cheese,250,315,65,1,00278,India
380236,2023-03-03,211,red bull,90,125,35,2,00278,India
380236,2023-03-03,209,pepsi,75,100,25,2,00278,India
380236,2023-03-03,208,sprite,75,100,25,2,00278,India
318527,2023-03-03,208,sprite,75,100,25,2,00206,India
318527,2023-03-03,209,pepsi,75,100,25,2,00206,India
518901,2023-03-03,206,yakult,360,400,40,2,00495,India
530648,2023-03-03,201,paneer,210,340,130,1,00372,India
530648,2023-03-03,206,yakult,360,400,40,2,00372,India
530648,2023-03-03,204,strawberry yogurt,50,60,10,2,00372,India
675037,2023-03-03,205,classic yogurt,45,60,15,2,00493,India
675037,2023-03-03,207,coca cola,75,100,25,2,00493,India
253562,2023-03-03,201,paneer,210,340,130,1,00057,India
253562,2023-03-03,208,sprite,75,100,25,2,00057,India
253562,2023-03-03,205,classic yogurt,45,60,15,2,00057,India
868608,2023-03-03,213,bisleri,6,15,9,2,00325,India
868608,2023-03-03,203,mango yogurt,50,60,10,2,00325,India
813484,2023-03-03,206,yakult,360,400,40,2,00416,India
813484,2023-03-03,209,pepsi,75,100,25,2,00416,India
813484,2023-03-03,210,mountain dew,75,100,25,2,00416,India
813484,2023-03-03,213,bisleri,6,15,9,2,00416,India
357927,2023-03-03,203,mango yogurt,50,60,10,2,00009,India
357927,2023-03-03,209,pepsi,75,100,25,2,00009,India
357927,2023-03-03,201,paneer,210,340,130,1,00009,India
357927,2023-03-03,206,yakult,360,400,40,2,00009,India
364792,2023-03-03,205,classic yogurt,45,60,15,2,00373,India
364792,2023-03-03,209,pepsi,75,100,25,2,00373,India
364792,2023-03-03,213,bisleri,6,15,9,2,00373,India
364792,2023-03-03,208,sprite,75,100,25,2,00373,India
364792,2023-03-03,206,yakult,360,400,40,2,00373,India
927853,2023-03-03,208,sprite,75,100,25,2,00144,India
927853,2023-03-03,201,paneer,210,340,130,1,00144,India
927853,2023-03-03,206,yakult,360,400,40,2,00144,India
153879,2023-03-03,206,yakult,360,400,40,2,00235,India
109746,2023-03-03,202,milk,12,27,15,1,00078,India
109746,2023-03-03,211,red bull,90,125,35,2,00078,India
109746,2023-03-03,205,classic yogurt,45,60,15,2,00078,India
109746,2023-03-03,201,paneer,210,340,130,1,00078,India
109746,2023-03-03,208,sprite,75,100,25,2,00078,India
489935,2023-03-03,204,strawberry yogurt,50,60,10,2,00340,India
489935,2023-03-03,206,yakult,360,400,40,2,00340,India
538558,2023-03-03,207,coca cola,75,100,25,2,00411,India
744695,2023-03-03,213,bisleri,6,15,9,2,00308,India
744695,2023-03-03,201,paneer,210,340,130,1,00308,India
744695,2023-03-03,207,coca cola,75,100,25,2,00308,India
744695,2023-03-03,208,sprite,75,100,25,2,00308,India
433895,2023-03-03,212,amul cheese,250,315,65,1,00073,India
433895,2023-03-03,207,coca cola,75,100,25,2,00073,India
433895,2023-03-03,213,bisleri,6,15,9,2,00073,India
224603,2023-03-03,202,milk,12,27,15,1,00285,India
224603,2023-03-03,201,paneer,210,340,130,1,00285,India
224603,2023-03-03,204,strawberry yogurt,50,60,10,2,00285,India
752319,2023-03-03,204,strawberry yogurt,50,60,10,2,00102,India
752319,2023-03-03,210,mountain dew,75,100,25,2,00102,India
759753,2023-03-03,208,sprite,75,100,25,2,00163,India
197440,2023-03-03,211,red bull,90,125,35,2,00495,India
197440,2023-03-03,201,paneer,210,340,130,1,00495,India
519473,2023-03-03,212,amul cheese,250,315,65,1,00449,India
555212,2023-03-03,207,coca cola,75,100,25,2,00322,India
555212,2023-03-03,202,milk,12,27,15,1,00322,India
555212,2023-03-03,211,red bull,90,125,35,2,00322,India
253709,2023-03-03,212,amul cheese,250,315,65,1,00246,India
539236,2023-03-03,205,classic yogurt,45,60,15,2,00085,India
539236,2023-03-03,203,mango yogurt,50,60,10,2,00085,India
539236,2023-03-03,210,mountain dew,75,100,25,2,00085,India
872517,2023-03-03,203,mango yogurt,50,60,10,2,00378,India
872517,2023-03-03,213,bisleri,6,15,9,2,00378,India
872517,2023-03-03,205,classic yogurt,45,60,15,2,00378,India
872517,2023-03-03,210,mountain dew,75,100,25,2,00378,India
349236,2023-03-03,204,strawberry yogurt,50,60,10,2,00006,India
349236,2023-03-03,202,milk,12,27,15,1,00006,India
349236,2023-03-03,209,pepsi,75,100,25,2,00006,India
349236,2023-03-03,205,classic yogurt,45,60,15,2,00006,India
697730,2023-03-03,212,amul cheese,250,315,65,1,00460,India
664613,2023-03-03,208,sprite,75,100,25,2,00307,India
664613,2023-03-03,213,bisleri,6,15,9,2,00307,India
664613,2023-03-03,210,mountain dew,75,100,25,2,00307,India
664613,2023-03-03,211,red bull,90,125,35,2,00307,India
300189,2023-03-03,203,mango yogurt,50,60,10,2,00360,India
385168,2023-03-03,210,mountain dew,75,100,25,2,00360,India
385168,2023-03-03,205,classic yogurt,45,60,15,2,00360,India
385168,2023-03-03,212,amul cheese,250,315,65,1,00360,India
149145,2023-03-03,208,sprite,75,100,25,2,00028,India
149145,2023-03-03,212,amul cheese,250,315,65,1,00028,India
149145,2023-03-03,209,pepsi,75,100,25,2,00028,India
149145,2023-03-03,204,strawberry yogurt,50,60,10,2,00028,India
511519,2023-03-03,208,sprite,75,100,25,2,00389,India
511519,2023-03-03,212,amul cheese,250,315,65,1,00389,India
677345,2023-03-03,212,amul cheese,250,315,65,1,00105,India
677345,2023-03-03,206,yakult,360,400,40,2,00105,India
677345,2023-03-03,209,pepsi,75,100,25,2,00105,India
496806,2023-03-03,208,sprite,75,100,25,2,00185,India
496806,2023-03-03,204,strawberry yogurt,50,60,10,2,00185,India
496806,2023-03-03,212,amul cheese,250,315,65,1,00185,India
496806,2023-03-03,210,mountain dew,75,100,25,2,00185,India
496806,2023-03-03,206,yakult,360,400,40,2,00185,India
448306,2023-03-03,204,strawberry yogurt,50,60,10,2,00247,India
448306,2023-03-03,201,paneer,210,340,130,1,00247,India
448306,2023-03-03,208,sprite,75,100,25,2,00247,India
448306,2023-03-03,203,mango yogurt,50,60,10,2,00247,India
827876,2023-03-03,211,red bull,90,125,35,2,00232,India
827876,2023-03-03,202,milk,12,27,15,1,00232,India
827876,2023-03-03,209,pepsi,75,100,25,2,00232,India
636873,2023-03-04,212,amul cheese,250,315,65,1,00407,India
636873,2023-03-04,209,pepsi,75,100,25,2,00407,India
942817,2023-03-04,206,yakult,360,400,40,2,00204,India
942817,2023-03-04,204,strawberry yogurt,50,60,10,2,00204,India
942817,2023-03-04,203,mango yogurt,50,60,10,2,00204,India
942817,2023-03-04,211,red bull,90,125,35,2,00204,India
260912,2023-03-04,213,bisleri,6,15,9,2,00106,India
260912,2023-03-04,212,amul cheese,250,315,65,1,00106,India
260912,2023-03-04,202,milk,12,27,15,1,00106,India
260912,2023-03-04,204,strawberry yogurt,50,60,10,2,00106,India
566893,2023-03-04,208,sprite,75,100,25,2,00117,India
566893,2023-03-04,207,coca cola,75,100,25,2,00117,India
758402,2023-03-04,206,yakult,360,400,40,2,00410,India
758402,2023-03-04,205,classic yogurt,45,60,15,2,00410,India
542730,2023-03-04,212,amul cheese,250,315,65,1,00283,India
542730,2023-03-04,204,strawberry yogurt,50,60,10,2,00283,India
542730,2023-03-04,213,bisleri,6,15,9,2,00283,India
730327,2023-03-04,206,yakult,360,400,40,2,00139,India
730327,2023-03-04,210,mountain dew,75,100,25,2,00139,India
804577,2023-03-04,201,paneer,210,340,130,1,00368,India
388026,2023-03-04,210,mountain dew,75,100,25,2,00261,India
388026,2023-03-04,204,strawberry yogurt,50,60,10,2,00261,India
651033,2023-03-04,211,red bull,90,125,35,2,00214,India
651033,2023-03-04,208,sprite,75,100,25,2,00214,India
651033,2023-03-04,202,milk,12,27,15,1,00214,India
446039,2023-03-04,213,bisleri,6,15,9,2,00415,India
446039,2023-03-04,212,amul cheese,250,315,65,1,00415,India
446039,2023-03-04,205,classic yogurt,45,60,15,2,00415,India
747700,2023-03-04,207,coca cola,75,100,25,2,00170,India
747700,2023-03-04,201,paneer,210,340,130,1,00170,India
747700,2023-03-04,212,amul cheese,250,315,65,1,00170,India
779398,2023-03-04,213,bisleri,6,15,9,2,00278,India
779398,2023-03-04,203,mango yogurt,50,60,10,2,00278,India
779398,2023-03-04,206,yakult,360,400,40,2,00278,India
779398,2023-03-04,202,milk,12,27,15,1,00278,India
281692,2023-03-04,210,mountain dew,75,100,25,2,00022,India
281692,2023-03-04,201,paneer,210,340,130,1,00022,India
281692,2023-03-04,204,strawberry yogurt,50,60,10,2,00022,India
531238,2023-03-04,202,milk,12,27,15,1,00134,India
531238,2023-03-04,211,red bull,90,125,35,2,00134,India
740958,2023-03-04,204,strawberry yogurt,50,60,10,2,00267,India
740958,2023-03-04,211,red bull,90,125,35,2,00267,India
740958,2023-03-04,208,sprite,75,100,25,2,00267,India
740958,2023-03-04,213,bisleri,6,15,9,2,00267,India
864654,2023-03-04,213,bisleri,6,15,9,2,00156,India
864654,2023-03-04,203,mango yogurt,50,60,10,2,00156,India
864654,2023-03-04,205,classic yogurt,45,60,15,2,00156,India
571900,2023-03-04,201,paneer,210,340,130,1,00313,India
571900,2023-03-04,206,yakult,360,400,40,2,00313,India
343938,2023-03-04,213,bisleri,6,15,9,2,00463,India
343938,2023-03-04,210,mountain dew,75,100,25,2,00463,India
190032,2023-03-04,209,pepsi,75,100,25,2,00403,India
190032,2023-03-04,213,bisleri,6,15,9,2,00403,India
190032,2023-03-04,203,mango yogurt,50,60,10,2,00403,India
190032,2023-03-04,205,classic yogurt,45,60,15,2,00403,India
765713,2023-03-04,206,yakult,360,400,40,2,00027,India
136015,2023-03-04,212,amul cheese,250,315,65,1,00453,India
136015,2023-03-04,210,mountain dew,75,100,25,2,00453,India
136015,2023-03-04,202,milk,12,27,15,1,00453,India
136015,2023-03-04,201,paneer,210,340,130,1,00453,India
678263,2023-03-04,205,classic yogurt,45,60,15,2,00069,India
678263,2023-03-04,209,pepsi,75,100,25,2,00069,India
894544,2023-03-04,203,mango yogurt,50,60,10,2,00315,India
531718,2023-03-04,206,yakult,360,400,40,2,00021,India
531718,2023-03-04,204,strawberry yogurt,50,60,10,2,00021,India
771644,2023-03-04,209,pepsi,75,100,25,2,00329,India
771644,2023-03-04,206,yakult,360,400,40,2,00329,India
771644,2023-03-04,210,mountain dew,75,100,25,2,00329,India
832942,2023-03-04,202,milk,12,27,15,1,00243,India
832942,2023-03-04,203,mango yogurt,50,60,10,2,00243,India
832942,2023-03-04,211,red bull,90,125,35,2,00243,India
218980,2023-03-04,210,mountain dew,75,100,25,2,00072,India
218980,2023-03-04,203,mango yogurt,50,60,10,2,00072,India
542388,2023-03-04,207,coca cola,75,100,25,2,00287,India
542388,2023-03-04,206,yakult,360,400,40,2,00287,India
542388,2023-03-04,213,bisleri,6,15,9,2,00287,India
542388,2023-03-04,211,red bull,90,125,35,2,00287,India
966531,2023-03-04,204,strawberry yogurt,50,60,10,2,00174,India
383969,2023-03-04,207,coca cola,75,100,25,2,00222,India
383969,2023-03-04,208,sprite,75,100,25,2,00222,India
383969,2023-03-04,206,yakult,360,400,40,2,00222,India
138212,2023-03-04,205,classic yogurt,45,60,15,2,00251,India
483316,2023-03-04,206,yakult,360,400,40,2,00034,India
483316,2023-03-04,201,paneer,210,340,130,1,00034,India
483316,2023-03-04,209,pepsi,75,100,25,2,00034,India
483316,2023-03-04,208,sprite,75,100,25,2,00034,India
478575,2023-03-04,207,coca cola,75,100,25,2,00187,India
478575,2023-03-04,204,strawberry yogurt,50,60,10,2,00187,India
478575,2023-03-04,206,yakult,360,400,40,2,00187,India
587157,2023-03-04,204,strawberry yogurt,50,60,10,2,00249,India
587157,2023-03-04,201,paneer,210,340,130,1,00249,India
404817,2023-03-04,202,milk,12,27,15,1,00161,India
404817,2023-03-04,209,pepsi,75,100,25,2,00161,India
404817,2023-03-04,211,red bull,90,125,35,2,00161,India
404817,2023-03-04,204,strawberry yogurt,50,60,10,2,00161,India
352855,2023-03-04,203,mango yogurt,50,60,10,2,00025,India
352855,2023-03-04,213,bisleri,6,15,9,2,00025,India
352855,2023-03-04,210,mountain dew,75,100,25,2,00025,India
167196,2023-03-04,205,classic yogurt,45,60,15,2,00081,India
167196,2023-03-04,206,yakult,360,400,40,2,00081,India
663697,2023-03-04,211,red bull,90,125,35,2,00390,India
663697,2023-03-04,202,milk,12,27,15,1,00390,India
931925,2023-03-04,210,mountain dew,75,100,25,2,00232,India
931925,2023-03-04,209,pepsi,75,100,25,2,00232,India
931925,2023-03-04,204,strawberry yogurt,50,60,10,2,00232,India
366608,2023-03-04,203,mango yogurt,50,60,10,2,00007,India
366608,2023-03-04,206,yakult,360,400,40,2,00007,India
366608,2023-03-04,211,red bull,90,125,35,2,00007,India
310199,2023-03-04,203,mango yogurt,50,60,10,2,00473,India
310199,2023-03-04,212,amul cheese,250,315,65,1,00473,India
310199,2023-03-04,201,paneer,210,340,130,1,00473,India
310199,2023-03-04,213,bisleri,6,15,9,2,00473,India
441464,2023-03-04,213,bisleri,6,15,9,2,00203,India
441464,2023-03-04,204,strawberry yogurt,50,60,10,2,00203,India
374539,2023-03-04,211,red bull,90,125,35,2,00177,India
152060,2023-03-04,202,milk,12,27,15,1,00418,India
152060,2023-03-04,203,mango yogurt,50,60,10,2,00418,India
243759,2023-03-04,202,milk,12,27,15,1,00252,India
299029,2023-03-04,201,paneer,210,340,130,1,00003,India
968206,2023-03-04,204,strawberry yogurt,50,60,10,2,00362,India
968206,2023-03-04,210,mountain dew,75,100,25,2,00362,India
344884,2023-03-04,205,classic yogurt,45,60,15,2,00178,India
344884,2023-03-04,209,pepsi,75,100,25,2,00178,India
344884,2023-03-04,211,red bull,90,125,35,2,00178,India
344884,2023-03-04,201,paneer,210,340,130,1,00178,India
582890,2023-03-04,213,bisleri,6,15,9,2,00271,India
582890,2023-03-04,203,mango yogurt,50,60,10,2,00271,India
582890,2023-03-04,204,strawberry yogurt,50,60,10,2,00271,India
582890,2023-03-04,205,classic yogurt,45,60,15,2,00271,India
672047,2023-03-04,209,pepsi,75,100,25,2,00369,India
964488,2023-03-04,207,coca cola,75,100,25,2,00270,India
964488,2023-03-04,213,bisleri,6,15,9,2,00270,India
964488,2023-03-04,201,paneer,210,340,130,1,00270,India
487482,2023-03-04,213,bisleri,6,15,9,2,00407,India
487482,2023-03-04,209,pepsi,75,100,25,2,00407,India
487482,2023-03-04,202,milk,12,27,15,1,00407,India
236176,2023-03-04,206,yakult,360,400,40,2,00313,India
236176,2023-03-04,207,coca cola,75,100,25,2,00313,India
205737,2023-03-04,213,bisleri,6,15,9,2,00032,India
205737,2023-03-04,211,red bull,90,125,35,2,00032,India
695596,2023-03-04,211,red bull,90,125,35,2,00328,India
695596,2023-03-04,207,coca cola,75,100,25,2,00328,India
665439,2023-03-04,209,pepsi,75,100,25,2,00248,India
202239,2023-03-04,211,red bull,90,125,35,2,00067,India
202239,2023-03-04,204,strawberry yogurt,50,60,10,2,00067,India
202239,2023-03-04,201,paneer,210,340,130,1,00067,India
323440,2023-03-04,203,mango yogurt,50,60,10,2,00027,India
902080,2023-03-04,208,sprite,75,100,25,2,00262,India
902080,2023-03-04,211,red bull,90,125,35,2,00262,India
902080,2023-03-04,213,bisleri,6,15,9,2,00262,India
902080,2023-03-04,202,milk,12,27,15,1,00262,India
321294,2023-03-04,206,yakult,360,400,40,2,00359,India
321294,2023-03-04,209,pepsi,75,100,25,2,00359,India
321294,2023-03-04,205,classic yogurt,45,60,15,2,00359,India
321294,2023-03-04,202,milk,12,27,15,1,00359,India
770376,2023-03-04,206,yakult,360,400,40,2,00376,India
176670,2023-03-04,207,coca cola,75,100,25,2,00190,India
176670,2023-03-04,211,red bull,90,125,35,2,00190,India
176670,2023-03-04,210,mountain dew,75,100,25,2,00190,India
119131,2023-03-04,211,red bull,90,125,35,2,00120,India
527254,2023-03-04,204,strawberry yogurt,50,60,10,2,00346,India
527254,2023-03-04,212,amul cheese,250,315,65,1,00346,India
527254,2023-03-04,206,yakult,360,400,40,2,00346,India
527254,2023-03-04,201,paneer,210,340,130,1,00346,India
177800,2023-03-04,210,mountain dew,75,100,25,2,00210,India
177800,2023-03-04,202,milk,12,27,15,1,00210,India
265012,2023-03-04,203,mango yogurt,50,60,10,2,00052,India
265012,2023-03-04,205,classic yogurt,45,60,15,2,00052,India
917961,2023-03-04,213,bisleri,6,15,9,2,00033,India
917961,2023-03-04,212,amul cheese,250,315,65,1,00033,India
917961,2023-03-04,204,strawberry yogurt,50,60,10,2,00033,India
917961,2023-03-04,210,mountain dew,75,100,25,2,00033,India
381929,2023-03-04,212,amul cheese,250,315,65,1,00140,India
381929,2023-03-04,201,paneer,210,340,130,1,00140,India
941205,2023-03-04,201,paneer,210,340,130,1,00171,India
547210,2023-03-04,203,mango yogurt,50,60,10,2,00226,India
547210,2023-03-04,209,pepsi,75,100,25,2,00226,India
547210,2023-03-04,211,red bull,90,125,35,2,00226,India
614114,2023-03-04,212,amul cheese,250,315,65,1,00137,India
614114,2023-03-04,204,strawberry yogurt,50,60,10,2,00137,India
614114,2023-03-04,213,bisleri,6,15,9,2,00137,India
313034,2023-03-04,205,classic yogurt,45,60,15,2,00200,India
143653,2023-03-04,212,amul cheese,250,315,65,1,00049,India
143653,2023-03-04,202,milk,12,27,15,1,00049,India
489764,2023-03-04,204,strawberry yogurt,50,60,10,2,00073,India
924367,2023-03-04,201,paneer,210,340,130,1,00342,India
835043,2023-03-04,204,strawberry yogurt,50,60,10,2,00086,India
835043,2023-03-04,201,paneer,210,340,130,1,00086,India
835043,2023-03-04,210,mountain dew,75,100,25,2,00086,India
835043,2023-03-04,203,mango yogurt,50,60,10,2,00086,India
628177,2023-03-04,208,sprite,75,100,25,2,00372,India
628177,2023-03-04,213,bisleri,6,15,9,2,00372,India
628177,2023-03-04,206,yakult,360,400,40,2,00372,India
628177,2023-03-04,207,coca cola,75,100,25,2,00372,India
599282,2023-03-04,212,amul cheese,250,315,65,1,00219,India
230764,2023-03-04,206,yakult,360,400,40,2,00147,India
173951,2023-03-04,209,pepsi,75,100,25,2,00271,India
173951,2023-03-04,213,bisleri,6,15,9,2,00271,India
173951,2023-03-04,212,amul cheese,250,315,65,1,00271,India
395205,2023-03-04,203,mango yogurt,50,60,10,2,00157,India
639751,2023-03-04,213,bisleri,6,15,9,2,00217,India
639751,2023-03-04,212,amul cheese,250,315,65,1,00217,India
639751,2023-03-04,206,yakult,360,400,40,2,00217,India
639751,2023-03-04,208,sprite,75,100,25,2,00217,India
638624,2023-03-04,205,classic yogurt,45,60,15,2,00050,India
638624,2023-03-04,213,bisleri,6,15,9,2,00050,India
638624,2023-03-04,206,yakult,360,400,40,2,00050,India
823885,2023-03-04,207,coca cola,75,100,25,2,00362,India
823885,2023-03-04,206,yakult,360,400,40,2,00362,India
823885,2023-03-04,202,milk,12,27,15,1,00362,India
805238,2023-03-04,204,strawberry yogurt,50,60,10,2,00480,India
805238,2023-03-04,201,paneer,210,340,130,1,00480,India
898145,2023-03-04,205,classic yogurt,45,60,15,2,00103,India
661913,2023-03-04,203,mango yogurt,50,60,10,2,00486,India
661913,2023-03-04,207,coca cola,75,100,25,2,00486,India
661913,2023-03-04,201,paneer,210,340,130,1,00486,India
661913,2023-03-04,206,yakult,360,400,40,2,00486,India
745572,2023-03-04,201,paneer,210,340,130,1,00421,India
745572,2023-03-04,204,strawberry yogurt,50,60,10,2,00421,India
745572,2023-03-04,211,red bull,90,125,35,2,00421,India
871338,2023-03-04,202,milk,12,27,15,1,00470,India
871338,2023-03-04,204,strawberry yogurt,50,60,10,2,00470,India
871338,2023-03-04,207,coca cola,75,100,25,2,00470,India
546571,2023-03-05,202,milk,12,27,15,1,00272,India
546571,2023-03-05,210,mountain dew,75,100,25,2,00272,India
546571,2023-03-05,208,sprite,75,100,25,2,00272,India
581033,2023-03-05,206,yakult,360,400,40,2,00068,India
581033,2023-03-05,209,pepsi,75,100,25,2,00068,India
581033,2023-03-05,205,classic yogurt,45,60,15,2,00068,India
581033,2023-03-05,202,milk,12,27,15,1,00068,India
758843,2023-03-05,213,bisleri,6,15,9,2,00025,India
758843,2023-03-05,205,classic yogurt,45,60,15,2,00025,India
758843,2023-03-05,202,milk,12,27,15,1,00025,India
997692,2023-03-05,209,pepsi,75,100,25,2,00195,India
807748,2023-03-05,212,amul cheese,250,315,65,1,00317,India
787836,2023-03-05,202,milk,12,27,15,1,00219,India
787836,2023-03-05,207,coca cola,75,100,25,2,00219,India
787836,2023-03-05,205,classic yogurt,45,60,15,2,00219,India
787836,2023-03-05,209,pepsi,75,100,25,2,00219,India
643217,2023-03-05,205,classic yogurt,45,60,15,2,00453,India
643217,2023-03-05,207,coca cola,75,100,25,2,00453,India
643217,2023-03-05,204,strawberry yogurt,50,60,10,2,00453,India
643217,2023-03-05,203,mango yogurt,50,60,10,2,00453,India
276157,2023-03-05,210,mountain dew,75,100,25,2,00040,India
276157,2023-03-05,207,coca cola,75,100,25,2,00040,India
276157,2023-03-05,206,yakult,360,400,40,2,00040,India
276157,2023-03-05,211,red bull,90,125,35,2,00040,India
722983,2023-03-05,213,bisleri,6,15,9,2,00388,India
722983,2023-03-05,206,yakult,360,400,40,2,00388,India
722983,2023-03-05,202,milk,12,27,15,1,00388,India
722983,2023-03-05,204,strawberry yogurt,50,60,10,2,00388,India
722983,2023-03-05,207,coca cola,75,100,25,2,00388,India
333130,2023-03-05,205,classic yogurt,45,60,15,2,00148,India
183829,2023-03-05,201,paneer,210,340,130,1,00086,India
183829,2023-03-05,209,pepsi,75,100,25,2,00086,India
972879,2023-03-05,206,yakult,360,400,40,2,00022,India
972879,2023-03-05,204,strawberry yogurt,50,60,10,2,00022,India
911717,2023-03-05,212,amul cheese,250,315,65,1,00243,India
911717,2023-03-05,201,paneer,210,340,130,1,00243,India
978725,2023-03-05,208,sprite,75,100,25,2,00370,India
978725,2023-03-05,207,coca cola,75,100,25,2,00370,India
978725,2023-03-05,202,milk,12,27,15,1,00370,India
345491,2023-03-05,207,coca cola,75,100,25,2,00384,India
974933,2023-03-05,206,yakult,360,400,40,2,00026,India
974933,2023-03-05,210,mountain dew,75,100,25,2,00026,India
808593,2023-03-05,203,mango yogurt,50,60,10,2,00080,India
180259,2023-03-05,202,milk,12,27,15,1,00194,India
180259,2023-03-05,203,mango yogurt,50,60,10,2,00194,India
274865,2023-03-05,210,mountain dew,75,100,25,2,00313,India
831646,2023-03-05,212,amul cheese,250,315,65,1,00230,India
893117,2023-03-05,202,milk,12,27,15,1,00298,India
893117,2023-03-05,201,paneer,210,340,130,1,00298,India
385884,2023-03-05,208,sprite,75,100,25,2,00181,India
385884,2023-03-05,211,red bull,90,125,35,2,00181,India
385884,2023-03-05,204,strawberry yogurt,50,60,10,2,00181,India
385884,2023-03-05,205,classic yogurt,45,60,15,2,00181,India
205736,2023-03-05,201,paneer,210,340,130,1,00440,India
205736,2023-03-05,213,bisleri,6,15,9,2,00440,India
205736,2023-03-05,203,mango yogurt,50,60,10,2,00440,India
255263,2023-03-05,207,coca cola,75,100,25,2,00013,India
255263,2023-03-05,202,milk,12,27,15,1,00013,India
255263,2023-03-05,201,paneer,210,340,130,1,00013,India
949469,2023-03-05,202,milk,12,27,15,1,00401,India
949469,2023-03-05,207,coca cola,75,100,25,2,00401,India
949469,2023-03-05,208,sprite,75,100,25,2,00401,India
949469,2023-03-05,210,mountain dew,75,100,25,2,00401,India
749935,2023-03-05,205,classic yogurt,45,60,15,2,00229,India
702844,2023-03-05,210,mountain dew,75,100,25,2,00021,India
285336,2023-03-05,204,strawberry yogurt,50,60,10,2,00410,India
285336,2023-03-05,202,milk,12,27,15,1,00410,India
749333,2023-03-05,204,strawberry yogurt,50,60,10,2,00372,India
891359,2023-03-05,212,amul cheese,250,315,65,1,00126,India
142160,2023-03-05,210,mountain dew,75,100,25,2,00306,India
142160,2023-03-05,205,classic yogurt,45,60,15,2,00306,India
490660,2023-03-05,209,pepsi,75,100,25,2,00135,India
490660,2023-03-05,204,strawberry yogurt,50,60,10,2,00135,India
983056,2023-03-05,206,yakult,360,400,40,2,00138,India
983056,2023-03-05,213,bisleri,6,15,9,2,00138,India
775171,2023-03-05,205,classic yogurt,45,60,15,2,00002,India
775171,2023-03-05,211,red bull,90,125,35,2,00002,India
775171,2023-03-05,202,milk,12,27,15,1,00002,India
775171,2023-03-05,204,strawberry yogurt,50,60,10,2,00002,India
787891,2023-03-05,205,classic yogurt,45,60,15,2,00381,India
787891,2023-03-05,206,yakult,360,400,40,2,00381,India
787891,2023-03-05,213,bisleri,6,15,9,2,00381,India
549747,2023-03-05,205,classic yogurt,45,60,15,2,00491,India
549747,2023-03-05,210,mountain dew,75,100,25,2,00491,India
549747,2023-03-05,208,sprite,75,100,25,2,00491,India
549747,2023-03-05,213,bisleri,6,15,9,2,00491,India
975226,2023-03-05,213,bisleri,6,15,9,2,00425,India
975226,2023-03-05,205,classic yogurt,45,60,15,2,00425,India
975226,2023-03-05,207,coca cola,75,100,25,2,00425,India
784284,2023-03-05,208,sprite,75,100,25,2,00012,India
784284,2023-03-05,201,paneer,210,340,130,1,00012,India
784284,2023-03-05,206,yakult,360,400,40,2,00012,India
784284,2023-03-05,202,milk,12,27,15,1,00012,India
429555,2023-03-05,202,milk,12,27,15,1,00155,India
429555,2023-03-05,207,coca cola,75,100,25,2,00155,India
429555,2023-03-05,201,paneer,210,340,130,1,00155,India
486788,2023-03-05,206,yakult,360,400,40,2,00050,India
486788,2023-03-05,203,mango yogurt,50,60,10,2,00050,India
879540,2023-03-05,201,paneer,210,340,130,1,00270,India
371545,2023-03-05,206,yakult,360,400,40,2,00192,India
258986,2023-03-05,206,yakult,360,400,40,2,00022,India
258986,2023-03-05,213,bisleri,6,15,9,2,00022,India
258986,2023-03-05,202,milk,12,27,15,1,00022,India
336066,2023-03-05,212,amul cheese,250,315,65,1,00048,India
129763,2023-03-05,211,red bull,90,125,35,2,00143,India
306949,2023-03-05,211,red bull,90,125,35,2,00129,India
306949,2023-03-05,209,pepsi,75,100,25,2,00129,India
306949,2023-03-05,203,mango yogurt,50,60,10,2,00129,India
306949,2023-03-05,206,yakult,360,400,40,2,00129,India
222922,2023-03-05,213,bisleri,6,15,9,2,00373,India
222922,2023-03-05,212,amul cheese,250,315,65,1,00373,India
369344,2023-03-05,209,pepsi,75,100,25,2,00470,India
369344,2023-03-05,202,milk,12,27,15,1,00470,India
369344,2023-03-05,207,coca cola,75,100,25,2,00470,India
421821,2023-03-05,203,mango yogurt,50,60,10,2,00401,India
421821,2023-03-05,211,red bull,90,125,35,2,00401,India
725832,2023-03-05,211,red bull,90,125,35,2,00366,India
346063,2023-03-05,208,sprite,75,100,25,2,00285,India
346063,2023-03-05,207,coca cola,75,100,25,2,00285,India
346063,2023-03-05,211,red bull,90,125,35,2,00285,India
866931,2023-03-05,207,coca cola,75,100,25,2,00203,India
866931,2023-03-05,204,strawberry yogurt,50,60,10,2,00203,India
273501,2023-03-05,209,pepsi,75,100,25,2,00484,India
273501,2023-03-05,212,amul cheese,250,315,65,1,00484,India
663819,2023-03-05,213,bisleri,6,15,9,2,00300,India
663819,2023-03-05,208,sprite,75,100,25,2,00300,India
295558,2023-03-05,205,classic yogurt,45,60,15,2,00301,India
410780,2023-03-05,211,red bull,90,125,35,2,00124,India
410780,2023-03-05,205,classic yogurt,45,60,15,2,00124,India
410780,2023-03-05,212,amul cheese,250,315,65,1,00124,India
410780,2023-03-05,203,mango yogurt,50,60,10,2,00124,India
535098,2023-03-05,213,bisleri,6,15,9,2,00196,India
535098,2023-03-05,204,strawberry yogurt,50,60,10,2,00196,India
535098,2023-03-05,201,paneer,210,340,130,1,00196,India
399480,2023-03-05,207,coca cola,75,100,25,2,00433,India
399480,2023-03-05,202,milk,12,27,15,1,00433,India
399480,2023-03-05,208,sprite,75,100,25,2,00433,India
399480,2023-03-05,210,mountain dew,75,100,25,2,00433,India
276621,2023-03-05,206,yakult,360,400,40,2,00466,India
276621,2023-03-05,211,red bull,90,125,35,2,00466,India
276621,2023-03-05,209,pepsi,75,100,25,2,00466,India
276621,2023-03-05,208,sprite,75,100,25,2,00466,India
195431,2023-03-06,211,red bull,90,125,35,2,00341,India
950131,2023-03-06,202,milk,12,27,15,1,00204,India
950131,2023-03-06,213,bisleri,6,15,9,2,00204,India
358198,2023-03-06,206,yakult,360,400,40,2,00436,India
358198,2023-03-06,213,bisleri,6,15,9,2,00436,India
358198,2023-03-06,204,strawberry yogurt,50,60,10,2,00436,India
734453,2023-03-06,210,mountain dew,75,100,25,2,00369,India
734453,2023-03-06,207,coca cola,75,100,25,2,00369,India
734453,2023-03-06,206,yakult,360,400,40,2,00369,India
734453,2023-03-06,211,red bull,90,125,35,2,00369,India
734453,2023-03-06,212,amul cheese,250,315,65,1,00369,India
885239,2023-03-06,210,mountain dew,75,100,25,2,00265,India
429400,2023-03-06,204,strawberry yogurt,50,60,10,2,00223,India
429400,2023-03-06,209,pepsi,75,100,25,2,00223,India
768698,2023-03-06,212,amul cheese,250,315,65,1,00350,India
768698,2023-03-06,204,strawberry yogurt,50,60,10,2,00350,India
768698,2023-03-06,211,red bull,90,125,35,2,00350,India
524874,2023-03-06,204,strawberry yogurt,50,60,10,2,00422,India
687633,2023-03-06,212,amul cheese,250,315,65,1,00246,India
687633,2023-03-06,206,yakult,360,400,40,2,00246,India
716814,2023-03-06,212,amul cheese,250,315,65,1,00368,India
362573,2023-03-06,207,coca cola,75,100,25,2,00113,India
362573,2023-03-06,210,mountain dew,75,100,25,2,00113,India
362573,2023-03-06,213,bisleri,6,15,9,2,00113,India
842191,2023-03-06,201,paneer,210,340,130,1,00208,India
842191,2023-03-06,206,yakult,360,400,40,2,00208,India
842191,2023-03-06,203,mango yogurt,50,60,10,2,00208,India
842191,2023-03-06,210,mountain dew,75,100,25,2,00208,India
842191,2023-03-06,211,red bull,90,125,35,2,00208,India
839207,2023-03-06,208,sprite,75,100,25,2,00143,India
839207,2023-03-06,201,paneer,210,340,130,1,00143,India
628530,2023-03-06,201,paneer,210,340,130,1,00225,India
628530,2023-03-06,204,strawberry yogurt,50,60,10,2,00225,India
628530,2023-03-06,203,mango yogurt,50,60,10,2,00225,India
628530,2023-03-06,206,yakult,360,400,40,2,00225,India
364516,2023-03-06,207,coca cola,75,100,25,2,00434,India
364516,2023-03-06,211,red bull,90,125,35,2,00434,India
814172,2023-03-06,206,yakult,360,400,40,2,00223,India
814172,2023-03-06,204,strawberry yogurt,50,60,10,2,00223,India
288214,2023-03-06,204,strawberry yogurt,50,60,10,2,00450,India
288214,2023-03-06,212,amul cheese,250,315,65,1,00450,India
288214,2023-03-06,211,red bull,90,125,35,2,00450,India
288214,2023-03-06,209,pepsi,75,100,25,2,00450,India
288214,2023-03-06,213,bisleri,6,15,9,2,00450,India
900538,2023-03-06,211,red bull,90,125,35,2,00462,India
900538,2023-03-06,201,paneer,210,340,130,1,00462,India
685882,2023-03-06,212,amul cheese,250,315,65,1,00455,India
685882,2023-03-06,202,milk,12,27,15,1,00455,India
685882,2023-03-06,208,sprite,75,100,25,2,00455,India
685882,2023-03-06,209,pepsi,75,100,25,2,00455,India
169512,2023-03-06,206,yakult,360,400,40,2,00499,India
413995,2023-03-06,201,paneer,210,340,130,1,00213,India
413995,2023-03-06,206,yakult,360,400,40,2,00213,India
391445,2023-03-06,211,red bull,90,125,35,2,00428,India
391445,2023-03-06,207,coca cola,75,100,25,2,00428,India
635965,2023-03-06,207,coca cola,75,100,25,2,00056,India
635965,2023-03-06,211,red bull,90,125,35,2,00056,India
635965,2023-03-06,201,paneer,210,340,130,1,00056,India
635965,2023-03-06,210,mountain dew,75,100,25,2,00056,India
635965,2023-03-06,202,milk,12,27,15,1,00056,India
717842,2023-03-06,203,mango yogurt,50,60,10,2,00138,India
950110,2023-03-06,203,mango yogurt,50,60,10,2,00028,India
950110,2023-03-06,208,sprite,75,100,25,2,00028,India
950110,2023-03-06,202,milk,12,27,15,1,00028,India
950110,2023-03-06,201,paneer,210,340,130,1,00028,India
950110,2023-03-06,207,coca cola,75,100,25,2,00028,India
607347,2023-03-06,213,bisleri,6,15,9,2,00144,India
424964,2023-03-06,201,paneer,210,340,130,1,00176,India
236948,2023-03-06,203,mango yogurt,50,60,10,2,00072,India
236948,2023-03-06,208,sprite,75,100,25,2,00072,India
236948,2023-03-06,212,amul cheese,250,315,65,1,00072,India
676402,2023-03-06,209,pepsi,75,100,25,2,00133,India
676402,2023-03-06,203,mango yogurt,50,60,10,2,00133,India
676402,2023-03-06,208,sprite,75,100,25,2,00133,India
799663,2023-03-06,213,bisleri,6,15,9,2,00360,India
799663,2023-03-06,205,classic yogurt,45,60,15,2,00360,India
799663,2023-03-06,206,yakult,360,400,40,2,00360,India
992769,2023-03-06,208,sprite,75,100,25,2,00282,India
448503,2023-03-06,202,milk,12,27,15,1,00223,India
182754,2023-03-06,212,amul cheese,250,315,65,1,00031,India
287326,2023-03-06,209,pepsi,75,100,25,2,00182,India
287326,2023-03-06,212,amul cheese,250,315,65,1,00182,India
287326,2023-03-06,210,mountain dew,75,100,25,2,00182,India
368001,2023-03-06,205,classic yogurt,45,60,15,2,00227,India
612958,2023-03-06,211,red bull,90,125,35,2,00199,India
612958,2023-03-06,207,coca cola,75,100,25,2,00199,India
612958,2023-03-06,213,bisleri,6,15,9,2,00199,India
365905,2023-03-06,209,pepsi,75,100,25,2,00381,India
365905,2023-03-06,211,red bull,90,125,35,2,00381,India
126097,2023-03-06,203,mango yogurt,50,60,10,2,00002,India
126097,2023-03-06,209,pepsi,75,100,25,2,00002,India
126097,2023-03-06,207,coca cola,75,100,25,2,00002,India
143890,2023-03-06,212,amul cheese,250,315,65,1,00307,India
143890,2023-03-06,210,mountain dew,75,100,25,2,00307,India
143890,2023-03-06,208,sprite,75,100,25,2,00307,India
143890,2023-03-06,209,pepsi,75,100,25,2,00307,India
991552,2023-03-06,211,red bull,90,125,35,2,00100,India
991552,2023-03-06,201,paneer,210,340,130,1,00100,India
991552,2023-03-06,206,yakult,360,400,40,2,00100,India
539156,2023-03-06,204,strawberry yogurt,50,60,10,2,00449,India
539156,2023-03-06,213,bisleri,6,15,9,2,00449,India
539156,2023-03-06,207,coca cola,75,100,25,2,00449,India
322104,2023-03-06,208,sprite,75,100,25,2,00162,India
322104,2023-03-06,210,mountain dew,75,100,25,2,00162,India
322104,2023-03-06,205,classic yogurt,45,60,15,2,00162,India
270671,2023-03-06,207,coca cola,75,100,25,2,00326,India
270671,2023-03-06,209,pepsi,75,100,25,2,00326,India
270671,2023-03-06,203,mango yogurt,50,60,10,2,00326,India
921167,2023-03-06,207,coca cola,75,100,25,2,00283,India
921167,2023-03-06,201,paneer,210,340,130,1,00283,India
877655,2023-03-06,201,paneer,210,340,130,1,00064,India
376537,2023-03-06,210,mountain dew,75,100,25,2,00486,India
722696,2023-03-06,206,yakult,360,400,40,2,00158,India
861039,2023-03-06,204,strawberry yogurt,50,60,10,2,00280,India
247911,2023-03-06,208,sprite,75,100,25,2,00078,India
247911,2023-03-06,210,mountain dew,75,100,25,2,00078,India
247911,2023-03-06,206,yakult,360,400,40,2,00078,India
766484,2023-03-06,206,yakult,360,400,40,2,00378,India
766484,2023-03-06,213,bisleri,6,15,9,2,00378,India
376759,2023-03-06,212,amul cheese,250,315,65,1,00234,India
376759,2023-03-06,211,red bull,90,125,35,2,00234,India
376759,2023-03-06,213,bisleri,6,15,9,2,00234,India
323372,2023-03-06,204,strawberry yogurt,50,60,10,2,00252,India
692609,2023-03-06,213,bisleri,6,15,9,2,00059,India
692609,2023-03-06,209,pepsi,75,100,25,2,00059,India
692609,2023-03-06,211,red bull,90,125,35,2,00059,India
291265,2023-03-06,210,mountain dew,75,100,25,2,00366,India
291265,2023-03-06,207,coca cola,75,100,25,2,00366,India
291265,2023-03-06,213,bisleri,6,15,9,2,00366,India
111800,2023-03-06,211,red bull,90,125,35,2,00080,India
111800,2023-03-06,208,sprite,75,100,25,2,00080,India
469155,2023-03-07,201,paneer,210,340,130,1,00140,India
469155,2023-03-07,205,classic yogurt,45,60,15,2,00140,India
469155,2023-03-07,209,pepsi,75,100,25,2,00140,India
258062,2023-03-07,213,bisleri,6,15,9,2,00362,India
258062,2023-03-07,210,mountain dew,75,100,25,2,00362,India
258062,2023-03-07,205,classic yogurt,45,60,15,2,00362,India
258062,2023-03-07,211,red bull,90,125,35,2,00362,India
767752,2023-03-07,205,classic yogurt,45,60,15,2,00104,India
767752,2023-03-07,210,mountain dew,75,100,25,2,00104,India
767752,2023-03-07,202,milk,12,27,15,1,00104,India
799229,2023-03-07,203,mango yogurt,50,60,10,2,00075,India
711030,2023-03-07,202,milk,12,27,15,1,00138,India
711030,2023-03-07,209,pepsi,75,100,25,2,00138,India
711030,2023-03-07,203,mango yogurt,50,60,10,2,00138,India
711030,2023-03-07,213,bisleri,6,15,9,2,00138,India
941328,2023-03-07,211,red bull,90,125,35,2,00101,India
941328,2023-03-07,210,mountain dew,75,100,25,2,00101,India
941328,2023-03-07,205,classic yogurt,45,60,15,2,00101,India
941328,2023-03-07,207,coca cola,75,100,25,2,00101,India
666756,2023-03-07,204,strawberry yogurt,50,60,10,2,00185,India
666756,2023-03-07,213,bisleri,6,15,9,2,00185,India
666756,2023-03-07,206,yakult,360,400,40,2,00185,India
338692,2023-03-07,203,mango yogurt,50,60,10,2,00310,India
338692,2023-03-07,212,amul cheese,250,315,65,1,00310,India
463680,2023-03-07,208,sprite,75,100,25,2,00264,India
463680,2023-03-07,211,red bull,90,125,35,2,00264,India
463680,2023-03-07,204,strawberry yogurt,50,60,10,2,00264,India
463680,2023-03-07,202,milk,12,27,15,1,00264,India
550409,2023-03-07,206,yakult,360,400,40,2,00456,India
550409,2023-03-07,202,milk,12,27,15,1,00456,India
550409,2023-03-07,208,sprite,75,100,25,2,00456,India
550409,2023-03-07,205,classic yogurt,45,60,15,2,00456,India
910881,2023-03-07,213,bisleri,6,15,9,2,00078,India
910881,2023-03-07,202,milk,12,27,15,1,00078,India
910881,2023-03-07,208,sprite,75,100,25,2,00078,India
795241,2023-03-07,208,sprite,75,100,25,2,00370,India
795241,2023-03-07,207,coca cola,75,100,25,2,00370,India
297289,2023-03-07,209,pepsi,75,100,25,2,00127,India
297289,2023-03-07,203,mango yogurt,50,60,10,2,00127,India
297289,2023-03-07,201,paneer,210,340,130,1,00127,India
297289,2023-03-07,207,coca cola,75,100,25,2,00127,India
403034,2023-03-07,205,classic yogurt,45,60,15,2,00239,India
403034,2023-03-07,211,red bull,90,125,35,2,00239,India
722031,2023-03-07,211,red bull,90,125,35,2,00461,India
722031,2023-03-07,203,mango yogurt,50,60,10,2,00461,India
722031,2023-03-07,202,milk,12,27,15,1,00461,India
155655,2023-03-07,205,classic yogurt,45,60,15,2,00410,India
155655,2023-03-07,213,bisleri,6,15,9,2,00410,India
155655,2023-03-07,207,coca cola,75,100,25,2,00410,India
258825,2023-03-07,208,sprite,75,100,25,2,00370,India
724921,2023-03-07,202,milk,12,27,15,1,00199,India
724921,2023-03-07,213,bisleri,6,15,9,2,00199,India
724921,2023-03-07,206,yakult,360,400,40,2,00199,India
902889,2023-03-07,202,milk,12,27,15,1,00472,India
902889,2023-03-07,208,sprite,75,100,25,2,00472,India
902889,2023-03-07,205,classic yogurt,45,60,15,2,00472,India
902889,2023-03-07,213,bisleri,6,15,9,2,00472,India
920251,2023-03-07,204,strawberry yogurt,50,60,10,2,00493,India
920251,2023-03-07,201,paneer,210,340,130,1,00493,India
920251,2023-03-07,208,sprite,75,100,25,2,00493,India
920251,2023-03-07,203,mango yogurt,50,60,10,2,00493,India
743801,2023-03-07,201,paneer,210,340,130,1,00061,India
743801,2023-03-07,210,mountain dew,75,100,25,2,00061,India
743801,2023-03-07,212,amul cheese,250,315,65,1,00061,India
743801,2023-03-07,202,milk,12,27,15,1,00061,India
435530,2023-03-07,202,milk,12,27,15,1,00322,India
813627,2023-03-07,204,strawberry yogurt,50,60,10,2,00363,India
813627,2023-03-07,203,mango yogurt,50,60,10,2,00363,India
299856,2023-03-07,206,yakult,360,400,40,2,00014,India
299856,2023-03-07,204,strawberry yogurt,50,60,10,2,00014,India
299856,2023-03-07,203,mango yogurt,50,60,10,2,00014,India
446114,2023-03-07,210,mountain dew,75,100,25,2,00253,India
446114,2023-03-07,207,coca cola,75,100,25,2,00253,India
306700,2023-03-07,204,strawberry yogurt,50,60,10,2,00211,India
213056,2023-03-07,207,coca cola,75,100,25,2,00309,India
213056,2023-03-07,210,mountain dew,75,100,25,2,00309,India
847207,2023-03-07,213,bisleri,6,15,9,2,00155,India
847207,2023-03-07,209,pepsi,75,100,25,2,00155,India
847207,2023-03-07,205,classic yogurt,45,60,15,2,00155,India
847207,2023-03-07,208,sprite,75,100,25,2,00155,India
354978,2023-03-07,209,pepsi,75,100,25,2,00352,India
340617,2023-03-07,204,strawberry yogurt,50,60,10,2,00429,India
340617,2023-03-07,213,bisleri,6,15,9,2,00429,India
506312,2023-03-07,212,amul cheese,250,315,65,1,00314,India
220098,2023-03-07,211,red bull,90,125,35,2,00369,India
220098,2023-03-07,204,strawberry yogurt,50,60,10,2,00369,India
220098,2023-03-07,208,sprite,75,100,25,2,00369,India
173252,2023-03-07,208,sprite,75,100,25,2,00027,India
623482,2023-03-07,203,mango yogurt,50,60,10,2,00422,India
940687,2023-03-07,204,strawberry yogurt,50,60,10,2,00419,India
940687,2023-03-07,202,milk,12,27,15,1,00419,India
940687,2023-03-07,207,coca cola,75,100,25,2,00419,India
530363,2023-03-07,204,strawberry yogurt,50,60,10,2,00472,India
530363,2023-03-07,201,paneer,210,340,130,1,00472,India
813691,2023-03-07,205,classic yogurt,45,60,15,2,00272,India
813691,2023-03-07,206,yakult,360,400,40,2,00272,India
813691,2023-03-07,203,mango yogurt,50,60,10,2,00272,India
813691,2023-03-07,210,mountain dew,75,100,25,2,00272,India
442500,2023-03-07,211,red bull,90,125,35,2,00230,India
442500,2023-03-07,209,pepsi,75,100,25,2,00230,India
442500,2023-03-07,208,sprite,75,100,25,2,00230,India
442500,2023-03-07,206,yakult,360,400,40,2,00230,India
307483,2023-03-07,201,paneer,210,340,130,1,00124,India
531331,2023-03-07,209,pepsi,75,100,25,2,00473,India
531331,2023-03-07,205,classic yogurt,45,60,15,2,00473,India
531331,2023-03-07,207,coca cola,75,100,25,2,00473,India
531331,2023-03-07,211,red bull,90,125,35,2,00473,India
531331,2023-03-07,201,paneer,210,340,130,1,00473,India
610284,2023-03-07,202,milk,12,27,15,1,00150,India
610284,2023-03-07,209,pepsi,75,100,25,2,00150,India
610284,2023-03-07,208,sprite,75,100,25,2,00150,India
593794,2023-03-07,204,strawberry yogurt,50,60,10,2,00199,India
593794,2023-03-07,211,red bull,90,125,35,2,00199,India
219387,2023-03-07,209,pepsi,75,100,25,2,00282,India
219387,2023-03-07,204,strawberry yogurt,50,60,10,2,00282,India
219387,2023-03-07,208,sprite,75,100,25,2,00282,India
219387,2023-03-07,207,coca cola,75,100,25,2,00282,India
219387,2023-03-07,205,classic yogurt,45,60,15,2,00282,India
759871,2023-03-07,213,bisleri,6,15,9,2,00168,India
759871,2023-03-07,201,paneer,210,340,130,1,00168,India
759871,2023-03-07,212,amul cheese,250,315,65,1,00168,India
759871,2023-03-07,210,mountain dew,75,100,25,2,00168,India
759871,2023-03-07,202,milk,12,27,15,1,00168,India
115362,2023-03-07,203,mango yogurt,50,60,10,2,00108,India
115362,2023-03-07,201,paneer,210,340,130,1,00108,India
115362,2023-03-07,212,amul cheese,250,315,65,1,00108,India
115362,2023-03-07,211,red bull,90,125,35,2,00108,India
115362,2023-03-07,204,strawberry yogurt,50,60,10,2,00108,India
974159,2023-03-07,202,milk,12,27,15,1,00205,India
974159,2023-03-07,209,pepsi,75,100,25,2,00205,India
974159,2023-03-07,205,classic yogurt,45,60,15,2,00205,India
974159,2023-03-07,213,bisleri,6,15,9,2,00205,India
161094,2023-03-07,208,sprite,75,100,25,2,00186,India
161094,2023-03-07,212,amul cheese,250,315,65,1,00186,India
161094,2023-03-07,203,mango yogurt,50,60,10,2,00186,India
902915,2023-03-07,211,red bull,90,125,35,2,00316,India
902915,2023-03-07,203,mango yogurt,50,60,10,2,00316,India
902915,2023-03-07,207,coca cola,75,100,25,2,00316,India
607132,2023-03-07,205,classic yogurt,45,60,15,2,00246,India
807790,2023-03-07,209,pepsi,75,100,25,2,00412,India
807790,2023-03-07,213,bisleri,6,15,9,2,00412,India
807790,2023-03-07,203,mango yogurt,50,60,10,2,00412,India
580735,2023-03-07,205,classic yogurt,45,60,15,2,00413,India
580735,2023-03-07,212,amul cheese,250,315,65,1,00413,India
580735,2023-03-07,201,paneer,210,340,130,1,00413,India
580735,2023-03-07,207,coca cola,75,100,25,2,00413,India
272977,2023-03-07,206,yakult,360,400,40,2,00090,India
272977,2023-03-07,202,milk,12,27,15,1,00090,India
344327,2023-03-07,205,classic yogurt,45,60,15,2,00106,India
344327,2023-03-07,203,mango yogurt,50,60,10,2,00106,India
344327,2023-03-07,202,milk,12,27,15,1,00106,India
222472,2023-03-07,213,bisleri,6,15,9,2,00167,India
611745,2023-03-07,212,amul cheese,250,315,65,1,00308,India
611745,2023-03-07,207,coca cola,75,100,25,2,00308,India
611745,2023-03-07,203,mango yogurt,50,60,10,2,00308,India
601546,2023-03-07,210,mountain dew,75,100,25,2,00276,India
601546,2023-03-07,209,pepsi,75,100,25,2,00276,India
601546,2023-03-07,207,coca cola,75,100,25,2,00276,India
601546,2023-03-07,203,mango yogurt,50,60,10,2,00276,India
784849,2023-03-07,204,strawberry yogurt,50,60,10,2,00373,India
784849,2023-03-07,206,yakult,360,400,40,2,00373,India
784849,2023-03-07,207,coca cola,75,100,25,2,00373,India
784849,2023-03-07,202,milk,12,27,15,1,00373,India
442058,2023-03-07,206,yakult,360,400,40,2,00428,India
442058,2023-03-07,209,pepsi,75,100,25,2,00428,India
823062,2023-03-07,213,bisleri,6,15,9,2,00269,India
823062,2023-03-07,212,amul cheese,250,315,65,1,00269,India
823062,2023-03-07,208,sprite,75,100,25,2,00269,India
998096,2023-03-07,206,yakult,360,400,40,2,00144,India
412741,2023-03-07,204,strawberry yogurt,50,60,10,2,00393,India
412741,2023-03-07,203,mango yogurt,50,60,10,2,00393,India
412741,2023-03-07,206,yakult,360,400,40,2,00393,India
436550,2023-03-08,210,mountain dew,75,100,25,2,00210,India
436550,2023-03-08,201,paneer,210,340,130,1,00210,India
442993,2023-03-08,201,paneer,210,340,130,1,00292,India
442993,2023-03-08,210,mountain dew,75,100,25,2,00292,India
442993,2023-03-08,207,coca cola,75,100,25,2,00292,India
902392,2023-03-08,212,amul cheese,250,315,65,1,00455,India
996649,2023-03-08,209,pepsi,75,100,25,2,00046,India
996649,2023-03-08,202,milk,12,27,15,1,00046,India
823283,2023-03-08,213,bisleri,6,15,9,2,00387,India
823283,2023-03-08,203,mango yogurt,50,60,10,2,00387,India
651895,2023-03-08,203,mango yogurt,50,60,10,2,00400,India
651895,2023-03-08,205,classic yogurt,45,60,15,2,00400,India
651895,2023-03-08,201,paneer,210,340,130,1,00400,India
651895,2023-03-08,206,yakult,360,400,40,2,00400,India
417892,2023-03-08,210,mountain dew,75,100,25,2,00354,India
417892,2023-03-08,203,mango yogurt,50,60,10,2,00354,India
417892,2023-03-08,206,yakult,360,400,40,2,00354,India
789230,2023-03-08,201,paneer,210,340,130,1,00097,India
789230,2023-03-08,209,pepsi,75,100,25,2,00097,India
789230,2023-03-08,205,classic yogurt,45,60,15,2,00097,India
789230,2023-03-08,204,strawberry yogurt,50,60,10,2,00097,India
789230,2023-03-08,206,yakult,360,400,40,2,00097,India
721517,2023-03-08,202,milk,12,27,15,1,00140,India
721517,2023-03-08,206,yakult,360,400,40,2,00140,India
721517,2023-03-08,210,mountain dew,75,100,25,2,00140,India
912621,2023-03-08,209,pepsi,75,100,25,2,00093,India
912621,2023-03-08,206,yakult,360,400,40,2,00093,India
912621,2023-03-08,204,strawberry yogurt,50,60,10,2,00093,India
442219,2023-03-08,208,sprite,75,100,25,2,00465,India
442219,2023-03-08,209,pepsi,75,100,25,2,00465,India
442219,2023-03-08,206,yakult,360,400,40,2,00465,India
972698,2023-03-08,212,amul cheese,250,315,65,1,00108,India
327974,2023-03-08,209,pepsi,75,100,25,2,00176,India
470841,2023-03-08,207,coca cola,75,100,25,2,00465,India
470841,2023-03-08,213,bisleri,6,15,9,2,00465,India
470841,2023-03-08,211,red bull,90,125,35,2,00465,India
653496,2023-03-08,205,classic yogurt,45,60,15,2,00416,India
653496,2023-03-08,207,coca cola,75,100,25,2,00416,India
131459,2023-03-08,203,mango yogurt,50,60,10,2,00023,India
131459,2023-03-08,209,pepsi,75,100,25,2,00023,India
640918,2023-03-08,202,milk,12,27,15,1,00319,India
640918,2023-03-08,210,mountain dew,75,100,25,2,00319,India
120610,2023-03-08,203,mango yogurt,50,60,10,2,00485,India
120610,2023-03-08,202,milk,12,27,15,1,00485,India
120610,2023-03-08,205,classic yogurt,45,60,15,2,00485,India
120610,2023-03-08,210,mountain dew,75,100,25,2,00485,India
811492,2023-03-08,211,red bull,90,125,35,2,00386,India
811492,2023-03-08,210,mountain dew,75,100,25,2,00386,India
173987,2023-03-08,208,sprite,75,100,25,2,00248,India
173987,2023-03-08,204,strawberry yogurt,50,60,10,2,00248,India
173987,2023-03-08,201,paneer,210,340,130,1,00248,India
173987,2023-03-08,213,bisleri,6,15,9,2,00248,India
246059,2023-03-08,205,classic yogurt,45,60,15,2,00238,India
246059,2023-03-08,212,amul cheese,250,315,65,1,00238,India
246059,2023-03-08,208,sprite,75,100,25,2,00238,India
246059,2023-03-08,213,bisleri,6,15,9,2,00238,India
246059,2023-03-08,201,paneer,210,340,130,1,00238,India
772503,2023-03-08,202,milk,12,27,15,1,00164,India
772503,2023-03-08,208,sprite,75,100,25,2,00164,India
772503,2023-03-08,207,coca cola,75,100,25,2,00164,India
630170,2023-03-08,207,coca cola,75,100,25,2,00002,India
630170,2023-03-08,201,paneer,210,340,130,1,00002,India
411138,2023-03-08,210,mountain dew,75,100,25,2,00159,India
411138,2023-03-08,206,yakult,360,400,40,2,00159,India
411138,2023-03-08,209,pepsi,75,100,25,2,00159,India
411138,2023-03-08,207,coca cola,75,100,25,2,00159,India
307964,2023-03-08,207,coca cola,75,100,25,2,00059,India
307964,2023-03-08,211,red bull,90,125,35,2,00059,India
307964,2023-03-08,203,mango yogurt,50,60,10,2,00059,India
387046,2023-03-08,213,bisleri,6,15,9,2,00252,India
387046,2023-03-08,204,strawberry yogurt,50,60,10,2,00252,India
387046,2023-03-08,206,yakult,360,400,40,2,00252,India
529334,2023-03-08,207,coca cola,75,100,25,2,00425,India
186379,2023-03-08,209,pepsi,75,100,25,2,00218,India
186379,2023-03-08,204,strawberry yogurt,50,60,10,2,00218,India
186379,2023-03-08,213,bisleri,6,15,9,2,00218,India
186379,2023-03-08,206,yakult,360,400,40,2,00218,India
350128,2023-03-08,206,yakult,360,400,40,2,00120,India
350128,2023-03-08,207,coca cola,75,100,25,2,00120,India
742722,2023-03-08,202,milk,12,27,15,1,00425,India
742722,2023-03-08,211,red bull,90,125,35,2,00425,India
742722,2023-03-08,203,mango yogurt,50,60,10,2,00425,India
206652,2023-03-08,209,pepsi,75,100,25,2,00405,India
206652,2023-03-08,206,yakult,360,400,40,2,00405,India
206652,2023-03-08,202,milk,12,27,15,1,00405,India
341939,2023-03-08,203,mango yogurt,50,60,10,2,00378,India
341939,2023-03-08,202,milk,12,27,15,1,00378,India
364604,2023-03-08,208,sprite,75,100,25,2,00004,India
364604,2023-03-08,213,bisleri,6,15,9,2,00004,India
151129,2023-03-08,203,mango yogurt,50,60,10,2,00047,India
151129,2023-03-08,208,sprite,75,100,25,2,00047,India
151129,2023-03-08,209,pepsi,75,100,25,2,00047,India
880327,2023-03-08,208,sprite,75,100,25,2,00409,India
880327,2023-03-08,203,mango yogurt,50,60,10,2,00409,India
880327,2023-03-08,206,yakult,360,400,40,2,00409,India
880327,2023-03-08,201,paneer,210,340,130,1,00409,India
880327,2023-03-08,209,pepsi,75,100,25,2,00409,India
503138,2023-03-08,207,coca cola,75,100,25,2,00407,India
503138,2023-03-08,203,mango yogurt,50,60,10,2,00407,India
503138,2023-03-08,212,amul cheese,250,315,65,1,00407,India
377036,2023-03-08,207,coca cola,75,100,25,2,00015,India
377036,2023-03-08,212,amul cheese,250,315,65,1,00015,India
580729,2023-03-08,209,pepsi,75,100,25,2,00256,India
580729,2023-03-08,201,paneer,210,340,130,1,00256,India
580729,2023-03-08,206,yakult,360,400,40,2,00256,India
241827,2023-03-08,206,yakult,360,400,40,2,00313,India
241827,2023-03-08,201,paneer,210,340,130,1,00313,India
241827,2023-03-08,205,classic yogurt,45,60,15,2,00313,India
241827,2023-03-08,211,red bull,90,125,35,2,00313,India
807090,2023-03-08,204,strawberry yogurt,50,60,10,2,00217,India
807090,2023-03-08,209,pepsi,75,100,25,2,00217,India
765470,2023-03-08,204,strawberry yogurt,50,60,10,2,00018,India
765470,2023-03-08,208,sprite,75,100,25,2,00018,India
765470,2023-03-08,203,mango yogurt,50,60,10,2,00018,India
181959,2023-03-08,205,classic yogurt,45,60,15,2,00169,India
181959,2023-03-08,212,amul cheese,250,315,65,1,00169,India
181959,2023-03-08,202,milk,12,27,15,1,00169,India
181959,2023-03-08,210,mountain dew,75,100,25,2,00169,India
181959,2023-03-08,204,strawberry yogurt,50,60,10,2,00169,India
544555,2023-03-08,201,paneer,210,340,130,1,00119,India
544555,2023-03-08,205,classic yogurt,45,60,15,2,00119,India
544555,2023-03-08,202,milk,12,27,15,1,00119,India
544555,2023-03-08,203,mango yogurt,50,60,10,2,00119,India
132175,2023-03-08,204,strawberry yogurt,50,60,10,2,00346,India
132175,2023-03-08,213,bisleri,6,15,9,2,00346,India
132175,2023-03-08,206,yakult,360,400,40,2,00346,India
132175,2023-03-08,202,milk,12,27,15,1,00346,India
132175,2023-03-08,201,paneer,210,340,130,1,00346,India
239202,2023-03-08,210,mountain dew,75,100,25,2,00398,India
239202,2023-03-08,202,milk,12,27,15,1,00398,India
239202,2023-03-08,211,red bull,90,125,35,2,00398,India
330295,2023-03-08,213,bisleri,6,15,9,2,00379,India
330295,2023-03-08,206,yakult,360,400,40,2,00379,India
330295,2023-03-08,203,mango yogurt,50,60,10,2,00379,India
369896,2023-03-08,208,sprite,75,100,25,2,00041,India
369896,2023-03-08,203,mango yogurt,50,60,10,2,00041,India
369896,2023-03-08,209,pepsi,75,100,25,2,00041,India
465164,2023-03-08,208,sprite,75,100,25,2,00402,India
465164,2023-03-08,201,paneer,210,340,130,1,00402,India
465164,2023-03-08,213,bisleri,6,15,9,2,00402,India
465164,2023-03-08,212,amul cheese,250,315,65,1,00402,India
465164,2023-03-08,207,coca cola,75,100,25,2,00402,India
916833,2023-03-08,208,sprite,75,100,25,2,00369,India
916833,2023-03-08,209,pepsi,75,100,25,2,00369,India
916833,2023-03-08,206,yakult,360,400,40,2,00369,India
392344,2023-03-08,210,mountain dew,75,100,25,2,00073,India
392344,2023-03-08,206,yakult,360,400,40,2,00073,India
392344,2023-03-08,209,pepsi,75,100,25,2,00073,India
629906,2023-03-08,203,mango yogurt,50,60,10,2,00469,India
629906,2023-03-08,210,mountain dew,75,100,25,2,00469,India
629906,2023-03-08,201,paneer,210,340,130,1,00469,India
726589,2023-03-08,211,red bull,90,125,35,2,00081,India
726589,2023-03-08,204,strawberry yogurt,50,60,10,2,00081,India
726589,2023-03-08,201,paneer,210,340,130,1,00081,India
726589,2023-03-08,202,milk,12,27,15,1,00081,India
726589,2023-03-08,209,pepsi,75,100,25,2,00081,India
408082,2023-03-08,204,strawberry yogurt,50,60,10,2,00112,India
408082,2023-03-08,213,bisleri,6,15,9,2,00112,India
408082,2023-03-08,211,red bull,90,125,35,2,00112,India
408082,2023-03-08,212,amul cheese,250,315,65,1,00112,India
319211,2023-03-08,203,mango yogurt,50,60,10,2,00022,India
319211,2023-03-08,201,paneer,210,340,130,1,00022,India
319211,2023-03-08,208,sprite,75,100,25,2,00022,India
616983,2023-03-08,208,sprite,75,100,25,2,00208,India
978153,2023-03-08,210,mountain dew,75,100,25,2,00198,India
775670,2023-03-08,207,coca cola,75,100,25,2,00231,India
775670,2023-03-08,206,yakult,360,400,40,2,00231,India
775670,2023-03-08,205,classic yogurt,45,60,15,2,00231,India
309477,2023-03-08,202,milk,12,27,15,1,00467,India
309477,2023-03-08,208,sprite,75,100,25,2,00467,India
309477,2023-03-08,212,amul cheese,250,315,65,1,00467,India
733719,2023-03-08,202,milk,12,27,15,1,00365,India
733719,2023-03-08,212,amul cheese,250,315,65,1,00365,India
733719,2023-03-08,208,sprite,75,100,25,2,00365,India
250966,2023-03-08,211,red bull,90,125,35,2,00250,India
250966,2023-03-08,213,bisleri,6,15,9,2,00250,India
250966,2023-03-08,212,amul cheese,250,315,65,1,00250,India
188360,2023-03-08,206,yakult,360,400,40,2,00118,India
188360,2023-03-08,208,sprite,75,100,25,2,00118,India
290618,2023-03-08,208,sprite,75,100,25,2,00034,India
290618,2023-03-08,201,paneer,210,340,130,1,00034,India
770725,2023-03-08,212,amul cheese,250,315,65,1,00272,India
148696,2023-03-08,203,mango yogurt,50,60,10,2,00023,India
148696,2023-03-08,209,pepsi,75,100,25,2,00023,India
148696,2023-03-08,204,strawberry yogurt,50,60,10,2,00023,India
175594,2023-03-08,205,classic yogurt,45,60,15,2,00108,India
175594,2023-03-08,201,paneer,210,340,130,1,00108,India
175594,2023-03-08,212,amul cheese,250,315,65,1,00108,India
914609,2023-03-08,207,coca cola,75,100,25,2,00035,India
914609,2023-03-08,202,milk,12,27,15,1,00035,India
914609,2023-03-08,213,bisleri,6,15,9,2,00035,India
244438,2023-03-09,211,red bull,90,125,35,2,00106,India
244438,2023-03-09,205,classic yogurt,45,60,15,2,00106,India
244438,2023-03-09,208,sprite,75,100,25,2,00106,India
115494,2023-03-09,207,coca cola,75,100,25,2,00104,India
115494,2023-03-09,212,amul cheese,250,315,65,1,00104,India
115494,2023-03-09,209,pepsi,75,100,25,2,00104,India
115494,2023-03-09,213,bisleri,6,15,9,2,00104,India
115494,2023-03-09,211,red bull,90,125,35,2,00104,India
613395,2023-03-09,208,sprite,75,100,25,2,00470,India
613395,2023-03-09,203,mango yogurt,50,60,10,2,00470,India
613395,2023-03-09,205,classic yogurt,45,60,15,2,00470,India
132396,2023-03-09,204,strawberry yogurt,50,60,10,2,00321,India
132396,2023-03-09,209,pepsi,75,100,25,2,00321,India
907360,2023-03-09,213,bisleri,6,15,9,2,00365,India
907360,2023-03-09,209,pepsi,75,100,25,2,00365,India
799842,2023-03-09,204,strawberry yogurt,50,60,10,2,00459,India
799842,2023-03-09,209,pepsi,75,100,25,2,00459,India
729595,2023-03-09,202,milk,12,27,15,1,00428,India
729595,2023-03-09,212,amul cheese,250,315,65,1,00428,India
566284,2023-03-09,204,strawberry yogurt,50,60,10,2,00007,India
566284,2023-03-09,209,pepsi,75,100,25,2,00007,India
566284,2023-03-09,203,mango yogurt,50,60,10,2,00007,India
566284,2023-03-09,211,red bull,90,125,35,2,00007,India
233417,2023-03-09,208,sprite,75,100,25,2,00277,India
233417,2023-03-09,209,pepsi,75,100,25,2,00277,India
233417,2023-03-09,213,bisleri,6,15,9,2,00277,India
588713,2023-03-09,202,milk,12,27,15,1,00177,India
588713,2023-03-09,204,strawberry yogurt,50,60,10,2,00177,India
588713,2023-03-09,213,bisleri,6,15,9,2,00177,India
425028,2023-03-09,202,milk,12,27,15,1,00181,India
425028,2023-03-09,204,strawberry yogurt,50,60,10,2,00181,India
880933,2023-03-09,207,coca cola,75,100,25,2,00331,India
880933,2023-03-09,212,amul cheese,250,315,65,1,00331,India
601652,2023-03-09,211,red bull,90,125,35,2,00469,India
601652,2023-03-09,212,amul cheese,250,315,65,1,00469,India
601652,2023-03-09,207,coca cola,75,100,25,2,00469,India
601652,2023-03-09,210,mountain dew,75,100,25,2,00469,India
148302,2023-03-09,211,red bull,90,125,35,2,00048,India
148302,2023-03-09,202,milk,12,27,15,1,00048,India
148302,2023-03-09,203,mango yogurt,50,60,10,2,00048,India
379338,2023-03-09,211,red bull,90,125,35,2,00319,India
379338,2023-03-09,210,mountain dew,75,100,25,2,00319,India
379338,2023-03-09,213,bisleri,6,15,9,2,00319,India
263128,2023-03-09,211,red bull,90,125,35,2,00421,India
263128,2023-03-09,210,mountain dew,75,100,25,2,00421,India
263128,2023-03-09,212,amul cheese,250,315,65,1,00421,India
945712,2023-03-09,207,coca cola,75,100,25,2,00089,India
945712,2023-03-09,208,sprite,75,100,25,2,00089,India
945712,2023-03-09,201,paneer,210,340,130,1,00089,India
945712,2023-03-09,209,pepsi,75,100,25,2,00089,India
466128,2023-03-09,212,amul cheese,250,315,65,1,00458,India
466128,2023-03-09,213,bisleri,6,15,9,2,00458,India
254297,2023-03-09,211,red bull,90,125,35,2,00262,India
849380,2023-03-09,203,mango yogurt,50,60,10,2,00271,India
849380,2023-03-09,206,yakult,360,400,40,2,00271,India
878220,2023-03-09,205,classic yogurt,45,60,15,2,00036,India
878220,2023-03-09,208,sprite,75,100,25,2,00036,India
878220,2023-03-09,201,paneer,210,340,130,1,00036,India
878220,2023-03-09,207,coca cola,75,100,25,2,00036,India
400307,2023-03-09,212,amul cheese,250,315,65,1,00346,India
400307,2023-03-09,213,bisleri,6,15,9,2,00346,India
400307,2023-03-09,209,pepsi,75,100,25,2,00346,India
400307,2023-03-09,201,paneer,210,340,130,1,00346,India
400307,2023-03-09,206,yakult,360,400,40,2,00346,India
158439,2023-03-09,207,coca cola,75,100,25,2,00175,India
158439,2023-03-09,211,red bull,90,125,35,2,00175,India
664477,2023-03-09,213,bisleri,6,15,9,2,00475,India
664477,2023-03-09,206,yakult,360,400,40,2,00475,India
664477,2023-03-09,201,paneer,210,340,130,1,00475,India
664477,2023-03-09,208,sprite,75,100,25,2,00475,India
727473,2023-03-09,202,milk,12,27,15,1,00058,India
727473,2023-03-09,206,yakult,360,400,40,2,00058,India
727473,2023-03-09,213,bisleri,6,15,9,2,00058,India
149356,2023-03-09,208,sprite,75,100,25,2,00382,India
149356,2023-03-09,204,strawberry yogurt,50,60,10,2,00382,India
287115,2023-03-09,201,paneer,210,340,130,1,00432,India
287115,2023-03-09,213,bisleri,6,15,9,2,00432,India
609068,2023-03-09,212,amul cheese,250,315,65,1,00440,India
609068,2023-03-09,201,paneer,210,340,130,1,00440,India
609068,2023-03-09,202,milk,12,27,15,1,00440,India
609068,2023-03-09,205,classic yogurt,45,60,15,2,00440,India
609068,2023-03-09,206,yakult,360,400,40,2,00440,India
947450,2023-03-09,213,bisleri,6,15,9,2,00192,India
778383,2023-03-09,206,yakult,360,400,40,2,00203,India
778383,2023-03-09,205,classic yogurt,45,60,15,2,00203,India
591932,2023-03-09,208,sprite,75,100,25,2,00474,India
591932,2023-03-09,201,paneer,210,340,130,1,00474,India
591932,2023-03-09,207,coca cola,75,100,25,2,00474,India
591932,2023-03-09,205,classic yogurt,45,60,15,2,00474,India
352455,2023-03-09,206,yakult,360,400,40,2,00409,India
352455,2023-03-09,201,paneer,210,340,130,1,00409,India
497567,2023-03-09,201,paneer,210,340,130,1,00015,India
497567,2023-03-09,204,strawberry yogurt,50,60,10,2,00015,India
716058,2023-03-09,202,milk,12,27,15,1,00469,India
716058,2023-03-09,208,sprite,75,100,25,2,00469,India
716058,2023-03-09,201,paneer,210,340,130,1,00469,India
845046,2023-03-09,210,mountain dew,75,100,25,2,00011,India
988524,2023-03-09,208,sprite,75,100,25,2,00300,India
483933,2023-03-09,213,bisleri,6,15,9,2,00498,India
824648,2023-03-09,205,classic yogurt,45,60,15,2,00056,India
824648,2023-03-09,206,yakult,360,400,40,2,00056,India
824648,2023-03-09,201,paneer,210,340,130,1,00056,India
824648,2023-03-09,212,amul cheese,250,315,65,1,00056,India
824648,2023-03-09,203,mango yogurt,50,60,10,2,00056,India
783317,2023-03-09,203,mango yogurt,50,60,10,2,00019,India
783317,2023-03-09,202,milk,12,27,15,1,00019,India
652858,2023-03-09,212,amul cheese,250,315,65,1,00261,India
652858,2023-03-09,210,mountain dew,75,100,25,2,00261,India
652858,2023-03-09,205,classic yogurt,45,60,15,2,00261,India
603897,2023-03-09,209,pepsi,75,100,25,2,00053,India
603897,2023-03-09,213,bisleri,6,15,9,2,00053,India
603897,2023-03-09,201,paneer,210,340,130,1,00053,India
603897,2023-03-09,203,mango yogurt,50,60,10,2,00053,India
802553,2023-03-09,209,pepsi,75,100,25,2,00304,India
802553,2023-03-09,211,red bull,90,125,35,2,00304,India
807780,2023-03-09,208,sprite,75,100,25,2,00429,India
807780,2023-03-09,211,red bull,90,125,35,2,00429,India
939397,2023-03-09,206,yakult,360,400,40,2,00444,India
939397,2023-03-09,210,mountain dew,75,100,25,2,00444,India
939397,2023-03-09,208,sprite,75,100,25,2,00444,India
939397,2023-03-09,212,amul cheese,250,315,65,1,00444,India
939397,2023-03-09,203,mango yogurt,50,60,10,2,00444,India
876383,2023-03-09,212,amul cheese,250,315,65,1,00231,India
876383,2023-03-09,203,mango yogurt,50,60,10,2,00231,India
876383,2023-03-09,208,sprite,75,100,25,2,00231,India
358294,2023-03-09,213,bisleri,6,15,9,2,00214,India
316657,2023-03-09,207,coca cola,75,100,25,2,00040,India
316657,2023-03-09,206,yakult,360,400,40,2,00040,India
316657,2023-03-09,202,milk,12,27,15,1,00040,India
861072,2023-03-09,202,milk,12,27,15,1,00377,India
861072,2023-03-09,207,coca cola,75,100,25,2,00377,India
861072,2023-03-09,213,bisleri,6,15,9,2,00377,India
899306,2023-03-09,208,sprite,75,100,25,2,00065,India
899306,2023-03-09,202,milk,12,27,15,1,00065,India
899306,2023-03-09,201,paneer,210,340,130,1,00065,India
559474,2023-03-09,213,bisleri,6,15,9,2,00381,India
559474,2023-03-09,210,mountain dew,75,100,25,2,00381,India
559474,2023-03-09,204,strawberry yogurt,50,60,10,2,00381,India
538013,2023-03-09,202,milk,12,27,15,1,00170,India
538013,2023-03-09,203,mango yogurt,50,60,10,2,00170,India
538013,2023-03-09,206,yakult,360,400,40,2,00170,India
538013,2023-03-09,209,pepsi,75,100,25,2,00170,India
553512,2023-03-09,201,paneer,210,340,130,1,00021,India
553512,2023-03-09,212,amul cheese,250,315,65,1,00021,India
553512,2023-03-09,205,classic yogurt,45,60,15,2,00021,India
230856,2023-03-09,208,sprite,75,100,25,2,00418,India
230856,2023-03-09,211,red bull,90,125,35,2,00418,India
230856,2023-03-09,202,milk,12,27,15,1,00418,India
230856,2023-03-09,209,pepsi,75,100,25,2,00418,India
362009,2023-03-09,213,bisleri,6,15,9,2,00192,India
362009,2023-03-09,209,pepsi,75,100,25,2,00192,India
362009,2023-03-09,212,amul cheese,250,315,65,1,00192,India
362009,2023-03-09,203,mango yogurt,50,60,10,2,00192,India
221001,2023-03-09,206,yakult,360,400,40,2,00441,India
992901,2023-03-09,209,pepsi,75,100,25,2,00162,India
992901,2023-03-09,211,red bull,90,125,35,2,00162,India
998953,2023-03-09,207,coca cola,75,100,25,2,00083,India
472008,2023-03-09,202,milk,12,27,15,1,00337,India
472008,2023-03-09,207,coca cola,75,100,25,2,00337,India
472008,2023-03-09,205,classic yogurt,45,60,15,2,00337,India
914180,2023-03-09,201,paneer,210,340,130,1,00189,India
914180,2023-03-09,213,bisleri,6,15,9,2,00189,India
341018,2023-03-09,202,milk,12,27,15,1,00258,India
341018,2023-03-09,206,yakult,360,400,40,2,00258,India
341018,2023-03-09,212,amul cheese,250,315,65,1,00258,India
529510,2023-03-09,202,milk,12,27,15,1,00377,India
529510,2023-03-09,210,mountain dew,75,100,25,2,00377,India
529510,2023-03-09,206,yakult,360,400,40,2,00377,India
529510,2023-03-09,207,coca cola,75,100,25,2,00377,India
952792,2023-03-09,203,mango yogurt,50,60,10,2,00307,India
923734,2023-03-10,201,paneer,210,340,130,1,00071,India
923734,2023-03-10,206,yakult,360,400,40,2,00071,India
923734,2023-03-10,209,pepsi,75,100,25,2,00071,India
489273,2023-03-10,202,milk,12,27,15,1,00205,India
489273,2023-03-10,210,mountain dew,75,100,25,2,00205,India
489273,2023-03-10,206,yakult,360,400,40,2,00205,India
908786,2023-03-10,213,bisleri,6,15,9,2,00299,India
908786,2023-03-10,210,mountain dew,75,100,25,2,00299,India
908786,2023-03-10,204,strawberry yogurt,50,60,10,2,00299,India
659025,2023-03-10,203,mango yogurt,50,60,10,2,00284,India
184470,2023-03-10,205,classic yogurt,45,60,15,2,00189,India
184470,2023-03-10,206,yakult,360,400,40,2,00189,India
184470,2023-03-10,210,mountain dew,75,100,25,2,00189,India
184470,2023-03-10,208,sprite,75,100,25,2,00189,India
184470,2023-03-10,201,paneer,210,340,130,1,00189,India
955765,2023-03-10,205,classic yogurt,45,60,15,2,00063,India
955765,2023-03-10,201,paneer,210,340,130,1,00063,India
525940,2023-03-10,204,strawberry yogurt,50,60,10,2,00311,India
525940,2023-03-10,203,mango yogurt,50,60,10,2,00311,India
525940,2023-03-10,206,yakult,360,400,40,2,00311,India
525940,2023-03-10,205,classic yogurt,45,60,15,2,00311,India
431859,2023-03-10,205,classic yogurt,45,60,15,2,00315,India
442954,2023-03-10,201,paneer,210,340,130,1,00345,India
442954,2023-03-10,208,sprite,75,100,25,2,00345,India
442954,2023-03-10,212,amul cheese,250,315,65,1,00345,India
442954,2023-03-10,209,pepsi,75,100,25,2,00345,India
442954,2023-03-10,205,classic yogurt,45,60,15,2,00345,India
551473,2023-03-10,207,coca cola,75,100,25,2,00458,India
551473,2023-03-10,213,bisleri,6,15,9,2,00458,India
551473,2023-03-10,202,milk,12,27,15,1,00458,India
551473,2023-03-10,212,amul cheese,250,315,65,1,00458,India
551473,2023-03-10,203,mango yogurt,50,60,10,2,00458,India
523777,2023-03-10,205,classic yogurt,45,60,15,2,00046,India
523777,2023-03-10,201,paneer,210,340,130,1,00046,India
351386,2023-03-10,205,classic yogurt,45,60,15,2,00391,India
351386,2023-03-10,210,mountain dew,75,100,25,2,00391,India
351386,2023-03-10,204,strawberry yogurt,50,60,10,2,00391,India
285649,2023-03-10,212,amul cheese,250,315,65,1,00384,India
285649,2023-03-10,205,classic yogurt,45,60,15,2,00384,India
281273,2023-03-10,208,sprite,75,100,25,2,00320,India
281273,2023-03-10,210,mountain dew,75,100,25,2,00320,India
281273,2023-03-10,212,amul cheese,250,315,65,1,00320,India
960810,2023-03-10,206,yakult,360,400,40,2,00465,India
960810,2023-03-10,203,mango yogurt,50,60,10,2,00465,India
198796,2023-03-10,208,sprite,75,100,25,2,00416,India
198796,2023-03-10,207,coca cola,75,100,25,2,00416,India
976599,2023-03-10,209,pepsi,75,100,25,2,00063,India
827975,2023-03-10,205,classic yogurt,45,60,15,2,00360,India
827975,2023-03-10,208,sprite,75,100,25,2,00360,India
827975,2023-03-10,209,pepsi,75,100,25,2,00360,India
305026,2023-03-10,211,red bull,90,125,35,2,00417,India
305026,2023-03-10,212,amul cheese,250,315,65,1,00417,India
422230,2023-03-10,210,mountain dew,75,100,25,2,00414,India
422230,2023-03-10,201,paneer,210,340,130,1,00414,India
705148,2023-03-10,202,milk,12,27,15,1,00004,India
705148,2023-03-10,204,strawberry yogurt,50,60,10,2,00004,India
423772,2023-03-10,211,red bull,90,125,35,2,00134,India
423772,2023-03-10,213,bisleri,6,15,9,2,00134,India
423772,2023-03-10,207,coca cola,75,100,25,2,00134,India
713745,2023-03-10,201,paneer,210,340,130,1,00325,India
713745,2023-03-10,203,mango yogurt,50,60,10,2,00325,India
713745,2023-03-10,205,classic yogurt,45,60,15,2,00325,India
713745,2023-03-10,202,milk,12,27,15,1,00325,India
889911,2023-03-10,213,bisleri,6,15,9,2,00246,India
889911,2023-03-10,204,strawberry yogurt,50,60,10,2,00246,India
889911,2023-03-10,207,coca cola,75,100,25,2,00246,India
889911,2023-03-10,201,paneer,210,340,130,1,00246,India
889911,2023-03-10,211,red bull,90,125,35,2,00246,India
121910,2023-03-10,202,milk,12,27,15,1,00302,India
121910,2023-03-10,212,amul cheese,250,315,65,1,00302,India
121910,2023-03-10,203,mango yogurt,50,60,10,2,00302,India
121910,2023-03-10,211,red bull,90,125,35,2,00302,India
544315,2023-03-10,204,strawberry yogurt,50,60,10,2,00348,India
544315,2023-03-10,207,coca cola,75,100,25,2,00348,India
544315,2023-03-10,210,mountain dew,75,100,25,2,00348,India
544315,2023-03-10,202,milk,12,27,15,1,00348,India
252838,2023-03-10,207,coca cola,75,100,25,2,00143,India
252838,2023-03-10,210,mountain dew,75,100,25,2,00143,India
252838,2023-03-10,208,sprite,75,100,25,2,00143,India
252838,2023-03-10,212,amul cheese,250,315,65,1,00143,India
465012,2023-03-10,202,milk,12,27,15,1,00454,India
465012,2023-03-10,208,sprite,75,100,25,2,00454,India
712210,2023-03-10,201,paneer,210,340,130,1,00458,India
756505,2023-03-10,206,yakult,360,400,40,2,00126,India
756505,2023-03-10,210,mountain dew,75,100,25,2,00126,India
756505,2023-03-10,202,milk,12,27,15,1,00126,India
743760,2023-03-10,210,mountain dew,75,100,25,2,00473,India
743760,2023-03-10,208,sprite,75,100,25,2,00473,India
743760,2023-03-10,202,milk,12,27,15,1,00473,India
609779,2023-03-10,202,milk,12,27,15,1,00344,India
389318,2023-03-10,208,sprite,75,100,25,2,00283,India
389318,2023-03-10,211,red bull,90,125,35,2,00283,India
592770,2023-03-10,209,pepsi,75,100,25,2,00360,India
592770,2023-03-10,201,paneer,210,340,130,1,00360,India
296561,2023-03-10,206,yakult,360,400,40,2,00492,India
296561,2023-03-10,203,mango yogurt,50,60,10,2,00492,India
296561,2023-03-10,209,pepsi,75,100,25,2,00492,India
296561,2023-03-10,205,classic yogurt,45,60,15,2,00492,India
329918,2023-03-10,203,mango yogurt,50,60,10,2,00490,India
329918,2023-03-10,202,milk,12,27,15,1,00490,India
731994,2023-03-10,209,pepsi,75,100,25,2,00180,India
731994,2023-03-10,210,mountain dew,75,100,25,2,00180,India
731994,2023-03-10,207,coca cola,75,100,25,2,00180,India
731994,2023-03-10,212,amul cheese,250,315,65,1,00180,India
178899,2023-03-10,210,mountain dew,75,100,25,2,00010,India
178899,2023-03-10,212,amul cheese,250,315,65,1,00010,India
637030,2023-03-10,203,mango yogurt,50,60,10,2,00254,India
637030,2023-03-10,204,strawberry yogurt,50,60,10,2,00254,India
637030,2023-03-10,206,yakult,360,400,40,2,00254,India
244020,2023-03-10,201,paneer,210,340,130,1,00150,India
728164,2023-03-10,207,coca cola,75,100,25,2,00219,India
728164,2023-03-10,206,yakult,360,400,40,2,00219,India
728164,2023-03-10,210,mountain dew,75,100,25,2,00219,India
728164,2023-03-10,209,pepsi,75,100,25,2,00219,India
728164,2023-03-10,203,mango yogurt,50,60,10,2,00219,India
937733,2023-03-10,204,strawberry yogurt,50,60,10,2,00281,India
937733,2023-03-10,213,bisleri,6,15,9,2,00281,India
937733,2023-03-10,208,sprite,75,100,25,2,00281,India
698342,2023-03-10,208,sprite,75,100,25,2,00163,India
698342,2023-03-10,211,red bull,90,125,35,2,00163,India
698342,2023-03-10,201,paneer,210,340,130,1,00163,India
646950,2023-03-10,213,bisleri,6,15,9,2,00069,India
646950,2023-03-10,201,paneer,210,340,130,1,00069,India
646950,2023-03-10,208,sprite,75,100,25,2,00069,India
646950,2023-03-10,202,milk,12,27,15,1,00069,India
435889,2023-03-10,208,sprite,75,100,25,2,00121,India
435889,2023-03-10,203,mango yogurt,50,60,10,2,00121,India
692483,2023-03-10,208,sprite,75,100,25,2,00492,India
692483,2023-03-10,209,pepsi,75,100,25,2,00492,India
692483,2023-03-10,210,mountain dew,75,100,25,2,00492,India
841017,2023-03-10,212,amul cheese,250,315,65,1,00141,India
988400,2023-03-10,208,sprite,75,100,25,2,00244,India
988400,2023-03-10,206,yakult,360,400,40,2,00244,India
988400,2023-03-10,212,amul cheese,250,315,65,1,00244,India
988400,2023-03-10,203,mango yogurt,50,60,10,2,00244,India
758425,2023-03-10,206,yakult,360,400,40,2,00485,India
758425,2023-03-10,210,mountain dew,75,100,25,2,00485,India
758425,2023-03-10,213,bisleri,6,15,9,2,00485,India
308799,2023-03-10,212,amul cheese,250,315,65,1,00420,India
183458,2023-03-10,202,milk,12,27,15,1,00344,India
183458,2023-03-10,207,coca cola,75,100,25,2,00344,India
183458,2023-03-10,213,bisleri,6,15,9,2,00344,India
631597,2023-03-10,209,pepsi,75,100,25,2,00366,India
953567,2023-03-10,208,sprite,75,100,25,2,00215,India
953567,2023-03-10,202,milk,12,27,15,1,00215,India
953567,2023-03-10,207,coca cola,75,100,25,2,00215,India
953567,2023-03-10,203,mango yogurt,50,60,10,2,00215,India
218172,2023-03-10,210,mountain dew,75,100,25,2,00220,India
218172,2023-03-10,204,strawberry yogurt,50,60,10,2,00220,India
218172,2023-03-10,202,milk,12,27,15,1,00220,India
218172,2023-03-10,207,coca cola,75,100,25,2,00220,India
101524,2023-03-10,203,mango yogurt,50,60,10,2,00312,India
101524,2023-03-10,204,strawberry yogurt,50,60,10,2,00312,India
101524,2023-03-10,211,red bull,90,125,35,2,00312,India
223750,2023-03-10,207,coca cola,75,100,25,2,00173,India
297770,2023-03-10,213,bisleri,6,15,9,2,00188,India
978454,2023-03-10,211,red bull,90,125,35,2,00213,India
978454,2023-03-10,213,bisleri,6,15,9,2,00213,India
978454,2023-03-10,202,milk,12,27,15,1,00213,India
978454,2023-03-10,208,sprite,75,100,25,2,00213,India
951484,2023-03-10,203,mango yogurt,50,60,10,2,00162,India
951484,2023-03-10,207,coca cola,75,100,25,2,00162,India
725338,2023-03-10,210,mountain dew,75,100,25,2,00341,India
725338,2023-03-10,209,pepsi,75,100,25,2,00341,India
725338,2023-03-10,212,amul cheese,250,315,65,1,00341,India
725338,2023-03-10,213,bisleri,6,15,9,2,00341,India
813840,2023-03-10,204,strawberry yogurt,50,60,10,2,00188,India
813840,2023-03-10,203,mango yogurt,50,60,10,2,00188,India
813840,2023-03-10,213,bisleri,6,15,9,2,00188,India
813840,2023-03-10,210,mountain dew,75,100,25,2,00188,India
598525,2023-03-10,201,paneer,210,340,130,1,00269,India
598525,2023-03-10,209,pepsi,75,100,25,2,00269,India
145625,2023-03-10,201,paneer,210,340,130,1,00398,India
145625,2023-03-10,210,mountain dew,75,100,25,2,00398,India
477129,2023-03-10,203,mango yogurt,50,60,10,2,00326,India
477129,2023-03-10,210,mountain dew,75,100,25,2,00326,India
477129,2023-03-10,205,classic yogurt,45,60,15,2,00326,India
477129,2023-03-10,209,pepsi,75,100,25,2,00326,India
477129,2023-03-10,206,yakult,360,400,40,2,00326,India
450984,2023-03-10,201,paneer,210,340,130,1,00411,India
450984,2023-03-10,203,mango yogurt,50,60,10,2,00411,India
450984,2023-03-10,211,red bull,90,125,35,2,00411,India
450984,2023-03-10,209,pepsi,75,100,25,2,00411,India
450984,2023-03-10,206,yakult,360,400,40,2,00411,India
737692,2023-03-10,213,bisleri,6,15,9,2,00445,India
737692,2023-03-10,207,coca cola,75,100,25,2,00445,India
737692,2023-03-10,211,red bull,90,125,35,2,00445,India
737692,2023-03-10,201,paneer,210,340,130,1,00445,India
353994,2023-03-10,202,milk,12,27,15,1,00445,India
353994,2023-03-10,207,coca cola,75,100,25,2,00445,India
353994,2023-03-10,212,amul cheese,250,315,65,1,00445,India
353994,2023-03-10,205,classic yogurt,45,60,15,2,00445,India
731687,2023-03-10,202,milk,12,27,15,1,00338,India
731687,2023-03-10,204,strawberry yogurt,50,60,10,2,00338,India
732419,2023-03-10,209,pepsi,75,100,25,2,00402,India
732419,2023-03-10,203,mango yogurt,50,60,10,2,00402,India
732419,2023-03-10,201,paneer,210,340,130,1,00402,India
732419,2023-03-10,205,classic yogurt,45,60,15,2,00402,India
769093,2023-03-10,202,milk,12,27,15,1,00177,India
769093,2023-03-10,203,mango yogurt,50,60,10,2,00177,India
769093,2023-03-10,211,red bull,90,125,35,2,00177,India
769093,2023-03-10,213,bisleri,6,15,9,2,00177,India
940182,2023-03-10,209,pepsi,75,100,25,2,00383,India
530598,2023-03-10,203,mango yogurt,50,60,10,2,00222,India
530598,2023-03-10,211,red bull,90,125,35,2,00222,India
542496,2023-03-10,208,sprite,75,100,25,2,00395,India
542496,2023-03-10,206,yakult,360,400,40,2,00395,India
542496,2023-03-10,211,red bull,90,125,35,2,00395,India
542496,2023-03-10,210,mountain dew,75,100,25,2,00395,India
620528,2023-03-11,203,mango yogurt,50,60,10,2,00354,India
620528,2023-03-11,213,bisleri,6,15,9,2,00354,India
620528,2023-03-11,210,mountain dew,75,100,25,2,00354,India
268304,2023-03-11,204,strawberry yogurt,50,60,10,2,00037,India
268304,2023-03-11,201,paneer,210,340,130,1,00037,India
268304,2023-03-11,202,milk,12,27,15,1,00037,India
268304,2023-03-11,211,red bull,90,125,35,2,00037,India
730598,2023-03-11,211,red bull,90,125,35,2,00330,India
730598,2023-03-11,213,bisleri,6,15,9,2,00330,India
730598,2023-03-11,209,pepsi,75,100,25,2,00330,India
730598,2023-03-11,203,mango yogurt,50,60,10,2,00330,India
523628,2023-03-11,205,classic yogurt,45,60,15,2,00085,India
523628,2023-03-11,209,pepsi,75,100,25,2,00085,India
523628,2023-03-11,202,milk,12,27,15,1,00085,India
523628,2023-03-11,206,yakult,360,400,40,2,00085,India
298071,2023-03-11,212,amul cheese,250,315,65,1,00136,India
298071,2023-03-11,202,milk,12,27,15,1,00136,India
298071,2023-03-11,208,sprite,75,100,25,2,00136,India
298071,2023-03-11,203,mango yogurt,50,60,10,2,00136,India
559838,2023-03-11,207,coca cola,75,100,25,2,00006,India
559838,2023-03-11,210,mountain dew,75,100,25,2,00006,India
559838,2023-03-11,208,sprite,75,100,25,2,00006,India
559838,2023-03-11,206,yakult,360,400,40,2,00006,India
559838,2023-03-11,202,milk,12,27,15,1,00006,India
764376,2023-03-11,206,yakult,360,400,40,2,00404,India
764376,2023-03-11,204,strawberry yogurt,50,60,10,2,00404,India
764376,2023-03-11,211,red bull,90,125,35,2,00404,India
681033,2023-03-11,212,amul cheese,250,315,65,1,00087,India
246098,2023-03-11,213,bisleri,6,15,9,2,00174,India
246098,2023-03-11,201,paneer,210,340,130,1,00174,India
246098,2023-03-11,204,strawberry yogurt,50,60,10,2,00174,India
246098,2023-03-11,207,coca cola,75,100,25,2,00174,India
246098,2023-03-11,205,classic yogurt,45,60,15,2,00174,India
155229,2023-03-11,201,paneer,210,340,130,1,00493,India
155229,2023-03-11,206,yakult,360,400,40,2,00493,India
155229,2023-03-11,203,mango yogurt,50,60,10,2,00493,India
155229,2023-03-11,205,classic yogurt,45,60,15,2,00493,India
155229,2023-03-11,210,mountain dew,75,100,25,2,00493,India
215262,2023-03-11,209,pepsi,75,100,25,2,00353,India
215262,2023-03-11,210,mountain dew,75,100,25,2,00353,India
743484,2023-03-11,206,yakult,360,400,40,2,00421,India
298861,2023-03-11,205,classic yogurt,45,60,15,2,00391,India
492100,2023-03-11,206,yakult,360,400,40,2,00338,India
492100,2023-03-11,204,strawberry yogurt,50,60,10,2,00338,India
492100,2023-03-11,209,pepsi,75,100,25,2,00338,India
384529,2023-03-11,205,classic yogurt,45,60,15,2,00346,India
384529,2023-03-11,204,strawberry yogurt,50,60,10,2,00346,India
865447,2023-03-11,202,milk,12,27,15,1,00149,India
865447,2023-03-11,213,bisleri,6,15,9,2,00149,India
865447,2023-03-11,206,yakult,360,400,40,2,00149,India
539093,2023-03-11,213,bisleri,6,15,9,2,00491,India
539093,2023-03-11,203,mango yogurt,50,60,10,2,00491,India
994920,2023-03-11,207,coca cola,75,100,25,2,00011,India
994920,2023-03-11,206,yakult,360,400,40,2,00011,India
442495,2023-03-11,205,classic yogurt,45,60,15,2,00070,India
442495,2023-03-11,213,bisleri,6,15,9,2,00070,India
442495,2023-03-11,204,strawberry yogurt,50,60,10,2,00070,India
520448,2023-03-11,213,bisleri,6,15,9,2,00066,India
520448,2023-03-11,210,mountain dew,75,100,25,2,00066,India
520448,2023-03-11,212,amul cheese,250,315,65,1,00066,India
687951,2023-03-11,206,yakult,360,400,40,2,00008,India
687951,2023-03-11,207,coca cola,75,100,25,2,00008,India
687951,2023-03-11,210,mountain dew,75,100,25,2,00008,India
948355,2023-03-11,201,paneer,210,340,130,1,00410,India
948355,2023-03-11,210,mountain dew,75,100,25,2,00410,India
520153,2023-03-11,205,classic yogurt,45,60,15,2,00118,India
520153,2023-03-11,209,pepsi,75,100,25,2,00118,India
839005,2023-03-11,210,mountain dew,75,100,25,2,00187,India
839005,2023-03-11,212,amul cheese,250,315,65,1,00187,India
839005,2023-03-11,201,paneer,210,340,130,1,00187,India
183085,2023-03-11,207,coca cola,75,100,25,2,00321,India
449139,2023-03-11,206,yakult,360,400,40,2,00485,India
449139,2023-03-11,209,pepsi,75,100,25,2,00485,India
632840,2023-03-11,212,amul cheese,250,315,65,1,00155,India
632840,2023-03-11,206,yakult,360,400,40,2,00155,India
632840,2023-03-11,201,paneer,210,340,130,1,00155,India
555900,2023-03-11,204,strawberry yogurt,50,60,10,2,00370,India
555900,2023-03-11,213,bisleri,6,15,9,2,00370,India
555900,2023-03-11,207,coca cola,75,100,25,2,00370,India
555900,2023-03-11,202,milk,12,27,15,1,00370,India
555900,2023-03-11,211,red bull,90,125,35,2,00370,India
504352,2023-03-11,202,milk,12,27,15,1,00114,India
504352,2023-03-11,207,coca cola,75,100,25,2,00114,India
504352,2023-03-11,213,bisleri,6,15,9,2,00114,India
504352,2023-03-11,210,mountain dew,75,100,25,2,00114,India
721108,2023-03-11,201,paneer,210,340,130,1,00427,India
721108,2023-03-11,212,amul cheese,250,315,65,1,00427,India
225709,2023-03-11,204,strawberry yogurt,50,60,10,2,00315,India
225709,2023-03-11,210,mountain dew,75,100,25,2,00315,India
225709,2023-03-11,202,milk,12,27,15,1,00315,India
225709,2023-03-11,205,classic yogurt,45,60,15,2,00315,India
351831,2023-03-11,202,milk,12,27,15,1,00454,India
846467,2023-03-11,203,mango yogurt,50,60,10,2,00256,India
846467,2023-03-11,207,coca cola,75,100,25,2,00256,India
313018,2023-03-11,204,strawberry yogurt,50,60,10,2,00319,India
313018,2023-03-11,206,yakult,360,400,40,2,00319,India
395381,2023-03-11,213,bisleri,6,15,9,2,00471,India
395381,2023-03-11,209,pepsi,75,100,25,2,00471,India
395381,2023-03-11,212,amul cheese,250,315,65,1,00471,India
133214,2023-03-11,209,pepsi,75,100,25,2,00052,India
267818,2023-03-11,203,mango yogurt,50,60,10,2,00099,India
267818,2023-03-11,212,amul cheese,250,315,65,1,00099,India
483413,2023-03-11,212,amul cheese,250,315,65,1,00251,India
483413,2023-03-11,206,yakult,360,400,40,2,00251,India
483413,2023-03-11,211,red bull,90,125,35,2,00251,India
483413,2023-03-11,207,coca cola,75,100,25,2,00251,India
612230,2023-03-11,203,mango yogurt,50,60,10,2,00307,India
612230,2023-03-11,213,bisleri,6,15,9,2,00307,India
612230,2023-03-11,206,yakult,360,400,40,2,00307,India
612230,2023-03-11,202,milk,12,27,15,1,00307,India
655303,2023-03-11,205,classic yogurt,45,60,15,2,00493,India
418619,2023-03-11,205,classic yogurt,45,60,15,2,00290,India
907727,2023-03-11,210,mountain dew,75,100,25,2,00328,India
907727,2023-03-11,207,coca cola,75,100,25,2,00328,India
907727,2023-03-11,212,amul cheese,250,315,65,1,00328,India
916384,2023-03-11,213,bisleri,6,15,9,2,00380,India
916384,2023-03-11,212,amul cheese,250,315,65,1,00380,India
916384,2023-03-11,208,sprite,75,100,25,2,00380,India
624196,2023-03-11,207,coca cola,75,100,25,2,00442,India
624196,2023-03-11,210,mountain dew,75,100,25,2,00442,India
624196,2023-03-11,201,paneer,210,340,130,1,00442,India
624196,2023-03-11,209,pepsi,75,100,25,2,00442,India
504599,2023-03-11,204,strawberry yogurt,50,60,10,2,00286,India
504599,2023-03-11,211,red bull,90,125,35,2,00286,India
870399,2023-03-11,211,red bull,90,125,35,2,00468,India
870399,2023-03-11,210,mountain dew,75,100,25,2,00468,India
870399,2023-03-11,202,milk,12,27,15,1,00468,India
870399,2023-03-11,213,bisleri,6,15,9,2,00468,India
404291,2023-03-11,206,yakult,360,400,40,2,00420,India
404291,2023-03-11,201,paneer,210,340,130,1,00420,India
404291,2023-03-11,209,pepsi,75,100,25,2,00420,India
966577,2023-03-11,209,pepsi,75,100,25,2,00159,India
966577,2023-03-11,206,yakult,360,400,40,2,00159,India
966577,2023-03-11,207,coca cola,75,100,25,2,00159,India
966577,2023-03-11,210,mountain dew,75,100,25,2,00159,India
966577,2023-03-11,204,strawberry yogurt,50,60,10,2,00159,India
560200,2023-03-11,207,coca cola,75,100,25,2,00126,India
560200,2023-03-11,209,pepsi,75,100,25,2,00126,India
560200,2023-03-11,204,strawberry yogurt,50,60,10,2,00126,India
303526,2023-03-11,208,sprite,75,100,25,2,00106,India
303526,2023-03-11,205,classic yogurt,45,60,15,2,00106,India
563731,2023-03-12,201,paneer,210,340,130,1,00100,India
563731,2023-03-12,213,bisleri,6,15,9,2,00100,India
277392,2023-03-12,206,yakult,360,400,40,2,00268,India
277392,2023-03-12,205,classic yogurt,45,60,15,2,00268,India
277392,2023-03-12,208,sprite,75,100,25,2,00268,India
277392,2023-03-12,213,bisleri,6,15,9,2,00268,India
535229,2023-03-12,212,amul cheese,250,315,65,1,00167,India
535229,2023-03-12,208,sprite,75,100,25,2,00167,India
535229,2023-03-12,207,coca cola,75,100,25,2,00167,India
203922,2023-03-12,203,mango yogurt,50,60,10,2,00134,India
695048,2023-03-12,212,amul cheese,250,315,65,1,00435,India
695048,2023-03-12,209,pepsi,75,100,25,2,00435,India
695048,2023-03-12,206,yakult,360,400,40,2,00435,India
695048,2023-03-12,208,sprite,75,100,25,2,00435,India
695048,2023-03-12,205,classic yogurt,45,60,15,2,00435,India
293699,2023-03-12,202,milk,12,27,15,1,00256,India
293699,2023-03-12,204,strawberry yogurt,50,60,10,2,00256,India
293699,2023-03-12,207,coca cola,75,100,25,2,00256,India
293699,2023-03-12,213,bisleri,6,15,9,2,00256,India
481404,2023-03-12,212,amul cheese,250,315,65,1,00362,India
479497,2023-03-12,204,strawberry yogurt,50,60,10,2,00375,India
479497,2023-03-12,203,mango yogurt,50,60,10,2,00375,India
479497,2023-03-12,210,mountain dew,75,100,25,2,00375,India
479497,2023-03-12,207,coca cola,75,100,25,2,00375,India
863383,2023-03-12,213,bisleri,6,15,9,2,00312,India
863383,2023-03-12,211,red bull,90,125,35,2,00312,India
863383,2023-03-12,208,sprite,75,100,25,2,00312,India
215342,2023-03-12,210,mountain dew,75,100,25,2,00302,India
607428,2023-03-12,210,mountain dew,75,100,25,2,00147,India
307606,2023-03-12,202,milk,12,27,15,1,00497,India
307606,2023-03-12,203,mango yogurt,50,60,10,2,00497,India
307606,2023-03-12,212,amul cheese,250,315,65,1,00497,India
307606,2023-03-12,201,paneer,210,340,130,1,00497,India
307606,2023-03-12,207,coca cola,75,100,25,2,00497,India
427541,2023-03-12,201,paneer,210,340,130,1,00189,India
427541,2023-03-12,212,amul cheese,250,315,65,1,00189,India
427541,2023-03-12,204,strawberry yogurt,50,60,10,2,00189,India
427541,2023-03-12,202,milk,12,27,15,1,00189,India
165782,2023-03-12,212,amul cheese,250,315,65,1,00102,India
165782,2023-03-12,207,coca cola,75,100,25,2,00102,India
165782,2023-03-12,202,milk,12,27,15,1,00102,India
713670,2023-03-12,205,classic yogurt,45,60,15,2,00029,India
609468,2023-03-12,208,sprite,75,100,25,2,00069,India
718369,2023-03-12,206,yakult,360,400,40,2,00459,India
718369,2023-03-12,205,classic yogurt,45,60,15,2,00459,India
718369,2023-03-12,203,mango yogurt,50,60,10,2,00459,India
889365,2023-03-12,211,red bull,90,125,35,2,00204,India
515194,2023-03-12,204,strawberry yogurt,50,60,10,2,00112,India
515194,2023-03-12,203,mango yogurt,50,60,10,2,00112,India
515194,2023-03-12,206,yakult,360,400,40,2,00112,India
515194,2023-03-12,201,paneer,210,340,130,1,00112,India
501922,2023-03-12,212,amul cheese,250,315,65,1,00147,India
501922,2023-03-12,209,pepsi,75,100,25,2,00147,India
989060,2023-03-12,202,milk,12,27,15,1,00346,India
989060,2023-03-12,205,classic yogurt,45,60,15,2,00346,India
989060,2023-03-12,210,mountain dew,75,100,25,2,00346,India
356087,2023-03-12,204,strawberry yogurt,50,60,10,2,00101,India
356087,2023-03-12,211,red bull,90,125,35,2,00101,India
356087,2023-03-12,201,paneer,210,340,130,1,00101,India
503619,2023-03-12,201,paneer,210,340,130,1,00003,India
503619,2023-03-12,209,pepsi,75,100,25,2,00003,India
448719,2023-03-12,209,pepsi,75,100,25,2,00390,India
448719,2023-03-12,212,amul cheese,250,315,65,1,00390,India
159844,2023-03-12,201,paneer,210,340,130,1,00253,India
159844,2023-03-12,212,amul cheese,250,315,65,1,00253,India
159844,2023-03-12,208,sprite,75,100,25,2,00253,India
159844,2023-03-12,202,milk,12,27,15,1,00253,India
817848,2023-03-12,213,bisleri,6,15,9,2,00339,India
969759,2023-03-12,204,strawberry yogurt,50,60,10,2,00012,India
969759,2023-03-12,201,paneer,210,340,130,1,00012,India
329367,2023-03-12,208,sprite,75,100,25,2,00437,India
505167,2023-03-12,208,sprite,75,100,25,2,00381,India
505167,2023-03-12,202,milk,12,27,15,1,00381,India
505167,2023-03-12,211,red bull,90,125,35,2,00381,India
155181,2023-03-12,207,coca cola,75,100,25,2,00475,India
155181,2023-03-12,212,amul cheese,250,315,65,1,00475,India
155181,2023-03-12,210,mountain dew,75,100,25,2,00475,India
166749,2023-03-12,211,red bull,90,125,35,2,00464,India
166749,2023-03-12,204,strawberry yogurt,50,60,10,2,00464,India
166749,2023-03-12,212,amul cheese,250,315,65,1,00464,India
407442,2023-03-12,204,strawberry yogurt,50,60,10,2,00353,India
407442,2023-03-12,206,yakult,360,400,40,2,00353,India
407442,2023-03-12,207,coca cola,75,100,25,2,00353,India
153254,2023-03-12,201,paneer,210,340,130,1,00459,India
153254,2023-03-12,211,red bull,90,125,35,2,00459,India
153254,2023-03-12,208,sprite,75,100,25,2,00459,India
710681,2023-03-12,211,red bull,90,125,35,2,00329,India
999884,2023-03-12,211,red bull,90,125,35,2,00466,India
999884,2023-03-12,201,paneer,210,340,130,1,00466,India
999884,2023-03-12,213,bisleri,6,15,9,2,00466,India
509629,2023-03-12,212,amul cheese,250,315,65,1,00375,India
509629,2023-03-12,209,pepsi,75,100,25,2,00375,India
509629,2023-03-12,208,sprite,75,100,25,2,00375,India
509629,2023-03-12,211,red bull,90,125,35,2,00375,India
509629,2023-03-12,203,mango yogurt,50,60,10,2,00375,India
810287,2023-03-12,206,yakult,360,400,40,2,00492,India
810287,2023-03-12,203,mango yogurt,50,60,10,2,00492,India
810287,2023-03-12,207,coca cola,75,100,25,2,00492,India
810287,2023-03-12,205,classic yogurt,45,60,15,2,00492,India
810287,2023-03-12,208,sprite,75,100,25,2,00492,India
267784,2023-03-12,206,yakult,360,400,40,2,00426,India
267784,2023-03-12,209,pepsi,75,100,25,2,00426,India
267784,2023-03-12,202,milk,12,27,15,1,00426,India
718153,2023-03-12,211,red bull,90,125,35,2,00118,India
718153,2023-03-12,203,mango yogurt,50,60,10,2,00118,India
718153,2023-03-12,210,mountain dew,75,100,25,2,00118,India
472523,2023-03-12,207,coca cola,75,100,25,2,00499,India
472523,2023-03-12,208,sprite,75,100,25,2,00499,India
301943,2023-03-12,212,amul cheese,250,315,65,1,00281,India
301943,2023-03-12,205,classic yogurt,45,60,15,2,00281,India
301943,2023-03-12,201,paneer,210,340,130,1,00281,India
304308,2023-03-12,204,strawberry yogurt,50,60,10,2,00131,India
304308,2023-03-12,209,pepsi,75,100,25,2,00131,India
304308,2023-03-12,212,amul cheese,250,315,65,1,00131,India
304308,2023-03-12,213,bisleri,6,15,9,2,00131,India
304308,2023-03-12,205,classic yogurt,45,60,15,2,00131,India
234509,2023-03-12,201,paneer,210,340,130,1,00299,India
234509,2023-03-12,205,classic yogurt,45,60,15,2,00299,India
680854,2023-03-12,210,mountain dew,75,100,25,2,00003,India
680854,2023-03-12,213,bisleri,6,15,9,2,00003,India
680854,2023-03-12,205,classic yogurt,45,60,15,2,00003,India
680854,2023-03-12,208,sprite,75,100,25,2,00003,India
439908,2023-03-12,210,mountain dew,75,100,25,2,00356,India
439908,2023-03-12,212,amul cheese,250,315,65,1,00356,India
439908,2023-03-12,209,pepsi,75,100,25,2,00356,India
470520,2023-03-12,209,pepsi,75,100,25,2,00294,India
882056,2023-03-12,202,milk,12,27,15,1,00426,India
914748,2023-03-12,201,paneer,210,340,130,1,00304,India
914748,2023-03-12,211,red bull,90,125,35,2,00304,India
675610,2023-03-12,202,milk,12,27,15,1,00207,India
675610,2023-03-12,209,pepsi,75,100,25,2,00207,India
675610,2023-03-12,201,paneer,210,340,130,1,00207,India
675610,2023-03-12,211,red bull,90,125,35,2,00207,India
675610,2023-03-12,213,bisleri,6,15,9,2,00207,India
506817,2023-03-12,203,mango yogurt,50,60,10,2,00276,India
506817,2023-03-12,212,amul cheese,250,315,65,1,00276,India
506817,2023-03-12,209,pepsi,75,100,25,2,00276,India
529110,2023-03-12,210,mountain dew,75,100,25,2,00111,India
529110,2023-03-12,208,sprite,75,100,25,2,00111,India
207962,2023-03-12,201,paneer,210,340,130,1,00038,India
207962,2023-03-12,202,milk,12,27,15,1,00038,India
207962,2023-03-12,213,bisleri,6,15,9,2,00038,India
481124,2023-03-12,204,strawberry yogurt,50,60,10,2,00060,India
481124,2023-03-12,213,bisleri,6,15,9,2,00060,India
481124,2023-03-12,208,sprite,75,100,25,2,00060,India
481124,2023-03-12,211,red bull,90,125,35,2,00060,India
330996,2023-03-12,212,amul cheese,250,315,65,1,00152,India
330996,2023-03-12,202,milk,12,27,15,1,00152,India
306994,2023-03-12,207,coca cola,75,100,25,2,00484,India
306994,2023-03-12,209,pepsi,75,100,25,2,00484,India
306994,2023-03-12,203,mango yogurt,50,60,10,2,00484,India
491493,2023-03-12,211,red bull,90,125,35,2,00162,India
491493,2023-03-12,209,pepsi,75,100,25,2,00162,India
141943,2023-03-12,210,mountain dew,75,100,25,2,00246,India
141943,2023-03-12,209,pepsi,75,100,25,2,00246,India
141943,2023-03-12,205,classic yogurt,45,60,15,2,00246,India
141943,2023-03-12,212,amul cheese,250,315,65,1,00246,India
722020,2023-03-12,211,red bull,90,125,35,2,00494,India
722020,2023-03-12,210,mountain dew,75,100,25,2,00494,India
722020,2023-03-12,204,strawberry yogurt,50,60,10,2,00494,India
722020,2023-03-12,213,bisleri,6,15,9,2,00494,India
548961,2023-03-12,211,red bull,90,125,35,2,00413,India
548961,2023-03-12,201,paneer,210,340,130,1,00413,India
548961,2023-03-12,204,strawberry yogurt,50,60,10,2,00413,India
734480,2023-03-13,202,milk,12,27,15,1,00183,India
734480,2023-03-13,206,yakult,360,400,40,2,00183,India
734480,2023-03-13,209,pepsi,75,100,25,2,00183,India
734480,2023-03-13,208,sprite,75,100,25,2,00183,India
707862,2023-03-13,204,strawberry yogurt,50,60,10,2,00232,India
681585,2023-03-13,205,classic yogurt,45,60,15,2,00332,India
681585,2023-03-13,210,mountain dew,75,100,25,2,00332,India
681585,2023-03-13,204,strawberry yogurt,50,60,10,2,00332,India
681585,2023-03-13,207,coca cola,75,100,25,2,00332,India
132297,2023-03-13,205,classic yogurt,45,60,15,2,00485,India
683605,2023-03-13,207,coca cola,75,100,25,2,00034,India
683605,2023-03-13,201,paneer,210,340,130,1,00034,India
389266,2023-03-13,206,yakult,360,400,40,2,00373,India
389266,2023-03-13,205,classic yogurt,45,60,15,2,00373,India
101425,2023-03-13,211,red bull,90,125,35,2,00025,India
101425,2023-03-13,210,mountain dew,75,100,25,2,00025,India
101425,2023-03-13,208,sprite,75,100,25,2,00025,India
101425,2023-03-13,205,classic yogurt,45,60,15,2,00025,India
101425,2023-03-13,209,pepsi,75,100,25,2,00025,India
948669,2023-03-13,212,amul cheese,250,315,65,1,00416,India
791696,2023-03-13,212,amul cheese,250,315,65,1,00230,India
791696,2023-03-13,205,classic yogurt,45,60,15,2,00230,India
791696,2023-03-13,209,pepsi,75,100,25,2,00230,India
791696,2023-03-13,202,milk,12,27,15,1,00230,India
791696,2023-03-13,203,mango yogurt,50,60,10,2,00230,India
739442,2023-03-13,205,classic yogurt,45,60,15,2,00245,India
739442,2023-03-13,209,pepsi,75,100,25,2,00245,India
739442,2023-03-13,211,red bull,90,125,35,2,00245,India
739442,2023-03-13,203,mango yogurt,50,60,10,2,00245,India
826242,2023-03-13,207,coca cola,75,100,25,2,00462,India
597956,2023-03-13,206,yakult,360,400,40,2,00109,India
597956,2023-03-13,209,pepsi,75,100,25,2,00109,India
597956,2023-03-13,201,paneer,210,340,130,1,00109,India
597956,2023-03-13,208,sprite,75,100,25,2,00109,India
940263,2023-03-13,210,mountain dew,75,100,25,2,00385,India
145006,2023-03-13,206,yakult,360,400,40,2,00169,India
145006,2023-03-13,203,mango yogurt,50,60,10,2,00169,India
145006,2023-03-13,210,mountain dew,75,100,25,2,00169,India
632289,2023-03-13,201,paneer,210,340,130,1,00215,India
632289,2023-03-13,206,yakult,360,400,40,2,00215,India
632289,2023-03-13,210,mountain dew,75,100,25,2,00215,India
752510,2023-03-13,210,mountain dew,75,100,25,2,00391,India
752510,2023-03-13,213,bisleri,6,15,9,2,00391,India
168386,2023-03-13,205,classic yogurt,45,60,15,2,00368,India
168386,2023-03-13,206,yakult,360,400,40,2,00368,India
392759,2023-03-13,208,sprite,75,100,25,2,00159,India
540458,2023-03-13,210,mountain dew,75,100,25,2,00370,India
540458,2023-03-13,207,coca cola,75,100,25,2,00370,India
540458,2023-03-13,203,mango yogurt,50,60,10,2,00370,India
540458,2023-03-13,212,amul cheese,250,315,65,1,00370,India
728240,2023-03-13,203,mango yogurt,50,60,10,2,00146,India
728240,2023-03-13,212,amul cheese,250,315,65,1,00146,India
728240,2023-03-13,202,milk,12,27,15,1,00146,India
728240,2023-03-13,207,coca cola,75,100,25,2,00146,India
772366,2023-03-13,211,red bull,90,125,35,2,00469,India
772366,2023-03-13,204,strawberry yogurt,50,60,10,2,00469,India
165638,2023-03-13,204,strawberry yogurt,50,60,10,2,00281,India
165638,2023-03-13,208,sprite,75,100,25,2,00281,India
153486,2023-03-13,211,red bull,90,125,35,2,00387,India
153486,2023-03-13,207,coca cola,75,100,25,2,00387,India
173166,2023-03-13,206,yakult,360,400,40,2,00157,India
173166,2023-03-13,205,classic yogurt,45,60,15,2,00157,India
173166,2023-03-13,208,sprite,75,100,25,2,00157,India
173166,2023-03-13,210,mountain dew,75,100,25,2,00157,India
582076,2023-03-13,201,paneer,210,340,130,1,00222,India
377650,2023-03-13,211,red bull,90,125,35,2,00295,India
377650,2023-03-13,208,sprite,75,100,25,2,00295,India
818299,2023-03-13,206,yakult,360,400,40,2,00206,India
818299,2023-03-13,204,strawberry yogurt,50,60,10,2,00206,India
818299,2023-03-13,205,classic yogurt,45,60,15,2,00206,India
808291,2023-03-13,211,red bull,90,125,35,2,00007,India
808291,2023-03-13,203,mango yogurt,50,60,10,2,00007,India
808291,2023-03-13,206,yakult,360,400,40,2,00007,India
980875,2023-03-13,207,coca cola,75,100,25,2,00405,India
980875,2023-03-13,210,mountain dew,75,100,25,2,00405,India
980875,2023-03-13,212,amul cheese,250,315,65,1,00405,India
160294,2023-03-13,211,red bull,90,125,35,2,00369,India
160294,2023-03-13,207,coca cola,75,100,25,2,00369,India
160294,2023-03-13,208,sprite,75,100,25,2,00369,India
160294,2023-03-13,204,strawberry yogurt,50,60,10,2,00369,India
996897,2023-03-13,205,classic yogurt,45,60,15,2,00137,India
996897,2023-03-13,204,strawberry yogurt,50,60,10,2,00137,India
996897,2023-03-13,208,sprite,75,100,25,2,00137,India
939742,2023-03-13,213,bisleri,6,15,9,2,00466,India
939742,2023-03-13,212,amul cheese,250,315,65,1,00466,India
939742,2023-03-13,209,pepsi,75,100,25,2,00466,India
939742,2023-03-13,206,yakult,360,400,40,2,00466,India
732823,2023-03-13,203,mango yogurt,50,60,10,2,00212,India
732823,2023-03-13,206,yakult,360,400,40,2,00212,India
608194,2023-03-13,209,pepsi,75,100,25,2,00410,India
179822,2023-03-13,203,mango yogurt,50,60,10,2,00027,India
275527,2023-03-13,208,sprite,75,100,25,2,00174,India
262790,2023-03-13,201,paneer,210,340,130,1,00114,India
262790,2023-03-13,203,mango yogurt,50,60,10,2,00114,India
262790,2023-03-13,208,sprite,75,100,25,2,00114,India
262790,2023-03-13,209,pepsi,75,100,25,2,00114,India
205827,2023-03-13,205,classic yogurt,45,60,15,2,00293,India
205827,2023-03-13,207,coca cola,75,100,25,2,00293,India
385318,2023-03-13,208,sprite,75,100,25,2,00411,India
385318,2023-03-13,202,milk,12,27,15,1,00411,India
385318,2023-03-13,206,yakult,360,400,40,2,00411,India
219547,2023-03-13,206,yakult,360,400,40,2,00181,India
802019,2023-03-13,212,amul cheese,250,315,65,1,00263,India
802019,2023-03-13,211,red bull,90,125,35,2,00263,India
253218,2023-03-13,203,mango yogurt,50,60,10,2,00013,India
320024,2023-03-13,207,coca cola,75,100,25,2,00429,India
447688,2023-03-13,207,coca cola,75,100,25,2,00039,India
447688,2023-03-13,202,milk,12,27,15,1,00039,India
447688,2023-03-13,211,red bull,90,125,35,2,00039,India
447688,2023-03-13,212,amul cheese,250,315,65,1,00039,India
181490,2023-03-13,210,mountain dew,75,100,25,2,00189,India
181490,2023-03-13,213,bisleri,6,15,9,2,00189,India
181490,2023-03-13,204,strawberry yogurt,50,60,10,2,00189,India
181490,2023-03-13,208,sprite,75,100,25,2,00189,India
181490,2023-03-13,206,yakult,360,400,40,2,00189,India
478857,2023-03-13,203,mango yogurt,50,60,10,2,00402,India
478857,2023-03-13,202,milk,12,27,15,1,00402,India
478857,2023-03-13,205,classic yogurt,45,60,15,2,00402,India
478857,2023-03-13,213,bisleri,6,15,9,2,00402,India
316089,2023-03-13,204,strawberry yogurt,50,60,10,2,00222,India
869667,2023-03-13,204,strawberry yogurt,50,60,10,2,00277,India
869667,2023-03-13,208,sprite,75,100,25,2,00277,India
869667,2023-03-13,201,paneer,210,340,130,1,00277,India
869667,2023-03-13,203,mango yogurt,50,60,10,2,00277,India
782063,2023-03-13,201,paneer,210,340,130,1,00105,India
747895,2023-03-13,213,bisleri,6,15,9,2,00082,India
747895,2023-03-13,208,sprite,75,100,25,2,00082,India
772907,2023-03-13,201,paneer,210,340,130,1,00374,India
772907,2023-03-13,204,strawberry yogurt,50,60,10,2,00374,India
750397,2023-03-13,205,classic yogurt,45,60,15,2,00394,India
750397,2023-03-13,207,coca cola,75,100,25,2,00394,India
750397,2023-03-13,209,pepsi,75,100,25,2,00394,India
750397,2023-03-13,206,yakult,360,400,40,2,00394,India
570348,2023-03-13,212,amul cheese,250,315,65,1,00151,India
570348,2023-03-13,203,mango yogurt,50,60,10,2,00151,India
570348,2023-03-13,206,yakult,360,400,40,2,00151,India
133974,2023-03-13,202,milk,12,27,15,1,00398,India
133974,2023-03-13,209,pepsi,75,100,25,2,00398,India
133974,2023-03-13,207,coca cola,75,100,25,2,00398,India
186485,2023-03-13,201,paneer,210,340,130,1,00009,India
186485,2023-03-13,211,red bull,90,125,35,2,00009,India
768494,2023-03-13,201,paneer,210,340,130,1,00027,India
768494,2023-03-13,211,red bull,90,125,35,2,00027,India
768494,2023-03-13,209,pepsi,75,100,25,2,00027,India
768494,2023-03-13,208,sprite,75,100,25,2,00027,India
963055,2023-03-14,201,paneer,210,340,130,1,00214,India
963055,2023-03-14,213,bisleri,6,15,9,2,00214,India
963055,2023-03-14,211,red bull,90,125,35,2,00214,India
963055,2023-03-14,212,amul cheese,250,315,65,1,00214,India
963055,2023-03-14,208,sprite,75,100,25,2,00214,India
452680,2023-03-14,213,bisleri,6,15,9,2,00142,India
452680,2023-03-14,201,paneer,210,340,130,1,00142,India
232224,2023-03-14,211,red bull,90,125,35,2,00270,India
232224,2023-03-14,213,bisleri,6,15,9,2,00270,India
858611,2023-03-14,210,mountain dew,75,100,25,2,00414,India
858611,2023-03-14,202,milk,12,27,15,1,00414,India
858611,2023-03-14,201,paneer,210,340,130,1,00414,India
858611,2023-03-14,213,bisleri,6,15,9,2,00414,India
844062,2023-03-14,211,red bull,90,125,35,2,00425,India
844062,2023-03-14,203,mango yogurt,50,60,10,2,00425,India
328554,2023-03-14,206,yakult,360,400,40,2,00366,India
328554,2023-03-14,205,classic yogurt,45,60,15,2,00366,India
328554,2023-03-14,207,coca cola,75,100,25,2,00366,India
328554,2023-03-14,209,pepsi,75,100,25,2,00366,India
772528,2023-03-14,203,mango yogurt,50,60,10,2,00375,India
400185,2023-03-14,209,pepsi,75,100,25,2,00486,India
400185,2023-03-14,204,strawberry yogurt,50,60,10,2,00486,India
400185,2023-03-14,208,sprite,75,100,25,2,00486,India
813044,2023-03-14,209,pepsi,75,100,25,2,00303,India
813044,2023-03-14,207,coca cola,75,100,25,2,00303,India
813044,2023-03-14,204,strawberry yogurt,50,60,10,2,00303,India
813044,2023-03-14,206,yakult,360,400,40,2,00303,India
629037,2023-03-14,209,pepsi,75,100,25,2,00160,India
629037,2023-03-14,201,paneer,210,340,130,1,00160,India
629037,2023-03-14,210,mountain dew,75,100,25,2,00160,India
562228,2023-03-14,208,sprite,75,100,25,2,00476,India
562228,2023-03-14,204,strawberry yogurt,50,60,10,2,00476,India
562228,2023-03-14,212,amul cheese,250,315,65,1,00476,India
562228,2023-03-14,213,bisleri,6,15,9,2,00476,India
706806,2023-03-14,210,mountain dew,75,100,25,2,00117,India
706806,2023-03-14,201,paneer,210,340,130,1,00117,India
706806,2023-03-14,209,pepsi,75,100,25,2,00117,India
706806,2023-03-14,211,red bull,90,125,35,2,00117,India
925118,2023-03-14,210,mountain dew,75,100,25,2,00227,India
925118,2023-03-14,208,sprite,75,100,25,2,00227,India
339063,2023-03-14,211,red bull,90,125,35,2,00008,India
339063,2023-03-14,210,mountain dew,75,100,25,2,00008,India
339063,2023-03-14,204,strawberry yogurt,50,60,10,2,00008,India
769283,2023-03-14,201,paneer,210,340,130,1,00419,India
769283,2023-03-14,204,strawberry yogurt,50,60,10,2,00419,India
660677,2023-03-14,205,classic yogurt,45,60,15,2,00285,India
660677,2023-03-14,213,bisleri,6,15,9,2,00285,India
660677,2023-03-14,212,amul cheese,250,315,65,1,00285,India
660677,2023-03-14,209,pepsi,75,100,25,2,00285,India
397732,2023-03-14,209,pepsi,75,100,25,2,00136,India
320051,2023-03-14,206,yakult,360,400,40,2,00334,India
320051,2023-03-14,211,red bull,90,125,35,2,00334,India
170848,2023-03-14,202,milk,12,27,15,1,00001,India
170848,2023-03-14,206,yakult,360,400,40,2,00001,India
192816,2023-03-14,211,red bull,90,125,35,2,00060,India
192816,2023-03-14,207,coca cola,75,100,25,2,00060,India
565792,2023-03-14,206,yakult,360,400,40,2,00319,India
565792,2023-03-14,210,mountain dew,75,100,25,2,00319,India
565792,2023-03-14,211,red bull,90,125,35,2,00319,India
687182,2023-03-14,205,classic yogurt,45,60,15,2,00022,India
687182,2023-03-14,203,mango yogurt,50,60,10,2,00022,India
687182,2023-03-14,212,amul cheese,250,315,65,1,00022,India
108216,2023-03-14,210,mountain dew,75,100,25,2,00466,India
108216,2023-03-14,204,strawberry yogurt,50,60,10,2,00466,India
108216,2023-03-14,205,classic yogurt,45,60,15,2,00466,India
108216,2023-03-14,208,sprite,75,100,25,2,00466,India
588633,2023-03-14,203,mango yogurt,50,60,10,2,00016,India
588633,2023-03-14,210,mountain dew,75,100,25,2,00016,India
588633,2023-03-14,209,pepsi,75,100,25,2,00016,India
588633,2023-03-14,211,red bull,90,125,35,2,00016,India
329337,2023-03-14,212,amul cheese,250,315,65,1,00299,India
367116,2023-03-14,203,mango yogurt,50,60,10,2,00323,India
906551,2023-03-14,210,mountain dew,75,100,25,2,00025,India
906551,2023-03-14,207,coca cola,75,100,25,2,00025,India
342228,2023-03-14,209,pepsi,75,100,25,2,00067,India
342228,2023-03-14,206,yakult,360,400,40,2,00067,India
342228,2023-03-14,201,paneer,210,340,130,1,00067,India
388530,2023-03-14,202,milk,12,27,15,1,00317,India
388530,2023-03-14,205,classic yogurt,45,60,15,2,00317,India
388530,2023-03-14,212,amul cheese,250,315,65,1,00317,India
388530,2023-03-14,203,mango yogurt,50,60,10,2,00317,India
388530,2023-03-14,208,sprite,75,100,25,2,00317,India
390418,2023-03-14,209,pepsi,75,100,25,2,00017,India
390418,2023-03-14,207,coca cola,75,100,25,2,00017,India
390418,2023-03-14,203,mango yogurt,50,60,10,2,00017,India
390418,2023-03-14,202,milk,12,27,15,1,00017,India
745631,2023-03-14,206,yakult,360,400,40,2,00233,India
745631,2023-03-14,203,mango yogurt,50,60,10,2,00233,India
745631,2023-03-14,204,strawberry yogurt,50,60,10,2,00233,India
293296,2023-03-14,207,coca cola,75,100,25,2,00354,India
293296,2023-03-14,209,pepsi,75,100,25,2,00354,India
293296,2023-03-14,208,sprite,75,100,25,2,00354,India
597195,2023-03-14,213,bisleri,6,15,9,2,00009,India
597195,2023-03-14,203,mango yogurt,50,60,10,2,00009,India
597195,2023-03-14,201,paneer,210,340,130,1,00009,India
212825,2023-03-14,209,pepsi,75,100,25,2,00152,India
212825,2023-03-14,211,red bull,90,125,35,2,00152,India
212825,2023-03-14,203,mango yogurt,50,60,10,2,00152,India
374761,2023-03-14,203,mango yogurt,50,60,10,2,00137,India
374761,2023-03-14,208,sprite,75,100,25,2,00137,India
940245,2023-03-14,203,mango yogurt,50,60,10,2,00379,India
940245,2023-03-14,213,bisleri,6,15,9,2,00379,India
940245,2023-03-14,208,sprite,75,100,25,2,00379,India
940245,2023-03-14,206,yakult,360,400,40,2,00379,India
100219,2023-03-14,207,coca cola,75,100,25,2,00155,India
770618,2023-03-14,212,amul cheese,250,315,65,1,00089,India
770618,2023-03-14,208,sprite,75,100,25,2,00089,India
925068,2023-03-14,203,mango yogurt,50,60,10,2,00378,India
925068,2023-03-14,209,pepsi,75,100,25,2,00378,India
361514,2023-03-14,210,mountain dew,75,100,25,2,00140,India
773690,2023-03-14,202,milk,12,27,15,1,00396,India
773690,2023-03-14,208,sprite,75,100,25,2,00396,India
773690,2023-03-14,201,paneer,210,340,130,1,00396,India
773690,2023-03-14,210,mountain dew,75,100,25,2,00396,India
727609,2023-03-14,202,milk,12,27,15,1,00395,India
727609,2023-03-14,212,amul cheese,250,315,65,1,00395,India
727609,2023-03-14,203,mango yogurt,50,60,10,2,00395,India
727609,2023-03-14,205,classic yogurt,45,60,15,2,00395,India
727609,2023-03-14,209,pepsi,75,100,25,2,00395,India
610793,2023-03-14,211,red bull,90,125,35,2,00361,India
610793,2023-03-14,203,mango yogurt,50,60,10,2,00361,India
932411,2023-03-14,204,strawberry yogurt,50,60,10,2,00008,India
932411,2023-03-14,206,yakult,360,400,40,2,00008,India
932411,2023-03-14,203,mango yogurt,50,60,10,2,00008,India
806557,2023-03-14,213,bisleri,6,15,9,2,00221,India
806557,2023-03-14,211,red bull,90,125,35,2,00221,India
806557,2023-03-14,209,pepsi,75,100,25,2,00221,India
806557,2023-03-14,201,paneer,210,340,130,1,00221,India
832653,2023-03-14,207,coca cola,75,100,25,2,00431,India
832653,2023-03-14,202,milk,12,27,15,1,00431,India
639269,2023-03-14,201,paneer,210,340,130,1,00046,India
639269,2023-03-14,203,mango yogurt,50,60,10,2,00046,India
639269,2023-03-14,202,milk,12,27,15,1,00046,India
700067,2023-03-14,210,mountain dew,75,100,25,2,00442,India
700067,2023-03-14,208,sprite,75,100,25,2,00442,India
804343,2023-03-14,209,pepsi,75,100,25,2,00239,India
804343,2023-03-14,204,strawberry yogurt,50,60,10,2,00239,India
978368,2023-03-14,211,red bull,90,125,35,2,00136,India
975705,2023-03-14,212,amul cheese,250,315,65,1,00417,India
975705,2023-03-14,206,yakult,360,400,40,2,00417,India
975705,2023-03-14,209,pepsi,75,100,25,2,00417,India
975705,2023-03-14,205,classic yogurt,45,60,15,2,00417,India
142980,2023-03-14,201,paneer,210,340,130,1,00469,India
142980,2023-03-14,208,sprite,75,100,25,2,00469,India
142980,2023-03-14,209,pepsi,75,100,25,2,00469,India
521739,2023-03-14,203,mango yogurt,50,60,10,2,00081,India
521739,2023-03-14,208,sprite,75,100,25,2,00081,India
521739,2023-03-14,205,classic yogurt,45,60,15,2,00081,India
327493,2023-03-14,211,red bull,90,125,35,2,00262,India
327493,2023-03-14,206,yakult,360,400,40,2,00262,India
327493,2023-03-14,207,coca cola,75,100,25,2,00262,India
327493,2023-03-14,203,mango yogurt,50,60,10,2,00262,India
781316,2023-03-14,208,sprite,75,100,25,2,00365,India
781316,2023-03-14,212,amul cheese,250,315,65,1,00365,India
603978,2023-03-14,206,yakult,360,400,40,2,00104,India
603978,2023-03-14,207,coca cola,75,100,25,2,00104,India
603978,2023-03-14,213,bisleri,6,15,9,2,00104,India
479460,2023-03-14,205,classic yogurt,45,60,15,2,00181,India
479460,2023-03-14,207,coca cola,75,100,25,2,00181,India
136388,2023-03-14,211,red bull,90,125,35,2,00330,India
136388,2023-03-14,202,milk,12,27,15,1,00330,India
136388,2023-03-14,201,paneer,210,340,130,1,00330,India
136388,2023-03-14,203,mango yogurt,50,60,10,2,00330,India
136388,2023-03-14,206,yakult,360,400,40,2,00330,India
893150,2023-03-14,206,yakult,360,400,40,2,00350,India
336039,2023-03-14,211,red bull,90,125,35,2,00420,India
336039,2023-03-14,209,pepsi,75,100,25,2,00420,India
336039,2023-03-14,202,milk,12,27,15,1,00420,India
597250,2023-03-14,213,bisleri,6,15,9,2,00477,India
597250,2023-03-14,203,mango yogurt,50,60,10,2,00477,India
597250,2023-03-14,209,pepsi,75,100,25,2,00477,India
597250,2023-03-14,204,strawberry yogurt,50,60,10,2,00477,India
324162,2023-03-15,211,red bull,90,125,35,2,00329,India
324162,2023-03-15,203,mango yogurt,50,60,10,2,00329,India
324162,2023-03-15,206,yakult,360,400,40,2,00329,India
494970,2023-03-15,206,yakult,360,400,40,2,00138,India
494970,2023-03-15,210,mountain dew,75,100,25,2,00138,India
136254,2023-03-15,207,coca cola,75,100,25,2,00311,India
136254,2023-03-15,213,bisleri,6,15,9,2,00311,India
136254,2023-03-15,203,mango yogurt,50,60,10,2,00311,India
957112,2023-03-15,211,red bull,90,125,35,2,00264,India
957112,2023-03-15,206,yakult,360,400,40,2,00264,India
957112,2023-03-15,204,strawberry yogurt,50,60,10,2,00264,India
957112,2023-03-15,209,pepsi,75,100,25,2,00264,India
853075,2023-03-15,203,mango yogurt,50,60,10,2,00419,India
853075,2023-03-15,211,red bull,90,125,35,2,00419,India
565617,2023-03-15,209,pepsi,75,100,25,2,00361,India
565617,2023-03-15,206,yakult,360,400,40,2,00361,India
547348,2023-03-15,206,yakult,360,400,40,2,00220,India
547348,2023-03-15,201,paneer,210,340,130,1,00220,India
547348,2023-03-15,205,classic yogurt,45,60,15,2,00220,India
547348,2023-03-15,212,amul cheese,250,315,65,1,00220,India
139277,2023-03-15,212,amul cheese,250,315,65,1,00306,India
139277,2023-03-15,202,milk,12,27,15,1,00306,India
139277,2023-03-15,201,paneer,210,340,130,1,00306,India
176934,2023-03-15,213,bisleri,6,15,9,2,00125,India
176934,2023-03-15,201,paneer,210,340,130,1,00125,India
176934,2023-03-15,203,mango yogurt,50,60,10,2,00125,India
176934,2023-03-15,210,mountain dew,75,100,25,2,00125,India
176934,2023-03-15,206,yakult,360,400,40,2,00125,India
391674,2023-03-15,210,mountain dew,75,100,25,2,00401,India
391674,2023-03-15,212,amul cheese,250,315,65,1,00401,India
391674,2023-03-15,205,classic yogurt,45,60,15,2,00401,India
628622,2023-03-15,201,paneer,210,340,130,1,00153,India
838206,2023-03-15,207,coca cola,75,100,25,2,00210,India
838206,2023-03-15,205,classic yogurt,45,60,15,2,00210,India
838206,2023-03-15,202,milk,12,27,15,1,00210,India
264204,2023-03-15,201,paneer,210,340,130,1,00178,India
264204,2023-03-15,210,mountain dew,75,100,25,2,00178,India
998529,2023-03-15,211,red bull,90,125,35,2,00204,India
998529,2023-03-15,202,milk,12,27,15,1,00204,India
998529,2023-03-15,206,yakult,360,400,40,2,00204,India
998529,2023-03-15,207,coca cola,75,100,25,2,00204,India
112404,2023-03-15,204,strawberry yogurt,50,60,10,2,00371,India
112404,2023-03-15,202,milk,12,27,15,1,00371,India
112404,2023-03-15,208,sprite,75,100,25,2,00371,India
950585,2023-03-15,210,mountain dew,75,100,25,2,00190,India
472351,2023-03-15,210,mountain dew,75,100,25,2,00429,India
472351,2023-03-15,207,coca cola,75,100,25,2,00429,India
472351,2023-03-15,202,milk,12,27,15,1,00429,India
472351,2023-03-15,211,red bull,90,125,35,2,00429,India
472351,2023-03-15,203,mango yogurt,50,60,10,2,00429,India
491176,2023-03-15,213,bisleri,6,15,9,2,00042,India
491176,2023-03-15,203,mango yogurt,50,60,10,2,00042,India
491176,2023-03-15,205,classic yogurt,45,60,15,2,00042,India
491176,2023-03-15,209,pepsi,75,100,25,2,00042,India
502574,2023-03-15,208,sprite,75,100,25,2,00361,India
502574,2023-03-15,207,coca cola,75,100,25,2,00361,India
502574,2023-03-15,201,paneer,210,340,130,1,00361,India
823735,2023-03-15,211,red bull,90,125,35,2,00122,India
823735,2023-03-15,212,amul cheese,250,315,65,1,00122,India
823735,2023-03-15,207,coca cola,75,100,25,2,00122,India
901695,2023-03-15,211,red bull,90,125,35,2,00126,India
901695,2023-03-15,203,mango yogurt,50,60,10,2,00126,India
901695,2023-03-15,208,sprite,75,100,25,2,00126,India
423038,2023-03-15,206,yakult,360,400,40,2,00039,India
423038,2023-03-15,207,coca cola,75,100,25,2,00039,India
423038,2023-03-15,212,amul cheese,250,315,65,1,00039,India
423038,2023-03-15,201,paneer,210,340,130,1,00039,India
479401,2023-03-15,213,bisleri,6,15,9,2,00201,India
975369,2023-03-15,207,coca cola,75,100,25,2,00488,India
975369,2023-03-15,206,yakult,360,400,40,2,00488,India
975369,2023-03-15,212,amul cheese,250,315,65,1,00488,India
735752,2023-03-15,211,red bull,90,125,35,2,00133,India
735752,2023-03-15,213,bisleri,6,15,9,2,00133,India
735752,2023-03-15,202,milk,12,27,15,1,00133,India
234975,2023-03-15,202,milk,12,27,15,1,00359,India
234975,2023-03-15,207,coca cola,75,100,25,2,00359,India
845717,2023-03-15,212,amul cheese,250,315,65,1,00152,India
507391,2023-03-15,206,yakult,360,400,40,2,00088,India
507391,2023-03-15,203,mango yogurt,50,60,10,2,00088,India
507391,2023-03-15,209,pepsi,75,100,25,2,00088,India
419752,2023-03-15,201,paneer,210,340,130,1,00386,India
419752,2023-03-15,213,bisleri,6,15,9,2,00386,India
335564,2023-03-15,207,coca cola,75,100,25,2,00410,India
335564,2023-03-15,209,pepsi,75,100,25,2,00410,India
335564,2023-03-15,212,amul cheese,250,315,65,1,00410,India
333549,2023-03-15,211,red bull,90,125,35,2,00385,India
333549,2023-03-15,203,mango yogurt,50,60,10,2,00385,India
333549,2023-03-15,204,strawberry yogurt,50,60,10,2,00385,India
333549,2023-03-15,209,pepsi,75,100,25,2,00385,India
333549,2023-03-15,212,amul cheese,250,315,65,1,00385,India
726604,2023-03-15,207,coca cola,75,100,25,2,00453,India
607116,2023-03-15,211,red bull,90,125,35,2,00357,India
607116,2023-03-15,201,paneer,210,340,130,1,00357,India
607116,2023-03-15,206,yakult,360,400,40,2,00357,India
607116,2023-03-15,205,classic yogurt,45,60,15,2,00357,India
103652,2023-03-15,201,paneer,210,340,130,1,00425,India
103652,2023-03-15,207,coca cola,75,100,25,2,00425,India
103652,2023-03-15,204,strawberry yogurt,50,60,10,2,00425,India
625107,2023-03-15,202,milk,12,27,15,1,00272,India
625107,2023-03-15,210,mountain dew,75,100,25,2,00272,India
625107,2023-03-15,211,red bull,90,125,35,2,00272,India
413941,2023-03-15,204,strawberry yogurt,50,60,10,2,00169,India
413941,2023-03-15,209,pepsi,75,100,25,2,00169,India
413941,2023-03-15,213,bisleri,6,15,9,2,00169,India
804130,2023-03-15,211,red bull,90,125,35,2,00453,India
804130,2023-03-15,206,yakult,360,400,40,2,00453,India
496623,2023-03-15,203,mango yogurt,50,60,10,2,00269,India
496623,2023-03-15,205,classic yogurt,45,60,15,2,00269,India
600510,2023-03-15,202,milk,12,27,15,1,00237,India
600510,2023-03-15,212,amul cheese,250,315,65,1,00237,India
600510,2023-03-15,203,mango yogurt,50,60,10,2,00237,India
673920,2023-03-15,212,amul cheese,250,315,65,1,00433,India
673920,2023-03-15,208,sprite,75,100,25,2,00433,India
673920,2023-03-15,207,coca cola,75,100,25,2,00433,India
343111,2023-03-15,206,yakult,360,400,40,2,00172,India
343111,2023-03-15,203,mango yogurt,50,60,10,2,00172,India
343111,2023-03-15,201,paneer,210,340,130,1,00172,India
131258,2023-03-15,207,coca cola,75,100,25,2,00191,India
131258,2023-03-15,203,mango yogurt,50,60,10,2,00191,India
131258,2023-03-15,208,sprite,75,100,25,2,00191,India
131258,2023-03-15,205,classic yogurt,45,60,15,2,00191,India
682135,2023-03-15,203,mango yogurt,50,60,10,2,00305,India
142741,2023-03-15,204,strawberry yogurt,50,60,10,2,00358,India
142741,2023-03-15,203,mango yogurt,50,60,10,2,00358,India
740838,2023-03-15,201,paneer,210,340,130,1,00399,India
740838,2023-03-15,205,classic yogurt,45,60,15,2,00399,India
740838,2023-03-15,212,amul cheese,250,315,65,1,00399,India
914433,2023-03-15,210,mountain dew,75,100,25,2,00132,India
914433,2023-03-15,207,coca cola,75,100,25,2,00132,India
119752,2023-03-15,204,strawberry yogurt,50,60,10,2,00338,India
523402,2023-03-15,212,amul cheese,250,315,65,1,00007,India
523402,2023-03-15,204,strawberry yogurt,50,60,10,2,00007,India
787158,2023-03-15,206,yakult,360,400,40,2,00062,India
787158,2023-03-15,213,bisleri,6,15,9,2,00062,India
140692,2023-03-15,207,coca cola,75,100,25,2,00371,India
140692,2023-03-15,208,sprite,75,100,25,2,00371,India
140692,2023-03-15,206,yakult,360,400,40,2,00371,India
556841,2023-03-15,209,pepsi,75,100,25,2,00152,India
556841,2023-03-15,211,red bull,90,125,35,2,00152,India
556841,2023-03-15,207,coca cola,75,100,25,2,00152,India
556841,2023-03-15,201,paneer,210,340,130,1,00152,India
556841,2023-03-15,203,mango yogurt,50,60,10,2,00152,India
616395,2023-03-15,211,red bull,90,125,35,2,00269,India
616395,2023-03-15,208,sprite,75,100,25,2,00269,India
616395,2023-03-15,209,pepsi,75,100,25,2,00269,India
616395,2023-03-15,202,milk,12,27,15,1,00269,India
506386,2023-03-15,203,mango yogurt,50,60,10,2,00094,India
717680,2023-03-15,212,amul cheese,250,315,65,1,00368,India
717680,2023-03-15,213,bisleri,6,15,9,2,00368,India
717680,2023-03-15,205,classic yogurt,45,60,15,2,00368,India
398667,2023-03-15,207,coca cola,75,100,25,2,00235,India
398667,2023-03-15,206,yakult,360,400,40,2,00235,India
398667,2023-03-15,204,strawberry yogurt,50,60,10,2,00235,India
398667,2023-03-15,212,amul cheese,250,315,65,1,00235,India
447250,2023-03-15,201,paneer,210,340,130,1,00478,India
447250,2023-03-15,213,bisleri,6,15,9,2,00478,India
447250,2023-03-15,204,strawberry yogurt,50,60,10,2,00478,India
447250,2023-03-15,211,red bull,90,125,35,2,00478,India
447250,2023-03-15,202,milk,12,27,15,1,00478,India
757152,2023-03-15,208,sprite,75,100,25,2,00084,India
757152,2023-03-15,211,red bull,90,125,35,2,00084,India
757152,2023-03-15,210,mountain dew,75,100,25,2,00084,India
757152,2023-03-15,203,mango yogurt,50,60,10,2,00084,India
174957,2023-03-15,212,amul cheese,250,315,65,1,00243,India
174957,2023-03-15,201,paneer,210,340,130,1,00243,India
174957,2023-03-15,211,red bull,90,125,35,2,00243,India
174957,2023-03-15,208,sprite,75,100,25,2,00243,India
661840,2023-03-15,205,classic yogurt,45,60,15,2,00251,India
661840,2023-03-15,213,bisleri,6,15,9,2,00251,India
661840,2023-03-15,202,milk,12,27,15,1,00251,India
362662,2023-03-15,203,mango yogurt,50,60,10,2,00017,India
741300,2023-03-15,210,mountain dew,75,100,25,2,00389,India
741300,2023-03-15,212,amul cheese,250,315,65,1,00389,India
988038,2023-03-15,211,red bull,90,125,35,2,00320,India
988038,2023-03-15,210,mountain dew,75,100,25,2,00320,India
988038,2023-03-15,212,amul cheese,250,315,65,1,00320,India
403116,2023-03-15,202,milk,12,27,15,1,00251,India
403116,2023-03-15,203,mango yogurt,50,60,10,2,00251,India
403116,2023-03-15,211,red bull,90,125,35,2,00251,India
994488,2023-03-15,206,yakult,360,400,40,2,00225,India
994488,2023-03-15,212,amul cheese,250,315,65,1,00225,India
944002,2023-03-15,203,mango yogurt,50,60,10,2,00491,India
944002,2023-03-15,211,red bull,90,125,35,2,00491,India
190464,2023-03-15,209,pepsi,75,100,25,2,00228,India
827778,2023-03-15,207,coca cola,75,100,25,2,00419,India
827778,2023-03-15,206,yakult,360,400,40,2,00419,India
827778,2023-03-15,208,sprite,75,100,25,2,00419,India
827778,2023-03-15,210,mountain dew,75,100,25,2,00419,India
439495,2023-03-15,211,red bull,90,125,35,2,00298,India
123538,2023-03-15,205,classic yogurt,45,60,15,2,00433,India
123538,2023-03-15,204,strawberry yogurt,50,60,10,2,00433,India
123538,2023-03-15,213,bisleri,6,15,9,2,00433,India
123538,2023-03-15,209,pepsi,75,100,25,2,00433,India
326276,2023-03-15,207,coca cola,75,100,25,2,00334,India
326276,2023-03-15,208,sprite,75,100,25,2,00334,India
501540,2023-03-15,202,milk,12,27,15,1,00301,India
501540,2023-03-15,206,yakult,360,400,40,2,00301,India
501540,2023-03-15,211,red bull,90,125,35,2,00301,India
501540,2023-03-15,213,bisleri,6,15,9,2,00301,India
501540,2023-03-15,212,amul cheese,250,315,65,1,00301,India
640173,2023-03-15,210,mountain dew,75,100,25,2,00233,India
640173,2023-03-15,203,mango yogurt,50,60,10,2,00233,India
640173,2023-03-15,206,yakult,360,400,40,2,00233,India
584466,2023-03-15,210,mountain dew,75,100,25,2,00001,India
584466,2023-03-15,203,mango yogurt,50,60,10,2,00001,India
584466,2023-03-15,211,red bull,90,125,35,2,00001,India
967197,2023-03-15,207,coca cola,75,100,25,2,00240,India
967197,2023-03-15,201,paneer,210,340,130,1,00240,India
967197,2023-03-15,206,yakult,360,400,40,2,00240,India
967197,2023-03-15,208,sprite,75,100,25,2,00240,India
967197,2023-03-15,211,red bull,90,125,35,2,00240,India
384686,2023-03-15,210,mountain dew,75,100,25,2,00380,India
384686,2023-03-15,207,coca cola,75,100,25,2,00380,India
372361,2023-03-15,204,strawberry yogurt,50,60,10,2,00216,India
372361,2023-03-15,213,bisleri,6,15,9,2,00216,India
372361,2023-03-15,212,amul cheese,250,315,65,1,00216,India
372361,2023-03-15,208,sprite,75,100,25,2,00216,India
352429,2023-03-15,213,bisleri,6,15,9,2,00181,India
352429,2023-03-15,208,sprite,75,100,25,2,00181,India
352429,2023-03-15,209,pepsi,75,100,25,2,00181,India
865000,2023-03-15,211,red bull,90,125,35,2,00216,India
865000,2023-03-15,210,mountain dew,75,100,25,2,00216,India
865000,2023-03-15,204,strawberry yogurt,50,60,10,2,00216,India
865000,2023-03-15,213,bisleri,6,15,9,2,00216,India
865000,2023-03-15,209,pepsi,75,100,25,2,00216,India
790145,2023-03-15,208,sprite,75,100,25,2,00178,India
790145,2023-03-15,209,pepsi,75,100,25,2,00178,India
423342,2023-03-15,202,milk,12,27,15,1,00035,India
423342,2023-03-15,213,bisleri,6,15,9,2,00035,India
423342,2023-03-15,204,strawberry yogurt,50,60,10,2,00035,India
423342,2023-03-15,212,amul cheese,250,315,65,1,00035,India
423342,2023-03-15,201,paneer,210,340,130,1,00035,India
166459,2023-03-15,202,milk,12,27,15,1,00064,India
166459,2023-03-15,205,classic yogurt,45,60,15,2,00064,India
166459,2023-03-15,210,mountain dew,75,100,25,2,00064,India
166459,2023-03-15,206,yakult,360,400,40,2,00064,India
657401,2023-03-15,209,pepsi,75,100,25,2,00103,India
657401,2023-03-15,207,coca cola,75,100,25,2,00103,India
917345,2023-03-15,213,bisleri,6,15,9,2,00243,India
917345,2023-03-15,212,amul cheese,250,315,65,1,00243,India
917345,2023-03-15,210,mountain dew,75,100,25,2,00243,India
917345,2023-03-15,201,paneer,210,340,130,1,00243,India
917345,2023-03-15,211,red bull,90,125,35,2,00243,India
768539,2023-03-15,211,red bull,90,125,35,2,00326,India
768539,2023-03-15,208,sprite,75,100,25,2,00326,India
768539,2023-03-15,205,classic yogurt,45,60,15,2,00326,India
768539,2023-03-15,203,mango yogurt,50,60,10,2,00326,India
983390,2023-03-15,206,yakult,360,400,40,2,00425,India
983390,2023-03-15,208,sprite,75,100,25,2,00425,India
983390,2023-03-15,202,milk,12,27,15,1,00425,India
983390,2023-03-15,205,classic yogurt,45,60,15,2,00425,India
218932,2023-03-15,210,mountain dew,75,100,25,2,00310,India
141801,2023-03-15,213,bisleri,6,15,9,2,00016,India
141801,2023-03-15,206,yakult,360,400,40,2,00016,India
117563,2023-03-15,205,classic yogurt,45,60,15,2,00255,India
117563,2023-03-15,208,sprite,75,100,25,2,00255,India
117563,2023-03-15,210,mountain dew,75,100,25,2,00255,India
117563,2023-03-15,202,milk,12,27,15,1,00255,India
945367,2023-03-15,211,red bull,90,125,35,2,00280,India
945367,2023-03-15,207,coca cola,75,100,25,2,00280,India
853654,2023-03-15,207,coca cola,75,100,25,2,00386,India
853654,2023-03-15,211,red bull,90,125,35,2,00386,India
853654,2023-03-15,208,sprite,75,100,25,2,00386,India
491290,2023-03-15,208,sprite,75,100,25,2,00200,India
491290,2023-03-15,210,mountain dew,75,100,25,2,00200,India
491290,2023-03-15,204,strawberry yogurt,50,60,10,2,00200,India
150299,2023-03-15,203,mango yogurt,50,60,10,2,00158,India
150299,2023-03-15,204,strawberry yogurt,50,60,10,2,00158,India
150299,2023-03-15,208,sprite,75,100,25,2,00158,India
150299,2023-03-15,201,paneer,210,340,130,1,00158,India
593299,2023-03-15,213,bisleri,6,15,9,2,00468,India
593299,2023-03-15,204,strawberry yogurt,50,60,10,2,00468,India
593299,2023-03-15,201,paneer,210,340,130,1,00468,India
593299,2023-03-15,205,classic yogurt,45,60,15,2,00468,India
593299,2023-03-15,210,mountain dew,75,100,25,2,00468,India
347586,2023-03-16,205,classic yogurt,45,60,15,2,00185,India
151079,2023-03-16,201,paneer,210,340,130,1,00419,India
151079,2023-03-16,203,mango yogurt,50,60,10,2,00419,India
151079,2023-03-16,202,milk,12,27,15,1,00419,India
433101,2023-03-16,205,classic yogurt,45,60,15,2,00158,India
433101,2023-03-16,202,milk,12,27,15,1,00158,India
433101,2023-03-16,206,yakult,360,400,40,2,00158,India
929573,2023-03-16,204,strawberry yogurt,50,60,10,2,00174,India
929573,2023-03-16,206,yakult,360,400,40,2,00174,India
934500,2023-03-16,212,amul cheese,250,315,65,1,00208,India
959091,2023-03-16,207,coca cola,75,100,25,2,00221,India
959091,2023-03-16,201,paneer,210,340,130,1,00221,India
125681,2023-03-16,212,amul cheese,250,315,65,1,00163,India
125681,2023-03-16,208,sprite,75,100,25,2,00163,India
125681,2023-03-16,201,paneer,210,340,130,1,00163,India
629896,2023-03-16,209,pepsi,75,100,25,2,00100,India
629896,2023-03-16,203,mango yogurt,50,60,10,2,00100,India
629896,2023-03-16,211,red bull,90,125,35,2,00100,India
629896,2023-03-16,206,yakult,360,400,40,2,00100,India
629896,2023-03-16,204,strawberry yogurt,50,60,10,2,00100,India
939311,2023-03-16,212,amul cheese,250,315,65,1,00354,India
939311,2023-03-16,203,mango yogurt,50,60,10,2,00354,India
939311,2023-03-16,206,yakult,360,400,40,2,00354,India
360305,2023-03-16,209,pepsi,75,100,25,2,00369,India
360305,2023-03-16,203,mango yogurt,50,60,10,2,00369,India
360305,2023-03-16,205,classic yogurt,45,60,15,2,00369,India
360305,2023-03-16,201,paneer,210,340,130,1,00369,India
282354,2023-03-16,201,paneer,210,340,130,1,00455,India
955017,2023-03-16,206,yakult,360,400,40,2,00041,India
955017,2023-03-16,210,mountain dew,75,100,25,2,00041,India
955017,2023-03-16,201,paneer,210,340,130,1,00041,India
521664,2023-03-16,208,sprite,75,100,25,2,00364,India
521664,2023-03-16,210,mountain dew,75,100,25,2,00364,India
521664,2023-03-16,206,yakult,360,400,40,2,00364,India
361577,2023-03-16,207,coca cola,75,100,25,2,00018,India
132603,2023-03-16,203,mango yogurt,50,60,10,2,00058,India
132603,2023-03-16,211,red bull,90,125,35,2,00058,India
428295,2023-03-16,205,classic yogurt,45,60,15,2,00163,India
428295,2023-03-16,201,paneer,210,340,130,1,00163,India
457197,2023-03-16,202,milk,12,27,15,1,00353,India
457197,2023-03-16,209,pepsi,75,100,25,2,00353,India
723589,2023-03-16,201,paneer,210,340,130,1,00347,India
746157,2023-03-16,206,yakult,360,400,40,2,00203,India
746157,2023-03-16,203,mango yogurt,50,60,10,2,00203,India
746157,2023-03-16,205,classic yogurt,45,60,15,2,00203,India
746157,2023-03-16,211,red bull,90,125,35,2,00203,India
746157,2023-03-16,201,paneer,210,340,130,1,00203,India
421636,2023-03-16,203,mango yogurt,50,60,10,2,00442,India
421636,2023-03-16,204,strawberry yogurt,50,60,10,2,00442,India
421636,2023-03-16,213,bisleri,6,15,9,2,00442,India
421636,2023-03-16,211,red bull,90,125,35,2,00442,India
741305,2023-03-16,203,mango yogurt,50,60,10,2,00340,India
741305,2023-03-16,211,red bull,90,125,35,2,00340,India
741305,2023-03-16,201,paneer,210,340,130,1,00340,India
741305,2023-03-16,205,classic yogurt,45,60,15,2,00340,India
741305,2023-03-16,209,pepsi,75,100,25,2,00340,India
422542,2023-03-16,212,amul cheese,250,315,65,1,00024,India
422542,2023-03-16,207,coca cola,75,100,25,2,00024,India
422542,2023-03-16,201,paneer,210,340,130,1,00024,India
422542,2023-03-16,211,red bull,90,125,35,2,00024,India
400368,2023-03-16,208,sprite,75,100,25,2,00196,India
400368,2023-03-16,204,strawberry yogurt,50,60,10,2,00196,India
400368,2023-03-16,213,bisleri,6,15,9,2,00196,India
856865,2023-03-16,212,amul cheese,250,315,65,1,00056,India
856865,2023-03-16,209,pepsi,75,100,25,2,00056,India
950737,2023-03-16,213,bisleri,6,15,9,2,00391,India
721981,2023-03-16,207,coca cola,75,100,25,2,00298,India
707702,2023-03-16,202,milk,12,27,15,1,00081,India
707702,2023-03-16,207,coca cola,75,100,25,2,00081,India
707702,2023-03-16,211,red bull,90,125,35,2,00081,India
707702,2023-03-16,204,strawberry yogurt,50,60,10,2,00081,India
364407,2023-03-16,210,mountain dew,75,100,25,2,00286,India
364407,2023-03-16,211,red bull,90,125,35,2,00286,India
364407,2023-03-16,202,milk,12,27,15,1,00286,India
287245,2023-03-16,211,red bull,90,125,35,2,00411,India
287245,2023-03-16,204,strawberry yogurt,50,60,10,2,00411,India
287245,2023-03-16,202,milk,12,27,15,1,00411,India
579362,2023-03-16,209,pepsi,75,100,25,2,00110,India
627881,2023-03-16,212,amul cheese,250,315,65,1,00212,India
732558,2023-03-16,205,classic yogurt,45,60,15,2,00461,India
732558,2023-03-16,212,amul cheese,250,315,65,1,00461,India
732558,2023-03-16,206,yakult,360,400,40,2,00461,India
732558,2023-03-16,210,mountain dew,75,100,25,2,00461,India
732558,2023-03-16,202,milk,12,27,15,1,00461,India
528009,2023-03-16,207,coca cola,75,100,25,2,00140,India
528009,2023-03-16,208,sprite,75,100,25,2,00140,India
528009,2023-03-16,204,strawberry yogurt,50,60,10,2,00140,India
345228,2023-03-16,206,yakult,360,400,40,2,00237,India
750056,2023-03-16,206,yakult,360,400,40,2,00023,India
750056,2023-03-16,201,paneer,210,340,130,1,00023,India
750056,2023-03-16,212,amul cheese,250,315,65,1,00023,India
306938,2023-03-16,209,pepsi,75,100,25,2,00434,India
306938,2023-03-16,211,red bull,90,125,35,2,00434,India
878277,2023-03-16,207,coca cola,75,100,25,2,00306,India
878277,2023-03-16,212,amul cheese,250,315,65,1,00306,India
878277,2023-03-16,210,mountain dew,75,100,25,2,00306,India
878277,2023-03-16,204,strawberry yogurt,50,60,10,2,00306,India
209319,2023-03-16,204,strawberry yogurt,50,60,10,2,00297,India
209319,2023-03-16,211,red bull,90,125,35,2,00297,India
209319,2023-03-16,202,milk,12,27,15,1,00297,India
209319,2023-03-16,203,mango yogurt,50,60,10,2,00297,India
543453,2023-03-16,209,pepsi,75,100,25,2,00104,India
543453,2023-03-16,202,milk,12,27,15,1,00104,India
163107,2023-03-16,202,milk,12,27,15,1,00332,India
163107,2023-03-16,203,mango yogurt,50,60,10,2,00332,India
163107,2023-03-16,209,pepsi,75,100,25,2,00332,India
163107,2023-03-16,212,amul cheese,250,315,65,1,00332,India
163107,2023-03-16,210,mountain dew,75,100,25,2,00332,India
285759,2023-03-16,201,paneer,210,340,130,1,00443,India
285759,2023-03-16,206,yakult,360,400,40,2,00443,India
842912,2023-03-16,213,bisleri,6,15,9,2,00409,India
842912,2023-03-16,202,milk,12,27,15,1,00409,India
842912,2023-03-16,207,coca cola,75,100,25,2,00409,India
305445,2023-03-16,202,milk,12,27,15,1,00355,India
305445,2023-03-16,213,bisleri,6,15,9,2,00355,India
305445,2023-03-16,201,paneer,210,340,130,1,00355,India
235614,2023-03-16,208,sprite,75,100,25,2,00391,India
911706,2023-03-16,212,amul cheese,250,315,65,1,00471,India
911706,2023-03-16,202,milk,12,27,15,1,00471,India
911706,2023-03-16,201,paneer,210,340,130,1,00471,India
871204,2023-03-16,204,strawberry yogurt,50,60,10,2,00485,India
871204,2023-03-16,208,sprite,75,100,25,2,00485,India
871204,2023-03-16,201,paneer,210,340,130,1,00485,India
850163,2023-03-16,203,mango yogurt,50,60,10,2,00454,India
850163,2023-03-16,210,mountain dew,75,100,25,2,00454,India
850163,2023-03-16,208,sprite,75,100,25,2,00454,India
850163,2023-03-16,211,red bull,90,125,35,2,00454,India
280239,2023-03-16,212,amul cheese,250,315,65,1,00238,India
280239,2023-03-16,204,strawberry yogurt,50,60,10,2,00238,India
794048,2023-03-16,213,bisleri,6,15,9,2,00236,India
794048,2023-03-16,206,yakult,360,400,40,2,00236,India
794048,2023-03-16,211,red bull,90,125,35,2,00236,India
953368,2023-03-16,209,pepsi,75,100,25,2,00285,India
953368,2023-03-16,207,coca cola,75,100,25,2,00285,India
953368,2023-03-16,212,amul cheese,250,315,65,1,00285,India
953368,2023-03-16,202,milk,12,27,15,1,00285,India
953368,2023-03-16,205,classic yogurt,45,60,15,2,00285,India
364467,2023-03-16,210,mountain dew,75,100,25,2,00126,India
589665,2023-03-16,205,classic yogurt,45,60,15,2,00436,India
589665,2023-03-16,208,sprite,75,100,25,2,00436,India
227761,2023-03-16,206,yakult,360,400,40,2,00468,India
227761,2023-03-16,207,coca cola,75,100,25,2,00468,India
265386,2023-03-16,209,pepsi,75,100,25,2,00387,India
265386,2023-03-16,213,bisleri,6,15,9,2,00387,India
265386,2023-03-16,206,yakult,360,400,40,2,00387,India
265386,2023-03-16,204,strawberry yogurt,50,60,10,2,00387,India
373898,2023-03-16,202,milk,12,27,15,1,00245,India
373898,2023-03-16,204,strawberry yogurt,50,60,10,2,00245,India
373898,2023-03-16,201,paneer,210,340,130,1,00245,India
942042,2023-03-16,213,bisleri,6,15,9,2,00331,India
746965,2023-03-16,211,red bull,90,125,35,2,00165,India
746965,2023-03-16,212,amul cheese,250,315,65,1,00165,India
903595,2023-03-16,212,amul cheese,250,315,65,1,00396,India
903595,2023-03-16,204,strawberry yogurt,50,60,10,2,00396,India
903595,2023-03-16,209,pepsi,75,100,25,2,00396,India
469247,2023-03-16,211,red bull,90,125,35,2,00321,India
936045,2023-03-16,207,coca cola,75,100,25,2,00349,India
936045,2023-03-16,203,mango yogurt,50,60,10,2,00349,India
936045,2023-03-16,209,pepsi,75,100,25,2,00349,India
936045,2023-03-16,202,milk,12,27,15,1,00349,India
204667,2023-03-16,212,amul cheese,250,315,65,1,00380,India
204667,2023-03-16,204,strawberry yogurt,50,60,10,2,00380,India
204667,2023-03-16,210,mountain dew,75,100,25,2,00380,India
970206,2023-03-16,201,paneer,210,340,130,1,00127,India
970206,2023-03-16,207,coca cola,75,100,25,2,00127,India
970206,2023-03-16,210,mountain dew,75,100,25,2,00127,India
410270,2023-03-16,207,coca cola,75,100,25,2,00209,India
776872,2023-03-17,207,coca cola,75,100,25,2,00289,India
776872,2023-03-17,208,sprite,75,100,25,2,00289,India
214093,2023-03-17,207,coca cola,75,100,25,2,00327,India
214093,2023-03-17,205,classic yogurt,45,60,15,2,00327,India
155776,2023-03-17,213,bisleri,6,15,9,2,00373,India
155776,2023-03-17,207,coca cola,75,100,25,2,00373,India
155776,2023-03-17,204,strawberry yogurt,50,60,10,2,00373,India
903374,2023-03-17,202,milk,12,27,15,1,00145,India
903374,2023-03-17,212,amul cheese,250,315,65,1,00145,India
903374,2023-03-17,209,pepsi,75,100,25,2,00145,India
903374,2023-03-17,203,mango yogurt,50,60,10,2,00145,India
615922,2023-03-17,205,classic yogurt,45,60,15,2,00030,India
615922,2023-03-17,210,mountain dew,75,100,25,2,00030,India
711994,2023-03-17,204,strawberry yogurt,50,60,10,2,00460,India
711994,2023-03-17,203,mango yogurt,50,60,10,2,00460,India
531876,2023-03-17,211,red bull,90,125,35,2,00453,India
531876,2023-03-17,201,paneer,210,340,130,1,00453,India
972047,2023-03-17,206,yakult,360,400,40,2,00240,India
972047,2023-03-17,213,bisleri,6,15,9,2,00240,India
972047,2023-03-17,210,mountain dew,75,100,25,2,00240,India
316275,2023-03-17,213,bisleri,6,15,9,2,00184,India
793776,2023-03-17,201,paneer,210,340,130,1,00360,India
793776,2023-03-17,208,sprite,75,100,25,2,00360,India
793776,2023-03-17,206,yakult,360,400,40,2,00360,India
793776,2023-03-17,212,amul cheese,250,315,65,1,00360,India
863732,2023-03-17,208,sprite,75,100,25,2,00085,India
445886,2023-03-17,203,mango yogurt,50,60,10,2,00267,India
445886,2023-03-17,208,sprite,75,100,25,2,00267,India
445886,2023-03-17,204,strawberry yogurt,50,60,10,2,00267,India
568496,2023-03-17,205,classic yogurt,45,60,15,2,00296,India
568496,2023-03-17,212,amul cheese,250,315,65,1,00296,India
197200,2023-03-17,213,bisleri,6,15,9,2,00004,India
459121,2023-03-17,212,amul cheese,250,315,65,1,00350,India
459121,2023-03-17,203,mango yogurt,50,60,10,2,00350,India
198636,2023-03-17,203,mango yogurt,50,60,10,2,00378,India
198636,2023-03-17,210,mountain dew,75,100,25,2,00378,India
198636,2023-03-17,204,strawberry yogurt,50,60,10,2,00378,India
586991,2023-03-17,207,coca cola,75,100,25,2,00374,India
586991,2023-03-17,202,milk,12,27,15,1,00374,India
586991,2023-03-17,205,classic yogurt,45,60,15,2,00374,India
586991,2023-03-17,203,mango yogurt,50,60,10,2,00374,India
296413,2023-03-17,208,sprite,75,100,25,2,00044,India
296413,2023-03-17,202,milk,12,27,15,1,00044,India
217273,2023-03-17,206,yakult,360,400,40,2,00176,India
217273,2023-03-17,209,pepsi,75,100,25,2,00176,India
217273,2023-03-17,203,mango yogurt,50,60,10,2,00176,India
217273,2023-03-17,208,sprite,75,100,25,2,00176,India
217273,2023-03-17,201,paneer,210,340,130,1,00176,India
207955,2023-03-17,212,amul cheese,250,315,65,1,00143,India
207955,2023-03-17,207,coca cola,75,100,25,2,00143,India
797821,2023-03-17,213,bisleri,6,15,9,2,00219,India
797821,2023-03-17,211,red bull,90,125,35,2,00219,India
797821,2023-03-17,210,mountain dew,75,100,25,2,00219,India
983806,2023-03-17,204,strawberry yogurt,50,60,10,2,00292,India
983806,2023-03-17,212,amul cheese,250,315,65,1,00292,India
983806,2023-03-17,205,classic yogurt,45,60,15,2,00292,India
727894,2023-03-17,212,amul cheese,250,315,65,1,00233,India
727894,2023-03-17,211,red bull,90,125,35,2,00233,India
727894,2023-03-17,208,sprite,75,100,25,2,00233,India
403415,2023-03-17,207,coca cola,75,100,25,2,00045,India
403415,2023-03-17,208,sprite,75,100,25,2,00045,India
941271,2023-03-17,204,strawberry yogurt,50,60,10,2,00016,India
622448,2023-03-17,207,coca cola,75,100,25,2,00139,India
622448,2023-03-17,202,milk,12,27,15,1,00139,India
622448,2023-03-17,203,mango yogurt,50,60,10,2,00139,India
886841,2023-03-17,207,coca cola,75,100,25,2,00113,India
886841,2023-03-17,211,red bull,90,125,35,2,00113,India
886841,2023-03-17,209,pepsi,75,100,25,2,00113,India
670041,2023-03-17,204,strawberry yogurt,50,60,10,2,00061,India
670041,2023-03-17,207,coca cola,75,100,25,2,00061,India
670041,2023-03-17,208,sprite,75,100,25,2,00061,India
670041,2023-03-17,203,mango yogurt,50,60,10,2,00061,India
670041,2023-03-17,209,pepsi,75,100,25,2,00061,India
271341,2023-03-17,212,amul cheese,250,315,65,1,00429,India
271341,2023-03-17,205,classic yogurt,45,60,15,2,00429,India
271341,2023-03-17,202,milk,12,27,15,1,00429,India
807176,2023-03-17,209,pepsi,75,100,25,2,00013,India
899042,2023-03-17,213,bisleri,6,15,9,2,00021,India
899042,2023-03-17,211,red bull,90,125,35,2,00021,India
899042,2023-03-17,206,yakult,360,400,40,2,00021,India
899042,2023-03-17,208,sprite,75,100,25,2,00021,India
217171,2023-03-17,207,coca cola,75,100,25,2,00218,India
767761,2023-03-17,209,pepsi,75,100,25,2,00177,India
767761,2023-03-17,207,coca cola,75,100,25,2,00177,India
767761,2023-03-17,210,mountain dew,75,100,25,2,00177,India
767761,2023-03-17,203,mango yogurt,50,60,10,2,00177,India
123131,2023-03-17,202,milk,12,27,15,1,00141,India
197636,2023-03-17,206,yakult,360,400,40,2,00032,India
814542,2023-03-17,202,milk,12,27,15,1,00370,India
814542,2023-03-17,209,pepsi,75,100,25,2,00370,India
814542,2023-03-17,201,paneer,210,340,130,1,00370,India
814542,2023-03-17,205,classic yogurt,45,60,15,2,00370,India
814542,2023-03-17,211,red bull,90,125,35,2,00370,India
605948,2023-03-17,209,pepsi,75,100,25,2,00480,India
605948,2023-03-17,203,mango yogurt,50,60,10,2,00480,India
403013,2023-03-17,209,pepsi,75,100,25,2,00384,India
403013,2023-03-17,205,classic yogurt,45,60,15,2,00384,India
403013,2023-03-17,201,paneer,210,340,130,1,00384,India
403013,2023-03-17,202,milk,12,27,15,1,00384,India
865621,2023-03-17,206,yakult,360,400,40,2,00183,India
865621,2023-03-17,212,amul cheese,250,315,65,1,00183,India
865621,2023-03-17,213,bisleri,6,15,9,2,00183,India
458827,2023-03-17,204,strawberry yogurt,50,60,10,2,00295,India
458827,2023-03-17,212,amul cheese,250,315,65,1,00295,India
458827,2023-03-17,208,sprite,75,100,25,2,00295,India
458827,2023-03-17,209,pepsi,75,100,25,2,00295,India
458827,2023-03-17,210,mountain dew,75,100,25,2,00295,India
698900,2023-03-17,207,coca cola,75,100,25,2,00053,India
698900,2023-03-17,201,paneer,210,340,130,1,00053,India
852139,2023-03-17,204,strawberry yogurt,50,60,10,2,00183,India
852139,2023-03-17,210,mountain dew,75,100,25,2,00183,India
852139,2023-03-17,213,bisleri,6,15,9,2,00183,India
593548,2023-03-17,210,mountain dew,75,100,25,2,00381,India
593548,2023-03-17,205,classic yogurt,45,60,15,2,00381,India
817593,2023-03-17,206,yakult,360,400,40,2,00493,India
817593,2023-03-17,203,mango yogurt,50,60,10,2,00493,India
817593,2023-03-17,202,milk,12,27,15,1,00493,India
817593,2023-03-17,204,strawberry yogurt,50,60,10,2,00493,India
817593,2023-03-17,208,sprite,75,100,25,2,00493,India
827789,2023-03-17,201,paneer,210,340,130,1,00135,India
827789,2023-03-17,212,amul cheese,250,315,65,1,00135,India
319920,2023-03-17,212,amul cheese,250,315,65,1,00016,India
164119,2023-03-17,205,classic yogurt,45,60,15,2,00187,India
164119,2023-03-17,208,sprite,75,100,25,2,00187,India
406608,2023-03-17,212,amul cheese,250,315,65,1,00424,India
407824,2023-03-17,209,pepsi,75,100,25,2,00044,India
407824,2023-03-17,211,red bull,90,125,35,2,00044,India
407824,2023-03-17,206,yakult,360,400,40,2,00044,India
407824,2023-03-17,203,mango yogurt,50,60,10,2,00044,India
429978,2023-03-17,204,strawberry yogurt,50,60,10,2,00444,India
429978,2023-03-17,203,mango yogurt,50,60,10,2,00444,India
326946,2023-03-17,205,classic yogurt,45,60,15,2,00337,India
876695,2023-03-17,212,amul cheese,250,315,65,1,00344,India
876695,2023-03-17,201,paneer,210,340,130,1,00344,India
876695,2023-03-17,207,coca cola,75,100,25,2,00344,India
876695,2023-03-17,211,red bull,90,125,35,2,00344,India
123901,2023-03-17,205,classic yogurt,45,60,15,2,00445,India
123901,2023-03-17,201,paneer,210,340,130,1,00445,India
123901,2023-03-17,207,coca cola,75,100,25,2,00445,India
123901,2023-03-17,210,mountain dew,75,100,25,2,00445,India
499093,2023-03-17,207,coca cola,75,100,25,2,00247,India
499093,2023-03-17,208,sprite,75,100,25,2,00247,India
499093,2023-03-17,204,strawberry yogurt,50,60,10,2,00247,India
856976,2023-03-17,206,yakult,360,400,40,2,00004,India
856976,2023-03-17,205,classic yogurt,45,60,15,2,00004,India
856976,2023-03-17,203,mango yogurt,50,60,10,2,00004,India
856976,2023-03-17,204,strawberry yogurt,50,60,10,2,00004,India
130046,2023-03-17,212,amul cheese,250,315,65,1,00051,India
130046,2023-03-17,211,red bull,90,125,35,2,00051,India
130046,2023-03-17,213,bisleri,6,15,9,2,00051,India
345027,2023-03-17,208,sprite,75,100,25,2,00257,India
345027,2023-03-17,207,coca cola,75,100,25,2,00257,India
500912,2023-03-17,204,strawberry yogurt,50,60,10,2,00228,India
688363,2023-03-17,212,amul cheese,250,315,65,1,00463,India
695663,2023-03-17,205,classic yogurt,45,60,15,2,00164,India
695663,2023-03-17,209,pepsi,75,100,25,2,00164,India
115945,2023-03-17,201,paneer,210,340,130,1,00252,India
877548,2023-03-17,202,milk,12,27,15,1,00259,India
877548,2023-03-17,213,bisleri,6,15,9,2,00259,India
679236,2023-03-17,202,milk,12,27,15,1,00207,India
198562,2023-03-17,204,strawberry yogurt,50,60,10,2,00094,India
198562,2023-03-17,208,sprite,75,100,25,2,00094,India
644002,2023-03-17,206,yakult,360,400,40,2,00480,India
644002,2023-03-17,210,mountain dew,75,100,25,2,00480,India
644002,2023-03-17,201,paneer,210,340,130,1,00480,India
644002,2023-03-17,212,amul cheese,250,315,65,1,00480,India
660092,2023-03-17,205,classic yogurt,45,60,15,2,00206,India
959416,2023-03-17,202,milk,12,27,15,1,00489,India
493115,2023-03-17,211,red bull,90,125,35,2,00103,India
493115,2023-03-17,210,mountain dew,75,100,25,2,00103,India
493115,2023-03-17,204,strawberry yogurt,50,60,10,2,00103,India
493115,2023-03-17,203,mango yogurt,50,60,10,2,00103,India
701952,2023-03-17,210,mountain dew,75,100,25,2,00135,India
701952,2023-03-17,209,pepsi,75,100,25,2,00135,India
753895,2023-03-17,204,strawberry yogurt,50,60,10,2,00145,India
753895,2023-03-17,211,red bull,90,125,35,2,00145,India
753895,2023-03-17,208,sprite,75,100,25,2,00145,India
753895,2023-03-17,201,paneer,210,340,130,1,00145,India
634577,2023-03-17,203,mango yogurt,50,60,10,2,00085,India
634577,2023-03-17,211,red bull,90,125,35,2,00085,India
634577,2023-03-17,210,mountain dew,75,100,25,2,00085,India
634577,2023-03-17,201,paneer,210,340,130,1,00085,India
334277,2023-03-17,206,yakult,360,400,40,2,00114,India
334277,2023-03-17,212,amul cheese,250,315,65,1,00114,India
849924,2023-03-17,213,bisleri,6,15,9,2,00256,India
849924,2023-03-17,211,red bull,90,125,35,2,00256,India
849924,2023-03-17,210,mountain dew,75,100,25,2,00256,India
849924,2023-03-17,212,amul cheese,250,315,65,1,00256,India
545989,2023-03-17,213,bisleri,6,15,9,2,00442,India
545989,2023-03-17,201,paneer,210,340,130,1,00442,India
545989,2023-03-17,209,pepsi,75,100,25,2,00442,India
525995,2023-03-17,210,mountain dew,75,100,25,2,00360,India
525995,2023-03-17,212,amul cheese,250,315,65,1,00360,India
525995,2023-03-17,201,paneer,210,340,130,1,00360,India
959980,2023-03-17,204,strawberry yogurt,50,60,10,2,00231,India
959980,2023-03-17,205,classic yogurt,45,60,15,2,00231,India
776108,2023-03-17,210,mountain dew,75,100,25,2,00111,India
727130,2023-03-17,201,paneer,210,340,130,1,00431,India
727130,2023-03-17,202,milk,12,27,15,1,00431,India
727130,2023-03-17,213,bisleri,6,15,9,2,00431,India
644795,2023-03-17,212,amul cheese,250,315,65,1,00487,India
644795,2023-03-17,206,yakult,360,400,40,2,00487,India
195724,2023-03-17,205,classic yogurt,45,60,15,2,00462,India
321281,2023-03-17,202,milk,12,27,15,1,00432,India
321281,2023-03-17,209,pepsi,75,100,25,2,00432,India
321281,2023-03-17,206,yakult,360,400,40,2,00432,India
671179,2023-03-17,208,sprite,75,100,25,2,00077,India
979362,2023-03-17,211,red bull,90,125,35,2,00359,India
979362,2023-03-17,201,paneer,210,340,130,1,00359,India
979362,2023-03-17,212,amul cheese,250,315,65,1,00359,India
729665,2023-03-17,208,sprite,75,100,25,2,00337,India
729665,2023-03-17,212,amul cheese,250,315,65,1,00337,India
729665,2023-03-17,207,coca cola,75,100,25,2,00337,India
892247,2023-03-17,202,milk,12,27,15,1,00054,India
892247,2023-03-17,211,red bull,90,125,35,2,00054,India
892247,2023-03-17,213,bisleri,6,15,9,2,00054,India
892247,2023-03-17,203,mango yogurt,50,60,10,2,00054,India
497838,2023-03-17,209,pepsi,75,100,25,2,00121,India
687994,2023-03-17,201,paneer,210,340,130,1,00141,India
822850,2023-03-17,206,yakult,360,400,40,2,00280,India
822850,2023-03-17,208,sprite,75,100,25,2,00280,India
822850,2023-03-17,201,paneer,210,340,130,1,00280,India
546988,2023-03-17,210,mountain dew,75,100,25,2,00135,India
938091,2023-03-17,207,coca cola,75,100,25,2,00144,India
938091,2023-03-17,203,mango yogurt,50,60,10,2,00144,India
598187,2023-03-17,203,mango yogurt,50,60,10,2,00227,India
598187,2023-03-17,208,sprite,75,100,25,2,00227,India
355333,2023-03-17,204,strawberry yogurt,50,60,10,2,00359,India
355333,2023-03-17,210,mountain dew,75,100,25,2,00359,India
355333,2023-03-17,205,classic yogurt,45,60,15,2,00359,India
355333,2023-03-17,213,bisleri,6,15,9,2,00359,India
894433,2023-03-17,206,yakult,360,400,40,2,00499,India
894433,2023-03-17,201,paneer,210,340,130,1,00499,India
894433,2023-03-17,205,classic yogurt,45,60,15,2,00499,India
894433,2023-03-17,204,strawberry yogurt,50,60,10,2,00499,India
645573,2023-03-17,207,coca cola,75,100,25,2,00027,India
645573,2023-03-17,209,pepsi,75,100,25,2,00027,India
645573,2023-03-17,206,yakult,360,400,40,2,00027,India
136520,2023-03-18,209,pepsi,75,100,25,2,00233,India
136520,2023-03-18,208,sprite,75,100,25,2,00233,India
136520,2023-03-18,212,amul cheese,250,315,65,1,00233,India
295816,2023-03-18,204,strawberry yogurt,50,60,10,2,00083,India
842402,2023-03-18,213,bisleri,6,15,9,2,00058,India
183348,2023-03-18,201,paneer,210,340,130,1,00445,India
150235,2023-03-18,203,mango yogurt,50,60,10,2,00266,India
150235,2023-03-18,207,coca cola,75,100,25,2,00266,India
870982,2023-03-18,207,coca cola,75,100,25,2,00349,India
870982,2023-03-18,209,pepsi,75,100,25,2,00349,India
870982,2023-03-18,204,strawberry yogurt,50,60,10,2,00349,India
870982,2023-03-18,202,milk,12,27,15,1,00349,India
870982,2023-03-18,210,mountain dew,75,100,25,2,00349,India
923672,2023-03-18,205,classic yogurt,45,60,15,2,00318,India
923672,2023-03-18,203,mango yogurt,50,60,10,2,00318,India
932778,2023-03-18,203,mango yogurt,50,60,10,2,00167,India
932778,2023-03-18,205,classic yogurt,45,60,15,2,00167,India
932778,2023-03-18,209,pepsi,75,100,25,2,00167,India
932778,2023-03-18,208,sprite,75,100,25,2,00167,India
205684,2023-03-18,202,milk,12,27,15,1,00227,India
205684,2023-03-18,211,red bull,90,125,35,2,00227,India
205684,2023-03-18,207,coca cola,75,100,25,2,00227,India
541320,2023-03-18,205,classic yogurt,45,60,15,2,00037,India
282915,2023-03-18,210,mountain dew,75,100,25,2,00245,India
282915,2023-03-18,209,pepsi,75,100,25,2,00245,India
282915,2023-03-18,213,bisleri,6,15,9,2,00245,India
969152,2023-03-18,204,strawberry yogurt,50,60,10,2,00164,India
140755,2023-03-18,211,red bull,90,125,35,2,00344,India
140755,2023-03-18,209,pepsi,75,100,25,2,00344,India
140755,2023-03-18,206,yakult,360,400,40,2,00344,India
140755,2023-03-18,207,coca cola,75,100,25,2,00344,India
477881,2023-03-18,202,milk,12,27,15,1,00493,India
477881,2023-03-18,204,strawberry yogurt,50,60,10,2,00493,India
477881,2023-03-18,208,sprite,75,100,25,2,00493,India
187570,2023-03-18,211,red bull,90,125,35,2,00128,India
187570,2023-03-18,213,bisleri,6,15,9,2,00128,India
187570,2023-03-18,212,amul cheese,250,315,65,1,00128,India
187570,2023-03-18,209,pepsi,75,100,25,2,00128,India
956331,2023-03-18,205,classic yogurt,45,60,15,2,00366,India
956331,2023-03-18,212,amul cheese,250,315,65,1,00366,India
956331,2023-03-18,211,red bull,90,125,35,2,00366,India
956331,2023-03-18,204,strawberry yogurt,50,60,10,2,00366,India
956331,2023-03-18,206,yakult,360,400,40,2,00366,India
560943,2023-03-18,203,mango yogurt,50,60,10,2,00464,India
560943,2023-03-18,204,strawberry yogurt,50,60,10,2,00464,India
560943,2023-03-18,212,amul cheese,250,315,65,1,00464,India
560943,2023-03-18,207,coca cola,75,100,25,2,00464,India
560943,2023-03-18,211,red bull,90,125,35,2,00464,India
395030,2023-03-18,208,sprite,75,100,25,2,00298,India
395030,2023-03-18,212,amul cheese,250,315,65,1,00298,India
395030,2023-03-18,207,coca cola,75,100,25,2,00298,India
395030,2023-03-18,201,paneer,210,340,130,1,00298,India
256997,2023-03-18,202,milk,12,27,15,1,00444,India
256997,2023-03-18,201,paneer,210,340,130,1,00444,India
256997,2023-03-18,208,sprite,75,100,25,2,00444,India
256997,2023-03-18,204,strawberry yogurt,50,60,10,2,00444,India
720542,2023-03-18,206,yakult,360,400,40,2,00326,India
720542,2023-03-18,201,paneer,210,340,130,1,00326,India
720542,2023-03-18,203,mango yogurt,50,60,10,2,00326,India
739436,2023-03-18,204,strawberry yogurt,50,60,10,2,00245,India
739436,2023-03-18,202,milk,12,27,15,1,00245,India
739436,2023-03-18,211,red bull,90,125,35,2,00245,India
739436,2023-03-18,206,yakult,360,400,40,2,00245,India
790821,2023-03-18,203,mango yogurt,50,60,10,2,00102,India
370318,2023-03-18,212,amul cheese,250,315,65,1,00383,India
370318,2023-03-18,207,coca cola,75,100,25,2,00383,India
370318,2023-03-18,210,mountain dew,75,100,25,2,00383,India
492984,2023-03-18,211,red bull,90,125,35,2,00361,India
492984,2023-03-18,209,pepsi,75,100,25,2,00361,India
196001,2023-03-18,209,pepsi,75,100,25,2,00298,India
196001,2023-03-18,204,strawberry yogurt,50,60,10,2,00298,India
196001,2023-03-18,205,classic yogurt,45,60,15,2,00298,India
196001,2023-03-18,201,paneer,210,340,130,1,00298,India
309778,2023-03-18,201,paneer,210,340,130,1,00416,India
309778,2023-03-18,207,coca cola,75,100,25,2,00416,India
766150,2023-03-18,211,red bull,90,125,35,2,00053,India
189212,2023-03-18,209,pepsi,75,100,25,2,00428,India
189212,2023-03-18,202,milk,12,27,15,1,00428,India
506554,2023-03-18,207,coca cola,75,100,25,2,00179,India
506554,2023-03-18,204,strawberry yogurt,50,60,10,2,00179,India
506554,2023-03-18,213,bisleri,6,15,9,2,00179,India
506554,2023-03-18,210,mountain dew,75,100,25,2,00179,India
856595,2023-03-18,203,mango yogurt,50,60,10,2,00394,India
759480,2023-03-18,208,sprite,75,100,25,2,00207,India
759480,2023-03-18,201,paneer,210,340,130,1,00207,India
759480,2023-03-18,211,red bull,90,125,35,2,00207,India
759480,2023-03-18,205,classic yogurt,45,60,15,2,00207,India
759480,2023-03-18,202,milk,12,27,15,1,00207,India
434171,2023-03-18,205,classic yogurt,45,60,15,2,00312,India
434171,2023-03-18,208,sprite,75,100,25,2,00312,India
601335,2023-03-18,210,mountain dew,75,100,25,2,00455,India
601335,2023-03-18,203,mango yogurt,50,60,10,2,00455,India
601335,2023-03-18,201,paneer,210,340,130,1,00455,India
601335,2023-03-18,212,amul cheese,250,315,65,1,00455,India
601335,2023-03-18,202,milk,12,27,15,1,00455,India
890682,2023-03-18,209,pepsi,75,100,25,2,00106,India
666260,2023-03-18,202,milk,12,27,15,1,00301,India
761945,2023-03-18,208,sprite,75,100,25,2,00188,India
761945,2023-03-18,201,paneer,210,340,130,1,00188,India
761945,2023-03-18,212,amul cheese,250,315,65,1,00188,India
761945,2023-03-18,207,coca cola,75,100,25,2,00188,India
257031,2023-03-18,207,coca cola,75,100,25,2,00075,India
305382,2023-03-18,212,amul cheese,250,315,65,1,00489,India
305382,2023-03-18,210,mountain dew,75,100,25,2,00489,India
305382,2023-03-18,201,paneer,210,340,130,1,00489,India
817962,2023-03-18,213,bisleri,6,15,9,2,00206,India
817962,2023-03-18,206,yakult,360,400,40,2,00206,India
817962,2023-03-18,207,coca cola,75,100,25,2,00206,India
340568,2023-03-18,208,sprite,75,100,25,2,00348,India
340568,2023-03-18,209,pepsi,75,100,25,2,00348,India
340568,2023-03-18,201,paneer,210,340,130,1,00348,India
774782,2023-03-18,206,yakult,360,400,40,2,00023,India
774782,2023-03-18,203,mango yogurt,50,60,10,2,00023,India
325212,2023-03-18,213,bisleri,6,15,9,2,00238,India
325212,2023-03-18,204,strawberry yogurt,50,60,10,2,00238,India
325212,2023-03-18,211,red bull,90,125,35,2,00238,India
642991,2023-03-18,208,sprite,75,100,25,2,00375,India
642991,2023-03-18,213,bisleri,6,15,9,2,00375,India
408497,2023-03-18,213,bisleri,6,15,9,2,00457,India
859898,2023-03-18,211,red bull,90,125,35,2,00352,India
795813,2023-03-18,208,sprite,75,100,25,2,00125,India
673801,2023-03-18,213,bisleri,6,15,9,2,00121,India
673801,2023-03-18,208,sprite,75,100,25,2,00121,India
130196,2023-03-18,207,coca cola,75,100,25,2,00321,India
130196,2023-03-18,209,pepsi,75,100,25,2,00321,India
130196,2023-03-18,204,strawberry yogurt,50,60,10,2,00321,India
130196,2023-03-18,210,mountain dew,75,100,25,2,00321,India
971372,2023-03-18,210,mountain dew,75,100,25,2,00234,India
971372,2023-03-18,206,yakult,360,400,40,2,00234,India
978399,2023-03-18,212,amul cheese,250,315,65,1,00065,India
978399,2023-03-18,208,sprite,75,100,25,2,00065,India
978399,2023-03-18,210,mountain dew,75,100,25,2,00065,India
555487,2023-03-18,212,amul cheese,250,315,65,1,00117,India
146435,2023-03-18,205,classic yogurt,45,60,15,2,00266,India
146435,2023-03-18,210,mountain dew,75,100,25,2,00266,India
354369,2023-03-18,201,paneer,210,340,130,1,00400,India
752099,2023-03-18,204,strawberry yogurt,50,60,10,2,00254,India
752099,2023-03-18,212,amul cheese,250,315,65,1,00254,India
438171,2023-03-18,211,red bull,90,125,35,2,00409,India
438171,2023-03-18,206,yakult,360,400,40,2,00409,India
438171,2023-03-18,201,paneer,210,340,130,1,00409,India
438171,2023-03-18,204,strawberry yogurt,50,60,10,2,00409,India
823179,2023-03-18,204,strawberry yogurt,50,60,10,2,00393,India
823179,2023-03-18,207,coca cola,75,100,25,2,00393,India
888601,2023-03-18,209,pepsi,75,100,25,2,00021,India
888601,2023-03-18,213,bisleri,6,15,9,2,00021,India
799196,2023-03-18,211,red bull,90,125,35,2,00320,India
799196,2023-03-18,213,bisleri,6,15,9,2,00320,India
799196,2023-03-18,212,amul cheese,250,315,65,1,00320,India
799196,2023-03-18,205,classic yogurt,45,60,15,2,00320,India
181322,2023-03-18,212,amul cheese,250,315,65,1,00422,India
181322,2023-03-18,203,mango yogurt,50,60,10,2,00422,India
769161,2023-03-18,206,yakult,360,400,40,2,00397,India
769161,2023-03-18,212,amul cheese,250,315,65,1,00397,India
769161,2023-03-18,211,red bull,90,125,35,2,00397,India
974985,2023-03-18,205,classic yogurt,45,60,15,2,00025,India
974985,2023-03-18,202,milk,12,27,15,1,00025,India
974985,2023-03-18,212,amul cheese,250,315,65,1,00025,India
974985,2023-03-18,206,yakult,360,400,40,2,00025,India
433414,2023-03-18,205,classic yogurt,45,60,15,2,00344,India
433414,2023-03-18,213,bisleri,6,15,9,2,00344,India
433414,2023-03-18,212,amul cheese,250,315,65,1,00344,India
948726,2023-03-18,207,coca cola,75,100,25,2,00100,India
948726,2023-03-18,203,mango yogurt,50,60,10,2,00100,India
210316,2023-03-18,210,mountain dew,75,100,25,2,00413,India
210316,2023-03-18,204,strawberry yogurt,50,60,10,2,00413,India
210316,2023-03-18,208,sprite,75,100,25,2,00413,India
455237,2023-03-18,208,sprite,75,100,25,2,00388,India
455237,2023-03-18,211,red bull,90,125,35,2,00388,India
455237,2023-03-18,210,mountain dew,75,100,25,2,00388,India
455237,2023-03-18,209,pepsi,75,100,25,2,00388,India
455237,2023-03-18,213,bisleri,6,15,9,2,00388,India
963600,2023-03-18,205,classic yogurt,45,60,15,2,00222,India
963600,2023-03-18,204,strawberry yogurt,50,60,10,2,00222,India
963600,2023-03-18,203,mango yogurt,50,60,10,2,00222,India
963600,2023-03-18,208,sprite,75,100,25,2,00222,India
963600,2023-03-18,211,red bull,90,125,35,2,00222,India
444837,2023-03-18,204,strawberry yogurt,50,60,10,2,00203,India
444837,2023-03-18,213,bisleri,6,15,9,2,00203,India
444837,2023-03-18,201,paneer,210,340,130,1,00203,India
444837,2023-03-18,212,amul cheese,250,315,65,1,00203,India
444837,2023-03-18,210,mountain dew,75,100,25,2,00203,India
578136,2023-03-18,204,strawberry yogurt,50,60,10,2,00297,India
765546,2023-03-18,202,milk,12,27,15,1,00398,India
765546,2023-03-18,204,strawberry yogurt,50,60,10,2,00398,India
765546,2023-03-18,210,mountain dew,75,100,25,2,00398,India
765546,2023-03-18,203,mango yogurt,50,60,10,2,00398,India
406775,2023-03-19,207,coca cola,75,100,25,2,00469,India
610529,2023-03-19,210,mountain dew,75,100,25,2,00300,India
610529,2023-03-19,204,strawberry yogurt,50,60,10,2,00300,India
610529,2023-03-19,202,milk,12,27,15,1,00300,India
274964,2023-03-19,209,pepsi,75,100,25,2,00178,India
742151,2023-03-19,203,mango yogurt,50,60,10,2,00315,India
909244,2023-03-19,211,red bull,90,125,35,2,00198,India
909244,2023-03-19,213,bisleri,6,15,9,2,00198,India
909244,2023-03-19,209,pepsi,75,100,25,2,00198,India
715147,2023-03-19,212,amul cheese,250,315,65,1,00038,India
715147,2023-03-19,209,pepsi,75,100,25,2,00038,India
171998,2023-03-19,213,bisleri,6,15,9,2,00220,India
171998,2023-03-19,208,sprite,75,100,25,2,00220,India
171998,2023-03-19,204,strawberry yogurt,50,60,10,2,00220,India
171998,2023-03-19,212,amul cheese,250,315,65,1,00220,India
248832,2023-03-19,213,bisleri,6,15,9,2,00027,India
248832,2023-03-19,205,classic yogurt,45,60,15,2,00027,India
728160,2023-03-19,213,bisleri,6,15,9,2,00308,India
728160,2023-03-19,208,sprite,75,100,25,2,00308,India
840434,2023-03-19,209,pepsi,75,100,25,2,00369,India
840434,2023-03-19,202,milk,12,27,15,1,00369,India
840434,2023-03-19,211,red bull,90,125,35,2,00369,India
688665,2023-03-19,209,pepsi,75,100,25,2,00218,India
688665,2023-03-19,202,milk,12,27,15,1,00218,India
688665,2023-03-19,211,red bull,90,125,35,2,00218,India
688665,2023-03-19,205,classic yogurt,45,60,15,2,00218,India
780696,2023-03-19,212,amul cheese,250,315,65,1,00436,India
780696,2023-03-19,202,milk,12,27,15,1,00436,India
829745,2023-03-19,211,red bull,90,125,35,2,00123,India
829745,2023-03-19,212,amul cheese,250,315,65,1,00123,India
829745,2023-03-19,206,yakult,360,400,40,2,00123,India
829745,2023-03-19,213,bisleri,6,15,9,2,00123,India
474411,2023-03-19,210,mountain dew,75,100,25,2,00118,India
474411,2023-03-19,205,classic yogurt,45,60,15,2,00118,India
474411,2023-03-19,211,red bull,90,125,35,2,00118,India
474411,2023-03-19,202,milk,12,27,15,1,00118,India
463511,2023-03-19,210,mountain dew,75,100,25,2,00267,India
463511,2023-03-19,206,yakult,360,400,40,2,00267,India
463511,2023-03-19,211,red bull,90,125,35,2,00267,India
463511,2023-03-19,205,classic yogurt,45,60,15,2,00267,India
510707,2023-03-19,211,red bull,90,125,35,2,00348,India
510707,2023-03-19,210,mountain dew,75,100,25,2,00348,India
748876,2023-03-19,202,milk,12,27,15,1,00403,India
748876,2023-03-19,207,coca cola,75,100,25,2,00403,India
748876,2023-03-19,205,classic yogurt,45,60,15,2,00403,India
748876,2023-03-19,203,mango yogurt,50,60,10,2,00403,India
748876,2023-03-19,210,mountain dew,75,100,25,2,00403,India
618597,2023-03-19,206,yakult,360,400,40,2,00447,India
618597,2023-03-19,205,classic yogurt,45,60,15,2,00447,India
618597,2023-03-19,207,coca cola,75,100,25,2,00447,India
591221,2023-03-19,210,mountain dew,75,100,25,2,00021,India
591221,2023-03-19,211,red bull,90,125,35,2,00021,India
591221,2023-03-19,212,amul cheese,250,315,65,1,00021,India
591221,2023-03-19,209,pepsi,75,100,25,2,00021,India
397862,2023-03-19,209,pepsi,75,100,25,2,00217,India
397862,2023-03-19,211,red bull,90,125,35,2,00217,India
397862,2023-03-19,212,amul cheese,250,315,65,1,00217,India
397862,2023-03-19,206,yakult,360,400,40,2,00217,India
545948,2023-03-19,208,sprite,75,100,25,2,00248,India
545948,2023-03-19,202,milk,12,27,15,1,00248,India
545948,2023-03-19,213,bisleri,6,15,9,2,00248,India
182747,2023-03-19,205,classic yogurt,45,60,15,2,00083,India
182747,2023-03-19,207,coca cola,75,100,25,2,00083,India
182747,2023-03-19,206,yakult,360,400,40,2,00083,India
182747,2023-03-19,202,milk,12,27,15,1,00083,India
493712,2023-03-19,204,strawberry yogurt,50,60,10,2,00233,India
493712,2023-03-19,213,bisleri,6,15,9,2,00233,India
493712,2023-03-19,202,milk,12,27,15,1,00233,India
348918,2023-03-19,211,red bull,90,125,35,2,00272,India
178352,2023-03-19,201,paneer,210,340,130,1,00312,India
178352,2023-03-19,210,mountain dew,75,100,25,2,00312,India
178352,2023-03-19,209,pepsi,75,100,25,2,00312,India
178352,2023-03-19,203,mango yogurt,50,60,10,2,00312,India
178352,2023-03-19,204,strawberry yogurt,50,60,10,2,00312,India
986514,2023-03-19,213,bisleri,6,15,9,2,00039,India
986514,2023-03-19,203,mango yogurt,50,60,10,2,00039,India
986514,2023-03-19,206,yakult,360,400,40,2,00039,India
986514,2023-03-19,201,paneer,210,340,130,1,00039,India
401118,2023-03-19,201,paneer,210,340,130,1,00069,India
401118,2023-03-19,212,amul cheese,250,315,65,1,00069,India
401118,2023-03-19,204,strawberry yogurt,50,60,10,2,00069,India
401118,2023-03-19,208,sprite,75,100,25,2,00069,India
115321,2023-03-19,209,pepsi,75,100,25,2,00235,India
115321,2023-03-19,212,amul cheese,250,315,65,1,00235,India
115321,2023-03-19,207,coca cola,75,100,25,2,00235,India
130494,2023-03-19,204,strawberry yogurt,50,60,10,2,00471,India
130494,2023-03-19,213,bisleri,6,15,9,2,00471,India
130494,2023-03-19,203,mango yogurt,50,60,10,2,00471,India
251302,2023-03-19,213,bisleri,6,15,9,2,00212,India
251302,2023-03-19,204,strawberry yogurt,50,60,10,2,00212,India
292860,2023-03-19,211,red bull,90,125,35,2,00330,India
292860,2023-03-19,213,bisleri,6,15,9,2,00330,India
292860,2023-03-19,202,milk,12,27,15,1,00330,India
498774,2023-03-19,201,paneer,210,340,130,1,00153,India
116844,2023-03-19,210,mountain dew,75,100,25,2,00493,India
221300,2023-03-19,207,coca cola,75,100,25,2,00215,India
221300,2023-03-19,213,bisleri,6,15,9,2,00215,India
221300,2023-03-19,203,mango yogurt,50,60,10,2,00215,India
221300,2023-03-19,210,mountain dew,75,100,25,2,00215,India
221300,2023-03-19,212,amul cheese,250,315,65,1,00215,India
438959,2023-03-19,211,red bull,90,125,35,2,00343,India
438959,2023-03-19,209,pepsi,75,100,25,2,00343,India
438959,2023-03-19,210,mountain dew,75,100,25,2,00343,India
946342,2023-03-19,203,mango yogurt,50,60,10,2,00389,India
522725,2023-03-19,211,red bull,90,125,35,2,00435,India
522725,2023-03-19,201,paneer,210,340,130,1,00435,India
522725,2023-03-19,205,classic yogurt,45,60,15,2,00435,India
522725,2023-03-19,202,milk,12,27,15,1,00435,India
522725,2023-03-19,212,amul cheese,250,315,65,1,00435,India
387835,2023-03-19,210,mountain dew,75,100,25,2,00323,India
387835,2023-03-19,202,milk,12,27,15,1,00323,India
145650,2023-03-19,204,strawberry yogurt,50,60,10,2,00051,India
145650,2023-03-19,201,paneer,210,340,130,1,00051,India
145650,2023-03-19,207,coca cola,75,100,25,2,00051,India
145650,2023-03-19,208,sprite,75,100,25,2,00051,India
145650,2023-03-19,202,milk,12,27,15,1,00051,India
283287,2023-03-19,206,yakult,360,400,40,2,00405,India
325137,2023-03-19,209,pepsi,75,100,25,2,00191,India
325137,2023-03-19,201,paneer,210,340,130,1,00191,India
325137,2023-03-19,203,mango yogurt,50,60,10,2,00191,India
325137,2023-03-19,210,mountain dew,75,100,25,2,00191,India
786565,2023-03-19,209,pepsi,75,100,25,2,00053,India
786565,2023-03-19,213,bisleri,6,15,9,2,00053,India
163175,2023-03-19,205,classic yogurt,45,60,15,2,00435,India
163175,2023-03-19,201,paneer,210,340,130,1,00435,India
163175,2023-03-19,203,mango yogurt,50,60,10,2,00435,India
163175,2023-03-19,202,milk,12,27,15,1,00435,India
546433,2023-03-19,209,pepsi,75,100,25,2,00115,India
546433,2023-03-19,201,paneer,210,340,130,1,00115,India
546433,2023-03-19,203,mango yogurt,50,60,10,2,00115,India
546433,2023-03-19,211,red bull,90,125,35,2,00115,India
571368,2023-03-19,206,yakult,360,400,40,2,00344,India
571368,2023-03-19,210,mountain dew,75,100,25,2,00344,India
571368,2023-03-19,201,paneer,210,340,130,1,00344,India
571368,2023-03-19,207,coca cola,75,100,25,2,00344,India
571368,2023-03-19,203,mango yogurt,50,60,10,2,00344,India
167118,2023-03-19,212,amul cheese,250,315,65,1,00269,India
167118,2023-03-19,202,milk,12,27,15,1,00269,India
167118,2023-03-19,211,red bull,90,125,35,2,00269,India
167118,2023-03-19,206,yakult,360,400,40,2,00269,India
793140,2023-03-19,203,mango yogurt,50,60,10,2,00143,India
793140,2023-03-19,209,pepsi,75,100,25,2,00143,India
793140,2023-03-19,207,coca cola,75,100,25,2,00143,India
355760,2023-03-19,213,bisleri,6,15,9,2,00163,India
355760,2023-03-19,209,pepsi,75,100,25,2,00163,India
585169,2023-03-19,207,coca cola,75,100,25,2,00123,India
585169,2023-03-19,206,yakult,360,400,40,2,00123,India
585169,2023-03-19,210,mountain dew,75,100,25,2,00123,India
149523,2023-03-19,202,milk,12,27,15,1,00393,India
149523,2023-03-19,207,coca cola,75,100,25,2,00393,India
149523,2023-03-19,212,amul cheese,250,315,65,1,00393,India
149523,2023-03-19,206,yakult,360,400,40,2,00393,India
221764,2023-03-19,205,classic yogurt,45,60,15,2,00318,India
221764,2023-03-19,203,mango yogurt,50,60,10,2,00318,India
221764,2023-03-19,204,strawberry yogurt,50,60,10,2,00318,India
749638,2023-03-19,210,mountain dew,75,100,25,2,00423,India
749638,2023-03-19,201,paneer,210,340,130,1,00423,India
749638,2023-03-19,204,strawberry yogurt,50,60,10,2,00423,India
596320,2023-03-19,210,mountain dew,75,100,25,2,00219,India
596320,2023-03-19,213,bisleri,6,15,9,2,00219,India
596320,2023-03-19,209,pepsi,75,100,25,2,00219,India
596320,2023-03-19,208,sprite,75,100,25,2,00219,India
730552,2023-03-19,213,bisleri,6,15,9,2,00354,India
730552,2023-03-19,210,mountain dew,75,100,25,2,00354,India
730552,2023-03-19,212,amul cheese,250,315,65,1,00354,India
730552,2023-03-19,209,pepsi,75,100,25,2,00354,India
870339,2023-03-19,202,milk,12,27,15,1,00111,India
686077,2023-03-19,210,mountain dew,75,100,25,2,00074,India
686077,2023-03-19,207,coca cola,75,100,25,2,00074,India
686077,2023-03-19,203,mango yogurt,50,60,10,2,00074,India
677645,2023-03-19,203,mango yogurt,50,60,10,2,00122,India
677645,2023-03-19,201,paneer,210,340,130,1,00122,India
677645,2023-03-19,211,red bull,90,125,35,2,00122,India
677645,2023-03-19,209,pepsi,75,100,25,2,00122,India
932366,2023-03-19,205,classic yogurt,45,60,15,2,00127,India
932366,2023-03-19,211,red bull,90,125,35,2,00127,India
148077,2023-03-19,202,milk,12,27,15,1,00288,India
148077,2023-03-19,211,red bull,90,125,35,2,00288,India
779846,2023-03-19,209,pepsi,75,100,25,2,00230,India
779846,2023-03-19,212,amul cheese,250,315,65,1,00230,India
779846,2023-03-19,203,mango yogurt,50,60,10,2,00230,India
779846,2023-03-19,202,milk,12,27,15,1,00230,India
779846,2023-03-19,213,bisleri,6,15,9,2,00230,India
541182,2023-03-19,206,yakult,360,400,40,2,00244,India
541182,2023-03-19,203,mango yogurt,50,60,10,2,00244,India
541182,2023-03-19,209,pepsi,75,100,25,2,00244,India
541182,2023-03-19,212,amul cheese,250,315,65,1,00244,India
350539,2023-03-19,206,yakult,360,400,40,2,00173,India
350539,2023-03-19,201,paneer,210,340,130,1,00173,India
790579,2023-03-19,202,milk,12,27,15,1,00492,India
790579,2023-03-19,201,paneer,210,340,130,1,00492,India
790579,2023-03-19,212,amul cheese,250,315,65,1,00492,India
237930,2023-03-19,204,strawberry yogurt,50,60,10,2,00371,India
237930,2023-03-19,212,amul cheese,250,315,65,1,00371,India
237930,2023-03-19,209,pepsi,75,100,25,2,00371,India
205713,2023-03-19,203,mango yogurt,50,60,10,2,00214,India
205713,2023-03-19,202,milk,12,27,15,1,00214,India
205713,2023-03-19,205,classic yogurt,45,60,15,2,00214,India
971214,2023-03-19,207,coca cola,75,100,25,2,00373,India
971214,2023-03-19,213,bisleri,6,15,9,2,00373,India
824326,2023-03-19,208,sprite,75,100,25,2,00073,India
824326,2023-03-19,201,paneer,210,340,130,1,00073,India
954643,2023-03-19,208,sprite,75,100,25,2,00449,India
954643,2023-03-19,209,pepsi,75,100,25,2,00449,India
954643,2023-03-19,204,strawberry yogurt,50,60,10,2,00449,India
914410,2023-03-19,211,red bull,90,125,35,2,00383,India
914410,2023-03-19,203,mango yogurt,50,60,10,2,00383,India
914410,2023-03-19,205,classic yogurt,45,60,15,2,00383,India
256566,2023-03-19,213,bisleri,6,15,9,2,00231,India
502222,2023-03-19,202,milk,12,27,15,1,00303,India
743830,2023-03-19,212,amul cheese,250,315,65,1,00336,India
743830,2023-03-19,213,bisleri,6,15,9,2,00336,India
743830,2023-03-19,207,coca cola,75,100,25,2,00336,India
666922,2023-03-19,202,milk,12,27,15,1,00342,India
666922,2023-03-19,207,coca cola,75,100,25,2,00342,India
966672,2023-03-20,203,mango yogurt,50,60,10,2,00154,India
180032,2023-03-20,201,paneer,210,340,130,1,00077,India
180032,2023-03-20,205,classic yogurt,45,60,15,2,00077,India
180032,2023-03-20,212,amul cheese,250,315,65,1,00077,India
180032,2023-03-20,203,mango yogurt,50,60,10,2,00077,India
180032,2023-03-20,207,coca cola,75,100,25,2,00077,India
797218,2023-03-20,213,bisleri,6,15,9,2,00300,India
797218,2023-03-20,209,pepsi,75,100,25,2,00300,India
797218,2023-03-20,211,red bull,90,125,35,2,00300,India
797218,2023-03-20,210,mountain dew,75,100,25,2,00300,India
731616,2023-03-20,204,strawberry yogurt,50,60,10,2,00018,India
333866,2023-03-20,210,mountain dew,75,100,25,2,00366,India
333866,2023-03-20,203,mango yogurt,50,60,10,2,00366,India
333866,2023-03-20,207,coca cola,75,100,25,2,00366,India
463290,2023-03-20,205,classic yogurt,45,60,15,2,00166,India
420507,2023-03-20,209,pepsi,75,100,25,2,00231,India
420507,2023-03-20,205,classic yogurt,45,60,15,2,00231,India
420507,2023-03-20,212,amul cheese,250,315,65,1,00231,India
420507,2023-03-20,210,mountain dew,75,100,25,2,00231,India
420507,2023-03-20,208,sprite,75,100,25,2,00231,India
340577,2023-03-20,208,sprite,75,100,25,2,00454,India
340577,2023-03-20,207,coca cola,75,100,25,2,00454,India
340577,2023-03-20,202,milk,12,27,15,1,00454,India
733328,2023-03-20,201,paneer,210,340,130,1,00210,India
733328,2023-03-20,203,mango yogurt,50,60,10,2,00210,India
733328,2023-03-20,207,coca cola,75,100,25,2,00210,India
733328,2023-03-20,212,amul cheese,250,315,65,1,00210,India
220393,2023-03-20,202,milk,12,27,15,1,00370,India
949064,2023-03-20,209,pepsi,75,100,25,2,00075,India
949064,2023-03-20,202,milk,12,27,15,1,00075,India
427732,2023-03-20,204,strawberry yogurt,50,60,10,2,00091,India
427732,2023-03-20,201,paneer,210,340,130,1,00091,India
427732,2023-03-20,203,mango yogurt,50,60,10,2,00091,India
779339,2023-03-20,213,bisleri,6,15,9,2,00465,India
779339,2023-03-20,201,paneer,210,340,130,1,00465,India
966583,2023-03-20,201,paneer,210,340,130,1,00181,India
276427,2023-03-20,207,coca cola,75,100,25,2,00368,India
276427,2023-03-20,208,sprite,75,100,25,2,00368,India
276427,2023-03-20,205,classic yogurt,45,60,15,2,00368,India
332156,2023-03-20,210,mountain dew,75,100,25,2,00370,India
332156,2023-03-20,212,amul cheese,250,315,65,1,00370,India
561607,2023-03-20,204,strawberry yogurt,50,60,10,2,00135,India
561607,2023-03-20,212,amul cheese,250,315,65,1,00135,India
561607,2023-03-20,207,coca cola,75,100,25,2,00135,India
906389,2023-03-20,206,yakult,360,400,40,2,00221,India
906389,2023-03-20,202,milk,12,27,15,1,00221,India
530139,2023-03-20,209,pepsi,75,100,25,2,00471,India
530139,2023-03-20,213,bisleri,6,15,9,2,00471,India
530139,2023-03-20,208,sprite,75,100,25,2,00471,India
530139,2023-03-20,204,strawberry yogurt,50,60,10,2,00471,India
600949,2023-03-20,202,milk,12,27,15,1,00284,India
600949,2023-03-20,212,amul cheese,250,315,65,1,00284,India
600949,2023-03-20,209,pepsi,75,100,25,2,00284,India
795192,2023-03-20,213,bisleri,6,15,9,2,00494,India
795192,2023-03-20,207,coca cola,75,100,25,2,00494,India
795192,2023-03-20,211,red bull,90,125,35,2,00494,India
795192,2023-03-20,208,sprite,75,100,25,2,00494,India
966410,2023-03-20,213,bisleri,6,15,9,2,00028,India
966410,2023-03-20,205,classic yogurt,45,60,15,2,00028,India
386573,2023-03-20,206,yakult,360,400,40,2,00105,India
386573,2023-03-20,202,milk,12,27,15,1,00105,India
774300,2023-03-20,208,sprite,75,100,25,2,00014,India
774300,2023-03-20,207,coca cola,75,100,25,2,00014,India
216515,2023-03-20,207,coca cola,75,100,25,2,00366,India
216515,2023-03-20,210,mountain dew,75,100,25,2,00366,India
216515,2023-03-20,202,milk,12,27,15,1,00366,India
715848,2023-03-20,209,pepsi,75,100,25,2,00370,India
715848,2023-03-20,203,mango yogurt,50,60,10,2,00370,India
906013,2023-03-20,213,bisleri,6,15,9,2,00057,India
906013,2023-03-20,212,amul cheese,250,315,65,1,00057,India
906013,2023-03-20,202,milk,12,27,15,1,00057,India
906013,2023-03-20,204,strawberry yogurt,50,60,10,2,00057,India
906013,2023-03-20,210,mountain dew,75,100,25,2,00057,India
349523,2023-03-20,210,mountain dew,75,100,25,2,00392,India
349523,2023-03-20,204,strawberry yogurt,50,60,10,2,00392,India
300430,2023-03-20,210,mountain dew,75,100,25,2,00499,India
300430,2023-03-20,213,bisleri,6,15,9,2,00499,India
300430,2023-03-20,209,pepsi,75,100,25,2,00499,India
300430,2023-03-20,211,red bull,90,125,35,2,00499,India
220044,2023-03-20,206,yakult,360,400,40,2,00059,India
220044,2023-03-20,202,milk,12,27,15,1,00059,India
220044,2023-03-20,211,red bull,90,125,35,2,00059,India
220044,2023-03-20,212,amul cheese,250,315,65,1,00059,India
873844,2023-03-20,208,sprite,75,100,25,2,00211,India
873844,2023-03-20,213,bisleri,6,15,9,2,00211,India
500508,2023-03-20,205,classic yogurt,45,60,15,2,00335,India
500508,2023-03-20,207,coca cola,75,100,25,2,00335,India
500508,2023-03-20,210,mountain dew,75,100,25,2,00335,India
500508,2023-03-20,202,milk,12,27,15,1,00335,India
725563,2023-03-20,205,classic yogurt,45,60,15,2,00134,India
725563,2023-03-20,201,paneer,210,340,130,1,00134,India
523781,2023-03-20,213,bisleri,6,15,9,2,00473,India
162320,2023-03-20,212,amul cheese,250,315,65,1,00410,India
162320,2023-03-20,213,bisleri,6,15,9,2,00410,India
162320,2023-03-20,209,pepsi,75,100,25,2,00410,India
205237,2023-03-20,210,mountain dew,75,100,25,2,00460,India
205237,2023-03-20,209,pepsi,75,100,25,2,00460,India
205237,2023-03-20,207,coca cola,75,100,25,2,00460,India
205237,2023-03-20,203,mango yogurt,50,60,10,2,00460,India
205237,2023-03-20,213,bisleri,6,15,9,2,00460,India
556793,2023-03-20,206,yakult,360,400,40,2,00040,India
179405,2023-03-20,206,yakult,360,400,40,2,00381,India
179405,2023-03-20,208,sprite,75,100,25,2,00381,India
330754,2023-03-20,212,amul cheese,250,315,65,1,00137,India
330754,2023-03-20,213,bisleri,6,15,9,2,00137,India
371255,2023-03-20,203,mango yogurt,50,60,10,2,00192,India
875881,2023-03-20,212,amul cheese,250,315,65,1,00068,India
875881,2023-03-20,211,red bull,90,125,35,2,00068,India
875881,2023-03-20,202,milk,12,27,15,1,00068,India
658231,2023-03-20,210,mountain dew,75,100,25,2,00143,India
658231,2023-03-20,208,sprite,75,100,25,2,00143,India
658231,2023-03-20,201,paneer,210,340,130,1,00143,India
658231,2023-03-20,204,strawberry yogurt,50,60,10,2,00143,India
220231,2023-03-20,203,mango yogurt,50,60,10,2,00106,India
401735,2023-03-20,209,pepsi,75,100,25,2,00009,India
401735,2023-03-20,205,classic yogurt,45,60,15,2,00009,India
901051,2023-03-20,208,sprite,75,100,25,2,00159,India
901051,2023-03-20,209,pepsi,75,100,25,2,00159,India
901051,2023-03-20,210,mountain dew,75,100,25,2,00159,India
901051,2023-03-20,204,strawberry yogurt,50,60,10,2,00159,India
901051,2023-03-20,211,red bull,90,125,35,2,00159,India
253529,2023-03-20,203,mango yogurt,50,60,10,2,00407,India
253529,2023-03-20,205,classic yogurt,45,60,15,2,00407,India
253529,2023-03-20,202,milk,12,27,15,1,00407,India
253529,2023-03-20,201,paneer,210,340,130,1,00407,India
232753,2023-03-20,207,coca cola,75,100,25,2,00077,India
232753,2023-03-20,206,yakult,360,400,40,2,00077,India
232753,2023-03-20,209,pepsi,75,100,25,2,00077,India
487905,2023-03-20,210,mountain dew,75,100,25,2,00272,India
487905,2023-03-20,202,milk,12,27,15,1,00272,India
247590,2023-03-20,205,classic yogurt,45,60,15,2,00237,India
652929,2023-03-20,212,amul cheese,250,315,65,1,00336,India
652929,2023-03-20,201,paneer,210,340,130,1,00336,India
652929,2023-03-20,208,sprite,75,100,25,2,00336,India
800518,2023-03-20,206,yakult,360,400,40,2,00402,India
800518,2023-03-20,203,mango yogurt,50,60,10,2,00402,India
800518,2023-03-20,208,sprite,75,100,25,2,00402,India
800518,2023-03-20,211,red bull,90,125,35,2,00402,India
800518,2023-03-20,212,amul cheese,250,315,65,1,00402,India
826695,2023-03-20,210,mountain dew,75,100,25,2,00097,India
826695,2023-03-20,205,classic yogurt,45,60,15,2,00097,India
162922,2023-03-20,212,amul cheese,250,315,65,1,00479,India
131563,2023-03-20,204,strawberry yogurt,50,60,10,2,00361,India
494288,2023-03-20,207,coca cola,75,100,25,2,00123,India
494288,2023-03-20,202,milk,12,27,15,1,00123,India
494288,2023-03-20,201,paneer,210,340,130,1,00123,India
476951,2023-03-20,211,red bull,90,125,35,2,00411,India
973363,2023-03-20,203,mango yogurt,50,60,10,2,00490,India
973363,2023-03-20,211,red bull,90,125,35,2,00490,India
676581,2023-03-20,206,yakult,360,400,40,2,00370,India
676581,2023-03-20,203,mango yogurt,50,60,10,2,00370,India
432140,2023-03-20,211,red bull,90,125,35,2,00263,India
561938,2023-03-20,204,strawberry yogurt,50,60,10,2,00450,India
561938,2023-03-20,212,amul cheese,250,315,65,1,00450,India
561938,2023-03-20,209,pepsi,75,100,25,2,00450,India
561938,2023-03-20,202,milk,12,27,15,1,00450,India
536339,2023-03-20,208,sprite,75,100,25,2,00268,India
177139,2023-03-20,210,mountain dew,75,100,25,2,00346,India
177139,2023-03-20,202,milk,12,27,15,1,00346,India
177139,2023-03-20,209,pepsi,75,100,25,2,00346,India
177139,2023-03-20,206,yakult,360,400,40,2,00346,India
159813,2023-03-20,203,mango yogurt,50,60,10,2,00492,India
516407,2023-03-20,204,strawberry yogurt,50,60,10,2,00243,India
329820,2023-03-20,207,coca cola,75,100,25,2,00364,India
329820,2023-03-20,201,paneer,210,340,130,1,00364,India
338185,2023-03-20,207,coca cola,75,100,25,2,00349,India
550528,2023-03-20,208,sprite,75,100,25,2,00161,India
550528,2023-03-20,209,pepsi,75,100,25,2,00161,India
550528,2023-03-20,207,coca cola,75,100,25,2,00161,India
550528,2023-03-20,201,paneer,210,340,130,1,00161,India
964743,2023-03-20,202,milk,12,27,15,1,00129,India
964743,2023-03-20,207,coca cola,75,100,25,2,00129,India
964743,2023-03-20,201,paneer,210,340,130,1,00129,India
964743,2023-03-20,208,sprite,75,100,25,2,00129,India
402135,2023-03-20,213,bisleri,6,15,9,2,00294,India
402135,2023-03-20,208,sprite,75,100,25,2,00294,India
690867,2023-03-20,204,strawberry yogurt,50,60,10,2,00438,India
690867,2023-03-20,203,mango yogurt,50,60,10,2,00438,India
690867,2023-03-20,212,amul cheese,250,315,65,1,00438,India
690867,2023-03-20,205,classic yogurt,45,60,15,2,00438,India
481515,2023-03-20,211,red bull,90,125,35,2,00422,India
481515,2023-03-20,209,pepsi,75,100,25,2,00422,India
481515,2023-03-20,206,yakult,360,400,40,2,00422,India
281912,2023-03-20,210,mountain dew,75,100,25,2,00141,India
281912,2023-03-20,207,coca cola,75,100,25,2,00141,India
281912,2023-03-20,206,yakult,360,400,40,2,00141,India
267880,2023-03-21,205,classic yogurt,45,60,15,2,00277,India
267880,2023-03-21,213,bisleri,6,15,9,2,00277,India
426777,2023-03-21,204,strawberry yogurt,50,60,10,2,00363,India
426777,2023-03-21,213,bisleri,6,15,9,2,00363,India
426777,2023-03-21,201,paneer,210,340,130,1,00363,India
426777,2023-03-21,209,pepsi,75,100,25,2,00363,India
457806,2023-03-21,205,classic yogurt,45,60,15,2,00002,India
457806,2023-03-21,212,amul cheese,250,315,65,1,00002,India
457806,2023-03-21,211,red bull,90,125,35,2,00002,India
990989,2023-03-21,213,bisleri,6,15,9,2,00397,India
704930,2023-03-21,212,amul cheese,250,315,65,1,00329,India
226548,2023-03-21,209,pepsi,75,100,25,2,00295,India
226548,2023-03-21,204,strawberry yogurt,50,60,10,2,00295,India
226548,2023-03-21,213,bisleri,6,15,9,2,00295,India
226548,2023-03-21,211,red bull,90,125,35,2,00295,India
226548,2023-03-21,201,paneer,210,340,130,1,00295,India
894164,2023-03-21,212,amul cheese,250,315,65,1,00348,India
302249,2023-03-21,201,paneer,210,340,130,1,00417,India
302249,2023-03-21,210,mountain dew,75,100,25,2,00417,India
302249,2023-03-21,205,classic yogurt,45,60,15,2,00417,India
302249,2023-03-21,202,milk,12,27,15,1,00417,India
326835,2023-03-21,203,mango yogurt,50,60,10,2,00319,India
668930,2023-03-21,210,mountain dew,75,100,25,2,00416,India
668930,2023-03-21,207,coca cola,75,100,25,2,00416,India
668930,2023-03-21,201,paneer,210,340,130,1,00416,India
281824,2023-03-21,207,coca cola,75,100,25,2,00090,India
281824,2023-03-21,201,paneer,210,340,130,1,00090,India
913638,2023-03-21,212,amul cheese,250,315,65,1,00089,India
913638,2023-03-21,202,milk,12,27,15,1,00089,India
913638,2023-03-21,203,mango yogurt,50,60,10,2,00089,India
381753,2023-03-21,212,amul cheese,250,315,65,1,00327,India
527607,2023-03-21,213,bisleri,6,15,9,2,00153,India
527607,2023-03-21,210,mountain dew,75,100,25,2,00153,India
570144,2023-03-21,201,paneer,210,340,130,1,00468,India
570144,2023-03-21,213,bisleri,6,15,9,2,00468,India
570144,2023-03-21,210,mountain dew,75,100,25,2,00468,India
568522,2023-03-21,202,milk,12,27,15,1,00455,India
568522,2023-03-21,210,mountain dew,75,100,25,2,00455,India
568522,2023-03-21,208,sprite,75,100,25,2,00455,India
486836,2023-03-21,212,amul cheese,250,315,65,1,00007,India
486836,2023-03-21,204,strawberry yogurt,50,60,10,2,00007,India
486836,2023-03-21,203,mango yogurt,50,60,10,2,00007,India
486836,2023-03-21,213,bisleri,6,15,9,2,00007,India
934277,2023-03-21,205,classic yogurt,45,60,15,2,00365,India
934277,2023-03-21,204,strawberry yogurt,50,60,10,2,00365,India
934277,2023-03-21,203,mango yogurt,50,60,10,2,00365,India
698866,2023-03-21,204,strawberry yogurt,50,60,10,2,00472,India
698866,2023-03-21,209,pepsi,75,100,25,2,00472,India
698866,2023-03-21,211,red bull,90,125,35,2,00472,India
667319,2023-03-21,209,pepsi,75,100,25,2,00448,India
667319,2023-03-21,210,mountain dew,75,100,25,2,00448,India
667319,2023-03-21,207,coca cola,75,100,25,2,00448,India
667319,2023-03-21,203,mango yogurt,50,60,10,2,00448,India
290713,2023-03-21,211,red bull,90,125,35,2,00239,India
290713,2023-03-21,209,pepsi,75,100,25,2,00239,India
918421,2023-03-21,203,mango yogurt,50,60,10,2,00433,India
918421,2023-03-21,212,amul cheese,250,315,65,1,00433,India
918421,2023-03-21,201,paneer,210,340,130,1,00433,India
596794,2023-03-21,201,paneer,210,340,130,1,00260,India
596794,2023-03-21,206,yakult,360,400,40,2,00260,India
104896,2023-03-21,202,milk,12,27,15,1,00272,India
104896,2023-03-21,203,mango yogurt,50,60,10,2,00272,India
461902,2023-03-21,202,milk,12,27,15,1,00457,India
222009,2023-03-21,204,strawberry yogurt,50,60,10,2,00214,India
222009,2023-03-21,208,sprite,75,100,25,2,00214,India
222009,2023-03-21,211,red bull,90,125,35,2,00214,India
222009,2023-03-21,206,yakult,360,400,40,2,00214,India
134739,2023-03-21,203,mango yogurt,50,60,10,2,00043,India
134739,2023-03-21,207,coca cola,75,100,25,2,00043,India
444557,2023-03-21,202,milk,12,27,15,1,00489,India
444557,2023-03-21,205,classic yogurt,45,60,15,2,00489,India
304866,2023-03-21,208,sprite,75,100,25,2,00065,India
304866,2023-03-21,213,bisleri,6,15,9,2,00065,India
304866,2023-03-21,203,mango yogurt,50,60,10,2,00065,India
304866,2023-03-21,202,milk,12,27,15,1,00065,India
304866,2023-03-21,204,strawberry yogurt,50,60,10,2,00065,India
756950,2023-03-21,208,sprite,75,100,25,2,00256,India
756950,2023-03-21,202,milk,12,27,15,1,00256,India
756950,2023-03-21,211,red bull,90,125,35,2,00256,India
756950,2023-03-21,205,classic yogurt,45,60,15,2,00256,India
234599,2023-03-21,212,amul cheese,250,315,65,1,00303,India
234599,2023-03-21,206,yakult,360,400,40,2,00303,India
234599,2023-03-21,213,bisleri,6,15,9,2,00303,India
888684,2023-03-21,205,classic yogurt,45,60,15,2,00238,India
888684,2023-03-21,212,amul cheese,250,315,65,1,00238,India
276713,2023-03-21,209,pepsi,75,100,25,2,00322,India
745482,2023-03-21,201,paneer,210,340,130,1,00122,India
745482,2023-03-21,212,amul cheese,250,315,65,1,00122,India
745482,2023-03-21,203,mango yogurt,50,60,10,2,00122,India
295011,2023-03-21,205,classic yogurt,45,60,15,2,00097,India
295011,2023-03-21,206,yakult,360,400,40,2,00097,India
295011,2023-03-21,202,milk,12,27,15,1,00097,India
295011,2023-03-21,210,mountain dew,75,100,25,2,00097,India
295011,2023-03-21,204,strawberry yogurt,50,60,10,2,00097,India
347670,2023-03-21,201,paneer,210,340,130,1,00460,India
347670,2023-03-21,206,yakult,360,400,40,2,00460,India
268349,2023-03-21,213,bisleri,6,15,9,2,00246,India
350373,2023-03-21,210,mountain dew,75,100,25,2,00074,India
204032,2023-03-21,211,red bull,90,125,35,2,00257,India
204032,2023-03-21,203,mango yogurt,50,60,10,2,00257,India
214587,2023-03-21,206,yakult,360,400,40,2,00421,India
214587,2023-03-21,208,sprite,75,100,25,2,00421,India
293021,2023-03-21,205,classic yogurt,45,60,15,2,00056,India
293021,2023-03-21,203,mango yogurt,50,60,10,2,00056,India
293021,2023-03-21,201,paneer,210,340,130,1,00056,India
451229,2023-03-21,205,classic yogurt,45,60,15,2,00467,India
451229,2023-03-21,211,red bull,90,125,35,2,00467,India
451229,2023-03-21,202,milk,12,27,15,1,00467,India
976153,2023-03-21,201,paneer,210,340,130,1,00323,India
976153,2023-03-21,210,mountain dew,75,100,25,2,00323,India
976153,2023-03-21,209,pepsi,75,100,25,2,00323,India
246647,2023-03-21,204,strawberry yogurt,50,60,10,2,00363,India
246647,2023-03-21,207,coca cola,75,100,25,2,00363,India
246647,2023-03-21,213,bisleri,6,15,9,2,00363,India
246647,2023-03-21,202,milk,12,27,15,1,00363,India
556225,2023-03-21,204,strawberry yogurt,50,60,10,2,00243,India
556225,2023-03-21,206,yakult,360,400,40,2,00243,India
556225,2023-03-21,210,mountain dew,75,100,25,2,00243,India
556225,2023-03-21,213,bisleri,6,15,9,2,00243,India
556225,2023-03-21,212,amul cheese,250,315,65,1,00243,India
178810,2023-03-21,205,classic yogurt,45,60,15,2,00239,India
178810,2023-03-21,210,mountain dew,75,100,25,2,00239,India
178810,2023-03-21,207,coca cola,75,100,25,2,00239,India
178810,2023-03-21,213,bisleri,6,15,9,2,00239,India
178810,2023-03-21,209,pepsi,75,100,25,2,00239,India
314104,2023-03-21,207,coca cola,75,100,25,2,00045,India
314104,2023-03-21,211,red bull,90,125,35,2,00045,India
915303,2023-03-21,213,bisleri,6,15,9,2,00062,India
915303,2023-03-21,204,strawberry yogurt,50,60,10,2,00062,India
915303,2023-03-21,205,classic yogurt,45,60,15,2,00062,India
169006,2023-03-21,209,pepsi,75,100,25,2,00230,India
169006,2023-03-21,205,classic yogurt,45,60,15,2,00230,India
169006,2023-03-21,204,strawberry yogurt,50,60,10,2,00230,India
265539,2023-03-21,201,paneer,210,340,130,1,00451,India
265539,2023-03-21,212,amul cheese,250,315,65,1,00451,India
265539,2023-03-21,205,classic yogurt,45,60,15,2,00451,India
662766,2023-03-21,202,milk,12,27,15,1,00372,India
662766,2023-03-21,211,red bull,90,125,35,2,00372,India
530257,2023-03-21,205,classic yogurt,45,60,15,2,00201,India
970149,2023-03-21,213,bisleri,6,15,9,2,00500,India
520518,2023-03-21,206,yakult,360,400,40,2,00036,India
520518,2023-03-21,207,coca cola,75,100,25,2,00036,India
520518,2023-03-21,202,milk,12,27,15,1,00036,India
520518,2023-03-21,205,classic yogurt,45,60,15,2,00036,India
126269,2023-03-21,213,bisleri,6,15,9,2,00262,India
126269,2023-03-21,208,sprite,75,100,25,2,00262,India
126269,2023-03-21,204,strawberry yogurt,50,60,10,2,00262,India
126269,2023-03-21,202,milk,12,27,15,1,00262,India
126269,2023-03-21,211,red bull,90,125,35,2,00262,India
369005,2023-03-21,202,milk,12,27,15,1,00278,India
369005,2023-03-21,213,bisleri,6,15,9,2,00278,India
369005,2023-03-21,207,coca cola,75,100,25,2,00278,India
163986,2023-03-21,210,mountain dew,75,100,25,2,00177,India
163986,2023-03-21,201,paneer,210,340,130,1,00177,India
163986,2023-03-21,212,amul cheese,250,315,65,1,00177,India
720715,2023-03-21,210,mountain dew,75,100,25,2,00414,India
720715,2023-03-21,211,red bull,90,125,35,2,00414,India
720715,2023-03-21,202,milk,12,27,15,1,00414,India
447590,2023-03-21,208,sprite,75,100,25,2,00134,India
447590,2023-03-21,209,pepsi,75,100,25,2,00134,India
447590,2023-03-21,206,yakult,360,400,40,2,00134,India
898864,2023-03-21,209,pepsi,75,100,25,2,00104,India
898864,2023-03-21,207,coca cola,75,100,25,2,00104,India
898864,2023-03-21,206,yakult,360,400,40,2,00104,India
649246,2023-03-21,208,sprite,75,100,25,2,00254,India
649246,2023-03-21,211,red bull,90,125,35,2,00254,India
649246,2023-03-21,201,paneer,210,340,130,1,00254,India
954407,2023-03-21,205,classic yogurt,45,60,15,2,00257,India
954407,2023-03-21,208,sprite,75,100,25,2,00257,India
433644,2023-03-21,211,red bull,90,125,35,2,00213,India
433644,2023-03-21,206,yakult,360,400,40,2,00213,India
433644,2023-03-21,207,coca cola,75,100,25,2,00213,India
433644,2023-03-21,209,pepsi,75,100,25,2,00213,India
565786,2023-03-21,208,sprite,75,100,25,2,00108,India
804080,2023-03-21,202,milk,12,27,15,1,00079,India
804080,2023-03-21,212,amul cheese,250,315,65,1,00079,India
804080,2023-03-21,203,mango yogurt,50,60,10,2,00079,India
334078,2023-03-21,209,pepsi,75,100,25,2,00371,India
334078,2023-03-21,202,milk,12,27,15,1,00371,India
334078,2023-03-21,207,coca cola,75,100,25,2,00371,India
915277,2023-03-22,201,paneer,210,340,130,1,00273,India
915277,2023-03-22,210,mountain dew,75,100,25,2,00273,India
915277,2023-03-22,204,strawberry yogurt,50,60,10,2,00273,India
372311,2023-03-22,206,yakult,360,400,40,2,00017,India
185204,2023-03-22,205,classic yogurt,45,60,15,2,00267,India
185204,2023-03-22,212,amul cheese,250,315,65,1,00267,India
185204,2023-03-22,210,mountain dew,75,100,25,2,00267,India
290852,2023-03-22,210,mountain dew,75,100,25,2,00031,India
290852,2023-03-22,212,amul cheese,250,315,65,1,00031,India
290852,2023-03-22,213,bisleri,6,15,9,2,00031,India
290852,2023-03-22,205,classic yogurt,45,60,15,2,00031,India
371387,2023-03-22,210,mountain dew,75,100,25,2,00288,India
371387,2023-03-22,212,amul cheese,250,315,65,1,00288,India
371387,2023-03-22,206,yakult,360,400,40,2,00288,India
371387,2023-03-22,211,red bull,90,125,35,2,00288,India
356120,2023-03-22,212,amul cheese,250,315,65,1,00327,India
858068,2023-03-22,203,mango yogurt,50,60,10,2,00375,India
858068,2023-03-22,210,mountain dew,75,100,25,2,00375,India
858068,2023-03-22,208,sprite,75,100,25,2,00375,India
858068,2023-03-22,204,strawberry yogurt,50,60,10,2,00375,India
903335,2023-03-22,203,mango yogurt,50,60,10,2,00458,India
330310,2023-03-22,211,red bull,90,125,35,2,00422,India
780817,2023-03-22,203,mango yogurt,50,60,10,2,00350,India
780817,2023-03-22,206,yakult,360,400,40,2,00350,India
780817,2023-03-22,210,mountain dew,75,100,25,2,00350,India
780817,2023-03-22,202,milk,12,27,15,1,00350,India
228156,2023-03-22,201,paneer,210,340,130,1,00211,India
228156,2023-03-22,208,sprite,75,100,25,2,00211,India
228156,2023-03-22,207,coca cola,75,100,25,2,00211,India
228156,2023-03-22,209,pepsi,75,100,25,2,00211,India
284058,2023-03-22,204,strawberry yogurt,50,60,10,2,00303,India
284058,2023-03-22,206,yakult,360,400,40,2,00303,India
284058,2023-03-22,212,amul cheese,250,315,65,1,00303,India
284058,2023-03-22,205,classic yogurt,45,60,15,2,00303,India
365644,2023-03-22,206,yakult,360,400,40,2,00235,India
365644,2023-03-22,204,strawberry yogurt,50,60,10,2,00235,India
853422,2023-03-22,211,red bull,90,125,35,2,00418,India
853422,2023-03-22,202,milk,12,27,15,1,00418,India
853422,2023-03-22,213,bisleri,6,15,9,2,00418,India
127753,2023-03-22,213,bisleri,6,15,9,2,00075,India
127753,2023-03-22,204,strawberry yogurt,50,60,10,2,00075,India
127753,2023-03-22,212,amul cheese,250,315,65,1,00075,India
127753,2023-03-22,209,pepsi,75,100,25,2,00075,India
318242,2023-03-22,206,yakult,360,400,40,2,00137,India
328952,2023-03-22,201,paneer,210,340,130,1,00029,India
328952,2023-03-22,205,classic yogurt,45,60,15,2,00029,India
328952,2023-03-22,202,milk,12,27,15,1,00029,India
328952,2023-03-22,207,coca cola,75,100,25,2,00029,India
328952,2023-03-22,213,bisleri,6,15,9,2,00029,India
469204,2023-03-22,213,bisleri,6,15,9,2,00467,India
469204,2023-03-22,202,milk,12,27,15,1,00467,India
469204,2023-03-22,212,amul cheese,250,315,65,1,00467,India
469204,2023-03-22,208,sprite,75,100,25,2,00467,India
469204,2023-03-22,204,strawberry yogurt,50,60,10,2,00467,India
953023,2023-03-22,212,amul cheese,250,315,65,1,00128,India
953023,2023-03-22,213,bisleri,6,15,9,2,00128,India
189669,2023-03-22,209,pepsi,75,100,25,2,00137,India
189669,2023-03-22,205,classic yogurt,45,60,15,2,00137,India
189669,2023-03-22,204,strawberry yogurt,50,60,10,2,00137,India
294136,2023-03-22,211,red bull,90,125,35,2,00122,India
294136,2023-03-22,204,strawberry yogurt,50,60,10,2,00122,India
294136,2023-03-22,202,milk,12,27,15,1,00122,India
294136,2023-03-22,203,mango yogurt,50,60,10,2,00122,India
294136,2023-03-22,201,paneer,210,340,130,1,00122,India
493219,2023-03-22,201,paneer,210,340,130,1,00321,India
282635,2023-03-22,209,pepsi,75,100,25,2,00070,India
282635,2023-03-22,202,milk,12,27,15,1,00070,India
282635,2023-03-22,210,mountain dew,75,100,25,2,00070,India
282635,2023-03-22,207,coca cola,75,100,25,2,00070,India
604091,2023-03-22,210,mountain dew,75,100,25,2,00382,India
604091,2023-03-22,201,paneer,210,340,130,1,00382,India
604091,2023-03-22,202,milk,12,27,15,1,00382,India
604091,2023-03-22,207,coca cola,75,100,25,2,00382,India
103572,2023-03-22,203,mango yogurt,50,60,10,2,00186,India
103572,2023-03-22,205,classic yogurt,45,60,15,2,00186,India
189771,2023-03-22,205,classic yogurt,45,60,15,2,00228,India
189771,2023-03-22,202,milk,12,27,15,1,00228,India
189771,2023-03-22,213,bisleri,6,15,9,2,00228,India
189771,2023-03-22,201,paneer,210,340,130,1,00228,India
189771,2023-03-22,208,sprite,75,100,25,2,00228,India
264433,2023-03-22,206,yakult,360,400,40,2,00025,India
264433,2023-03-22,213,bisleri,6,15,9,2,00025,India
264433,2023-03-22,207,coca cola,75,100,25,2,00025,India
488972,2023-03-22,210,mountain dew,75,100,25,2,00087,India
488972,2023-03-22,203,mango yogurt,50,60,10,2,00087,India
343604,2023-03-22,204,strawberry yogurt,50,60,10,2,00409,India
281522,2023-03-22,207,coca cola,75,100,25,2,00464,India
281522,2023-03-22,209,pepsi,75,100,25,2,00464,India
415694,2023-03-22,206,yakult,360,400,40,2,00309,India
415694,2023-03-22,213,bisleri,6,15,9,2,00309,India
301640,2023-03-22,204,strawberry yogurt,50,60,10,2,00012,India
301640,2023-03-22,209,pepsi,75,100,25,2,00012,India
301640,2023-03-22,211,red bull,90,125,35,2,00012,India
639601,2023-03-22,206,yakult,360,400,40,2,00035,India
425682,2023-03-22,212,amul cheese,250,315,65,1,00142,India
649231,2023-03-22,201,paneer,210,340,130,1,00040,India
649231,2023-03-22,203,mango yogurt,50,60,10,2,00040,India
649231,2023-03-22,204,strawberry yogurt,50,60,10,2,00040,India
490122,2023-03-22,203,mango yogurt,50,60,10,2,00428,India
490122,2023-03-22,206,yakult,360,400,40,2,00428,India
490122,2023-03-22,210,mountain dew,75,100,25,2,00428,India
490122,2023-03-22,213,bisleri,6,15,9,2,00428,India
760728,2023-03-22,204,strawberry yogurt,50,60,10,2,00476,India
760728,2023-03-22,205,classic yogurt,45,60,15,2,00476,India
273280,2023-03-22,211,red bull,90,125,35,2,00322,India
273280,2023-03-22,206,yakult,360,400,40,2,00322,India
273280,2023-03-22,204,strawberry yogurt,50,60,10,2,00322,India
273280,2023-03-22,202,milk,12,27,15,1,00322,India
445598,2023-03-22,203,mango yogurt,50,60,10,2,00163,India
445598,2023-03-22,202,milk,12,27,15,1,00163,India
445598,2023-03-22,207,coca cola,75,100,25,2,00163,India
445598,2023-03-22,209,pepsi,75,100,25,2,00163,India
230351,2023-03-22,206,yakult,360,400,40,2,00145,India
679529,2023-03-22,213,bisleri,6,15,9,2,00317,India
679529,2023-03-22,209,pepsi,75,100,25,2,00317,India
679529,2023-03-22,211,red bull,90,125,35,2,00317,India
679529,2023-03-22,210,mountain dew,75,100,25,2,00317,India
786576,2023-03-22,208,sprite,75,100,25,2,00413,India
786576,2023-03-22,211,red bull,90,125,35,2,00413,India
786576,2023-03-22,202,milk,12,27,15,1,00413,India
853961,2023-03-22,202,milk,12,27,15,1,00202,India
853961,2023-03-22,204,strawberry yogurt,50,60,10,2,00202,India
190621,2023-03-22,203,mango yogurt,50,60,10,2,00006,India
190621,2023-03-22,205,classic yogurt,45,60,15,2,00006,India
190621,2023-03-22,212,amul cheese,250,315,65,1,00006,India
190621,2023-03-22,210,mountain dew,75,100,25,2,00006,India
969264,2023-03-22,210,mountain dew,75,100,25,2,00073,India
969264,2023-03-22,206,yakult,360,400,40,2,00073,India
969264,2023-03-22,208,sprite,75,100,25,2,00073,India
746659,2023-03-22,201,paneer,210,340,130,1,00335,India
746659,2023-03-22,207,coca cola,75,100,25,2,00335,India
746659,2023-03-22,205,classic yogurt,45,60,15,2,00335,India
746659,2023-03-22,212,amul cheese,250,315,65,1,00335,India
811828,2023-03-22,209,pepsi,75,100,25,2,00478,India
697720,2023-03-22,203,mango yogurt,50,60,10,2,00128,India
697720,2023-03-22,210,mountain dew,75,100,25,2,00128,India
697720,2023-03-22,208,sprite,75,100,25,2,00128,India
697720,2023-03-22,206,yakult,360,400,40,2,00128,India
697720,2023-03-22,202,milk,12,27,15,1,00128,India
412415,2023-03-22,201,paneer,210,340,130,1,00336,India
939649,2023-03-22,207,coca cola,75,100,25,2,00172,India
939649,2023-03-22,210,mountain dew,75,100,25,2,00172,India
939649,2023-03-22,201,paneer,210,340,130,1,00172,India
568981,2023-03-22,209,pepsi,75,100,25,2,00429,India
568981,2023-03-22,212,amul cheese,250,315,65,1,00429,India
554900,2023-03-22,210,mountain dew,75,100,25,2,00099,India
554900,2023-03-22,211,red bull,90,125,35,2,00099,India
554900,2023-03-22,213,bisleri,6,15,9,2,00099,India
554900,2023-03-22,202,milk,12,27,15,1,00099,India
554900,2023-03-22,207,coca cola,75,100,25,2,00099,India
914785,2023-03-22,207,coca cola,75,100,25,2,00315,India
138525,2023-03-22,204,strawberry yogurt,50,60,10,2,00250,India
138525,2023-03-22,211,red bull,90,125,35,2,00250,India
138525,2023-03-22,213,bisleri,6,15,9,2,00250,India
138525,2023-03-22,201,paneer,210,340,130,1,00250,India
945634,2023-03-22,208,sprite,75,100,25,2,00370,India
945634,2023-03-22,212,amul cheese,250,315,65,1,00370,India
945634,2023-03-22,210,mountain dew,75,100,25,2,00370,India
336951,2023-03-22,209,pepsi,75,100,25,2,00328,India
960431,2023-03-22,209,pepsi,75,100,25,2,00386,India
960431,2023-03-22,204,strawberry yogurt,50,60,10,2,00386,India
311090,2023-03-22,203,mango yogurt,50,60,10,2,00340,India
311090,2023-03-22,213,bisleri,6,15,9,2,00340,India
365619,2023-03-22,203,mango yogurt,50,60,10,2,00495,India
365619,2023-03-22,211,red bull,90,125,35,2,00495,India
365619,2023-03-22,204,strawberry yogurt,50,60,10,2,00495,India
543353,2023-03-22,209,pepsi,75,100,25,2,00232,India
900608,2023-03-22,208,sprite,75,100,25,2,00177,India
241351,2023-03-22,212,amul cheese,250,315,65,1,00281,India
241351,2023-03-22,213,bisleri,6,15,9,2,00281,India
241351,2023-03-22,203,mango yogurt,50,60,10,2,00281,India
241351,2023-03-22,211,red bull,90,125,35,2,00281,India
204868,2023-03-22,206,yakult,360,400,40,2,00114,India
204868,2023-03-22,202,milk,12,27,15,1,00114,India
204868,2023-03-22,210,mountain dew,75,100,25,2,00114,India
204868,2023-03-22,207,coca cola,75,100,25,2,00114,India
204868,2023-03-22,212,amul cheese,250,315,65,1,00114,India
200480,2023-03-22,201,paneer,210,340,130,1,00184,India
200480,2023-03-22,204,strawberry yogurt,50,60,10,2,00184,India
200480,2023-03-22,205,classic yogurt,45,60,15,2,00184,India
200480,2023-03-22,202,milk,12,27,15,1,00184,India
200480,2023-03-22,211,red bull,90,125,35,2,00184,India
828940,2023-03-22,209,pepsi,75,100,25,2,00134,India
828940,2023-03-22,212,amul cheese,250,315,65,1,00134,India
828940,2023-03-22,203,mango yogurt,50,60,10,2,00134,India
828940,2023-03-22,204,strawberry yogurt,50,60,10,2,00134,India
828940,2023-03-22,211,red bull,90,125,35,2,00134,India
211080,2023-03-22,205,classic yogurt,45,60,15,2,00381,India
974306,2023-03-22,205,classic yogurt,45,60,15,2,00024,India
974306,2023-03-22,204,strawberry yogurt,50,60,10,2,00024,India
974306,2023-03-22,212,amul cheese,250,315,65,1,00024,India
974306,2023-03-22,201,paneer,210,340,130,1,00024,India
791932,2023-03-22,210,mountain dew,75,100,25,2,00215,India
791932,2023-03-22,202,milk,12,27,15,1,00215,India
791932,2023-03-22,211,red bull,90,125,35,2,00215,India
791932,2023-03-22,206,yakult,360,400,40,2,00215,India
111970,2023-03-22,211,red bull,90,125,35,2,00356,India
111970,2023-03-22,207,coca cola,75,100,25,2,00356,India
111970,2023-03-22,202,milk,12,27,15,1,00356,India
111970,2023-03-22,206,yakult,360,400,40,2,00356,India
546532,2023-03-22,205,classic yogurt,45,60,15,2,00061,India
546532,2023-03-22,213,bisleri,6,15,9,2,00061,India
546532,2023-03-22,201,paneer,210,340,130,1,00061,India
287728,2023-03-22,202,milk,12,27,15,1,00233,India
287728,2023-03-22,204,strawberry yogurt,50,60,10,2,00233,India
492492,2023-03-22,208,sprite,75,100,25,2,00117,India
492492,2023-03-22,202,milk,12,27,15,1,00117,India
492492,2023-03-22,211,red bull,90,125,35,2,00117,India
151090,2023-03-22,205,classic yogurt,45,60,15,2,00406,India
151090,2023-03-22,208,sprite,75,100,25,2,00406,India
400035,2023-03-22,212,amul cheese,250,315,65,1,00187,India
126352,2023-03-22,202,milk,12,27,15,1,00020,India
902421,2023-03-22,204,strawberry yogurt,50,60,10,2,00366,India
902421,2023-03-22,201,paneer,210,340,130,1,00366,India
734298,2023-03-22,212,amul cheese,250,315,65,1,00077,India
734298,2023-03-22,211,red bull,90,125,35,2,00077,India
734298,2023-03-22,210,mountain dew,75,100,25,2,00077,India
734298,2023-03-22,208,sprite,75,100,25,2,00077,India
382935,2023-03-22,210,mountain dew,75,100,25,2,00314,India
382935,2023-03-22,205,classic yogurt,45,60,15,2,00314,India
382935,2023-03-22,207,coca cola,75,100,25,2,00314,India
565798,2023-03-22,213,bisleri,6,15,9,2,00417,India
565798,2023-03-22,204,strawberry yogurt,50,60,10,2,00417,India
565798,2023-03-22,206,yakult,360,400,40,2,00417,India
759649,2023-03-22,213,bisleri,6,15,9,2,00089,India
759649,2023-03-22,205,classic yogurt,45,60,15,2,00089,India
649815,2023-03-22,212,amul cheese,250,315,65,1,00011,India
649815,2023-03-22,203,mango yogurt,50,60,10,2,00011,India
649815,2023-03-22,207,coca cola,75,100,25,2,00011,India
883484,2023-03-22,207,coca cola,75,100,25,2,00265,India
883484,2023-03-22,208,sprite,75,100,25,2,00265,India
883484,2023-03-22,213,bisleri,6,15,9,2,00265,India
884875,2023-03-22,212,amul cheese,250,315,65,1,00196,India
884875,2023-03-22,202,milk,12,27,15,1,00196,India
884875,2023-03-22,201,paneer,210,340,130,1,00196,India
884875,2023-03-22,205,classic yogurt,45,60,15,2,00196,India
107560,2023-03-22,204,strawberry yogurt,50,60,10,2,00266,India
107560,2023-03-22,208,sprite,75,100,25,2,00266,India
107560,2023-03-22,209,pepsi,75,100,25,2,00266,India
107560,2023-03-22,213,bisleri,6,15,9,2,00266,India
203477,2023-03-22,209,pepsi,75,100,25,2,00049,India
203477,2023-03-22,211,red bull,90,125,35,2,00049,India
203477,2023-03-22,213,bisleri,6,15,9,2,00049,India
203477,2023-03-22,205,classic yogurt,45,60,15,2,00049,India
596660,2023-03-22,203,mango yogurt,50,60,10,2,00219,India
596660,2023-03-22,201,paneer,210,340,130,1,00219,India
562103,2023-03-22,212,amul cheese,250,315,65,1,00426,India
870118,2023-03-22,210,mountain dew,75,100,25,2,00479,India
870118,2023-03-22,203,mango yogurt,50,60,10,2,00479,India
870118,2023-03-22,211,red bull,90,125,35,2,00479,India
287964,2023-03-22,212,amul cheese,250,315,65,1,00491,India
287964,2023-03-22,203,mango yogurt,50,60,10,2,00491,India
694401,2023-03-22,210,mountain dew,75,100,25,2,00474,India
694401,2023-03-22,205,classic yogurt,45,60,15,2,00474,India
694401,2023-03-22,206,yakult,360,400,40,2,00474,India
694401,2023-03-22,213,bisleri,6,15,9,2,00474,India
694401,2023-03-22,209,pepsi,75,100,25,2,00474,India
877358,2023-03-22,204,strawberry yogurt,50,60,10,2,00280,India
877358,2023-03-22,211,red bull,90,125,35,2,00280,India
877358,2023-03-22,208,sprite,75,100,25,2,00280,India
877358,2023-03-22,203,mango yogurt,50,60,10,2,00280,India
363941,2023-03-22,202,milk,12,27,15,1,00053,India
363941,2023-03-22,211,red bull,90,125,35,2,00053,India
738027,2023-03-22,202,milk,12,27,15,1,00041,India
738027,2023-03-22,203,mango yogurt,50,60,10,2,00041,India
738027,2023-03-22,204,strawberry yogurt,50,60,10,2,00041,India
954175,2023-03-22,203,mango yogurt,50,60,10,2,00097,India
954175,2023-03-22,205,classic yogurt,45,60,15,2,00097,India
954175,2023-03-22,204,strawberry yogurt,50,60,10,2,00097,India
954175,2023-03-22,206,yakult,360,400,40,2,00097,India
705444,2023-03-22,212,amul cheese,250,315,65,1,00173,India
949862,2023-03-22,203,mango yogurt,50,60,10,2,00452,India
949862,2023-03-22,211,red bull,90,125,35,2,00452,India
266386,2023-03-23,212,amul cheese,250,315,65,1,00260,India
266386,2023-03-23,209,pepsi,75,100,25,2,00260,India
266386,2023-03-23,203,mango yogurt,50,60,10,2,00260,India
381267,2023-03-23,201,paneer,210,340,130,1,00312,India
381267,2023-03-23,209,pepsi,75,100,25,2,00312,India
381267,2023-03-23,206,yakult,360,400,40,2,00312,India
279857,2023-03-23,208,sprite,75,100,25,2,00409,India
279857,2023-03-23,204,strawberry yogurt,50,60,10,2,00409,India
279857,2023-03-23,212,amul cheese,250,315,65,1,00409,India
281907,2023-03-23,205,classic yogurt,45,60,15,2,00164,India
154969,2023-03-23,201,paneer,210,340,130,1,00026,India
742627,2023-03-23,206,yakult,360,400,40,2,00481,India
742627,2023-03-23,203,mango yogurt,50,60,10,2,00481,India
742627,2023-03-23,205,classic yogurt,45,60,15,2,00481,India
927254,2023-03-23,205,classic yogurt,45,60,15,2,00149,India
927254,2023-03-23,212,amul cheese,250,315,65,1,00149,India
927254,2023-03-23,210,mountain dew,75,100,25,2,00149,India
927254,2023-03-23,201,paneer,210,340,130,1,00149,India
927254,2023-03-23,202,milk,12,27,15,1,00149,India
380062,2023-03-23,205,classic yogurt,45,60,15,2,00022,India
380062,2023-03-23,202,milk,12,27,15,1,00022,India
380062,2023-03-23,209,pepsi,75,100,25,2,00022,India
380062,2023-03-23,212,amul cheese,250,315,65,1,00022,India
380062,2023-03-23,213,bisleri,6,15,9,2,00022,India
584331,2023-03-23,213,bisleri,6,15,9,2,00145,India
584331,2023-03-23,206,yakult,360,400,40,2,00145,India
626897,2023-03-23,208,sprite,75,100,25,2,00327,India
562148,2023-03-23,213,bisleri,6,15,9,2,00497,India
562148,2023-03-23,211,red bull,90,125,35,2,00497,India
705590,2023-03-23,210,mountain dew,75,100,25,2,00128,India
705590,2023-03-23,205,classic yogurt,45,60,15,2,00128,India
895637,2023-03-23,202,milk,12,27,15,1,00391,India
895637,2023-03-23,205,classic yogurt,45,60,15,2,00391,India
711005,2023-03-23,209,pepsi,75,100,25,2,00369,India
711005,2023-03-23,203,mango yogurt,50,60,10,2,00369,India
711005,2023-03-23,210,mountain dew,75,100,25,2,00369,India
711005,2023-03-23,201,paneer,210,340,130,1,00369,India
149325,2023-03-23,211,red bull,90,125,35,2,00198,India
541197,2023-03-23,212,amul cheese,250,315,65,1,00354,India
541197,2023-03-23,209,pepsi,75,100,25,2,00354,India
541197,2023-03-23,211,red bull,90,125,35,2,00354,India
541197,2023-03-23,203,mango yogurt,50,60,10,2,00354,India
541197,2023-03-23,201,paneer,210,340,130,1,00354,India
491783,2023-03-23,203,mango yogurt,50,60,10,2,00050,India
491783,2023-03-23,205,classic yogurt,45,60,15,2,00050,India
491783,2023-03-23,208,sprite,75,100,25,2,00050,India
491783,2023-03-23,207,coca cola,75,100,25,2,00050,India
991577,2023-03-23,211,red bull,90,125,35,2,00488,India
991577,2023-03-23,209,pepsi,75,100,25,2,00488,India
991577,2023-03-23,204,strawberry yogurt,50,60,10,2,00488,India
991577,2023-03-23,201,paneer,210,340,130,1,00488,India
980854,2023-03-23,213,bisleri,6,15,9,2,00196,India
980854,2023-03-23,201,paneer,210,340,130,1,00196,India
980854,2023-03-23,212,amul cheese,250,315,65,1,00196,India
429436,2023-03-23,201,paneer,210,340,130,1,00137,India
369810,2023-03-23,204,strawberry yogurt,50,60,10,2,00093,India
637101,2023-03-23,204,strawberry yogurt,50,60,10,2,00261,India
637101,2023-03-23,211,red bull,90,125,35,2,00261,India
637101,2023-03-23,213,bisleri,6,15,9,2,00261,India
637101,2023-03-23,207,coca cola,75,100,25,2,00261,India
746346,2023-03-23,204,strawberry yogurt,50,60,10,2,00227,India
746346,2023-03-23,210,mountain dew,75,100,25,2,00227,India
746346,2023-03-23,208,sprite,75,100,25,2,00227,India
876717,2023-03-23,203,mango yogurt,50,60,10,2,00355,India
876717,2023-03-23,205,classic yogurt,45,60,15,2,00355,India
382734,2023-03-23,210,mountain dew,75,100,25,2,00091,India
177933,2023-03-23,204,strawberry yogurt,50,60,10,2,00029,India
177933,2023-03-23,207,coca cola,75,100,25,2,00029,India
177933,2023-03-23,203,mango yogurt,50,60,10,2,00029,India
177933,2023-03-23,209,pepsi,75,100,25,2,00029,India
617210,2023-03-23,203,mango yogurt,50,60,10,2,00257,India
617210,2023-03-23,206,yakult,360,400,40,2,00257,India
617210,2023-03-23,205,classic yogurt,45,60,15,2,00257,India
617210,2023-03-23,208,sprite,75,100,25,2,00257,India
363011,2023-03-23,206,yakult,360,400,40,2,00139,India
363011,2023-03-23,213,bisleri,6,15,9,2,00139,India
763076,2023-03-23,213,bisleri,6,15,9,2,00188,India
763076,2023-03-23,209,pepsi,75,100,25,2,00188,India
951346,2023-03-23,206,yakult,360,400,40,2,00397,India
951346,2023-03-23,204,strawberry yogurt,50,60,10,2,00397,India
951346,2023-03-23,212,amul cheese,250,315,65,1,00397,India
602689,2023-03-23,203,mango yogurt,50,60,10,2,00218,India
602689,2023-03-23,201,paneer,210,340,130,1,00218,India
602689,2023-03-23,211,red bull,90,125,35,2,00218,India
602689,2023-03-23,212,amul cheese,250,315,65,1,00218,India
602689,2023-03-23,206,yakult,360,400,40,2,00218,India
781274,2023-03-23,207,coca cola,75,100,25,2,00168,India
781274,2023-03-23,202,milk,12,27,15,1,00168,India
781274,2023-03-23,203,mango yogurt,50,60,10,2,00168,India
433049,2023-03-23,213,bisleri,6,15,9,2,00311,India
433049,2023-03-23,206,yakult,360,400,40,2,00311,India
433049,2023-03-23,204,strawberry yogurt,50,60,10,2,00311,India
524367,2023-03-23,212,amul cheese,250,315,65,1,00112,India
126951,2023-03-23,202,milk,12,27,15,1,00172,India
126951,2023-03-23,212,amul cheese,250,315,65,1,00172,India
126951,2023-03-23,211,red bull,90,125,35,2,00172,India
653762,2023-03-23,205,classic yogurt,45,60,15,2,00223,India
653762,2023-03-23,212,amul cheese,250,315,65,1,00223,India
653762,2023-03-23,204,strawberry yogurt,50,60,10,2,00223,India
577164,2023-03-23,208,sprite,75,100,25,2,00169,India
577164,2023-03-23,203,mango yogurt,50,60,10,2,00169,India
577164,2023-03-23,209,pepsi,75,100,25,2,00169,India
577164,2023-03-23,202,milk,12,27,15,1,00169,India
577164,2023-03-23,212,amul cheese,250,315,65,1,00169,India
161682,2023-03-23,208,sprite,75,100,25,2,00325,India
161682,2023-03-23,211,red bull,90,125,35,2,00325,India
161682,2023-03-23,207,coca cola,75,100,25,2,00325,India
599978,2023-03-23,211,red bull,90,125,35,2,00152,India
371411,2023-03-23,208,sprite,75,100,25,2,00336,India
371411,2023-03-23,210,mountain dew,75,100,25,2,00336,India
371411,2023-03-23,202,milk,12,27,15,1,00336,India
371411,2023-03-23,204,strawberry yogurt,50,60,10,2,00336,India
371411,2023-03-23,201,paneer,210,340,130,1,00336,India
182934,2023-03-23,208,sprite,75,100,25,2,00146,India
636475,2023-03-23,207,coca cola,75,100,25,2,00130,India
318437,2023-03-23,209,pepsi,75,100,25,2,00435,India
318437,2023-03-23,201,paneer,210,340,130,1,00435,India
906555,2023-03-23,213,bisleri,6,15,9,2,00228,India
906555,2023-03-23,210,mountain dew,75,100,25,2,00228,India
342540,2023-03-23,210,mountain dew,75,100,25,2,00018,India
260098,2023-03-23,209,pepsi,75,100,25,2,00052,India
260098,2023-03-23,205,classic yogurt,45,60,15,2,00052,India
260098,2023-03-23,211,red bull,90,125,35,2,00052,India
260098,2023-03-23,203,mango yogurt,50,60,10,2,00052,India
881524,2023-03-23,213,bisleri,6,15,9,2,00050,India
881524,2023-03-23,212,amul cheese,250,315,65,1,00050,India
344264,2023-03-23,208,sprite,75,100,25,2,00101,India
344264,2023-03-23,213,bisleri,6,15,9,2,00101,India
344264,2023-03-23,202,milk,12,27,15,1,00101,India
983453,2023-03-23,210,mountain dew,75,100,25,2,00180,India
983453,2023-03-23,205,classic yogurt,45,60,15,2,00180,India
983453,2023-03-23,208,sprite,75,100,25,2,00180,India
983453,2023-03-23,201,paneer,210,340,130,1,00180,India
882248,2023-03-23,212,amul cheese,250,315,65,1,00403,India
882248,2023-03-23,202,milk,12,27,15,1,00403,India
882248,2023-03-23,203,mango yogurt,50,60,10,2,00403,India
560485,2023-03-23,212,amul cheese,250,315,65,1,00406,India
560485,2023-03-23,208,sprite,75,100,25,2,00406,India
560485,2023-03-23,202,milk,12,27,15,1,00406,India
560485,2023-03-23,213,bisleri,6,15,9,2,00406,India
379600,2023-03-23,212,amul cheese,250,315,65,1,00401,India
379600,2023-03-23,207,coca cola,75,100,25,2,00401,India
379600,2023-03-23,210,mountain dew,75,100,25,2,00401,India
669175,2023-03-23,203,mango yogurt,50,60,10,2,00153,India
669175,2023-03-23,207,coca cola,75,100,25,2,00153,India
669175,2023-03-23,204,strawberry yogurt,50,60,10,2,00153,India
669175,2023-03-23,213,bisleri,6,15,9,2,00153,India
953277,2023-03-23,208,sprite,75,100,25,2,00267,India
953277,2023-03-23,202,milk,12,27,15,1,00267,India
953277,2023-03-23,209,pepsi,75,100,25,2,00267,India
953277,2023-03-23,212,amul cheese,250,315,65,1,00267,India
396035,2023-03-23,207,coca cola,75,100,25,2,00209,India
396035,2023-03-23,211,red bull,90,125,35,2,00209,India
407589,2023-03-23,201,paneer,210,340,130,1,00124,India
407589,2023-03-23,210,mountain dew,75,100,25,2,00124,India
407589,2023-03-23,211,red bull,90,125,35,2,00124,India
375771,2023-03-23,202,milk,12,27,15,1,00250,India
821801,2023-03-23,210,mountain dew,75,100,25,2,00258,India
514275,2023-03-23,210,mountain dew,75,100,25,2,00433,India
514275,2023-03-23,205,classic yogurt,45,60,15,2,00433,India
514275,2023-03-23,209,pepsi,75,100,25,2,00433,India
514275,2023-03-23,202,milk,12,27,15,1,00433,India
514275,2023-03-23,212,amul cheese,250,315,65,1,00433,India
293849,2023-03-23,208,sprite,75,100,25,2,00057,India
293849,2023-03-23,213,bisleri,6,15,9,2,00057,India
293849,2023-03-23,201,paneer,210,340,130,1,00057,India
293849,2023-03-23,211,red bull,90,125,35,2,00057,India
337207,2023-03-23,211,red bull,90,125,35,2,00485,India
337207,2023-03-23,205,classic yogurt,45,60,15,2,00485,India
337207,2023-03-23,208,sprite,75,100,25,2,00485,India
534498,2023-03-23,209,pepsi,75,100,25,2,00095,India
534498,2023-03-23,202,milk,12,27,15,1,00095,India
534498,2023-03-23,213,bisleri,6,15,9,2,00095,India
534498,2023-03-23,204,strawberry yogurt,50,60,10,2,00095,India
534498,2023-03-23,201,paneer,210,340,130,1,00095,India
733960,2023-03-23,207,coca cola,75,100,25,2,00374,India
733960,2023-03-23,213,bisleri,6,15,9,2,00374,India
733960,2023-03-23,201,paneer,210,340,130,1,00374,India
733960,2023-03-23,212,amul cheese,250,315,65,1,00374,India
544014,2023-03-23,213,bisleri,6,15,9,2,00133,India
544014,2023-03-23,202,milk,12,27,15,1,00133,India
544014,2023-03-23,211,red bull,90,125,35,2,00133,India
544014,2023-03-23,201,paneer,210,340,130,1,00133,India
734465,2023-03-23,202,milk,12,27,15,1,00252,India
179341,2023-03-23,204,strawberry yogurt,50,60,10,2,00289,India
179341,2023-03-23,213,bisleri,6,15,9,2,00289,India
179341,2023-03-23,201,paneer,210,340,130,1,00289,India
179341,2023-03-23,208,sprite,75,100,25,2,00289,India
996301,2023-03-23,201,paneer,210,340,130,1,00308,India
996301,2023-03-23,212,amul cheese,250,315,65,1,00308,India
996301,2023-03-23,213,bisleri,6,15,9,2,00308,India
996301,2023-03-23,208,sprite,75,100,25,2,00308,India
141298,2023-03-23,207,coca cola,75,100,25,2,00368,India
141298,2023-03-23,208,sprite,75,100,25,2,00368,India
955988,2023-03-23,211,red bull,90,125,35,2,00013,India
955988,2023-03-23,212,amul cheese,250,315,65,1,00013,India
955988,2023-03-23,209,pepsi,75,100,25,2,00013,India
684683,2023-03-23,206,yakult,360,400,40,2,00069,India
684683,2023-03-23,203,mango yogurt,50,60,10,2,00069,India
885635,2023-03-23,208,sprite,75,100,25,2,00481,India
885635,2023-03-23,203,mango yogurt,50,60,10,2,00481,India
218055,2023-03-23,206,yakult,360,400,40,2,00204,India
218055,2023-03-23,212,amul cheese,250,315,65,1,00204,India
584086,2023-03-23,206,yakult,360,400,40,2,00180,India
584086,2023-03-23,207,coca cola,75,100,25,2,00180,India
584086,2023-03-23,212,amul cheese,250,315,65,1,00180,India
584086,2023-03-23,213,bisleri,6,15,9,2,00180,India
494876,2023-03-23,203,mango yogurt,50,60,10,2,00092,India
494876,2023-03-23,213,bisleri,6,15,9,2,00092,India
494876,2023-03-23,207,coca cola,75,100,25,2,00092,India
494876,2023-03-23,208,sprite,75,100,25,2,00092,India
143538,2023-03-23,207,coca cola,75,100,25,2,00419,India
143538,2023-03-23,212,amul cheese,250,315,65,1,00419,India
143538,2023-03-23,208,sprite,75,100,25,2,00419,India
271623,2023-03-23,206,yakult,360,400,40,2,00413,India
640318,2023-03-23,204,strawberry yogurt,50,60,10,2,00217,India
640318,2023-03-23,207,coca cola,75,100,25,2,00217,India
640318,2023-03-23,211,red bull,90,125,35,2,00217,India
543604,2023-03-23,213,bisleri,6,15,9,2,00200,India
688019,2023-03-23,210,mountain dew,75,100,25,2,00170,India
688019,2023-03-23,207,coca cola,75,100,25,2,00170,India
214185,2023-03-23,211,red bull,90,125,35,2,00448,India
214185,2023-03-23,206,yakult,360,400,40,2,00448,India
214185,2023-03-23,209,pepsi,75,100,25,2,00448,India
857530,2023-03-23,209,pepsi,75,100,25,2,00424,India
862083,2023-03-23,204,strawberry yogurt,50,60,10,2,00421,India
862083,2023-03-23,212,amul cheese,250,315,65,1,00421,India
862083,2023-03-23,208,sprite,75,100,25,2,00421,India
862083,2023-03-23,202,milk,12,27,15,1,00421,India
862083,2023-03-23,213,bisleri,6,15,9,2,00421,India
649837,2023-03-23,211,red bull,90,125,35,2,00477,India
649837,2023-03-23,203,mango yogurt,50,60,10,2,00477,India
978650,2023-03-23,210,mountain dew,75,100,25,2,00237,India
978650,2023-03-23,202,milk,12,27,15,1,00237,India
978650,2023-03-23,212,amul cheese,250,315,65,1,00237,India
978650,2023-03-23,201,paneer,210,340,130,1,00237,India
663971,2023-03-23,204,strawberry yogurt,50,60,10,2,00451,India
663971,2023-03-23,201,paneer,210,340,130,1,00451,India
663971,2023-03-23,203,mango yogurt,50,60,10,2,00451,India
663971,2023-03-23,202,milk,12,27,15,1,00451,India
109846,2023-03-23,203,mango yogurt,50,60,10,2,00394,India
109846,2023-03-23,204,strawberry yogurt,50,60,10,2,00394,India
989267,2023-03-23,208,sprite,75,100,25,2,00092,India
989267,2023-03-23,209,pepsi,75,100,25,2,00092,India
989267,2023-03-23,205,classic yogurt,45,60,15,2,00092,India
989267,2023-03-23,210,mountain dew,75,100,25,2,00092,India
352605,2023-03-23,203,mango yogurt,50,60,10,2,00242,India
300263,2023-03-23,208,sprite,75,100,25,2,00200,India
300263,2023-03-23,212,amul cheese,250,315,65,1,00200,India
618432,2023-03-23,208,sprite,75,100,25,2,00274,India
618432,2023-03-23,209,pepsi,75,100,25,2,00274,India
618432,2023-03-23,210,mountain dew,75,100,25,2,00274,India
184958,2023-03-23,213,bisleri,6,15,9,2,00002,India
184958,2023-03-23,212,amul cheese,250,315,65,1,00002,India
765541,2023-03-23,201,paneer,210,340,130,1,00144,India
765541,2023-03-23,211,red bull,90,125,35,2,00144,India
671583,2023-03-23,206,yakult,360,400,40,2,00212,India
671583,2023-03-23,211,red bull,90,125,35,2,00212,India
424418,2023-03-23,212,amul cheese,250,315,65,1,00242,India
424418,2023-03-23,209,pepsi,75,100,25,2,00242,India
424418,2023-03-23,208,sprite,75,100,25,2,00242,India
424418,2023-03-23,207,coca cola,75,100,25,2,00242,India
981575,2023-03-23,212,amul cheese,250,315,65,1,00039,India
981575,2023-03-23,213,bisleri,6,15,9,2,00039,India
335609,2023-03-23,203,mango yogurt,50,60,10,2,00432,India
212531,2023-03-23,213,bisleri,6,15,9,2,00048,India
212531,2023-03-23,210,mountain dew,75,100,25,2,00048,India
212531,2023-03-23,212,amul cheese,250,315,65,1,00048,India
212531,2023-03-23,211,red bull,90,125,35,2,00048,India
212531,2023-03-23,209,pepsi,75,100,25,2,00048,India
399383,2023-03-23,204,strawberry yogurt,50,60,10,2,00263,India
879914,2023-03-23,205,classic yogurt,45,60,15,2,00116,India
346573,2023-03-24,213,bisleri,6,15,9,2,00478,India
346573,2023-03-24,201,paneer,210,340,130,1,00478,India
346573,2023-03-24,203,mango yogurt,50,60,10,2,00478,India
346573,2023-03-24,210,mountain dew,75,100,25,2,00478,India
694826,2023-03-24,213,bisleri,6,15,9,2,00299,India
694826,2023-03-24,212,amul cheese,250,315,65,1,00299,India
507983,2023-03-24,208,sprite,75,100,25,2,00020,India
507983,2023-03-24,213,bisleri,6,15,9,2,00020,India
446389,2023-03-24,205,classic yogurt,45,60,15,2,00245,India
446389,2023-03-24,206,yakult,360,400,40,2,00245,India
446389,2023-03-24,202,milk,12,27,15,1,00245,India
687690,2023-03-24,204,strawberry yogurt,50,60,10,2,00062,India
687690,2023-03-24,209,pepsi,75,100,25,2,00062,India
687690,2023-03-24,211,red bull,90,125,35,2,00062,India
687690,2023-03-24,212,amul cheese,250,315,65,1,00062,India
706365,2023-03-24,208,sprite,75,100,25,2,00281,India
706365,2023-03-24,202,milk,12,27,15,1,00281,India
706365,2023-03-24,207,coca cola,75,100,25,2,00281,India
276803,2023-03-24,211,red bull,90,125,35,2,00448,India
935239,2023-03-24,211,red bull,90,125,35,2,00085,India
935239,2023-03-24,208,sprite,75,100,25,2,00085,India
935239,2023-03-24,213,bisleri,6,15,9,2,00085,India
163257,2023-03-24,203,mango yogurt,50,60,10,2,00338,India
163257,2023-03-24,207,coca cola,75,100,25,2,00338,India
163257,2023-03-24,211,red bull,90,125,35,2,00338,India
163257,2023-03-24,210,mountain dew,75,100,25,2,00338,India
163257,2023-03-24,209,pepsi,75,100,25,2,00338,India
352885,2023-03-24,207,coca cola,75,100,25,2,00150,India
352885,2023-03-24,209,pepsi,75,100,25,2,00150,India
352885,2023-03-24,203,mango yogurt,50,60,10,2,00150,India
216813,2023-03-24,213,bisleri,6,15,9,2,00356,India
934036,2023-03-24,206,yakult,360,400,40,2,00446,India
934036,2023-03-24,210,mountain dew,75,100,25,2,00446,India
380662,2023-03-24,211,red bull,90,125,35,2,00429,India
380662,2023-03-24,208,sprite,75,100,25,2,00429,India
380662,2023-03-24,207,coca cola,75,100,25,2,00429,India
161779,2023-03-24,213,bisleri,6,15,9,2,00365,India
161779,2023-03-24,205,classic yogurt,45,60,15,2,00365,India
161779,2023-03-24,201,paneer,210,340,130,1,00365,India
338843,2023-03-24,207,coca cola,75,100,25,2,00081,India
338843,2023-03-24,205,classic yogurt,45,60,15,2,00081,India
338843,2023-03-24,209,pepsi,75,100,25,2,00081,India
651126,2023-03-24,205,classic yogurt,45,60,15,2,00406,India
651126,2023-03-24,211,red bull,90,125,35,2,00406,India
651126,2023-03-24,204,strawberry yogurt,50,60,10,2,00406,India
651126,2023-03-24,208,sprite,75,100,25,2,00406,India
651126,2023-03-24,201,paneer,210,340,130,1,00406,India
613431,2023-03-24,211,red bull,90,125,35,2,00084,India
613431,2023-03-24,212,amul cheese,250,315,65,1,00084,India
613431,2023-03-24,213,bisleri,6,15,9,2,00084,India
613431,2023-03-24,206,yakult,360,400,40,2,00084,India
310311,2023-03-24,203,mango yogurt,50,60,10,2,00402,India
310311,2023-03-24,201,paneer,210,340,130,1,00402,India
310311,2023-03-24,202,milk,12,27,15,1,00402,India
385416,2023-03-24,211,red bull,90,125,35,2,00391,India
385416,2023-03-24,213,bisleri,6,15,9,2,00391,India
385416,2023-03-24,208,sprite,75,100,25,2,00391,India
722931,2023-03-24,211,red bull,90,125,35,2,00345,India
722931,2023-03-24,206,yakult,360,400,40,2,00345,India
486943,2023-03-24,209,pepsi,75,100,25,2,00068,India
486943,2023-03-24,208,sprite,75,100,25,2,00068,India
486943,2023-03-24,210,mountain dew,75,100,25,2,00068,India
726279,2023-03-24,210,mountain dew,75,100,25,2,00489,India
726279,2023-03-24,213,bisleri,6,15,9,2,00489,India
726279,2023-03-24,203,mango yogurt,50,60,10,2,00489,India
726279,2023-03-24,208,sprite,75,100,25,2,00489,India
964359,2023-03-24,202,milk,12,27,15,1,00131,India
964359,2023-03-24,204,strawberry yogurt,50,60,10,2,00131,India
964359,2023-03-24,208,sprite,75,100,25,2,00131,India
964359,2023-03-24,203,mango yogurt,50,60,10,2,00131,India
778517,2023-03-24,210,mountain dew,75,100,25,2,00075,India
778517,2023-03-24,213,bisleri,6,15,9,2,00075,India
778517,2023-03-24,212,amul cheese,250,315,65,1,00075,India
778517,2023-03-24,206,yakult,360,400,40,2,00075,India
778517,2023-03-24,209,pepsi,75,100,25,2,00075,India
402152,2023-03-24,203,mango yogurt,50,60,10,2,00157,India
402152,2023-03-24,210,mountain dew,75,100,25,2,00157,India
402152,2023-03-24,207,coca cola,75,100,25,2,00157,India
402152,2023-03-24,208,sprite,75,100,25,2,00157,India
486048,2023-03-24,207,coca cola,75,100,25,2,00162,India
627861,2023-03-24,212,amul cheese,250,315,65,1,00092,India
543333,2023-03-24,201,paneer,210,340,130,1,00360,India
797670,2023-03-24,211,red bull,90,125,35,2,00192,India
797670,2023-03-24,205,classic yogurt,45,60,15,2,00192,India
332928,2023-03-24,203,mango yogurt,50,60,10,2,00015,India
332928,2023-03-24,209,pepsi,75,100,25,2,00015,India
332928,2023-03-24,211,red bull,90,125,35,2,00015,India
824555,2023-03-24,212,amul cheese,250,315,65,1,00025,India
824555,2023-03-24,209,pepsi,75,100,25,2,00025,India
824555,2023-03-24,204,strawberry yogurt,50,60,10,2,00025,India
630469,2023-03-24,213,bisleri,6,15,9,2,00192,India
630469,2023-03-24,201,paneer,210,340,130,1,00192,India
630469,2023-03-24,211,red bull,90,125,35,2,00192,India
976488,2023-03-24,205,classic yogurt,45,60,15,2,00259,India
976488,2023-03-24,212,amul cheese,250,315,65,1,00259,India
976488,2023-03-24,208,sprite,75,100,25,2,00259,India
271788,2023-03-24,212,amul cheese,250,315,65,1,00300,India
271788,2023-03-24,203,mango yogurt,50,60,10,2,00300,India
541278,2023-03-24,208,sprite,75,100,25,2,00327,India
541278,2023-03-24,203,mango yogurt,50,60,10,2,00327,India
541278,2023-03-24,201,paneer,210,340,130,1,00327,India
962051,2023-03-24,204,strawberry yogurt,50,60,10,2,00289,India
948806,2023-03-24,201,paneer,210,340,130,1,00101,India
948806,2023-03-24,206,yakult,360,400,40,2,00101,India
335365,2023-03-24,209,pepsi,75,100,25,2,00034,India
639893,2023-03-24,212,amul cheese,250,315,65,1,00104,India
639893,2023-03-24,202,milk,12,27,15,1,00104,India
639893,2023-03-24,205,classic yogurt,45,60,15,2,00104,India
303058,2023-03-24,212,amul cheese,250,315,65,1,00331,India
303058,2023-03-24,202,milk,12,27,15,1,00331,India
303058,2023-03-24,210,mountain dew,75,100,25,2,00331,India
245763,2023-03-24,208,sprite,75,100,25,2,00319,India
245763,2023-03-24,204,strawberry yogurt,50,60,10,2,00319,India
245763,2023-03-24,202,milk,12,27,15,1,00319,India
323880,2023-03-24,210,mountain dew,75,100,25,2,00129,India
323880,2023-03-24,202,milk,12,27,15,1,00129,India
323880,2023-03-24,201,paneer,210,340,130,1,00129,India
323880,2023-03-24,212,amul cheese,250,315,65,1,00129,India
159686,2023-03-24,201,paneer,210,340,130,1,00169,India
159686,2023-03-24,205,classic yogurt,45,60,15,2,00169,India
159686,2023-03-24,203,mango yogurt,50,60,10,2,00169,India
239329,2023-03-24,207,coca cola,75,100,25,2,00363,India
239329,2023-03-24,201,paneer,210,340,130,1,00363,India
239329,2023-03-24,212,amul cheese,250,315,65,1,00363,India
616231,2023-03-24,205,classic yogurt,45,60,15,2,00307,India
616231,2023-03-24,211,red bull,90,125,35,2,00307,India
616231,2023-03-24,202,milk,12,27,15,1,00307,India
616231,2023-03-24,212,amul cheese,250,315,65,1,00307,India
772584,2023-03-24,203,mango yogurt,50,60,10,2,00474,India
772584,2023-03-24,206,yakult,360,400,40,2,00474,India
647420,2023-03-24,205,classic yogurt,45,60,15,2,00255,India
647420,2023-03-24,201,paneer,210,340,130,1,00255,India
647420,2023-03-24,212,amul cheese,250,315,65,1,00255,India
823162,2023-03-24,210,mountain dew,75,100,25,2,00333,India
823162,2023-03-24,206,yakult,360,400,40,2,00333,India
823162,2023-03-24,209,pepsi,75,100,25,2,00333,India
273762,2023-03-24,205,classic yogurt,45,60,15,2,00122,India
273762,2023-03-24,208,sprite,75,100,25,2,00122,India
273762,2023-03-24,207,coca cola,75,100,25,2,00122,India
392731,2023-03-24,202,milk,12,27,15,1,00410,India
392731,2023-03-24,208,sprite,75,100,25,2,00410,India
392731,2023-03-24,204,strawberry yogurt,50,60,10,2,00410,India
392731,2023-03-24,211,red bull,90,125,35,2,00410,India
392731,2023-03-24,207,coca cola,75,100,25,2,00410,India
397819,2023-03-24,210,mountain dew,75,100,25,2,00118,India
397819,2023-03-24,208,sprite,75,100,25,2,00118,India
397819,2023-03-24,212,amul cheese,250,315,65,1,00118,India
513055,2023-03-24,210,mountain dew,75,100,25,2,00249,India
513055,2023-03-24,202,milk,12,27,15,1,00249,India
513055,2023-03-24,212,amul cheese,250,315,65,1,00249,India
339025,2023-03-24,209,pepsi,75,100,25,2,00284,India
339025,2023-03-24,212,amul cheese,250,315,65,1,00284,India
339025,2023-03-24,211,red bull,90,125,35,2,00284,India
339025,2023-03-24,201,paneer,210,340,130,1,00284,India
855728,2023-03-24,204,strawberry yogurt,50,60,10,2,00181,India
855728,2023-03-24,211,red bull,90,125,35,2,00181,India
855728,2023-03-24,205,classic yogurt,45,60,15,2,00181,India
855728,2023-03-24,210,mountain dew,75,100,25,2,00181,India
730872,2023-03-24,209,pepsi,75,100,25,2,00007,India
730872,2023-03-24,205,classic yogurt,45,60,15,2,00007,India
730872,2023-03-24,206,yakult,360,400,40,2,00007,India
950002,2023-03-24,209,pepsi,75,100,25,2,00032,India
950002,2023-03-24,211,red bull,90,125,35,2,00032,India
950002,2023-03-24,201,paneer,210,340,130,1,00032,India
112393,2023-03-24,205,classic yogurt,45,60,15,2,00486,India
160697,2023-03-24,209,pepsi,75,100,25,2,00245,India
160697,2023-03-24,208,sprite,75,100,25,2,00245,India
894093,2023-03-24,213,bisleri,6,15,9,2,00095,India
809853,2023-03-24,209,pepsi,75,100,25,2,00470,India
809853,2023-03-24,201,paneer,210,340,130,1,00470,India
809853,2023-03-24,207,coca cola,75,100,25,2,00470,India
968428,2023-03-24,207,coca cola,75,100,25,2,00122,India
968428,2023-03-24,201,paneer,210,340,130,1,00122,India
968428,2023-03-24,212,amul cheese,250,315,65,1,00122,India
968428,2023-03-24,210,mountain dew,75,100,25,2,00122,India
968428,2023-03-24,203,mango yogurt,50,60,10,2,00122,India
448958,2023-03-24,206,yakult,360,400,40,2,00402,India
448958,2023-03-24,210,mountain dew,75,100,25,2,00402,India
448958,2023-03-24,211,red bull,90,125,35,2,00402,India
448958,2023-03-24,213,bisleri,6,15,9,2,00402,India
448958,2023-03-24,201,paneer,210,340,130,1,00402,India
326932,2023-03-24,208,sprite,75,100,25,2,00100,India
604796,2023-03-24,207,coca cola,75,100,25,2,00182,India
604796,2023-03-24,202,milk,12,27,15,1,00182,India
604796,2023-03-24,212,amul cheese,250,315,65,1,00182,India
604796,2023-03-24,203,mango yogurt,50,60,10,2,00182,India
971946,2023-03-25,207,coca cola,75,100,25,2,00057,India
971946,2023-03-25,208,sprite,75,100,25,2,00057,India
742437,2023-03-25,205,classic yogurt,45,60,15,2,00239,India
742437,2023-03-25,212,amul cheese,250,315,65,1,00239,India
742437,2023-03-25,210,mountain dew,75,100,25,2,00239,India
742437,2023-03-25,206,yakult,360,400,40,2,00239,India
978575,2023-03-25,202,milk,12,27,15,1,00066,India
978575,2023-03-25,211,red bull,90,125,35,2,00066,India
978575,2023-03-25,203,mango yogurt,50,60,10,2,00066,India
978575,2023-03-25,213,bisleri,6,15,9,2,00066,India
832027,2023-03-25,211,red bull,90,125,35,2,00041,India
565010,2023-03-25,208,sprite,75,100,25,2,00398,India
620299,2023-03-25,203,mango yogurt,50,60,10,2,00450,India
620299,2023-03-25,205,classic yogurt,45,60,15,2,00450,India
620299,2023-03-25,204,strawberry yogurt,50,60,10,2,00450,India
450165,2023-03-25,210,mountain dew,75,100,25,2,00241,India
450165,2023-03-25,212,amul cheese,250,315,65,1,00241,India
450165,2023-03-25,201,paneer,210,340,130,1,00241,India
450165,2023-03-25,204,strawberry yogurt,50,60,10,2,00241,India
178269,2023-03-25,201,paneer,210,340,130,1,00051,India
178269,2023-03-25,206,yakult,360,400,40,2,00051,India
178269,2023-03-25,202,milk,12,27,15,1,00051,India
300209,2023-03-25,206,yakult,360,400,40,2,00336,India
300209,2023-03-25,205,classic yogurt,45,60,15,2,00336,India
461373,2023-03-25,208,sprite,75,100,25,2,00382,India
496649,2023-03-25,212,amul cheese,250,315,65,1,00037,India
496649,2023-03-25,202,milk,12,27,15,1,00037,India
707453,2023-03-25,205,classic yogurt,45,60,15,2,00007,India
956925,2023-03-25,207,coca cola,75,100,25,2,00176,India
956925,2023-03-25,208,sprite,75,100,25,2,00176,India
106176,2023-03-25,210,mountain dew,75,100,25,2,00205,India
106176,2023-03-25,207,coca cola,75,100,25,2,00205,India
398463,2023-03-25,202,milk,12,27,15,1,00141,India
398463,2023-03-25,211,red bull,90,125,35,2,00141,India
870665,2023-03-25,201,paneer,210,340,130,1,00440,India
870665,2023-03-25,213,bisleri,6,15,9,2,00440,India
870665,2023-03-25,207,coca cola,75,100,25,2,00440,India
870665,2023-03-25,212,amul cheese,250,315,65,1,00440,India
870665,2023-03-25,206,yakult,360,400,40,2,00440,India
247201,2023-03-25,204,strawberry yogurt,50,60,10,2,00116,India
836508,2023-03-25,212,amul cheese,250,315,65,1,00495,India
988524,2023-03-25,204,strawberry yogurt,50,60,10,2,00300,India
849829,2023-03-25,208,sprite,75,100,25,2,00149,India
849829,2023-03-25,209,pepsi,75,100,25,2,00149,India
849829,2023-03-25,210,mountain dew,75,100,25,2,00149,India
849829,2023-03-25,212,amul cheese,250,315,65,1,00149,India
541003,2023-03-25,208,sprite,75,100,25,2,00385,India
895635,2023-03-25,206,yakult,360,400,40,2,00287,India
267883,2023-03-25,203,mango yogurt,50,60,10,2,00324,India
267883,2023-03-25,205,classic yogurt,45,60,15,2,00324,India
135680,2023-03-25,213,bisleri,6,15,9,2,00357,India
166397,2023-03-25,201,paneer,210,340,130,1,00391,India
166397,2023-03-25,208,sprite,75,100,25,2,00391,India
813942,2023-03-25,208,sprite,75,100,25,2,00205,India
813942,2023-03-25,212,amul cheese,250,315,65,1,00205,India
813942,2023-03-25,202,milk,12,27,15,1,00205,India
785720,2023-03-25,211,red bull,90,125,35,2,00173,India
785720,2023-03-25,202,milk,12,27,15,1,00173,India
785720,2023-03-25,208,sprite,75,100,25,2,00173,India
785720,2023-03-25,201,paneer,210,340,130,1,00173,India
737101,2023-03-25,201,paneer,210,340,130,1,00123,India
737101,2023-03-25,206,yakult,360,400,40,2,00123,India
926616,2023-03-25,211,red bull,90,125,35,2,00381,India
926616,2023-03-25,203,mango yogurt,50,60,10,2,00381,India
926616,2023-03-25,204,strawberry yogurt,50,60,10,2,00381,India
926616,2023-03-25,207,coca cola,75,100,25,2,00381,India
922592,2023-03-25,212,amul cheese,250,315,65,1,00117,India
922592,2023-03-25,206,yakult,360,400,40,2,00117,India
922592,2023-03-25,211,red bull,90,125,35,2,00117,India
200557,2023-03-25,208,sprite,75,100,25,2,00305,India
351234,2023-03-25,207,coca cola,75,100,25,2,00431,India
351234,2023-03-25,213,bisleri,6,15,9,2,00431,India
351234,2023-03-25,204,strawberry yogurt,50,60,10,2,00431,India
962180,2023-03-25,211,red bull,90,125,35,2,00218,India
962180,2023-03-25,208,sprite,75,100,25,2,00218,India
146243,2023-03-25,202,milk,12,27,15,1,00246,India
146243,2023-03-25,206,yakult,360,400,40,2,00246,India
146243,2023-03-25,208,sprite,75,100,25,2,00246,India
709983,2023-03-25,201,paneer,210,340,130,1,00096,India
709983,2023-03-25,204,strawberry yogurt,50,60,10,2,00096,India
709983,2023-03-25,205,classic yogurt,45,60,15,2,00096,India
709983,2023-03-25,208,sprite,75,100,25,2,00096,India
709983,2023-03-25,206,yakult,360,400,40,2,00096,India
807228,2023-03-25,202,milk,12,27,15,1,00354,India
807228,2023-03-25,207,coca cola,75,100,25,2,00354,India
807228,2023-03-25,213,bisleri,6,15,9,2,00354,India
807228,2023-03-25,203,mango yogurt,50,60,10,2,00354,India
630889,2023-03-25,203,mango yogurt,50,60,10,2,00439,India
630889,2023-03-25,205,classic yogurt,45,60,15,2,00439,India
630889,2023-03-25,206,yakult,360,400,40,2,00439,India
630889,2023-03-25,207,coca cola,75,100,25,2,00439,India
306727,2023-03-25,209,pepsi,75,100,25,2,00150,India
306727,2023-03-25,203,mango yogurt,50,60,10,2,00150,India
882765,2023-03-25,213,bisleri,6,15,9,2,00081,India
236179,2023-03-25,204,strawberry yogurt,50,60,10,2,00013,India
236179,2023-03-25,208,sprite,75,100,25,2,00013,India
236179,2023-03-25,213,bisleri,6,15,9,2,00013,India
236179,2023-03-25,201,paneer,210,340,130,1,00013,India
236179,2023-03-25,207,coca cola,75,100,25,2,00013,India
725282,2023-03-25,213,bisleri,6,15,9,2,00412,India
725282,2023-03-25,205,classic yogurt,45,60,15,2,00412,India
725282,2023-03-25,207,coca cola,75,100,25,2,00412,India
565185,2023-03-25,201,paneer,210,340,130,1,00114,India
471973,2023-03-25,210,mountain dew,75,100,25,2,00329,India
471973,2023-03-25,211,red bull,90,125,35,2,00329,India
471973,2023-03-25,213,bisleri,6,15,9,2,00329,India
645657,2023-03-25,204,strawberry yogurt,50,60,10,2,00120,India
645657,2023-03-25,206,yakult,360,400,40,2,00120,India
645657,2023-03-25,212,amul cheese,250,315,65,1,00120,India
558745,2023-03-25,209,pepsi,75,100,25,2,00271,India
411520,2023-03-25,208,sprite,75,100,25,2,00396,India
411520,2023-03-25,203,mango yogurt,50,60,10,2,00396,India
411520,2023-03-25,206,yakult,360,400,40,2,00396,India
411520,2023-03-25,213,bisleri,6,15,9,2,00396,India
411520,2023-03-25,202,milk,12,27,15,1,00396,India
511964,2023-03-25,208,sprite,75,100,25,2,00013,India
511964,2023-03-25,203,mango yogurt,50,60,10,2,00013,India
511964,2023-03-25,204,strawberry yogurt,50,60,10,2,00013,India
187766,2023-03-25,203,mango yogurt,50,60,10,2,00138,India
187766,2023-03-25,201,paneer,210,340,130,1,00138,India
187766,2023-03-25,204,strawberry yogurt,50,60,10,2,00138,India
187766,2023-03-25,206,yakult,360,400,40,2,00138,India
187766,2023-03-25,208,sprite,75,100,25,2,00138,India
610707,2023-03-25,213,bisleri,6,15,9,2,00022,India
610707,2023-03-25,202,milk,12,27,15,1,00022,India
610707,2023-03-25,210,mountain dew,75,100,25,2,00022,India
610707,2023-03-25,205,classic yogurt,45,60,15,2,00022,India
616481,2023-03-25,206,yakult,360,400,40,2,00010,India
616481,2023-03-25,201,paneer,210,340,130,1,00010,India
616481,2023-03-25,202,milk,12,27,15,1,00010,India
616481,2023-03-25,211,red bull,90,125,35,2,00010,India
119237,2023-03-25,210,mountain dew,75,100,25,2,00281,India
119237,2023-03-25,211,red bull,90,125,35,2,00281,India
467626,2023-03-25,211,red bull,90,125,35,2,00372,India
455112,2023-03-25,206,yakult,360,400,40,2,00338,India
455112,2023-03-25,204,strawberry yogurt,50,60,10,2,00338,India
697440,2023-03-25,204,strawberry yogurt,50,60,10,2,00097,India
697440,2023-03-25,206,yakult,360,400,40,2,00097,India
120524,2023-03-25,208,sprite,75,100,25,2,00272,India
120524,2023-03-25,206,yakult,360,400,40,2,00272,India
789548,2023-03-26,208,sprite,75,100,25,2,00320,India
474448,2023-03-26,211,red bull,90,125,35,2,00070,India
416697,2023-03-26,204,strawberry yogurt,50,60,10,2,00189,India
416697,2023-03-26,203,mango yogurt,50,60,10,2,00189,India
416697,2023-03-26,212,amul cheese,250,315,65,1,00189,India
416697,2023-03-26,210,mountain dew,75,100,25,2,00189,India
416697,2023-03-26,202,milk,12,27,15,1,00189,India
534744,2023-03-26,206,yakult,360,400,40,2,00030,India
534744,2023-03-26,202,milk,12,27,15,1,00030,India
130753,2023-03-26,208,sprite,75,100,25,2,00080,India
975732,2023-03-26,212,amul cheese,250,315,65,1,00341,India
939071,2023-03-26,212,amul cheese,250,315,65,1,00259,India
939071,2023-03-26,205,classic yogurt,45,60,15,2,00259,India
939071,2023-03-26,206,yakult,360,400,40,2,00259,India
939071,2023-03-26,209,pepsi,75,100,25,2,00259,India
939071,2023-03-26,202,milk,12,27,15,1,00259,India
741736,2023-03-26,202,milk,12,27,15,1,00494,India
383770,2023-03-26,211,red bull,90,125,35,2,00406,India
383770,2023-03-26,204,strawberry yogurt,50,60,10,2,00406,India
610568,2023-03-26,206,yakult,360,400,40,2,00484,India
610568,2023-03-26,202,milk,12,27,15,1,00484,India
911039,2023-03-26,207,coca cola,75,100,25,2,00303,India
911039,2023-03-26,212,amul cheese,250,315,65,1,00303,India
911039,2023-03-26,210,mountain dew,75,100,25,2,00303,India
911039,2023-03-26,208,sprite,75,100,25,2,00303,India
574868,2023-03-26,209,pepsi,75,100,25,2,00215,India
574868,2023-03-26,211,red bull,90,125,35,2,00215,India
574868,2023-03-26,213,bisleri,6,15,9,2,00215,India
574868,2023-03-26,205,classic yogurt,45,60,15,2,00215,India
851599,2023-03-26,212,amul cheese,250,315,65,1,00270,India
851599,2023-03-26,206,yakult,360,400,40,2,00270,India
621088,2023-03-26,204,strawberry yogurt,50,60,10,2,00372,India
621088,2023-03-26,208,sprite,75,100,25,2,00372,India
621088,2023-03-26,206,yakult,360,400,40,2,00372,India
621088,2023-03-26,213,bisleri,6,15,9,2,00372,India
982615,2023-03-26,213,bisleri,6,15,9,2,00459,India
982615,2023-03-26,208,sprite,75,100,25,2,00459,India
982615,2023-03-26,210,mountain dew,75,100,25,2,00459,India
982615,2023-03-26,211,red bull,90,125,35,2,00459,India
982615,2023-03-26,204,strawberry yogurt,50,60,10,2,00459,India
651324,2023-03-26,202,milk,12,27,15,1,00024,India
651324,2023-03-26,205,classic yogurt,45,60,15,2,00024,India
651324,2023-03-26,209,pepsi,75,100,25,2,00024,India
651324,2023-03-26,211,red bull,90,125,35,2,00024,India
651324,2023-03-26,206,yakult,360,400,40,2,00024,India
515337,2023-03-26,210,mountain dew,75,100,25,2,00398,India
250924,2023-03-26,204,strawberry yogurt,50,60,10,2,00121,India
906267,2023-03-26,203,mango yogurt,50,60,10,2,00038,India
906267,2023-03-26,207,coca cola,75,100,25,2,00038,India
532773,2023-03-26,210,mountain dew,75,100,25,2,00106,India
525332,2023-03-26,203,mango yogurt,50,60,10,2,00446,India
525332,2023-03-26,211,red bull,90,125,35,2,00446,India
148121,2023-03-26,203,mango yogurt,50,60,10,2,00405,India
148121,2023-03-26,204,strawberry yogurt,50,60,10,2,00405,India
825520,2023-03-26,204,strawberry yogurt,50,60,10,2,00080,India
825520,2023-03-26,208,sprite,75,100,25,2,00080,India
825520,2023-03-26,201,paneer,210,340,130,1,00080,India
548981,2023-03-26,203,mango yogurt,50,60,10,2,00218,India
659807,2023-03-26,202,milk,12,27,15,1,00450,India
659807,2023-03-26,208,sprite,75,100,25,2,00450,India
659807,2023-03-26,204,strawberry yogurt,50,60,10,2,00450,India
557777,2023-03-26,211,red bull,90,125,35,2,00014,India
557777,2023-03-26,210,mountain dew,75,100,25,2,00014,India
557777,2023-03-26,206,yakult,360,400,40,2,00014,India
557777,2023-03-26,205,classic yogurt,45,60,15,2,00014,India
557777,2023-03-26,202,milk,12,27,15,1,00014,India
185051,2023-03-26,206,yakult,360,400,40,2,00093,India
185051,2023-03-26,202,milk,12,27,15,1,00093,India
185051,2023-03-26,201,paneer,210,340,130,1,00093,India
185051,2023-03-26,211,red bull,90,125,35,2,00093,India
185051,2023-03-26,212,amul cheese,250,315,65,1,00093,India
765500,2023-03-26,205,classic yogurt,45,60,15,2,00263,India
737906,2023-03-26,203,mango yogurt,50,60,10,2,00163,India
737906,2023-03-26,206,yakult,360,400,40,2,00163,India
496494,2023-03-26,203,mango yogurt,50,60,10,2,00112,India
496494,2023-03-26,208,sprite,75,100,25,2,00112,India
496494,2023-03-26,206,yakult,360,400,40,2,00112,India
496494,2023-03-26,201,paneer,210,340,130,1,00112,India
442939,2023-03-26,206,yakult,360,400,40,2,00442,India
442939,2023-03-26,210,mountain dew,75,100,25,2,00442,India
442939,2023-03-26,208,sprite,75,100,25,2,00442,India
442939,2023-03-26,207,coca cola,75,100,25,2,00442,India
442939,2023-03-26,205,classic yogurt,45,60,15,2,00442,India
763093,2023-03-26,208,sprite,75,100,25,2,00058,India
763093,2023-03-26,205,classic yogurt,45,60,15,2,00058,India
763093,2023-03-26,213,bisleri,6,15,9,2,00058,India
763093,2023-03-26,201,paneer,210,340,130,1,00058,India
109544,2023-03-26,207,coca cola,75,100,25,2,00301,India
109544,2023-03-26,213,bisleri,6,15,9,2,00301,India
109544,2023-03-26,209,pepsi,75,100,25,2,00301,India
109544,2023-03-26,212,amul cheese,250,315,65,1,00301,India
800399,2023-03-26,207,coca cola,75,100,25,2,00220,India
800399,2023-03-26,205,classic yogurt,45,60,15,2,00220,India
800399,2023-03-26,202,milk,12,27,15,1,00220,India
800399,2023-03-26,213,bisleri,6,15,9,2,00220,India
251068,2023-03-26,212,amul cheese,250,315,65,1,00128,India
251068,2023-03-26,213,bisleri,6,15,9,2,00128,India
251068,2023-03-26,204,strawberry yogurt,50,60,10,2,00128,India
133185,2023-03-26,207,coca cola,75,100,25,2,00141,India
133185,2023-03-26,213,bisleri,6,15,9,2,00141,India
133185,2023-03-26,208,sprite,75,100,25,2,00141,India
701026,2023-03-26,211,red bull,90,125,35,2,00338,India
338415,2023-03-26,211,red bull,90,125,35,2,00174,India
338415,2023-03-26,213,bisleri,6,15,9,2,00174,India
781530,2023-03-26,207,coca cola,75,100,25,2,00014,India
781530,2023-03-26,202,milk,12,27,15,1,00014,India
753063,2023-03-26,206,yakult,360,400,40,2,00216,India
496690,2023-03-26,206,yakult,360,400,40,2,00050,India
496690,2023-03-26,210,mountain dew,75,100,25,2,00050,India
496690,2023-03-26,201,paneer,210,340,130,1,00050,India
524305,2023-03-26,209,pepsi,75,100,25,2,00057,India
199144,2023-03-26,205,classic yogurt,45,60,15,2,00069,India
199144,2023-03-26,207,coca cola,75,100,25,2,00069,India
199144,2023-03-26,204,strawberry yogurt,50,60,10,2,00069,India
199144,2023-03-26,208,sprite,75,100,25,2,00069,India
229585,2023-03-26,205,classic yogurt,45,60,15,2,00307,India
229585,2023-03-26,212,amul cheese,250,315,65,1,00307,India
229585,2023-03-26,211,red bull,90,125,35,2,00307,India
996017,2023-03-26,205,classic yogurt,45,60,15,2,00210,India
610026,2023-03-26,209,pepsi,75,100,25,2,00237,India
610026,2023-03-26,207,coca cola,75,100,25,2,00237,India
610026,2023-03-26,201,paneer,210,340,130,1,00237,India
174056,2023-03-26,212,amul cheese,250,315,65,1,00235,India
746640,2023-03-26,210,mountain dew,75,100,25,2,00482,India
746640,2023-03-26,212,amul cheese,250,315,65,1,00482,India
746640,2023-03-26,203,mango yogurt,50,60,10,2,00482,India
746640,2023-03-26,213,bisleri,6,15,9,2,00482,India
795498,2023-03-26,202,milk,12,27,15,1,00462,India
727462,2023-03-26,202,milk,12,27,15,1,00377,India
727462,2023-03-26,201,paneer,210,340,130,1,00377,India
727462,2023-03-26,206,yakult,360,400,40,2,00377,India
531904,2023-03-26,208,sprite,75,100,25,2,00225,India
531904,2023-03-26,213,bisleri,6,15,9,2,00225,India
531904,2023-03-26,202,milk,12,27,15,1,00225,India
531904,2023-03-26,211,red bull,90,125,35,2,00225,India
531904,2023-03-26,207,coca cola,75,100,25,2,00225,India
935924,2023-03-26,209,pepsi,75,100,25,2,00253,India
935924,2023-03-26,205,classic yogurt,45,60,15,2,00253,India
234272,2023-03-26,204,strawberry yogurt,50,60,10,2,00042,India
984865,2023-03-26,210,mountain dew,75,100,25,2,00223,India
984865,2023-03-26,206,yakult,360,400,40,2,00223,India
984865,2023-03-26,204,strawberry yogurt,50,60,10,2,00223,India
791397,2023-03-26,211,red bull,90,125,35,2,00469,India
791397,2023-03-26,210,mountain dew,75,100,25,2,00469,India
791397,2023-03-26,202,milk,12,27,15,1,00469,India
377851,2023-03-26,211,red bull,90,125,35,2,00010,India
377851,2023-03-26,213,bisleri,6,15,9,2,00010,India
812848,2023-03-26,213,bisleri,6,15,9,2,00364,India
326701,2023-03-26,210,mountain dew,75,100,25,2,00142,India
326701,2023-03-26,212,amul cheese,250,315,65,1,00142,India
326701,2023-03-26,208,sprite,75,100,25,2,00142,India
326701,2023-03-26,203,mango yogurt,50,60,10,2,00142,India
326701,2023-03-26,204,strawberry yogurt,50,60,10,2,00142,India
555767,2023-03-26,208,sprite,75,100,25,2,00490,India
372428,2023-03-26,209,pepsi,75,100,25,2,00469,India
372428,2023-03-26,213,bisleri,6,15,9,2,00469,India
372428,2023-03-26,204,strawberry yogurt,50,60,10,2,00469,India
849211,2023-03-26,201,paneer,210,340,130,1,00460,India
849211,2023-03-26,213,bisleri,6,15,9,2,00460,India
819384,2023-03-26,210,mountain dew,75,100,25,2,00413,India
819384,2023-03-26,205,classic yogurt,45,60,15,2,00413,India
819384,2023-03-26,209,pepsi,75,100,25,2,00413,India
373842,2023-03-26,211,red bull,90,125,35,2,00016,India
373842,2023-03-26,206,yakult,360,400,40,2,00016,India
569444,2023-03-26,208,sprite,75,100,25,2,00305,India
569444,2023-03-26,212,amul cheese,250,315,65,1,00305,India
569444,2023-03-26,207,coca cola,75,100,25,2,00305,India
287735,2023-03-27,211,red bull,90,125,35,2,00368,India
287735,2023-03-27,202,milk,12,27,15,1,00368,India
287735,2023-03-27,210,mountain dew,75,100,25,2,00368,India
664870,2023-03-27,204,strawberry yogurt,50,60,10,2,00077,India
416524,2023-03-27,204,strawberry yogurt,50,60,10,2,00313,India
416524,2023-03-27,213,bisleri,6,15,9,2,00313,India
416524,2023-03-27,208,sprite,75,100,25,2,00313,India
984625,2023-03-27,209,pepsi,75,100,25,2,00240,India
984625,2023-03-27,212,amul cheese,250,315,65,1,00240,India
984625,2023-03-27,213,bisleri,6,15,9,2,00240,India
692220,2023-03-27,211,red bull,90,125,35,2,00332,India
692220,2023-03-27,204,strawberry yogurt,50,60,10,2,00332,India
692220,2023-03-27,207,coca cola,75,100,25,2,00332,India
692220,2023-03-27,201,paneer,210,340,130,1,00332,India
692220,2023-03-27,208,sprite,75,100,25,2,00332,India
353558,2023-03-27,209,pepsi,75,100,25,2,00033,India
353558,2023-03-27,203,mango yogurt,50,60,10,2,00033,India
353558,2023-03-27,202,milk,12,27,15,1,00033,India
353558,2023-03-27,201,paneer,210,340,130,1,00033,India
684371,2023-03-27,213,bisleri,6,15,9,2,00212,India
684371,2023-03-27,204,strawberry yogurt,50,60,10,2,00212,India
684371,2023-03-27,202,milk,12,27,15,1,00212,India
684371,2023-03-27,212,amul cheese,250,315,65,1,00212,India
684371,2023-03-27,209,pepsi,75,100,25,2,00212,India
343932,2023-03-27,204,strawberry yogurt,50,60,10,2,00041,India
343932,2023-03-27,206,yakult,360,400,40,2,00041,India
343932,2023-03-27,212,amul cheese,250,315,65,1,00041,India
762678,2023-03-27,208,sprite,75,100,25,2,00003,India
762678,2023-03-27,210,mountain dew,75,100,25,2,00003,India
762678,2023-03-27,201,paneer,210,340,130,1,00003,India
762678,2023-03-27,205,classic yogurt,45,60,15,2,00003,India
762678,2023-03-27,202,milk,12,27,15,1,00003,India
172470,2023-03-27,208,sprite,75,100,25,2,00423,India
172470,2023-03-27,213,bisleri,6,15,9,2,00423,India
172470,2023-03-27,201,paneer,210,340,130,1,00423,India
172470,2023-03-27,209,pepsi,75,100,25,2,00423,India
111946,2023-03-27,203,mango yogurt,50,60,10,2,00396,India
111946,2023-03-27,204,strawberry yogurt,50,60,10,2,00396,India
111946,2023-03-27,213,bisleri,6,15,9,2,00396,India
111946,2023-03-27,205,classic yogurt,45,60,15,2,00396,India
765982,2023-03-27,208,sprite,75,100,25,2,00279,India
765982,2023-03-27,202,milk,12,27,15,1,00279,India
765982,2023-03-27,201,paneer,210,340,130,1,00279,India
924951,2023-03-27,205,classic yogurt,45,60,15,2,00134,India
924951,2023-03-27,206,yakult,360,400,40,2,00134,India
924951,2023-03-27,210,mountain dew,75,100,25,2,00134,India
975276,2023-03-27,210,mountain dew,75,100,25,2,00107,India
975276,2023-03-27,201,paneer,210,340,130,1,00107,India
237676,2023-03-27,207,coca cola,75,100,25,2,00437,India
237676,2023-03-27,213,bisleri,6,15,9,2,00437,India
812360,2023-03-27,213,bisleri,6,15,9,2,00171,India
812360,2023-03-27,203,mango yogurt,50,60,10,2,00171,India
812360,2023-03-27,206,yakult,360,400,40,2,00171,India
720188,2023-03-27,207,coca cola,75,100,25,2,00178,India
926000,2023-03-27,208,sprite,75,100,25,2,00152,India
926000,2023-03-27,207,coca cola,75,100,25,2,00152,India
926000,2023-03-27,213,bisleri,6,15,9,2,00152,India
926000,2023-03-27,205,classic yogurt,45,60,15,2,00152,India
328520,2023-03-27,202,milk,12,27,15,1,00498,India
516713,2023-03-27,203,mango yogurt,50,60,10,2,00486,India
516713,2023-03-27,213,bisleri,6,15,9,2,00486,India
516713,2023-03-27,210,mountain dew,75,100,25,2,00486,India
516713,2023-03-27,206,yakult,360,400,40,2,00486,India
488014,2023-03-27,213,bisleri,6,15,9,2,00101,India
488014,2023-03-27,203,mango yogurt,50,60,10,2,00101,India
488014,2023-03-27,212,amul cheese,250,315,65,1,00101,India
488014,2023-03-27,209,pepsi,75,100,25,2,00101,India
365884,2023-03-27,203,mango yogurt,50,60,10,2,00444,India
365884,2023-03-27,205,classic yogurt,45,60,15,2,00444,India
365884,2023-03-27,202,milk,12,27,15,1,00444,India
414618,2023-03-27,212,amul cheese,250,315,65,1,00271,India
522492,2023-03-27,203,mango yogurt,50,60,10,2,00081,India
522492,2023-03-27,211,red bull,90,125,35,2,00081,India
522492,2023-03-27,201,paneer,210,340,130,1,00081,India
383287,2023-03-27,209,pepsi,75,100,25,2,00393,India
383287,2023-03-27,201,paneer,210,340,130,1,00393,India
383287,2023-03-27,213,bisleri,6,15,9,2,00393,India
383287,2023-03-27,205,classic yogurt,45,60,15,2,00393,India
607895,2023-03-27,207,coca cola,75,100,25,2,00318,India
607895,2023-03-27,208,sprite,75,100,25,2,00318,India
653412,2023-03-27,208,sprite,75,100,25,2,00266,India
653412,2023-03-27,213,bisleri,6,15,9,2,00266,India
653412,2023-03-27,201,paneer,210,340,130,1,00266,India
653412,2023-03-27,204,strawberry yogurt,50,60,10,2,00266,India
941827,2023-03-27,212,amul cheese,250,315,65,1,00242,India
941827,2023-03-27,201,paneer,210,340,130,1,00242,India
659637,2023-03-27,202,milk,12,27,15,1,00172,India
659637,2023-03-27,210,mountain dew,75,100,25,2,00172,India
854911,2023-03-27,212,amul cheese,250,315,65,1,00455,India
854911,2023-03-27,213,bisleri,6,15,9,2,00455,India
854911,2023-03-27,201,paneer,210,340,130,1,00455,India
711575,2023-03-27,212,amul cheese,250,315,65,1,00343,India
711575,2023-03-27,203,mango yogurt,50,60,10,2,00343,India
178976,2023-03-27,212,amul cheese,250,315,65,1,00430,India
178976,2023-03-27,208,sprite,75,100,25,2,00430,India
178976,2023-03-27,206,yakult,360,400,40,2,00430,India
276444,2023-03-27,206,yakult,360,400,40,2,00159,India
276444,2023-03-27,204,strawberry yogurt,50,60,10,2,00159,India
276444,2023-03-27,205,classic yogurt,45,60,15,2,00159,India
276444,2023-03-27,202,milk,12,27,15,1,00159,India
276444,2023-03-27,210,mountain dew,75,100,25,2,00159,India
749885,2023-03-27,210,mountain dew,75,100,25,2,00387,India
749885,2023-03-27,202,milk,12,27,15,1,00387,India
749885,2023-03-27,206,yakult,360,400,40,2,00387,India
749885,2023-03-27,207,coca cola,75,100,25,2,00387,India
132210,2023-03-27,211,red bull,90,125,35,2,00213,India
132210,2023-03-27,201,paneer,210,340,130,1,00213,India
132210,2023-03-27,209,pepsi,75,100,25,2,00213,India
132210,2023-03-27,205,classic yogurt,45,60,15,2,00213,India
913272,2023-03-27,209,pepsi,75,100,25,2,00019,India
913272,2023-03-27,208,sprite,75,100,25,2,00019,India
913272,2023-03-27,203,mango yogurt,50,60,10,2,00019,India
707983,2023-03-27,204,strawberry yogurt,50,60,10,2,00285,India
707983,2023-03-27,213,bisleri,6,15,9,2,00285,India
352171,2023-03-27,207,coca cola,75,100,25,2,00114,India
352171,2023-03-27,209,pepsi,75,100,25,2,00114,India
352171,2023-03-27,212,amul cheese,250,315,65,1,00114,India
313056,2023-03-27,204,strawberry yogurt,50,60,10,2,00160,India
313056,2023-03-27,209,pepsi,75,100,25,2,00160,India
313056,2023-03-27,211,red bull,90,125,35,2,00160,India
313056,2023-03-27,207,coca cola,75,100,25,2,00160,India
636985,2023-03-27,205,classic yogurt,45,60,15,2,00408,India
957039,2023-03-27,202,milk,12,27,15,1,00063,India
957039,2023-03-27,207,coca cola,75,100,25,2,00063,India
957039,2023-03-27,210,mountain dew,75,100,25,2,00063,India
957039,2023-03-27,206,yakult,360,400,40,2,00063,India
939389,2023-03-27,208,sprite,75,100,25,2,00441,India
939389,2023-03-27,207,coca cola,75,100,25,2,00441,India
939389,2023-03-27,206,yakult,360,400,40,2,00441,India
239980,2023-03-27,202,milk,12,27,15,1,00223,India
239980,2023-03-27,201,paneer,210,340,130,1,00223,India
239980,2023-03-27,212,amul cheese,250,315,65,1,00223,India
239980,2023-03-27,208,sprite,75,100,25,2,00223,India
163964,2023-03-27,203,mango yogurt,50,60,10,2,00487,India
163964,2023-03-27,206,yakult,360,400,40,2,00487,India
163964,2023-03-27,210,mountain dew,75,100,25,2,00487,India
163964,2023-03-27,208,sprite,75,100,25,2,00487,India
163964,2023-03-27,201,paneer,210,340,130,1,00487,India
636295,2023-03-27,207,coca cola,75,100,25,2,00147,India
650612,2023-03-27,208,sprite,75,100,25,2,00394,India
650612,2023-03-27,212,amul cheese,250,315,65,1,00394,India
650612,2023-03-27,204,strawberry yogurt,50,60,10,2,00394,India
650612,2023-03-27,202,milk,12,27,15,1,00394,India
192883,2023-03-27,213,bisleri,6,15,9,2,00042,India
192883,2023-03-27,204,strawberry yogurt,50,60,10,2,00042,India
737802,2023-03-27,212,amul cheese,250,315,65,1,00293,India
633928,2023-03-27,202,milk,12,27,15,1,00451,India
633928,2023-03-27,213,bisleri,6,15,9,2,00451,India
633928,2023-03-27,210,mountain dew,75,100,25,2,00451,India
377131,2023-03-27,203,mango yogurt,50,60,10,2,00227,India
377131,2023-03-27,210,mountain dew,75,100,25,2,00227,India
377131,2023-03-27,208,sprite,75,100,25,2,00227,India
640774,2023-03-27,205,classic yogurt,45,60,15,2,00123,India
640774,2023-03-27,211,red bull,90,125,35,2,00123,India
640774,2023-03-27,201,paneer,210,340,130,1,00123,India
640774,2023-03-27,202,milk,12,27,15,1,00123,India
654629,2023-03-27,203,mango yogurt,50,60,10,2,00057,India
654629,2023-03-27,210,mountain dew,75,100,25,2,00057,India
850902,2023-03-27,203,mango yogurt,50,60,10,2,00252,India
850902,2023-03-27,209,pepsi,75,100,25,2,00252,India
850902,2023-03-27,202,milk,12,27,15,1,00252,India
639006,2023-03-27,209,pepsi,75,100,25,2,00034,India
639006,2023-03-27,212,amul cheese,250,315,65,1,00034,India
639006,2023-03-27,203,mango yogurt,50,60,10,2,00034,India
639006,2023-03-27,213,bisleri,6,15,9,2,00034,India
639006,2023-03-27,202,milk,12,27,15,1,00034,India
392868,2023-03-27,202,milk,12,27,15,1,00425,India
392868,2023-03-27,212,amul cheese,250,315,65,1,00425,India
392868,2023-03-27,201,paneer,210,340,130,1,00425,India
392868,2023-03-27,213,bisleri,6,15,9,2,00425,India
285625,2023-03-27,208,sprite,75,100,25,2,00277,India
285625,2023-03-27,211,red bull,90,125,35,2,00277,India
769793,2023-03-27,205,classic yogurt,45,60,15,2,00440,India
769793,2023-03-27,204,strawberry yogurt,50,60,10,2,00440,India
992249,2023-03-27,204,strawberry yogurt,50,60,10,2,00476,India
992249,2023-03-27,212,amul cheese,250,315,65,1,00476,India
558187,2023-03-27,212,amul cheese,250,315,65,1,00436,India
558187,2023-03-27,208,sprite,75,100,25,2,00436,India
558187,2023-03-27,203,mango yogurt,50,60,10,2,00436,India
258705,2023-03-27,210,mountain dew,75,100,25,2,00485,India
258705,2023-03-27,205,classic yogurt,45,60,15,2,00485,India
990577,2023-03-27,202,milk,12,27,15,1,00310,India
406094,2023-03-27,201,paneer,210,340,130,1,00025,India
406094,2023-03-27,208,sprite,75,100,25,2,00025,India
481732,2023-03-27,212,amul cheese,250,315,65,1,00377,India
481732,2023-03-27,209,pepsi,75,100,25,2,00377,India
129020,2023-03-27,201,paneer,210,340,130,1,00132,India
129020,2023-03-27,207,coca cola,75,100,25,2,00132,India
618831,2023-03-27,202,milk,12,27,15,1,00292,India
618831,2023-03-27,201,paneer,210,340,130,1,00292,India
618831,2023-03-27,205,classic yogurt,45,60,15,2,00292,India
618831,2023-03-27,206,yakult,360,400,40,2,00292,India
722875,2023-03-27,204,strawberry yogurt,50,60,10,2,00033,India
722875,2023-03-27,206,yakult,360,400,40,2,00033,India
722875,2023-03-27,210,mountain dew,75,100,25,2,00033,India
722875,2023-03-27,208,sprite,75,100,25,2,00033,India
507996,2023-03-27,203,mango yogurt,50,60,10,2,00350,India
980571,2023-03-27,202,milk,12,27,15,1,00063,India
980571,2023-03-27,205,classic yogurt,45,60,15,2,00063,India
661080,2023-03-27,205,classic yogurt,45,60,15,2,00225,India
661080,2023-03-27,201,paneer,210,340,130,1,00225,India
661080,2023-03-27,202,milk,12,27,15,1,00225,India
457457,2023-03-27,210,mountain dew,75,100,25,2,00177,India
457457,2023-03-27,211,red bull,90,125,35,2,00177,India
457457,2023-03-27,209,pepsi,75,100,25,2,00177,India
457457,2023-03-27,213,bisleri,6,15,9,2,00177,India
457457,2023-03-27,206,yakult,360,400,40,2,00177,India
544269,2023-03-27,205,classic yogurt,45,60,15,2,00163,India
767994,2023-03-27,211,red bull,90,125,35,2,00276,India
767994,2023-03-27,205,classic yogurt,45,60,15,2,00276,India
388753,2023-03-27,210,mountain dew,75,100,25,2,00245,India
388753,2023-03-27,201,paneer,210,340,130,1,00245,India
886788,2023-03-27,205,classic yogurt,45,60,15,2,00455,India
886788,2023-03-27,203,mango yogurt,50,60,10,2,00455,India
886788,2023-03-27,206,yakult,360,400,40,2,00455,India
515122,2023-03-27,206,yakult,360,400,40,2,00028,India
515122,2023-03-27,209,pepsi,75,100,25,2,00028,India
515122,2023-03-27,204,strawberry yogurt,50,60,10,2,00028,India
956665,2023-03-27,213,bisleri,6,15,9,2,00057,India
956665,2023-03-27,211,red bull,90,125,35,2,00057,India
956665,2023-03-27,201,paneer,210,340,130,1,00057,India
186646,2023-03-27,206,yakult,360,400,40,2,00279,India
816012,2023-03-27,206,yakult,360,400,40,2,00171,India
816012,2023-03-27,203,mango yogurt,50,60,10,2,00171,India
920046,2023-03-27,204,strawberry yogurt,50,60,10,2,00214,India
920046,2023-03-27,202,milk,12,27,15,1,00214,India
920046,2023-03-27,212,amul cheese,250,315,65,1,00214,India
920046,2023-03-27,205,classic yogurt,45,60,15,2,00214,India
462713,2023-03-27,210,mountain dew,75,100,25,2,00017,India
302108,2023-03-27,213,bisleri,6,15,9,2,00080,India
302108,2023-03-27,211,red bull,90,125,35,2,00080,India
302108,2023-03-27,210,mountain dew,75,100,25,2,00080,India
134574,2023-03-27,203,mango yogurt,50,60,10,2,00259,India
327842,2023-03-27,201,paneer,210,340,130,1,00313,India
161475,2023-03-27,211,red bull,90,125,35,2,00411,India
714891,2023-03-27,213,bisleri,6,15,9,2,00170,India
714891,2023-03-27,209,pepsi,75,100,25,2,00170,India
714891,2023-03-27,211,red bull,90,125,35,2,00170,India
428576,2023-03-28,210,mountain dew,75,100,25,2,00407,India
428576,2023-03-28,201,paneer,210,340,130,1,00407,India
428576,2023-03-28,206,yakult,360,400,40,2,00407,India
428576,2023-03-28,204,strawberry yogurt,50,60,10,2,00407,India
119350,2023-03-28,210,mountain dew,75,100,25,2,00148,India
119350,2023-03-28,204,strawberry yogurt,50,60,10,2,00148,India
865181,2023-03-28,203,mango yogurt,50,60,10,2,00262,India
865181,2023-03-28,211,red bull,90,125,35,2,00262,India
865181,2023-03-28,210,mountain dew,75,100,25,2,00262,India
865181,2023-03-28,204,strawberry yogurt,50,60,10,2,00262,India
763439,2023-03-28,205,classic yogurt,45,60,15,2,00002,India
934126,2023-03-28,213,bisleri,6,15,9,2,00153,India
934126,2023-03-28,201,paneer,210,340,130,1,00153,India
292993,2023-03-28,208,sprite,75,100,25,2,00410,India
292993,2023-03-28,207,coca cola,75,100,25,2,00410,India
292993,2023-03-28,201,paneer,210,340,130,1,00410,India
412369,2023-03-28,204,strawberry yogurt,50,60,10,2,00129,India
412369,2023-03-28,203,mango yogurt,50,60,10,2,00129,India
162167,2023-03-28,208,sprite,75,100,25,2,00293,India
162167,2023-03-28,206,yakult,360,400,40,2,00293,India
162167,2023-03-28,203,mango yogurt,50,60,10,2,00293,India
162167,2023-03-28,204,strawberry yogurt,50,60,10,2,00293,India
733846,2023-03-28,207,coca cola,75,100,25,2,00499,India
482525,2023-03-28,209,pepsi,75,100,25,2,00201,India
793821,2023-03-28,205,classic yogurt,45,60,15,2,00202,India
793821,2023-03-28,213,bisleri,6,15,9,2,00202,India
793821,2023-03-28,203,mango yogurt,50,60,10,2,00202,India
791745,2023-03-28,204,strawberry yogurt,50,60,10,2,00168,India
791745,2023-03-28,203,mango yogurt,50,60,10,2,00168,India
229518,2023-03-28,204,strawberry yogurt,50,60,10,2,00261,India
229518,2023-03-28,210,mountain dew,75,100,25,2,00261,India
229518,2023-03-28,209,pepsi,75,100,25,2,00261,India
610067,2023-03-28,205,classic yogurt,45,60,15,2,00044,India
610067,2023-03-28,202,milk,12,27,15,1,00044,India
610067,2023-03-28,211,red bull,90,125,35,2,00044,India
610067,2023-03-28,212,amul cheese,250,315,65,1,00044,India
590468,2023-03-28,212,amul cheese,250,315,65,1,00021,India
590468,2023-03-28,205,classic yogurt,45,60,15,2,00021,India
590468,2023-03-28,204,strawberry yogurt,50,60,10,2,00021,India
244772,2023-03-28,205,classic yogurt,45,60,15,2,00442,India
244772,2023-03-28,201,paneer,210,340,130,1,00442,India
722454,2023-03-28,210,mountain dew,75,100,25,2,00475,India
722454,2023-03-28,206,yakult,360,400,40,2,00475,India
878481,2023-03-28,209,pepsi,75,100,25,2,00417,India
878481,2023-03-28,201,paneer,210,340,130,1,00417,India
878481,2023-03-28,202,milk,12,27,15,1,00417,India
674745,2023-03-28,213,bisleri,6,15,9,2,00282,India
357769,2023-03-28,205,classic yogurt,45,60,15,2,00091,India
357769,2023-03-28,207,coca cola,75,100,25,2,00091,India
725602,2023-03-28,206,yakult,360,400,40,2,00263,India
725602,2023-03-28,204,strawberry yogurt,50,60,10,2,00263,India
725602,2023-03-28,201,paneer,210,340,130,1,00263,India
462924,2023-03-28,203,mango yogurt,50,60,10,2,00293,India
711805,2023-03-28,210,mountain dew,75,100,25,2,00314,India
711805,2023-03-28,204,strawberry yogurt,50,60,10,2,00314,India
711805,2023-03-28,209,pepsi,75,100,25,2,00314,India
711805,2023-03-28,211,red bull,90,125,35,2,00314,India
941247,2023-03-28,201,paneer,210,340,130,1,00284,India
941247,2023-03-28,204,strawberry yogurt,50,60,10,2,00284,India
941247,2023-03-28,210,mountain dew,75,100,25,2,00284,India
941247,2023-03-28,202,milk,12,27,15,1,00284,India
941247,2023-03-28,206,yakult,360,400,40,2,00284,India
361668,2023-03-28,211,red bull,90,125,35,2,00170,India
361668,2023-03-28,213,bisleri,6,15,9,2,00170,India
266806,2023-03-28,208,sprite,75,100,25,2,00299,India
266806,2023-03-28,209,pepsi,75,100,25,2,00299,India
266806,2023-03-28,201,paneer,210,340,130,1,00299,India
361969,2023-03-28,208,sprite,75,100,25,2,00426,India
361969,2023-03-28,204,strawberry yogurt,50,60,10,2,00426,India
987796,2023-03-28,204,strawberry yogurt,50,60,10,2,00478,India
987796,2023-03-28,201,paneer,210,340,130,1,00478,India
987796,2023-03-28,210,mountain dew,75,100,25,2,00478,India
896159,2023-03-28,203,mango yogurt,50,60,10,2,00389,India
896159,2023-03-28,206,yakult,360,400,40,2,00389,India
652551,2023-03-28,204,strawberry yogurt,50,60,10,2,00315,India
588185,2023-03-28,206,yakult,360,400,40,2,00247,India
588185,2023-03-28,204,strawberry yogurt,50,60,10,2,00247,India
588185,2023-03-28,208,sprite,75,100,25,2,00247,India
588185,2023-03-28,211,red bull,90,125,35,2,00247,India
588185,2023-03-28,212,amul cheese,250,315,65,1,00247,India
351533,2023-03-28,204,strawberry yogurt,50,60,10,2,00046,India
351533,2023-03-28,212,amul cheese,250,315,65,1,00046,India
123451,2023-03-28,213,bisleri,6,15,9,2,00279,India
123451,2023-03-28,205,classic yogurt,45,60,15,2,00279,India
123451,2023-03-28,206,yakult,360,400,40,2,00279,India
123451,2023-03-28,201,paneer,210,340,130,1,00279,India
644272,2023-03-28,208,sprite,75,100,25,2,00060,India
644272,2023-03-28,211,red bull,90,125,35,2,00060,India
822301,2023-03-28,213,bisleri,6,15,9,2,00385,India
812770,2023-03-28,204,strawberry yogurt,50,60,10,2,00261,India
812770,2023-03-28,208,sprite,75,100,25,2,00261,India
812770,2023-03-28,212,amul cheese,250,315,65,1,00261,India
812770,2023-03-28,203,mango yogurt,50,60,10,2,00261,India
701895,2023-03-28,201,paneer,210,340,130,1,00457,India
701895,2023-03-28,204,strawberry yogurt,50,60,10,2,00457,India
701895,2023-03-28,205,classic yogurt,45,60,15,2,00457,India
701895,2023-03-28,212,amul cheese,250,315,65,1,00457,India
701895,2023-03-28,206,yakult,360,400,40,2,00457,India
416134,2023-03-28,212,amul cheese,250,315,65,1,00476,India
416134,2023-03-28,210,mountain dew,75,100,25,2,00476,India
416134,2023-03-28,201,paneer,210,340,130,1,00476,India
416134,2023-03-28,205,classic yogurt,45,60,15,2,00476,India
416134,2023-03-28,211,red bull,90,125,35,2,00476,India
805406,2023-03-28,213,bisleri,6,15,9,2,00148,India
805406,2023-03-28,202,milk,12,27,15,1,00148,India
805406,2023-03-28,203,mango yogurt,50,60,10,2,00148,India
805406,2023-03-28,209,pepsi,75,100,25,2,00148,India
722782,2023-03-28,207,coca cola,75,100,25,2,00003,India
722782,2023-03-28,210,mountain dew,75,100,25,2,00003,India
840971,2023-03-28,204,strawberry yogurt,50,60,10,2,00397,India
840971,2023-03-28,201,paneer,210,340,130,1,00397,India
317368,2023-03-28,205,classic yogurt,45,60,15,2,00172,India
317368,2023-03-28,210,mountain dew,75,100,25,2,00172,India
317368,2023-03-28,213,bisleri,6,15,9,2,00172,India
317368,2023-03-28,206,yakult,360,400,40,2,00172,India
689879,2023-03-28,212,amul cheese,250,315,65,1,00009,India
689879,2023-03-28,211,red bull,90,125,35,2,00009,India
518397,2023-03-28,213,bisleri,6,15,9,2,00336,India
518397,2023-03-28,210,mountain dew,75,100,25,2,00336,India
518397,2023-03-28,212,amul cheese,250,315,65,1,00336,India
518397,2023-03-28,202,milk,12,27,15,1,00336,India
721638,2023-03-28,207,coca cola,75,100,25,2,00245,India
721638,2023-03-28,204,strawberry yogurt,50,60,10,2,00245,India
721638,2023-03-28,202,milk,12,27,15,1,00245,India
988101,2023-03-28,211,red bull,90,125,35,2,00420,India
492406,2023-03-28,205,classic yogurt,45,60,15,2,00154,India
492406,2023-03-28,212,amul cheese,250,315,65,1,00154,India
492406,2023-03-28,207,coca cola,75,100,25,2,00154,India
377208,2023-03-28,205,classic yogurt,45,60,15,2,00214,India
106446,2023-03-28,211,red bull,90,125,35,2,00177,India
106446,2023-03-28,213,bisleri,6,15,9,2,00177,India
106446,2023-03-28,205,classic yogurt,45,60,15,2,00177,India
846968,2023-03-28,209,pepsi,75,100,25,2,00113,India
322960,2023-03-28,210,mountain dew,75,100,25,2,00401,India
322960,2023-03-28,206,yakult,360,400,40,2,00401,India
322960,2023-03-28,203,mango yogurt,50,60,10,2,00401,India
813374,2023-03-28,206,yakult,360,400,40,2,00042,India
813374,2023-03-28,202,milk,12,27,15,1,00042,India
235295,2023-03-28,203,mango yogurt,50,60,10,2,00305,India
235295,2023-03-28,208,sprite,75,100,25,2,00305,India
235295,2023-03-28,209,pepsi,75,100,25,2,00305,India
235295,2023-03-28,210,mountain dew,75,100,25,2,00305,India
892342,2023-03-28,206,yakult,360,400,40,2,00299,India
892342,2023-03-28,207,coca cola,75,100,25,2,00299,India
892342,2023-03-28,203,mango yogurt,50,60,10,2,00299,India
453813,2023-03-28,207,coca cola,75,100,25,2,00050,India
453813,2023-03-28,203,mango yogurt,50,60,10,2,00050,India
417278,2023-03-28,206,yakult,360,400,40,2,00325,India
417278,2023-03-28,203,mango yogurt,50,60,10,2,00325,India
638613,2023-03-28,207,coca cola,75,100,25,2,00398,India
638613,2023-03-28,201,paneer,210,340,130,1,00398,India
638613,2023-03-28,205,classic yogurt,45,60,15,2,00398,India
638613,2023-03-28,204,strawberry yogurt,50,60,10,2,00398,India
461399,2023-03-28,203,mango yogurt,50,60,10,2,00020,India
461399,2023-03-28,207,coca cola,75,100,25,2,00020,India
461399,2023-03-28,205,classic yogurt,45,60,15,2,00020,India
461399,2023-03-28,210,mountain dew,75,100,25,2,00020,India
492541,2023-03-28,201,paneer,210,340,130,1,00078,India
492541,2023-03-28,210,mountain dew,75,100,25,2,00078,India
492541,2023-03-28,209,pepsi,75,100,25,2,00078,India
492541,2023-03-28,204,strawberry yogurt,50,60,10,2,00078,India
794252,2023-03-28,206,yakult,360,400,40,2,00467,India
794252,2023-03-28,207,coca cola,75,100,25,2,00467,India
794252,2023-03-28,213,bisleri,6,15,9,2,00467,India
288087,2023-03-28,207,coca cola,75,100,25,2,00191,India
288087,2023-03-28,203,mango yogurt,50,60,10,2,00191,India
315394,2023-03-28,206,yakult,360,400,40,2,00243,India
315394,2023-03-28,203,mango yogurt,50,60,10,2,00243,India
315394,2023-03-28,201,paneer,210,340,130,1,00243,India
315394,2023-03-28,211,red bull,90,125,35,2,00243,India
315394,2023-03-28,213,bisleri,6,15,9,2,00243,India
630461,2023-03-28,201,paneer,210,340,130,1,00477,India
340470,2023-03-28,211,red bull,90,125,35,2,00168,India
340470,2023-03-28,209,pepsi,75,100,25,2,00168,India
340470,2023-03-28,202,milk,12,27,15,1,00168,India
340470,2023-03-28,206,yakult,360,400,40,2,00168,India
368891,2023-03-28,210,mountain dew,75,100,25,2,00174,India
368891,2023-03-28,204,strawberry yogurt,50,60,10,2,00174,India
368891,2023-03-28,211,red bull,90,125,35,2,00174,India
368891,2023-03-28,208,sprite,75,100,25,2,00174,India
116866,2023-03-28,205,classic yogurt,45,60,15,2,00026,India
116866,2023-03-28,206,yakult,360,400,40,2,00026,India
116866,2023-03-28,211,red bull,90,125,35,2,00026,India
116866,2023-03-28,212,amul cheese,250,315,65,1,00026,India
116866,2023-03-28,210,mountain dew,75,100,25,2,00026,India
325506,2023-03-28,207,coca cola,75,100,25,2,00368,India
325506,2023-03-28,202,milk,12,27,15,1,00368,India
381870,2023-03-28,204,strawberry yogurt,50,60,10,2,00163,India
381870,2023-03-28,206,yakult,360,400,40,2,00163,India
381870,2023-03-28,210,mountain dew,75,100,25,2,00163,India
381870,2023-03-28,203,mango yogurt,50,60,10,2,00163,India
381870,2023-03-28,207,coca cola,75,100,25,2,00163,India
416720,2023-03-28,213,bisleri,6,15,9,2,00047,India
416720,2023-03-28,207,coca cola,75,100,25,2,00047,India
190807,2023-03-28,209,pepsi,75,100,25,2,00300,India
731357,2023-03-28,208,sprite,75,100,25,2,00083,India
731357,2023-03-28,202,milk,12,27,15,1,00083,India
352037,2023-03-28,209,pepsi,75,100,25,2,00276,India
352037,2023-03-28,201,paneer,210,340,130,1,00276,India
861815,2023-03-28,207,coca cola,75,100,25,2,00008,India
861815,2023-03-28,201,paneer,210,340,130,1,00008,India
930310,2023-03-28,213,bisleri,6,15,9,2,00019,India
930310,2023-03-28,207,coca cola,75,100,25,2,00019,India
930310,2023-03-28,205,classic yogurt,45,60,15,2,00019,India
511462,2023-03-28,207,coca cola,75,100,25,2,00450,India
511462,2023-03-28,210,mountain dew,75,100,25,2,00450,India
461704,2023-03-28,202,milk,12,27,15,1,00389,India
461704,2023-03-28,207,coca cola,75,100,25,2,00389,India
461704,2023-03-28,208,sprite,75,100,25,2,00389,India
161612,2023-03-28,204,strawberry yogurt,50,60,10,2,00266,India
161612,2023-03-28,201,paneer,210,340,130,1,00266,India
161612,2023-03-28,210,mountain dew,75,100,25,2,00266,India
716511,2023-03-28,205,classic yogurt,45,60,15,2,00104,India
716511,2023-03-28,210,mountain dew,75,100,25,2,00104,India
716511,2023-03-28,207,coca cola,75,100,25,2,00104,India
507906,2023-03-28,213,bisleri,6,15,9,2,00174,India
507906,2023-03-28,210,mountain dew,75,100,25,2,00174,India
729544,2023-03-28,208,sprite,75,100,25,2,00191,India
729544,2023-03-28,211,red bull,90,125,35,2,00191,India
594232,2023-03-28,204,strawberry yogurt,50,60,10,2,00026,India
594232,2023-03-28,208,sprite,75,100,25,2,00026,India
594232,2023-03-28,211,red bull,90,125,35,2,00026,India
594232,2023-03-28,210,mountain dew,75,100,25,2,00026,India
918973,2023-03-28,210,mountain dew,75,100,25,2,00456,India
999911,2023-03-28,203,mango yogurt,50,60,10,2,00154,India
690867,2023-03-28,204,strawberry yogurt,50,60,10,2,00438,India
690867,2023-03-28,205,classic yogurt,45,60,15,2,00438,India
690867,2023-03-28,206,yakult,360,400,40,2,00438,India
690867,2023-03-28,210,mountain dew,75,100,25,2,00438,India
494550,2023-03-28,211,red bull,90,125,35,2,00160,India
494550,2023-03-28,210,mountain dew,75,100,25,2,00160,India
494550,2023-03-28,203,mango yogurt,50,60,10,2,00160,India
494550,2023-03-28,201,paneer,210,340,130,1,00160,India
194925,2023-03-28,208,sprite,75,100,25,2,00445,India
194925,2023-03-28,201,paneer,210,340,130,1,00445,India
194925,2023-03-28,202,milk,12,27,15,1,00445,India
330489,2023-03-28,213,bisleri,6,15,9,2,00011,India
330489,2023-03-28,212,amul cheese,250,315,65,1,00011,India
330489,2023-03-28,204,strawberry yogurt,50,60,10,2,00011,India
330489,2023-03-28,209,pepsi,75,100,25,2,00011,India
476293,2023-03-28,209,pepsi,75,100,25,2,00439,India
476293,2023-03-28,201,paneer,210,340,130,1,00439,India
476293,2023-03-28,207,coca cola,75,100,25,2,00439,India
954058,2023-03-28,211,red bull,90,125,35,2,00176,India
954058,2023-03-28,203,mango yogurt,50,60,10,2,00176,India
954058,2023-03-28,212,amul cheese,250,315,65,1,00176,India
725564,2023-03-28,209,pepsi,75,100,25,2,00408,India
725564,2023-03-28,213,bisleri,6,15,9,2,00408,India
670519,2023-03-28,203,mango yogurt,50,60,10,2,00115,India
850955,2023-03-29,211,red bull,90,125,35,2,00412,India
850955,2023-03-29,210,mountain dew,75,100,25,2,00412,India
850955,2023-03-29,206,yakult,360,400,40,2,00412,India
850955,2023-03-29,205,classic yogurt,45,60,15,2,00412,India
898849,2023-03-29,212,amul cheese,250,315,65,1,00359,India
898849,2023-03-29,208,sprite,75,100,25,2,00359,India
898849,2023-03-29,207,coca cola,75,100,25,2,00359,India
898849,2023-03-29,201,paneer,210,340,130,1,00359,India
898849,2023-03-29,211,red bull,90,125,35,2,00359,India
246962,2023-03-29,205,classic yogurt,45,60,15,2,00027,India
246962,2023-03-29,204,strawberry yogurt,50,60,10,2,00027,India
246962,2023-03-29,210,mountain dew,75,100,25,2,00027,India
246962,2023-03-29,208,sprite,75,100,25,2,00027,India
246962,2023-03-29,211,red bull,90,125,35,2,00027,India
784062,2023-03-29,211,red bull,90,125,35,2,00452,India
784062,2023-03-29,205,classic yogurt,45,60,15,2,00452,India
784062,2023-03-29,203,mango yogurt,50,60,10,2,00452,India
784062,2023-03-29,206,yakult,360,400,40,2,00452,India
397594,2023-03-29,210,mountain dew,75,100,25,2,00405,India
397594,2023-03-29,208,sprite,75,100,25,2,00405,India
397594,2023-03-29,203,mango yogurt,50,60,10,2,00405,India
579495,2023-03-29,207,coca cola,75,100,25,2,00278,India
579495,2023-03-29,201,paneer,210,340,130,1,00278,India
579495,2023-03-29,203,mango yogurt,50,60,10,2,00278,India
443632,2023-03-29,207,coca cola,75,100,25,2,00155,India
443632,2023-03-29,209,pepsi,75,100,25,2,00155,India
909808,2023-03-29,201,paneer,210,340,130,1,00278,India
909808,2023-03-29,207,coca cola,75,100,25,2,00278,India
909808,2023-03-29,202,milk,12,27,15,1,00278,India
951375,2023-03-29,207,coca cola,75,100,25,2,00079,India
951375,2023-03-29,209,pepsi,75,100,25,2,00079,India
951375,2023-03-29,205,classic yogurt,45,60,15,2,00079,India
753885,2023-03-29,205,classic yogurt,45,60,15,2,00357,India
753885,2023-03-29,213,bisleri,6,15,9,2,00357,India
753885,2023-03-29,209,pepsi,75,100,25,2,00357,India
753885,2023-03-29,212,amul cheese,250,315,65,1,00357,India
983162,2023-03-29,208,sprite,75,100,25,2,00240,India
983162,2023-03-29,206,yakult,360,400,40,2,00240,India
983162,2023-03-29,207,coca cola,75,100,25,2,00240,India
129000,2023-03-29,207,coca cola,75,100,25,2,00242,India
129000,2023-03-29,203,mango yogurt,50,60,10,2,00242,India
129000,2023-03-29,201,paneer,210,340,130,1,00242,India
129000,2023-03-29,213,bisleri,6,15,9,2,00242,India
554062,2023-03-29,210,mountain dew,75,100,25,2,00042,India
554062,2023-03-29,206,yakult,360,400,40,2,00042,India
134026,2023-03-29,212,amul cheese,250,315,65,1,00064,India
207351,2023-03-29,201,paneer,210,340,130,1,00458,India
207351,2023-03-29,207,coca cola,75,100,25,2,00458,India
207351,2023-03-29,208,sprite,75,100,25,2,00458,India
207351,2023-03-29,202,milk,12,27,15,1,00458,India
669893,2023-03-29,211,red bull,90,125,35,2,00490,India
669893,2023-03-29,203,mango yogurt,50,60,10,2,00490,India
669893,2023-03-29,202,milk,12,27,15,1,00490,India
164789,2023-03-29,211,red bull,90,125,35,2,00364,India
133721,2023-03-29,206,yakult,360,400,40,2,00451,India
585575,2023-03-29,205,classic yogurt,45,60,15,2,00114,India
585575,2023-03-29,207,coca cola,75,100,25,2,00114,India
904308,2023-03-29,203,mango yogurt,50,60,10,2,00481,India
904308,2023-03-29,206,yakult,360,400,40,2,00481,India
495770,2023-03-29,202,milk,12,27,15,1,00100,India
670755,2023-03-29,203,mango yogurt,50,60,10,2,00304,India
670755,2023-03-29,209,pepsi,75,100,25,2,00304,India
380457,2023-03-29,212,amul cheese,250,315,65,1,00118,India
380457,2023-03-29,209,pepsi,75,100,25,2,00118,India
254479,2023-03-29,202,milk,12,27,15,1,00152,India
254479,2023-03-29,208,sprite,75,100,25,2,00152,India
135267,2023-03-29,206,yakult,360,400,40,2,00042,India
135267,2023-03-29,207,coca cola,75,100,25,2,00042,India
880067,2023-03-29,207,coca cola,75,100,25,2,00461,India
880067,2023-03-29,204,strawberry yogurt,50,60,10,2,00461,India
138347,2023-03-29,205,classic yogurt,45,60,15,2,00120,India
138347,2023-03-29,202,milk,12,27,15,1,00120,India
138347,2023-03-29,212,amul cheese,250,315,65,1,00120,India
335095,2023-03-29,202,milk,12,27,15,1,00417,India
335095,2023-03-29,206,yakult,360,400,40,2,00417,India
335095,2023-03-29,213,bisleri,6,15,9,2,00417,India
335095,2023-03-29,203,mango yogurt,50,60,10,2,00417,India
335095,2023-03-29,207,coca cola,75,100,25,2,00417,India
892923,2023-03-29,213,bisleri,6,15,9,2,00498,India
892923,2023-03-29,211,red bull,90,125,35,2,00498,India
176657,2023-03-29,202,milk,12,27,15,1,00351,India
176657,2023-03-29,208,sprite,75,100,25,2,00351,India
176657,2023-03-29,209,pepsi,75,100,25,2,00351,India
176657,2023-03-29,213,bisleri,6,15,9,2,00351,India
572374,2023-03-29,211,red bull,90,125,35,2,00082,India
572374,2023-03-29,204,strawberry yogurt,50,60,10,2,00082,India
572374,2023-03-29,202,milk,12,27,15,1,00082,India
410069,2023-03-29,213,bisleri,6,15,9,2,00301,India
410069,2023-03-29,205,classic yogurt,45,60,15,2,00301,India
165391,2023-03-29,201,paneer,210,340,130,1,00271,India
165391,2023-03-29,206,yakult,360,400,40,2,00271,India
165391,2023-03-29,210,mountain dew,75,100,25,2,00271,India
793085,2023-03-29,207,coca cola,75,100,25,2,00320,India
601295,2023-03-29,204,strawberry yogurt,50,60,10,2,00152,India
601295,2023-03-29,206,yakult,360,400,40,2,00152,India
601295,2023-03-29,207,coca cola,75,100,25,2,00152,India
621205,2023-03-29,206,yakult,360,400,40,2,00357,India
621205,2023-03-29,208,sprite,75,100,25,2,00357,India
621205,2023-03-29,209,pepsi,75,100,25,2,00357,India
621205,2023-03-29,205,classic yogurt,45,60,15,2,00357,India
535415,2023-03-29,213,bisleri,6,15,9,2,00084,India
535415,2023-03-29,209,pepsi,75,100,25,2,00084,India
535415,2023-03-29,208,sprite,75,100,25,2,00084,India
535415,2023-03-29,212,amul cheese,250,315,65,1,00084,India
792559,2023-03-29,203,mango yogurt,50,60,10,2,00452,India
703034,2023-03-29,205,classic yogurt,45,60,15,2,00337,India
703034,2023-03-29,209,pepsi,75,100,25,2,00337,India
398166,2023-03-29,206,yakult,360,400,40,2,00134,India
398166,2023-03-29,208,sprite,75,100,25,2,00134,India
398166,2023-03-29,201,paneer,210,340,130,1,00134,India
398166,2023-03-29,209,pepsi,75,100,25,2,00134,India
398166,2023-03-29,207,coca cola,75,100,25,2,00134,India
358107,2023-03-29,205,classic yogurt,45,60,15,2,00446,India
358107,2023-03-29,209,pepsi,75,100,25,2,00446,India
358107,2023-03-29,204,strawberry yogurt,50,60,10,2,00446,India
358107,2023-03-29,201,paneer,210,340,130,1,00446,India
602866,2023-03-29,209,pepsi,75,100,25,2,00242,India
602866,2023-03-29,211,red bull,90,125,35,2,00242,India
602866,2023-03-29,205,classic yogurt,45,60,15,2,00242,India
336394,2023-03-29,207,coca cola,75,100,25,2,00181,India
336394,2023-03-29,210,mountain dew,75,100,25,2,00181,India
546960,2023-03-29,203,mango yogurt,50,60,10,2,00373,India
546960,2023-03-29,209,pepsi,75,100,25,2,00373,India
546960,2023-03-29,212,amul cheese,250,315,65,1,00373,India
546960,2023-03-29,208,sprite,75,100,25,2,00373,India
546960,2023-03-29,204,strawberry yogurt,50,60,10,2,00373,India
966820,2023-03-29,202,milk,12,27,15,1,00283,India
140223,2023-03-29,211,red bull,90,125,35,2,00215,India
140223,2023-03-29,208,sprite,75,100,25,2,00215,India
140223,2023-03-29,206,yakult,360,400,40,2,00215,India
140223,2023-03-29,207,coca cola,75,100,25,2,00215,India
140223,2023-03-29,203,mango yogurt,50,60,10,2,00215,India
439746,2023-03-29,211,red bull,90,125,35,2,00038,India
321858,2023-03-29,208,sprite,75,100,25,2,00500,India
556223,2023-03-29,208,sprite,75,100,25,2,00483,India
556223,2023-03-29,203,mango yogurt,50,60,10,2,00483,India
556223,2023-03-29,202,milk,12,27,15,1,00483,India
556223,2023-03-29,205,classic yogurt,45,60,15,2,00483,India
386652,2023-03-29,213,bisleri,6,15,9,2,00155,India
386652,2023-03-29,208,sprite,75,100,25,2,00155,India
386652,2023-03-29,202,milk,12,27,15,1,00155,India
226888,2023-03-29,204,strawberry yogurt,50,60,10,2,00017,India
859229,2023-03-29,212,amul cheese,250,315,65,1,00242,India
859229,2023-03-29,209,pepsi,75,100,25,2,00242,India
859229,2023-03-29,206,yakult,360,400,40,2,00242,India
738714,2023-03-29,211,red bull,90,125,35,2,00021,India
455303,2023-03-29,210,mountain dew,75,100,25,2,00144,India
455303,2023-03-29,205,classic yogurt,45,60,15,2,00144,India
455303,2023-03-29,204,strawberry yogurt,50,60,10,2,00144,India
191182,2023-03-29,212,amul cheese,250,315,65,1,00393,India
191182,2023-03-29,205,classic yogurt,45,60,15,2,00393,India
191182,2023-03-29,211,red bull,90,125,35,2,00393,India
672975,2023-03-30,202,milk,12,27,15,1,00462,India
672975,2023-03-30,207,coca cola,75,100,25,2,00462,India
672975,2023-03-30,203,mango yogurt,50,60,10,2,00462,India
611099,2023-03-30,208,sprite,75,100,25,2,00002,India
611099,2023-03-30,211,red bull,90,125,35,2,00002,India
611099,2023-03-30,201,paneer,210,340,130,1,00002,India
611099,2023-03-30,212,amul cheese,250,315,65,1,00002,India
427513,2023-03-30,207,coca cola,75,100,25,2,00088,India
427513,2023-03-30,208,sprite,75,100,25,2,00088,India
427513,2023-03-30,201,paneer,210,340,130,1,00088,India
948492,2023-03-30,213,bisleri,6,15,9,2,00060,India
158589,2023-03-30,208,sprite,75,100,25,2,00465,India
158589,2023-03-30,213,bisleri,6,15,9,2,00465,India
158589,2023-03-30,210,mountain dew,75,100,25,2,00465,India
617004,2023-03-30,209,pepsi,75,100,25,2,00423,India
617004,2023-03-30,206,yakult,360,400,40,2,00423,India
617004,2023-03-30,201,paneer,210,340,130,1,00423,India
617004,2023-03-30,212,amul cheese,250,315,65,1,00423,India
560111,2023-03-30,206,yakult,360,400,40,2,00211,India
560111,2023-03-30,208,sprite,75,100,25,2,00211,India
511122,2023-03-30,208,sprite,75,100,25,2,00110,India
511122,2023-03-30,207,coca cola,75,100,25,2,00110,India
511122,2023-03-30,206,yakult,360,400,40,2,00110,India
511122,2023-03-30,212,amul cheese,250,315,65,1,00110,India
721228,2023-03-30,205,classic yogurt,45,60,15,2,00169,India
590580,2023-03-30,201,paneer,210,340,130,1,00243,India
437270,2023-03-30,209,pepsi,75,100,25,2,00022,India
437270,2023-03-30,203,mango yogurt,50,60,10,2,00022,India
646363,2023-03-30,204,strawberry yogurt,50,60,10,2,00069,India
646363,2023-03-30,212,amul cheese,250,315,65,1,00069,India
514862,2023-03-30,207,coca cola,75,100,25,2,00235,India
514862,2023-03-30,202,milk,12,27,15,1,00235,India
514862,2023-03-30,208,sprite,75,100,25,2,00235,India
514862,2023-03-30,213,bisleri,6,15,9,2,00235,India
418211,2023-03-30,201,paneer,210,340,130,1,00029,India
957650,2023-03-30,209,pepsi,75,100,25,2,00052,India
904638,2023-03-30,206,yakult,360,400,40,2,00192,India
904638,2023-03-30,205,classic yogurt,45,60,15,2,00192,India
904638,2023-03-30,201,paneer,210,340,130,1,00192,India
904638,2023-03-30,210,mountain dew,75,100,25,2,00192,India
775064,2023-03-30,208,sprite,75,100,25,2,00187,India
638848,2023-03-30,213,bisleri,6,15,9,2,00102,India
638848,2023-03-30,210,mountain dew,75,100,25,2,00102,India
352285,2023-03-30,207,coca cola,75,100,25,2,00256,India
352285,2023-03-30,201,paneer,210,340,130,1,00256,India
956266,2023-03-30,205,classic yogurt,45,60,15,2,00276,India
956266,2023-03-30,207,coca cola,75,100,25,2,00276,India
956266,2023-03-30,203,mango yogurt,50,60,10,2,00276,India
956266,2023-03-30,202,milk,12,27,15,1,00276,India
142301,2023-03-30,210,mountain dew,75,100,25,2,00187,India
142301,2023-03-30,201,paneer,210,340,130,1,00187,India
142301,2023-03-30,204,strawberry yogurt,50,60,10,2,00187,India
333517,2023-03-30,211,red bull,90,125,35,2,00480,India
333517,2023-03-30,205,classic yogurt,45,60,15,2,00480,India
711377,2023-03-30,209,pepsi,75,100,25,2,00173,India
711377,2023-03-30,207,coca cola,75,100,25,2,00173,India
711377,2023-03-30,213,bisleri,6,15,9,2,00173,India
129954,2023-03-30,206,yakult,360,400,40,2,00331,India
988715,2023-03-30,208,sprite,75,100,25,2,00374,India
988715,2023-03-30,211,red bull,90,125,35,2,00374,India
988715,2023-03-30,206,yakult,360,400,40,2,00374,India
988715,2023-03-30,209,pepsi,75,100,25,2,00374,India
394245,2023-03-30,210,mountain dew,75,100,25,2,00473,India
394245,2023-03-30,208,sprite,75,100,25,2,00473,India
394245,2023-03-30,209,pepsi,75,100,25,2,00473,India
394245,2023-03-30,205,classic yogurt,45,60,15,2,00473,India
982092,2023-03-30,212,amul cheese,250,315,65,1,00078,India
982092,2023-03-30,213,bisleri,6,15,9,2,00078,India
982092,2023-03-30,207,coca cola,75,100,25,2,00078,India
982092,2023-03-30,210,mountain dew,75,100,25,2,00078,India
982092,2023-03-30,202,milk,12,27,15,1,00078,India
303932,2023-03-30,210,mountain dew,75,100,25,2,00189,India
303932,2023-03-30,204,strawberry yogurt,50,60,10,2,00189,India
303932,2023-03-30,207,coca cola,75,100,25,2,00189,India
219151,2023-03-30,203,mango yogurt,50,60,10,2,00232,India
219151,2023-03-30,212,amul cheese,250,315,65,1,00232,India
219151,2023-03-30,209,pepsi,75,100,25,2,00232,India
608151,2023-03-30,202,milk,12,27,15,1,00454,India
608151,2023-03-30,205,classic yogurt,45,60,15,2,00454,India
608151,2023-03-30,207,coca cola,75,100,25,2,00454,India
608151,2023-03-30,209,pepsi,75,100,25,2,00454,India
466104,2023-03-30,209,pepsi,75,100,25,2,00166,India
148366,2023-03-30,203,mango yogurt,50,60,10,2,00433,India
148366,2023-03-30,211,red bull,90,125,35,2,00433,India
148366,2023-03-30,213,bisleri,6,15,9,2,00433,India
148366,2023-03-30,205,classic yogurt,45,60,15,2,00433,India
148366,2023-03-30,210,mountain dew,75,100,25,2,00433,India
548749,2023-03-30,211,red bull,90,125,35,2,00109,India
548749,2023-03-30,213,bisleri,6,15,9,2,00109,India
548749,2023-03-30,202,milk,12,27,15,1,00109,India
280217,2023-03-30,213,bisleri,6,15,9,2,00363,India
280217,2023-03-30,204,strawberry yogurt,50,60,10,2,00363,India
280217,2023-03-30,202,milk,12,27,15,1,00363,India
561891,2023-03-30,212,amul cheese,250,315,65,1,00431,India
561891,2023-03-30,210,mountain dew,75,100,25,2,00431,India
561891,2023-03-30,211,red bull,90,125,35,2,00431,India
247970,2023-03-30,206,yakult,360,400,40,2,00089,India
692418,2023-03-30,206,yakult,360,400,40,2,00451,India
692418,2023-03-30,213,bisleri,6,15,9,2,00451,India
774646,2023-03-30,203,mango yogurt,50,60,10,2,00005,India
774646,2023-03-30,213,bisleri,6,15,9,2,00005,India
774646,2023-03-30,205,classic yogurt,45,60,15,2,00005,India
774646,2023-03-30,202,milk,12,27,15,1,00005,India
641945,2023-03-30,207,coca cola,75,100,25,2,00254,India
641945,2023-03-30,204,strawberry yogurt,50,60,10,2,00254,India
848935,2023-03-30,201,paneer,210,340,130,1,00242,India
848935,2023-03-30,205,classic yogurt,45,60,15,2,00242,India
514119,2023-03-30,209,pepsi,75,100,25,2,00364,India
514119,2023-03-30,211,red bull,90,125,35,2,00364,India
514119,2023-03-30,207,coca cola,75,100,25,2,00364,India
433841,2023-03-30,208,sprite,75,100,25,2,00369,India
433841,2023-03-30,204,strawberry yogurt,50,60,10,2,00369,India
433841,2023-03-30,212,amul cheese,250,315,65,1,00369,India
995325,2023-03-30,209,pepsi,75,100,25,2,00433,India
995325,2023-03-30,203,mango yogurt,50,60,10,2,00433,India
757815,2023-03-30,205,classic yogurt,45,60,15,2,00242,India
757815,2023-03-30,212,amul cheese,250,315,65,1,00242,India
757815,2023-03-30,210,mountain dew,75,100,25,2,00242,India
757815,2023-03-30,211,red bull,90,125,35,2,00242,India
757815,2023-03-30,213,bisleri,6,15,9,2,00242,India
890227,2023-03-30,212,amul cheese,250,315,65,1,00345,India
890227,2023-03-30,204,strawberry yogurt,50,60,10,2,00345,India
828264,2023-03-30,212,amul cheese,250,315,65,1,00497,India
828264,2023-03-30,202,milk,12,27,15,1,00497,India
828264,2023-03-30,206,yakult,360,400,40,2,00497,India
156387,2023-03-30,201,paneer,210,340,130,1,00287,India
156387,2023-03-30,205,classic yogurt,45,60,15,2,00287,India
156387,2023-03-30,202,milk,12,27,15,1,00287,India
508444,2023-03-30,213,bisleri,6,15,9,2,00295,India
508444,2023-03-30,211,red bull,90,125,35,2,00295,India
508444,2023-03-30,204,strawberry yogurt,50,60,10,2,00295,India
287282,2023-03-30,206,yakult,360,400,40,2,00016,India
287282,2023-03-30,209,pepsi,75,100,25,2,00016,India
287282,2023-03-30,212,amul cheese,250,315,65,1,00016,India
821654,2023-03-30,208,sprite,75,100,25,2,00210,India
821654,2023-03-30,211,red bull,90,125,35,2,00210,India
821654,2023-03-30,204,strawberry yogurt,50,60,10,2,00210,India
445907,2023-03-30,212,amul cheese,250,315,65,1,00122,India
578486,2023-03-30,204,strawberry yogurt,50,60,10,2,00139,India
578486,2023-03-30,213,bisleri,6,15,9,2,00139,India
578486,2023-03-30,207,coca cola,75,100,25,2,00139,India
578486,2023-03-30,202,milk,12,27,15,1,00139,India
587498,2023-03-30,204,strawberry yogurt,50,60,10,2,00098,India
587498,2023-03-30,212,amul cheese,250,315,65,1,00098,India
831270,2023-03-30,202,milk,12,27,15,1,00191,India
831270,2023-03-30,206,yakult,360,400,40,2,00191,India
831270,2023-03-30,210,mountain dew,75,100,25,2,00191,India
693798,2023-03-30,212,amul cheese,250,315,65,1,00284,India
693798,2023-03-30,209,pepsi,75,100,25,2,00284,India
693798,2023-03-30,203,mango yogurt,50,60,10,2,00284,India
693798,2023-03-30,211,red bull,90,125,35,2,00284,India
881147,2023-03-30,206,yakult,360,400,40,2,00463,India
881147,2023-03-30,207,coca cola,75,100,25,2,00463,India
881147,2023-03-30,208,sprite,75,100,25,2,00463,India
614679,2023-03-30,203,mango yogurt,50,60,10,2,00455,India
614679,2023-03-30,202,milk,12,27,15,1,00455,India
834148,2023-03-30,212,amul cheese,250,315,65,1,00375,India
834148,2023-03-30,203,mango yogurt,50,60,10,2,00375,India
646283,2023-03-30,206,yakult,360,400,40,2,00026,India
646283,2023-03-30,204,strawberry yogurt,50,60,10,2,00026,India
646283,2023-03-30,203,mango yogurt,50,60,10,2,00026,India
682011,2023-03-30,211,red bull,90,125,35,2,00014,India
682011,2023-03-30,210,mountain dew,75,100,25,2,00014,India
682011,2023-03-30,205,classic yogurt,45,60,15,2,00014,India
168582,2023-03-30,202,milk,12,27,15,1,00221,India
168582,2023-03-30,201,paneer,210,340,130,1,00221,India
168582,2023-03-30,213,bisleri,6,15,9,2,00221,India
168582,2023-03-30,210,mountain dew,75,100,25,2,00221,India
863097,2023-03-30,204,strawberry yogurt,50,60,10,2,00058,India
863097,2023-03-30,208,sprite,75,100,25,2,00058,India
863097,2023-03-30,201,paneer,210,340,130,1,00058,India
775995,2023-03-30,207,coca cola,75,100,25,2,00260,India
775995,2023-03-30,206,yakult,360,400,40,2,00260,India
775995,2023-03-30,211,red bull,90,125,35,2,00260,India
775995,2023-03-30,212,amul cheese,250,315,65,1,00260,India
932279,2023-03-30,206,yakult,360,400,40,2,00046,India
932279,2023-03-30,208,sprite,75,100,25,2,00046,India
932279,2023-03-30,201,paneer,210,340,130,1,00046,India
932279,2023-03-30,204,strawberry yogurt,50,60,10,2,00046,India
963285,2023-03-30,204,strawberry yogurt,50,60,10,2,00436,India
963285,2023-03-30,210,mountain dew,75,100,25,2,00436,India
645521,2023-03-30,213,bisleri,6,15,9,2,00407,India
645521,2023-03-30,203,mango yogurt,50,60,10,2,00407,India
645521,2023-03-30,201,paneer,210,340,130,1,00407,India
645521,2023-03-30,202,milk,12,27,15,1,00407,India
178921,2023-03-30,207,coca cola,75,100,25,2,00350,India
178921,2023-03-30,211,red bull,90,125,35,2,00350,India
178921,2023-03-30,204,strawberry yogurt,50,60,10,2,00350,India
633513,2023-03-30,209,pepsi,75,100,25,2,00431,India
633513,2023-03-30,202,milk,12,27,15,1,00431,India
916903,2023-03-30,213,bisleri,6,15,9,2,00323,India
916903,2023-03-30,201,paneer,210,340,130,1,00323,India
916903,2023-03-30,202,milk,12,27,15,1,00323,India
639628,2023-03-30,208,sprite,75,100,25,2,00039,India
221923,2023-03-30,210,mountain dew,75,100,25,2,00454,India
221923,2023-03-30,206,yakult,360,400,40,2,00454,India
221923,2023-03-30,202,milk,12,27,15,1,00454,India
262252,2023-03-30,201,paneer,210,340,130,1,00335,India
262252,2023-03-30,209,pepsi,75,100,25,2,00335,India
371861,2023-03-30,211,red bull,90,125,35,2,00472,India
534298,2023-03-30,210,mountain dew,75,100,25,2,00044,India
534298,2023-03-30,212,amul cheese,250,315,65,1,00044,India
534298,2023-03-30,203,mango yogurt,50,60,10,2,00044,India
534298,2023-03-30,202,milk,12,27,15,1,00044,India
534298,2023-03-30,209,pepsi,75,100,25,2,00044,India
880496,2023-03-30,207,coca cola,75,100,25,2,00327,India
880496,2023-03-30,210,mountain dew,75,100,25,2,00327,India
737824,2023-03-30,202,milk,12,27,15,1,00090,India
737824,2023-03-30,201,paneer,210,340,130,1,00090,India
737824,2023-03-30,213,bisleri,6,15,9,2,00090,India
135870,2023-03-30,205,classic yogurt,45,60,15,2,00081,India
135870,2023-03-30,203,mango yogurt,50,60,10,2,00081,India
135870,2023-03-30,207,coca cola,75,100,25,2,00081,India
135870,2023-03-30,211,red bull,90,125,35,2,00081,India
243607,2023-03-30,201,paneer,210,340,130,1,00122,India
243607,2023-03-30,202,milk,12,27,15,1,00122,India
243607,2023-03-30,206,yakult,360,400,40,2,00122,India
243607,2023-03-30,210,mountain dew,75,100,25,2,00122,India
243607,2023-03-30,205,classic yogurt,45,60,15,2,00122,India
253319,2023-03-30,203,mango yogurt,50,60,10,2,00365,India
253319,2023-03-30,204,strawberry yogurt,50,60,10,2,00365,India
253319,2023-03-30,202,milk,12,27,15,1,00365,India
180816,2023-03-30,203,mango yogurt,50,60,10,2,00087,India
180816,2023-03-30,207,coca cola,75,100,25,2,00087,India
180816,2023-03-30,210,mountain dew,75,100,25,2,00087,India
180816,2023-03-30,209,pepsi,75,100,25,2,00087,India
571725,2023-03-30,204,strawberry yogurt,50,60,10,2,00480,India
571725,2023-03-30,202,milk,12,27,15,1,00480,India
571725,2023-03-30,212,amul cheese,250,315,65,1,00480,India
571725,2023-03-30,208,sprite,75,100,25,2,00480,India
571725,2023-03-30,206,yakult,360,400,40,2,00480,India
987916,2023-03-30,203,mango yogurt,50,60,10,2,00273,India
987916,2023-03-30,210,mountain dew,75,100,25,2,00273,India
987916,2023-03-30,213,bisleri,6,15,9,2,00273,India
987916,2023-03-30,209,pepsi,75,100,25,2,00273,India
987916,2023-03-30,212,amul cheese,250,315,65,1,00273,India
900885,2023-03-30,210,mountain dew,75,100,25,2,00042,India
900885,2023-03-30,212,amul cheese,250,315,65,1,00042,India
841856,2023-03-30,201,paneer,210,340,130,1,00493,India
841856,2023-03-30,210,mountain dew,75,100,25,2,00493,India
841856,2023-03-30,208,sprite,75,100,25,2,00493,India
841856,2023-03-30,203,mango yogurt,50,60,10,2,00493,India
652434,2023-03-30,213,bisleri,6,15,9,2,00038,India
666171,2023-03-30,212,amul cheese,250,315,65,1,00493,India
666171,2023-03-30,201,paneer,210,340,130,1,00493,India
666171,2023-03-30,213,bisleri,6,15,9,2,00493,India
689658,2023-03-30,207,coca cola,75,100,25,2,00422,India
689658,2023-03-30,205,classic yogurt,45,60,15,2,00422,India
689658,2023-03-30,211,red bull,90,125,35,2,00422,India
689658,2023-03-30,201,paneer,210,340,130,1,00422,India
689658,2023-03-30,202,milk,12,27,15,1,00422,India
932933,2023-03-30,201,paneer,210,340,130,1,00322,India
932933,2023-03-30,205,classic yogurt,45,60,15,2,00322,India
932933,2023-03-30,204,strawberry yogurt,50,60,10,2,00322,India
932933,2023-03-30,202,milk,12,27,15,1,00322,India
529691,2023-03-30,209,pepsi,75,100,25,2,00371,India
740638,2023-03-30,209,pepsi,75,100,25,2,00435,India
740638,2023-03-30,211,red bull,90,125,35,2,00435,India
740638,2023-03-30,204,strawberry yogurt,50,60,10,2,00435,India
984296,2023-03-30,211,red bull,90,125,35,2,00141,India
984296,2023-03-30,203,mango yogurt,50,60,10,2,00141,India
984296,2023-03-30,208,sprite,75,100,25,2,00141,India
984296,2023-03-30,213,bisleri,6,15,9,2,00141,India
984296,2023-03-30,202,milk,12,27,15,1,00141,India
466040,2023-03-30,203,mango yogurt,50,60,10,2,00282,India
466040,2023-03-30,207,coca cola,75,100,25,2,00282,India
466040,2023-03-30,206,yakult,360,400,40,2,00282,India
466040,2023-03-30,211,red bull,90,125,35,2,00282,India
131903,2023-03-30,206,yakult,360,400,40,2,00077,India
131903,2023-03-30,204,strawberry yogurt,50,60,10,2,00077,India
131903,2023-03-30,201,paneer,210,340,130,1,00077,India
131903,2023-03-30,203,mango yogurt,50,60,10,2,00077,India
739090,2023-03-30,212,amul cheese,250,315,65,1,00337,India
437686,2023-03-30,207,coca cola,75,100,25,2,00138,India
539523,2023-03-30,202,milk,12,27,15,1,00131,India
539523,2023-03-30,201,paneer,210,340,130,1,00131,India
539523,2023-03-30,210,mountain dew,75,100,25,2,00131,India
539523,2023-03-30,212,amul cheese,250,315,65,1,00131,India
105351,2023-03-30,204,strawberry yogurt,50,60,10,2,00158,India
105351,2023-03-30,209,pepsi,75,100,25,2,00158,India
105351,2023-03-30,213,bisleri,6,15,9,2,00158,India
794554,2023-03-30,203,mango yogurt,50,60,10,2,00177,India
794554,2023-03-30,210,mountain dew,75,100,25,2,00177,India
794554,2023-03-30,206,yakult,360,400,40,2,00177,India
794554,2023-03-30,207,coca cola,75,100,25,2,00177,India
947941,2023-03-30,203,mango yogurt,50,60,10,2,00284,India
300971,2023-03-30,213,bisleri,6,15,9,2,00033,India
300971,2023-03-30,210,mountain dew,75,100,25,2,00033,India
300971,2023-03-30,208,sprite,75,100,25,2,00033,India
463927,2023-03-31,208,sprite,75,100,25,2,00104,India
487921,2023-03-31,208,sprite,75,100,25,2,00278,India
487921,2023-03-31,201,paneer,210,340,130,1,00278,India
351271,2023-03-31,207,coca cola,75,100,25,2,00297,India
351271,2023-03-31,202,milk,12,27,15,1,00297,India
624241,2023-03-31,208,sprite,75,100,25,2,00455,India
624241,2023-03-31,206,yakult,360,400,40,2,00455,India
624241,2023-03-31,204,strawberry yogurt,50,60,10,2,00455,India
443355,2023-03-31,206,yakult,360,400,40,2,00175,India
443355,2023-03-31,204,strawberry yogurt,50,60,10,2,00175,India
443355,2023-03-31,205,classic yogurt,45,60,15,2,00175,India
721958,2023-03-31,201,paneer,210,340,130,1,00350,India
721958,2023-03-31,207,coca cola,75,100,25,2,00350,India
721958,2023-03-31,206,yakult,360,400,40,2,00350,India
721958,2023-03-31,202,milk,12,27,15,1,00350,India
721958,2023-03-31,212,amul cheese,250,315,65,1,00350,India
525353,2023-03-31,205,classic yogurt,45,60,15,2,00423,India
525353,2023-03-31,210,mountain dew,75,100,25,2,00423,India
599641,2023-03-31,213,bisleri,6,15,9,2,00239,India
599641,2023-03-31,205,classic yogurt,45,60,15,2,00239,India
599641,2023-03-31,206,yakult,360,400,40,2,00239,India
599641,2023-03-31,207,coca cola,75,100,25,2,00239,India
742319,2023-03-31,202,milk,12,27,15,1,00376,India
742319,2023-03-31,209,pepsi,75,100,25,2,00376,India
742319,2023-03-31,213,bisleri,6,15,9,2,00376,India
763100,2023-03-31,211,red bull,90,125,35,2,00166,India
763100,2023-03-31,210,mountain dew,75,100,25,2,00166,India
237639,2023-03-31,209,pepsi,75,100,25,2,00075,India
237639,2023-03-31,210,mountain dew,75,100,25,2,00075,India
244676,2023-03-31,201,paneer,210,340,130,1,00337,India
244676,2023-03-31,204,strawberry yogurt,50,60,10,2,00337,India
244676,2023-03-31,209,pepsi,75,100,25,2,00337,India
244676,2023-03-31,205,classic yogurt,45,60,15,2,00337,India
686753,2023-03-31,207,coca cola,75,100,25,2,00181,India
528017,2023-03-31,210,mountain dew,75,100,25,2,00051,India
528017,2023-03-31,201,paneer,210,340,130,1,00051,India
528017,2023-03-31,209,pepsi,75,100,25,2,00051,India
528017,2023-03-31,211,red bull,90,125,35,2,00051,India
980203,2023-03-31,208,sprite,75,100,25,2,00175,India
980203,2023-03-31,212,amul cheese,250,315,65,1,00175,India
980203,2023-03-31,211,red bull,90,125,35,2,00175,India
980203,2023-03-31,207,coca cola,75,100,25,2,00175,India
980203,2023-03-31,205,classic yogurt,45,60,15,2,00175,India
177291,2023-03-31,201,paneer,210,340,130,1,00239,India
177291,2023-03-31,209,pepsi,75,100,25,2,00239,India
177291,2023-03-31,213,bisleri,6,15,9,2,00239,India
177291,2023-03-31,208,sprite,75,100,25,2,00239,India
933398,2023-03-31,202,milk,12,27,15,1,00405,India
933398,2023-03-31,213,bisleri,6,15,9,2,00405,India
933398,2023-03-31,205,classic yogurt,45,60,15,2,00405,India
536658,2023-03-31,209,pepsi,75,100,25,2,00483,India
536658,2023-03-31,213,bisleri,6,15,9,2,00483,India
681629,2023-03-31,201,paneer,210,340,130,1,00152,India
681629,2023-03-31,213,bisleri,6,15,9,2,00152,India
681629,2023-03-31,211,red bull,90,125,35,2,00152,India
681629,2023-03-31,206,yakult,360,400,40,2,00152,India
827162,2023-03-31,202,milk,12,27,15,1,00041,India
827162,2023-03-31,211,red bull,90,125,35,2,00041,India
827162,2023-03-31,201,paneer,210,340,130,1,00041,India
827162,2023-03-31,205,classic yogurt,45,60,15,2,00041,India
827162,2023-03-31,213,bisleri,6,15,9,2,00041,India
342475,2023-03-31,205,classic yogurt,45,60,15,2,00162,India
342475,2023-03-31,209,pepsi,75,100,25,2,00162,India
342475,2023-03-31,201,paneer,210,340,130,1,00162,India
342475,2023-03-31,210,mountain dew,75,100,25,2,00162,India
342475,2023-03-31,211,red bull,90,125,35,2,00162,India
501662,2023-03-31,210,mountain dew,75,100,25,2,00360,India
501662,2023-03-31,212,amul cheese,250,315,65,1,00360,India
501662,2023-03-31,209,pepsi,75,100,25,2,00360,India
501662,2023-03-31,201,paneer,210,340,130,1,00360,India
754128,2023-03-31,204,strawberry yogurt,50,60,10,2,00132,India
754128,2023-03-31,201,paneer,210,340,130,1,00132,India
665212,2023-03-31,212,amul cheese,250,315,65,1,00340,India
925178,2023-03-31,213,bisleri,6,15,9,2,00273,India
725268,2023-03-31,209,pepsi,75,100,25,2,00496,India
725268,2023-03-31,202,milk,12,27,15,1,00496,India
681284,2023-03-31,210,mountain dew,75,100,25,2,00125,India
681284,2023-03-31,203,mango yogurt,50,60,10,2,00125,India
681284,2023-03-31,205,classic yogurt,45,60,15,2,00125,India
681284,2023-03-31,206,yakult,360,400,40,2,00125,India
819449,2023-03-31,205,classic yogurt,45,60,15,2,00423,India
819449,2023-03-31,211,red bull,90,125,35,2,00423,India
629772,2023-03-31,206,yakult,360,400,40,2,00203,India
629772,2023-03-31,212,amul cheese,250,315,65,1,00203,India
629772,2023-03-31,211,red bull,90,125,35,2,00203,India
865112,2023-03-31,203,mango yogurt,50,60,10,2,00497,India
865112,2023-03-31,204,strawberry yogurt,50,60,10,2,00497,India
865112,2023-03-31,201,paneer,210,340,130,1,00497,India
865112,2023-03-31,208,sprite,75,100,25,2,00497,India
549608,2023-03-31,211,red bull,90,125,35,2,00193,India
549608,2023-03-31,202,milk,12,27,15,1,00193,India
549608,2023-03-31,213,bisleri,6,15,9,2,00193,India
549608,2023-03-31,210,mountain dew,75,100,25,2,00193,India
108784,2023-03-31,207,coca cola,75,100,25,2,00220,India
108784,2023-03-31,203,mango yogurt,50,60,10,2,00220,India
108784,2023-03-31,212,amul cheese,250,315,65,1,00220,India
108784,2023-03-31,202,milk,12,27,15,1,00220,India
108784,2023-03-31,206,yakult,360,400,40,2,00220,India
262474,2023-03-31,207,coca cola,75,100,25,2,00044,India
727908,2023-03-31,202,milk,12,27,15,1,00116,India
370457,2023-03-31,213,bisleri,6,15,9,2,00198,India
370457,2023-03-31,210,mountain dew,75,100,25,2,00198,India
370457,2023-03-31,204,strawberry yogurt,50,60,10,2,00198,India
100526,2023-03-31,210,mountain dew,75,100,25,2,00053,India
100526,2023-03-31,203,mango yogurt,50,60,10,2,00053,India
100526,2023-03-31,201,paneer,210,340,130,1,00053,India
100526,2023-03-31,204,strawberry yogurt,50,60,10,2,00053,India
100526,2023-03-31,206,yakult,360,400,40,2,00053,India
977536,2023-03-31,212,amul cheese,250,315,65,1,00422,India
977536,2023-03-31,202,milk,12,27,15,1,00422,India
977536,2023-03-31,203,mango yogurt,50,60,10,2,00422,India
977536,2023-03-31,208,sprite,75,100,25,2,00422,India
512223,2023-03-31,203,mango yogurt,50,60,10,2,00487,India
512223,2023-03-31,209,pepsi,75,100,25,2,00487,India
512223,2023-03-31,201,paneer,210,340,130,1,00487,India
566638,2023-03-31,210,mountain dew,75,100,25,2,00064,India
432792,2023-03-31,203,mango yogurt,50,60,10,2,00005,India
404515,2023-03-31,206,yakult,360,400,40,2,00337,India
404515,2023-03-31,204,strawberry yogurt,50,60,10,2,00337,India
404515,2023-03-31,203,mango yogurt,50,60,10,2,00337,India
776423,2023-03-31,205,classic yogurt,45,60,15,2,00009,India
776423,2023-03-31,208,sprite,75,100,25,2,00009,India
776423,2023-03-31,212,amul cheese,250,315,65,1,00009,India
776423,2023-03-31,211,red bull,90,125,35,2,00009,India
771430,2023-03-31,205,classic yogurt,45,60,15,2,00200,India
771430,2023-03-31,209,pepsi,75,100,25,2,00200,India
771430,2023-03-31,212,amul cheese,250,315,65,1,00200,India
317830,2023-03-31,212,amul cheese,250,315,65,1,00329,India
317830,2023-03-31,207,coca cola,75,100,25,2,00329,India
317830,2023-03-31,209,pepsi,75,100,25,2,00329,India
230873,2023-03-31,205,classic yogurt,45,60,15,2,00147,India
230873,2023-03-31,209,pepsi,75,100,25,2,00147,India
230873,2023-03-31,208,sprite,75,100,25,2,00147,India
230873,2023-03-31,202,milk,12,27,15,1,00147,India
414788,2023-03-31,211,red bull,90,125,35,2,00184,India
350715,2023-03-31,210,mountain dew,75,100,25,2,00417,India
884054,2023-03-31,205,classic yogurt,45,60,15,2,00453,India
884054,2023-03-31,202,milk,12,27,15,1,00453,India
884054,2023-03-31,213,bisleri,6,15,9,2,00453,India
968231,2023-03-31,209,pepsi,75,100,25,2,00060,India
968231,2023-03-31,210,mountain dew,75,100,25,2,00060,India
968231,2023-03-31,201,paneer,210,340,130,1,00060,India
968231,2023-03-31,202,milk,12,27,15,1,00060,India
892363,2023-03-31,207,coca cola,75,100,25,2,00329,India
892363,2023-03-31,210,mountain dew,75,100,25,2,00329,India
892363,2023-03-31,211,red bull,90,125,35,2,00329,India
196091,2023-03-31,213,bisleri,6,15,9,2,00369,India
196091,2023-03-31,205,classic yogurt,45,60,15,2,00369,India
196091,2023-03-31,204,strawberry yogurt,50,60,10,2,00369,India
588468,2023-03-31,203,mango yogurt,50,60,10,2,00055,India
588468,2023-03-31,208,sprite,75,100,25,2,00055,India
298182,2023-03-31,211,red bull,90,125,35,2,00394,India
538202,2023-03-31,212,amul cheese,250,315,65,1,00181,India
538202,2023-03-31,201,paneer,210,340,130,1,00181,India
538202,2023-03-31,202,milk,12,27,15,1,00181,India
538202,2023-03-31,204,strawberry yogurt,50,60,10,2,00181,India
388790,2023-03-31,202,milk,12,27,15,1,00117,India
388790,2023-03-31,201,paneer,210,340,130,1,00117,India
388790,2023-03-31,211,red bull,90,125,35,2,00117,India
388790,2023-03-31,203,mango yogurt,50,60,10,2,00117,India
643715,2023-03-31,201,paneer,210,340,130,1,00121,India
643715,2023-03-31,208,sprite,75,100,25,2,00121,India
902335,2023-03-31,206,yakult,360,400,40,2,00393,India
249207,2023-03-31,209,pepsi,75,100,25,2,00184,India
249207,2023-03-31,203,mango yogurt,50,60,10,2,00184,India
673869,2023-03-31,207,coca cola,75,100,25,2,00473,India
673869,2023-03-31,210,mountain dew,75,100,25,2,00473,India
673869,2023-03-31,209,pepsi,75,100,25,2,00473,India
673869,2023-03-31,202,milk,12,27,15,1,00473,India
673869,2023-03-31,211,red bull,90,125,35,2,00473,India
107519,2023-03-31,212,amul cheese,250,315,65,1,00141,India
107519,2023-03-31,201,paneer,210,340,130,1,00141,India
994753,2023-03-31,201,paneer,210,340,130,1,00362,India
976803,2023-03-31,212,amul cheese,250,315,65,1,00169,India
976803,2023-03-31,208,sprite,75,100,25,2,00169,India
276550,2023-03-31,211,red bull,90,125,35,2,00237,India
276550,2023-03-31,213,bisleri,6,15,9,2,00237,India
276550,2023-03-31,210,mountain dew,75,100,25,2,00237,India
692718,2023-03-31,201,paneer,210,340,130,1,00214,India
692718,2023-03-31,208,sprite,75,100,25,2,00214,India
144749,2023-03-31,206,yakult,360,400,40,2,00233,India
144749,2023-03-31,209,pepsi,75,100,25,2,00233,India
144749,2023-03-31,210,mountain dew,75,100,25,2,00233,India
915934,2023-03-31,211,red bull,90,125,35,2,00209,India
915934,2023-03-31,202,milk,12,27,15,1,00209,India
442911,2023-03-31,206,yakult,360,400,40,2,00323,India
569169,2023-03-31,207,coca cola,75,100,25,2,00225,India
569169,2023-03-31,209,pepsi,75,100,25,2,00225,India
186161,2023-03-31,207,coca cola,75,100,25,2,00177,India
186161,2023-03-31,213,bisleri,6,15,9,2,00177,India
314171,2023-03-31,205,classic yogurt,45,60,15,2,00156,India
933660,2023-03-31,207,coca cola,75,100,25,2,00496,India
933660,2023-03-31,204,strawberry yogurt,50,60,10,2,00496,India
933660,2023-03-31,211,red bull,90,125,35,2,00496,India
672630,2023-03-31,208,sprite,75,100,25,2,00240,India
672630,2023-03-31,205,classic yogurt,45,60,15,2,00240,India
374750,2023-03-31,212,amul cheese,250,315,65,1,00118,India
374750,2023-03-31,201,paneer,210,340,130,1,00118,India
305076,2023-03-31,203,mango yogurt,50,60,10,2,00294,India
305076,2023-03-31,209,pepsi,75,100,25,2,00294,India
305076,2023-03-31,207,coca cola,75,100,25,2,00294,India
972648,2023-03-31,202,milk,12,27,15,1,00133,India
972648,2023-03-31,207,coca cola,75,100,25,2,00133,India
972648,2023-03-31,212,amul cheese,250,315,65,1,00133,India
972648,2023-03-31,213,bisleri,6,15,9,2,00133,India
972648,2023-03-31,204,strawberry yogurt,50,60,10,2,00133,India
340623,2023-03-31,211,red bull,90,125,35,2,00168,India
865122,2023-03-31,210,mountain dew,75,100,25,2,00499,India
865122,2023-03-31,212,amul cheese,250,315,65,1,00499,India
865122,2023-03-31,202,milk,12,27,15,1,00499,India
631279,2023-03-31,208,sprite,75,100,25,2,00053,India
631279,2023-03-31,213,bisleri,6,15,9,2,00053,India
278666,2023-03-31,206,yakult,360,400,40,2,00129,India
278666,2023-03-31,201,paneer,210,340,130,1,00129,India
681025,2023-03-31,206,yakult,360,400,40,2,00234,India
681025,2023-03-31,212,amul cheese,250,315,65,1,00234,India
681025,2023-03-31,207,coca cola,75,100,25,2,00234,India
365218,2023-03-31,213,bisleri,6,15,9,2,00072,India
365218,2023-03-31,203,mango yogurt,50,60,10,2,00072,India
365218,2023-03-31,204,strawberry yogurt,50,60,10,2,00072,India
365218,2023-03-31,202,milk,12,27,15,1,00072,India
365218,2023-03-31,206,yakult,360,400,40,2,00072,India
998854,2023-03-31,203,mango yogurt,50,60,10,2,00137,India
998854,2023-03-31,207,coca cola,75,100,25,2,00137,India
581579,2023-03-31,203,mango yogurt,50,60,10,2,00034,India
581579,2023-03-31,208,sprite,75,100,25,2,00034,India
581579,2023-03-31,202,milk,12,27,15,1,00034,India
581579,2023-03-31,210,mountain dew,75,100,25,2,00034,India
260051,2023-03-31,206,yakult,360,400,40,2,00198,India
740143,2023-03-31,204,strawberry yogurt,50,60,10,2,00042,India
740143,2023-03-31,213,bisleri,6,15,9,2,00042,India
679314,2023-03-31,207,coca cola,75,100,25,2,00120,India
679314,2023-03-31,202,milk,12,27,15,1,00120,India
174981,2023-03-31,204,strawberry yogurt,50,60,10,2,00083,India
174981,2023-03-31,213,bisleri,6,15,9,2,00083,India
373866,2023-03-31,203,mango yogurt,50,60,10,2,00313,India
373866,2023-03-31,213,bisleri,6,15,9,2,00313,India
373866,2023-03-31,207,coca cola,75,100,25,2,00313,India
373866,2023-03-31,209,pepsi,75,100,25,2,00313,India
477411,2023-03-31,211,red bull,90,125,35,2,00011,India
313681,2023-03-31,213,bisleri,6,15,9,2,00083,India
313681,2023-03-31,203,mango yogurt,50,60,10,2,00083,India
313681,2023-03-31,210,mountain dew,75,100,25,2,00083,India
977348,2023-03-31,210,mountain dew,75,100,25,2,00376,India
977348,2023-03-31,208,sprite,75,100,25,2,00376,India
977348,2023-03-31,212,amul cheese,250,315,65,1,00376,India
977348,2023-03-31,201,paneer,210,340,130,1,00376,India
131182,2023-03-31,210,mountain dew,75,100,25,2,00105,India
131182,2023-03-31,207,coca cola,75,100,25,2,00105,India
131182,2023-03-31,208,sprite,75,100,25,2,00105,India
882518,2023-03-31,202,milk,12,27,15,1,00041,India
882518,2023-03-31,210,mountain dew,75,100,25,2,00041,India
718521,2023-03-31,210,mountain dew,75,100,25,2,00493,India
718521,2023-03-31,209,pepsi,75,100,25,2,00493,India
718521,2023-03-31,204,strawberry yogurt,50,60,10,2,00493,India
448036,2023-04-01,213,bisleri,6,15,9,2,00096,India
448036,2023-04-01,209,pepsi,75,100,25,2,00096,India
222254,2023-04-01,203,mango yogurt,50,60,10,2,00022,India
222254,2023-04-01,209,pepsi,75,100,25,2,00022,India
222254,2023-04-01,206,yakult,360,400,40,2,00022,India
222254,2023-04-01,211,red bull,90,125,35,2,00022,India
967162,2023-04-01,210,mountain dew,75,100,25,2,00209,India
967162,2023-04-01,206,yakult,360,400,40,2,00209,India
967162,2023-04-01,208,sprite,75,100,25,2,00209,India
290772,2023-04-01,201,paneer,210,340,130,1,00265,India
290772,2023-04-01,202,milk,12,27,15,1,00265,India
290772,2023-04-01,213,bisleri,6,15,9,2,00265,India
512106,2023-04-01,201,paneer,210,340,130,1,00404,India
512106,2023-04-01,211,red bull,90,125,35,2,00404,India
512106,2023-04-01,202,milk,12,27,15,1,00404,India
512106,2023-04-01,207,coca cola,75,100,25,2,00404,India
512106,2023-04-01,204,strawberry yogurt,50,60,10,2,00404,India
497588,2023-04-01,206,yakult,360,400,40,2,00193,India
427834,2023-04-01,213,bisleri,6,15,9,2,00174,India
427834,2023-04-01,209,pepsi,75,100,25,2,00174,India
427834,2023-04-01,206,yakult,360,400,40,2,00174,India
119869,2023-04-01,212,amul cheese,250,315,65,1,00234,India
119869,2023-04-01,211,red bull,90,125,35,2,00234,India
119869,2023-04-01,204,strawberry yogurt,50,60,10,2,00234,India
119869,2023-04-01,205,classic yogurt,45,60,15,2,00234,India
119869,2023-04-01,206,yakult,360,400,40,2,00234,India
953240,2023-04-01,209,pepsi,75,100,25,2,00097,India
836497,2023-04-01,201,paneer,210,340,130,1,00043,India
836497,2023-04-01,211,red bull,90,125,35,2,00043,India
836497,2023-04-01,213,bisleri,6,15,9,2,00043,India
934760,2023-04-01,205,classic yogurt,45,60,15,2,00153,India
614503,2023-04-01,208,sprite,75,100,25,2,00211,India
614503,2023-04-01,205,classic yogurt,45,60,15,2,00211,India
983061,2023-04-01,210,mountain dew,75,100,25,2,00363,India
983061,2023-04-01,211,red bull,90,125,35,2,00363,India
983061,2023-04-01,212,amul cheese,250,315,65,1,00363,India
983061,2023-04-01,213,bisleri,6,15,9,2,00363,India
247993,2023-04-01,210,mountain dew,75,100,25,2,00346,India
497748,2023-04-01,208,sprite,75,100,25,2,00131,India
497748,2023-04-01,206,yakult,360,400,40,2,00131,India
739064,2023-04-01,206,yakult,360,400,40,2,00482,India
739064,2023-04-01,209,pepsi,75,100,25,2,00482,India
739064,2023-04-01,203,mango yogurt,50,60,10,2,00482,India
320815,2023-04-01,213,bisleri,6,15,9,2,00347,India
332749,2023-04-01,211,red bull,90,125,35,2,00472,India
332749,2023-04-01,203,mango yogurt,50,60,10,2,00472,India
332749,2023-04-01,210,mountain dew,75,100,25,2,00472,India
332749,2023-04-01,213,bisleri,6,15,9,2,00472,India
488584,2023-04-01,213,bisleri,6,15,9,2,00318,India
488584,2023-04-01,209,pepsi,75,100,25,2,00318,India
488584,2023-04-01,203,mango yogurt,50,60,10,2,00318,India
488584,2023-04-01,208,sprite,75,100,25,2,00318,India
488584,2023-04-01,207,coca cola,75,100,25,2,00318,India
893370,2023-04-01,205,classic yogurt,45,60,15,2,00176,India
893370,2023-04-01,211,red bull,90,125,35,2,00176,India
893370,2023-04-01,209,pepsi,75,100,25,2,00176,India
893370,2023-04-01,202,milk,12,27,15,1,00176,India
171019,2023-04-01,202,milk,12,27,15,1,00262,India
171019,2023-04-01,210,mountain dew,75,100,25,2,00262,India
171019,2023-04-01,213,bisleri,6,15,9,2,00262,India
171019,2023-04-01,204,strawberry yogurt,50,60,10,2,00262,India
240045,2023-04-01,201,paneer,210,340,130,1,00264,India
240045,2023-04-01,205,classic yogurt,45,60,15,2,00264,India
240045,2023-04-01,207,coca cola,75,100,25,2,00264,India
240045,2023-04-01,203,mango yogurt,50,60,10,2,00264,India
240045,2023-04-01,204,strawberry yogurt,50,60,10,2,00264,India
822686,2023-04-01,207,coca cola,75,100,25,2,00432,India
822686,2023-04-01,202,milk,12,27,15,1,00432,India
822686,2023-04-01,205,classic yogurt,45,60,15,2,00432,India
822686,2023-04-01,208,sprite,75,100,25,2,00432,India
881953,2023-04-01,206,yakult,360,400,40,2,00365,India
881953,2023-04-01,207,coca cola,75,100,25,2,00365,India
881953,2023-04-01,211,red bull,90,125,35,2,00365,India
471853,2023-04-01,202,milk,12,27,15,1,00149,India
471853,2023-04-01,201,paneer,210,340,130,1,00149,India
471853,2023-04-01,203,mango yogurt,50,60,10,2,00149,India
283154,2023-04-01,210,mountain dew,75,100,25,2,00112,India
283154,2023-04-01,212,amul cheese,250,315,65,1,00112,India
283154,2023-04-01,209,pepsi,75,100,25,2,00112,India
283154,2023-04-01,207,coca cola,75,100,25,2,00112,India
774922,2023-04-01,208,sprite,75,100,25,2,00275,India
292773,2023-04-01,211,red bull,90,125,35,2,00424,India
292773,2023-04-01,209,pepsi,75,100,25,2,00424,India
292773,2023-04-01,213,bisleri,6,15,9,2,00424,India
203618,2023-04-01,208,sprite,75,100,25,2,00246,India
635106,2023-04-01,209,pepsi,75,100,25,2,00396,India
635106,2023-04-01,206,yakult,360,400,40,2,00396,India
635106,2023-04-01,202,milk,12,27,15,1,00396,India
249646,2023-04-01,203,mango yogurt,50,60,10,2,00270,India
249646,2023-04-01,201,paneer,210,340,130,1,00270,India
249646,2023-04-01,204,strawberry yogurt,50,60,10,2,00270,India
249646,2023-04-01,202,milk,12,27,15,1,00270,India
716592,2023-04-01,202,milk,12,27,15,1,00229,India
716592,2023-04-01,211,red bull,90,125,35,2,00229,India
716592,2023-04-01,213,bisleri,6,15,9,2,00229,India
998730,2023-04-01,204,strawberry yogurt,50,60,10,2,00319,India
998730,2023-04-01,213,bisleri,6,15,9,2,00319,India
998730,2023-04-01,206,yakult,360,400,40,2,00319,India
720939,2023-04-01,211,red bull,90,125,35,2,00323,India
720939,2023-04-01,213,bisleri,6,15,9,2,00323,India
720939,2023-04-01,207,coca cola,75,100,25,2,00323,India
730036,2023-04-01,213,bisleri,6,15,9,2,00414,India
276589,2023-04-01,205,classic yogurt,45,60,15,2,00109,India
484520,2023-04-01,201,paneer,210,340,130,1,00074,India
484520,2023-04-01,213,bisleri,6,15,9,2,00074,India
484520,2023-04-01,211,red bull,90,125,35,2,00074,India
827382,2023-04-01,211,red bull,90,125,35,2,00447,India
827382,2023-04-01,202,milk,12,27,15,1,00447,India
827382,2023-04-01,208,sprite,75,100,25,2,00447,India
827382,2023-04-01,209,pepsi,75,100,25,2,00447,India
827382,2023-04-01,203,mango yogurt,50,60,10,2,00447,India
342679,2023-04-01,204,strawberry yogurt,50,60,10,2,00474,India
342679,2023-04-01,205,classic yogurt,45,60,15,2,00474,India
304076,2023-04-01,209,pepsi,75,100,25,2,00123,India
304076,2023-04-01,203,mango yogurt,50,60,10,2,00123,India
304076,2023-04-01,212,amul cheese,250,315,65,1,00123,India
230463,2023-04-01,210,mountain dew,75,100,25,2,00131,India
230463,2023-04-01,213,bisleri,6,15,9,2,00131,India
230463,2023-04-01,207,coca cola,75,100,25,2,00131,India
848786,2023-04-01,213,bisleri,6,15,9,2,00426,India
848786,2023-04-01,212,amul cheese,250,315,65,1,00426,India
307667,2023-04-01,204,strawberry yogurt,50,60,10,2,00457,India
307667,2023-04-01,209,pepsi,75,100,25,2,00457,India
307667,2023-04-01,207,coca cola,75,100,25,2,00457,India
307667,2023-04-01,201,paneer,210,340,130,1,00457,India
149113,2023-04-01,207,coca cola,75,100,25,2,00264,India
149113,2023-04-01,213,bisleri,6,15,9,2,00264,India
654609,2023-04-01,208,sprite,75,100,25,2,00306,India
654609,2023-04-01,209,pepsi,75,100,25,2,00306,India
608142,2023-04-01,205,classic yogurt,45,60,15,2,00112,India
608142,2023-04-01,208,sprite,75,100,25,2,00112,India
505799,2023-04-01,206,yakult,360,400,40,2,00434,India
505799,2023-04-01,205,classic yogurt,45,60,15,2,00434,India
505799,2023-04-01,211,red bull,90,125,35,2,00434,India
812874,2023-04-01,206,yakult,360,400,40,2,00284,India
812874,2023-04-01,208,sprite,75,100,25,2,00284,India
812874,2023-04-01,205,classic yogurt,45,60,15,2,00284,India
812874,2023-04-01,204,strawberry yogurt,50,60,10,2,00284,India
929060,2023-04-01,204,strawberry yogurt,50,60,10,2,00021,India
929060,2023-04-01,209,pepsi,75,100,25,2,00021,India
929060,2023-04-01,203,mango yogurt,50,60,10,2,00021,India
929060,2023-04-01,202,milk,12,27,15,1,00021,India
218390,2023-04-01,210,mountain dew,75,100,25,2,00301,India
218390,2023-04-01,209,pepsi,75,100,25,2,00301,India
303632,2023-04-01,211,red bull,90,125,35,2,00124,India
303632,2023-04-01,209,pepsi,75,100,25,2,00124,India
303632,2023-04-01,207,coca cola,75,100,25,2,00124,India
303632,2023-04-01,202,milk,12,27,15,1,00124,India
867778,2023-04-01,203,mango yogurt,50,60,10,2,00465,India
867778,2023-04-01,201,paneer,210,340,130,1,00465,India
867778,2023-04-01,207,coca cola,75,100,25,2,00465,India
867778,2023-04-01,209,pepsi,75,100,25,2,00465,India
867778,2023-04-01,205,classic yogurt,45,60,15,2,00465,India
252515,2023-04-01,204,strawberry yogurt,50,60,10,2,00047,India
252515,2023-04-01,201,paneer,210,340,130,1,00047,India
252515,2023-04-01,213,bisleri,6,15,9,2,00047,India
252515,2023-04-01,211,red bull,90,125,35,2,00047,India
647853,2023-04-01,204,strawberry yogurt,50,60,10,2,00410,India
647853,2023-04-01,211,red bull,90,125,35,2,00410,India
197136,2023-04-01,203,mango yogurt,50,60,10,2,00368,India
197136,2023-04-01,209,pepsi,75,100,25,2,00368,India
832217,2023-04-01,206,yakult,360,400,40,2,00396,India
832217,2023-04-01,210,mountain dew,75,100,25,2,00396,India
832217,2023-04-01,211,red bull,90,125,35,2,00396,India
832217,2023-04-01,205,classic yogurt,45,60,15,2,00396,India
622924,2023-04-01,202,milk,12,27,15,1,00479,India
771563,2023-04-01,204,strawberry yogurt,50,60,10,2,00037,India
771563,2023-04-01,202,milk,12,27,15,1,00037,India
771563,2023-04-01,206,yakult,360,400,40,2,00037,India
771563,2023-04-01,201,paneer,210,340,130,1,00037,India
416697,2023-04-01,210,mountain dew,75,100,25,2,00189,India
416697,2023-04-01,202,milk,12,27,15,1,00189,India
416697,2023-04-01,209,pepsi,75,100,25,2,00189,India
715869,2023-04-01,213,bisleri,6,15,9,2,00359,India
715869,2023-04-01,201,paneer,210,340,130,1,00359,India
648569,2023-04-01,201,paneer,210,340,130,1,00028,India
648569,2023-04-01,212,amul cheese,250,315,65,1,00028,India
648569,2023-04-01,203,mango yogurt,50,60,10,2,00028,India
648569,2023-04-01,213,bisleri,6,15,9,2,00028,India
648569,2023-04-01,207,coca cola,75,100,25,2,00028,India
436260,2023-04-01,203,mango yogurt,50,60,10,2,00092,India
436260,2023-04-01,207,coca cola,75,100,25,2,00092,India
589610,2023-04-01,209,pepsi,75,100,25,2,00135,India
589610,2023-04-01,211,red bull,90,125,35,2,00135,India
151527,2023-04-01,209,pepsi,75,100,25,2,00484,India
732796,2023-04-01,206,yakult,360,400,40,2,00056,India
732796,2023-04-01,203,mango yogurt,50,60,10,2,00056,India
732796,2023-04-01,213,bisleri,6,15,9,2,00056,India
856352,2023-04-01,207,coca cola,75,100,25,2,00461,India
856352,2023-04-01,213,bisleri,6,15,9,2,00461,India
344840,2023-04-01,211,red bull,90,125,35,2,00350,India
344840,2023-04-01,212,amul cheese,250,315,65,1,00350,India
344840,2023-04-01,209,pepsi,75,100,25,2,00350,India
344840,2023-04-01,201,paneer,210,340,130,1,00350,India
853861,2023-04-01,208,sprite,75,100,25,2,00109,India
806348,2023-04-01,213,bisleri,6,15,9,2,00194,India
801922,2023-04-01,209,pepsi,75,100,25,2,00160,India
772974,2023-04-01,203,mango yogurt,50,60,10,2,00337,India
977823,2023-04-01,201,paneer,210,340,130,1,00456,India
977823,2023-04-01,203,mango yogurt,50,60,10,2,00456,India
977823,2023-04-01,211,red bull,90,125,35,2,00456,India
751628,2023-04-01,205,classic yogurt,45,60,15,2,00062,India
751628,2023-04-01,206,yakult,360,400,40,2,00062,India
751628,2023-04-01,211,red bull,90,125,35,2,00062,India
751628,2023-04-01,212,amul cheese,250,315,65,1,00062,India
751628,2023-04-01,213,bisleri,6,15,9,2,00062,India
282888,2023-04-01,213,bisleri,6,15,9,2,00266,India
282888,2023-04-01,210,mountain dew,75,100,25,2,00266,India
282888,2023-04-01,206,yakult,360,400,40,2,00266,India
328742,2023-04-01,206,yakult,360,400,40,2,00015,India
720641,2023-04-01,204,strawberry yogurt,50,60,10,2,00323,India
720641,2023-04-01,202,milk,12,27,15,1,00323,India
720641,2023-04-01,211,red bull,90,125,35,2,00323,India
720641,2023-04-01,207,coca cola,75,100,25,2,00323,India
720641,2023-04-01,205,classic yogurt,45,60,15,2,00323,India
556770,2023-04-01,211,red bull,90,125,35,2,00049,India
556770,2023-04-01,212,amul cheese,250,315,65,1,00049,India
556770,2023-04-01,201,paneer,210,340,130,1,00049,India
924573,2023-04-01,211,red bull,90,125,35,2,00195,India
700166,2023-04-01,209,pepsi,75,100,25,2,00153,India
918771,2023-04-01,202,milk,12,27,15,1,00358,India
214599,2023-04-01,213,bisleri,6,15,9,2,00103,India
214599,2023-04-01,206,yakult,360,400,40,2,00103,India
111301,2023-04-01,211,red bull,90,125,35,2,00113,India
111301,2023-04-01,202,milk,12,27,15,1,00113,India
111301,2023-04-01,203,mango yogurt,50,60,10,2,00113,India
111301,2023-04-01,209,pepsi,75,100,25,2,00113,India
666030,2023-04-02,211,red bull,90,125,35,2,00312,India
508438,2023-04-02,212,amul cheese,250,315,65,1,00074,India
508438,2023-04-02,203,mango yogurt,50,60,10,2,00074,India
508438,2023-04-02,204,strawberry yogurt,50,60,10,2,00074,India
170239,2023-04-02,201,paneer,210,340,130,1,00065,India
170239,2023-04-02,211,red bull,90,125,35,2,00065,India
170239,2023-04-02,202,milk,12,27,15,1,00065,India
495339,2023-04-02,213,bisleri,6,15,9,2,00334,India
495339,2023-04-02,208,sprite,75,100,25,2,00334,India
275789,2023-04-02,210,mountain dew,75,100,25,2,00364,India
923569,2023-04-02,211,red bull,90,125,35,2,00167,India
923569,2023-04-02,206,yakult,360,400,40,2,00167,India
923569,2023-04-02,202,milk,12,27,15,1,00167,India
857712,2023-04-02,213,bisleri,6,15,9,2,00259,India
857712,2023-04-02,206,yakult,360,400,40,2,00259,India
857712,2023-04-02,208,sprite,75,100,25,2,00259,India
355565,2023-04-02,203,mango yogurt,50,60,10,2,00396,India
775122,2023-04-02,206,yakult,360,400,40,2,00027,India
775122,2023-04-02,205,classic yogurt,45,60,15,2,00027,India
775122,2023-04-02,210,mountain dew,75,100,25,2,00027,India
775122,2023-04-02,207,coca cola,75,100,25,2,00027,India
307514,2023-04-02,210,mountain dew,75,100,25,2,00444,India
307514,2023-04-02,206,yakult,360,400,40,2,00444,India
307514,2023-04-02,203,mango yogurt,50,60,10,2,00444,India
307514,2023-04-02,213,bisleri,6,15,9,2,00444,India
522355,2023-04-02,210,mountain dew,75,100,25,2,00215,India
522355,2023-04-02,206,yakult,360,400,40,2,00215,India
522355,2023-04-02,209,pepsi,75,100,25,2,00215,India
753764,2023-04-02,202,milk,12,27,15,1,00247,India
753764,2023-04-02,203,mango yogurt,50,60,10,2,00247,India
753764,2023-04-02,201,paneer,210,340,130,1,00247,India
428205,2023-04-02,212,amul cheese,250,315,65,1,00010,India
428205,2023-04-02,206,yakult,360,400,40,2,00010,India
428205,2023-04-02,203,mango yogurt,50,60,10,2,00010,India
428205,2023-04-02,211,red bull,90,125,35,2,00010,India
309058,2023-04-02,205,classic yogurt,45,60,15,2,00164,India
309058,2023-04-02,208,sprite,75,100,25,2,00164,India
454689,2023-04-02,210,mountain dew,75,100,25,2,00322,India
454689,2023-04-02,201,paneer,210,340,130,1,00322,India
964148,2023-04-02,211,red bull,90,125,35,2,00085,India
964148,2023-04-02,206,yakult,360,400,40,2,00085,India
964148,2023-04-02,205,classic yogurt,45,60,15,2,00085,India
168242,2023-04-02,202,milk,12,27,15,1,00390,India
168242,2023-04-02,212,amul cheese,250,315,65,1,00390,India
612331,2023-04-02,210,mountain dew,75,100,25,2,00464,India
612331,2023-04-02,209,pepsi,75,100,25,2,00464,India
612331,2023-04-02,211,red bull,90,125,35,2,00464,India
843985,2023-04-02,208,sprite,75,100,25,2,00439,India
843985,2023-04-02,207,coca cola,75,100,25,2,00439,India
409842,2023-04-02,202,milk,12,27,15,1,00409,India
409842,2023-04-02,210,mountain dew,75,100,25,2,00409,India
409842,2023-04-02,204,strawberry yogurt,50,60,10,2,00409,India
409842,2023-04-02,213,bisleri,6,15,9,2,00409,India
409842,2023-04-02,206,yakult,360,400,40,2,00409,India
315882,2023-04-02,213,bisleri,6,15,9,2,00475,India
187187,2023-04-02,201,paneer,210,340,130,1,00302,India
187187,2023-04-02,204,strawberry yogurt,50,60,10,2,00302,India
833943,2023-04-02,209,pepsi,75,100,25,2,00491,India
833943,2023-04-02,201,paneer,210,340,130,1,00491,India
779491,2023-04-02,203,mango yogurt,50,60,10,2,00346,India
779491,2023-04-02,213,bisleri,6,15,9,2,00346,India
779491,2023-04-02,204,strawberry yogurt,50,60,10,2,00346,India
779491,2023-04-02,208,sprite,75,100,25,2,00346,India
214763,2023-04-02,210,mountain dew,75,100,25,2,00280,India
214763,2023-04-02,201,paneer,210,340,130,1,00280,India
214763,2023-04-02,202,milk,12,27,15,1,00280,India
214763,2023-04-02,206,yakult,360,400,40,2,00280,India
560326,2023-04-02,205,classic yogurt,45,60,15,2,00276,India
560326,2023-04-02,204,strawberry yogurt,50,60,10,2,00276,India
742701,2023-04-02,211,red bull,90,125,35,2,00188,India
742701,2023-04-02,201,paneer,210,340,130,1,00188,India
742701,2023-04-02,202,milk,12,27,15,1,00188,India
742701,2023-04-02,213,bisleri,6,15,9,2,00188,India
216567,2023-04-02,208,sprite,75,100,25,2,00230,India
216567,2023-04-02,211,red bull,90,125,35,2,00230,India
216567,2023-04-02,210,mountain dew,75,100,25,2,00230,India
216567,2023-04-02,205,classic yogurt,45,60,15,2,00230,India
216567,2023-04-02,204,strawberry yogurt,50,60,10,2,00230,India
394033,2023-04-02,210,mountain dew,75,100,25,2,00433,India
394033,2023-04-02,201,paneer,210,340,130,1,00433,India
678467,2023-04-02,201,paneer,210,340,130,1,00466,India
678467,2023-04-02,211,red bull,90,125,35,2,00466,India
678467,2023-04-02,213,bisleri,6,15,9,2,00466,India
425510,2023-04-02,206,yakult,360,400,40,2,00384,India
323274,2023-04-02,213,bisleri,6,15,9,2,00400,India
323274,2023-04-02,204,strawberry yogurt,50,60,10,2,00400,India
842826,2023-04-02,209,pepsi,75,100,25,2,00286,India
170077,2023-04-02,211,red bull,90,125,35,2,00482,India
170077,2023-04-02,202,milk,12,27,15,1,00482,India
170077,2023-04-02,201,paneer,210,340,130,1,00482,India
321321,2023-04-02,205,classic yogurt,45,60,15,2,00131,India
439169,2023-04-02,205,classic yogurt,45,60,15,2,00418,India
439169,2023-04-02,201,paneer,210,340,130,1,00418,India
439169,2023-04-02,209,pepsi,75,100,25,2,00418,India
439169,2023-04-02,210,mountain dew,75,100,25,2,00418,India
793774,2023-04-02,213,bisleri,6,15,9,2,00295,India
793774,2023-04-02,204,strawberry yogurt,50,60,10,2,00295,India
793774,2023-04-02,207,coca cola,75,100,25,2,00295,India
892168,2023-04-02,213,bisleri,6,15,9,2,00074,India
892168,2023-04-02,207,coca cola,75,100,25,2,00074,India
892168,2023-04-02,205,classic yogurt,45,60,15,2,00074,India
892168,2023-04-02,201,paneer,210,340,130,1,00074,India
624944,2023-04-02,211,red bull,90,125,35,2,00477,India
624944,2023-04-02,213,bisleri,6,15,9,2,00477,India
230171,2023-04-02,209,pepsi,75,100,25,2,00438,India
230171,2023-04-02,201,paneer,210,340,130,1,00438,India
230171,2023-04-02,204,strawberry yogurt,50,60,10,2,00438,India
230171,2023-04-02,212,amul cheese,250,315,65,1,00438,India
204563,2023-04-02,211,red bull,90,125,35,2,00167,India
204563,2023-04-02,206,yakult,360,400,40,2,00167,India
221651,2023-04-02,201,paneer,210,340,130,1,00160,India
221651,2023-04-02,208,sprite,75,100,25,2,00160,India
463604,2023-04-02,203,mango yogurt,50,60,10,2,00313,India
463604,2023-04-02,202,milk,12,27,15,1,00313,India
274815,2023-04-02,202,milk,12,27,15,1,00180,India
274815,2023-04-02,208,sprite,75,100,25,2,00180,India
274815,2023-04-02,209,pepsi,75,100,25,2,00180,India
642525,2023-04-02,202,milk,12,27,15,1,00430,India
642525,2023-04-02,208,sprite,75,100,25,2,00430,India
952203,2023-04-02,208,sprite,75,100,25,2,00192,India
952203,2023-04-02,207,coca cola,75,100,25,2,00192,India
952203,2023-04-02,205,classic yogurt,45,60,15,2,00192,India
274377,2023-04-02,207,coca cola,75,100,25,2,00246,India
354530,2023-04-02,213,bisleri,6,15,9,2,00439,India
354530,2023-04-02,204,strawberry yogurt,50,60,10,2,00439,India
234462,2023-04-02,210,mountain dew,75,100,25,2,00032,India
531534,2023-04-02,206,yakult,360,400,40,2,00089,India
531534,2023-04-02,210,mountain dew,75,100,25,2,00089,India
766327,2023-04-02,207,coca cola,75,100,25,2,00428,India
380841,2023-04-02,210,mountain dew,75,100,25,2,00150,India
580743,2023-04-02,211,red bull,90,125,35,2,00134,India
580743,2023-04-02,210,mountain dew,75,100,25,2,00134,India
580743,2023-04-02,212,amul cheese,250,315,65,1,00134,India
580743,2023-04-02,203,mango yogurt,50,60,10,2,00134,India
857187,2023-04-02,211,red bull,90,125,35,2,00487,India
857187,2023-04-02,212,amul cheese,250,315,65,1,00487,India
857187,2023-04-02,205,classic yogurt,45,60,15,2,00487,India
698640,2023-04-02,210,mountain dew,75,100,25,2,00250,India
607940,2023-04-02,204,strawberry yogurt,50,60,10,2,00159,India
607940,2023-04-02,207,coca cola,75,100,25,2,00159,India
559772,2023-04-02,203,mango yogurt,50,60,10,2,00044,India
559772,2023-04-02,211,red bull,90,125,35,2,00044,India
559772,2023-04-02,212,amul cheese,250,315,65,1,00044,India
559772,2023-04-02,206,yakult,360,400,40,2,00044,India
559772,2023-04-02,208,sprite,75,100,25,2,00044,India
896444,2023-04-02,204,strawberry yogurt,50,60,10,2,00487,India
896444,2023-04-02,201,paneer,210,340,130,1,00487,India
756742,2023-04-02,207,coca cola,75,100,25,2,00418,India
756742,2023-04-02,211,red bull,90,125,35,2,00418,India
756742,2023-04-02,205,classic yogurt,45,60,15,2,00418,India
756742,2023-04-02,206,yakult,360,400,40,2,00418,India
491866,2023-04-02,207,coca cola,75,100,25,2,00329,India
491866,2023-04-02,209,pepsi,75,100,25,2,00329,India
334505,2023-04-02,201,paneer,210,340,130,1,00287,India
334505,2023-04-02,211,red bull,90,125,35,2,00287,India
334505,2023-04-02,208,sprite,75,100,25,2,00287,India
244880,2023-04-02,210,mountain dew,75,100,25,2,00262,India
244880,2023-04-02,209,pepsi,75,100,25,2,00262,India
374991,2023-04-02,202,milk,12,27,15,1,00195,India
374991,2023-04-02,209,pepsi,75,100,25,2,00195,India
987645,2023-04-03,204,strawberry yogurt,50,60,10,2,00007,India
330743,2023-04-03,208,sprite,75,100,25,2,00014,India
949862,2023-04-03,211,red bull,90,125,35,2,00452,India
486994,2023-04-03,210,mountain dew,75,100,25,2,00014,India
486994,2023-04-03,207,coca cola,75,100,25,2,00014,India
486994,2023-04-03,213,bisleri,6,15,9,2,00014,India
486994,2023-04-03,209,pepsi,75,100,25,2,00014,India
679984,2023-04-03,208,sprite,75,100,25,2,00246,India
679984,2023-04-03,205,classic yogurt,45,60,15,2,00246,India
679984,2023-04-03,207,coca cola,75,100,25,2,00246,India
679984,2023-04-03,203,mango yogurt,50,60,10,2,00246,India
173122,2023-04-03,211,red bull,90,125,35,2,00472,India
173122,2023-04-03,204,strawberry yogurt,50,60,10,2,00472,India
298601,2023-04-03,213,bisleri,6,15,9,2,00173,India
639438,2023-04-03,208,sprite,75,100,25,2,00329,India
639438,2023-04-03,206,yakult,360,400,40,2,00329,India
515668,2023-04-03,209,pepsi,75,100,25,2,00124,India
515668,2023-04-03,205,classic yogurt,45,60,15,2,00124,India
246142,2023-04-03,210,mountain dew,75,100,25,2,00456,India
246142,2023-04-03,209,pepsi,75,100,25,2,00456,India
246142,2023-04-03,211,red bull,90,125,35,2,00456,India
973187,2023-04-03,211,red bull,90,125,35,2,00377,India
973187,2023-04-03,204,strawberry yogurt,50,60,10,2,00377,India
827881,2023-04-03,205,classic yogurt,45,60,15,2,00055,India
678380,2023-04-03,202,milk,12,27,15,1,00415,India
678380,2023-04-03,213,bisleri,6,15,9,2,00415,India
996951,2023-04-03,203,mango yogurt,50,60,10,2,00125,India
996951,2023-04-03,205,classic yogurt,45,60,15,2,00125,India
574118,2023-04-03,207,coca cola,75,100,25,2,00312,India
574118,2023-04-03,203,mango yogurt,50,60,10,2,00312,India
574118,2023-04-03,212,amul cheese,250,315,65,1,00312,India
696785,2023-04-03,207,coca cola,75,100,25,2,00316,India
696785,2023-04-03,211,red bull,90,125,35,2,00316,India
696785,2023-04-03,204,strawberry yogurt,50,60,10,2,00316,India
323597,2023-04-03,211,red bull,90,125,35,2,00227,India
778922,2023-04-03,207,coca cola,75,100,25,2,00044,India
778922,2023-04-03,201,paneer,210,340,130,1,00044,India
778922,2023-04-03,205,classic yogurt,45,60,15,2,00044,India
536512,2023-04-03,202,milk,12,27,15,1,00158,India
536512,2023-04-03,204,strawberry yogurt,50,60,10,2,00158,India
536512,2023-04-03,206,yakult,360,400,40,2,00158,India
536512,2023-04-03,203,mango yogurt,50,60,10,2,00158,India
879996,2023-04-03,208,sprite,75,100,25,2,00099,India
879996,2023-04-03,212,amul cheese,250,315,65,1,00099,India
879996,2023-04-03,207,coca cola,75,100,25,2,00099,India
879996,2023-04-03,209,pepsi,75,100,25,2,00099,India
516387,2023-04-03,205,classic yogurt,45,60,15,2,00403,India
516387,2023-04-03,211,red bull,90,125,35,2,00403,India
516387,2023-04-03,207,coca cola,75,100,25,2,00403,India
482038,2023-04-03,213,bisleri,6,15,9,2,00179,India
482038,2023-04-03,206,yakult,360,400,40,2,00179,India
482038,2023-04-03,207,coca cola,75,100,25,2,00179,India
482038,2023-04-03,205,classic yogurt,45,60,15,2,00179,India
647037,2023-04-03,206,yakult,360,400,40,2,00160,India
647037,2023-04-03,213,bisleri,6,15,9,2,00160,India
647037,2023-04-03,209,pepsi,75,100,25,2,00160,India
647037,2023-04-03,210,mountain dew,75,100,25,2,00160,India
647037,2023-04-03,208,sprite,75,100,25,2,00160,India
799541,2023-04-03,209,pepsi,75,100,25,2,00293,India
799541,2023-04-03,203,mango yogurt,50,60,10,2,00293,India
799541,2023-04-03,210,mountain dew,75,100,25,2,00293,India
799541,2023-04-03,212,amul cheese,250,315,65,1,00293,India
855698,2023-04-03,211,red bull,90,125,35,2,00074,India
855698,2023-04-03,209,pepsi,75,100,25,2,00074,India
855698,2023-04-03,212,amul cheese,250,315,65,1,00074,India
726919,2023-04-03,210,mountain dew,75,100,25,2,00042,India
726919,2023-04-03,211,red bull,90,125,35,2,00042,India
726919,2023-04-03,204,strawberry yogurt,50,60,10,2,00042,India
187534,2023-04-03,213,bisleri,6,15,9,2,00189,India
187534,2023-04-03,202,milk,12,27,15,1,00189,India
413107,2023-04-03,204,strawberry yogurt,50,60,10,2,00274,India
413107,2023-04-03,205,classic yogurt,45,60,15,2,00274,India
413107,2023-04-03,209,pepsi,75,100,25,2,00274,India
413107,2023-04-03,208,sprite,75,100,25,2,00274,India
413107,2023-04-03,207,coca cola,75,100,25,2,00274,India
263769,2023-04-03,203,mango yogurt,50,60,10,2,00221,India
263769,2023-04-03,202,milk,12,27,15,1,00221,India
847823,2023-04-03,212,amul cheese,250,315,65,1,00034,India
847823,2023-04-03,207,coca cola,75,100,25,2,00034,India
847823,2023-04-03,206,yakult,360,400,40,2,00034,India
847823,2023-04-03,209,pepsi,75,100,25,2,00034,India
657059,2023-04-03,207,coca cola,75,100,25,2,00120,India
657059,2023-04-03,203,mango yogurt,50,60,10,2,00120,India
469150,2023-04-03,209,pepsi,75,100,25,2,00477,India
469150,2023-04-03,204,strawberry yogurt,50,60,10,2,00477,India
469150,2023-04-03,208,sprite,75,100,25,2,00477,India
469150,2023-04-03,203,mango yogurt,50,60,10,2,00477,India
102305,2023-04-03,212,amul cheese,250,315,65,1,00377,India
506258,2023-04-03,209,pepsi,75,100,25,2,00020,India
506258,2023-04-03,204,strawberry yogurt,50,60,10,2,00020,India
506258,2023-04-03,211,red bull,90,125,35,2,00020,India
798035,2023-04-03,213,bisleri,6,15,9,2,00390,India
798035,2023-04-03,203,mango yogurt,50,60,10,2,00390,India
423280,2023-04-03,211,red bull,90,125,35,2,00113,India
423280,2023-04-03,203,mango yogurt,50,60,10,2,00113,India
423280,2023-04-03,205,classic yogurt,45,60,15,2,00113,India
258330,2023-04-03,204,strawberry yogurt,50,60,10,2,00244,India
258330,2023-04-03,208,sprite,75,100,25,2,00244,India
223950,2023-04-03,212,amul cheese,250,315,65,1,00014,India
223950,2023-04-03,205,classic yogurt,45,60,15,2,00014,India
223950,2023-04-03,213,bisleri,6,15,9,2,00014,India
223950,2023-04-03,203,mango yogurt,50,60,10,2,00014,India
492486,2023-04-03,209,pepsi,75,100,25,2,00486,India
492486,2023-04-03,206,yakult,360,400,40,2,00486,India
333059,2023-04-03,209,pepsi,75,100,25,2,00045,India
743922,2023-04-03,213,bisleri,6,15,9,2,00270,India
743922,2023-04-03,207,coca cola,75,100,25,2,00270,India
743922,2023-04-03,212,amul cheese,250,315,65,1,00270,India
895783,2023-04-03,206,yakult,360,400,40,2,00086,India
895783,2023-04-03,213,bisleri,6,15,9,2,00086,India
884883,2023-04-03,202,milk,12,27,15,1,00085,India
430448,2023-04-03,212,amul cheese,250,315,65,1,00367,India
430448,2023-04-03,205,classic yogurt,45,60,15,2,00367,India
430448,2023-04-03,204,strawberry yogurt,50,60,10,2,00367,India
584163,2023-04-03,204,strawberry yogurt,50,60,10,2,00398,India
584163,2023-04-03,208,sprite,75,100,25,2,00398,India
584163,2023-04-03,209,pepsi,75,100,25,2,00398,India
584163,2023-04-03,206,yakult,360,400,40,2,00398,India
919562,2023-04-03,205,classic yogurt,45,60,15,2,00192,India
919562,2023-04-03,201,paneer,210,340,130,1,00192,India
919562,2023-04-03,213,bisleri,6,15,9,2,00192,India
342162,2023-04-03,210,mountain dew,75,100,25,2,00019,India
342162,2023-04-03,213,bisleri,6,15,9,2,00019,India
342162,2023-04-03,211,red bull,90,125,35,2,00019,India
432751,2023-04-03,205,classic yogurt,45,60,15,2,00324,India
840870,2023-04-03,202,milk,12,27,15,1,00420,India
923515,2023-04-03,205,classic yogurt,45,60,15,2,00163,India
923515,2023-04-03,212,amul cheese,250,315,65,1,00163,India
923515,2023-04-03,210,mountain dew,75,100,25,2,00163,India
371450,2023-04-03,204,strawberry yogurt,50,60,10,2,00225,India
371450,2023-04-03,202,milk,12,27,15,1,00225,India
371450,2023-04-03,209,pepsi,75,100,25,2,00225,India
592631,2023-04-03,205,classic yogurt,45,60,15,2,00316,India
437615,2023-04-03,210,mountain dew,75,100,25,2,00487,India
437615,2023-04-03,208,sprite,75,100,25,2,00487,India
437615,2023-04-03,204,strawberry yogurt,50,60,10,2,00487,India
387788,2023-04-03,204,strawberry yogurt,50,60,10,2,00197,India
387788,2023-04-03,206,yakult,360,400,40,2,00197,India
387788,2023-04-03,210,mountain dew,75,100,25,2,00197,India
387788,2023-04-03,211,red bull,90,125,35,2,00197,India
387788,2023-04-03,213,bisleri,6,15,9,2,00197,India
319201,2023-04-03,207,coca cola,75,100,25,2,00256,India
319201,2023-04-03,213,bisleri,6,15,9,2,00256,India
319201,2023-04-03,210,mountain dew,75,100,25,2,00256,India
319201,2023-04-03,205,classic yogurt,45,60,15,2,00256,India
319201,2023-04-03,201,paneer,210,340,130,1,00256,India
298725,2023-04-03,206,yakult,360,400,40,2,00201,India
298725,2023-04-03,203,mango yogurt,50,60,10,2,00201,India
727283,2023-04-03,204,strawberry yogurt,50,60,10,2,00466,India
613605,2023-04-03,211,red bull,90,125,35,2,00271,India
613605,2023-04-03,206,yakult,360,400,40,2,00271,India
613605,2023-04-03,205,classic yogurt,45,60,15,2,00271,India
963700,2023-04-03,207,coca cola,75,100,25,2,00341,India
963700,2023-04-03,206,yakult,360,400,40,2,00341,India
963700,2023-04-03,213,bisleri,6,15,9,2,00341,India
227428,2023-04-03,203,mango yogurt,50,60,10,2,00273,India
227428,2023-04-03,213,bisleri,6,15,9,2,00273,India
227428,2023-04-03,201,paneer,210,340,130,1,00273,India
532047,2023-04-03,213,bisleri,6,15,9,2,00383,India
532047,2023-04-03,211,red bull,90,125,35,2,00383,India
532047,2023-04-03,208,sprite,75,100,25,2,00383,India
532047,2023-04-03,209,pepsi,75,100,25,2,00383,India
532047,2023-04-03,201,paneer,210,340,130,1,00383,India
520880,2023-04-03,207,coca cola,75,100,25,2,00255,India
520880,2023-04-03,205,classic yogurt,45,60,15,2,00255,India
520880,2023-04-03,210,mountain dew,75,100,25,2,00255,India
520880,2023-04-03,212,amul cheese,250,315,65,1,00255,India
375801,2023-04-03,213,bisleri,6,15,9,2,00156,India
375801,2023-04-03,208,sprite,75,100,25,2,00156,India
375801,2023-04-03,205,classic yogurt,45,60,15,2,00156,India
375801,2023-04-03,203,mango yogurt,50,60,10,2,00156,India
777479,2023-04-03,207,coca cola,75,100,25,2,00296,India
777479,2023-04-03,212,amul cheese,250,315,65,1,00296,India
777479,2023-04-03,209,pepsi,75,100,25,2,00296,India
777479,2023-04-03,205,classic yogurt,45,60,15,2,00296,India
946346,2023-04-03,213,bisleri,6,15,9,2,00434,India
946346,2023-04-03,204,strawberry yogurt,50,60,10,2,00434,India
946346,2023-04-03,206,yakult,360,400,40,2,00434,India
946346,2023-04-03,211,red bull,90,125,35,2,00434,India
946346,2023-04-03,205,classic yogurt,45,60,15,2,00434,India
734193,2023-04-03,211,red bull,90,125,35,2,00250,India
734193,2023-04-03,208,sprite,75,100,25,2,00250,India
734193,2023-04-03,212,amul cheese,250,315,65,1,00250,India
102409,2023-04-03,210,mountain dew,75,100,25,2,00111,India
239646,2023-04-03,213,bisleri,6,15,9,2,00007,India
314258,2023-04-03,206,yakult,360,400,40,2,00271,India
314258,2023-04-03,212,amul cheese,250,315,65,1,00271,India
314258,2023-04-03,207,coca cola,75,100,25,2,00271,India
314258,2023-04-03,211,red bull,90,125,35,2,00271,India
314258,2023-04-03,201,paneer,210,340,130,1,00271,India
175844,2023-04-03,210,mountain dew,75,100,25,2,00355,India
175844,2023-04-03,202,milk,12,27,15,1,00355,India
175844,2023-04-03,206,yakult,360,400,40,2,00355,India
175844,2023-04-03,212,amul cheese,250,315,65,1,00355,India
175844,2023-04-03,209,pepsi,75,100,25,2,00355,India
505679,2023-04-03,207,coca cola,75,100,25,2,00304,India
505679,2023-04-03,212,amul cheese,250,315,65,1,00304,India
530944,2023-04-03,207,coca cola,75,100,25,2,00062,India
530944,2023-04-03,212,amul cheese,250,315,65,1,00062,India
132509,2023-04-03,213,bisleri,6,15,9,2,00313,India
132509,2023-04-03,211,red bull,90,125,35,2,00313,India
132509,2023-04-03,202,milk,12,27,15,1,00313,India
476333,2023-04-03,213,bisleri,6,15,9,2,00319,India
455353,2023-04-03,210,mountain dew,75,100,25,2,00483,India
455353,2023-04-03,208,sprite,75,100,25,2,00483,India
455353,2023-04-03,205,classic yogurt,45,60,15,2,00483,India
455353,2023-04-03,201,paneer,210,340,130,1,00483,India
933890,2023-04-03,204,strawberry yogurt,50,60,10,2,00338,India
933890,2023-04-03,202,milk,12,27,15,1,00338,India
933890,2023-04-03,210,mountain dew,75,100,25,2,00338,India
933890,2023-04-03,203,mango yogurt,50,60,10,2,00338,India
933890,2023-04-03,211,red bull,90,125,35,2,00338,India
957077,2023-04-03,204,strawberry yogurt,50,60,10,2,00450,India
957077,2023-04-03,212,amul cheese,250,315,65,1,00450,India
957077,2023-04-03,209,pepsi,75,100,25,2,00450,India
827576,2023-04-03,207,coca cola,75,100,25,2,00464,India
827576,2023-04-03,213,bisleri,6,15,9,2,00464,India
827576,2023-04-03,201,paneer,210,340,130,1,00464,India
988430,2023-04-03,207,coca cola,75,100,25,2,00093,India
988430,2023-04-03,209,pepsi,75,100,25,2,00093,India
988430,2023-04-03,208,sprite,75,100,25,2,00093,India
916777,2023-04-03,205,classic yogurt,45,60,15,2,00139,India
101191,2023-04-03,201,paneer,210,340,130,1,00019,India
101191,2023-04-03,203,mango yogurt,50,60,10,2,00019,India
101191,2023-04-03,204,strawberry yogurt,50,60,10,2,00019,India
365175,2023-04-03,203,mango yogurt,50,60,10,2,00012,India
572592,2023-04-03,201,paneer,210,340,130,1,00204,India
572592,2023-04-03,209,pepsi,75,100,25,2,00204,India
637530,2023-04-03,202,milk,12,27,15,1,00015,India
637530,2023-04-03,213,bisleri,6,15,9,2,00015,India
301862,2023-04-03,206,yakult,360,400,40,2,00300,India
301862,2023-04-03,208,sprite,75,100,25,2,00300,India
301862,2023-04-03,211,red bull,90,125,35,2,00300,India
301862,2023-04-03,213,bisleri,6,15,9,2,00300,India
301862,2023-04-03,205,classic yogurt,45,60,15,2,00300,India
377304,2023-04-03,205,classic yogurt,45,60,15,2,00132,India
377304,2023-04-03,203,mango yogurt,50,60,10,2,00132,India
852345,2023-04-04,209,pepsi,75,100,25,2,00257,India
861879,2023-04-04,208,sprite,75,100,25,2,00404,India
912272,2023-04-04,201,paneer,210,340,130,1,00414,India
912272,2023-04-04,209,pepsi,75,100,25,2,00414,India
417719,2023-04-04,211,red bull,90,125,35,2,00288,India
417719,2023-04-04,202,milk,12,27,15,1,00288,India
417719,2023-04-04,207,coca cola,75,100,25,2,00288,India
611082,2023-04-04,203,mango yogurt,50,60,10,2,00364,India
611082,2023-04-04,213,bisleri,6,15,9,2,00364,India
644031,2023-04-04,202,milk,12,27,15,1,00027,India
644031,2023-04-04,212,amul cheese,250,315,65,1,00027,India
644031,2023-04-04,210,mountain dew,75,100,25,2,00027,India
644031,2023-04-04,204,strawberry yogurt,50,60,10,2,00027,India
643823,2023-04-04,209,pepsi,75,100,25,2,00371,India
643823,2023-04-04,208,sprite,75,100,25,2,00371,India
643823,2023-04-04,202,milk,12,27,15,1,00371,India
892142,2023-04-04,204,strawberry yogurt,50,60,10,2,00468,India
689783,2023-04-04,203,mango yogurt,50,60,10,2,00449,India
689783,2023-04-04,209,pepsi,75,100,25,2,00449,India
689783,2023-04-04,210,mountain dew,75,100,25,2,00449,India
104086,2023-04-04,210,mountain dew,75,100,25,2,00452,India
104086,2023-04-04,206,yakult,360,400,40,2,00452,India
104086,2023-04-04,204,strawberry yogurt,50,60,10,2,00452,India
115386,2023-04-04,203,mango yogurt,50,60,10,2,00054,India
115386,2023-04-04,209,pepsi,75,100,25,2,00054,India
115386,2023-04-04,212,amul cheese,250,315,65,1,00054,India
115386,2023-04-04,207,coca cola,75,100,25,2,00054,India
667781,2023-04-04,213,bisleri,6,15,9,2,00101,India
667781,2023-04-04,204,strawberry yogurt,50,60,10,2,00101,India
667781,2023-04-04,210,mountain dew,75,100,25,2,00101,India
976803,2023-04-04,211,red bull,90,125,35,2,00169,India
976803,2023-04-04,204,strawberry yogurt,50,60,10,2,00169,India
976803,2023-04-04,203,mango yogurt,50,60,10,2,00169,India
957411,2023-04-04,205,classic yogurt,45,60,15,2,00406,India
957411,2023-04-04,210,mountain dew,75,100,25,2,00406,India
259688,2023-04-04,201,paneer,210,340,130,1,00240,India
563618,2023-04-04,205,classic yogurt,45,60,15,2,00466,India
563618,2023-04-04,211,red bull,90,125,35,2,00466,India
563618,2023-04-04,213,bisleri,6,15,9,2,00466,India
706701,2023-04-04,212,amul cheese,250,315,65,1,00339,India
706701,2023-04-04,204,strawberry yogurt,50,60,10,2,00339,India
706701,2023-04-04,202,milk,12,27,15,1,00339,India
192540,2023-04-04,202,milk,12,27,15,1,00258,India
192540,2023-04-04,212,amul cheese,250,315,65,1,00258,India
359379,2023-04-04,207,coca cola,75,100,25,2,00376,India
359379,2023-04-04,203,mango yogurt,50,60,10,2,00376,India
359379,2023-04-04,205,classic yogurt,45,60,15,2,00376,India
359379,2023-04-04,209,pepsi,75,100,25,2,00376,India
964767,2023-04-04,204,strawberry yogurt,50,60,10,2,00077,India
838681,2023-04-04,206,yakult,360,400,40,2,00258,India
838681,2023-04-04,210,mountain dew,75,100,25,2,00258,India
838681,2023-04-04,202,milk,12,27,15,1,00258,India
285920,2023-04-04,213,bisleri,6,15,9,2,00147,India
555545,2023-04-04,205,classic yogurt,45,60,15,2,00268,India
555545,2023-04-04,204,strawberry yogurt,50,60,10,2,00268,India
746354,2023-04-04,209,pepsi,75,100,25,2,00030,India
746354,2023-04-04,208,sprite,75,100,25,2,00030,India
477682,2023-04-04,209,pepsi,75,100,25,2,00411,India
477682,2023-04-04,203,mango yogurt,50,60,10,2,00411,India
477682,2023-04-04,210,mountain dew,75,100,25,2,00411,India
477682,2023-04-04,206,yakult,360,400,40,2,00411,India
704874,2023-04-04,202,milk,12,27,15,1,00249,India
704874,2023-04-04,207,coca cola,75,100,25,2,00249,India
216159,2023-04-04,205,classic yogurt,45,60,15,2,00078,India
620872,2023-04-04,202,milk,12,27,15,1,00058,India
620872,2023-04-04,208,sprite,75,100,25,2,00058,India
620872,2023-04-04,201,paneer,210,340,130,1,00058,India
155538,2023-04-04,209,pepsi,75,100,25,2,00149,India
475947,2023-04-04,203,mango yogurt,50,60,10,2,00252,India
475947,2023-04-04,204,strawberry yogurt,50,60,10,2,00252,India
626676,2023-04-04,208,sprite,75,100,25,2,00050,India
626676,2023-04-04,213,bisleri,6,15,9,2,00050,India
119943,2023-04-04,213,bisleri,6,15,9,2,00266,India
119943,2023-04-04,211,red bull,90,125,35,2,00266,India
840561,2023-04-04,207,coca cola,75,100,25,2,00242,India
840561,2023-04-04,201,paneer,210,340,130,1,00242,India
751650,2023-04-04,212,amul cheese,250,315,65,1,00340,India
751650,2023-04-04,201,paneer,210,340,130,1,00340,India
751650,2023-04-04,202,milk,12,27,15,1,00340,India
485942,2023-04-04,208,sprite,75,100,25,2,00193,India
485942,2023-04-04,205,classic yogurt,45,60,15,2,00193,India
485942,2023-04-04,201,paneer,210,340,130,1,00193,India
626021,2023-04-04,210,mountain dew,75,100,25,2,00006,India
626021,2023-04-04,201,paneer,210,340,130,1,00006,India
626021,2023-04-04,209,pepsi,75,100,25,2,00006,India
626021,2023-04-04,207,coca cola,75,100,25,2,00006,India
135733,2023-04-04,202,milk,12,27,15,1,00498,India
496167,2023-04-04,213,bisleri,6,15,9,2,00235,India
496167,2023-04-04,203,mango yogurt,50,60,10,2,00235,India
987999,2023-04-04,202,milk,12,27,15,1,00121,India
810831,2023-04-04,201,paneer,210,340,130,1,00292,India
810831,2023-04-04,207,coca cola,75,100,25,2,00292,India
810831,2023-04-04,211,red bull,90,125,35,2,00292,India
721904,2023-04-04,210,mountain dew,75,100,25,2,00308,India
721904,2023-04-04,207,coca cola,75,100,25,2,00308,India
721904,2023-04-04,212,amul cheese,250,315,65,1,00308,India
721904,2023-04-04,202,milk,12,27,15,1,00308,India
788620,2023-04-04,203,mango yogurt,50,60,10,2,00392,India
788620,2023-04-04,204,strawberry yogurt,50,60,10,2,00392,India
788620,2023-04-04,207,coca cola,75,100,25,2,00392,India
788620,2023-04-04,209,pepsi,75,100,25,2,00392,India
287392,2023-04-04,205,classic yogurt,45,60,15,2,00087,India
287392,2023-04-04,211,red bull,90,125,35,2,00087,India
962940,2023-04-04,211,red bull,90,125,35,2,00241,India
962940,2023-04-04,212,amul cheese,250,315,65,1,00241,India
962940,2023-04-04,203,mango yogurt,50,60,10,2,00241,India
962940,2023-04-04,205,classic yogurt,45,60,15,2,00241,India
651713,2023-04-04,201,paneer,210,340,130,1,00015,India
651713,2023-04-04,202,milk,12,27,15,1,00015,India
651713,2023-04-04,213,bisleri,6,15,9,2,00015,India
651713,2023-04-04,211,red bull,90,125,35,2,00015,India
649541,2023-04-04,208,sprite,75,100,25,2,00055,India
774169,2023-04-04,210,mountain dew,75,100,25,2,00131,India
617716,2023-04-04,211,red bull,90,125,35,2,00004,India
617716,2023-04-04,201,paneer,210,340,130,1,00004,India
910842,2023-04-04,210,mountain dew,75,100,25,2,00126,India
910842,2023-04-04,211,red bull,90,125,35,2,00126,India
910842,2023-04-04,212,amul cheese,250,315,65,1,00126,India
990286,2023-04-04,201,paneer,210,340,130,1,00059,India
103148,2023-04-04,201,paneer,210,340,130,1,00324,India
103148,2023-04-04,209,pepsi,75,100,25,2,00324,India
103148,2023-04-04,210,mountain dew,75,100,25,2,00324,India
103148,2023-04-04,208,sprite,75,100,25,2,00324,India
103148,2023-04-04,213,bisleri,6,15,9,2,00324,India
248768,2023-04-04,203,mango yogurt,50,60,10,2,00293,India
248768,2023-04-04,204,strawberry yogurt,50,60,10,2,00293,India
865360,2023-04-04,213,bisleri,6,15,9,2,00236,India
865360,2023-04-04,209,pepsi,75,100,25,2,00236,India
865360,2023-04-04,205,classic yogurt,45,60,15,2,00236,India
865360,2023-04-04,202,milk,12,27,15,1,00236,India
399821,2023-04-04,201,paneer,210,340,130,1,00433,India
323360,2023-04-04,211,red bull,90,125,35,2,00329,India
314029,2023-04-04,209,pepsi,75,100,25,2,00047,India
314029,2023-04-04,211,red bull,90,125,35,2,00047,India
314029,2023-04-04,208,sprite,75,100,25,2,00047,India
314029,2023-04-04,207,coca cola,75,100,25,2,00047,India
314029,2023-04-04,202,milk,12,27,15,1,00047,India
409880,2023-04-04,203,mango yogurt,50,60,10,2,00211,India
409880,2023-04-04,205,classic yogurt,45,60,15,2,00211,India
525549,2023-04-04,212,amul cheese,250,315,65,1,00434,India
683939,2023-04-04,201,paneer,210,340,130,1,00427,India
683939,2023-04-04,206,yakult,360,400,40,2,00427,India
683939,2023-04-04,203,mango yogurt,50,60,10,2,00427,India
683939,2023-04-04,212,amul cheese,250,315,65,1,00427,India
882675,2023-04-04,210,mountain dew,75,100,25,2,00352,India
882675,2023-04-04,209,pepsi,75,100,25,2,00352,India
882675,2023-04-04,204,strawberry yogurt,50,60,10,2,00352,India
669883,2023-04-04,212,amul cheese,250,315,65,1,00360,India
669883,2023-04-04,210,mountain dew,75,100,25,2,00360,India
460778,2023-04-04,213,bisleri,6,15,9,2,00206,India
460778,2023-04-04,212,amul cheese,250,315,65,1,00206,India
415863,2023-04-04,201,paneer,210,340,130,1,00245,India
546592,2023-04-04,205,classic yogurt,45,60,15,2,00047,India
245267,2023-04-04,205,classic yogurt,45,60,15,2,00252,India
245267,2023-04-04,209,pepsi,75,100,25,2,00252,India
992190,2023-04-04,202,milk,12,27,15,1,00118,India
992190,2023-04-04,209,pepsi,75,100,25,2,00118,India
992190,2023-04-04,203,mango yogurt,50,60,10,2,00118,India
992190,2023-04-04,210,mountain dew,75,100,25,2,00118,India
992190,2023-04-04,201,paneer,210,340,130,1,00118,India
323421,2023-04-05,207,coca cola,75,100,25,2,00299,India
323421,2023-04-05,203,mango yogurt,50,60,10,2,00299,India
323421,2023-04-05,210,mountain dew,75,100,25,2,00299,India
109469,2023-04-05,212,amul cheese,250,315,65,1,00076,India
109469,2023-04-05,211,red bull,90,125,35,2,00076,India
109469,2023-04-05,204,strawberry yogurt,50,60,10,2,00076,India
109469,2023-04-05,213,bisleri,6,15,9,2,00076,India
797508,2023-04-05,204,strawberry yogurt,50,60,10,2,00467,India
797508,2023-04-05,203,mango yogurt,50,60,10,2,00467,India
797508,2023-04-05,201,paneer,210,340,130,1,00467,India
797508,2023-04-05,212,amul cheese,250,315,65,1,00467,India
797508,2023-04-05,202,milk,12,27,15,1,00467,India
587038,2023-04-05,206,yakult,360,400,40,2,00063,India
587038,2023-04-05,210,mountain dew,75,100,25,2,00063,India
587038,2023-04-05,207,coca cola,75,100,25,2,00063,India
217832,2023-04-05,212,amul cheese,250,315,65,1,00463,India
486176,2023-04-05,209,pepsi,75,100,25,2,00369,India
808492,2023-04-05,213,bisleri,6,15,9,2,00135,India
808492,2023-04-05,211,red bull,90,125,35,2,00135,India
808492,2023-04-05,204,strawberry yogurt,50,60,10,2,00135,India
105103,2023-04-05,201,paneer,210,340,130,1,00260,India
105103,2023-04-05,202,milk,12,27,15,1,00260,India
844744,2023-04-05,209,pepsi,75,100,25,2,00239,India
844744,2023-04-05,205,classic yogurt,45,60,15,2,00239,India
844744,2023-04-05,207,coca cola,75,100,25,2,00239,India
571971,2023-04-05,208,sprite,75,100,25,2,00371,India
952256,2023-04-05,201,paneer,210,340,130,1,00431,India
952256,2023-04-05,209,pepsi,75,100,25,2,00431,India
952256,2023-04-05,207,coca cola,75,100,25,2,00431,India
952256,2023-04-05,205,classic yogurt,45,60,15,2,00431,India
108230,2023-04-05,211,red bull,90,125,35,2,00470,India
108230,2023-04-05,210,mountain dew,75,100,25,2,00470,India
108230,2023-04-05,212,amul cheese,250,315,65,1,00470,India
820557,2023-04-05,212,amul cheese,250,315,65,1,00308,India
820557,2023-04-05,206,yakult,360,400,40,2,00308,India
820557,2023-04-05,204,strawberry yogurt,50,60,10,2,00308,India
820557,2023-04-05,201,paneer,210,340,130,1,00308,India
820557,2023-04-05,203,mango yogurt,50,60,10,2,00308,India
489148,2023-04-05,208,sprite,75,100,25,2,00046,India
489148,2023-04-05,212,amul cheese,250,315,65,1,00046,India
489148,2023-04-05,213,bisleri,6,15,9,2,00046,India
236750,2023-04-05,201,paneer,210,340,130,1,00260,India
236750,2023-04-05,209,pepsi,75,100,25,2,00260,India
236750,2023-04-05,210,mountain dew,75,100,25,2,00260,India
132698,2023-04-05,205,classic yogurt,45,60,15,2,00446,India
132698,2023-04-05,206,yakult,360,400,40,2,00446,India
925911,2023-04-05,204,strawberry yogurt,50,60,10,2,00287,India
925911,2023-04-05,209,pepsi,75,100,25,2,00287,India
925911,2023-04-05,203,mango yogurt,50,60,10,2,00287,India
925911,2023-04-05,212,amul cheese,250,315,65,1,00287,India
925911,2023-04-05,201,paneer,210,340,130,1,00287,India
417992,2023-04-05,202,milk,12,27,15,1,00015,India
417992,2023-04-05,204,strawberry yogurt,50,60,10,2,00015,India
417992,2023-04-05,208,sprite,75,100,25,2,00015,India
756478,2023-04-05,207,coca cola,75,100,25,2,00095,India
810219,2023-04-05,205,classic yogurt,45,60,15,2,00263,India
707733,2023-04-05,202,milk,12,27,15,1,00220,India
969069,2023-04-05,208,sprite,75,100,25,2,00168,India
969069,2023-04-05,213,bisleri,6,15,9,2,00168,India
969069,2023-04-05,207,coca cola,75,100,25,2,00168,India
404499,2023-04-05,213,bisleri,6,15,9,2,00447,India
404499,2023-04-05,205,classic yogurt,45,60,15,2,00447,India
549337,2023-04-05,206,yakult,360,400,40,2,00046,India
549337,2023-04-05,212,amul cheese,250,315,65,1,00046,India
549337,2023-04-05,203,mango yogurt,50,60,10,2,00046,India
795461,2023-04-05,202,milk,12,27,15,1,00239,India
402891,2023-04-05,201,paneer,210,340,130,1,00077,India
402891,2023-04-05,207,coca cola,75,100,25,2,00077,India
402891,2023-04-05,203,mango yogurt,50,60,10,2,00077,India
100742,2023-04-05,211,red bull,90,125,35,2,00009,India
100742,2023-04-05,204,strawberry yogurt,50,60,10,2,00009,India
416223,2023-04-05,206,yakult,360,400,40,2,00278,India
416223,2023-04-05,207,coca cola,75,100,25,2,00278,India
984736,2023-04-05,201,paneer,210,340,130,1,00002,India
984736,2023-04-05,209,pepsi,75,100,25,2,00002,India
984736,2023-04-05,210,mountain dew,75,100,25,2,00002,India
984736,2023-04-05,213,bisleri,6,15,9,2,00002,India
242747,2023-04-05,206,yakult,360,400,40,2,00499,India
242747,2023-04-05,203,mango yogurt,50,60,10,2,00499,India
242747,2023-04-05,201,paneer,210,340,130,1,00499,India
627105,2023-04-05,207,coca cola,75,100,25,2,00449,India
627105,2023-04-05,202,milk,12,27,15,1,00449,India
514981,2023-04-05,213,bisleri,6,15,9,2,00350,India
514981,2023-04-05,212,amul cheese,250,315,65,1,00350,India
514981,2023-04-05,210,mountain dew,75,100,25,2,00350,India
514981,2023-04-05,201,paneer,210,340,130,1,00350,India
321857,2023-04-05,203,mango yogurt,50,60,10,2,00489,India
321857,2023-04-05,208,sprite,75,100,25,2,00489,India
221749,2023-04-05,208,sprite,75,100,25,2,00487,India
726066,2023-04-05,204,strawberry yogurt,50,60,10,2,00162,India
726066,2023-04-05,213,bisleri,6,15,9,2,00162,India
726066,2023-04-05,201,paneer,210,340,130,1,00162,India
195140,2023-04-05,209,pepsi,75,100,25,2,00044,India
195140,2023-04-05,212,amul cheese,250,315,65,1,00044,India
470705,2023-04-05,211,red bull,90,125,35,2,00064,India
753375,2023-04-05,203,mango yogurt,50,60,10,2,00250,India
753375,2023-04-05,211,red bull,90,125,35,2,00250,India
753375,2023-04-05,212,amul cheese,250,315,65,1,00250,India
753375,2023-04-05,206,yakult,360,400,40,2,00250,India
753375,2023-04-05,202,milk,12,27,15,1,00250,India
288467,2023-04-05,203,mango yogurt,50,60,10,2,00257,India
777308,2023-04-05,203,mango yogurt,50,60,10,2,00229,India
777308,2023-04-05,202,milk,12,27,15,1,00229,India
777308,2023-04-05,212,amul cheese,250,315,65,1,00229,India
745062,2023-04-05,208,sprite,75,100,25,2,00354,India
745062,2023-04-05,201,paneer,210,340,130,1,00354,India
135394,2023-04-05,203,mango yogurt,50,60,10,2,00129,India
135394,2023-04-05,212,amul cheese,250,315,65,1,00129,India
135394,2023-04-05,206,yakult,360,400,40,2,00129,India
135394,2023-04-05,208,sprite,75,100,25,2,00129,India
625194,2023-04-05,202,milk,12,27,15,1,00154,India
625194,2023-04-05,213,bisleri,6,15,9,2,00154,India
625194,2023-04-05,209,pepsi,75,100,25,2,00154,India
625194,2023-04-05,205,classic yogurt,45,60,15,2,00154,India
560261,2023-04-05,206,yakult,360,400,40,2,00278,India
560261,2023-04-05,209,pepsi,75,100,25,2,00278,India
560261,2023-04-05,201,paneer,210,340,130,1,00278,India
560261,2023-04-05,205,classic yogurt,45,60,15,2,00278,India
821555,2023-04-05,203,mango yogurt,50,60,10,2,00377,India
821555,2023-04-05,204,strawberry yogurt,50,60,10,2,00377,India
821555,2023-04-05,212,amul cheese,250,315,65,1,00377,India
821555,2023-04-05,202,milk,12,27,15,1,00377,India
911611,2023-04-05,212,amul cheese,250,315,65,1,00376,India
707066,2023-04-05,208,sprite,75,100,25,2,00493,India
342698,2023-04-05,212,amul cheese,250,315,65,1,00431,India
489680,2023-04-05,204,strawberry yogurt,50,60,10,2,00153,India
489680,2023-04-05,213,bisleri,6,15,9,2,00153,India
733340,2023-04-05,205,classic yogurt,45,60,15,2,00125,India
733340,2023-04-05,210,mountain dew,75,100,25,2,00125,India
733340,2023-04-05,202,milk,12,27,15,1,00125,India
733340,2023-04-05,213,bisleri,6,15,9,2,00125,India
733340,2023-04-05,211,red bull,90,125,35,2,00125,India
280457,2023-04-06,211,red bull,90,125,35,2,00210,India
280457,2023-04-06,209,pepsi,75,100,25,2,00210,India
280457,2023-04-06,213,bisleri,6,15,9,2,00210,India
527930,2023-04-06,212,amul cheese,250,315,65,1,00303,India
527930,2023-04-06,203,mango yogurt,50,60,10,2,00303,India
527930,2023-04-06,208,sprite,75,100,25,2,00303,India
527930,2023-04-06,202,milk,12,27,15,1,00303,India
741194,2023-04-06,211,red bull,90,125,35,2,00308,India
741194,2023-04-06,210,mountain dew,75,100,25,2,00308,India
741194,2023-04-06,204,strawberry yogurt,50,60,10,2,00308,India
282105,2023-04-06,207,coca cola,75,100,25,2,00415,India
282105,2023-04-06,203,mango yogurt,50,60,10,2,00415,India
282105,2023-04-06,213,bisleri,6,15,9,2,00415,India
431941,2023-04-06,202,milk,12,27,15,1,00474,India
431941,2023-04-06,212,amul cheese,250,315,65,1,00474,India
727259,2023-04-06,208,sprite,75,100,25,2,00097,India
721391,2023-04-06,207,coca cola,75,100,25,2,00009,India
721391,2023-04-06,204,strawberry yogurt,50,60,10,2,00009,India
721391,2023-04-06,202,milk,12,27,15,1,00009,India
721391,2023-04-06,209,pepsi,75,100,25,2,00009,India
721391,2023-04-06,210,mountain dew,75,100,25,2,00009,India
119394,2023-04-06,206,yakult,360,400,40,2,00300,India
119394,2023-04-06,204,strawberry yogurt,50,60,10,2,00300,India
119394,2023-04-06,203,mango yogurt,50,60,10,2,00300,India
119394,2023-04-06,212,amul cheese,250,315,65,1,00300,India
827505,2023-04-06,213,bisleri,6,15,9,2,00128,India
827505,2023-04-06,202,milk,12,27,15,1,00128,India
827505,2023-04-06,206,yakult,360,400,40,2,00128,India
157629,2023-04-06,210,mountain dew,75,100,25,2,00079,India
157629,2023-04-06,206,yakult,360,400,40,2,00079,India
157629,2023-04-06,213,bisleri,6,15,9,2,00079,India
283295,2023-04-06,212,amul cheese,250,315,65,1,00258,India
851696,2023-04-06,202,milk,12,27,15,1,00012,India
851696,2023-04-06,206,yakult,360,400,40,2,00012,India
851696,2023-04-06,209,pepsi,75,100,25,2,00012,India
691786,2023-04-06,203,mango yogurt,50,60,10,2,00194,India
691786,2023-04-06,206,yakult,360,400,40,2,00194,India
691786,2023-04-06,201,paneer,210,340,130,1,00194,India
691786,2023-04-06,211,red bull,90,125,35,2,00194,India
418991,2023-04-06,201,paneer,210,340,130,1,00350,India
324453,2023-04-06,209,pepsi,75,100,25,2,00031,India
324453,2023-04-06,205,classic yogurt,45,60,15,2,00031,India
324453,2023-04-06,213,bisleri,6,15,9,2,00031,India
746435,2023-04-06,210,mountain dew,75,100,25,2,00229,India
746435,2023-04-06,209,pepsi,75,100,25,2,00229,India
746435,2023-04-06,213,bisleri,6,15,9,2,00229,India
746435,2023-04-06,206,yakult,360,400,40,2,00229,India
279939,2023-04-06,203,mango yogurt,50,60,10,2,00272,India
279939,2023-04-06,213,bisleri,6,15,9,2,00272,India
279939,2023-04-06,205,classic yogurt,45,60,15,2,00272,India
327827,2023-04-06,204,strawberry yogurt,50,60,10,2,00397,India
327827,2023-04-06,206,yakult,360,400,40,2,00397,India
327827,2023-04-06,212,amul cheese,250,315,65,1,00397,India
327827,2023-04-06,201,paneer,210,340,130,1,00397,India
327827,2023-04-06,205,classic yogurt,45,60,15,2,00397,India
229496,2023-04-06,206,yakult,360,400,40,2,00213,India
957540,2023-04-06,202,milk,12,27,15,1,00355,India
784809,2023-04-06,212,amul cheese,250,315,65,1,00338,India
128840,2023-04-06,205,classic yogurt,45,60,15,2,00275,India
128840,2023-04-06,212,amul cheese,250,315,65,1,00275,India
889380,2023-04-06,203,mango yogurt,50,60,10,2,00467,India
574338,2023-04-06,208,sprite,75,100,25,2,00382,India
574338,2023-04-06,213,bisleri,6,15,9,2,00382,India
574338,2023-04-06,201,paneer,210,340,130,1,00382,India
574338,2023-04-06,209,pepsi,75,100,25,2,00382,India
574338,2023-04-06,202,milk,12,27,15,1,00382,India
314285,2023-04-06,201,paneer,210,340,130,1,00277,India
314285,2023-04-06,205,classic yogurt,45,60,15,2,00277,India
314285,2023-04-06,210,mountain dew,75,100,25,2,00277,India
536336,2023-04-06,208,sprite,75,100,25,2,00352,India
536336,2023-04-06,212,amul cheese,250,315,65,1,00352,India
536336,2023-04-06,211,red bull,90,125,35,2,00352,India
344864,2023-04-06,207,coca cola,75,100,25,2,00354,India
970549,2023-04-06,207,coca cola,75,100,25,2,00449,India
970549,2023-04-06,212,amul cheese,250,315,65,1,00449,India
970549,2023-04-06,210,mountain dew,75,100,25,2,00449,India
970549,2023-04-06,204,strawberry yogurt,50,60,10,2,00449,India
970549,2023-04-06,208,sprite,75,100,25,2,00449,India
336491,2023-04-06,204,strawberry yogurt,50,60,10,2,00395,India
336491,2023-04-06,203,mango yogurt,50,60,10,2,00395,India
336491,2023-04-06,213,bisleri,6,15,9,2,00395,India
732490,2023-04-06,210,mountain dew,75,100,25,2,00330,India
732490,2023-04-06,211,red bull,90,125,35,2,00330,India
732490,2023-04-06,204,strawberry yogurt,50,60,10,2,00330,India
289895,2023-04-06,201,paneer,210,340,130,1,00254,India
295558,2023-04-06,209,pepsi,75,100,25,2,00301,India
295558,2023-04-06,208,sprite,75,100,25,2,00301,India
295558,2023-04-06,207,coca cola,75,100,25,2,00301,India
295558,2023-04-06,203,mango yogurt,50,60,10,2,00301,India
980126,2023-04-06,208,sprite,75,100,25,2,00276,India
980126,2023-04-06,206,yakult,360,400,40,2,00276,India
980126,2023-04-06,203,mango yogurt,50,60,10,2,00276,India
144302,2023-04-06,212,amul cheese,250,315,65,1,00290,India
153236,2023-04-06,203,mango yogurt,50,60,10,2,00250,India
153236,2023-04-06,201,paneer,210,340,130,1,00250,India
153236,2023-04-06,209,pepsi,75,100,25,2,00250,India
329461,2023-04-06,209,pepsi,75,100,25,2,00100,India
329461,2023-04-06,205,classic yogurt,45,60,15,2,00100,India
329461,2023-04-06,202,milk,12,27,15,1,00100,India
522942,2023-04-06,209,pepsi,75,100,25,2,00140,India
522942,2023-04-06,213,bisleri,6,15,9,2,00140,India
522942,2023-04-06,206,yakult,360,400,40,2,00140,India
522942,2023-04-06,211,red bull,90,125,35,2,00140,India
522942,2023-04-06,201,paneer,210,340,130,1,00140,India
418124,2023-04-06,212,amul cheese,250,315,65,1,00250,India
418124,2023-04-06,203,mango yogurt,50,60,10,2,00250,India
418124,2023-04-06,211,red bull,90,125,35,2,00250,India
320686,2023-04-06,203,mango yogurt,50,60,10,2,00059,India
320686,2023-04-06,207,coca cola,75,100,25,2,00059,India
320686,2023-04-06,213,bisleri,6,15,9,2,00059,India
320686,2023-04-06,204,strawberry yogurt,50,60,10,2,00059,India
590123,2023-04-06,209,pepsi,75,100,25,2,00493,India
663199,2023-04-06,212,amul cheese,250,315,65,1,00180,India
772761,2023-04-06,203,mango yogurt,50,60,10,2,00472,India
772761,2023-04-06,212,amul cheese,250,315,65,1,00472,India
772761,2023-04-06,207,coca cola,75,100,25,2,00472,India
772761,2023-04-06,210,mountain dew,75,100,25,2,00472,India
894820,2023-04-06,206,yakult,360,400,40,2,00287,India
894820,2023-04-06,212,amul cheese,250,315,65,1,00287,India
894820,2023-04-06,202,milk,12,27,15,1,00287,India
894820,2023-04-06,211,red bull,90,125,35,2,00287,India
352213,2023-04-06,205,classic yogurt,45,60,15,2,00321,India
352213,2023-04-06,208,sprite,75,100,25,2,00321,India
352213,2023-04-06,209,pepsi,75,100,25,2,00321,India
352213,2023-04-06,201,paneer,210,340,130,1,00321,India
985341,2023-04-06,202,milk,12,27,15,1,00319,India
985341,2023-04-06,204,strawberry yogurt,50,60,10,2,00319,India
985341,2023-04-06,210,mountain dew,75,100,25,2,00319,India
213780,2023-04-06,210,mountain dew,75,100,25,2,00398,India
213780,2023-04-06,212,amul cheese,250,315,65,1,00398,India
213780,2023-04-06,205,classic yogurt,45,60,15,2,00398,India
213780,2023-04-06,211,red bull,90,125,35,2,00398,India
213780,2023-04-06,202,milk,12,27,15,1,00398,India
288788,2023-04-06,213,bisleri,6,15,9,2,00116,India
288788,2023-04-06,206,yakult,360,400,40,2,00116,India
288788,2023-04-06,209,pepsi,75,100,25,2,00116,India
288788,2023-04-06,207,coca cola,75,100,25,2,00116,India
329850,2023-04-06,204,strawberry yogurt,50,60,10,2,00389,India
329850,2023-04-06,210,mountain dew,75,100,25,2,00389,India
299178,2023-04-06,205,classic yogurt,45,60,15,2,00373,India
299178,2023-04-06,204,strawberry yogurt,50,60,10,2,00373,India
299178,2023-04-06,206,yakult,360,400,40,2,00373,India
299178,2023-04-06,207,coca cola,75,100,25,2,00373,India
461710,2023-04-06,208,sprite,75,100,25,2,00500,India
983500,2023-04-06,208,sprite,75,100,25,2,00048,India
983500,2023-04-06,213,bisleri,6,15,9,2,00048,India
636274,2023-04-06,209,pepsi,75,100,25,2,00309,India
636274,2023-04-06,211,red bull,90,125,35,2,00309,India
636274,2023-04-06,210,mountain dew,75,100,25,2,00309,India
908709,2023-04-06,211,red bull,90,125,35,2,00216,India
908709,2023-04-06,207,coca cola,75,100,25,2,00216,India
908709,2023-04-06,206,yakult,360,400,40,2,00216,India
101354,2023-04-06,205,classic yogurt,45,60,15,2,00147,India
101354,2023-04-06,202,milk,12,27,15,1,00147,India
101354,2023-04-06,204,strawberry yogurt,50,60,10,2,00147,India
134045,2023-04-06,205,classic yogurt,45,60,15,2,00018,India
134045,2023-04-06,203,mango yogurt,50,60,10,2,00018,India
134045,2023-04-06,213,bisleri,6,15,9,2,00018,India
134045,2023-04-06,208,sprite,75,100,25,2,00018,India
688798,2023-04-06,202,milk,12,27,15,1,00208,India
688798,2023-04-06,205,classic yogurt,45,60,15,2,00208,India
688798,2023-04-06,207,coca cola,75,100,25,2,00208,India
990054,2023-04-06,210,mountain dew,75,100,25,2,00124,India
990054,2023-04-06,208,sprite,75,100,25,2,00124,India
990054,2023-04-06,207,coca cola,75,100,25,2,00124,India
990054,2023-04-06,201,paneer,210,340,130,1,00124,India
567290,2023-04-06,205,classic yogurt,45,60,15,2,00079,India
567290,2023-04-06,204,strawberry yogurt,50,60,10,2,00079,India
567290,2023-04-06,203,mango yogurt,50,60,10,2,00079,India
567290,2023-04-06,212,amul cheese,250,315,65,1,00079,India
567290,2023-04-06,207,coca cola,75,100,25,2,00079,India
809761,2023-04-06,207,coca cola,75,100,25,2,00268,India
809761,2023-04-06,212,amul cheese,250,315,65,1,00268,India
809761,2023-04-06,211,red bull,90,125,35,2,00268,India
809761,2023-04-06,213,bisleri,6,15,9,2,00268,India
346406,2023-04-06,213,bisleri,6,15,9,2,00262,India
346406,2023-04-06,212,amul cheese,250,315,65,1,00262,India
346406,2023-04-06,208,sprite,75,100,25,2,00262,India
346406,2023-04-06,206,yakult,360,400,40,2,00262,India
836988,2023-04-06,201,paneer,210,340,130,1,00011,India
836988,2023-04-06,202,milk,12,27,15,1,00011,India
836988,2023-04-06,208,sprite,75,100,25,2,00011,India
214552,2023-04-06,205,classic yogurt,45,60,15,2,00165,India
214552,2023-04-06,211,red bull,90,125,35,2,00165,India
214552,2023-04-06,207,coca cola,75,100,25,2,00165,India
745473,2023-04-06,210,mountain dew,75,100,25,2,00373,India
745473,2023-04-06,212,amul cheese,250,315,65,1,00373,India
745473,2023-04-06,203,mango yogurt,50,60,10,2,00373,India
745473,2023-04-06,208,sprite,75,100,25,2,00373,India
902321,2023-04-06,202,milk,12,27,15,1,00337,India
763863,2023-04-06,201,paneer,210,340,130,1,00042,India
763863,2023-04-06,205,classic yogurt,45,60,15,2,00042,India
646413,2023-04-06,204,strawberry yogurt,50,60,10,2,00483,India
646413,2023-04-06,210,mountain dew,75,100,25,2,00483,India
646413,2023-04-06,208,sprite,75,100,25,2,00483,India
607197,2023-04-06,205,classic yogurt,45,60,15,2,00341,India
283324,2023-04-06,204,strawberry yogurt,50,60,10,2,00419,India
451392,2023-04-06,209,pepsi,75,100,25,2,00234,India
451392,2023-04-06,203,mango yogurt,50,60,10,2,00234,India
451392,2023-04-06,204,strawberry yogurt,50,60,10,2,00234,India
451392,2023-04-06,207,coca cola,75,100,25,2,00234,India
688964,2023-04-06,209,pepsi,75,100,25,2,00436,India
688964,2023-04-06,203,mango yogurt,50,60,10,2,00436,India
688964,2023-04-06,204,strawberry yogurt,50,60,10,2,00436,India
536199,2023-04-06,210,mountain dew,75,100,25,2,00057,India
536199,2023-04-06,211,red bull,90,125,35,2,00057,India
536199,2023-04-06,201,paneer,210,340,130,1,00057,India
536199,2023-04-06,203,mango yogurt,50,60,10,2,00057,India
194817,2023-04-06,206,yakult,360,400,40,2,00174,India
194817,2023-04-06,204,strawberry yogurt,50,60,10,2,00174,India
194817,2023-04-06,202,milk,12,27,15,1,00174,India
194817,2023-04-06,212,amul cheese,250,315,65,1,00174,India
194817,2023-04-06,211,red bull,90,125,35,2,00174,India
480613,2023-04-06,204,strawberry yogurt,50,60,10,2,00224,India
480613,2023-04-06,212,amul cheese,250,315,65,1,00224,India
480613,2023-04-06,203,mango yogurt,50,60,10,2,00224,India
725414,2023-04-06,210,mountain dew,75,100,25,2,00209,India
233427,2023-04-06,203,mango yogurt,50,60,10,2,00483,India
233427,2023-04-06,210,mountain dew,75,100,25,2,00483,India
233427,2023-04-06,202,milk,12,27,15,1,00483,India
669047,2023-04-06,212,amul cheese,250,315,65,1,00170,India
669047,2023-04-06,209,pepsi,75,100,25,2,00170,India
669047,2023-04-06,213,bisleri,6,15,9,2,00170,India
669047,2023-04-06,211,red bull,90,125,35,2,00170,India
666607,2023-04-06,203,mango yogurt,50,60,10,2,00126,India
666607,2023-04-06,210,mountain dew,75,100,25,2,00126,India
850155,2023-04-06,213,bisleri,6,15,9,2,00092,India
101109,2023-04-06,207,coca cola,75,100,25,2,00046,India
101109,2023-04-06,203,mango yogurt,50,60,10,2,00046,India
101109,2023-04-06,211,red bull,90,125,35,2,00046,India
947356,2023-04-06,208,sprite,75,100,25,2,00097,India
770806,2023-04-06,206,yakult,360,400,40,2,00449,India
980897,2023-04-06,207,coca cola,75,100,25,2,00116,India
980897,2023-04-06,211,red bull,90,125,35,2,00116,India
980897,2023-04-06,202,milk,12,27,15,1,00116,India
980897,2023-04-06,210,mountain dew,75,100,25,2,00116,India
601972,2023-04-06,209,pepsi,75,100,25,2,00441,India
601972,2023-04-06,201,paneer,210,340,130,1,00441,India
601972,2023-04-06,207,coca cola,75,100,25,2,00441,India
601972,2023-04-06,205,classic yogurt,45,60,15,2,00441,India
258044,2023-04-06,205,classic yogurt,45,60,15,2,00096,India
258044,2023-04-06,211,red bull,90,125,35,2,00096,India
756689,2023-04-06,201,paneer,210,340,130,1,00181,India
756689,2023-04-06,204,strawberry yogurt,50,60,10,2,00181,India
309890,2023-04-06,207,coca cola,75,100,25,2,00295,India
309890,2023-04-06,208,sprite,75,100,25,2,00295,India
138211,2023-04-06,212,amul cheese,250,315,65,1,00275,India
328373,2023-04-06,202,milk,12,27,15,1,00441,India
328373,2023-04-06,205,classic yogurt,45,60,15,2,00441,India
328373,2023-04-06,203,mango yogurt,50,60,10,2,00441,India
877515,2023-04-06,205,classic yogurt,45,60,15,2,00079,India
877515,2023-04-06,201,paneer,210,340,130,1,00079,India
877515,2023-04-06,204,strawberry yogurt,50,60,10,2,00079,India
877515,2023-04-06,212,amul cheese,250,315,65,1,00079,India
956046,2023-04-06,203,mango yogurt,50,60,10,2,00053,India
956046,2023-04-06,204,strawberry yogurt,50,60,10,2,00053,India
860419,2023-04-06,204,strawberry yogurt,50,60,10,2,00092,India
860419,2023-04-06,201,paneer,210,340,130,1,00092,India
860419,2023-04-06,211,red bull,90,125,35,2,00092,India
615898,2023-04-06,204,strawberry yogurt,50,60,10,2,00333,India
615898,2023-04-06,203,mango yogurt,50,60,10,2,00333,India
615898,2023-04-06,212,amul cheese,250,315,65,1,00333,India
615898,2023-04-06,208,sprite,75,100,25,2,00333,India
369152,2023-04-06,210,mountain dew,75,100,25,2,00296,India
908366,2023-04-06,206,yakult,360,400,40,2,00041,India
908366,2023-04-06,201,paneer,210,340,130,1,00041,India
908366,2023-04-06,212,amul cheese,250,315,65,1,00041,India
300200,2023-04-06,207,coca cola,75,100,25,2,00048,India
300200,2023-04-06,211,red bull,90,125,35,2,00048,India
218057,2023-04-06,211,red bull,90,125,35,2,00453,India
218057,2023-04-06,207,coca cola,75,100,25,2,00453,India
218057,2023-04-06,213,bisleri,6,15,9,2,00453,India
218057,2023-04-06,210,mountain dew,75,100,25,2,00453,India
584342,2023-04-07,211,red bull,90,125,35,2,00477,India
584342,2023-04-07,205,classic yogurt,45,60,15,2,00477,India
584342,2023-04-07,213,bisleri,6,15,9,2,00477,India
808164,2023-04-07,209,pepsi,75,100,25,2,00010,India
808164,2023-04-07,207,coca cola,75,100,25,2,00010,India
656685,2023-04-07,207,coca cola,75,100,25,2,00283,India
656685,2023-04-07,204,strawberry yogurt,50,60,10,2,00283,India
656685,2023-04-07,202,milk,12,27,15,1,00283,India
366522,2023-04-07,211,red bull,90,125,35,2,00274,India
725954,2023-04-07,210,mountain dew,75,100,25,2,00187,India
725954,2023-04-07,207,coca cola,75,100,25,2,00187,India
725954,2023-04-07,208,sprite,75,100,25,2,00187,India
725954,2023-04-07,204,strawberry yogurt,50,60,10,2,00187,India
725954,2023-04-07,213,bisleri,6,15,9,2,00187,India
181837,2023-04-07,207,coca cola,75,100,25,2,00134,India
214998,2023-04-07,202,milk,12,27,15,1,00292,India
751488,2023-04-07,205,classic yogurt,45,60,15,2,00258,India
887173,2023-04-07,209,pepsi,75,100,25,2,00402,India
928979,2023-04-07,207,coca cola,75,100,25,2,00383,India
928979,2023-04-07,203,mango yogurt,50,60,10,2,00383,India
895094,2023-04-07,201,paneer,210,340,130,1,00492,India
895094,2023-04-07,209,pepsi,75,100,25,2,00492,India
895094,2023-04-07,211,red bull,90,125,35,2,00492,India
895094,2023-04-07,205,classic yogurt,45,60,15,2,00492,India
895094,2023-04-07,212,amul cheese,250,315,65,1,00492,India
446839,2023-04-07,206,yakult,360,400,40,2,00067,India
446839,2023-04-07,204,strawberry yogurt,50,60,10,2,00067,India
446839,2023-04-07,208,sprite,75,100,25,2,00067,India
176608,2023-04-07,209,pepsi,75,100,25,2,00353,India
176608,2023-04-07,208,sprite,75,100,25,2,00353,India
176608,2023-04-07,207,coca cola,75,100,25,2,00353,India
176608,2023-04-07,201,paneer,210,340,130,1,00353,India
176608,2023-04-07,202,milk,12,27,15,1,00353,India
821344,2023-04-07,208,sprite,75,100,25,2,00230,India
821344,2023-04-07,211,red bull,90,125,35,2,00230,India
821344,2023-04-07,204,strawberry yogurt,50,60,10,2,00230,India
821344,2023-04-07,201,paneer,210,340,130,1,00230,India
367992,2023-04-07,207,coca cola,75,100,25,2,00103,India
367992,2023-04-07,204,strawberry yogurt,50,60,10,2,00103,India
737320,2023-04-07,212,amul cheese,250,315,65,1,00057,India
737320,2023-04-07,208,sprite,75,100,25,2,00057,India
737320,2023-04-07,209,pepsi,75,100,25,2,00057,India
361656,2023-04-07,205,classic yogurt,45,60,15,2,00348,India
361656,2023-04-07,213,bisleri,6,15,9,2,00348,India
361656,2023-04-07,201,paneer,210,340,130,1,00348,India
361656,2023-04-07,208,sprite,75,100,25,2,00348,India
885304,2023-04-07,204,strawberry yogurt,50,60,10,2,00236,India
885304,2023-04-07,201,paneer,210,340,130,1,00236,India
885304,2023-04-07,208,sprite,75,100,25,2,00236,India
885304,2023-04-07,209,pepsi,75,100,25,2,00236,India
148228,2023-04-07,202,milk,12,27,15,1,00274,India
538123,2023-04-07,210,mountain dew,75,100,25,2,00047,India
114243,2023-04-07,210,mountain dew,75,100,25,2,00229,India
114243,2023-04-07,204,strawberry yogurt,50,60,10,2,00229,India
567940,2023-04-07,211,red bull,90,125,35,2,00436,India
814649,2023-04-07,210,mountain dew,75,100,25,2,00375,India
814649,2023-04-07,212,amul cheese,250,315,65,1,00375,India
814649,2023-04-07,203,mango yogurt,50,60,10,2,00375,India
814649,2023-04-07,208,sprite,75,100,25,2,00375,India
814649,2023-04-07,211,red bull,90,125,35,2,00375,India
757038,2023-04-07,204,strawberry yogurt,50,60,10,2,00124,India
757038,2023-04-07,201,paneer,210,340,130,1,00124,India
487694,2023-04-07,204,strawberry yogurt,50,60,10,2,00135,India
487694,2023-04-07,203,mango yogurt,50,60,10,2,00135,India
487694,2023-04-07,208,sprite,75,100,25,2,00135,India
387499,2023-04-07,211,red bull,90,125,35,2,00141,India
490656,2023-04-07,210,mountain dew,75,100,25,2,00383,India
490656,2023-04-07,207,coca cola,75,100,25,2,00383,India
666934,2023-04-07,205,classic yogurt,45,60,15,2,00062,India
792352,2023-04-07,201,paneer,210,340,130,1,00178,India
792352,2023-04-07,208,sprite,75,100,25,2,00178,India
792352,2023-04-07,210,mountain dew,75,100,25,2,00178,India
792352,2023-04-07,204,strawberry yogurt,50,60,10,2,00178,India
789591,2023-04-07,203,mango yogurt,50,60,10,2,00299,India
789591,2023-04-07,201,paneer,210,340,130,1,00299,India
789591,2023-04-07,202,milk,12,27,15,1,00299,India
789591,2023-04-07,209,pepsi,75,100,25,2,00299,India
368335,2023-04-07,202,milk,12,27,15,1,00128,India
368335,2023-04-07,205,classic yogurt,45,60,15,2,00128,India
368335,2023-04-07,212,amul cheese,250,315,65,1,00128,India
368335,2023-04-07,210,mountain dew,75,100,25,2,00128,India
289826,2023-04-07,211,red bull,90,125,35,2,00198,India
289826,2023-04-07,204,strawberry yogurt,50,60,10,2,00198,India
289826,2023-04-07,202,milk,12,27,15,1,00198,India
224891,2023-04-07,213,bisleri,6,15,9,2,00220,India
224891,2023-04-07,205,classic yogurt,45,60,15,2,00220,India
224891,2023-04-07,211,red bull,90,125,35,2,00220,India
224891,2023-04-07,210,mountain dew,75,100,25,2,00220,India
873103,2023-04-07,205,classic yogurt,45,60,15,2,00477,India
873103,2023-04-07,213,bisleri,6,15,9,2,00477,India
976065,2023-04-07,206,yakult,360,400,40,2,00385,India
976065,2023-04-07,203,mango yogurt,50,60,10,2,00385,India
976065,2023-04-07,201,paneer,210,340,130,1,00385,India
227533,2023-04-07,209,pepsi,75,100,25,2,00492,India
227533,2023-04-07,213,bisleri,6,15,9,2,00492,India
227533,2023-04-07,207,coca cola,75,100,25,2,00492,India
321060,2023-04-07,201,paneer,210,340,130,1,00426,India
321060,2023-04-07,206,yakult,360,400,40,2,00426,India
321060,2023-04-07,210,mountain dew,75,100,25,2,00426,India
321060,2023-04-07,205,classic yogurt,45,60,15,2,00426,India
971239,2023-04-07,202,milk,12,27,15,1,00311,India
784679,2023-04-07,207,coca cola,75,100,25,2,00408,India
784679,2023-04-07,208,sprite,75,100,25,2,00408,India
784679,2023-04-07,211,red bull,90,125,35,2,00408,India
678012,2023-04-07,209,pepsi,75,100,25,2,00209,India
678012,2023-04-07,212,amul cheese,250,315,65,1,00209,India
777657,2023-04-07,204,strawberry yogurt,50,60,10,2,00232,India
777657,2023-04-07,211,red bull,90,125,35,2,00232,India
777657,2023-04-07,202,milk,12,27,15,1,00232,India
107328,2023-04-07,203,mango yogurt,50,60,10,2,00208,India
107328,2023-04-07,201,paneer,210,340,130,1,00208,India
107328,2023-04-07,209,pepsi,75,100,25,2,00208,India
829475,2023-04-07,213,bisleri,6,15,9,2,00406,India
829475,2023-04-07,203,mango yogurt,50,60,10,2,00406,India
311825,2023-04-07,201,paneer,210,340,130,1,00437,India
311825,2023-04-07,209,pepsi,75,100,25,2,00437,India
311825,2023-04-07,208,sprite,75,100,25,2,00437,India
311825,2023-04-07,202,milk,12,27,15,1,00437,India
882527,2023-04-07,205,classic yogurt,45,60,15,2,00042,India
882527,2023-04-07,203,mango yogurt,50,60,10,2,00042,India
963649,2023-04-07,209,pepsi,75,100,25,2,00244,India
963649,2023-04-07,201,paneer,210,340,130,1,00244,India
963649,2023-04-07,205,classic yogurt,45,60,15,2,00244,India
825629,2023-04-07,212,amul cheese,250,315,65,1,00183,India
825629,2023-04-07,202,milk,12,27,15,1,00183,India
825629,2023-04-07,207,coca cola,75,100,25,2,00183,India
173057,2023-04-07,212,amul cheese,250,315,65,1,00478,India
173057,2023-04-07,207,coca cola,75,100,25,2,00478,India
173057,2023-04-07,204,strawberry yogurt,50,60,10,2,00478,India
173057,2023-04-07,211,red bull,90,125,35,2,00478,India
173057,2023-04-07,203,mango yogurt,50,60,10,2,00478,India
794831,2023-04-07,206,yakult,360,400,40,2,00169,India
794831,2023-04-07,203,mango yogurt,50,60,10,2,00169,India
794831,2023-04-07,207,coca cola,75,100,25,2,00169,India
530130,2023-04-07,208,sprite,75,100,25,2,00213,India
530130,2023-04-07,209,pepsi,75,100,25,2,00213,India
530130,2023-04-07,213,bisleri,6,15,9,2,00213,India
881018,2023-04-07,202,milk,12,27,15,1,00418,India
881018,2023-04-07,205,classic yogurt,45,60,15,2,00418,India
881018,2023-04-07,210,mountain dew,75,100,25,2,00418,India
881018,2023-04-07,207,coca cola,75,100,25,2,00418,India
162258,2023-04-07,212,amul cheese,250,315,65,1,00315,India
162258,2023-04-07,201,paneer,210,340,130,1,00315,India
162258,2023-04-07,204,strawberry yogurt,50,60,10,2,00315,India
162258,2023-04-07,209,pepsi,75,100,25,2,00315,India
162258,2023-04-07,210,mountain dew,75,100,25,2,00315,India
345905,2023-04-07,209,pepsi,75,100,25,2,00471,India
345905,2023-04-07,201,paneer,210,340,130,1,00471,India
634657,2023-04-07,203,mango yogurt,50,60,10,2,00167,India
180439,2023-04-07,207,coca cola,75,100,25,2,00348,India
180439,2023-04-07,205,classic yogurt,45,60,15,2,00348,India
180439,2023-04-07,211,red bull,90,125,35,2,00348,India
180439,2023-04-07,210,mountain dew,75,100,25,2,00348,India
180439,2023-04-07,208,sprite,75,100,25,2,00348,India
482785,2023-04-07,208,sprite,75,100,25,2,00446,India
482785,2023-04-07,203,mango yogurt,50,60,10,2,00446,India
482785,2023-04-07,209,pepsi,75,100,25,2,00446,India
482785,2023-04-07,212,amul cheese,250,315,65,1,00446,India
482785,2023-04-07,201,paneer,210,340,130,1,00446,India
445365,2023-04-07,207,coca cola,75,100,25,2,00261,India
641798,2023-04-07,203,mango yogurt,50,60,10,2,00185,India
641798,2023-04-07,213,bisleri,6,15,9,2,00185,India
631306,2023-04-07,206,yakult,360,400,40,2,00079,India
377464,2023-04-07,209,pepsi,75,100,25,2,00402,India
377464,2023-04-07,213,bisleri,6,15,9,2,00402,India
377464,2023-04-07,204,strawberry yogurt,50,60,10,2,00402,India
341281,2023-04-07,212,amul cheese,250,315,65,1,00356,India
341281,2023-04-07,205,classic yogurt,45,60,15,2,00356,India
460577,2023-04-07,207,coca cola,75,100,25,2,00361,India
460577,2023-04-07,202,milk,12,27,15,1,00361,India
954565,2023-04-07,206,yakult,360,400,40,2,00069,India
954565,2023-04-07,204,strawberry yogurt,50,60,10,2,00069,India
954565,2023-04-07,208,sprite,75,100,25,2,00069,India
724585,2023-04-07,204,strawberry yogurt,50,60,10,2,00031,India
724585,2023-04-07,211,red bull,90,125,35,2,00031,India
724585,2023-04-07,201,paneer,210,340,130,1,00031,India
724585,2023-04-07,202,milk,12,27,15,1,00031,India
724585,2023-04-07,206,yakult,360,400,40,2,00031,India
861783,2023-04-07,213,bisleri,6,15,9,2,00330,India
861783,2023-04-07,203,mango yogurt,50,60,10,2,00330,India
580733,2023-04-07,201,paneer,210,340,130,1,00228,India
580733,2023-04-07,205,classic yogurt,45,60,15,2,00228,India
580733,2023-04-07,209,pepsi,75,100,25,2,00228,India
580733,2023-04-07,208,sprite,75,100,25,2,00228,India
551577,2023-04-07,211,red bull,90,125,35,2,00440,India
551577,2023-04-07,203,mango yogurt,50,60,10,2,00440,India
551577,2023-04-07,207,coca cola,75,100,25,2,00440,India
935484,2023-04-07,201,paneer,210,340,130,1,00176,India
194324,2023-04-07,206,yakult,360,400,40,2,00162,India
194324,2023-04-07,210,mountain dew,75,100,25,2,00162,India
194324,2023-04-07,202,milk,12,27,15,1,00162,India
194324,2023-04-07,211,red bull,90,125,35,2,00162,India
170227,2023-04-07,205,classic yogurt,45,60,15,2,00219,India
170227,2023-04-07,210,mountain dew,75,100,25,2,00219,India
170227,2023-04-07,211,red bull,90,125,35,2,00219,India
299381,2023-04-07,208,sprite,75,100,25,2,00361,India
299381,2023-04-07,206,yakult,360,400,40,2,00361,India
299381,2023-04-07,204,strawberry yogurt,50,60,10,2,00361,India
564436,2023-04-07,206,yakult,360,400,40,2,00414,India
564436,2023-04-07,208,sprite,75,100,25,2,00414,India
679960,2023-04-07,212,amul cheese,250,315,65,1,00209,India
679960,2023-04-07,202,milk,12,27,15,1,00209,India
646609,2023-04-07,213,bisleri,6,15,9,2,00336,India
646609,2023-04-07,212,amul cheese,250,315,65,1,00336,India
160101,2023-04-07,203,mango yogurt,50,60,10,2,00499,India
160101,2023-04-07,205,classic yogurt,45,60,15,2,00499,India
391207,2023-04-07,204,strawberry yogurt,50,60,10,2,00437,India
391207,2023-04-07,205,classic yogurt,45,60,15,2,00437,India
330578,2023-04-07,203,mango yogurt,50,60,10,2,00208,India
330578,2023-04-07,206,yakult,360,400,40,2,00208,India
330578,2023-04-07,212,amul cheese,250,315,65,1,00208,India
877046,2023-04-07,205,classic yogurt,45,60,15,2,00465,India
877046,2023-04-07,202,milk,12,27,15,1,00465,India
877046,2023-04-07,210,mountain dew,75,100,25,2,00465,India
526951,2023-04-07,201,paneer,210,340,130,1,00331,India
526951,2023-04-07,205,classic yogurt,45,60,15,2,00331,India
526951,2023-04-07,204,strawberry yogurt,50,60,10,2,00331,India
526951,2023-04-07,207,coca cola,75,100,25,2,00331,India
223452,2023-04-07,207,coca cola,75,100,25,2,00343,India
223452,2023-04-07,201,paneer,210,340,130,1,00343,India
454230,2023-04-07,206,yakult,360,400,40,2,00473,India
848066,2023-04-07,212,amul cheese,250,315,65,1,00333,India
848066,2023-04-07,202,milk,12,27,15,1,00333,India
848066,2023-04-07,209,pepsi,75,100,25,2,00333,India
860286,2023-04-07,201,paneer,210,340,130,1,00438,India
860286,2023-04-07,208,sprite,75,100,25,2,00438,India
860286,2023-04-07,213,bisleri,6,15,9,2,00438,India
860286,2023-04-07,211,red bull,90,125,35,2,00438,India
419732,2023-04-07,207,coca cola,75,100,25,2,00179,India
419732,2023-04-07,203,mango yogurt,50,60,10,2,00179,India
258408,2023-04-07,212,amul cheese,250,315,65,1,00490,India
258408,2023-04-07,207,coca cola,75,100,25,2,00490,India
258408,2023-04-07,206,yakult,360,400,40,2,00490,India
394927,2023-04-07,211,red bull,90,125,35,2,00301,India
394927,2023-04-07,205,classic yogurt,45,60,15,2,00301,India
394927,2023-04-07,208,sprite,75,100,25,2,00301,India
365501,2023-04-07,209,pepsi,75,100,25,2,00154,India
278579,2023-04-07,208,sprite,75,100,25,2,00147,India
318868,2023-04-07,202,milk,12,27,15,1,00154,India
539945,2023-04-07,208,sprite,75,100,25,2,00310,India
896161,2023-04-07,206,yakult,360,400,40,2,00011,India
896161,2023-04-07,201,paneer,210,340,130,1,00011,India
276892,2023-04-07,208,sprite,75,100,25,2,00279,India
276892,2023-04-07,213,bisleri,6,15,9,2,00279,India
332751,2023-04-08,210,mountain dew,75,100,25,2,00228,India
903542,2023-04-08,202,milk,12,27,15,1,00094,India
903542,2023-04-08,203,mango yogurt,50,60,10,2,00094,India
980701,2023-04-08,201,paneer,210,340,130,1,00208,India
980701,2023-04-08,211,red bull,90,125,35,2,00208,India
260636,2023-04-08,203,mango yogurt,50,60,10,2,00294,India
260636,2023-04-08,205,classic yogurt,45,60,15,2,00294,India
127385,2023-04-08,204,strawberry yogurt,50,60,10,2,00047,India
127385,2023-04-08,208,sprite,75,100,25,2,00047,India
215015,2023-04-08,209,pepsi,75,100,25,2,00411,India
215015,2023-04-08,207,coca cola,75,100,25,2,00411,India
720449,2023-04-08,213,bisleri,6,15,9,2,00241,India
720449,2023-04-08,212,amul cheese,250,315,65,1,00241,India
720449,2023-04-08,201,paneer,210,340,130,1,00241,India
720449,2023-04-08,209,pepsi,75,100,25,2,00241,India
720449,2023-04-08,211,red bull,90,125,35,2,00241,India
247441,2023-04-08,203,mango yogurt,50,60,10,2,00132,India
247441,2023-04-08,206,yakult,360,400,40,2,00132,India
247441,2023-04-08,207,coca cola,75,100,25,2,00132,India
247441,2023-04-08,213,bisleri,6,15,9,2,00132,India
415574,2023-04-08,201,paneer,210,340,130,1,00162,India
415574,2023-04-08,208,sprite,75,100,25,2,00162,India
415574,2023-04-08,213,bisleri,6,15,9,2,00162,India
415574,2023-04-08,212,amul cheese,250,315,65,1,00162,India
608114,2023-04-08,204,strawberry yogurt,50,60,10,2,00349,India
608114,2023-04-08,208,sprite,75,100,25,2,00349,India
608114,2023-04-08,212,amul cheese,250,315,65,1,00349,India
510955,2023-04-08,209,pepsi,75,100,25,2,00082,India
510955,2023-04-08,202,milk,12,27,15,1,00082,India
510955,2023-04-08,210,mountain dew,75,100,25,2,00082,India
510955,2023-04-08,208,sprite,75,100,25,2,00082,India
510955,2023-04-08,201,paneer,210,340,130,1,00082,India
227808,2023-04-08,204,strawberry yogurt,50,60,10,2,00111,India
426516,2023-04-08,202,milk,12,27,15,1,00117,India
426516,2023-04-08,203,mango yogurt,50,60,10,2,00117,India
426516,2023-04-08,211,red bull,90,125,35,2,00117,India
168787,2023-04-08,201,paneer,210,340,130,1,00368,India
168787,2023-04-08,207,coca cola,75,100,25,2,00368,India
166116,2023-04-08,202,milk,12,27,15,1,00050,India
166116,2023-04-08,204,strawberry yogurt,50,60,10,2,00050,India
157384,2023-04-08,211,red bull,90,125,35,2,00240,India
502471,2023-04-08,206,yakult,360,400,40,2,00478,India
670161,2023-04-08,208,sprite,75,100,25,2,00335,India
830549,2023-04-08,210,mountain dew,75,100,25,2,00162,India
830549,2023-04-08,212,amul cheese,250,315,65,1,00162,India
830549,2023-04-08,202,milk,12,27,15,1,00162,India
830549,2023-04-08,213,bisleri,6,15,9,2,00162,India
224133,2023-04-08,211,red bull,90,125,35,2,00228,India
224133,2023-04-08,204,strawberry yogurt,50,60,10,2,00228,India
764758,2023-04-08,212,amul cheese,250,315,65,1,00065,India
467669,2023-04-08,205,classic yogurt,45,60,15,2,00076,India
467669,2023-04-08,201,paneer,210,340,130,1,00076,India
467669,2023-04-08,204,strawberry yogurt,50,60,10,2,00076,India
432098,2023-04-08,209,pepsi,75,100,25,2,00177,India
432098,2023-04-08,206,yakult,360,400,40,2,00177,India
432098,2023-04-08,210,mountain dew,75,100,25,2,00177,India
673676,2023-04-08,207,coca cola,75,100,25,2,00142,India
673676,2023-04-08,208,sprite,75,100,25,2,00142,India
673676,2023-04-08,211,red bull,90,125,35,2,00142,India
670204,2023-04-08,204,strawberry yogurt,50,60,10,2,00394,India
670204,2023-04-08,212,amul cheese,250,315,65,1,00394,India
670204,2023-04-08,203,mango yogurt,50,60,10,2,00394,India
670204,2023-04-08,205,classic yogurt,45,60,15,2,00394,India
303118,2023-04-08,202,milk,12,27,15,1,00129,India
375882,2023-04-08,203,mango yogurt,50,60,10,2,00316,India
528002,2023-04-08,212,amul cheese,250,315,65,1,00081,India
528002,2023-04-08,209,pepsi,75,100,25,2,00081,India
578010,2023-04-08,202,milk,12,27,15,1,00450,India
578010,2023-04-08,207,coca cola,75,100,25,2,00450,India
578010,2023-04-08,206,yakult,360,400,40,2,00450,India
578010,2023-04-08,209,pepsi,75,100,25,2,00450,India
578010,2023-04-08,208,sprite,75,100,25,2,00450,India
339154,2023-04-08,206,yakult,360,400,40,2,00357,India
339154,2023-04-08,204,strawberry yogurt,50,60,10,2,00357,India
339154,2023-04-08,208,sprite,75,100,25,2,00357,India
339154,2023-04-08,205,classic yogurt,45,60,15,2,00357,India
269923,2023-04-08,213,bisleri,6,15,9,2,00355,India
269923,2023-04-08,209,pepsi,75,100,25,2,00355,India
269923,2023-04-08,201,paneer,210,340,130,1,00355,India
269923,2023-04-08,202,milk,12,27,15,1,00355,India
269923,2023-04-08,207,coca cola,75,100,25,2,00355,India
781758,2023-04-08,207,coca cola,75,100,25,2,00044,India
781758,2023-04-08,210,mountain dew,75,100,25,2,00044,India
624169,2023-04-08,206,yakult,360,400,40,2,00164,India
899149,2023-04-08,211,red bull,90,125,35,2,00268,India
899149,2023-04-08,202,milk,12,27,15,1,00268,India
899149,2023-04-08,210,mountain dew,75,100,25,2,00268,India
899149,2023-04-08,203,mango yogurt,50,60,10,2,00268,India
368452,2023-04-08,209,pepsi,75,100,25,2,00028,India
368452,2023-04-08,210,mountain dew,75,100,25,2,00028,India
557424,2023-04-08,205,classic yogurt,45,60,15,2,00235,India
557424,2023-04-08,212,amul cheese,250,315,65,1,00235,India
556055,2023-04-08,213,bisleri,6,15,9,2,00194,India
556055,2023-04-08,205,classic yogurt,45,60,15,2,00194,India
556055,2023-04-08,206,yakult,360,400,40,2,00194,India
498862,2023-04-08,209,pepsi,75,100,25,2,00499,India
498862,2023-04-08,207,coca cola,75,100,25,2,00499,India
358816,2023-04-08,211,red bull,90,125,35,2,00029,India
358816,2023-04-08,204,strawberry yogurt,50,60,10,2,00029,India
233221,2023-04-08,211,red bull,90,125,35,2,00356,India
930825,2023-04-08,207,coca cola,75,100,25,2,00495,India
930825,2023-04-08,209,pepsi,75,100,25,2,00495,India
930825,2023-04-08,204,strawberry yogurt,50,60,10,2,00495,India
688677,2023-04-08,210,mountain dew,75,100,25,2,00074,India
688677,2023-04-08,207,coca cola,75,100,25,2,00074,India
500334,2023-04-08,211,red bull,90,125,35,2,00023,India
874028,2023-04-08,213,bisleri,6,15,9,2,00298,India
874028,2023-04-08,203,mango yogurt,50,60,10,2,00298,India
874028,2023-04-08,209,pepsi,75,100,25,2,00298,India
580229,2023-04-08,203,mango yogurt,50,60,10,2,00161,India
580229,2023-04-08,208,sprite,75,100,25,2,00161,India
580229,2023-04-08,205,classic yogurt,45,60,15,2,00161,India
580229,2023-04-08,202,milk,12,27,15,1,00161,India
158710,2023-04-08,204,strawberry yogurt,50,60,10,2,00352,India
117475,2023-04-08,203,mango yogurt,50,60,10,2,00428,India
117475,2023-04-08,204,strawberry yogurt,50,60,10,2,00428,India
117475,2023-04-08,211,red bull,90,125,35,2,00428,India
117475,2023-04-08,209,pepsi,75,100,25,2,00428,India
702143,2023-04-08,208,sprite,75,100,25,2,00407,India
182227,2023-04-08,212,amul cheese,250,315,65,1,00137,India
182227,2023-04-08,208,sprite,75,100,25,2,00137,India
182227,2023-04-08,209,pepsi,75,100,25,2,00137,India
748323,2023-04-08,205,classic yogurt,45,60,15,2,00108,India
748323,2023-04-08,210,mountain dew,75,100,25,2,00108,India
748323,2023-04-08,213,bisleri,6,15,9,2,00108,India
577415,2023-04-08,203,mango yogurt,50,60,10,2,00127,India
577415,2023-04-08,212,amul cheese,250,315,65,1,00127,India
872153,2023-04-08,201,paneer,210,340,130,1,00124,India
872153,2023-04-08,204,strawberry yogurt,50,60,10,2,00124,India
872153,2023-04-08,205,classic yogurt,45,60,15,2,00124,India
872153,2023-04-08,212,amul cheese,250,315,65,1,00124,India
872153,2023-04-08,208,sprite,75,100,25,2,00124,India
557282,2023-04-08,201,paneer,210,340,130,1,00113,India
557282,2023-04-08,213,bisleri,6,15,9,2,00113,India
557282,2023-04-08,210,mountain dew,75,100,25,2,00113,India
557282,2023-04-08,205,classic yogurt,45,60,15,2,00113,India
557282,2023-04-08,206,yakult,360,400,40,2,00113,India
444666,2023-04-08,209,pepsi,75,100,25,2,00229,India
444666,2023-04-08,212,amul cheese,250,315,65,1,00229,India
444666,2023-04-08,201,paneer,210,340,130,1,00229,India
444666,2023-04-08,205,classic yogurt,45,60,15,2,00229,India
716504,2023-04-08,203,mango yogurt,50,60,10,2,00390,India
716504,2023-04-08,209,pepsi,75,100,25,2,00390,India
978985,2023-04-08,201,paneer,210,340,130,1,00007,India
978985,2023-04-08,210,mountain dew,75,100,25,2,00007,India
800474,2023-04-08,206,yakult,360,400,40,2,00304,India
800474,2023-04-08,202,milk,12,27,15,1,00304,India
849052,2023-04-08,209,pepsi,75,100,25,2,00391,India
849052,2023-04-08,202,milk,12,27,15,1,00391,India
320187,2023-04-08,204,strawberry yogurt,50,60,10,2,00480,India
320187,2023-04-08,213,bisleri,6,15,9,2,00480,India
927496,2023-04-08,201,paneer,210,340,130,1,00491,India
927496,2023-04-08,209,pepsi,75,100,25,2,00491,India
927496,2023-04-08,204,strawberry yogurt,50,60,10,2,00491,India
927496,2023-04-08,206,yakult,360,400,40,2,00491,India
119423,2023-04-08,213,bisleri,6,15,9,2,00105,India
119423,2023-04-08,209,pepsi,75,100,25,2,00105,India
929496,2023-04-08,201,paneer,210,340,130,1,00148,India
929496,2023-04-08,205,classic yogurt,45,60,15,2,00148,India
929496,2023-04-08,210,mountain dew,75,100,25,2,00148,India
929496,2023-04-08,202,milk,12,27,15,1,00148,India
929496,2023-04-08,206,yakult,360,400,40,2,00148,India
507893,2023-04-08,211,red bull,90,125,35,2,00118,India
507893,2023-04-08,208,sprite,75,100,25,2,00118,India
507893,2023-04-08,206,yakult,360,400,40,2,00118,India
507893,2023-04-08,202,milk,12,27,15,1,00118,India
507893,2023-04-08,212,amul cheese,250,315,65,1,00118,India
493583,2023-04-08,209,pepsi,75,100,25,2,00099,India
493583,2023-04-08,201,paneer,210,340,130,1,00099,India
493583,2023-04-08,206,yakult,360,400,40,2,00099,India
980909,2023-04-08,212,amul cheese,250,315,65,1,00462,India
980909,2023-04-08,208,sprite,75,100,25,2,00462,India
980909,2023-04-08,207,coca cola,75,100,25,2,00462,India
980909,2023-04-08,203,mango yogurt,50,60,10,2,00462,India
980909,2023-04-08,210,mountain dew,75,100,25,2,00462,India
384273,2023-04-08,201,paneer,210,340,130,1,00062,India
384273,2023-04-08,207,coca cola,75,100,25,2,00062,India
384273,2023-04-08,208,sprite,75,100,25,2,00062,India
384273,2023-04-08,211,red bull,90,125,35,2,00062,India
899040,2023-04-08,213,bisleri,6,15,9,2,00287,India
899040,2023-04-08,201,paneer,210,340,130,1,00287,India
899040,2023-04-08,203,mango yogurt,50,60,10,2,00287,India
638254,2023-04-08,213,bisleri,6,15,9,2,00388,India
638254,2023-04-08,201,paneer,210,340,130,1,00388,India
638254,2023-04-08,206,yakult,360,400,40,2,00388,India
372531,2023-04-08,209,pepsi,75,100,25,2,00087,India
372531,2023-04-08,211,red bull,90,125,35,2,00087,India
756257,2023-04-08,205,classic yogurt,45,60,15,2,00110,India
756257,2023-04-08,210,mountain dew,75,100,25,2,00110,India
756257,2023-04-08,209,pepsi,75,100,25,2,00110,India
955022,2023-04-08,209,pepsi,75,100,25,2,00483,India
955022,2023-04-08,210,mountain dew,75,100,25,2,00483,India
531163,2023-04-08,203,mango yogurt,50,60,10,2,00395,India
160345,2023-04-08,210,mountain dew,75,100,25,2,00163,India
160345,2023-04-08,204,strawberry yogurt,50,60,10,2,00163,India
160345,2023-04-08,209,pepsi,75,100,25,2,00163,India
160345,2023-04-08,213,bisleri,6,15,9,2,00163,India
626350,2023-04-08,207,coca cola,75,100,25,2,00430,India
626350,2023-04-08,212,amul cheese,250,315,65,1,00430,India
626350,2023-04-08,205,classic yogurt,45,60,15,2,00430,India
626350,2023-04-08,210,mountain dew,75,100,25,2,00430,India
479454,2023-04-08,206,yakult,360,400,40,2,00143,India
479454,2023-04-08,211,red bull,90,125,35,2,00143,India
171594,2023-04-08,209,pepsi,75,100,25,2,00087,India
322361,2023-04-08,207,coca cola,75,100,25,2,00033,India
913230,2023-04-08,204,strawberry yogurt,50,60,10,2,00175,India
647447,2023-04-08,203,mango yogurt,50,60,10,2,00026,India
647447,2023-04-08,206,yakult,360,400,40,2,00026,India
647447,2023-04-08,210,mountain dew,75,100,25,2,00026,India
597362,2023-04-08,207,coca cola,75,100,25,2,00202,India
597362,2023-04-08,209,pepsi,75,100,25,2,00202,India
597362,2023-04-08,212,amul cheese,250,315,65,1,00202,India
847617,2023-04-08,213,bisleri,6,15,9,2,00347,India
847617,2023-04-08,206,yakult,360,400,40,2,00347,India
847617,2023-04-08,202,milk,12,27,15,1,00347,India
170286,2023-04-08,207,coca cola,75,100,25,2,00350,India
170286,2023-04-08,210,mountain dew,75,100,25,2,00350,India
170286,2023-04-08,204,strawberry yogurt,50,60,10,2,00350,India
170286,2023-04-08,205,classic yogurt,45,60,15,2,00350,India
170286,2023-04-08,212,amul cheese,250,315,65,1,00350,India
989539,2023-04-08,212,amul cheese,250,315,65,1,00459,India
543881,2023-04-08,211,red bull,90,125,35,2,00275,India
543881,2023-04-08,212,amul cheese,250,315,65,1,00275,India
151392,2023-04-08,208,sprite,75,100,25,2,00045,India
151392,2023-04-08,205,classic yogurt,45,60,15,2,00045,India
151392,2023-04-08,204,strawberry yogurt,50,60,10,2,00045,India
151392,2023-04-08,212,amul cheese,250,315,65,1,00045,India
642351,2023-04-08,203,mango yogurt,50,60,10,2,00071,India
642351,2023-04-08,206,yakult,360,400,40,2,00071,India
270728,2023-04-08,213,bisleri,6,15,9,2,00263,India
270728,2023-04-08,203,mango yogurt,50,60,10,2,00263,India
270728,2023-04-08,204,strawberry yogurt,50,60,10,2,00263,India
339613,2023-04-08,213,bisleri,6,15,9,2,00311,India
339613,2023-04-08,209,pepsi,75,100,25,2,00311,India
339613,2023-04-08,201,paneer,210,340,130,1,00311,India
339613,2023-04-08,207,coca cola,75,100,25,2,00311,India
193248,2023-04-08,204,strawberry yogurt,50,60,10,2,00241,India
193248,2023-04-08,212,amul cheese,250,315,65,1,00241,India
193248,2023-04-08,202,milk,12,27,15,1,00241,India
206594,2023-04-08,206,yakult,360,400,40,2,00298,India
396936,2023-04-08,213,bisleri,6,15,9,2,00265,India
396936,2023-04-08,208,sprite,75,100,25,2,00265,India
396936,2023-04-08,206,yakult,360,400,40,2,00265,India
396936,2023-04-08,212,amul cheese,250,315,65,1,00265,India
396936,2023-04-08,203,mango yogurt,50,60,10,2,00265,India
336426,2023-04-08,202,milk,12,27,15,1,00195,India
336426,2023-04-08,207,coca cola,75,100,25,2,00195,India
336426,2023-04-08,203,mango yogurt,50,60,10,2,00195,India
336426,2023-04-08,210,mountain dew,75,100,25,2,00195,India
638724,2023-04-08,202,milk,12,27,15,1,00371,India
638724,2023-04-08,203,mango yogurt,50,60,10,2,00371,India
638724,2023-04-08,204,strawberry yogurt,50,60,10,2,00371,India
638724,2023-04-08,207,coca cola,75,100,25,2,00371,India
804843,2023-04-08,204,strawberry yogurt,50,60,10,2,00262,India
804843,2023-04-08,205,classic yogurt,45,60,15,2,00262,India
804843,2023-04-08,201,paneer,210,340,130,1,00262,India
477457,2023-04-08,204,strawberry yogurt,50,60,10,2,00144,India
477457,2023-04-08,213,bisleri,6,15,9,2,00144,India
477457,2023-04-08,205,classic yogurt,45,60,15,2,00144,India
744782,2023-04-08,208,sprite,75,100,25,2,00496,India
744782,2023-04-08,210,mountain dew,75,100,25,2,00496,India
744782,2023-04-08,201,paneer,210,340,130,1,00496,India
893964,2023-04-08,203,mango yogurt,50,60,10,2,00478,India
781385,2023-04-08,209,pepsi,75,100,25,2,00309,India
781385,2023-04-08,208,sprite,75,100,25,2,00309,India
781385,2023-04-08,211,red bull,90,125,35,2,00309,India
781385,2023-04-08,213,bisleri,6,15,9,2,00309,India
781385,2023-04-08,210,mountain dew,75,100,25,2,00309,India
726189,2023-04-08,211,red bull,90,125,35,2,00400,India
113589,2023-04-09,201,paneer,210,340,130,1,00382,India
113589,2023-04-09,211,red bull,90,125,35,2,00382,India
113589,2023-04-09,207,coca cola,75,100,25,2,00382,India
419315,2023-04-09,213,bisleri,6,15,9,2,00391,India
419315,2023-04-09,208,sprite,75,100,25,2,00391,India
419315,2023-04-09,212,amul cheese,250,315,65,1,00391,India
725407,2023-04-09,208,sprite,75,100,25,2,00346,India
725407,2023-04-09,202,milk,12,27,15,1,00346,India
992317,2023-04-09,201,paneer,210,340,130,1,00330,India
992317,2023-04-09,206,yakult,360,400,40,2,00330,India
992317,2023-04-09,209,pepsi,75,100,25,2,00330,India
623888,2023-04-09,213,bisleri,6,15,9,2,00453,India
623888,2023-04-09,209,pepsi,75,100,25,2,00453,India
669242,2023-04-09,206,yakult,360,400,40,2,00167,India
669242,2023-04-09,203,mango yogurt,50,60,10,2,00167,India
669242,2023-04-09,202,milk,12,27,15,1,00167,India
669242,2023-04-09,213,bisleri,6,15,9,2,00167,India
669242,2023-04-09,207,coca cola,75,100,25,2,00167,India
202391,2023-04-09,206,yakult,360,400,40,2,00218,India
202391,2023-04-09,204,strawberry yogurt,50,60,10,2,00218,India
283126,2023-04-09,202,milk,12,27,15,1,00267,India
283126,2023-04-09,210,mountain dew,75,100,25,2,00267,India
826857,2023-04-09,208,sprite,75,100,25,2,00171,India
826857,2023-04-09,210,mountain dew,75,100,25,2,00171,India
826857,2023-04-09,213,bisleri,6,15,9,2,00171,India
570511,2023-04-09,209,pepsi,75,100,25,2,00214,India
570511,2023-04-09,207,coca cola,75,100,25,2,00214,India
570511,2023-04-09,213,bisleri,6,15,9,2,00214,India
570511,2023-04-09,204,strawberry yogurt,50,60,10,2,00214,India
248824,2023-04-09,208,sprite,75,100,25,2,00056,India
248824,2023-04-09,203,mango yogurt,50,60,10,2,00056,India
248824,2023-04-09,206,yakult,360,400,40,2,00056,India
248824,2023-04-09,212,amul cheese,250,315,65,1,00056,India
993981,2023-04-09,201,paneer,210,340,130,1,00163,India
993981,2023-04-09,208,sprite,75,100,25,2,00163,India
993981,2023-04-09,210,mountain dew,75,100,25,2,00163,India
689791,2023-04-09,206,yakult,360,400,40,2,00254,India
689791,2023-04-09,211,red bull,90,125,35,2,00254,India
689791,2023-04-09,208,sprite,75,100,25,2,00254,India
689791,2023-04-09,201,paneer,210,340,130,1,00254,India
689791,2023-04-09,203,mango yogurt,50,60,10,2,00254,India
116679,2023-04-09,211,red bull,90,125,35,2,00206,India
116679,2023-04-09,210,mountain dew,75,100,25,2,00206,India
465612,2023-04-09,201,paneer,210,340,130,1,00416,India
465612,2023-04-09,203,mango yogurt,50,60,10,2,00416,India
465612,2023-04-09,213,bisleri,6,15,9,2,00416,India
473077,2023-04-09,203,mango yogurt,50,60,10,2,00232,India
473077,2023-04-09,201,paneer,210,340,130,1,00232,India
473077,2023-04-09,210,mountain dew,75,100,25,2,00232,India
473077,2023-04-09,207,coca cola,75,100,25,2,00232,India
279222,2023-04-09,213,bisleri,6,15,9,2,00054,India
279222,2023-04-09,210,mountain dew,75,100,25,2,00054,India
279222,2023-04-09,206,yakult,360,400,40,2,00054,India
667865,2023-04-09,212,amul cheese,250,315,65,1,00237,India
667865,2023-04-09,204,strawberry yogurt,50,60,10,2,00237,India
528295,2023-04-09,203,mango yogurt,50,60,10,2,00466,India
528295,2023-04-09,213,bisleri,6,15,9,2,00466,India
528295,2023-04-09,201,paneer,210,340,130,1,00466,India
502479,2023-04-09,203,mango yogurt,50,60,10,2,00056,India
502479,2023-04-09,213,bisleri,6,15,9,2,00056,India
502479,2023-04-09,207,coca cola,75,100,25,2,00056,India
810480,2023-04-09,208,sprite,75,100,25,2,00088,India
810480,2023-04-09,206,yakult,360,400,40,2,00088,India
598896,2023-04-09,211,red bull,90,125,35,2,00403,India
598896,2023-04-09,208,sprite,75,100,25,2,00403,India
598896,2023-04-09,209,pepsi,75,100,25,2,00403,India
529693,2023-04-09,213,bisleri,6,15,9,2,00185,India
529693,2023-04-09,207,coca cola,75,100,25,2,00185,India
529693,2023-04-09,206,yakult,360,400,40,2,00185,India
633994,2023-04-09,212,amul cheese,250,315,65,1,00072,India
633994,2023-04-09,209,pepsi,75,100,25,2,00072,India
633994,2023-04-09,207,coca cola,75,100,25,2,00072,India
633994,2023-04-09,205,classic yogurt,45,60,15,2,00072,India
733221,2023-04-09,213,bisleri,6,15,9,2,00440,India
759131,2023-04-09,202,milk,12,27,15,1,00300,India
759131,2023-04-09,204,strawberry yogurt,50,60,10,2,00300,India
759131,2023-04-09,208,sprite,75,100,25,2,00300,India
759131,2023-04-09,209,pepsi,75,100,25,2,00300,India
534316,2023-04-09,209,pepsi,75,100,25,2,00328,India
516872,2023-04-09,206,yakult,360,400,40,2,00277,India
516872,2023-04-09,211,red bull,90,125,35,2,00277,India
516872,2023-04-09,204,strawberry yogurt,50,60,10,2,00277,India
967800,2023-04-09,210,mountain dew,75,100,25,2,00425,India
967800,2023-04-09,207,coca cola,75,100,25,2,00425,India
967800,2023-04-09,206,yakult,360,400,40,2,00425,India
967800,2023-04-09,209,pepsi,75,100,25,2,00425,India
967800,2023-04-09,208,sprite,75,100,25,2,00425,India
151762,2023-04-09,207,coca cola,75,100,25,2,00106,India
151762,2023-04-09,205,classic yogurt,45,60,15,2,00106,India
151762,2023-04-09,210,mountain dew,75,100,25,2,00106,India
113990,2023-04-09,211,red bull,90,125,35,2,00052,India
113990,2023-04-09,206,yakult,360,400,40,2,00052,India
113990,2023-04-09,213,bisleri,6,15,9,2,00052,India
557772,2023-04-09,213,bisleri,6,15,9,2,00314,India
557772,2023-04-09,212,amul cheese,250,315,65,1,00314,India
557772,2023-04-09,210,mountain dew,75,100,25,2,00314,India
397354,2023-04-09,208,sprite,75,100,25,2,00220,India
397354,2023-04-09,202,milk,12,27,15,1,00220,India
397354,2023-04-09,209,pepsi,75,100,25,2,00220,India
249482,2023-04-09,201,paneer,210,340,130,1,00485,India
249482,2023-04-09,207,coca cola,75,100,25,2,00485,India
717520,2023-04-09,203,mango yogurt,50,60,10,2,00149,India
717520,2023-04-09,211,red bull,90,125,35,2,00149,India
867711,2023-04-09,204,strawberry yogurt,50,60,10,2,00129,India
356847,2023-04-09,202,milk,12,27,15,1,00300,India
356847,2023-04-09,205,classic yogurt,45,60,15,2,00300,India
356847,2023-04-09,213,bisleri,6,15,9,2,00300,India
356847,2023-04-09,212,amul cheese,250,315,65,1,00300,India
356847,2023-04-09,204,strawberry yogurt,50,60,10,2,00300,India
560047,2023-04-09,213,bisleri,6,15,9,2,00311,India
560047,2023-04-09,210,mountain dew,75,100,25,2,00311,India
557725,2023-04-09,211,red bull,90,125,35,2,00101,India
557725,2023-04-09,209,pepsi,75,100,25,2,00101,India
557725,2023-04-09,206,yakult,360,400,40,2,00101,India
624060,2023-04-09,203,mango yogurt,50,60,10,2,00299,India
624060,2023-04-09,210,mountain dew,75,100,25,2,00299,India
624060,2023-04-09,202,milk,12,27,15,1,00299,India
871694,2023-04-09,212,amul cheese,250,315,65,1,00273,India
206075,2023-04-09,213,bisleri,6,15,9,2,00011,India
312250,2023-04-09,213,bisleri,6,15,9,2,00357,India
312250,2023-04-09,203,mango yogurt,50,60,10,2,00357,India
312250,2023-04-09,205,classic yogurt,45,60,15,2,00357,India
312250,2023-04-09,207,coca cola,75,100,25,2,00357,India
473038,2023-04-09,213,bisleri,6,15,9,2,00171,India
473038,2023-04-09,212,amul cheese,250,315,65,1,00171,India
565000,2023-04-09,212,amul cheese,250,315,65,1,00450,India
565000,2023-04-09,202,milk,12,27,15,1,00450,India
565000,2023-04-09,211,red bull,90,125,35,2,00450,India
115399,2023-04-09,206,yakult,360,400,40,2,00082,India
115399,2023-04-09,203,mango yogurt,50,60,10,2,00082,India
115399,2023-04-09,204,strawberry yogurt,50,60,10,2,00082,India
115399,2023-04-09,212,amul cheese,250,315,65,1,00082,India
115399,2023-04-09,210,mountain dew,75,100,25,2,00082,India
634344,2023-04-09,207,coca cola,75,100,25,2,00140,India
634344,2023-04-09,203,mango yogurt,50,60,10,2,00140,India
634344,2023-04-09,210,mountain dew,75,100,25,2,00140,India
828778,2023-04-09,204,strawberry yogurt,50,60,10,2,00100,India
828778,2023-04-09,205,classic yogurt,45,60,15,2,00100,India
828778,2023-04-09,202,milk,12,27,15,1,00100,India
969616,2023-04-09,213,bisleri,6,15,9,2,00292,India
969616,2023-04-09,204,strawberry yogurt,50,60,10,2,00292,India
969616,2023-04-09,201,paneer,210,340,130,1,00292,India
969616,2023-04-09,202,milk,12,27,15,1,00292,India
969616,2023-04-09,206,yakult,360,400,40,2,00292,India
257524,2023-04-09,206,yakult,360,400,40,2,00319,India
257524,2023-04-09,202,milk,12,27,15,1,00319,India
257524,2023-04-09,205,classic yogurt,45,60,15,2,00319,India
257524,2023-04-09,207,coca cola,75,100,25,2,00319,India
191366,2023-04-09,209,pepsi,75,100,25,2,00423,India
191366,2023-04-09,210,mountain dew,75,100,25,2,00423,India
191366,2023-04-09,206,yakult,360,400,40,2,00423,India
604673,2023-04-09,209,pepsi,75,100,25,2,00433,India
930944,2023-04-09,213,bisleri,6,15,9,2,00071,India
500562,2023-04-09,201,paneer,210,340,130,1,00482,India
500562,2023-04-09,203,mango yogurt,50,60,10,2,00482,India
500562,2023-04-09,213,bisleri,6,15,9,2,00482,India
846999,2023-04-09,208,sprite,75,100,25,2,00326,India
846999,2023-04-09,206,yakult,360,400,40,2,00326,India
846999,2023-04-09,207,coca cola,75,100,25,2,00326,India
846999,2023-04-09,202,milk,12,27,15,1,00326,India
334297,2023-04-09,204,strawberry yogurt,50,60,10,2,00353,India
334297,2023-04-09,213,bisleri,6,15,9,2,00353,India
924921,2023-04-09,205,classic yogurt,45,60,15,2,00325,India
927979,2023-04-09,208,sprite,75,100,25,2,00262,India
927979,2023-04-09,202,milk,12,27,15,1,00262,India
927979,2023-04-09,207,coca cola,75,100,25,2,00262,India
600135,2023-04-09,205,classic yogurt,45,60,15,2,00231,India
253278,2023-04-09,202,milk,12,27,15,1,00166,India
298094,2023-04-09,203,mango yogurt,50,60,10,2,00266,India
298094,2023-04-09,205,classic yogurt,45,60,15,2,00266,India
298094,2023-04-09,212,amul cheese,250,315,65,1,00266,India
473415,2023-04-09,201,paneer,210,340,130,1,00227,India
473415,2023-04-09,205,classic yogurt,45,60,15,2,00227,India
473415,2023-04-09,213,bisleri,6,15,9,2,00227,India
473415,2023-04-09,203,mango yogurt,50,60,10,2,00227,India
470075,2023-04-09,210,mountain dew,75,100,25,2,00409,India
470075,2023-04-09,207,coca cola,75,100,25,2,00409,India
470075,2023-04-09,201,paneer,210,340,130,1,00409,India
318338,2023-04-09,202,milk,12,27,15,1,00343,India
318338,2023-04-09,205,classic yogurt,45,60,15,2,00343,India
231829,2023-04-09,203,mango yogurt,50,60,10,2,00432,India
231829,2023-04-09,204,strawberry yogurt,50,60,10,2,00432,India
576021,2023-04-09,201,paneer,210,340,130,1,00207,India
576021,2023-04-09,206,yakult,360,400,40,2,00207,India
576021,2023-04-09,208,sprite,75,100,25,2,00207,India
948578,2023-04-09,210,mountain dew,75,100,25,2,00476,India
948578,2023-04-09,207,coca cola,75,100,25,2,00476,India
602909,2023-04-09,202,milk,12,27,15,1,00151,India
570730,2023-04-09,208,sprite,75,100,25,2,00456,India
570730,2023-04-09,213,bisleri,6,15,9,2,00456,India
570730,2023-04-09,210,mountain dew,75,100,25,2,00456,India
570730,2023-04-09,203,mango yogurt,50,60,10,2,00456,India
491350,2023-04-09,208,sprite,75,100,25,2,00355,India
491350,2023-04-09,205,classic yogurt,45,60,15,2,00355,India
658244,2023-04-09,206,yakult,360,400,40,2,00024,India
658244,2023-04-09,211,red bull,90,125,35,2,00024,India
658244,2023-04-09,205,classic yogurt,45,60,15,2,00024,India
741203,2023-04-09,205,classic yogurt,45,60,15,2,00026,India
741203,2023-04-09,203,mango yogurt,50,60,10,2,00026,India
741203,2023-04-09,201,paneer,210,340,130,1,00026,India
741203,2023-04-09,210,mountain dew,75,100,25,2,00026,India
498320,2023-04-09,204,strawberry yogurt,50,60,10,2,00100,India
498320,2023-04-09,206,yakult,360,400,40,2,00100,India
920977,2023-04-09,201,paneer,210,340,130,1,00007,India
920977,2023-04-09,211,red bull,90,125,35,2,00007,India
512172,2023-04-09,208,sprite,75,100,25,2,00182,India
377635,2023-04-09,213,bisleri,6,15,9,2,00054,India
377635,2023-04-09,209,pepsi,75,100,25,2,00054,India
197181,2023-04-09,203,mango yogurt,50,60,10,2,00402,India
197181,2023-04-09,205,classic yogurt,45,60,15,2,00402,India
197181,2023-04-09,210,mountain dew,75,100,25,2,00402,India
494293,2023-04-09,202,milk,12,27,15,1,00417,India
494293,2023-04-09,207,coca cola,75,100,25,2,00417,India
494293,2023-04-09,211,red bull,90,125,35,2,00417,India
494293,2023-04-09,204,strawberry yogurt,50,60,10,2,00417,India
494293,2023-04-09,210,mountain dew,75,100,25,2,00417,India
544881,2023-04-09,205,classic yogurt,45,60,15,2,00225,India
544881,2023-04-09,202,milk,12,27,15,1,00225,India
326893,2023-04-09,210,mountain dew,75,100,25,2,00215,India
855695,2023-04-09,203,mango yogurt,50,60,10,2,00024,India
855695,2023-04-09,210,mountain dew,75,100,25,2,00024,India
855695,2023-04-09,209,pepsi,75,100,25,2,00024,India
255570,2023-04-09,201,paneer,210,340,130,1,00241,India
777536,2023-04-09,209,pepsi,75,100,25,2,00044,India
777536,2023-04-09,204,strawberry yogurt,50,60,10,2,00044,India
777536,2023-04-09,212,amul cheese,250,315,65,1,00044,India
777536,2023-04-09,210,mountain dew,75,100,25,2,00044,India
777536,2023-04-09,208,sprite,75,100,25,2,00044,India
825596,2023-04-09,201,paneer,210,340,130,1,00300,India
256192,2023-04-09,204,strawberry yogurt,50,60,10,2,00126,India
857431,2023-04-09,209,pepsi,75,100,25,2,00334,India
644823,2023-04-09,208,sprite,75,100,25,2,00211,India
358337,2023-04-09,213,bisleri,6,15,9,2,00228,India
358337,2023-04-09,204,strawberry yogurt,50,60,10,2,00228,India
358337,2023-04-09,207,coca cola,75,100,25,2,00228,India
358337,2023-04-09,205,classic yogurt,45,60,15,2,00228,India
358337,2023-04-09,206,yakult,360,400,40,2,00228,India
321731,2023-04-09,202,milk,12,27,15,1,00428,India
321731,2023-04-09,207,coca cola,75,100,25,2,00428,India
321731,2023-04-09,201,paneer,210,340,130,1,00428,India
321731,2023-04-09,209,pepsi,75,100,25,2,00428,India
544329,2023-04-09,211,red bull,90,125,35,2,00189,India
544329,2023-04-09,208,sprite,75,100,25,2,00189,India
544329,2023-04-09,201,paneer,210,340,130,1,00189,India
390265,2023-04-09,206,yakult,360,400,40,2,00136,India
390265,2023-04-09,204,strawberry yogurt,50,60,10,2,00136,India
390265,2023-04-09,203,mango yogurt,50,60,10,2,00136,India
983677,2023-04-09,210,mountain dew,75,100,25,2,00183,India
482803,2023-04-09,205,classic yogurt,45,60,15,2,00020,India
482803,2023-04-09,201,paneer,210,340,130,1,00020,India
482803,2023-04-09,213,bisleri,6,15,9,2,00020,India
482803,2023-04-09,209,pepsi,75,100,25,2,00020,India
482803,2023-04-09,210,mountain dew,75,100,25,2,00020,India
444502,2023-04-09,208,sprite,75,100,25,2,00360,India
444502,2023-04-09,204,strawberry yogurt,50,60,10,2,00360,India
444502,2023-04-09,209,pepsi,75,100,25,2,00360,India
444502,2023-04-09,205,classic yogurt,45,60,15,2,00360,India
799366,2023-04-09,212,amul cheese,250,315,65,1,00387,India
799366,2023-04-09,206,yakult,360,400,40,2,00387,India
433774,2023-04-09,212,amul cheese,250,315,65,1,00456,India
727638,2023-04-09,202,milk,12,27,15,1,00401,India
727638,2023-04-09,209,pepsi,75,100,25,2,00401,India
577741,2023-04-10,203,mango yogurt,50,60,10,2,00298,India
577741,2023-04-10,206,yakult,360,400,40,2,00298,India
197964,2023-04-10,203,mango yogurt,50,60,10,2,00022,India
197964,2023-04-10,207,coca cola,75,100,25,2,00022,India
848004,2023-04-10,205,classic yogurt,45,60,15,2,00296,India
848004,2023-04-10,210,mountain dew,75,100,25,2,00296,India
848004,2023-04-10,202,milk,12,27,15,1,00296,India
791053,2023-04-10,211,red bull,90,125,35,2,00037,India
791053,2023-04-10,205,classic yogurt,45,60,15,2,00037,India
791053,2023-04-10,204,strawberry yogurt,50,60,10,2,00037,India
993575,2023-04-10,210,mountain dew,75,100,25,2,00246,India
993575,2023-04-10,211,red bull,90,125,35,2,00246,India
993575,2023-04-10,205,classic yogurt,45,60,15,2,00246,India
993575,2023-04-10,207,coca cola,75,100,25,2,00246,India
486194,2023-04-10,202,milk,12,27,15,1,00357,India
486194,2023-04-10,213,bisleri,6,15,9,2,00357,India
486194,2023-04-10,203,mango yogurt,50,60,10,2,00357,India
486194,2023-04-10,212,amul cheese,250,315,65,1,00357,India
486194,2023-04-10,207,coca cola,75,100,25,2,00357,India
498688,2023-04-10,210,mountain dew,75,100,25,2,00006,India
498688,2023-04-10,211,red bull,90,125,35,2,00006,India
498688,2023-04-10,206,yakult,360,400,40,2,00006,India
498688,2023-04-10,209,pepsi,75,100,25,2,00006,India
976121,2023-04-10,210,mountain dew,75,100,25,2,00495,India
992105,2023-04-10,203,mango yogurt,50,60,10,2,00168,India
535291,2023-04-10,211,red bull,90,125,35,2,00183,India
535291,2023-04-10,206,yakult,360,400,40,2,00183,India
132675,2023-04-10,201,paneer,210,340,130,1,00235,India
132675,2023-04-10,212,amul cheese,250,315,65,1,00235,India
132675,2023-04-10,208,sprite,75,100,25,2,00235,India
132675,2023-04-10,210,mountain dew,75,100,25,2,00235,India
132675,2023-04-10,203,mango yogurt,50,60,10,2,00235,India
811450,2023-04-10,203,mango yogurt,50,60,10,2,00036,India
811450,2023-04-10,201,paneer,210,340,130,1,00036,India
425608,2023-04-10,208,sprite,75,100,25,2,00359,India
900696,2023-04-10,212,amul cheese,250,315,65,1,00451,India
241641,2023-04-10,212,amul cheese,250,315,65,1,00221,India
241641,2023-04-10,205,classic yogurt,45,60,15,2,00221,India
241641,2023-04-10,201,paneer,210,340,130,1,00221,India
241641,2023-04-10,203,mango yogurt,50,60,10,2,00221,India
241641,2023-04-10,209,pepsi,75,100,25,2,00221,India
814650,2023-04-10,201,paneer,210,340,130,1,00328,India
814650,2023-04-10,202,milk,12,27,15,1,00328,India
467437,2023-04-10,206,yakult,360,400,40,2,00207,India
232366,2023-04-10,206,yakult,360,400,40,2,00080,India
232366,2023-04-10,211,red bull,90,125,35,2,00080,India
232366,2023-04-10,208,sprite,75,100,25,2,00080,India
232366,2023-04-10,210,mountain dew,75,100,25,2,00080,India
232366,2023-04-10,201,paneer,210,340,130,1,00080,India
994696,2023-04-10,212,amul cheese,250,315,65,1,00011,India
994696,2023-04-10,205,classic yogurt,45,60,15,2,00011,India
994696,2023-04-10,209,pepsi,75,100,25,2,00011,India
372237,2023-04-10,206,yakult,360,400,40,2,00133,India
372237,2023-04-10,211,red bull,90,125,35,2,00133,India
372237,2023-04-10,203,mango yogurt,50,60,10,2,00133,India
372237,2023-04-10,202,milk,12,27,15,1,00133,India
404549,2023-04-10,203,mango yogurt,50,60,10,2,00131,India
404549,2023-04-10,212,amul cheese,250,315,65,1,00131,India
404549,2023-04-10,201,paneer,210,340,130,1,00131,India
404549,2023-04-10,205,classic yogurt,45,60,15,2,00131,India
238672,2023-04-10,202,milk,12,27,15,1,00222,India
238672,2023-04-10,204,strawberry yogurt,50,60,10,2,00222,India
370479,2023-04-10,209,pepsi,75,100,25,2,00139,India
370479,2023-04-10,205,classic yogurt,45,60,15,2,00139,India
681314,2023-04-10,201,paneer,210,340,130,1,00272,India
681314,2023-04-10,213,bisleri,6,15,9,2,00272,India
681314,2023-04-10,205,classic yogurt,45,60,15,2,00272,India
182290,2023-04-10,213,bisleri,6,15,9,2,00178,India
182290,2023-04-10,205,classic yogurt,45,60,15,2,00178,India
182290,2023-04-10,209,pepsi,75,100,25,2,00178,India
182290,2023-04-10,206,yakult,360,400,40,2,00178,India
614631,2023-04-10,202,milk,12,27,15,1,00500,India
614631,2023-04-10,213,bisleri,6,15,9,2,00500,India
614631,2023-04-10,210,mountain dew,75,100,25,2,00500,India
614631,2023-04-10,204,strawberry yogurt,50,60,10,2,00500,India
143171,2023-04-10,207,coca cola,75,100,25,2,00411,India
143171,2023-04-10,209,pepsi,75,100,25,2,00411,India
988253,2023-04-10,212,amul cheese,250,315,65,1,00394,India
988253,2023-04-10,206,yakult,360,400,40,2,00394,India
988253,2023-04-10,208,sprite,75,100,25,2,00394,India
988253,2023-04-10,203,mango yogurt,50,60,10,2,00394,India
533275,2023-04-10,211,red bull,90,125,35,2,00120,India
590432,2023-04-10,213,bisleri,6,15,9,2,00216,India
590432,2023-04-10,205,classic yogurt,45,60,15,2,00216,India
994682,2023-04-10,204,strawberry yogurt,50,60,10,2,00395,India
586531,2023-04-10,209,pepsi,75,100,25,2,00255,India
586531,2023-04-10,201,paneer,210,340,130,1,00255,India
567236,2023-04-10,201,paneer,210,340,130,1,00497,India
567236,2023-04-10,203,mango yogurt,50,60,10,2,00497,India
567236,2023-04-10,206,yakult,360,400,40,2,00497,India
440119,2023-04-10,201,paneer,210,340,130,1,00187,India
440119,2023-04-10,211,red bull,90,125,35,2,00187,India
440119,2023-04-10,206,yakult,360,400,40,2,00187,India
440119,2023-04-10,213,bisleri,6,15,9,2,00187,India
805873,2023-04-10,205,classic yogurt,45,60,15,2,00374,India
805873,2023-04-10,204,strawberry yogurt,50,60,10,2,00374,India
805873,2023-04-10,213,bisleri,6,15,9,2,00374,India
942483,2023-04-10,205,classic yogurt,45,60,15,2,00304,India
942483,2023-04-10,202,milk,12,27,15,1,00304,India
942483,2023-04-10,211,red bull,90,125,35,2,00304,India
942483,2023-04-10,206,yakult,360,400,40,2,00304,India
942483,2023-04-10,207,coca cola,75,100,25,2,00304,India
322637,2023-04-10,210,mountain dew,75,100,25,2,00188,India
322637,2023-04-10,209,pepsi,75,100,25,2,00188,India
975155,2023-04-10,207,coca cola,75,100,25,2,00223,India
975155,2023-04-10,209,pepsi,75,100,25,2,00223,India
975155,2023-04-10,205,classic yogurt,45,60,15,2,00223,India
992868,2023-04-10,213,bisleri,6,15,9,2,00065,India
458287,2023-04-10,212,amul cheese,250,315,65,1,00384,India
458287,2023-04-10,205,classic yogurt,45,60,15,2,00384,India
331271,2023-04-10,208,sprite,75,100,25,2,00424,India
331271,2023-04-10,204,strawberry yogurt,50,60,10,2,00424,India
903269,2023-04-10,209,pepsi,75,100,25,2,00323,India
903269,2023-04-10,201,paneer,210,340,130,1,00323,India
903269,2023-04-10,203,mango yogurt,50,60,10,2,00323,India
548477,2023-04-10,202,milk,12,27,15,1,00246,India
548477,2023-04-10,201,paneer,210,340,130,1,00246,India
548477,2023-04-10,210,mountain dew,75,100,25,2,00246,India
548477,2023-04-10,207,coca cola,75,100,25,2,00246,India
548477,2023-04-10,211,red bull,90,125,35,2,00246,India
936795,2023-04-10,205,classic yogurt,45,60,15,2,00287,India
936795,2023-04-10,209,pepsi,75,100,25,2,00287,India
936795,2023-04-10,212,amul cheese,250,315,65,1,00287,India
589084,2023-04-10,213,bisleri,6,15,9,2,00061,India
589084,2023-04-10,202,milk,12,27,15,1,00061,India
589084,2023-04-10,208,sprite,75,100,25,2,00061,India
584747,2023-04-10,206,yakult,360,400,40,2,00223,India
584747,2023-04-10,204,strawberry yogurt,50,60,10,2,00223,India
584747,2023-04-10,202,milk,12,27,15,1,00223,India
584747,2023-04-10,210,mountain dew,75,100,25,2,00223,India
221927,2023-04-10,208,sprite,75,100,25,2,00487,India
221927,2023-04-10,205,classic yogurt,45,60,15,2,00487,India
579585,2023-04-10,213,bisleri,6,15,9,2,00252,India
579585,2023-04-10,206,yakult,360,400,40,2,00252,India
742409,2023-04-10,208,sprite,75,100,25,2,00466,India
742409,2023-04-10,212,amul cheese,250,315,65,1,00466,India
378794,2023-04-10,212,amul cheese,250,315,65,1,00214,India
378794,2023-04-10,203,mango yogurt,50,60,10,2,00214,India
378794,2023-04-10,211,red bull,90,125,35,2,00214,India
294763,2023-04-10,206,yakult,360,400,40,2,00110,India
486530,2023-04-10,205,classic yogurt,45,60,15,2,00009,India
486530,2023-04-10,207,coca cola,75,100,25,2,00009,India
486530,2023-04-10,208,sprite,75,100,25,2,00009,India
532110,2023-04-10,209,pepsi,75,100,25,2,00178,India
532110,2023-04-10,206,yakult,360,400,40,2,00178,India
532110,2023-04-10,201,paneer,210,340,130,1,00178,India
532110,2023-04-10,212,amul cheese,250,315,65,1,00178,India
545681,2023-04-10,204,strawberry yogurt,50,60,10,2,00448,India
545681,2023-04-10,207,coca cola,75,100,25,2,00448,India
182896,2023-04-10,201,paneer,210,340,130,1,00249,India
182896,2023-04-10,202,milk,12,27,15,1,00249,India
182896,2023-04-10,212,amul cheese,250,315,65,1,00249,India
182896,2023-04-10,205,classic yogurt,45,60,15,2,00249,India
334460,2023-04-10,204,strawberry yogurt,50,60,10,2,00194,India
334460,2023-04-10,211,red bull,90,125,35,2,00194,India
334460,2023-04-10,209,pepsi,75,100,25,2,00194,India
334460,2023-04-10,202,milk,12,27,15,1,00194,India
102489,2023-04-10,213,bisleri,6,15,9,2,00190,India
102489,2023-04-10,205,classic yogurt,45,60,15,2,00190,India
102489,2023-04-10,208,sprite,75,100,25,2,00190,India
958446,2023-04-10,205,classic yogurt,45,60,15,2,00204,India
958446,2023-04-10,212,amul cheese,250,315,65,1,00204,India
958446,2023-04-10,204,strawberry yogurt,50,60,10,2,00204,India
958446,2023-04-10,201,paneer,210,340,130,1,00204,India
762228,2023-04-10,213,bisleri,6,15,9,2,00424,India
762228,2023-04-10,209,pepsi,75,100,25,2,00424,India
762228,2023-04-10,211,red bull,90,125,35,2,00424,India
700889,2023-04-10,210,mountain dew,75,100,25,2,00054,India
700889,2023-04-10,208,sprite,75,100,25,2,00054,India
700889,2023-04-10,201,paneer,210,340,130,1,00054,India
916136,2023-04-10,212,amul cheese,250,315,65,1,00174,India
727464,2023-04-10,211,red bull,90,125,35,2,00288,India
694883,2023-04-10,208,sprite,75,100,25,2,00028,India
694883,2023-04-10,201,paneer,210,340,130,1,00028,India
694883,2023-04-10,212,amul cheese,250,315,65,1,00028,India
694883,2023-04-10,206,yakult,360,400,40,2,00028,India
447759,2023-04-10,209,pepsi,75,100,25,2,00021,India
621377,2023-04-10,213,bisleri,6,15,9,2,00178,India
621377,2023-04-10,204,strawberry yogurt,50,60,10,2,00178,India
621377,2023-04-10,210,mountain dew,75,100,25,2,00178,India
621377,2023-04-10,208,sprite,75,100,25,2,00178,India
789834,2023-04-10,213,bisleri,6,15,9,2,00217,India
789834,2023-04-10,206,yakult,360,400,40,2,00217,India
789834,2023-04-10,202,milk,12,27,15,1,00217,India
789834,2023-04-10,204,strawberry yogurt,50,60,10,2,00217,India
789834,2023-04-10,211,red bull,90,125,35,2,00217,India
889527,2023-04-10,211,red bull,90,125,35,2,00418,India
889527,2023-04-10,204,strawberry yogurt,50,60,10,2,00418,India
889527,2023-04-10,208,sprite,75,100,25,2,00418,India
218008,2023-04-10,213,bisleri,6,15,9,2,00366,India
425158,2023-04-10,204,strawberry yogurt,50,60,10,2,00050,India
425158,2023-04-10,203,mango yogurt,50,60,10,2,00050,India
425158,2023-04-10,205,classic yogurt,45,60,15,2,00050,India
974548,2023-04-10,205,classic yogurt,45,60,15,2,00265,India
974548,2023-04-10,201,paneer,210,340,130,1,00265,India
974548,2023-04-10,209,pepsi,75,100,25,2,00265,India
974548,2023-04-10,204,strawberry yogurt,50,60,10,2,00265,India
974548,2023-04-10,210,mountain dew,75,100,25,2,00265,India
954551,2023-04-10,203,mango yogurt,50,60,10,2,00033,India
954551,2023-04-10,212,amul cheese,250,315,65,1,00033,India
954551,2023-04-10,207,coca cola,75,100,25,2,00033,India
221253,2023-04-10,211,red bull,90,125,35,2,00019,India
221253,2023-04-10,201,paneer,210,340,130,1,00019,India
221253,2023-04-10,203,mango yogurt,50,60,10,2,00019,India
221253,2023-04-10,202,milk,12,27,15,1,00019,India
608175,2023-04-10,203,mango yogurt,50,60,10,2,00425,India
608175,2023-04-10,212,amul cheese,250,315,65,1,00425,India
491387,2023-04-10,210,mountain dew,75,100,25,2,00118,India
968220,2023-04-10,207,coca cola,75,100,25,2,00254,India
968220,2023-04-10,208,sprite,75,100,25,2,00254,India
968220,2023-04-10,202,milk,12,27,15,1,00254,India
968220,2023-04-10,212,amul cheese,250,315,65,1,00254,India
439415,2023-04-10,204,strawberry yogurt,50,60,10,2,00341,India
158437,2023-04-10,203,mango yogurt,50,60,10,2,00185,India
158437,2023-04-10,209,pepsi,75,100,25,2,00185,India
158437,2023-04-10,206,yakult,360,400,40,2,00185,India
480298,2023-04-10,213,bisleri,6,15,9,2,00455,India
480298,2023-04-10,207,coca cola,75,100,25,2,00455,India
480298,2023-04-10,204,strawberry yogurt,50,60,10,2,00455,India
480298,2023-04-10,205,classic yogurt,45,60,15,2,00455,India
776794,2023-04-11,211,red bull,90,125,35,2,00025,India
776794,2023-04-11,202,milk,12,27,15,1,00025,India
776794,2023-04-11,210,mountain dew,75,100,25,2,00025,India
776794,2023-04-11,208,sprite,75,100,25,2,00025,India
768813,2023-04-11,210,mountain dew,75,100,25,2,00182,India
673125,2023-04-11,207,coca cola,75,100,25,2,00437,India
673125,2023-04-11,212,amul cheese,250,315,65,1,00437,India
211852,2023-04-11,205,classic yogurt,45,60,15,2,00040,India
211852,2023-04-11,202,milk,12,27,15,1,00040,India
211852,2023-04-11,209,pepsi,75,100,25,2,00040,India
945200,2023-04-11,202,milk,12,27,15,1,00054,India
945200,2023-04-11,204,strawberry yogurt,50,60,10,2,00054,India
502503,2023-04-11,206,yakult,360,400,40,2,00017,India
502503,2023-04-11,210,mountain dew,75,100,25,2,00017,India
829513,2023-04-11,209,pepsi,75,100,25,2,00288,India
829513,2023-04-11,211,red bull,90,125,35,2,00288,India
829513,2023-04-11,212,amul cheese,250,315,65,1,00288,India
829513,2023-04-11,207,coca cola,75,100,25,2,00288,India
118190,2023-04-11,203,mango yogurt,50,60,10,2,00150,India
118190,2023-04-11,212,amul cheese,250,315,65,1,00150,India
118190,2023-04-11,204,strawberry yogurt,50,60,10,2,00150,India
524555,2023-04-11,211,red bull,90,125,35,2,00063,India
524555,2023-04-11,207,coca cola,75,100,25,2,00063,India
164974,2023-04-11,208,sprite,75,100,25,2,00475,India
164974,2023-04-11,203,mango yogurt,50,60,10,2,00475,India
913527,2023-04-11,203,mango yogurt,50,60,10,2,00204,India
913527,2023-04-11,204,strawberry yogurt,50,60,10,2,00204,India
913527,2023-04-11,213,bisleri,6,15,9,2,00204,India
913527,2023-04-11,211,red bull,90,125,35,2,00204,India
955418,2023-04-11,210,mountain dew,75,100,25,2,00239,India
955418,2023-04-11,203,mango yogurt,50,60,10,2,00239,India
434427,2023-04-11,210,mountain dew,75,100,25,2,00104,India
434427,2023-04-11,208,sprite,75,100,25,2,00104,India
434427,2023-04-11,212,amul cheese,250,315,65,1,00104,India
434427,2023-04-11,204,strawberry yogurt,50,60,10,2,00104,India
691818,2023-04-11,207,coca cola,75,100,25,2,00026,India
669072,2023-04-11,210,mountain dew,75,100,25,2,00394,India
669072,2023-04-11,211,red bull,90,125,35,2,00394,India
669072,2023-04-11,201,paneer,210,340,130,1,00394,India
488683,2023-04-11,202,milk,12,27,15,1,00461,India
488683,2023-04-11,208,sprite,75,100,25,2,00461,India
488683,2023-04-11,210,mountain dew,75,100,25,2,00461,India
503874,2023-04-11,208,sprite,75,100,25,2,00436,India
503874,2023-04-11,207,coca cola,75,100,25,2,00436,India
503874,2023-04-11,204,strawberry yogurt,50,60,10,2,00436,India
503874,2023-04-11,205,classic yogurt,45,60,15,2,00436,India
136056,2023-04-11,212,amul cheese,250,315,65,1,00374,India
136056,2023-04-11,210,mountain dew,75,100,25,2,00374,India
136056,2023-04-11,207,coca cola,75,100,25,2,00374,India
136056,2023-04-11,205,classic yogurt,45,60,15,2,00374,India
136056,2023-04-11,201,paneer,210,340,130,1,00374,India
385701,2023-04-11,209,pepsi,75,100,25,2,00389,India
385701,2023-04-11,201,paneer,210,340,130,1,00389,India
385701,2023-04-11,206,yakult,360,400,40,2,00389,India
385701,2023-04-11,210,mountain dew,75,100,25,2,00389,India
385701,2023-04-11,208,sprite,75,100,25,2,00389,India
894583,2023-04-11,205,classic yogurt,45,60,15,2,00451,India
894583,2023-04-11,212,amul cheese,250,315,65,1,00451,India
712763,2023-04-11,207,coca cola,75,100,25,2,00410,India
847957,2023-04-11,205,classic yogurt,45,60,15,2,00082,India
847957,2023-04-11,201,paneer,210,340,130,1,00082,India
847957,2023-04-11,208,sprite,75,100,25,2,00082,India
847957,2023-04-11,204,strawberry yogurt,50,60,10,2,00082,India
975044,2023-04-11,203,mango yogurt,50,60,10,2,00290,India
915342,2023-04-11,202,milk,12,27,15,1,00177,India
915342,2023-04-11,210,mountain dew,75,100,25,2,00177,India
915342,2023-04-11,203,mango yogurt,50,60,10,2,00177,India
620133,2023-04-11,202,milk,12,27,15,1,00445,India
620133,2023-04-11,213,bisleri,6,15,9,2,00445,India
620133,2023-04-11,210,mountain dew,75,100,25,2,00445,India
620133,2023-04-11,209,pepsi,75,100,25,2,00445,India
620133,2023-04-11,206,yakult,360,400,40,2,00445,India
581485,2023-04-11,206,yakult,360,400,40,2,00331,India
581485,2023-04-11,210,mountain dew,75,100,25,2,00331,India
581485,2023-04-11,205,classic yogurt,45,60,15,2,00331,India
296943,2023-04-11,211,red bull,90,125,35,2,00143,India
296943,2023-04-11,204,strawberry yogurt,50,60,10,2,00143,India
145237,2023-04-11,209,pepsi,75,100,25,2,00452,India
145237,2023-04-11,204,strawberry yogurt,50,60,10,2,00452,India
145237,2023-04-11,208,sprite,75,100,25,2,00452,India
145237,2023-04-11,205,classic yogurt,45,60,15,2,00452,India
368458,2023-04-11,211,red bull,90,125,35,2,00006,India
368458,2023-04-11,210,mountain dew,75,100,25,2,00006,India
915825,2023-04-11,206,yakult,360,400,40,2,00043,India
915825,2023-04-11,205,classic yogurt,45,60,15,2,00043,India
915825,2023-04-11,213,bisleri,6,15,9,2,00043,India
215451,2023-04-11,205,classic yogurt,45,60,15,2,00219,India
215451,2023-04-11,201,paneer,210,340,130,1,00219,India
215451,2023-04-11,209,pepsi,75,100,25,2,00219,India
215451,2023-04-11,204,strawberry yogurt,50,60,10,2,00219,India
409518,2023-04-11,211,red bull,90,125,35,2,00337,India
876057,2023-04-11,210,mountain dew,75,100,25,2,00132,India
876057,2023-04-11,206,yakult,360,400,40,2,00132,India
876057,2023-04-11,209,pepsi,75,100,25,2,00132,India
876057,2023-04-11,213,bisleri,6,15,9,2,00132,India
368125,2023-04-11,210,mountain dew,75,100,25,2,00151,India
368125,2023-04-11,202,milk,12,27,15,1,00151,India
368125,2023-04-11,205,classic yogurt,45,60,15,2,00151,India
308715,2023-04-11,201,paneer,210,340,130,1,00477,India
308715,2023-04-11,211,red bull,90,125,35,2,00477,India
242414,2023-04-11,209,pepsi,75,100,25,2,00238,India
242414,2023-04-11,211,red bull,90,125,35,2,00238,India
919678,2023-04-11,205,classic yogurt,45,60,15,2,00341,India
742697,2023-04-11,204,strawberry yogurt,50,60,10,2,00004,India
742697,2023-04-11,205,classic yogurt,45,60,15,2,00004,India
742697,2023-04-11,212,amul cheese,250,315,65,1,00004,India
742697,2023-04-11,209,pepsi,75,100,25,2,00004,India
742697,2023-04-11,213,bisleri,6,15,9,2,00004,India
783232,2023-04-11,211,red bull,90,125,35,2,00323,India
783232,2023-04-11,202,milk,12,27,15,1,00323,India
783232,2023-04-11,210,mountain dew,75,100,25,2,00323,India
865165,2023-04-11,212,amul cheese,250,315,65,1,00172,India
865165,2023-04-11,202,milk,12,27,15,1,00172,India
865165,2023-04-11,213,bisleri,6,15,9,2,00172,India
865165,2023-04-11,208,sprite,75,100,25,2,00172,India
686231,2023-04-11,213,bisleri,6,15,9,2,00498,India
686231,2023-04-11,206,yakult,360,400,40,2,00498,India
381259,2023-04-11,206,yakult,360,400,40,2,00443,India
381259,2023-04-11,209,pepsi,75,100,25,2,00443,India
895832,2023-04-11,205,classic yogurt,45,60,15,2,00309,India
895832,2023-04-11,207,coca cola,75,100,25,2,00309,India
227496,2023-04-11,211,red bull,90,125,35,2,00175,India
861245,2023-04-11,211,red bull,90,125,35,2,00499,India
665526,2023-04-11,204,strawberry yogurt,50,60,10,2,00059,India
665526,2023-04-11,210,mountain dew,75,100,25,2,00059,India
665526,2023-04-11,202,milk,12,27,15,1,00059,India
331650,2023-04-11,211,red bull,90,125,35,2,00383,India
331650,2023-04-11,205,classic yogurt,45,60,15,2,00383,India
331650,2023-04-11,202,milk,12,27,15,1,00383,India
331650,2023-04-11,207,coca cola,75,100,25,2,00383,India
753446,2023-04-11,202,milk,12,27,15,1,00446,India
753446,2023-04-11,212,amul cheese,250,315,65,1,00446,India
753446,2023-04-11,205,classic yogurt,45,60,15,2,00446,India
753446,2023-04-11,211,red bull,90,125,35,2,00446,India
753446,2023-04-11,204,strawberry yogurt,50,60,10,2,00446,India
416069,2023-04-11,213,bisleri,6,15,9,2,00469,India
416069,2023-04-11,202,milk,12,27,15,1,00469,India
416069,2023-04-11,207,coca cola,75,100,25,2,00469,India
197144,2023-04-11,208,sprite,75,100,25,2,00250,India
171168,2023-04-11,201,paneer,210,340,130,1,00159,India
171168,2023-04-11,207,coca cola,75,100,25,2,00159,India
171168,2023-04-11,203,mango yogurt,50,60,10,2,00159,India
171168,2023-04-11,202,milk,12,27,15,1,00159,India
981317,2023-04-11,206,yakult,360,400,40,2,00208,India
981317,2023-04-11,201,paneer,210,340,130,1,00208,India
981317,2023-04-11,208,sprite,75,100,25,2,00208,India
407942,2023-04-11,203,mango yogurt,50,60,10,2,00150,India
407942,2023-04-11,210,mountain dew,75,100,25,2,00150,India
930859,2023-04-11,210,mountain dew,75,100,25,2,00039,India
533109,2023-04-11,204,strawberry yogurt,50,60,10,2,00480,India
619209,2023-04-11,209,pepsi,75,100,25,2,00383,India
619209,2023-04-11,201,paneer,210,340,130,1,00383,India
619209,2023-04-11,203,mango yogurt,50,60,10,2,00383,India
619209,2023-04-11,206,yakult,360,400,40,2,00383,India
337084,2023-04-11,205,classic yogurt,45,60,15,2,00356,India
337084,2023-04-11,209,pepsi,75,100,25,2,00356,India
337084,2023-04-11,213,bisleri,6,15,9,2,00356,India
337084,2023-04-11,206,yakult,360,400,40,2,00356,India
798657,2023-04-11,209,pepsi,75,100,25,2,00006,India
798657,2023-04-11,210,mountain dew,75,100,25,2,00006,India
798657,2023-04-11,202,milk,12,27,15,1,00006,India
115279,2023-04-11,210,mountain dew,75,100,25,2,00218,India
115279,2023-04-11,213,bisleri,6,15,9,2,00218,India
115279,2023-04-11,201,paneer,210,340,130,1,00218,India
115279,2023-04-11,212,amul cheese,250,315,65,1,00218,India
387430,2023-04-11,203,mango yogurt,50,60,10,2,00014,India
387430,2023-04-11,205,classic yogurt,45,60,15,2,00014,India
387430,2023-04-11,213,bisleri,6,15,9,2,00014,India
318608,2023-04-11,205,classic yogurt,45,60,15,2,00321,India
318608,2023-04-11,204,strawberry yogurt,50,60,10,2,00321,India
318608,2023-04-11,203,mango yogurt,50,60,10,2,00321,India
318608,2023-04-11,211,red bull,90,125,35,2,00321,India
575524,2023-04-11,208,sprite,75,100,25,2,00393,India
575524,2023-04-11,202,milk,12,27,15,1,00393,India
575524,2023-04-11,201,paneer,210,340,130,1,00393,India
696971,2023-04-11,202,milk,12,27,15,1,00153,India
696971,2023-04-11,205,classic yogurt,45,60,15,2,00153,India
696971,2023-04-11,204,strawberry yogurt,50,60,10,2,00153,India
254294,2023-04-11,205,classic yogurt,45,60,15,2,00161,India
902410,2023-04-11,209,pepsi,75,100,25,2,00102,India
902410,2023-04-11,201,paneer,210,340,130,1,00102,India
902410,2023-04-11,205,classic yogurt,45,60,15,2,00102,India
972904,2023-04-11,205,classic yogurt,45,60,15,2,00036,India
972904,2023-04-11,203,mango yogurt,50,60,10,2,00036,India
972904,2023-04-11,209,pepsi,75,100,25,2,00036,India
972904,2023-04-11,206,yakult,360,400,40,2,00036,India
842085,2023-04-11,211,red bull,90,125,35,2,00009,India
712355,2023-04-12,207,coca cola,75,100,25,2,00324,India
712355,2023-04-12,205,classic yogurt,45,60,15,2,00324,India
712355,2023-04-12,202,milk,12,27,15,1,00324,India
289980,2023-04-12,202,milk,12,27,15,1,00256,India
289980,2023-04-12,208,sprite,75,100,25,2,00256,India
289980,2023-04-12,203,mango yogurt,50,60,10,2,00256,India
289980,2023-04-12,204,strawberry yogurt,50,60,10,2,00256,India
466067,2023-04-12,208,sprite,75,100,25,2,00483,India
466067,2023-04-12,212,amul cheese,250,315,65,1,00483,India
466067,2023-04-12,206,yakult,360,400,40,2,00483,India
466067,2023-04-12,207,coca cola,75,100,25,2,00483,India
404652,2023-04-12,202,milk,12,27,15,1,00023,India
404652,2023-04-12,206,yakult,360,400,40,2,00023,India
404652,2023-04-12,209,pepsi,75,100,25,2,00023,India
772280,2023-04-12,213,bisleri,6,15,9,2,00120,India
772280,2023-04-12,208,sprite,75,100,25,2,00120,India
772280,2023-04-12,210,mountain dew,75,100,25,2,00120,India
772280,2023-04-12,201,paneer,210,340,130,1,00120,India
772280,2023-04-12,207,coca cola,75,100,25,2,00120,India
143045,2023-04-12,201,paneer,210,340,130,1,00122,India
143045,2023-04-12,213,bisleri,6,15,9,2,00122,India
143045,2023-04-12,212,amul cheese,250,315,65,1,00122,India
143045,2023-04-12,203,mango yogurt,50,60,10,2,00122,India
170270,2023-04-12,213,bisleri,6,15,9,2,00244,India
126116,2023-04-12,203,mango yogurt,50,60,10,2,00407,India
126116,2023-04-12,207,coca cola,75,100,25,2,00407,India
184282,2023-04-12,202,milk,12,27,15,1,00481,India
647538,2023-04-12,212,amul cheese,250,315,65,1,00294,India
647538,2023-04-12,204,strawberry yogurt,50,60,10,2,00294,India
647538,2023-04-12,210,mountain dew,75,100,25,2,00294,India
647538,2023-04-12,211,red bull,90,125,35,2,00294,India
258564,2023-04-12,205,classic yogurt,45,60,15,2,00120,India
258564,2023-04-12,202,milk,12,27,15,1,00120,India
258564,2023-04-12,204,strawberry yogurt,50,60,10,2,00120,India
906950,2023-04-12,204,strawberry yogurt,50,60,10,2,00492,India
906950,2023-04-12,202,milk,12,27,15,1,00492,India
906950,2023-04-12,201,paneer,210,340,130,1,00492,India
424952,2023-04-12,210,mountain dew,75,100,25,2,00164,India
424952,2023-04-12,207,coca cola,75,100,25,2,00164,India
424952,2023-04-12,203,mango yogurt,50,60,10,2,00164,India
424952,2023-04-12,201,paneer,210,340,130,1,00164,India
291924,2023-04-12,205,classic yogurt,45,60,15,2,00034,India
291924,2023-04-12,211,red bull,90,125,35,2,00034,India
291924,2023-04-12,206,yakult,360,400,40,2,00034,India
291924,2023-04-12,207,coca cola,75,100,25,2,00034,India
965411,2023-04-12,204,strawberry yogurt,50,60,10,2,00348,India
895930,2023-04-12,213,bisleri,6,15,9,2,00346,India
895930,2023-04-12,204,strawberry yogurt,50,60,10,2,00346,India
895930,2023-04-12,207,coca cola,75,100,25,2,00346,India
727087,2023-04-12,205,classic yogurt,45,60,15,2,00335,India
953623,2023-04-12,207,coca cola,75,100,25,2,00270,India
953623,2023-04-12,203,mango yogurt,50,60,10,2,00270,India
953623,2023-04-12,205,classic yogurt,45,60,15,2,00270,India
540020,2023-04-12,202,milk,12,27,15,1,00173,India
540020,2023-04-12,211,red bull,90,125,35,2,00173,India
540020,2023-04-12,210,mountain dew,75,100,25,2,00173,India
194873,2023-04-12,208,sprite,75,100,25,2,00277,India
194873,2023-04-12,204,strawberry yogurt,50,60,10,2,00277,India
194873,2023-04-12,203,mango yogurt,50,60,10,2,00277,India
628018,2023-04-12,206,yakult,360,400,40,2,00285,India
628018,2023-04-12,201,paneer,210,340,130,1,00285,India
447019,2023-04-12,208,sprite,75,100,25,2,00245,India
447019,2023-04-12,202,milk,12,27,15,1,00245,India
447019,2023-04-12,204,strawberry yogurt,50,60,10,2,00245,India
447019,2023-04-12,206,yakult,360,400,40,2,00245,India
792234,2023-04-12,210,mountain dew,75,100,25,2,00155,India
792234,2023-04-12,205,classic yogurt,45,60,15,2,00155,India
210634,2023-04-12,204,strawberry yogurt,50,60,10,2,00151,India
889320,2023-04-12,212,amul cheese,250,315,65,1,00482,India
889320,2023-04-12,201,paneer,210,340,130,1,00482,India
889320,2023-04-12,209,pepsi,75,100,25,2,00482,India
894480,2023-04-12,213,bisleri,6,15,9,2,00189,India
894480,2023-04-12,208,sprite,75,100,25,2,00189,India
894480,2023-04-12,212,amul cheese,250,315,65,1,00189,India
894480,2023-04-12,207,coca cola,75,100,25,2,00189,India
404835,2023-04-12,208,sprite,75,100,25,2,00380,India
404835,2023-04-12,211,red bull,90,125,35,2,00380,India
384381,2023-04-12,209,pepsi,75,100,25,2,00481,India
384381,2023-04-12,202,milk,12,27,15,1,00481,India
384381,2023-04-12,207,coca cola,75,100,25,2,00481,India
822063,2023-04-12,211,red bull,90,125,35,2,00016,India
408217,2023-04-12,205,classic yogurt,45,60,15,2,00010,India
408217,2023-04-12,203,mango yogurt,50,60,10,2,00010,India
408217,2023-04-12,201,paneer,210,340,130,1,00010,India
408217,2023-04-12,206,yakult,360,400,40,2,00010,India
121387,2023-04-12,210,mountain dew,75,100,25,2,00306,India
121387,2023-04-12,204,strawberry yogurt,50,60,10,2,00306,India
606808,2023-04-12,205,classic yogurt,45,60,15,2,00072,India
712197,2023-04-12,213,bisleri,6,15,9,2,00231,India
712197,2023-04-12,203,mango yogurt,50,60,10,2,00231,India
712197,2023-04-12,208,sprite,75,100,25,2,00231,India
712197,2023-04-12,206,yakult,360,400,40,2,00231,India
712197,2023-04-12,212,amul cheese,250,315,65,1,00231,India
951331,2023-04-12,213,bisleri,6,15,9,2,00357,India
951331,2023-04-12,211,red bull,90,125,35,2,00357,India
951331,2023-04-12,202,milk,12,27,15,1,00357,India
309941,2023-04-12,213,bisleri,6,15,9,2,00115,India
540257,2023-04-12,210,mountain dew,75,100,25,2,00388,India
540257,2023-04-12,209,pepsi,75,100,25,2,00388,India
540257,2023-04-12,213,bisleri,6,15,9,2,00388,India
540257,2023-04-12,201,paneer,210,340,130,1,00388,India
842849,2023-04-12,213,bisleri,6,15,9,2,00056,India
842849,2023-04-12,205,classic yogurt,45,60,15,2,00056,India
842849,2023-04-12,201,paneer,210,340,130,1,00056,India
477780,2023-04-12,211,red bull,90,125,35,2,00124,India
477780,2023-04-12,204,strawberry yogurt,50,60,10,2,00124,India
477780,2023-04-12,206,yakult,360,400,40,2,00124,India
899561,2023-04-12,209,pepsi,75,100,25,2,00172,India
425184,2023-04-12,202,milk,12,27,15,1,00026,India
425184,2023-04-12,212,amul cheese,250,315,65,1,00026,India
425184,2023-04-12,203,mango yogurt,50,60,10,2,00026,India
425184,2023-04-12,213,bisleri,6,15,9,2,00026,India
885730,2023-04-12,209,pepsi,75,100,25,2,00483,India
885730,2023-04-12,207,coca cola,75,100,25,2,00483,India
885730,2023-04-12,208,sprite,75,100,25,2,00483,India
885730,2023-04-12,203,mango yogurt,50,60,10,2,00483,India
657944,2023-04-12,206,yakult,360,400,40,2,00448,India
657944,2023-04-12,209,pepsi,75,100,25,2,00448,India
657944,2023-04-12,213,bisleri,6,15,9,2,00448,India
898541,2023-04-12,213,bisleri,6,15,9,2,00178,India
898541,2023-04-12,208,sprite,75,100,25,2,00178,India
804410,2023-04-12,212,amul cheese,250,315,65,1,00485,India
804410,2023-04-12,206,yakult,360,400,40,2,00485,India
856076,2023-04-12,213,bisleri,6,15,9,2,00447,India
856076,2023-04-12,203,mango yogurt,50,60,10,2,00447,India
856076,2023-04-12,201,paneer,210,340,130,1,00447,India
686252,2023-04-12,209,pepsi,75,100,25,2,00288,India
686252,2023-04-12,207,coca cola,75,100,25,2,00288,India
686252,2023-04-12,204,strawberry yogurt,50,60,10,2,00288,India
803686,2023-04-12,212,amul cheese,250,315,65,1,00090,India
647863,2023-04-12,213,bisleri,6,15,9,2,00177,India
647863,2023-04-12,204,strawberry yogurt,50,60,10,2,00177,India
728996,2023-04-12,208,sprite,75,100,25,2,00416,India
728996,2023-04-12,206,yakult,360,400,40,2,00416,India
728996,2023-04-12,211,red bull,90,125,35,2,00416,India
627735,2023-04-12,213,bisleri,6,15,9,2,00178,India
627735,2023-04-12,207,coca cola,75,100,25,2,00178,India
627735,2023-04-12,211,red bull,90,125,35,2,00178,India
627735,2023-04-12,206,yakult,360,400,40,2,00178,India
138312,2023-04-12,208,sprite,75,100,25,2,00275,India
138312,2023-04-12,210,mountain dew,75,100,25,2,00275,India
231772,2023-04-12,204,strawberry yogurt,50,60,10,2,00007,India
231772,2023-04-12,213,bisleri,6,15,9,2,00007,India
231772,2023-04-12,202,milk,12,27,15,1,00007,India
466714,2023-04-12,211,red bull,90,125,35,2,00398,India
466714,2023-04-12,204,strawberry yogurt,50,60,10,2,00398,India
466714,2023-04-12,210,mountain dew,75,100,25,2,00398,India
466714,2023-04-12,208,sprite,75,100,25,2,00398,India
160094,2023-04-12,208,sprite,75,100,25,2,00407,India
160094,2023-04-12,211,red bull,90,125,35,2,00407,India
144667,2023-04-12,210,mountain dew,75,100,25,2,00419,India
850268,2023-04-12,211,red bull,90,125,35,2,00282,India
850268,2023-04-12,212,amul cheese,250,315,65,1,00282,India
137474,2023-04-12,204,strawberry yogurt,50,60,10,2,00227,India
137474,2023-04-12,213,bisleri,6,15,9,2,00227,India
735623,2023-04-12,209,pepsi,75,100,25,2,00026,India
735623,2023-04-12,201,paneer,210,340,130,1,00026,India
186827,2023-04-12,204,strawberry yogurt,50,60,10,2,00292,India
186827,2023-04-12,201,paneer,210,340,130,1,00292,India
186827,2023-04-12,203,mango yogurt,50,60,10,2,00292,India
305044,2023-04-12,205,classic yogurt,45,60,15,2,00304,India
153672,2023-04-12,206,yakult,360,400,40,2,00383,India
153672,2023-04-12,205,classic yogurt,45,60,15,2,00383,India
885555,2023-04-12,203,mango yogurt,50,60,10,2,00126,India
460442,2023-04-13,208,sprite,75,100,25,2,00202,India
943696,2023-04-13,207,coca cola,75,100,25,2,00343,India
459919,2023-04-13,209,pepsi,75,100,25,2,00471,India
558638,2023-04-13,205,classic yogurt,45,60,15,2,00005,India
558638,2023-04-13,203,mango yogurt,50,60,10,2,00005,India
558638,2023-04-13,207,coca cola,75,100,25,2,00005,India
384050,2023-04-13,208,sprite,75,100,25,2,00028,India
384050,2023-04-13,209,pepsi,75,100,25,2,00028,India
611663,2023-04-13,205,classic yogurt,45,60,15,2,00108,India
611663,2023-04-13,201,paneer,210,340,130,1,00108,India
966723,2023-04-13,213,bisleri,6,15,9,2,00456,India
966723,2023-04-13,210,mountain dew,75,100,25,2,00456,India
966723,2023-04-13,207,coca cola,75,100,25,2,00456,India
686346,2023-04-13,201,paneer,210,340,130,1,00360,India
686346,2023-04-13,209,pepsi,75,100,25,2,00360,India
252393,2023-04-13,206,yakult,360,400,40,2,00179,India
252393,2023-04-13,201,paneer,210,340,130,1,00179,India
252393,2023-04-13,209,pepsi,75,100,25,2,00179,India
252393,2023-04-13,212,amul cheese,250,315,65,1,00179,India
493195,2023-04-13,202,milk,12,27,15,1,00398,India
110862,2023-04-13,211,red bull,90,125,35,2,00218,India
110862,2023-04-13,208,sprite,75,100,25,2,00218,India
110862,2023-04-13,201,paneer,210,340,130,1,00218,India
110862,2023-04-13,210,mountain dew,75,100,25,2,00218,India
961919,2023-04-13,208,sprite,75,100,25,2,00475,India
961919,2023-04-13,213,bisleri,6,15,9,2,00475,India
961919,2023-04-13,210,mountain dew,75,100,25,2,00475,India
961919,2023-04-13,206,yakult,360,400,40,2,00475,India
537893,2023-04-13,203,mango yogurt,50,60,10,2,00018,India
537893,2023-04-13,201,paneer,210,340,130,1,00018,India
537893,2023-04-13,206,yakult,360,400,40,2,00018,India
773278,2023-04-13,203,mango yogurt,50,60,10,2,00425,India
773278,2023-04-13,206,yakult,360,400,40,2,00425,India
590801,2023-04-13,202,milk,12,27,15,1,00452,India
590801,2023-04-13,205,classic yogurt,45,60,15,2,00452,India
590801,2023-04-13,211,red bull,90,125,35,2,00452,India
590801,2023-04-13,210,mountain dew,75,100,25,2,00452,India
258659,2023-04-13,209,pepsi,75,100,25,2,00236,India
258659,2023-04-13,202,milk,12,27,15,1,00236,India
692286,2023-04-13,209,pepsi,75,100,25,2,00186,India
692286,2023-04-13,206,yakult,360,400,40,2,00186,India
692286,2023-04-13,201,paneer,210,340,130,1,00186,India
524856,2023-04-13,204,strawberry yogurt,50,60,10,2,00150,India
524856,2023-04-13,201,paneer,210,340,130,1,00150,India
524856,2023-04-13,207,coca cola,75,100,25,2,00150,India
914791,2023-04-13,208,sprite,75,100,25,2,00220,India
914791,2023-04-13,202,milk,12,27,15,1,00220,India
914791,2023-04-13,205,classic yogurt,45,60,15,2,00220,India
914791,2023-04-13,201,paneer,210,340,130,1,00220,India
277895,2023-04-13,210,mountain dew,75,100,25,2,00364,India
277895,2023-04-13,213,bisleri,6,15,9,2,00364,India
277895,2023-04-13,206,yakult,360,400,40,2,00364,India
208584,2023-04-13,211,red bull,90,125,35,2,00218,India
208584,2023-04-13,207,coca cola,75,100,25,2,00218,India
208584,2023-04-13,206,yakult,360,400,40,2,00218,India
208584,2023-04-13,205,classic yogurt,45,60,15,2,00218,India
583347,2023-04-13,208,sprite,75,100,25,2,00337,India
583347,2023-04-13,204,strawberry yogurt,50,60,10,2,00337,India
583347,2023-04-13,209,pepsi,75,100,25,2,00337,India
583347,2023-04-13,201,paneer,210,340,130,1,00337,India
469917,2023-04-13,202,milk,12,27,15,1,00249,India
469917,2023-04-13,208,sprite,75,100,25,2,00249,India
469917,2023-04-13,206,yakult,360,400,40,2,00249,India
469917,2023-04-13,205,classic yogurt,45,60,15,2,00249,India
330432,2023-04-13,202,milk,12,27,15,1,00154,India
330432,2023-04-13,208,sprite,75,100,25,2,00154,India
330432,2023-04-13,212,amul cheese,250,315,65,1,00154,India
793284,2023-04-13,208,sprite,75,100,25,2,00426,India
793284,2023-04-13,207,coca cola,75,100,25,2,00426,India
853720,2023-04-13,209,pepsi,75,100,25,2,00093,India
616528,2023-04-13,202,milk,12,27,15,1,00025,India
616528,2023-04-13,207,coca cola,75,100,25,2,00025,India
616528,2023-04-13,210,mountain dew,75,100,25,2,00025,India
616528,2023-04-13,211,red bull,90,125,35,2,00025,India
616528,2023-04-13,203,mango yogurt,50,60,10,2,00025,India
363769,2023-04-13,211,red bull,90,125,35,2,00044,India
363769,2023-04-13,210,mountain dew,75,100,25,2,00044,India
363769,2023-04-13,213,bisleri,6,15,9,2,00044,India
363769,2023-04-13,209,pepsi,75,100,25,2,00044,India
993204,2023-04-13,201,paneer,210,340,130,1,00284,India
993204,2023-04-13,210,mountain dew,75,100,25,2,00284,India
834174,2023-04-13,209,pepsi,75,100,25,2,00419,India
834174,2023-04-13,204,strawberry yogurt,50,60,10,2,00419,India
834174,2023-04-13,203,mango yogurt,50,60,10,2,00419,India
834174,2023-04-13,206,yakult,360,400,40,2,00419,India
294044,2023-04-13,213,bisleri,6,15,9,2,00141,India
294044,2023-04-13,208,sprite,75,100,25,2,00141,India
294044,2023-04-13,206,yakult,360,400,40,2,00141,India
192852,2023-04-13,213,bisleri,6,15,9,2,00284,India
192852,2023-04-13,204,strawberry yogurt,50,60,10,2,00284,India
838186,2023-04-13,202,milk,12,27,15,1,00304,India
838186,2023-04-13,206,yakult,360,400,40,2,00304,India
838186,2023-04-13,201,paneer,210,340,130,1,00304,India
788584,2023-04-13,211,red bull,90,125,35,2,00244,India
788584,2023-04-13,204,strawberry yogurt,50,60,10,2,00244,India
788584,2023-04-13,202,milk,12,27,15,1,00244,India
788584,2023-04-13,212,amul cheese,250,315,65,1,00244,India
301504,2023-04-13,202,milk,12,27,15,1,00391,India
301504,2023-04-13,203,mango yogurt,50,60,10,2,00391,India
177858,2023-04-13,202,milk,12,27,15,1,00463,India
177858,2023-04-13,211,red bull,90,125,35,2,00463,India
177858,2023-04-13,206,yakult,360,400,40,2,00463,India
177858,2023-04-13,201,paneer,210,340,130,1,00463,India
177858,2023-04-13,210,mountain dew,75,100,25,2,00463,India
449945,2023-04-13,211,red bull,90,125,35,2,00022,India
449945,2023-04-13,207,coca cola,75,100,25,2,00022,India
121748,2023-04-13,205,classic yogurt,45,60,15,2,00373,India
121748,2023-04-13,210,mountain dew,75,100,25,2,00373,India
121748,2023-04-13,203,mango yogurt,50,60,10,2,00373,India
121748,2023-04-13,208,sprite,75,100,25,2,00373,India
380429,2023-04-13,211,red bull,90,125,35,2,00227,India
380429,2023-04-13,210,mountain dew,75,100,25,2,00227,India
380429,2023-04-13,204,strawberry yogurt,50,60,10,2,00227,India
511538,2023-04-13,213,bisleri,6,15,9,2,00040,India
385619,2023-04-13,209,pepsi,75,100,25,2,00025,India
497346,2023-04-13,208,sprite,75,100,25,2,00431,India
497346,2023-04-13,212,amul cheese,250,315,65,1,00431,India
497346,2023-04-13,201,paneer,210,340,130,1,00431,India
497346,2023-04-13,205,classic yogurt,45,60,15,2,00431,India
497346,2023-04-13,213,bisleri,6,15,9,2,00431,India
530391,2023-04-13,210,mountain dew,75,100,25,2,00141,India
639384,2023-04-13,213,bisleri,6,15,9,2,00002,India
639384,2023-04-13,207,coca cola,75,100,25,2,00002,India
639384,2023-04-13,208,sprite,75,100,25,2,00002,India
639384,2023-04-13,211,red bull,90,125,35,2,00002,India
742853,2023-04-13,207,coca cola,75,100,25,2,00414,India
671513,2023-04-13,204,strawberry yogurt,50,60,10,2,00179,India
671513,2023-04-13,203,mango yogurt,50,60,10,2,00179,India
116826,2023-04-13,204,strawberry yogurt,50,60,10,2,00329,India
116826,2023-04-13,209,pepsi,75,100,25,2,00329,India
662385,2023-04-13,212,amul cheese,250,315,65,1,00190,India
662385,2023-04-13,210,mountain dew,75,100,25,2,00190,India
511674,2023-04-13,207,coca cola,75,100,25,2,00087,India
511674,2023-04-13,213,bisleri,6,15,9,2,00087,India
511674,2023-04-13,212,amul cheese,250,315,65,1,00087,India
219236,2023-04-13,205,classic yogurt,45,60,15,2,00037,India
219236,2023-04-13,211,red bull,90,125,35,2,00037,India
219236,2023-04-13,203,mango yogurt,50,60,10,2,00037,India
189809,2023-04-13,213,bisleri,6,15,9,2,00064,India
189809,2023-04-13,205,classic yogurt,45,60,15,2,00064,India
189809,2023-04-13,203,mango yogurt,50,60,10,2,00064,India
233073,2023-04-13,202,milk,12,27,15,1,00252,India
233073,2023-04-13,210,mountain dew,75,100,25,2,00252,India
233073,2023-04-13,205,classic yogurt,45,60,15,2,00252,India
233073,2023-04-13,207,coca cola,75,100,25,2,00252,India
723229,2023-04-13,205,classic yogurt,45,60,15,2,00050,India
723229,2023-04-13,207,coca cola,75,100,25,2,00050,India
723229,2023-04-13,211,red bull,90,125,35,2,00050,India
723229,2023-04-13,209,pepsi,75,100,25,2,00050,India
893732,2023-04-13,207,coca cola,75,100,25,2,00332,India
851113,2023-04-13,208,sprite,75,100,25,2,00407,India
851113,2023-04-13,211,red bull,90,125,35,2,00407,India
851113,2023-04-13,203,mango yogurt,50,60,10,2,00407,India
380985,2023-04-13,201,paneer,210,340,130,1,00329,India
380985,2023-04-13,213,bisleri,6,15,9,2,00329,India
586889,2023-04-13,203,mango yogurt,50,60,10,2,00315,India
586889,2023-04-13,213,bisleri,6,15,9,2,00315,India
586889,2023-04-13,212,amul cheese,250,315,65,1,00315,India
586889,2023-04-13,204,strawberry yogurt,50,60,10,2,00315,India
586889,2023-04-13,207,coca cola,75,100,25,2,00315,India
386779,2023-04-13,203,mango yogurt,50,60,10,2,00309,India
548014,2023-04-13,213,bisleri,6,15,9,2,00335,India
548014,2023-04-13,203,mango yogurt,50,60,10,2,00335,India
548014,2023-04-13,202,milk,12,27,15,1,00335,India
548014,2023-04-13,208,sprite,75,100,25,2,00335,India
276239,2023-04-13,212,amul cheese,250,315,65,1,00495,India
276239,2023-04-13,204,strawberry yogurt,50,60,10,2,00495,India
276239,2023-04-13,205,classic yogurt,45,60,15,2,00495,India
276239,2023-04-13,209,pepsi,75,100,25,2,00495,India
835391,2023-04-13,210,mountain dew,75,100,25,2,00461,India
835391,2023-04-13,211,red bull,90,125,35,2,00461,India
322640,2023-04-13,201,paneer,210,340,130,1,00009,India
322640,2023-04-13,213,bisleri,6,15,9,2,00009,India
322640,2023-04-13,205,classic yogurt,45,60,15,2,00009,India
840858,2023-04-13,202,milk,12,27,15,1,00468,India
840858,2023-04-13,212,amul cheese,250,315,65,1,00468,India
840858,2023-04-13,203,mango yogurt,50,60,10,2,00468,India
840858,2023-04-13,209,pepsi,75,100,25,2,00468,India
866398,2023-04-13,207,coca cola,75,100,25,2,00225,India
866398,2023-04-13,208,sprite,75,100,25,2,00225,India
866398,2023-04-13,203,mango yogurt,50,60,10,2,00225,India
866398,2023-04-13,212,amul cheese,250,315,65,1,00225,India
866398,2023-04-13,209,pepsi,75,100,25,2,00225,India
591486,2023-04-13,207,coca cola,75,100,25,2,00027,India
591486,2023-04-13,211,red bull,90,125,35,2,00027,India
591486,2023-04-13,212,amul cheese,250,315,65,1,00027,India
591486,2023-04-13,206,yakult,360,400,40,2,00027,India
450112,2023-04-13,205,classic yogurt,45,60,15,2,00285,India
450112,2023-04-13,209,pepsi,75,100,25,2,00285,India
450112,2023-04-13,210,mountain dew,75,100,25,2,00285,India
450112,2023-04-13,211,red bull,90,125,35,2,00285,India
871835,2023-04-13,211,red bull,90,125,35,2,00312,India
871835,2023-04-13,210,mountain dew,75,100,25,2,00312,India
871835,2023-04-13,205,classic yogurt,45,60,15,2,00312,India
871835,2023-04-13,208,sprite,75,100,25,2,00312,India
316436,2023-04-13,201,paneer,210,340,130,1,00390,India
700986,2023-04-13,208,sprite,75,100,25,2,00187,India
700986,2023-04-13,212,amul cheese,250,315,65,1,00187,India
405106,2023-04-13,213,bisleri,6,15,9,2,00404,India
405106,2023-04-13,210,mountain dew,75,100,25,2,00404,India
405106,2023-04-13,209,pepsi,75,100,25,2,00404,India
929309,2023-04-13,209,pepsi,75,100,25,2,00360,India
929309,2023-04-13,206,yakult,360,400,40,2,00360,India
929309,2023-04-13,203,mango yogurt,50,60,10,2,00360,India
929309,2023-04-13,210,mountain dew,75,100,25,2,00360,India
164617,2023-04-13,202,milk,12,27,15,1,00236,India
164617,2023-04-13,207,coca cola,75,100,25,2,00236,India
882012,2023-04-13,210,mountain dew,75,100,25,2,00206,India
882012,2023-04-13,201,paneer,210,340,130,1,00206,India
882012,2023-04-13,211,red bull,90,125,35,2,00206,India
655145,2023-04-13,211,red bull,90,125,35,2,00469,India
655145,2023-04-13,210,mountain dew,75,100,25,2,00469,India
889445,2023-04-13,204,strawberry yogurt,50,60,10,2,00369,India
889445,2023-04-13,207,coca cola,75,100,25,2,00369,India
889445,2023-04-13,213,bisleri,6,15,9,2,00369,India
889445,2023-04-13,211,red bull,90,125,35,2,00369,India
697934,2023-04-14,206,yakult,360,400,40,2,00400,India
697934,2023-04-14,203,mango yogurt,50,60,10,2,00400,India
697934,2023-04-14,213,bisleri,6,15,9,2,00400,India
697934,2023-04-14,205,classic yogurt,45,60,15,2,00400,India
173290,2023-04-14,213,bisleri,6,15,9,2,00208,India
173290,2023-04-14,209,pepsi,75,100,25,2,00208,India
756901,2023-04-14,209,pepsi,75,100,25,2,00177,India
838840,2023-04-14,213,bisleri,6,15,9,2,00181,India
159337,2023-04-14,212,amul cheese,250,315,65,1,00383,India
159337,2023-04-14,213,bisleri,6,15,9,2,00383,India
159337,2023-04-14,210,mountain dew,75,100,25,2,00383,India
159337,2023-04-14,205,classic yogurt,45,60,15,2,00383,India
356354,2023-04-14,203,mango yogurt,50,60,10,2,00214,India
625349,2023-04-14,202,milk,12,27,15,1,00493,India
625349,2023-04-14,211,red bull,90,125,35,2,00493,India
625349,2023-04-14,207,coca cola,75,100,25,2,00493,India
625349,2023-04-14,204,strawberry yogurt,50,60,10,2,00493,India
625349,2023-04-14,212,amul cheese,250,315,65,1,00493,India
425234,2023-04-14,211,red bull,90,125,35,2,00341,India
545479,2023-04-14,206,yakult,360,400,40,2,00021,India
545479,2023-04-14,211,red bull,90,125,35,2,00021,India
545479,2023-04-14,212,amul cheese,250,315,65,1,00021,India
279962,2023-04-14,211,red bull,90,125,35,2,00388,India
279962,2023-04-14,207,coca cola,75,100,25,2,00388,India
279962,2023-04-14,205,classic yogurt,45,60,15,2,00388,India
279962,2023-04-14,213,bisleri,6,15,9,2,00388,India
216927,2023-04-14,209,pepsi,75,100,25,2,00040,India
216927,2023-04-14,205,classic yogurt,45,60,15,2,00040,India
216927,2023-04-14,208,sprite,75,100,25,2,00040,India
281396,2023-04-14,213,bisleri,6,15,9,2,00313,India
281396,2023-04-14,203,mango yogurt,50,60,10,2,00313,India
281396,2023-04-14,209,pepsi,75,100,25,2,00313,India
657389,2023-04-14,202,milk,12,27,15,1,00448,India
657389,2023-04-14,201,paneer,210,340,130,1,00448,India
657389,2023-04-14,212,amul cheese,250,315,65,1,00448,India
657389,2023-04-14,210,mountain dew,75,100,25,2,00448,India
880041,2023-04-14,205,classic yogurt,45,60,15,2,00430,India
263852,2023-04-14,209,pepsi,75,100,25,2,00286,India
477802,2023-04-14,201,paneer,210,340,130,1,00257,India
477802,2023-04-14,206,yakult,360,400,40,2,00257,India
542066,2023-04-14,206,yakult,360,400,40,2,00340,India
542066,2023-04-14,209,pepsi,75,100,25,2,00340,India
134730,2023-04-14,213,bisleri,6,15,9,2,00099,India
134730,2023-04-14,209,pepsi,75,100,25,2,00099,India
134730,2023-04-14,210,mountain dew,75,100,25,2,00099,India
783086,2023-04-14,210,mountain dew,75,100,25,2,00152,India
783086,2023-04-14,208,sprite,75,100,25,2,00152,India
783086,2023-04-14,206,yakult,360,400,40,2,00152,India
783086,2023-04-14,212,amul cheese,250,315,65,1,00152,India
792259,2023-04-14,205,classic yogurt,45,60,15,2,00093,India
792259,2023-04-14,207,coca cola,75,100,25,2,00093,India
802169,2023-04-14,202,milk,12,27,15,1,00196,India
802169,2023-04-14,203,mango yogurt,50,60,10,2,00196,India
802169,2023-04-14,206,yakult,360,400,40,2,00196,India
388652,2023-04-14,206,yakult,360,400,40,2,00412,India
388652,2023-04-14,208,sprite,75,100,25,2,00412,India
154651,2023-04-14,206,yakult,360,400,40,2,00493,India
154651,2023-04-14,210,mountain dew,75,100,25,2,00493,India
154651,2023-04-14,208,sprite,75,100,25,2,00493,India
689117,2023-04-14,206,yakult,360,400,40,2,00161,India
689117,2023-04-14,209,pepsi,75,100,25,2,00161,India
689117,2023-04-14,210,mountain dew,75,100,25,2,00161,India
936213,2023-04-14,205,classic yogurt,45,60,15,2,00114,India
936213,2023-04-14,211,red bull,90,125,35,2,00114,India
936213,2023-04-14,201,paneer,210,340,130,1,00114,India
936213,2023-04-14,207,coca cola,75,100,25,2,00114,India
936213,2023-04-14,202,milk,12,27,15,1,00114,India
206150,2023-04-14,207,coca cola,75,100,25,2,00381,India
206150,2023-04-14,206,yakult,360,400,40,2,00381,India
599872,2023-04-14,208,sprite,75,100,25,2,00064,India
599872,2023-04-14,205,classic yogurt,45,60,15,2,00064,India
599872,2023-04-14,206,yakult,360,400,40,2,00064,India
134696,2023-04-14,204,strawberry yogurt,50,60,10,2,00126,India
193421,2023-04-14,203,mango yogurt,50,60,10,2,00401,India
193421,2023-04-14,209,pepsi,75,100,25,2,00401,India
443004,2023-04-14,212,amul cheese,250,315,65,1,00482,India
443004,2023-04-14,205,classic yogurt,45,60,15,2,00482,India
443004,2023-04-14,210,mountain dew,75,100,25,2,00482,India
443004,2023-04-14,207,coca cola,75,100,25,2,00482,India
579435,2023-04-14,208,sprite,75,100,25,2,00382,India
579435,2023-04-14,211,red bull,90,125,35,2,00382,India
547887,2023-04-14,202,milk,12,27,15,1,00395,India
547887,2023-04-14,206,yakult,360,400,40,2,00395,India
547887,2023-04-14,213,bisleri,6,15,9,2,00395,India
547887,2023-04-14,205,classic yogurt,45,60,15,2,00395,India
547887,2023-04-14,207,coca cola,75,100,25,2,00395,India
752329,2023-04-14,205,classic yogurt,45,60,15,2,00181,India
752329,2023-04-14,206,yakult,360,400,40,2,00181,India
752329,2023-04-14,204,strawberry yogurt,50,60,10,2,00181,India
188331,2023-04-14,207,coca cola,75,100,25,2,00426,India
918191,2023-04-14,202,milk,12,27,15,1,00427,India
918191,2023-04-14,210,mountain dew,75,100,25,2,00427,India
781969,2023-04-14,203,mango yogurt,50,60,10,2,00175,India
347548,2023-04-14,212,amul cheese,250,315,65,1,00363,India
347548,2023-04-14,210,mountain dew,75,100,25,2,00363,India
347548,2023-04-14,209,pepsi,75,100,25,2,00363,India
832265,2023-04-14,201,paneer,210,340,130,1,00355,India
832265,2023-04-14,212,amul cheese,250,315,65,1,00355,India
832265,2023-04-14,209,pepsi,75,100,25,2,00355,India
918734,2023-04-14,212,amul cheese,250,315,65,1,00422,India
918734,2023-04-14,213,bisleri,6,15,9,2,00422,India
918734,2023-04-14,204,strawberry yogurt,50,60,10,2,00422,India
918734,2023-04-14,203,mango yogurt,50,60,10,2,00422,India
631504,2023-04-14,208,sprite,75,100,25,2,00247,India
631504,2023-04-14,204,strawberry yogurt,50,60,10,2,00247,India
631504,2023-04-14,202,milk,12,27,15,1,00247,India
724276,2023-04-14,208,sprite,75,100,25,2,00122,India
724276,2023-04-14,205,classic yogurt,45,60,15,2,00122,India
724276,2023-04-14,211,red bull,90,125,35,2,00122,India
724276,2023-04-14,206,yakult,360,400,40,2,00122,India
246293,2023-04-14,204,strawberry yogurt,50,60,10,2,00274,India
246293,2023-04-14,206,yakult,360,400,40,2,00274,India
246293,2023-04-14,210,mountain dew,75,100,25,2,00274,India
246293,2023-04-14,202,milk,12,27,15,1,00274,India
384811,2023-04-14,212,amul cheese,250,315,65,1,00113,India
384811,2023-04-14,202,milk,12,27,15,1,00113,India
384811,2023-04-14,204,strawberry yogurt,50,60,10,2,00113,India
170917,2023-04-14,212,amul cheese,250,315,65,1,00163,India
170917,2023-04-14,210,mountain dew,75,100,25,2,00163,India
170917,2023-04-14,203,mango yogurt,50,60,10,2,00163,India
170917,2023-04-14,206,yakult,360,400,40,2,00163,India
724402,2023-04-14,207,coca cola,75,100,25,2,00281,India
724402,2023-04-14,208,sprite,75,100,25,2,00281,India
724402,2023-04-14,209,pepsi,75,100,25,2,00281,India
724402,2023-04-14,212,amul cheese,250,315,65,1,00281,India
724402,2023-04-14,204,strawberry yogurt,50,60,10,2,00281,India
285097,2023-04-14,208,sprite,75,100,25,2,00404,India
285097,2023-04-14,203,mango yogurt,50,60,10,2,00404,India
982189,2023-04-14,213,bisleri,6,15,9,2,00176,India
982189,2023-04-14,207,coca cola,75,100,25,2,00176,India
399886,2023-04-14,210,mountain dew,75,100,25,2,00020,India
519348,2023-04-14,206,yakult,360,400,40,2,00400,India
519348,2023-04-14,211,red bull,90,125,35,2,00400,India
269224,2023-04-14,201,paneer,210,340,130,1,00058,India
269224,2023-04-14,208,sprite,75,100,25,2,00058,India
925655,2023-04-14,212,amul cheese,250,315,65,1,00009,India
650616,2023-04-14,211,red bull,90,125,35,2,00137,India
650616,2023-04-14,209,pepsi,75,100,25,2,00137,India
713963,2023-04-14,211,red bull,90,125,35,2,00460,India
713963,2023-04-14,204,strawberry yogurt,50,60,10,2,00460,India
713963,2023-04-14,208,sprite,75,100,25,2,00460,India
587174,2023-04-14,202,milk,12,27,15,1,00042,India
587174,2023-04-14,206,yakult,360,400,40,2,00042,India
449156,2023-04-14,208,sprite,75,100,25,2,00011,India
449156,2023-04-14,213,bisleri,6,15,9,2,00011,India
449156,2023-04-14,205,classic yogurt,45,60,15,2,00011,India
449156,2023-04-14,202,milk,12,27,15,1,00011,India
515187,2023-04-14,203,mango yogurt,50,60,10,2,00472,India
515187,2023-04-14,204,strawberry yogurt,50,60,10,2,00472,India
515187,2023-04-14,211,red bull,90,125,35,2,00472,India
639554,2023-04-14,208,sprite,75,100,25,2,00317,India
639554,2023-04-14,202,milk,12,27,15,1,00317,India
685259,2023-04-14,206,yakult,360,400,40,2,00419,India
130136,2023-04-14,208,sprite,75,100,25,2,00240,India
130136,2023-04-14,206,yakult,360,400,40,2,00240,India
130136,2023-04-14,211,red bull,90,125,35,2,00240,India
287302,2023-04-14,210,mountain dew,75,100,25,2,00180,India
287302,2023-04-14,202,milk,12,27,15,1,00180,India
287302,2023-04-14,204,strawberry yogurt,50,60,10,2,00180,India
287302,2023-04-14,212,amul cheese,250,315,65,1,00180,India
987255,2023-04-14,207,coca cola,75,100,25,2,00469,India
987255,2023-04-14,203,mango yogurt,50,60,10,2,00469,India
987255,2023-04-14,204,strawberry yogurt,50,60,10,2,00469,India
987255,2023-04-14,211,red bull,90,125,35,2,00469,India
875141,2023-04-14,211,red bull,90,125,35,2,00040,India
312231,2023-04-14,207,coca cola,75,100,25,2,00125,India
312231,2023-04-14,202,milk,12,27,15,1,00125,India
921812,2023-04-14,202,milk,12,27,15,1,00323,India
921812,2023-04-14,209,pepsi,75,100,25,2,00323,India
921812,2023-04-14,208,sprite,75,100,25,2,00323,India
802889,2023-04-14,210,mountain dew,75,100,25,2,00122,India
802889,2023-04-14,208,sprite,75,100,25,2,00122,India
802889,2023-04-14,202,milk,12,27,15,1,00122,India
802889,2023-04-14,211,red bull,90,125,35,2,00122,India
802889,2023-04-14,203,mango yogurt,50,60,10,2,00122,India
796926,2023-04-14,203,mango yogurt,50,60,10,2,00055,India
713378,2023-04-14,209,pepsi,75,100,25,2,00274,India
713378,2023-04-14,203,mango yogurt,50,60,10,2,00274,India
713378,2023-04-14,213,bisleri,6,15,9,2,00274,India
713378,2023-04-14,208,sprite,75,100,25,2,00274,India
517967,2023-04-14,201,paneer,210,340,130,1,00069,India
517967,2023-04-14,207,coca cola,75,100,25,2,00069,India
517967,2023-04-14,211,red bull,90,125,35,2,00069,India
517967,2023-04-14,208,sprite,75,100,25,2,00069,India
206344,2023-04-14,202,milk,12,27,15,1,00284,India
206344,2023-04-14,210,mountain dew,75,100,25,2,00284,India
206344,2023-04-14,205,classic yogurt,45,60,15,2,00284,India
344778,2023-04-14,204,strawberry yogurt,50,60,10,2,00343,India
344778,2023-04-14,210,mountain dew,75,100,25,2,00343,India
344778,2023-04-14,202,milk,12,27,15,1,00343,India
972123,2023-04-14,208,sprite,75,100,25,2,00274,India
972123,2023-04-14,207,coca cola,75,100,25,2,00274,India
972123,2023-04-14,211,red bull,90,125,35,2,00274,India
972123,2023-04-14,205,classic yogurt,45,60,15,2,00274,India
972123,2023-04-14,213,bisleri,6,15,9,2,00274,India
967397,2023-04-14,207,coca cola,75,100,25,2,00284,India
967397,2023-04-14,213,bisleri,6,15,9,2,00284,India
782529,2023-04-14,206,yakult,360,400,40,2,00249,India
782529,2023-04-14,213,bisleri,6,15,9,2,00249,India
782529,2023-04-14,210,mountain dew,75,100,25,2,00249,India
782529,2023-04-14,205,classic yogurt,45,60,15,2,00249,India
497224,2023-04-14,204,strawberry yogurt,50,60,10,2,00218,India
497224,2023-04-14,213,bisleri,6,15,9,2,00218,India
497224,2023-04-14,210,mountain dew,75,100,25,2,00218,India
497224,2023-04-14,203,mango yogurt,50,60,10,2,00218,India
497224,2023-04-14,205,classic yogurt,45,60,15,2,00218,India
621849,2023-04-14,210,mountain dew,75,100,25,2,00317,India
621849,2023-04-14,201,paneer,210,340,130,1,00317,India
107010,2023-04-14,209,pepsi,75,100,25,2,00282,India
107010,2023-04-14,206,yakult,360,400,40,2,00282,India
757495,2023-04-14,213,bisleri,6,15,9,2,00075,India
757495,2023-04-14,205,classic yogurt,45,60,15,2,00075,India
545618,2023-04-14,213,bisleri,6,15,9,2,00379,India
545618,2023-04-14,209,pepsi,75,100,25,2,00379,India
554080,2023-04-14,201,paneer,210,340,130,1,00381,India
554080,2023-04-14,204,strawberry yogurt,50,60,10,2,00381,India
554080,2023-04-14,202,milk,12,27,15,1,00381,India
373902,2023-04-14,202,milk,12,27,15,1,00411,India
373902,2023-04-14,205,classic yogurt,45,60,15,2,00411,India
373902,2023-04-14,209,pepsi,75,100,25,2,00411,India
614015,2023-04-14,202,milk,12,27,15,1,00383,India
638277,2023-04-14,213,bisleri,6,15,9,2,00207,India
213594,2023-04-14,209,pepsi,75,100,25,2,00436,India
213594,2023-04-14,205,classic yogurt,45,60,15,2,00436,India
400333,2023-04-14,206,yakult,360,400,40,2,00360,India
400333,2023-04-14,203,mango yogurt,50,60,10,2,00360,India
444256,2023-04-14,210,mountain dew,75,100,25,2,00148,India
444256,2023-04-14,209,pepsi,75,100,25,2,00148,India
444256,2023-04-14,202,milk,12,27,15,1,00148,India
940457,2023-04-14,207,coca cola,75,100,25,2,00435,India
940457,2023-04-14,202,milk,12,27,15,1,00435,India
716715,2023-04-14,206,yakult,360,400,40,2,00478,India
716715,2023-04-14,204,strawberry yogurt,50,60,10,2,00478,India
716715,2023-04-14,213,bisleri,6,15,9,2,00478,India
716715,2023-04-14,208,sprite,75,100,25,2,00478,India
716715,2023-04-14,202,milk,12,27,15,1,00478,India
673469,2023-04-14,209,pepsi,75,100,25,2,00187,India
673469,2023-04-14,207,coca cola,75,100,25,2,00187,India
673469,2023-04-14,204,strawberry yogurt,50,60,10,2,00187,India
673469,2023-04-14,211,red bull,90,125,35,2,00187,India
614886,2023-04-14,213,bisleri,6,15,9,2,00050,India
727362,2023-04-15,209,pepsi,75,100,25,2,00014,India
727362,2023-04-15,201,paneer,210,340,130,1,00014,India
727362,2023-04-15,210,mountain dew,75,100,25,2,00014,India
504054,2023-04-15,202,milk,12,27,15,1,00399,India
504054,2023-04-15,203,mango yogurt,50,60,10,2,00399,India
504054,2023-04-15,212,amul cheese,250,315,65,1,00399,India
504054,2023-04-15,211,red bull,90,125,35,2,00399,India
327233,2023-04-15,213,bisleri,6,15,9,2,00221,India
327233,2023-04-15,206,yakult,360,400,40,2,00221,India
327233,2023-04-15,207,coca cola,75,100,25,2,00221,India
327233,2023-04-15,204,strawberry yogurt,50,60,10,2,00221,India
176024,2023-04-15,212,amul cheese,250,315,65,1,00279,India
176024,2023-04-15,210,mountain dew,75,100,25,2,00279,India
176024,2023-04-15,206,yakult,360,400,40,2,00279,India
503550,2023-04-15,210,mountain dew,75,100,25,2,00255,India
503550,2023-04-15,213,bisleri,6,15,9,2,00255,India
503550,2023-04-15,206,yakult,360,400,40,2,00255,India
849751,2023-04-15,201,paneer,210,340,130,1,00182,India
849751,2023-04-15,207,coca cola,75,100,25,2,00182,India
361156,2023-04-15,207,coca cola,75,100,25,2,00371,India
361156,2023-04-15,208,sprite,75,100,25,2,00371,India
361156,2023-04-15,212,amul cheese,250,315,65,1,00371,India
361156,2023-04-15,209,pepsi,75,100,25,2,00371,India
257809,2023-04-15,207,coca cola,75,100,25,2,00472,India
257809,2023-04-15,211,red bull,90,125,35,2,00472,India
257809,2023-04-15,208,sprite,75,100,25,2,00472,India
826350,2023-04-15,202,milk,12,27,15,1,00212,India
826350,2023-04-15,209,pepsi,75,100,25,2,00212,India
826350,2023-04-15,201,paneer,210,340,130,1,00212,India
826350,2023-04-15,203,mango yogurt,50,60,10,2,00212,India
826350,2023-04-15,210,mountain dew,75,100,25,2,00212,India
259745,2023-04-15,204,strawberry yogurt,50,60,10,2,00147,India
259745,2023-04-15,207,coca cola,75,100,25,2,00147,India
259745,2023-04-15,213,bisleri,6,15,9,2,00147,India
788171,2023-04-15,211,red bull,90,125,35,2,00388,India
788171,2023-04-15,201,paneer,210,340,130,1,00388,India
117696,2023-04-15,213,bisleri,6,15,9,2,00196,India
117696,2023-04-15,211,red bull,90,125,35,2,00196,India
117696,2023-04-15,209,pepsi,75,100,25,2,00196,India
242217,2023-04-15,203,mango yogurt,50,60,10,2,00328,India
735072,2023-04-15,206,yakult,360,400,40,2,00293,India
735072,2023-04-15,209,pepsi,75,100,25,2,00293,India
735072,2023-04-15,201,paneer,210,340,130,1,00293,India
735072,2023-04-15,207,coca cola,75,100,25,2,00293,India
735072,2023-04-15,211,red bull,90,125,35,2,00293,India
354060,2023-04-15,210,mountain dew,75,100,25,2,00251,India
354060,2023-04-15,202,milk,12,27,15,1,00251,India
920956,2023-04-15,201,paneer,210,340,130,1,00409,India
920956,2023-04-15,209,pepsi,75,100,25,2,00409,India
920956,2023-04-15,205,classic yogurt,45,60,15,2,00409,India
141875,2023-04-15,206,yakult,360,400,40,2,00312,India
279265,2023-04-15,202,milk,12,27,15,1,00131,India
279265,2023-04-15,207,coca cola,75,100,25,2,00131,India
279265,2023-04-15,203,mango yogurt,50,60,10,2,00131,India
264869,2023-04-15,201,paneer,210,340,130,1,00240,India
264869,2023-04-15,209,pepsi,75,100,25,2,00240,India
357602,2023-04-15,201,paneer,210,340,130,1,00111,India
413428,2023-04-15,205,classic yogurt,45,60,15,2,00229,India
413428,2023-04-15,203,mango yogurt,50,60,10,2,00229,India
413428,2023-04-15,213,bisleri,6,15,9,2,00229,India
413428,2023-04-15,206,yakult,360,400,40,2,00229,India
787987,2023-04-15,212,amul cheese,250,315,65,1,00469,India
787987,2023-04-15,208,sprite,75,100,25,2,00469,India
549853,2023-04-15,203,mango yogurt,50,60,10,2,00036,India
549853,2023-04-15,212,amul cheese,250,315,65,1,00036,India
549853,2023-04-15,201,paneer,210,340,130,1,00036,India
192430,2023-04-15,204,strawberry yogurt,50,60,10,2,00359,India
192430,2023-04-15,201,paneer,210,340,130,1,00359,India
876875,2023-04-15,204,strawberry yogurt,50,60,10,2,00177,India
876875,2023-04-15,205,classic yogurt,45,60,15,2,00177,India
876875,2023-04-15,209,pepsi,75,100,25,2,00177,India
655453,2023-04-15,212,amul cheese,250,315,65,1,00311,India
655453,2023-04-15,213,bisleri,6,15,9,2,00311,India
687429,2023-04-15,203,mango yogurt,50,60,10,2,00311,India
555300,2023-04-15,211,red bull,90,125,35,2,00460,India
555300,2023-04-15,203,mango yogurt,50,60,10,2,00460,India
555300,2023-04-15,209,pepsi,75,100,25,2,00460,India
555300,2023-04-15,212,amul cheese,250,315,65,1,00460,India
555300,2023-04-15,205,classic yogurt,45,60,15,2,00460,India
878864,2023-04-15,209,pepsi,75,100,25,2,00072,India
878864,2023-04-15,212,amul cheese,250,315,65,1,00072,India
878864,2023-04-15,206,yakult,360,400,40,2,00072,India
972160,2023-04-15,213,bisleri,6,15,9,2,00152,India
972160,2023-04-15,212,amul cheese,250,315,65,1,00152,India
972160,2023-04-15,207,coca cola,75,100,25,2,00152,India
999414,2023-04-15,209,pepsi,75,100,25,2,00347,India
999414,2023-04-15,210,mountain dew,75,100,25,2,00347,India
999414,2023-04-15,202,milk,12,27,15,1,00347,India
999414,2023-04-15,211,red bull,90,125,35,2,00347,India
429309,2023-04-15,212,amul cheese,250,315,65,1,00295,India
429309,2023-04-15,201,paneer,210,340,130,1,00295,India
429309,2023-04-15,211,red bull,90,125,35,2,00295,India
429309,2023-04-15,208,sprite,75,100,25,2,00295,India
361615,2023-04-15,203,mango yogurt,50,60,10,2,00092,India
361615,2023-04-15,209,pepsi,75,100,25,2,00092,India
361615,2023-04-15,211,red bull,90,125,35,2,00092,India
361615,2023-04-15,213,bisleri,6,15,9,2,00092,India
361615,2023-04-15,207,coca cola,75,100,25,2,00092,India
215136,2023-04-15,205,classic yogurt,45,60,15,2,00138,India
215136,2023-04-15,212,amul cheese,250,315,65,1,00138,India
215136,2023-04-15,213,bisleri,6,15,9,2,00138,India
215136,2023-04-15,207,coca cola,75,100,25,2,00138,India
445557,2023-04-15,201,paneer,210,340,130,1,00082,India
484553,2023-04-15,207,coca cola,75,100,25,2,00459,India
484553,2023-04-15,211,red bull,90,125,35,2,00459,India
598008,2023-04-15,211,red bull,90,125,35,2,00293,India
598008,2023-04-15,213,bisleri,6,15,9,2,00293,India
254201,2023-04-15,205,classic yogurt,45,60,15,2,00280,India
774186,2023-04-15,208,sprite,75,100,25,2,00111,India
740397,2023-04-15,207,coca cola,75,100,25,2,00420,India
740397,2023-04-15,203,mango yogurt,50,60,10,2,00420,India
160829,2023-04-15,208,sprite,75,100,25,2,00039,India
160829,2023-04-15,207,coca cola,75,100,25,2,00039,India
160829,2023-04-15,211,red bull,90,125,35,2,00039,India
766311,2023-04-15,204,strawberry yogurt,50,60,10,2,00144,India
458902,2023-04-15,209,pepsi,75,100,25,2,00253,India
458902,2023-04-15,208,sprite,75,100,25,2,00253,India
241545,2023-04-15,208,sprite,75,100,25,2,00245,India
241545,2023-04-15,209,pepsi,75,100,25,2,00245,India
600365,2023-04-15,210,mountain dew,75,100,25,2,00235,India
600365,2023-04-15,205,classic yogurt,45,60,15,2,00235,India
600365,2023-04-15,204,strawberry yogurt,50,60,10,2,00235,India
149767,2023-04-15,201,paneer,210,340,130,1,00209,India
139992,2023-04-15,212,amul cheese,250,315,65,1,00415,India
139992,2023-04-15,204,strawberry yogurt,50,60,10,2,00415,India
139992,2023-04-15,208,sprite,75,100,25,2,00415,India
139992,2023-04-15,202,milk,12,27,15,1,00415,India
806220,2023-04-15,209,pepsi,75,100,25,2,00196,India
806220,2023-04-15,210,mountain dew,75,100,25,2,00196,India
806220,2023-04-15,206,yakult,360,400,40,2,00196,India
726284,2023-04-15,205,classic yogurt,45,60,15,2,00056,India
726284,2023-04-15,212,amul cheese,250,315,65,1,00056,India
726284,2023-04-15,213,bisleri,6,15,9,2,00056,India
726284,2023-04-15,210,mountain dew,75,100,25,2,00056,India
590196,2023-04-15,204,strawberry yogurt,50,60,10,2,00034,India
590196,2023-04-15,207,coca cola,75,100,25,2,00034,India
590196,2023-04-15,212,amul cheese,250,315,65,1,00034,India
590196,2023-04-15,211,red bull,90,125,35,2,00034,India
622957,2023-04-15,202,milk,12,27,15,1,00060,India
622957,2023-04-15,204,strawberry yogurt,50,60,10,2,00060,India
622957,2023-04-15,213,bisleri,6,15,9,2,00060,India
622957,2023-04-15,207,coca cola,75,100,25,2,00060,India
950555,2023-04-15,210,mountain dew,75,100,25,2,00489,India
950555,2023-04-15,207,coca cola,75,100,25,2,00489,India
563192,2023-04-15,206,yakult,360,400,40,2,00094,India
563192,2023-04-15,205,classic yogurt,45,60,15,2,00094,India
563192,2023-04-15,204,strawberry yogurt,50,60,10,2,00094,India
563192,2023-04-15,203,mango yogurt,50,60,10,2,00094,India
563192,2023-04-15,213,bisleri,6,15,9,2,00094,India
871630,2023-04-15,202,milk,12,27,15,1,00492,India
871630,2023-04-15,206,yakult,360,400,40,2,00492,India
871630,2023-04-15,208,sprite,75,100,25,2,00492,India
871630,2023-04-15,209,pepsi,75,100,25,2,00492,India
629920,2023-04-15,209,pepsi,75,100,25,2,00417,India
629920,2023-04-15,211,red bull,90,125,35,2,00417,India
905709,2023-04-15,208,sprite,75,100,25,2,00214,India
905709,2023-04-15,202,milk,12,27,15,1,00214,India
905709,2023-04-15,201,paneer,210,340,130,1,00214,India
322837,2023-04-15,201,paneer,210,340,130,1,00237,India
322837,2023-04-15,208,sprite,75,100,25,2,00237,India
322837,2023-04-15,202,milk,12,27,15,1,00237,India
783180,2023-04-15,212,amul cheese,250,315,65,1,00242,India
783180,2023-04-15,209,pepsi,75,100,25,2,00242,India
783180,2023-04-15,201,paneer,210,340,130,1,00242,India
783180,2023-04-15,203,mango yogurt,50,60,10,2,00242,India
779143,2023-04-15,206,yakult,360,400,40,2,00238,India
779143,2023-04-15,210,mountain dew,75,100,25,2,00238,India
779143,2023-04-15,204,strawberry yogurt,50,60,10,2,00238,India
779143,2023-04-15,211,red bull,90,125,35,2,00238,India
968213,2023-04-15,211,red bull,90,125,35,2,00477,India
968213,2023-04-15,205,classic yogurt,45,60,15,2,00477,India
968213,2023-04-15,207,coca cola,75,100,25,2,00477,India
168428,2023-04-15,204,strawberry yogurt,50,60,10,2,00325,India
168428,2023-04-15,201,paneer,210,340,130,1,00325,India
168428,2023-04-15,205,classic yogurt,45,60,15,2,00325,India
168428,2023-04-15,203,mango yogurt,50,60,10,2,00325,India
442859,2023-04-15,207,coca cola,75,100,25,2,00064,India
442859,2023-04-15,213,bisleri,6,15,9,2,00064,India
310356,2023-04-15,210,mountain dew,75,100,25,2,00150,India
728914,2023-04-15,203,mango yogurt,50,60,10,2,00496,India
728914,2023-04-15,210,mountain dew,75,100,25,2,00496,India
896317,2023-04-15,205,classic yogurt,45,60,15,2,00401,India
896317,2023-04-15,207,coca cola,75,100,25,2,00401,India
458344,2023-04-15,203,mango yogurt,50,60,10,2,00067,India
586742,2023-04-15,203,mango yogurt,50,60,10,2,00082,India
586742,2023-04-15,207,coca cola,75,100,25,2,00082,India
308448,2023-04-15,211,red bull,90,125,35,2,00318,India
308448,2023-04-15,210,mountain dew,75,100,25,2,00318,India
265230,2023-04-15,213,bisleri,6,15,9,2,00315,India
955831,2023-04-15,210,mountain dew,75,100,25,2,00430,India
955831,2023-04-15,207,coca cola,75,100,25,2,00430,India
955831,2023-04-15,211,red bull,90,125,35,2,00430,India
955831,2023-04-15,209,pepsi,75,100,25,2,00430,India
810872,2023-04-15,202,milk,12,27,15,1,00124,India
273606,2023-04-15,205,classic yogurt,45,60,15,2,00441,India
273606,2023-04-15,203,mango yogurt,50,60,10,2,00441,India
273606,2023-04-15,206,yakult,360,400,40,2,00441,India
273606,2023-04-15,207,coca cola,75,100,25,2,00441,India
846498,2023-04-15,210,mountain dew,75,100,25,2,00471,India
422623,2023-04-16,206,yakult,360,400,40,2,00289,India
422623,2023-04-16,211,red bull,90,125,35,2,00289,India
730419,2023-04-16,208,sprite,75,100,25,2,00485,India
730419,2023-04-16,206,yakult,360,400,40,2,00485,India
543909,2023-04-16,203,mango yogurt,50,60,10,2,00095,India
721943,2023-04-16,207,coca cola,75,100,25,2,00118,India
721943,2023-04-16,203,mango yogurt,50,60,10,2,00118,India
746947,2023-04-16,208,sprite,75,100,25,2,00354,India
746947,2023-04-16,203,mango yogurt,50,60,10,2,00354,India
746947,2023-04-16,204,strawberry yogurt,50,60,10,2,00354,India
464654,2023-04-16,209,pepsi,75,100,25,2,00060,India
666160,2023-04-16,202,milk,12,27,15,1,00137,India
666160,2023-04-16,205,classic yogurt,45,60,15,2,00137,India
666160,2023-04-16,213,bisleri,6,15,9,2,00137,India
666160,2023-04-16,201,paneer,210,340,130,1,00137,India
513738,2023-04-16,208,sprite,75,100,25,2,00348,India
513738,2023-04-16,205,classic yogurt,45,60,15,2,00348,India
513738,2023-04-16,210,mountain dew,75,100,25,2,00348,India
513738,2023-04-16,209,pepsi,75,100,25,2,00348,India
513738,2023-04-16,207,coca cola,75,100,25,2,00348,India
860366,2023-04-16,203,mango yogurt,50,60,10,2,00470,India
906136,2023-04-16,203,mango yogurt,50,60,10,2,00009,India
906136,2023-04-16,201,paneer,210,340,130,1,00009,India
906136,2023-04-16,207,coca cola,75,100,25,2,00009,India
906136,2023-04-16,213,bisleri,6,15,9,2,00009,India
475816,2023-04-16,205,classic yogurt,45,60,15,2,00432,India
424987,2023-04-16,212,amul cheese,250,315,65,1,00494,India
424987,2023-04-16,201,paneer,210,340,130,1,00494,India
310815,2023-04-16,207,coca cola,75,100,25,2,00214,India
310815,2023-04-16,210,mountain dew,75,100,25,2,00214,India
310815,2023-04-16,209,pepsi,75,100,25,2,00214,India
931522,2023-04-16,206,yakult,360,400,40,2,00422,India
931522,2023-04-16,210,mountain dew,75,100,25,2,00422,India
931522,2023-04-16,208,sprite,75,100,25,2,00422,India
931522,2023-04-16,212,amul cheese,250,315,65,1,00422,India
931522,2023-04-16,202,milk,12,27,15,1,00422,India
921207,2023-04-16,208,sprite,75,100,25,2,00472,India
921207,2023-04-16,204,strawberry yogurt,50,60,10,2,00472,India
921207,2023-04-16,213,bisleri,6,15,9,2,00472,India
944797,2023-04-16,210,mountain dew,75,100,25,2,00091,India
817256,2023-04-16,202,milk,12,27,15,1,00387,India
817256,2023-04-16,205,classic yogurt,45,60,15,2,00387,India
817256,2023-04-16,207,coca cola,75,100,25,2,00387,India
411300,2023-04-16,207,coca cola,75,100,25,2,00295,India
411300,2023-04-16,212,amul cheese,250,315,65,1,00295,India
411300,2023-04-16,203,mango yogurt,50,60,10,2,00295,India
500632,2023-04-16,205,classic yogurt,45,60,15,2,00370,India
500632,2023-04-16,209,pepsi,75,100,25,2,00370,India
500632,2023-04-16,206,yakult,360,400,40,2,00370,India
881362,2023-04-16,203,mango yogurt,50,60,10,2,00188,India
166122,2023-04-16,207,coca cola,75,100,25,2,00121,India
166122,2023-04-16,209,pepsi,75,100,25,2,00121,India
166122,2023-04-16,202,milk,12,27,15,1,00121,India
166122,2023-04-16,212,amul cheese,250,315,65,1,00121,India
925913,2023-04-16,207,coca cola,75,100,25,2,00350,India
925913,2023-04-16,206,yakult,360,400,40,2,00350,India
925913,2023-04-16,208,sprite,75,100,25,2,00350,India
925913,2023-04-16,202,milk,12,27,15,1,00350,India
383636,2023-04-16,210,mountain dew,75,100,25,2,00309,India
383636,2023-04-16,201,paneer,210,340,130,1,00309,India
383636,2023-04-16,209,pepsi,75,100,25,2,00309,India
383636,2023-04-16,205,classic yogurt,45,60,15,2,00309,India
277804,2023-04-16,208,sprite,75,100,25,2,00091,India
277804,2023-04-16,212,amul cheese,250,315,65,1,00091,India
277804,2023-04-16,202,milk,12,27,15,1,00091,India
812546,2023-04-16,208,sprite,75,100,25,2,00262,India
812546,2023-04-16,209,pepsi,75,100,25,2,00262,India
812546,2023-04-16,206,yakult,360,400,40,2,00262,India
812546,2023-04-16,213,bisleri,6,15,9,2,00262,India
612765,2023-04-16,207,coca cola,75,100,25,2,00263,India
371416,2023-04-16,203,mango yogurt,50,60,10,2,00346,India
371416,2023-04-16,206,yakult,360,400,40,2,00346,India
371416,2023-04-16,205,classic yogurt,45,60,15,2,00346,India
265003,2023-04-16,204,strawberry yogurt,50,60,10,2,00177,India
265003,2023-04-16,206,yakult,360,400,40,2,00177,India
265003,2023-04-16,205,classic yogurt,45,60,15,2,00177,India
265003,2023-04-16,212,amul cheese,250,315,65,1,00177,India
869465,2023-04-16,212,amul cheese,250,315,65,1,00308,India
869465,2023-04-16,205,classic yogurt,45,60,15,2,00308,India
869465,2023-04-16,206,yakult,360,400,40,2,00308,India
869465,2023-04-16,201,paneer,210,340,130,1,00308,India
314663,2023-04-16,203,mango yogurt,50,60,10,2,00395,India
314663,2023-04-16,213,bisleri,6,15,9,2,00395,India
850680,2023-04-16,202,milk,12,27,15,1,00385,India
850680,2023-04-16,211,red bull,90,125,35,2,00385,India
850680,2023-04-16,213,bisleri,6,15,9,2,00385,India
825142,2023-04-16,209,pepsi,75,100,25,2,00134,India
922727,2023-04-16,206,yakult,360,400,40,2,00109,India
669225,2023-04-16,207,coca cola,75,100,25,2,00181,India
669225,2023-04-16,205,classic yogurt,45,60,15,2,00181,India
669225,2023-04-16,206,yakult,360,400,40,2,00181,India
669225,2023-04-16,212,amul cheese,250,315,65,1,00181,India
720339,2023-04-16,213,bisleri,6,15,9,2,00050,India
698700,2023-04-16,203,mango yogurt,50,60,10,2,00253,India
749718,2023-04-16,211,red bull,90,125,35,2,00285,India
749718,2023-04-16,203,mango yogurt,50,60,10,2,00285,India
749718,2023-04-16,212,amul cheese,250,315,65,1,00285,India
749718,2023-04-16,202,milk,12,27,15,1,00285,India
749718,2023-04-16,205,classic yogurt,45,60,15,2,00285,India
615201,2023-04-16,209,pepsi,75,100,25,2,00196,India
127591,2023-04-16,208,sprite,75,100,25,2,00096,India
250773,2023-04-16,205,classic yogurt,45,60,15,2,00343,India
465076,2023-04-16,211,red bull,90,125,35,2,00048,India
465076,2023-04-16,202,milk,12,27,15,1,00048,India
465076,2023-04-16,209,pepsi,75,100,25,2,00048,India
821539,2023-04-16,209,pepsi,75,100,25,2,00055,India
821539,2023-04-16,208,sprite,75,100,25,2,00055,India
821539,2023-04-16,210,mountain dew,75,100,25,2,00055,India
192616,2023-04-16,205,classic yogurt,45,60,15,2,00381,India
192616,2023-04-16,210,mountain dew,75,100,25,2,00381,India
192616,2023-04-16,204,strawberry yogurt,50,60,10,2,00381,India
192616,2023-04-16,206,yakult,360,400,40,2,00381,India
192616,2023-04-16,201,paneer,210,340,130,1,00381,India
689160,2023-04-16,207,coca cola,75,100,25,2,00471,India
689160,2023-04-16,204,strawberry yogurt,50,60,10,2,00471,India
310005,2023-04-16,201,paneer,210,340,130,1,00041,India
310005,2023-04-16,209,pepsi,75,100,25,2,00041,India
948963,2023-04-16,211,red bull,90,125,35,2,00293,India
808921,2023-04-16,202,milk,12,27,15,1,00255,India
655900,2023-04-16,209,pepsi,75,100,25,2,00326,India
655900,2023-04-16,213,bisleri,6,15,9,2,00326,India
655900,2023-04-16,212,amul cheese,250,315,65,1,00326,India
995294,2023-04-16,204,strawberry yogurt,50,60,10,2,00274,India
995294,2023-04-16,201,paneer,210,340,130,1,00274,India
814573,2023-04-16,203,mango yogurt,50,60,10,2,00182,India
231174,2023-04-16,209,pepsi,75,100,25,2,00489,India
231174,2023-04-16,212,amul cheese,250,315,65,1,00489,India
231174,2023-04-16,210,mountain dew,75,100,25,2,00489,India
231174,2023-04-16,206,yakult,360,400,40,2,00489,India
767126,2023-04-16,209,pepsi,75,100,25,2,00181,India
767126,2023-04-16,203,mango yogurt,50,60,10,2,00181,India
767126,2023-04-16,201,paneer,210,340,130,1,00181,India
767126,2023-04-16,204,strawberry yogurt,50,60,10,2,00181,India
560615,2023-04-16,207,coca cola,75,100,25,2,00241,India
774549,2023-04-16,201,paneer,210,340,130,1,00206,India
774549,2023-04-16,212,amul cheese,250,315,65,1,00206,India
774549,2023-04-16,209,pepsi,75,100,25,2,00206,India
377790,2023-04-16,210,mountain dew,75,100,25,2,00318,India
818360,2023-04-16,202,milk,12,27,15,1,00213,India
281566,2023-04-16,202,milk,12,27,15,1,00077,India
281566,2023-04-16,212,amul cheese,250,315,65,1,00077,India
281566,2023-04-16,209,pepsi,75,100,25,2,00077,India
281566,2023-04-16,203,mango yogurt,50,60,10,2,00077,India
241385,2023-04-16,206,yakult,360,400,40,2,00253,India
241385,2023-04-16,208,sprite,75,100,25,2,00253,India
241385,2023-04-16,201,paneer,210,340,130,1,00253,India
241385,2023-04-16,203,mango yogurt,50,60,10,2,00253,India
241385,2023-04-16,209,pepsi,75,100,25,2,00253,India
191678,2023-04-16,203,mango yogurt,50,60,10,2,00019,India
191678,2023-04-16,209,pepsi,75,100,25,2,00019,India
191678,2023-04-16,212,amul cheese,250,315,65,1,00019,India
333235,2023-04-16,212,amul cheese,250,315,65,1,00317,India
333235,2023-04-16,208,sprite,75,100,25,2,00317,India
333235,2023-04-16,201,paneer,210,340,130,1,00317,India
777675,2023-04-16,213,bisleri,6,15,9,2,00131,India
777675,2023-04-16,206,yakult,360,400,40,2,00131,India
878203,2023-04-16,203,mango yogurt,50,60,10,2,00426,India
878203,2023-04-16,212,amul cheese,250,315,65,1,00426,India
763382,2023-04-16,211,red bull,90,125,35,2,00245,India
242321,2023-04-16,209,pepsi,75,100,25,2,00032,India
242321,2023-04-16,210,mountain dew,75,100,25,2,00032,India
242321,2023-04-16,206,yakult,360,400,40,2,00032,India
242321,2023-04-16,204,strawberry yogurt,50,60,10,2,00032,India
461187,2023-04-17,208,sprite,75,100,25,2,00336,India
461187,2023-04-17,202,milk,12,27,15,1,00336,India
461187,2023-04-17,204,strawberry yogurt,50,60,10,2,00336,India
838217,2023-04-17,213,bisleri,6,15,9,2,00487,India
369740,2023-04-17,210,mountain dew,75,100,25,2,00194,India
214538,2023-04-17,201,paneer,210,340,130,1,00033,India
289970,2023-04-17,203,mango yogurt,50,60,10,2,00446,India
289970,2023-04-17,205,classic yogurt,45,60,15,2,00446,India
763889,2023-04-17,207,coca cola,75,100,25,2,00363,India
763889,2023-04-17,208,sprite,75,100,25,2,00363,India
763889,2023-04-17,205,classic yogurt,45,60,15,2,00363,India
491566,2023-04-17,209,pepsi,75,100,25,2,00254,India
491566,2023-04-17,213,bisleri,6,15,9,2,00254,India
491566,2023-04-17,205,classic yogurt,45,60,15,2,00254,India
491566,2023-04-17,208,sprite,75,100,25,2,00254,India
515438,2023-04-17,210,mountain dew,75,100,25,2,00057,India
515438,2023-04-17,207,coca cola,75,100,25,2,00057,India
418992,2023-04-17,202,milk,12,27,15,1,00430,India
418992,2023-04-17,206,yakult,360,400,40,2,00430,India
418992,2023-04-17,205,classic yogurt,45,60,15,2,00430,India
418992,2023-04-17,203,mango yogurt,50,60,10,2,00430,India
790708,2023-04-17,210,mountain dew,75,100,25,2,00142,India
790708,2023-04-17,212,amul cheese,250,315,65,1,00142,India
790708,2023-04-17,207,coca cola,75,100,25,2,00142,India
178222,2023-04-17,203,mango yogurt,50,60,10,2,00142,India
191290,2023-04-17,212,amul cheese,250,315,65,1,00185,India
191290,2023-04-17,204,strawberry yogurt,50,60,10,2,00185,India
191290,2023-04-17,201,paneer,210,340,130,1,00185,India
802459,2023-04-17,210,mountain dew,75,100,25,2,00099,India
802459,2023-04-17,202,milk,12,27,15,1,00099,India
135987,2023-04-17,207,coca cola,75,100,25,2,00160,India
135987,2023-04-17,212,amul cheese,250,315,65,1,00160,India
456298,2023-04-17,202,milk,12,27,15,1,00174,India
456298,2023-04-17,204,strawberry yogurt,50,60,10,2,00174,India
285876,2023-04-17,206,yakult,360,400,40,2,00495,India
285876,2023-04-17,213,bisleri,6,15,9,2,00495,India
285876,2023-04-17,203,mango yogurt,50,60,10,2,00495,India
285876,2023-04-17,205,classic yogurt,45,60,15,2,00495,India
285876,2023-04-17,209,pepsi,75,100,25,2,00495,India
214531,2023-04-17,213,bisleri,6,15,9,2,00203,India
390723,2023-04-17,204,strawberry yogurt,50,60,10,2,00086,India
390723,2023-04-17,212,amul cheese,250,315,65,1,00086,India
500744,2023-04-17,205,classic yogurt,45,60,15,2,00261,India
500744,2023-04-17,204,strawberry yogurt,50,60,10,2,00261,India
366373,2023-04-17,207,coca cola,75,100,25,2,00066,India
366373,2023-04-17,210,mountain dew,75,100,25,2,00066,India
366373,2023-04-17,209,pepsi,75,100,25,2,00066,India
366373,2023-04-17,205,classic yogurt,45,60,15,2,00066,India
911725,2023-04-17,209,pepsi,75,100,25,2,00480,India
118698,2023-04-17,202,milk,12,27,15,1,00426,India
118698,2023-04-17,203,mango yogurt,50,60,10,2,00426,India
285366,2023-04-17,204,strawberry yogurt,50,60,10,2,00087,India
285366,2023-04-17,206,yakult,360,400,40,2,00087,India
939401,2023-04-17,201,paneer,210,340,130,1,00228,India
535815,2023-04-17,212,amul cheese,250,315,65,1,00228,India
535815,2023-04-17,204,strawberry yogurt,50,60,10,2,00228,India
535815,2023-04-17,202,milk,12,27,15,1,00228,India
535815,2023-04-17,213,bisleri,6,15,9,2,00228,India
192462,2023-04-17,213,bisleri,6,15,9,2,00303,India
192462,2023-04-17,209,pepsi,75,100,25,2,00303,India
883788,2023-04-17,213,bisleri,6,15,9,2,00062,India
883788,2023-04-17,210,mountain dew,75,100,25,2,00062,India
883788,2023-04-17,202,milk,12,27,15,1,00062,India
883788,2023-04-17,201,paneer,210,340,130,1,00062,India
862614,2023-04-17,211,red bull,90,125,35,2,00215,India
862614,2023-04-17,208,sprite,75,100,25,2,00215,India
862614,2023-04-17,206,yakult,360,400,40,2,00215,India
409820,2023-04-17,202,milk,12,27,15,1,00162,India
409820,2023-04-17,211,red bull,90,125,35,2,00162,India
479712,2023-04-17,210,mountain dew,75,100,25,2,00065,India
479712,2023-04-17,203,mango yogurt,50,60,10,2,00065,India
479712,2023-04-17,207,coca cola,75,100,25,2,00065,India
479712,2023-04-17,211,red bull,90,125,35,2,00065,India
585036,2023-04-17,202,milk,12,27,15,1,00075,India
585036,2023-04-17,212,amul cheese,250,315,65,1,00075,India
585036,2023-04-17,204,strawberry yogurt,50,60,10,2,00075,India
585036,2023-04-17,211,red bull,90,125,35,2,00075,India
991843,2023-04-17,213,bisleri,6,15,9,2,00102,India
991843,2023-04-17,205,classic yogurt,45,60,15,2,00102,India
991843,2023-04-17,201,paneer,210,340,130,1,00102,India
991843,2023-04-17,203,mango yogurt,50,60,10,2,00102,India
110242,2023-04-17,202,milk,12,27,15,1,00118,India
110242,2023-04-17,205,classic yogurt,45,60,15,2,00118,India
677746,2023-04-17,210,mountain dew,75,100,25,2,00255,India
664938,2023-04-17,201,paneer,210,340,130,1,00311,India
664938,2023-04-17,213,bisleri,6,15,9,2,00311,India
702723,2023-04-17,207,coca cola,75,100,25,2,00354,India
702723,2023-04-17,212,amul cheese,250,315,65,1,00354,India
702723,2023-04-17,204,strawberry yogurt,50,60,10,2,00354,India
702723,2023-04-17,208,sprite,75,100,25,2,00354,India
464801,2023-04-17,203,mango yogurt,50,60,10,2,00037,India
464801,2023-04-17,205,classic yogurt,45,60,15,2,00037,India
464801,2023-04-17,210,mountain dew,75,100,25,2,00037,India
746767,2023-04-17,211,red bull,90,125,35,2,00261,India
746767,2023-04-17,210,mountain dew,75,100,25,2,00261,India
746767,2023-04-17,212,amul cheese,250,315,65,1,00261,India
746767,2023-04-17,208,sprite,75,100,25,2,00261,India
373877,2023-04-17,201,paneer,210,340,130,1,00218,India
373877,2023-04-17,204,strawberry yogurt,50,60,10,2,00218,India
373877,2023-04-17,207,coca cola,75,100,25,2,00218,India
625832,2023-04-17,204,strawberry yogurt,50,60,10,2,00316,India
625832,2023-04-17,205,classic yogurt,45,60,15,2,00316,India
625832,2023-04-17,210,mountain dew,75,100,25,2,00316,India
459152,2023-04-17,212,amul cheese,250,315,65,1,00210,India
459152,2023-04-17,209,pepsi,75,100,25,2,00210,India
459152,2023-04-17,205,classic yogurt,45,60,15,2,00210,India
459152,2023-04-17,203,mango yogurt,50,60,10,2,00210,India
224404,2023-04-17,213,bisleri,6,15,9,2,00391,India
224404,2023-04-17,210,mountain dew,75,100,25,2,00391,India
224404,2023-04-17,212,amul cheese,250,315,65,1,00391,India
956575,2023-04-17,213,bisleri,6,15,9,2,00175,India
956575,2023-04-17,205,classic yogurt,45,60,15,2,00175,India
956575,2023-04-17,202,milk,12,27,15,1,00175,India
956575,2023-04-17,203,mango yogurt,50,60,10,2,00175,India
816662,2023-04-17,201,paneer,210,340,130,1,00377,India
816662,2023-04-17,203,mango yogurt,50,60,10,2,00377,India
816662,2023-04-17,213,bisleri,6,15,9,2,00377,India
127151,2023-04-17,212,amul cheese,250,315,65,1,00476,India
127151,2023-04-17,213,bisleri,6,15,9,2,00476,India
127151,2023-04-17,207,coca cola,75,100,25,2,00476,India
127151,2023-04-17,210,mountain dew,75,100,25,2,00476,India
963224,2023-04-17,212,amul cheese,250,315,65,1,00023,India
963224,2023-04-17,204,strawberry yogurt,50,60,10,2,00023,India
681765,2023-04-17,210,mountain dew,75,100,25,2,00370,India
586969,2023-04-17,205,classic yogurt,45,60,15,2,00138,India
586969,2023-04-17,203,mango yogurt,50,60,10,2,00138,India
586969,2023-04-17,212,amul cheese,250,315,65,1,00138,India
586969,2023-04-17,209,pepsi,75,100,25,2,00138,India
420293,2023-04-17,212,amul cheese,250,315,65,1,00066,India
420293,2023-04-17,202,milk,12,27,15,1,00066,India
420293,2023-04-17,211,red bull,90,125,35,2,00066,India
346828,2023-04-17,207,coca cola,75,100,25,2,00423,India
346828,2023-04-17,210,mountain dew,75,100,25,2,00423,India
346828,2023-04-17,202,milk,12,27,15,1,00423,India
346828,2023-04-17,203,mango yogurt,50,60,10,2,00423,India
357803,2023-04-17,205,classic yogurt,45,60,15,2,00375,India
357803,2023-04-17,211,red bull,90,125,35,2,00375,India
357803,2023-04-17,209,pepsi,75,100,25,2,00375,India
499709,2023-04-17,209,pepsi,75,100,25,2,00257,India
499709,2023-04-17,205,classic yogurt,45,60,15,2,00257,India
499709,2023-04-17,202,milk,12,27,15,1,00257,India
499709,2023-04-17,201,paneer,210,340,130,1,00257,India
614538,2023-04-17,208,sprite,75,100,25,2,00094,India
614538,2023-04-17,212,amul cheese,250,315,65,1,00094,India
614538,2023-04-17,209,pepsi,75,100,25,2,00094,India
614538,2023-04-17,201,paneer,210,340,130,1,00094,India
712007,2023-04-17,209,pepsi,75,100,25,2,00493,India
712007,2023-04-17,203,mango yogurt,50,60,10,2,00493,India
712007,2023-04-17,213,bisleri,6,15,9,2,00493,India
525923,2023-04-17,203,mango yogurt,50,60,10,2,00453,India
525923,2023-04-17,207,coca cola,75,100,25,2,00453,India
525923,2023-04-17,211,red bull,90,125,35,2,00453,India
562051,2023-04-17,204,strawberry yogurt,50,60,10,2,00226,India
562051,2023-04-17,201,paneer,210,340,130,1,00226,India
562051,2023-04-17,211,red bull,90,125,35,2,00226,India
562051,2023-04-17,203,mango yogurt,50,60,10,2,00226,India
807156,2023-04-17,209,pepsi,75,100,25,2,00205,India
807156,2023-04-17,204,strawberry yogurt,50,60,10,2,00205,India
807156,2023-04-17,203,mango yogurt,50,60,10,2,00205,India
807156,2023-04-17,207,coca cola,75,100,25,2,00205,India
202241,2023-04-17,210,mountain dew,75,100,25,2,00307,India
202241,2023-04-17,206,yakult,360,400,40,2,00307,India
202241,2023-04-17,205,classic yogurt,45,60,15,2,00307,India
202241,2023-04-17,213,bisleri,6,15,9,2,00307,India
996907,2023-04-17,201,paneer,210,340,130,1,00055,India
996907,2023-04-17,211,red bull,90,125,35,2,00055,India
996907,2023-04-17,212,amul cheese,250,315,65,1,00055,India
303727,2023-04-17,201,paneer,210,340,130,1,00181,India
303727,2023-04-17,205,classic yogurt,45,60,15,2,00181,India
303727,2023-04-17,208,sprite,75,100,25,2,00181,India
171571,2023-04-17,211,red bull,90,125,35,2,00340,India
362605,2023-04-17,210,mountain dew,75,100,25,2,00436,India
554391,2023-04-17,205,classic yogurt,45,60,15,2,00287,India
565871,2023-04-17,205,classic yogurt,45,60,15,2,00314,India
565871,2023-04-17,201,paneer,210,340,130,1,00314,India
565871,2023-04-17,208,sprite,75,100,25,2,00314,India
565871,2023-04-17,202,milk,12,27,15,1,00314,India
565871,2023-04-17,210,mountain dew,75,100,25,2,00314,India
996752,2023-04-17,211,red bull,90,125,35,2,00155,India
996752,2023-04-17,203,mango yogurt,50,60,10,2,00155,India
330858,2023-04-17,211,red bull,90,125,35,2,00387,India
330858,2023-04-17,208,sprite,75,100,25,2,00387,India
330858,2023-04-17,213,bisleri,6,15,9,2,00387,India
455380,2023-04-17,205,classic yogurt,45,60,15,2,00157,India
455380,2023-04-17,201,paneer,210,340,130,1,00157,India
876564,2023-04-17,209,pepsi,75,100,25,2,00153,India
876564,2023-04-17,206,yakult,360,400,40,2,00153,India
876564,2023-04-17,213,bisleri,6,15,9,2,00153,India
876564,2023-04-17,202,milk,12,27,15,1,00153,India
129414,2023-04-17,209,pepsi,75,100,25,2,00040,India
129414,2023-04-17,212,amul cheese,250,315,65,1,00040,India
129414,2023-04-17,202,milk,12,27,15,1,00040,India
860208,2023-04-17,212,amul cheese,250,315,65,1,00350,India
860208,2023-04-17,208,sprite,75,100,25,2,00350,India
860208,2023-04-17,211,red bull,90,125,35,2,00350,India
608584,2023-04-17,201,paneer,210,340,130,1,00472,India
608584,2023-04-17,206,yakult,360,400,40,2,00472,India
608584,2023-04-17,208,sprite,75,100,25,2,00472,India
892751,2023-04-17,204,strawberry yogurt,50,60,10,2,00103,India
892751,2023-04-17,210,mountain dew,75,100,25,2,00103,India
892751,2023-04-17,201,paneer,210,340,130,1,00103,India
892751,2023-04-17,213,bisleri,6,15,9,2,00103,India
474180,2023-04-17,202,milk,12,27,15,1,00361,India
108381,2023-04-17,208,sprite,75,100,25,2,00123,India
108381,2023-04-17,207,coca cola,75,100,25,2,00123,India
108381,2023-04-17,202,milk,12,27,15,1,00123,India
765558,2023-04-17,208,sprite,75,100,25,2,00413,India
765558,2023-04-17,207,coca cola,75,100,25,2,00413,India
849036,2023-04-17,204,strawberry yogurt,50,60,10,2,00315,India
690113,2023-04-17,202,milk,12,27,15,1,00318,India
690113,2023-04-17,212,amul cheese,250,315,65,1,00318,India
690113,2023-04-17,201,paneer,210,340,130,1,00318,India
690113,2023-04-17,209,pepsi,75,100,25,2,00318,India
690113,2023-04-17,208,sprite,75,100,25,2,00318,India
134121,2023-04-17,209,pepsi,75,100,25,2,00124,India
134121,2023-04-17,205,classic yogurt,45,60,15,2,00124,India
134121,2023-04-17,203,mango yogurt,50,60,10,2,00124,India
134121,2023-04-17,201,paneer,210,340,130,1,00124,India
134121,2023-04-17,213,bisleri,6,15,9,2,00124,India
276730,2023-04-17,201,paneer,210,340,130,1,00118,India
148970,2023-04-17,213,bisleri,6,15,9,2,00199,India
970899,2023-04-17,208,sprite,75,100,25,2,00186,India
970899,2023-04-17,206,yakult,360,400,40,2,00186,India
970899,2023-04-17,210,mountain dew,75,100,25,2,00186,India
970899,2023-04-17,209,pepsi,75,100,25,2,00186,India
970899,2023-04-17,204,strawberry yogurt,50,60,10,2,00186,India
706457,2023-04-18,203,mango yogurt,50,60,10,2,00375,India
706457,2023-04-18,205,classic yogurt,45,60,15,2,00375,India
706457,2023-04-18,212,amul cheese,250,315,65,1,00375,India
706457,2023-04-18,210,mountain dew,75,100,25,2,00375,India
706457,2023-04-18,206,yakult,360,400,40,2,00375,India
439604,2023-04-18,201,paneer,210,340,130,1,00023,India
439604,2023-04-18,206,yakult,360,400,40,2,00023,India
714412,2023-04-18,212,amul cheese,250,315,65,1,00470,India
714412,2023-04-18,207,coca cola,75,100,25,2,00470,India
714412,2023-04-18,208,sprite,75,100,25,2,00470,India
348990,2023-04-18,203,mango yogurt,50,60,10,2,00091,India
348990,2023-04-18,205,classic yogurt,45,60,15,2,00091,India
348990,2023-04-18,204,strawberry yogurt,50,60,10,2,00091,India
348990,2023-04-18,206,yakult,360,400,40,2,00091,India
348990,2023-04-18,210,mountain dew,75,100,25,2,00091,India
108247,2023-04-18,213,bisleri,6,15,9,2,00479,India
108247,2023-04-18,203,mango yogurt,50,60,10,2,00479,India
272311,2023-04-18,204,strawberry yogurt,50,60,10,2,00324,India
272311,2023-04-18,202,milk,12,27,15,1,00324,India
272311,2023-04-18,207,coca cola,75,100,25,2,00324,India
272311,2023-04-18,201,paneer,210,340,130,1,00324,India
871575,2023-04-18,203,mango yogurt,50,60,10,2,00489,India
871575,2023-04-18,207,coca cola,75,100,25,2,00489,India
871575,2023-04-18,202,milk,12,27,15,1,00489,India
871575,2023-04-18,205,classic yogurt,45,60,15,2,00489,India
426403,2023-04-18,201,paneer,210,340,130,1,00155,India
426403,2023-04-18,213,bisleri,6,15,9,2,00155,India
426403,2023-04-18,203,mango yogurt,50,60,10,2,00155,India
426403,2023-04-18,204,strawberry yogurt,50,60,10,2,00155,India
798074,2023-04-18,209,pepsi,75,100,25,2,00260,India
798074,2023-04-18,208,sprite,75,100,25,2,00260,India
730211,2023-04-18,213,bisleri,6,15,9,2,00132,India
730211,2023-04-18,206,yakult,360,400,40,2,00132,India
730211,2023-04-18,201,paneer,210,340,130,1,00132,India
730211,2023-04-18,202,milk,12,27,15,1,00132,India
809353,2023-04-18,207,coca cola,75,100,25,2,00412,India
809353,2023-04-18,212,amul cheese,250,315,65,1,00412,India
841727,2023-04-18,206,yakult,360,400,40,2,00319,India
841727,2023-04-18,201,paneer,210,340,130,1,00319,India
841727,2023-04-18,211,red bull,90,125,35,2,00319,India
841727,2023-04-18,213,bisleri,6,15,9,2,00319,India
575839,2023-04-18,209,pepsi,75,100,25,2,00451,India
575839,2023-04-18,201,paneer,210,340,130,1,00451,India
575839,2023-04-18,204,strawberry yogurt,50,60,10,2,00451,India
575839,2023-04-18,208,sprite,75,100,25,2,00451,India
101400,2023-04-18,213,bisleri,6,15,9,2,00017,India
101400,2023-04-18,208,sprite,75,100,25,2,00017,India
978542,2023-04-18,206,yakult,360,400,40,2,00361,India
288286,2023-04-18,208,sprite,75,100,25,2,00480,India
288286,2023-04-18,212,amul cheese,250,315,65,1,00480,India
288286,2023-04-18,207,coca cola,75,100,25,2,00480,India
665713,2023-04-18,209,pepsi,75,100,25,2,00348,India
665713,2023-04-18,206,yakult,360,400,40,2,00348,India
665713,2023-04-18,201,paneer,210,340,130,1,00348,India
958252,2023-04-18,209,pepsi,75,100,25,2,00097,India
958252,2023-04-18,210,mountain dew,75,100,25,2,00097,India
134383,2023-04-18,207,coca cola,75,100,25,2,00439,India
134383,2023-04-18,201,paneer,210,340,130,1,00439,India
908472,2023-04-18,206,yakult,360,400,40,2,00064,India
908472,2023-04-18,209,pepsi,75,100,25,2,00064,India
908472,2023-04-18,205,classic yogurt,45,60,15,2,00064,India
908472,2023-04-18,210,mountain dew,75,100,25,2,00064,India
909826,2023-04-18,211,red bull,90,125,35,2,00028,India
909826,2023-04-18,206,yakult,360,400,40,2,00028,India
909826,2023-04-18,205,classic yogurt,45,60,15,2,00028,India
909826,2023-04-18,212,amul cheese,250,315,65,1,00028,India
337158,2023-04-18,203,mango yogurt,50,60,10,2,00278,India
337158,2023-04-18,213,bisleri,6,15,9,2,00278,India
721388,2023-04-18,210,mountain dew,75,100,25,2,00224,India
721388,2023-04-18,204,strawberry yogurt,50,60,10,2,00224,India
684319,2023-04-18,201,paneer,210,340,130,1,00384,India
684319,2023-04-18,210,mountain dew,75,100,25,2,00384,India
684319,2023-04-18,209,pepsi,75,100,25,2,00384,India
538902,2023-04-18,203,mango yogurt,50,60,10,2,00058,India
538902,2023-04-18,207,coca cola,75,100,25,2,00058,India
538902,2023-04-18,209,pepsi,75,100,25,2,00058,India
538902,2023-04-18,208,sprite,75,100,25,2,00058,India
538902,2023-04-18,204,strawberry yogurt,50,60,10,2,00058,India
655863,2023-04-18,204,strawberry yogurt,50,60,10,2,00441,India
655863,2023-04-18,208,sprite,75,100,25,2,00441,India
655863,2023-04-18,201,paneer,210,340,130,1,00441,India
275416,2023-04-18,204,strawberry yogurt,50,60,10,2,00056,India
587788,2023-04-18,212,amul cheese,250,315,65,1,00133,India
587788,2023-04-18,213,bisleri,6,15,9,2,00133,India
494070,2023-04-18,208,sprite,75,100,25,2,00137,India
494070,2023-04-18,210,mountain dew,75,100,25,2,00137,India
494070,2023-04-18,207,coca cola,75,100,25,2,00137,India
494070,2023-04-18,206,yakult,360,400,40,2,00137,India
126375,2023-04-18,213,bisleri,6,15,9,2,00333,India
327649,2023-04-18,202,milk,12,27,15,1,00068,India
327649,2023-04-18,212,amul cheese,250,315,65,1,00068,India
535837,2023-04-18,209,pepsi,75,100,25,2,00239,India
535837,2023-04-18,212,amul cheese,250,315,65,1,00239,India
230171,2023-04-18,201,paneer,210,340,130,1,00438,India
230171,2023-04-18,206,yakult,360,400,40,2,00438,India
102494,2023-04-18,213,bisleri,6,15,9,2,00366,India
102494,2023-04-18,206,yakult,360,400,40,2,00366,India
102494,2023-04-18,207,coca cola,75,100,25,2,00366,India
682339,2023-04-18,205,classic yogurt,45,60,15,2,00476,India
682339,2023-04-18,207,coca cola,75,100,25,2,00476,India
682339,2023-04-18,203,mango yogurt,50,60,10,2,00476,India
682339,2023-04-18,212,amul cheese,250,315,65,1,00476,India
727468,2023-04-18,208,sprite,75,100,25,2,00199,India
727468,2023-04-18,211,red bull,90,125,35,2,00199,India
991236,2023-04-18,213,bisleri,6,15,9,2,00057,India
877022,2023-04-18,210,mountain dew,75,100,25,2,00028,India
877022,2023-04-18,205,classic yogurt,45,60,15,2,00028,India
877022,2023-04-18,208,sprite,75,100,25,2,00028,India
877022,2023-04-18,213,bisleri,6,15,9,2,00028,India
487260,2023-04-18,203,mango yogurt,50,60,10,2,00321,India
487260,2023-04-18,209,pepsi,75,100,25,2,00321,India
487260,2023-04-18,205,classic yogurt,45,60,15,2,00321,India
487260,2023-04-18,202,milk,12,27,15,1,00321,India
487260,2023-04-18,212,amul cheese,250,315,65,1,00321,India
504947,2023-04-18,206,yakult,360,400,40,2,00472,India
261204,2023-04-18,210,mountain dew,75,100,25,2,00087,India
261204,2023-04-18,209,pepsi,75,100,25,2,00087,India
261204,2023-04-18,208,sprite,75,100,25,2,00087,India
261204,2023-04-18,213,bisleri,6,15,9,2,00087,India
514204,2023-04-18,201,paneer,210,340,130,1,00351,India
514204,2023-04-18,206,yakult,360,400,40,2,00351,India
923565,2023-04-18,206,yakult,360,400,40,2,00065,India
923565,2023-04-18,213,bisleri,6,15,9,2,00065,India
520204,2023-04-18,201,paneer,210,340,130,1,00072,India
520204,2023-04-18,203,mango yogurt,50,60,10,2,00072,India
723072,2023-04-18,212,amul cheese,250,315,65,1,00034,India
723072,2023-04-18,211,red bull,90,125,35,2,00034,India
723072,2023-04-18,209,pepsi,75,100,25,2,00034,India
723072,2023-04-18,204,strawberry yogurt,50,60,10,2,00034,India
914286,2023-04-18,205,classic yogurt,45,60,15,2,00065,India
914286,2023-04-18,202,milk,12,27,15,1,00065,India
587565,2023-04-18,204,strawberry yogurt,50,60,10,2,00267,India
587565,2023-04-18,211,red bull,90,125,35,2,00267,India
723953,2023-04-18,203,mango yogurt,50,60,10,2,00410,India
723953,2023-04-18,207,coca cola,75,100,25,2,00410,India
723953,2023-04-18,202,milk,12,27,15,1,00410,India
723953,2023-04-18,201,paneer,210,340,130,1,00410,India
483404,2023-04-18,204,strawberry yogurt,50,60,10,2,00180,India
523150,2023-04-18,203,mango yogurt,50,60,10,2,00416,India
523150,2023-04-18,212,amul cheese,250,315,65,1,00416,India
321069,2023-04-18,203,mango yogurt,50,60,10,2,00196,India
321069,2023-04-18,201,paneer,210,340,130,1,00196,India
321069,2023-04-18,208,sprite,75,100,25,2,00196,India
321069,2023-04-18,202,milk,12,27,15,1,00196,India
114989,2023-04-18,206,yakult,360,400,40,2,00347,India
114989,2023-04-18,208,sprite,75,100,25,2,00347,India
114989,2023-04-18,205,classic yogurt,45,60,15,2,00347,India
114989,2023-04-18,210,mountain dew,75,100,25,2,00347,India
132158,2023-04-18,201,paneer,210,340,130,1,00452,India
836342,2023-04-18,202,milk,12,27,15,1,00220,India
836342,2023-04-18,206,yakult,360,400,40,2,00220,India
836342,2023-04-18,204,strawberry yogurt,50,60,10,2,00220,India
836342,2023-04-18,211,red bull,90,125,35,2,00220,India
443343,2023-04-19,208,sprite,75,100,25,2,00438,India
443343,2023-04-19,206,yakult,360,400,40,2,00438,India
443343,2023-04-19,210,mountain dew,75,100,25,2,00438,India
920821,2023-04-19,210,mountain dew,75,100,25,2,00352,India
285172,2023-04-19,212,amul cheese,250,315,65,1,00124,India
285172,2023-04-19,213,bisleri,6,15,9,2,00124,India
407186,2023-04-19,202,milk,12,27,15,1,00113,India
626443,2023-04-19,212,amul cheese,250,315,65,1,00038,India
555548,2023-04-19,209,pepsi,75,100,25,2,00390,India
555548,2023-04-19,211,red bull,90,125,35,2,00390,India
555548,2023-04-19,204,strawberry yogurt,50,60,10,2,00390,India
295616,2023-04-19,209,pepsi,75,100,25,2,00086,India
295616,2023-04-19,211,red bull,90,125,35,2,00086,India
295616,2023-04-19,212,amul cheese,250,315,65,1,00086,India
515713,2023-04-19,204,strawberry yogurt,50,60,10,2,00004,India
515713,2023-04-19,207,coca cola,75,100,25,2,00004,India
515713,2023-04-19,211,red bull,90,125,35,2,00004,India
515713,2023-04-19,206,yakult,360,400,40,2,00004,India
579513,2023-04-19,204,strawberry yogurt,50,60,10,2,00281,India
579513,2023-04-19,203,mango yogurt,50,60,10,2,00281,India
726705,2023-04-19,210,mountain dew,75,100,25,2,00451,India
159918,2023-04-19,204,strawberry yogurt,50,60,10,2,00076,India
914371,2023-04-19,212,amul cheese,250,315,65,1,00202,India
914371,2023-04-19,203,mango yogurt,50,60,10,2,00202,India
914371,2023-04-19,204,strawberry yogurt,50,60,10,2,00202,India
914371,2023-04-19,201,paneer,210,340,130,1,00202,India
755058,2023-04-19,206,yakult,360,400,40,2,00148,India
755058,2023-04-19,208,sprite,75,100,25,2,00148,India
755058,2023-04-19,210,mountain dew,75,100,25,2,00148,India
671041,2023-04-19,211,red bull,90,125,35,2,00304,India
671041,2023-04-19,202,milk,12,27,15,1,00304,India
671041,2023-04-19,210,mountain dew,75,100,25,2,00304,India
671041,2023-04-19,207,coca cola,75,100,25,2,00304,India
441411,2023-04-19,210,mountain dew,75,100,25,2,00444,India
441411,2023-04-19,208,sprite,75,100,25,2,00444,India
441411,2023-04-19,203,mango yogurt,50,60,10,2,00444,India
441411,2023-04-19,207,coca cola,75,100,25,2,00444,India
502156,2023-04-19,209,pepsi,75,100,25,2,00328,India
502156,2023-04-19,206,yakult,360,400,40,2,00328,India
502156,2023-04-19,203,mango yogurt,50,60,10,2,00328,India
481612,2023-04-19,203,mango yogurt,50,60,10,2,00475,India
481612,2023-04-19,206,yakult,360,400,40,2,00475,India
481612,2023-04-19,210,mountain dew,75,100,25,2,00475,India
481612,2023-04-19,212,amul cheese,250,315,65,1,00475,India
106973,2023-04-19,209,pepsi,75,100,25,2,00494,India
106973,2023-04-19,202,milk,12,27,15,1,00494,India
106973,2023-04-19,201,paneer,210,340,130,1,00494,India
106973,2023-04-19,211,red bull,90,125,35,2,00494,India
106973,2023-04-19,205,classic yogurt,45,60,15,2,00494,India
345441,2023-04-19,202,milk,12,27,15,1,00365,India
345441,2023-04-19,207,coca cola,75,100,25,2,00365,India
872367,2023-04-19,208,sprite,75,100,25,2,00277,India
872367,2023-04-19,203,mango yogurt,50,60,10,2,00277,India
872367,2023-04-19,209,pepsi,75,100,25,2,00277,India
134826,2023-04-19,209,pepsi,75,100,25,2,00401,India
134826,2023-04-19,204,strawberry yogurt,50,60,10,2,00401,India
134826,2023-04-19,206,yakult,360,400,40,2,00401,India
263610,2023-04-19,208,sprite,75,100,25,2,00398,India
263610,2023-04-19,207,coca cola,75,100,25,2,00398,India
263610,2023-04-19,205,classic yogurt,45,60,15,2,00398,India
263610,2023-04-19,201,paneer,210,340,130,1,00398,India
263610,2023-04-19,204,strawberry yogurt,50,60,10,2,00398,India
457767,2023-04-19,212,amul cheese,250,315,65,1,00404,India
263270,2023-04-19,210,mountain dew,75,100,25,2,00492,India
264135,2023-04-19,207,coca cola,75,100,25,2,00357,India
264135,2023-04-19,208,sprite,75,100,25,2,00357,India
264135,2023-04-19,205,classic yogurt,45,60,15,2,00357,India
264135,2023-04-19,201,paneer,210,340,130,1,00357,India
600361,2023-04-19,206,yakult,360,400,40,2,00045,India
631341,2023-04-19,205,classic yogurt,45,60,15,2,00007,India
631341,2023-04-19,204,strawberry yogurt,50,60,10,2,00007,India
631341,2023-04-19,206,yakult,360,400,40,2,00007,India
856033,2023-04-19,202,milk,12,27,15,1,00490,India
856033,2023-04-19,211,red bull,90,125,35,2,00490,India
856033,2023-04-19,204,strawberry yogurt,50,60,10,2,00490,India
198786,2023-04-19,207,coca cola,75,100,25,2,00097,India
198786,2023-04-19,202,milk,12,27,15,1,00097,India
198786,2023-04-19,201,paneer,210,340,130,1,00097,India
198786,2023-04-19,203,mango yogurt,50,60,10,2,00097,India
490819,2023-04-19,213,bisleri,6,15,9,2,00267,India
490819,2023-04-19,206,yakult,360,400,40,2,00267,India
490819,2023-04-19,209,pepsi,75,100,25,2,00267,India
490819,2023-04-19,212,amul cheese,250,315,65,1,00267,India
760287,2023-04-19,211,red bull,90,125,35,2,00483,India
760287,2023-04-19,202,milk,12,27,15,1,00483,India
497765,2023-04-19,203,mango yogurt,50,60,10,2,00222,India
497765,2023-04-19,210,mountain dew,75,100,25,2,00222,India
497765,2023-04-19,208,sprite,75,100,25,2,00222,India
888435,2023-04-19,204,strawberry yogurt,50,60,10,2,00336,India
888435,2023-04-19,201,paneer,210,340,130,1,00336,India
292412,2023-04-19,203,mango yogurt,50,60,10,2,00450,India
650795,2023-04-19,212,amul cheese,250,315,65,1,00497,India
477588,2023-04-19,207,coca cola,75,100,25,2,00341,India
200988,2023-04-19,206,yakult,360,400,40,2,00302,India
200988,2023-04-19,203,mango yogurt,50,60,10,2,00302,India
387313,2023-04-19,208,sprite,75,100,25,2,00421,India
387313,2023-04-19,203,mango yogurt,50,60,10,2,00421,India
387313,2023-04-19,213,bisleri,6,15,9,2,00421,India
387313,2023-04-19,205,classic yogurt,45,60,15,2,00421,India
387313,2023-04-19,201,paneer,210,340,130,1,00421,India
857453,2023-04-19,204,strawberry yogurt,50,60,10,2,00469,India
857453,2023-04-19,205,classic yogurt,45,60,15,2,00469,India
857453,2023-04-19,206,yakult,360,400,40,2,00469,India
857453,2023-04-19,210,mountain dew,75,100,25,2,00469,India
350161,2023-04-19,207,coca cola,75,100,25,2,00389,India
432387,2023-04-19,207,coca cola,75,100,25,2,00097,India
967122,2023-04-19,201,paneer,210,340,130,1,00337,India
506847,2023-04-19,213,bisleri,6,15,9,2,00490,India
506847,2023-04-19,211,red bull,90,125,35,2,00490,India
642822,2023-04-19,212,amul cheese,250,315,65,1,00228,India
642822,2023-04-19,204,strawberry yogurt,50,60,10,2,00228,India
642822,2023-04-19,202,milk,12,27,15,1,00228,India
410172,2023-04-19,208,sprite,75,100,25,2,00064,India
410172,2023-04-19,207,coca cola,75,100,25,2,00064,India
410172,2023-04-19,212,amul cheese,250,315,65,1,00064,India
410172,2023-04-19,201,paneer,210,340,130,1,00064,India
714658,2023-04-19,213,bisleri,6,15,9,2,00416,India
714658,2023-04-19,205,classic yogurt,45,60,15,2,00416,India
714658,2023-04-19,208,sprite,75,100,25,2,00416,India
220675,2023-04-19,207,coca cola,75,100,25,2,00265,India
220675,2023-04-19,206,yakult,360,400,40,2,00265,India
220675,2023-04-19,208,sprite,75,100,25,2,00265,India
683277,2023-04-19,205,classic yogurt,45,60,15,2,00081,India
683277,2023-04-19,207,coca cola,75,100,25,2,00081,India
683277,2023-04-19,206,yakult,360,400,40,2,00081,India
683277,2023-04-19,203,mango yogurt,50,60,10,2,00081,India
438841,2023-04-19,204,strawberry yogurt,50,60,10,2,00398,India
438841,2023-04-19,206,yakult,360,400,40,2,00398,India
438841,2023-04-19,208,sprite,75,100,25,2,00398,India
520851,2023-04-19,213,bisleri,6,15,9,2,00335,India
716437,2023-04-19,206,yakult,360,400,40,2,00358,India
716437,2023-04-19,208,sprite,75,100,25,2,00358,India
530418,2023-04-19,213,bisleri,6,15,9,2,00368,India
530418,2023-04-19,208,sprite,75,100,25,2,00368,India
530418,2023-04-19,201,paneer,210,340,130,1,00368,India
962603,2023-04-19,201,paneer,210,340,130,1,00127,India
754295,2023-04-19,201,paneer,210,340,130,1,00052,India
805944,2023-04-19,204,strawberry yogurt,50,60,10,2,00087,India
805944,2023-04-19,212,amul cheese,250,315,65,1,00087,India
805944,2023-04-19,201,paneer,210,340,130,1,00087,India
300041,2023-04-19,210,mountain dew,75,100,25,2,00195,India
300041,2023-04-19,211,red bull,90,125,35,2,00195,India
300041,2023-04-19,208,sprite,75,100,25,2,00195,India
892157,2023-04-19,203,mango yogurt,50,60,10,2,00293,India
892157,2023-04-19,209,pepsi,75,100,25,2,00293,India
892157,2023-04-19,207,coca cola,75,100,25,2,00293,India
352190,2023-04-19,204,strawberry yogurt,50,60,10,2,00042,India
352190,2023-04-19,206,yakult,360,400,40,2,00042,India
352190,2023-04-19,208,sprite,75,100,25,2,00042,India
352190,2023-04-19,205,classic yogurt,45,60,15,2,00042,India
265604,2023-04-19,201,paneer,210,340,130,1,00277,India
265604,2023-04-19,206,yakult,360,400,40,2,00277,India
541936,2023-04-19,204,strawberry yogurt,50,60,10,2,00371,India
541936,2023-04-19,205,classic yogurt,45,60,15,2,00371,India
478343,2023-04-19,208,sprite,75,100,25,2,00131,India
478343,2023-04-19,211,red bull,90,125,35,2,00131,India
478343,2023-04-19,205,classic yogurt,45,60,15,2,00131,India
897505,2023-04-19,213,bisleri,6,15,9,2,00104,India
897505,2023-04-19,204,strawberry yogurt,50,60,10,2,00104,India
882469,2023-04-19,212,amul cheese,250,315,65,1,00459,India
496787,2023-04-19,212,amul cheese,250,315,65,1,00222,India
496787,2023-04-19,204,strawberry yogurt,50,60,10,2,00222,India
366331,2023-04-19,208,sprite,75,100,25,2,00056,India
366331,2023-04-19,213,bisleri,6,15,9,2,00056,India
688221,2023-04-20,207,coca cola,75,100,25,2,00496,India
688221,2023-04-20,212,amul cheese,250,315,65,1,00496,India
688221,2023-04-20,208,sprite,75,100,25,2,00496,India
312170,2023-04-20,201,paneer,210,340,130,1,00086,India
312170,2023-04-20,206,yakult,360,400,40,2,00086,India
109802,2023-04-20,210,mountain dew,75,100,25,2,00045,India
109802,2023-04-20,201,paneer,210,340,130,1,00045,India
109802,2023-04-20,206,yakult,360,400,40,2,00045,India
109802,2023-04-20,208,sprite,75,100,25,2,00045,India
416409,2023-04-20,204,strawberry yogurt,50,60,10,2,00170,India
416409,2023-04-20,210,mountain dew,75,100,25,2,00170,India
416409,2023-04-20,206,yakult,360,400,40,2,00170,India
416409,2023-04-20,202,milk,12,27,15,1,00170,India
101386,2023-04-20,204,strawberry yogurt,50,60,10,2,00375,India
101386,2023-04-20,212,amul cheese,250,315,65,1,00375,India
101386,2023-04-20,211,red bull,90,125,35,2,00375,India
101386,2023-04-20,209,pepsi,75,100,25,2,00375,India
101386,2023-04-20,201,paneer,210,340,130,1,00375,India
388147,2023-04-20,211,red bull,90,125,35,2,00167,India
388147,2023-04-20,210,mountain dew,75,100,25,2,00167,India
739324,2023-04-20,212,amul cheese,250,315,65,1,00201,India
739324,2023-04-20,205,classic yogurt,45,60,15,2,00201,India
179768,2023-04-20,208,sprite,75,100,25,2,00066,India
179768,2023-04-20,212,amul cheese,250,315,65,1,00066,India
986582,2023-04-20,206,yakult,360,400,40,2,00292,India
986582,2023-04-20,202,milk,12,27,15,1,00292,India
986582,2023-04-20,210,mountain dew,75,100,25,2,00292,India
458347,2023-04-20,206,yakult,360,400,40,2,00053,India
458347,2023-04-20,211,red bull,90,125,35,2,00053,India
458347,2023-04-20,213,bisleri,6,15,9,2,00053,India
794474,2023-04-20,204,strawberry yogurt,50,60,10,2,00147,India
741944,2023-04-20,202,milk,12,27,15,1,00179,India
741944,2023-04-20,210,mountain dew,75,100,25,2,00179,India
460871,2023-04-20,204,strawberry yogurt,50,60,10,2,00259,India
460871,2023-04-20,202,milk,12,27,15,1,00259,India
460871,2023-04-20,203,mango yogurt,50,60,10,2,00259,India
685497,2023-04-20,209,pepsi,75,100,25,2,00123,India
685497,2023-04-20,206,yakult,360,400,40,2,00123,India
685497,2023-04-20,202,milk,12,27,15,1,00123,India
465226,2023-04-20,210,mountain dew,75,100,25,2,00226,India
523187,2023-04-20,207,coca cola,75,100,25,2,00395,India
893701,2023-04-20,201,paneer,210,340,130,1,00067,India
893701,2023-04-20,211,red bull,90,125,35,2,00067,India
893701,2023-04-20,202,milk,12,27,15,1,00067,India
156291,2023-04-20,210,mountain dew,75,100,25,2,00176,India
156291,2023-04-20,211,red bull,90,125,35,2,00176,India
156291,2023-04-20,206,yakult,360,400,40,2,00176,India
156291,2023-04-20,208,sprite,75,100,25,2,00176,India
156291,2023-04-20,212,amul cheese,250,315,65,1,00176,India
898977,2023-04-20,210,mountain dew,75,100,25,2,00472,India
898977,2023-04-20,204,strawberry yogurt,50,60,10,2,00472,India
898977,2023-04-20,201,paneer,210,340,130,1,00472,India
242678,2023-04-20,211,red bull,90,125,35,2,00451,India
242678,2023-04-20,204,strawberry yogurt,50,60,10,2,00451,India
242678,2023-04-20,209,pepsi,75,100,25,2,00451,India
242678,2023-04-20,208,sprite,75,100,25,2,00451,India
160231,2023-04-20,204,strawberry yogurt,50,60,10,2,00184,India
160231,2023-04-20,213,bisleri,6,15,9,2,00184,India
160231,2023-04-20,210,mountain dew,75,100,25,2,00184,India
883772,2023-04-20,213,bisleri,6,15,9,2,00064,India
883772,2023-04-20,210,mountain dew,75,100,25,2,00064,India
592719,2023-04-20,204,strawberry yogurt,50,60,10,2,00383,India
592719,2023-04-20,203,mango yogurt,50,60,10,2,00383,India
592719,2023-04-20,209,pepsi,75,100,25,2,00383,India
409635,2023-04-20,209,pepsi,75,100,25,2,00028,India
409635,2023-04-20,201,paneer,210,340,130,1,00028,India
409635,2023-04-20,205,classic yogurt,45,60,15,2,00028,India
713016,2023-04-20,201,paneer,210,340,130,1,00041,India
713016,2023-04-20,213,bisleri,6,15,9,2,00041,India
713016,2023-04-20,212,amul cheese,250,315,65,1,00041,India
713016,2023-04-20,204,strawberry yogurt,50,60,10,2,00041,India
608636,2023-04-20,209,pepsi,75,100,25,2,00027,India
608636,2023-04-20,213,bisleri,6,15,9,2,00027,India
608636,2023-04-20,204,strawberry yogurt,50,60,10,2,00027,India
608636,2023-04-20,202,milk,12,27,15,1,00027,India
899508,2023-04-20,210,mountain dew,75,100,25,2,00090,India
618176,2023-04-20,201,paneer,210,340,130,1,00023,India
618176,2023-04-20,206,yakult,360,400,40,2,00023,India
618176,2023-04-20,205,classic yogurt,45,60,15,2,00023,India
618176,2023-04-20,212,amul cheese,250,315,65,1,00023,India
618176,2023-04-20,207,coca cola,75,100,25,2,00023,India
275828,2023-04-20,212,amul cheese,250,315,65,1,00140,India
275828,2023-04-20,204,strawberry yogurt,50,60,10,2,00140,India
275828,2023-04-20,207,coca cola,75,100,25,2,00140,India
439241,2023-04-20,202,milk,12,27,15,1,00449,India
439241,2023-04-20,201,paneer,210,340,130,1,00449,India
439241,2023-04-20,211,red bull,90,125,35,2,00449,India
439241,2023-04-20,212,amul cheese,250,315,65,1,00449,India
909727,2023-04-20,202,milk,12,27,15,1,00412,India
784751,2023-04-20,203,mango yogurt,50,60,10,2,00183,India
784751,2023-04-20,202,milk,12,27,15,1,00183,India
916417,2023-04-20,206,yakult,360,400,40,2,00032,India
916417,2023-04-20,201,paneer,210,340,130,1,00032,India
916417,2023-04-20,207,coca cola,75,100,25,2,00032,India
916417,2023-04-20,213,bisleri,6,15,9,2,00032,India
317156,2023-04-20,209,pepsi,75,100,25,2,00054,India
317156,2023-04-20,202,milk,12,27,15,1,00054,India
317156,2023-04-20,210,mountain dew,75,100,25,2,00054,India
337507,2023-04-20,204,strawberry yogurt,50,60,10,2,00045,India
337507,2023-04-20,208,sprite,75,100,25,2,00045,India
554887,2023-04-20,212,amul cheese,250,315,65,1,00220,India
554887,2023-04-20,213,bisleri,6,15,9,2,00220,India
554887,2023-04-20,202,milk,12,27,15,1,00220,India
866414,2023-04-20,209,pepsi,75,100,25,2,00422,India
866414,2023-04-20,205,classic yogurt,45,60,15,2,00422,India
831237,2023-04-20,206,yakult,360,400,40,2,00236,India
831237,2023-04-20,203,mango yogurt,50,60,10,2,00236,India
464835,2023-04-20,202,milk,12,27,15,1,00334,India
464835,2023-04-20,207,coca cola,75,100,25,2,00334,India
464835,2023-04-20,206,yakult,360,400,40,2,00334,India
338752,2023-04-20,208,sprite,75,100,25,2,00046,India
338752,2023-04-20,206,yakult,360,400,40,2,00046,India
338752,2023-04-20,209,pepsi,75,100,25,2,00046,India
338752,2023-04-20,202,milk,12,27,15,1,00046,India
338752,2023-04-20,201,paneer,210,340,130,1,00046,India
366065,2023-04-20,211,red bull,90,125,35,2,00152,India
366065,2023-04-20,210,mountain dew,75,100,25,2,00152,India
442696,2023-04-20,210,mountain dew,75,100,25,2,00491,India
442696,2023-04-20,212,amul cheese,250,315,65,1,00491,India
442696,2023-04-20,211,red bull,90,125,35,2,00491,India
442696,2023-04-20,203,mango yogurt,50,60,10,2,00491,India
359555,2023-04-20,205,classic yogurt,45,60,15,2,00329,India
359555,2023-04-20,204,strawberry yogurt,50,60,10,2,00329,India
359555,2023-04-20,208,sprite,75,100,25,2,00329,India
444894,2023-04-20,203,mango yogurt,50,60,10,2,00422,India
444894,2023-04-20,205,classic yogurt,45,60,15,2,00422,India
444894,2023-04-20,213,bisleri,6,15,9,2,00422,India
444894,2023-04-20,210,mountain dew,75,100,25,2,00422,India
329137,2023-04-20,201,paneer,210,340,130,1,00020,India
422281,2023-04-20,210,mountain dew,75,100,25,2,00117,India
422281,2023-04-20,208,sprite,75,100,25,2,00117,India
422281,2023-04-20,203,mango yogurt,50,60,10,2,00117,India
452258,2023-04-20,202,milk,12,27,15,1,00202,India
452258,2023-04-20,205,classic yogurt,45,60,15,2,00202,India
452258,2023-04-20,207,coca cola,75,100,25,2,00202,India
452258,2023-04-20,209,pepsi,75,100,25,2,00202,India
469777,2023-04-20,203,mango yogurt,50,60,10,2,00296,India
469777,2023-04-20,202,milk,12,27,15,1,00296,India
469777,2023-04-20,210,mountain dew,75,100,25,2,00296,India
330634,2023-04-20,203,mango yogurt,50,60,10,2,00442,India
375568,2023-04-20,212,amul cheese,250,315,65,1,00302,India
375568,2023-04-20,206,yakult,360,400,40,2,00302,India
375568,2023-04-20,207,coca cola,75,100,25,2,00302,India
375568,2023-04-20,203,mango yogurt,50,60,10,2,00302,India
497694,2023-04-20,206,yakult,360,400,40,2,00036,India
497694,2023-04-20,202,milk,12,27,15,1,00036,India
802059,2023-04-20,212,amul cheese,250,315,65,1,00178,India
802059,2023-04-20,209,pepsi,75,100,25,2,00178,India
802059,2023-04-20,203,mango yogurt,50,60,10,2,00178,India
493536,2023-04-20,203,mango yogurt,50,60,10,2,00490,India
493536,2023-04-20,202,milk,12,27,15,1,00490,India
493536,2023-04-20,212,amul cheese,250,315,65,1,00490,India
493536,2023-04-20,207,coca cola,75,100,25,2,00490,India
542533,2023-04-20,211,red bull,90,125,35,2,00244,India
542533,2023-04-20,206,yakult,360,400,40,2,00244,India
542533,2023-04-20,202,milk,12,27,15,1,00244,India
596051,2023-04-20,213,bisleri,6,15,9,2,00246,India
596051,2023-04-20,208,sprite,75,100,25,2,00246,India
596051,2023-04-20,204,strawberry yogurt,50,60,10,2,00246,India
219199,2023-04-20,209,pepsi,75,100,25,2,00438,India
219199,2023-04-20,208,sprite,75,100,25,2,00438,India
219199,2023-04-20,210,mountain dew,75,100,25,2,00438,India
219199,2023-04-20,212,amul cheese,250,315,65,1,00438,India
861401,2023-04-20,212,amul cheese,250,315,65,1,00129,India
861401,2023-04-20,205,classic yogurt,45,60,15,2,00129,India
861401,2023-04-20,204,strawberry yogurt,50,60,10,2,00129,India
877314,2023-04-20,205,classic yogurt,45,60,15,2,00437,India
877314,2023-04-20,213,bisleri,6,15,9,2,00437,India
549932,2023-04-20,204,strawberry yogurt,50,60,10,2,00462,India
761858,2023-04-20,204,strawberry yogurt,50,60,10,2,00180,India
146843,2023-04-20,207,coca cola,75,100,25,2,00439,India
146843,2023-04-20,202,milk,12,27,15,1,00439,India
146843,2023-04-20,208,sprite,75,100,25,2,00439,India
146843,2023-04-20,209,pepsi,75,100,25,2,00439,India
694370,2023-04-20,212,amul cheese,250,315,65,1,00168,India
694370,2023-04-20,206,yakult,360,400,40,2,00168,India
694370,2023-04-20,211,red bull,90,125,35,2,00168,India
306291,2023-04-20,209,pepsi,75,100,25,2,00009,India
270987,2023-04-20,206,yakult,360,400,40,2,00379,India
270987,2023-04-20,208,sprite,75,100,25,2,00379,India
105247,2023-04-20,204,strawberry yogurt,50,60,10,2,00433,India
105247,2023-04-20,207,coca cola,75,100,25,2,00433,India
581963,2023-04-20,204,strawberry yogurt,50,60,10,2,00141,India
581963,2023-04-20,201,paneer,210,340,130,1,00141,India
581963,2023-04-20,202,milk,12,27,15,1,00141,India
581963,2023-04-20,205,classic yogurt,45,60,15,2,00141,India
541390,2023-04-20,207,coca cola,75,100,25,2,00331,India
815128,2023-04-20,202,milk,12,27,15,1,00296,India
815128,2023-04-20,210,mountain dew,75,100,25,2,00296,India
441343,2023-04-20,202,milk,12,27,15,1,00228,India
441343,2023-04-20,204,strawberry yogurt,50,60,10,2,00228,India
441343,2023-04-20,206,yakult,360,400,40,2,00228,India
247627,2023-04-20,203,mango yogurt,50,60,10,2,00034,India
247627,2023-04-20,202,milk,12,27,15,1,00034,India
501560,2023-04-20,213,bisleri,6,15,9,2,00474,India
501560,2023-04-20,202,milk,12,27,15,1,00474,India
501560,2023-04-20,207,coca cola,75,100,25,2,00474,India
438310,2023-04-20,212,amul cheese,250,315,65,1,00381,India
438310,2023-04-20,202,milk,12,27,15,1,00381,India
319065,2023-04-21,201,paneer,210,340,130,1,00371,India
319065,2023-04-21,205,classic yogurt,45,60,15,2,00371,India
603704,2023-04-21,209,pepsi,75,100,25,2,00437,India
845757,2023-04-21,212,amul cheese,250,315,65,1,00498,India
845757,2023-04-21,211,red bull,90,125,35,2,00498,India
845757,2023-04-21,213,bisleri,6,15,9,2,00498,India
845757,2023-04-21,203,mango yogurt,50,60,10,2,00498,India
329400,2023-04-21,211,red bull,90,125,35,2,00028,India
329400,2023-04-21,205,classic yogurt,45,60,15,2,00028,India
329400,2023-04-21,213,bisleri,6,15,9,2,00028,India
329400,2023-04-21,210,mountain dew,75,100,25,2,00028,India
689203,2023-04-21,204,strawberry yogurt,50,60,10,2,00330,India
689203,2023-04-21,206,yakult,360,400,40,2,00330,India
689203,2023-04-21,209,pepsi,75,100,25,2,00330,India
689203,2023-04-21,213,bisleri,6,15,9,2,00330,India
624938,2023-04-21,208,sprite,75,100,25,2,00434,India
624938,2023-04-21,213,bisleri,6,15,9,2,00434,India
624938,2023-04-21,201,paneer,210,340,130,1,00434,India
624938,2023-04-21,206,yakult,360,400,40,2,00434,India
291980,2023-04-21,213,bisleri,6,15,9,2,00209,India
291980,2023-04-21,201,paneer,210,340,130,1,00209,India
291980,2023-04-21,208,sprite,75,100,25,2,00209,India
547446,2023-04-21,210,mountain dew,75,100,25,2,00150,India
547446,2023-04-21,212,amul cheese,250,315,65,1,00150,India
394416,2023-04-21,211,red bull,90,125,35,2,00271,India
394416,2023-04-21,208,sprite,75,100,25,2,00271,India
394416,2023-04-21,202,milk,12,27,15,1,00271,India
932949,2023-04-21,211,red bull,90,125,35,2,00449,India
932949,2023-04-21,201,paneer,210,340,130,1,00449,India
932949,2023-04-21,203,mango yogurt,50,60,10,2,00449,India
932949,2023-04-21,213,bisleri,6,15,9,2,00449,India
936073,2023-04-21,204,strawberry yogurt,50,60,10,2,00287,India
936073,2023-04-21,205,classic yogurt,45,60,15,2,00287,India
936073,2023-04-21,212,amul cheese,250,315,65,1,00287,India
567765,2023-04-21,206,yakult,360,400,40,2,00066,India
877833,2023-04-21,210,mountain dew,75,100,25,2,00101,India
877833,2023-04-21,204,strawberry yogurt,50,60,10,2,00101,India
877833,2023-04-21,201,paneer,210,340,130,1,00101,India
877833,2023-04-21,208,sprite,75,100,25,2,00101,India
345040,2023-04-21,213,bisleri,6,15,9,2,00464,India
345040,2023-04-21,210,mountain dew,75,100,25,2,00464,India
345040,2023-04-21,205,classic yogurt,45,60,15,2,00464,India
345040,2023-04-21,212,amul cheese,250,315,65,1,00464,India
821892,2023-04-21,206,yakult,360,400,40,2,00243,India
957079,2023-04-21,206,yakult,360,400,40,2,00056,India
957079,2023-04-21,205,classic yogurt,45,60,15,2,00056,India
957079,2023-04-21,213,bisleri,6,15,9,2,00056,India
177304,2023-04-21,210,mountain dew,75,100,25,2,00401,India
177304,2023-04-21,204,strawberry yogurt,50,60,10,2,00401,India
377889,2023-04-21,203,mango yogurt,50,60,10,2,00066,India
377889,2023-04-21,204,strawberry yogurt,50,60,10,2,00066,India
377889,2023-04-21,212,amul cheese,250,315,65,1,00066,India
377889,2023-04-21,207,coca cola,75,100,25,2,00066,India
950431,2023-04-21,212,amul cheese,250,315,65,1,00377,India
950431,2023-04-21,207,coca cola,75,100,25,2,00377,India
950431,2023-04-21,203,mango yogurt,50,60,10,2,00377,India
950431,2023-04-21,206,yakult,360,400,40,2,00377,India
950431,2023-04-21,213,bisleri,6,15,9,2,00377,India
374918,2023-04-21,201,paneer,210,340,130,1,00187,India
374918,2023-04-21,208,sprite,75,100,25,2,00187,India
374918,2023-04-21,212,amul cheese,250,315,65,1,00187,India
201389,2023-04-21,201,paneer,210,340,130,1,00386,India
931354,2023-04-21,212,amul cheese,250,315,65,1,00338,India
896882,2023-04-21,212,amul cheese,250,315,65,1,00325,India
896882,2023-04-21,203,mango yogurt,50,60,10,2,00325,India
896882,2023-04-21,208,sprite,75,100,25,2,00325,India
896882,2023-04-21,205,classic yogurt,45,60,15,2,00325,India
211022,2023-04-21,203,mango yogurt,50,60,10,2,00462,India
211022,2023-04-21,201,paneer,210,340,130,1,00462,India
211022,2023-04-21,206,yakult,360,400,40,2,00462,India
306881,2023-04-21,207,coca cola,75,100,25,2,00401,India
306881,2023-04-21,213,bisleri,6,15,9,2,00401,India
306881,2023-04-21,201,paneer,210,340,130,1,00401,India
523058,2023-04-21,201,paneer,210,340,130,1,00200,India
523058,2023-04-21,206,yakult,360,400,40,2,00200,India
523058,2023-04-21,213,bisleri,6,15,9,2,00200,India
523058,2023-04-21,202,milk,12,27,15,1,00200,India
276848,2023-04-21,212,amul cheese,250,315,65,1,00491,India
276848,2023-04-21,213,bisleri,6,15,9,2,00491,India
897616,2023-04-21,210,mountain dew,75,100,25,2,00427,India
897616,2023-04-21,208,sprite,75,100,25,2,00427,India
897616,2023-04-21,206,yakult,360,400,40,2,00427,India
897616,2023-04-21,209,pepsi,75,100,25,2,00427,India
115849,2023-04-21,210,mountain dew,75,100,25,2,00296,India
115849,2023-04-21,208,sprite,75,100,25,2,00296,India
115849,2023-04-21,211,red bull,90,125,35,2,00296,India
144329,2023-04-21,205,classic yogurt,45,60,15,2,00333,India
144329,2023-04-21,201,paneer,210,340,130,1,00333,India
144329,2023-04-21,208,sprite,75,100,25,2,00333,India
259151,2023-04-21,206,yakult,360,400,40,2,00225,India
913643,2023-04-21,201,paneer,210,340,130,1,00183,India
913643,2023-04-21,203,mango yogurt,50,60,10,2,00183,India
852985,2023-04-21,209,pepsi,75,100,25,2,00111,India
852985,2023-04-21,206,yakult,360,400,40,2,00111,India
852985,2023-04-21,207,coca cola,75,100,25,2,00111,India
852985,2023-04-21,205,classic yogurt,45,60,15,2,00111,India
421829,2023-04-21,210,mountain dew,75,100,25,2,00113,India
421829,2023-04-21,212,amul cheese,250,315,65,1,00113,India
421829,2023-04-21,205,classic yogurt,45,60,15,2,00113,India
355729,2023-04-21,206,yakult,360,400,40,2,00479,India
355729,2023-04-21,207,coca cola,75,100,25,2,00479,India
355729,2023-04-21,202,milk,12,27,15,1,00479,India
355729,2023-04-21,208,sprite,75,100,25,2,00479,India
355729,2023-04-21,211,red bull,90,125,35,2,00479,India
593625,2023-04-21,203,mango yogurt,50,60,10,2,00305,India
912252,2023-04-21,204,strawberry yogurt,50,60,10,2,00412,India
912252,2023-04-21,203,mango yogurt,50,60,10,2,00412,India
912252,2023-04-21,208,sprite,75,100,25,2,00412,India
912252,2023-04-21,209,pepsi,75,100,25,2,00412,India
912252,2023-04-21,202,milk,12,27,15,1,00412,India
573760,2023-04-21,210,mountain dew,75,100,25,2,00346,India
573760,2023-04-21,203,mango yogurt,50,60,10,2,00346,India
573760,2023-04-21,213,bisleri,6,15,9,2,00346,India
573760,2023-04-21,209,pepsi,75,100,25,2,00346,India
786965,2023-04-21,202,milk,12,27,15,1,00413,India
786965,2023-04-21,206,yakult,360,400,40,2,00413,India
786965,2023-04-21,210,mountain dew,75,100,25,2,00413,India
839626,2023-04-21,206,yakult,360,400,40,2,00293,India
839626,2023-04-21,210,mountain dew,75,100,25,2,00293,India
962705,2023-04-21,202,milk,12,27,15,1,00164,India
673875,2023-04-21,201,paneer,210,340,130,1,00052,India
241273,2023-04-21,210,mountain dew,75,100,25,2,00285,India
241273,2023-04-21,213,bisleri,6,15,9,2,00285,India
241273,2023-04-21,206,yakult,360,400,40,2,00285,India
895432,2023-04-21,201,paneer,210,340,130,1,00392,India
895432,2023-04-21,209,pepsi,75,100,25,2,00392,India
408867,2023-04-21,206,yakult,360,400,40,2,00028,India
408867,2023-04-21,202,milk,12,27,15,1,00028,India
915360,2023-04-21,207,coca cola,75,100,25,2,00035,India
915360,2023-04-21,210,mountain dew,75,100,25,2,00035,India
915360,2023-04-21,209,pepsi,75,100,25,2,00035,India
183398,2023-04-21,209,pepsi,75,100,25,2,00427,India
876836,2023-04-21,201,paneer,210,340,130,1,00302,India
876836,2023-04-21,208,sprite,75,100,25,2,00302,India
876836,2023-04-21,205,classic yogurt,45,60,15,2,00302,India
931868,2023-04-21,210,mountain dew,75,100,25,2,00069,India
931868,2023-04-21,213,bisleri,6,15,9,2,00069,India
931868,2023-04-21,206,yakult,360,400,40,2,00069,India
931868,2023-04-21,205,classic yogurt,45,60,15,2,00069,India
843678,2023-04-21,209,pepsi,75,100,25,2,00001,India
319513,2023-04-21,209,pepsi,75,100,25,2,00291,India
319513,2023-04-21,211,red bull,90,125,35,2,00291,India
319513,2023-04-21,206,yakult,360,400,40,2,00291,India
318931,2023-04-21,201,paneer,210,340,130,1,00447,India
318931,2023-04-21,212,amul cheese,250,315,65,1,00447,India
318931,2023-04-21,208,sprite,75,100,25,2,00447,India
318931,2023-04-21,207,coca cola,75,100,25,2,00447,India
902750,2023-04-21,206,yakult,360,400,40,2,00361,India
902750,2023-04-21,203,mango yogurt,50,60,10,2,00361,India
902750,2023-04-21,202,milk,12,27,15,1,00361,India
124835,2023-04-21,203,mango yogurt,50,60,10,2,00338,India
124835,2023-04-21,212,amul cheese,250,315,65,1,00338,India
878427,2023-04-21,204,strawberry yogurt,50,60,10,2,00337,India
440011,2023-04-21,213,bisleri,6,15,9,2,00177,India
440011,2023-04-21,202,milk,12,27,15,1,00177,India
440011,2023-04-21,207,coca cola,75,100,25,2,00177,India
440011,2023-04-21,211,red bull,90,125,35,2,00177,India
354331,2023-04-21,203,mango yogurt,50,60,10,2,00235,India
354331,2023-04-21,213,bisleri,6,15,9,2,00235,India
354331,2023-04-21,206,yakult,360,400,40,2,00235,India
354331,2023-04-21,211,red bull,90,125,35,2,00235,India
354331,2023-04-21,209,pepsi,75,100,25,2,00235,India
658011,2023-04-21,201,paneer,210,340,130,1,00344,India
658011,2023-04-21,203,mango yogurt,50,60,10,2,00344,India
658011,2023-04-21,211,red bull,90,125,35,2,00344,India
583768,2023-04-21,202,milk,12,27,15,1,00160,India
156160,2023-04-21,203,mango yogurt,50,60,10,2,00373,India
156160,2023-04-21,205,classic yogurt,45,60,15,2,00373,India
276381,2023-04-21,204,strawberry yogurt,50,60,10,2,00135,India
276381,2023-04-21,207,coca cola,75,100,25,2,00135,India
578862,2023-04-21,211,red bull,90,125,35,2,00415,India
578862,2023-04-21,210,mountain dew,75,100,25,2,00415,India
578862,2023-04-21,213,bisleri,6,15,9,2,00415,India
578862,2023-04-21,205,classic yogurt,45,60,15,2,00415,India
872879,2023-04-21,206,yakult,360,400,40,2,00079,India
872879,2023-04-21,211,red bull,90,125,35,2,00079,India
952479,2023-04-21,201,paneer,210,340,130,1,00015,India
952479,2023-04-21,210,mountain dew,75,100,25,2,00015,India
952479,2023-04-21,209,pepsi,75,100,25,2,00015,India
389740,2023-04-21,201,paneer,210,340,130,1,00445,India
389740,2023-04-21,212,amul cheese,250,315,65,1,00445,India
276694,2023-04-21,204,strawberry yogurt,50,60,10,2,00392,India
309092,2023-04-21,210,mountain dew,75,100,25,2,00199,India
309092,2023-04-21,202,milk,12,27,15,1,00199,India
309092,2023-04-21,204,strawberry yogurt,50,60,10,2,00199,India
309092,2023-04-21,203,mango yogurt,50,60,10,2,00199,India
504646,2023-04-21,211,red bull,90,125,35,2,00470,India
271121,2023-04-21,208,sprite,75,100,25,2,00008,India
271121,2023-04-21,206,yakult,360,400,40,2,00008,India
271121,2023-04-21,207,coca cola,75,100,25,2,00008,India
271121,2023-04-21,202,milk,12,27,15,1,00008,India
519886,2023-04-22,212,amul cheese,250,315,65,1,00217,India
110500,2023-04-22,206,yakult,360,400,40,2,00311,India
110500,2023-04-22,213,bisleri,6,15,9,2,00311,India
110500,2023-04-22,203,mango yogurt,50,60,10,2,00311,India
935675,2023-04-22,203,mango yogurt,50,60,10,2,00255,India
935675,2023-04-22,210,mountain dew,75,100,25,2,00255,India
935675,2023-04-22,204,strawberry yogurt,50,60,10,2,00255,India
480113,2023-04-22,212,amul cheese,250,315,65,1,00035,India
597269,2023-04-22,208,sprite,75,100,25,2,00023,India
597269,2023-04-22,211,red bull,90,125,35,2,00023,India
597269,2023-04-22,210,mountain dew,75,100,25,2,00023,India
597269,2023-04-22,204,strawberry yogurt,50,60,10,2,00023,India
731242,2023-04-22,211,red bull,90,125,35,2,00152,India
731242,2023-04-22,206,yakult,360,400,40,2,00152,India
731242,2023-04-22,202,milk,12,27,15,1,00152,India
731242,2023-04-22,207,coca cola,75,100,25,2,00152,India
179104,2023-04-22,207,coca cola,75,100,25,2,00104,India
179104,2023-04-22,208,sprite,75,100,25,2,00104,India
179104,2023-04-22,203,mango yogurt,50,60,10,2,00104,India
179104,2023-04-22,213,bisleri,6,15,9,2,00104,India
243335,2023-04-22,212,amul cheese,250,315,65,1,00282,India
243335,2023-04-22,210,mountain dew,75,100,25,2,00282,India
243335,2023-04-22,204,strawberry yogurt,50,60,10,2,00282,India
885333,2023-04-22,203,mango yogurt,50,60,10,2,00301,India
199079,2023-04-22,208,sprite,75,100,25,2,00455,India
603962,2023-04-22,210,mountain dew,75,100,25,2,00454,India
603962,2023-04-22,205,classic yogurt,45,60,15,2,00454,India
603962,2023-04-22,213,bisleri,6,15,9,2,00454,India
923979,2023-04-22,212,amul cheese,250,315,65,1,00099,India
923979,2023-04-22,203,mango yogurt,50,60,10,2,00099,India
923979,2023-04-22,209,pepsi,75,100,25,2,00099,India
582983,2023-04-22,205,classic yogurt,45,60,15,2,00402,India
268487,2023-04-22,203,mango yogurt,50,60,10,2,00291,India
268487,2023-04-22,209,pepsi,75,100,25,2,00291,India
268487,2023-04-22,212,amul cheese,250,315,65,1,00291,India
268487,2023-04-22,204,strawberry yogurt,50,60,10,2,00291,India
452878,2023-04-22,211,red bull,90,125,35,2,00429,India
452878,2023-04-22,205,classic yogurt,45,60,15,2,00429,India
418666,2023-04-22,203,mango yogurt,50,60,10,2,00196,India
418666,2023-04-22,211,red bull,90,125,35,2,00196,India
244342,2023-04-22,202,milk,12,27,15,1,00386,India
866393,2023-04-22,201,paneer,210,340,130,1,00227,India
866393,2023-04-22,213,bisleri,6,15,9,2,00227,India
866393,2023-04-22,212,amul cheese,250,315,65,1,00227,India
866393,2023-04-22,209,pepsi,75,100,25,2,00227,India
180522,2023-04-22,211,red bull,90,125,35,2,00465,India
628469,2023-04-22,208,sprite,75,100,25,2,00123,India
628469,2023-04-22,204,strawberry yogurt,50,60,10,2,00123,India
628469,2023-04-22,213,bisleri,6,15,9,2,00123,India
223704,2023-04-22,204,strawberry yogurt,50,60,10,2,00459,India
223704,2023-04-22,209,pepsi,75,100,25,2,00459,India
529158,2023-04-22,209,pepsi,75,100,25,2,00180,India
812501,2023-04-22,202,milk,12,27,15,1,00258,India
115700,2023-04-22,204,strawberry yogurt,50,60,10,2,00082,India
115700,2023-04-22,209,pepsi,75,100,25,2,00082,India
115700,2023-04-22,213,bisleri,6,15,9,2,00082,India
966658,2023-04-22,210,mountain dew,75,100,25,2,00311,India
966658,2023-04-22,211,red bull,90,125,35,2,00311,India
966658,2023-04-22,207,coca cola,75,100,25,2,00311,India
966658,2023-04-22,213,bisleri,6,15,9,2,00311,India
966658,2023-04-22,203,mango yogurt,50,60,10,2,00311,India
693554,2023-04-22,210,mountain dew,75,100,25,2,00367,India
297378,2023-04-22,203,mango yogurt,50,60,10,2,00419,India
297378,2023-04-22,201,paneer,210,340,130,1,00419,India
297378,2023-04-22,205,classic yogurt,45,60,15,2,00419,India
297378,2023-04-22,208,sprite,75,100,25,2,00419,India
297378,2023-04-22,212,amul cheese,250,315,65,1,00419,India
637346,2023-04-22,212,amul cheese,250,315,65,1,00253,India
637346,2023-04-22,203,mango yogurt,50,60,10,2,00253,India
475214,2023-04-22,201,paneer,210,340,130,1,00445,India
475214,2023-04-22,202,milk,12,27,15,1,00445,India
475214,2023-04-22,205,classic yogurt,45,60,15,2,00445,India
592164,2023-04-22,202,milk,12,27,15,1,00150,India
592164,2023-04-22,205,classic yogurt,45,60,15,2,00150,India
681749,2023-04-22,209,pepsi,75,100,25,2,00335,India
681749,2023-04-22,211,red bull,90,125,35,2,00335,India
681749,2023-04-22,204,strawberry yogurt,50,60,10,2,00335,India
681749,2023-04-22,210,mountain dew,75,100,25,2,00335,India
802712,2023-04-22,201,paneer,210,340,130,1,00293,India
686029,2023-04-22,206,yakult,360,400,40,2,00475,India
686029,2023-04-22,209,pepsi,75,100,25,2,00475,India
686029,2023-04-22,208,sprite,75,100,25,2,00475,India
686029,2023-04-22,205,classic yogurt,45,60,15,2,00475,India
686029,2023-04-22,201,paneer,210,340,130,1,00475,India
351333,2023-04-22,205,classic yogurt,45,60,15,2,00462,India
351333,2023-04-22,202,milk,12,27,15,1,00462,India
351333,2023-04-22,208,sprite,75,100,25,2,00462,India
488426,2023-04-22,205,classic yogurt,45,60,15,2,00333,India
488426,2023-04-22,201,paneer,210,340,130,1,00333,India
488426,2023-04-22,206,yakult,360,400,40,2,00333,India
488426,2023-04-22,213,bisleri,6,15,9,2,00333,India
877623,2023-04-22,209,pepsi,75,100,25,2,00373,India
877623,2023-04-22,212,amul cheese,250,315,65,1,00373,India
877623,2023-04-22,204,strawberry yogurt,50,60,10,2,00373,India
877623,2023-04-22,201,paneer,210,340,130,1,00373,India
396579,2023-04-22,204,strawberry yogurt,50,60,10,2,00127,India
396579,2023-04-22,206,yakult,360,400,40,2,00127,India
525340,2023-04-22,205,classic yogurt,45,60,15,2,00494,India
525340,2023-04-22,213,bisleri,6,15,9,2,00494,India
525340,2023-04-22,203,mango yogurt,50,60,10,2,00494,India
525340,2023-04-22,206,yakult,360,400,40,2,00494,India
379986,2023-04-22,205,classic yogurt,45,60,15,2,00117,India
379986,2023-04-22,212,amul cheese,250,315,65,1,00117,India
379986,2023-04-22,202,milk,12,27,15,1,00117,India
453365,2023-04-22,210,mountain dew,75,100,25,2,00420,India
453365,2023-04-22,208,sprite,75,100,25,2,00420,India
453365,2023-04-22,203,mango yogurt,50,60,10,2,00420,India
578335,2023-04-22,212,amul cheese,250,315,65,1,00350,India
578335,2023-04-22,213,bisleri,6,15,9,2,00350,India
578335,2023-04-22,207,coca cola,75,100,25,2,00350,India
735666,2023-04-22,205,classic yogurt,45,60,15,2,00006,India
735666,2023-04-22,206,yakult,360,400,40,2,00006,India
735666,2023-04-22,209,pepsi,75,100,25,2,00006,India
735666,2023-04-22,208,sprite,75,100,25,2,00006,India
177262,2023-04-22,203,mango yogurt,50,60,10,2,00236,India
177262,2023-04-22,206,yakult,360,400,40,2,00236,India
177262,2023-04-22,207,coca cola,75,100,25,2,00236,India
177262,2023-04-22,205,classic yogurt,45,60,15,2,00236,India
177262,2023-04-22,208,sprite,75,100,25,2,00236,India
308336,2023-04-22,204,strawberry yogurt,50,60,10,2,00267,India
308336,2023-04-22,206,yakult,360,400,40,2,00267,India
308336,2023-04-22,208,sprite,75,100,25,2,00267,India
893450,2023-04-22,206,yakult,360,400,40,2,00185,India
893450,2023-04-22,213,bisleri,6,15,9,2,00185,India
385130,2023-04-22,208,sprite,75,100,25,2,00360,India
385130,2023-04-22,209,pepsi,75,100,25,2,00360,India
385130,2023-04-22,204,strawberry yogurt,50,60,10,2,00360,India
385130,2023-04-22,203,mango yogurt,50,60,10,2,00360,India
452180,2023-04-22,202,milk,12,27,15,1,00456,India
452180,2023-04-22,201,paneer,210,340,130,1,00456,India
452180,2023-04-22,204,strawberry yogurt,50,60,10,2,00456,India
416376,2023-04-22,201,paneer,210,340,130,1,00232,India
416376,2023-04-22,206,yakult,360,400,40,2,00232,India
416376,2023-04-22,202,milk,12,27,15,1,00232,India
416376,2023-04-22,204,strawberry yogurt,50,60,10,2,00232,India
990397,2023-04-22,212,amul cheese,250,315,65,1,00443,India
990397,2023-04-22,210,mountain dew,75,100,25,2,00443,India
592303,2023-04-22,211,red bull,90,125,35,2,00411,India
592303,2023-04-22,213,bisleri,6,15,9,2,00411,India
368430,2023-04-22,212,amul cheese,250,315,65,1,00342,India
368430,2023-04-22,201,paneer,210,340,130,1,00342,India
157726,2023-04-22,201,paneer,210,340,130,1,00419,India
157726,2023-04-22,206,yakult,360,400,40,2,00419,India
157726,2023-04-22,210,mountain dew,75,100,25,2,00419,India
157726,2023-04-22,202,milk,12,27,15,1,00419,India
157726,2023-04-22,204,strawberry yogurt,50,60,10,2,00419,India
350920,2023-04-22,207,coca cola,75,100,25,2,00084,India
350920,2023-04-22,210,mountain dew,75,100,25,2,00084,India
278205,2023-04-22,206,yakult,360,400,40,2,00197,India
278205,2023-04-22,203,mango yogurt,50,60,10,2,00197,India
278205,2023-04-22,210,mountain dew,75,100,25,2,00197,India
829305,2023-04-22,213,bisleri,6,15,9,2,00449,India
581283,2023-04-22,213,bisleri,6,15,9,2,00479,India
581283,2023-04-22,212,amul cheese,250,315,65,1,00479,India
581283,2023-04-22,203,mango yogurt,50,60,10,2,00479,India
581283,2023-04-22,205,classic yogurt,45,60,15,2,00479,India
581283,2023-04-22,207,coca cola,75,100,25,2,00479,India
465946,2023-04-22,204,strawberry yogurt,50,60,10,2,00027,India
465946,2023-04-22,208,sprite,75,100,25,2,00027,India
465946,2023-04-22,202,milk,12,27,15,1,00027,India
436665,2023-04-22,203,mango yogurt,50,60,10,2,00338,India
436665,2023-04-22,205,classic yogurt,45,60,15,2,00338,India
233786,2023-04-22,201,paneer,210,340,130,1,00319,India
233786,2023-04-22,202,milk,12,27,15,1,00319,India
613927,2023-04-22,213,bisleri,6,15,9,2,00068,India
613927,2023-04-22,205,classic yogurt,45,60,15,2,00068,India
613927,2023-04-22,208,sprite,75,100,25,2,00068,India
613927,2023-04-22,204,strawberry yogurt,50,60,10,2,00068,India
438087,2023-04-22,206,yakult,360,400,40,2,00391,India
735173,2023-04-22,209,pepsi,75,100,25,2,00395,India
735173,2023-04-22,212,amul cheese,250,315,65,1,00395,India
735173,2023-04-22,204,strawberry yogurt,50,60,10,2,00395,India
735173,2023-04-22,203,mango yogurt,50,60,10,2,00395,India
735173,2023-04-22,201,paneer,210,340,130,1,00395,India
935296,2023-04-22,202,milk,12,27,15,1,00411,India
935296,2023-04-22,210,mountain dew,75,100,25,2,00411,India
935296,2023-04-22,201,paneer,210,340,130,1,00411,India
936234,2023-04-22,212,amul cheese,250,315,65,1,00343,India
936234,2023-04-22,210,mountain dew,75,100,25,2,00343,India
936234,2023-04-22,203,mango yogurt,50,60,10,2,00343,India
232239,2023-04-22,208,sprite,75,100,25,2,00096,India
232239,2023-04-22,212,amul cheese,250,315,65,1,00096,India
232239,2023-04-22,206,yakult,360,400,40,2,00096,India
170490,2023-04-22,209,pepsi,75,100,25,2,00048,India
826852,2023-04-22,205,classic yogurt,45,60,15,2,00170,India
826852,2023-04-22,209,pepsi,75,100,25,2,00170,India
913294,2023-04-22,210,mountain dew,75,100,25,2,00189,India
913294,2023-04-22,206,yakult,360,400,40,2,00189,India
913294,2023-04-22,203,mango yogurt,50,60,10,2,00189,India
913294,2023-04-22,212,amul cheese,250,315,65,1,00189,India
966055,2023-04-22,203,mango yogurt,50,60,10,2,00153,India
966055,2023-04-22,213,bisleri,6,15,9,2,00153,India
332706,2023-04-22,209,pepsi,75,100,25,2,00105,India
332706,2023-04-22,201,paneer,210,340,130,1,00105,India
332706,2023-04-22,210,mountain dew,75,100,25,2,00105,India
332706,2023-04-22,204,strawberry yogurt,50,60,10,2,00105,India
465718,2023-04-22,201,paneer,210,340,130,1,00363,India
465718,2023-04-22,210,mountain dew,75,100,25,2,00363,India
580097,2023-04-22,210,mountain dew,75,100,25,2,00018,India
580097,2023-04-22,207,coca cola,75,100,25,2,00018,India
580097,2023-04-22,202,milk,12,27,15,1,00018,India
580097,2023-04-22,201,paneer,210,340,130,1,00018,India
440850,2023-04-22,205,classic yogurt,45,60,15,2,00114,India
440850,2023-04-22,203,mango yogurt,50,60,10,2,00114,India
440850,2023-04-22,207,coca cola,75,100,25,2,00114,India
440850,2023-04-22,206,yakult,360,400,40,2,00114,India
440850,2023-04-22,212,amul cheese,250,315,65,1,00114,India
113753,2023-04-22,210,mountain dew,75,100,25,2,00393,India
163621,2023-04-22,210,mountain dew,75,100,25,2,00341,India
163621,2023-04-22,209,pepsi,75,100,25,2,00341,India
163621,2023-04-22,201,paneer,210,340,130,1,00341,India
163621,2023-04-22,206,yakult,360,400,40,2,00341,India
910928,2023-04-22,203,mango yogurt,50,60,10,2,00397,India
910928,2023-04-22,206,yakult,360,400,40,2,00397,India
992295,2023-04-22,210,mountain dew,75,100,25,2,00023,India
664014,2023-04-23,207,coca cola,75,100,25,2,00383,India
664014,2023-04-23,202,milk,12,27,15,1,00383,India
664014,2023-04-23,206,yakult,360,400,40,2,00383,India
999282,2023-04-23,210,mountain dew,75,100,25,2,00497,India
999282,2023-04-23,209,pepsi,75,100,25,2,00497,India
999282,2023-04-23,205,classic yogurt,45,60,15,2,00497,India
999282,2023-04-23,212,amul cheese,250,315,65,1,00497,India
999282,2023-04-23,208,sprite,75,100,25,2,00497,India
818599,2023-04-23,211,red bull,90,125,35,2,00274,India
818599,2023-04-23,207,coca cola,75,100,25,2,00274,India
818599,2023-04-23,206,yakult,360,400,40,2,00274,India
978293,2023-04-23,206,yakult,360,400,40,2,00355,India
978293,2023-04-23,213,bisleri,6,15,9,2,00355,India
809905,2023-04-23,205,classic yogurt,45,60,15,2,00091,India
172078,2023-04-23,205,classic yogurt,45,60,15,2,00321,India
172078,2023-04-23,210,mountain dew,75,100,25,2,00321,India
172078,2023-04-23,211,red bull,90,125,35,2,00321,India
291656,2023-04-23,203,mango yogurt,50,60,10,2,00179,India
291656,2023-04-23,209,pepsi,75,100,25,2,00179,India
291656,2023-04-23,208,sprite,75,100,25,2,00179,India
291656,2023-04-23,212,amul cheese,250,315,65,1,00179,India
428997,2023-04-23,212,amul cheese,250,315,65,1,00168,India
134423,2023-04-23,208,sprite,75,100,25,2,00485,India
134423,2023-04-23,204,strawberry yogurt,50,60,10,2,00485,India
134423,2023-04-23,212,amul cheese,250,315,65,1,00485,India
134423,2023-04-23,203,mango yogurt,50,60,10,2,00485,India
134423,2023-04-23,202,milk,12,27,15,1,00485,India
429832,2023-04-23,207,coca cola,75,100,25,2,00471,India
429832,2023-04-23,204,strawberry yogurt,50,60,10,2,00471,India
429832,2023-04-23,203,mango yogurt,50,60,10,2,00471,India
429832,2023-04-23,201,paneer,210,340,130,1,00471,India
429832,2023-04-23,202,milk,12,27,15,1,00471,India
416587,2023-04-23,208,sprite,75,100,25,2,00256,India
946780,2023-04-23,211,red bull,90,125,35,2,00074,India
946780,2023-04-23,204,strawberry yogurt,50,60,10,2,00074,India
946780,2023-04-23,208,sprite,75,100,25,2,00074,India
197205,2023-04-23,212,amul cheese,250,315,65,1,00092,India
197205,2023-04-23,204,strawberry yogurt,50,60,10,2,00092,India
100280,2023-04-23,206,yakult,360,400,40,2,00078,India
454928,2023-04-23,211,red bull,90,125,35,2,00437,India
454928,2023-04-23,210,mountain dew,75,100,25,2,00437,India
454928,2023-04-23,206,yakult,360,400,40,2,00437,India
454928,2023-04-23,208,sprite,75,100,25,2,00437,India
808868,2023-04-23,207,coca cola,75,100,25,2,00117,India
808868,2023-04-23,211,red bull,90,125,35,2,00117,India
808868,2023-04-23,209,pepsi,75,100,25,2,00117,India
808868,2023-04-23,201,paneer,210,340,130,1,00117,India
264772,2023-04-23,201,paneer,210,340,130,1,00361,India
264772,2023-04-23,208,sprite,75,100,25,2,00361,India
264772,2023-04-23,213,bisleri,6,15,9,2,00361,India
264772,2023-04-23,206,yakult,360,400,40,2,00361,India
264772,2023-04-23,207,coca cola,75,100,25,2,00361,India
314393,2023-04-23,210,mountain dew,75,100,25,2,00191,India
185667,2023-04-23,209,pepsi,75,100,25,2,00335,India
185667,2023-04-23,204,strawberry yogurt,50,60,10,2,00335,India
581717,2023-04-23,209,pepsi,75,100,25,2,00126,India
581717,2023-04-23,207,coca cola,75,100,25,2,00126,India
581717,2023-04-23,202,milk,12,27,15,1,00126,India
294795,2023-04-23,211,red bull,90,125,35,2,00144,India
236691,2023-04-23,213,bisleri,6,15,9,2,00275,India
236691,2023-04-23,210,mountain dew,75,100,25,2,00275,India
786299,2023-04-23,201,paneer,210,340,130,1,00255,India
419468,2023-04-23,210,mountain dew,75,100,25,2,00053,India
366131,2023-04-23,207,coca cola,75,100,25,2,00027,India
366131,2023-04-23,211,red bull,90,125,35,2,00027,India
366131,2023-04-23,201,paneer,210,340,130,1,00027,India
324684,2023-04-23,201,paneer,210,340,130,1,00101,India
324684,2023-04-23,205,classic yogurt,45,60,15,2,00101,India
324684,2023-04-23,211,red bull,90,125,35,2,00101,India
324684,2023-04-23,204,strawberry yogurt,50,60,10,2,00101,India
195961,2023-04-23,209,pepsi,75,100,25,2,00215,India
494401,2023-04-23,207,coca cola,75,100,25,2,00057,India
494401,2023-04-23,206,yakult,360,400,40,2,00057,India
494401,2023-04-23,212,amul cheese,250,315,65,1,00057,India
568209,2023-04-23,205,classic yogurt,45,60,15,2,00445,India
568209,2023-04-23,210,mountain dew,75,100,25,2,00445,India
568209,2023-04-23,213,bisleri,6,15,9,2,00445,India
568209,2023-04-23,203,mango yogurt,50,60,10,2,00445,India
684841,2023-04-23,205,classic yogurt,45,60,15,2,00266,India
684841,2023-04-23,210,mountain dew,75,100,25,2,00266,India
877311,2023-04-23,208,sprite,75,100,25,2,00414,India
671209,2023-04-23,201,paneer,210,340,130,1,00072,India
671209,2023-04-23,203,mango yogurt,50,60,10,2,00072,India
671209,2023-04-23,210,mountain dew,75,100,25,2,00072,India
539805,2023-04-23,212,amul cheese,250,315,65,1,00283,India
539805,2023-04-23,201,paneer,210,340,130,1,00283,India
539805,2023-04-23,213,bisleri,6,15,9,2,00283,India
697842,2023-04-23,202,milk,12,27,15,1,00149,India
697842,2023-04-23,209,pepsi,75,100,25,2,00149,India
697842,2023-04-23,203,mango yogurt,50,60,10,2,00149,India
697842,2023-04-23,210,mountain dew,75,100,25,2,00149,India
626828,2023-04-23,204,strawberry yogurt,50,60,10,2,00142,India
345221,2023-04-23,205,classic yogurt,45,60,15,2,00476,India
345221,2023-04-23,207,coca cola,75,100,25,2,00476,India
345221,2023-04-23,213,bisleri,6,15,9,2,00476,India
590286,2023-04-23,206,yakult,360,400,40,2,00395,India
590286,2023-04-23,205,classic yogurt,45,60,15,2,00395,India
590286,2023-04-23,207,coca cola,75,100,25,2,00395,India
590286,2023-04-23,211,red bull,90,125,35,2,00395,India
509483,2023-04-23,209,pepsi,75,100,25,2,00459,India
509483,2023-04-23,211,red bull,90,125,35,2,00459,India
978931,2023-04-23,210,mountain dew,75,100,25,2,00254,India
978931,2023-04-23,205,classic yogurt,45,60,15,2,00254,India
978931,2023-04-23,212,amul cheese,250,315,65,1,00254,India
685787,2023-04-23,210,mountain dew,75,100,25,2,00283,India
685787,2023-04-23,202,milk,12,27,15,1,00283,India
685787,2023-04-23,213,bisleri,6,15,9,2,00283,India
685787,2023-04-23,205,classic yogurt,45,60,15,2,00283,India
685787,2023-04-23,208,sprite,75,100,25,2,00283,India
914811,2023-04-23,205,classic yogurt,45,60,15,2,00136,India
914811,2023-04-23,204,strawberry yogurt,50,60,10,2,00136,India
914811,2023-04-23,207,coca cola,75,100,25,2,00136,India
180201,2023-04-23,212,amul cheese,250,315,65,1,00327,India
180201,2023-04-23,209,pepsi,75,100,25,2,00327,India
180201,2023-04-23,204,strawberry yogurt,50,60,10,2,00327,India
674156,2023-04-23,204,strawberry yogurt,50,60,10,2,00020,India
674156,2023-04-23,209,pepsi,75,100,25,2,00020,India
909928,2023-04-23,210,mountain dew,75,100,25,2,00392,India
909928,2023-04-23,211,red bull,90,125,35,2,00392,India
483195,2023-04-23,211,red bull,90,125,35,2,00052,India
515522,2023-04-23,207,coca cola,75,100,25,2,00303,India
515522,2023-04-23,203,mango yogurt,50,60,10,2,00303,India
515522,2023-04-23,213,bisleri,6,15,9,2,00303,India
515522,2023-04-23,201,paneer,210,340,130,1,00303,India
515522,2023-04-23,208,sprite,75,100,25,2,00303,India
797133,2023-04-23,202,milk,12,27,15,1,00138,India
797133,2023-04-23,210,mountain dew,75,100,25,2,00138,India
797133,2023-04-23,205,classic yogurt,45,60,15,2,00138,India
350057,2023-04-23,213,bisleri,6,15,9,2,00337,India
107855,2023-04-23,203,mango yogurt,50,60,10,2,00029,India
107855,2023-04-23,213,bisleri,6,15,9,2,00029,India
422362,2023-04-23,213,bisleri,6,15,9,2,00081,India
422362,2023-04-23,206,yakult,360,400,40,2,00081,India
422362,2023-04-23,209,pepsi,75,100,25,2,00081,India
201827,2023-04-23,207,coca cola,75,100,25,2,00098,India
201827,2023-04-23,202,milk,12,27,15,1,00098,India
274792,2023-04-23,206,yakult,360,400,40,2,00403,India
800135,2023-04-23,211,red bull,90,125,35,2,00081,India
800135,2023-04-23,202,milk,12,27,15,1,00081,India
800135,2023-04-23,204,strawberry yogurt,50,60,10,2,00081,India
800135,2023-04-23,201,paneer,210,340,130,1,00081,India
461771,2023-04-23,208,sprite,75,100,25,2,00361,India
975453,2023-04-23,203,mango yogurt,50,60,10,2,00097,India
975453,2023-04-23,206,yakult,360,400,40,2,00097,India
975453,2023-04-23,213,bisleri,6,15,9,2,00097,India
571413,2023-04-23,201,paneer,210,340,130,1,00176,India
571413,2023-04-23,205,classic yogurt,45,60,15,2,00176,India
571413,2023-04-23,213,bisleri,6,15,9,2,00176,India
571413,2023-04-23,203,mango yogurt,50,60,10,2,00176,India
538789,2023-04-23,204,strawberry yogurt,50,60,10,2,00419,India
538789,2023-04-23,202,milk,12,27,15,1,00419,India
359406,2023-04-23,203,mango yogurt,50,60,10,2,00308,India
359406,2023-04-23,210,mountain dew,75,100,25,2,00308,India
102406,2023-04-23,201,paneer,210,340,130,1,00496,India
102406,2023-04-23,207,coca cola,75,100,25,2,00496,India
102406,2023-04-23,213,bisleri,6,15,9,2,00496,India
102406,2023-04-23,204,strawberry yogurt,50,60,10,2,00496,India
171320,2023-04-23,207,coca cola,75,100,25,2,00450,India
171320,2023-04-23,208,sprite,75,100,25,2,00450,India
747671,2023-04-23,211,red bull,90,125,35,2,00138,India
747671,2023-04-23,204,strawberry yogurt,50,60,10,2,00138,India
827838,2023-04-23,210,mountain dew,75,100,25,2,00167,India
827838,2023-04-23,203,mango yogurt,50,60,10,2,00167,India
827838,2023-04-23,212,amul cheese,250,315,65,1,00167,India
307300,2023-04-23,202,milk,12,27,15,1,00150,India
307300,2023-04-23,204,strawberry yogurt,50,60,10,2,00150,India
307300,2023-04-23,209,pepsi,75,100,25,2,00150,India
307300,2023-04-23,203,mango yogurt,50,60,10,2,00150,India
405782,2023-04-23,212,amul cheese,250,315,65,1,00109,India
405782,2023-04-23,206,yakult,360,400,40,2,00109,India
405782,2023-04-23,204,strawberry yogurt,50,60,10,2,00109,India
405782,2023-04-23,205,classic yogurt,45,60,15,2,00109,India
837370,2023-04-23,207,coca cola,75,100,25,2,00045,India
837370,2023-04-23,206,yakult,360,400,40,2,00045,India
837370,2023-04-23,210,mountain dew,75,100,25,2,00045,India
837370,2023-04-23,203,mango yogurt,50,60,10,2,00045,India
382679,2023-04-23,201,paneer,210,340,130,1,00434,India
396094,2023-04-23,201,paneer,210,340,130,1,00214,India
396094,2023-04-23,208,sprite,75,100,25,2,00214,India
819298,2023-04-23,213,bisleri,6,15,9,2,00237,India
764063,2023-04-23,202,milk,12,27,15,1,00441,India
764063,2023-04-23,211,red bull,90,125,35,2,00441,India
764063,2023-04-23,206,yakult,360,400,40,2,00441,India
764063,2023-04-23,203,mango yogurt,50,60,10,2,00441,India
460432,2023-04-23,209,pepsi,75,100,25,2,00046,India
460432,2023-04-23,202,milk,12,27,15,1,00046,India
860998,2023-04-23,205,classic yogurt,45,60,15,2,00312,India
860998,2023-04-23,209,pepsi,75,100,25,2,00312,India
566227,2023-04-23,202,milk,12,27,15,1,00027,India
621186,2023-04-23,209,pepsi,75,100,25,2,00109,India
621186,2023-04-23,207,coca cola,75,100,25,2,00109,India
621186,2023-04-23,202,milk,12,27,15,1,00109,India
844935,2023-04-23,203,mango yogurt,50,60,10,2,00327,India
276604,2023-04-23,208,sprite,75,100,25,2,00130,India
276604,2023-04-23,212,amul cheese,250,315,65,1,00130,India
276604,2023-04-23,209,pepsi,75,100,25,2,00130,India
276604,2023-04-23,211,red bull,90,125,35,2,00130,India
956609,2023-04-23,208,sprite,75,100,25,2,00027,India
956609,2023-04-23,205,classic yogurt,45,60,15,2,00027,India
956609,2023-04-23,201,paneer,210,340,130,1,00027,India
956609,2023-04-23,206,yakult,360,400,40,2,00027,India
340126,2023-04-23,210,mountain dew,75,100,25,2,00289,India
340126,2023-04-23,205,classic yogurt,45,60,15,2,00289,India
340126,2023-04-23,206,yakult,360,400,40,2,00289,India
624961,2023-04-23,202,milk,12,27,15,1,00392,India
624961,2023-04-23,213,bisleri,6,15,9,2,00392,India
624961,2023-04-23,211,red bull,90,125,35,2,00392,India
341112,2023-04-23,202,milk,12,27,15,1,00262,India
341112,2023-04-23,212,amul cheese,250,315,65,1,00262,India
341112,2023-04-23,210,mountain dew,75,100,25,2,00262,India
341112,2023-04-23,209,pepsi,75,100,25,2,00262,India
194060,2023-04-23,203,mango yogurt,50,60,10,2,00256,India
194060,2023-04-23,205,classic yogurt,45,60,15,2,00256,India
194060,2023-04-23,211,red bull,90,125,35,2,00256,India
194060,2023-04-23,202,milk,12,27,15,1,00256,India
399561,2023-04-23,208,sprite,75,100,25,2,00167,India
399561,2023-04-23,206,yakult,360,400,40,2,00167,India
399561,2023-04-23,205,classic yogurt,45,60,15,2,00167,India
380139,2023-04-23,208,sprite,75,100,25,2,00257,India
380139,2023-04-23,213,bisleri,6,15,9,2,00257,India
380139,2023-04-23,202,milk,12,27,15,1,00257,India
830740,2023-04-24,201,paneer,210,340,130,1,00446,India
830740,2023-04-24,209,pepsi,75,100,25,2,00446,India
891809,2023-04-24,203,mango yogurt,50,60,10,2,00088,India
891809,2023-04-24,205,classic yogurt,45,60,15,2,00088,India
824226,2023-04-24,210,mountain dew,75,100,25,2,00118,India
824226,2023-04-24,212,amul cheese,250,315,65,1,00118,India
762919,2023-04-24,212,amul cheese,250,315,65,1,00355,India
762919,2023-04-24,202,milk,12,27,15,1,00355,India
762919,2023-04-24,207,coca cola,75,100,25,2,00355,India
536400,2023-04-24,203,mango yogurt,50,60,10,2,00092,India
504357,2023-04-24,210,mountain dew,75,100,25,2,00289,India
504357,2023-04-24,211,red bull,90,125,35,2,00289,India
504357,2023-04-24,212,amul cheese,250,315,65,1,00289,India
821053,2023-04-24,202,milk,12,27,15,1,00390,India
821053,2023-04-24,204,strawberry yogurt,50,60,10,2,00390,India
821053,2023-04-24,208,sprite,75,100,25,2,00390,India
821053,2023-04-24,213,bisleri,6,15,9,2,00390,India
159810,2023-04-24,206,yakult,360,400,40,2,00092,India
159810,2023-04-24,207,coca cola,75,100,25,2,00092,India
920983,2023-04-24,203,mango yogurt,50,60,10,2,00061,India
920983,2023-04-24,201,paneer,210,340,130,1,00061,India
920983,2023-04-24,209,pepsi,75,100,25,2,00061,India
920983,2023-04-24,206,yakult,360,400,40,2,00061,India
171459,2023-04-24,211,red bull,90,125,35,2,00175,India
171459,2023-04-24,208,sprite,75,100,25,2,00175,India
171459,2023-04-24,212,amul cheese,250,315,65,1,00175,India
668163,2023-04-24,209,pepsi,75,100,25,2,00098,India
346090,2023-04-24,212,amul cheese,250,315,65,1,00394,India
346090,2023-04-24,203,mango yogurt,50,60,10,2,00394,India
346090,2023-04-24,207,coca cola,75,100,25,2,00394,India
346090,2023-04-24,201,paneer,210,340,130,1,00394,India
294043,2023-04-24,205,classic yogurt,45,60,15,2,00149,India
294043,2023-04-24,209,pepsi,75,100,25,2,00149,India
294043,2023-04-24,202,milk,12,27,15,1,00149,India
573645,2023-04-24,201,paneer,210,340,130,1,00216,India
573645,2023-04-24,208,sprite,75,100,25,2,00216,India
573645,2023-04-24,209,pepsi,75,100,25,2,00216,India
773958,2023-04-24,201,paneer,210,340,130,1,00286,India
773958,2023-04-24,206,yakult,360,400,40,2,00286,India
773958,2023-04-24,211,red bull,90,125,35,2,00286,India
967269,2023-04-24,204,strawberry yogurt,50,60,10,2,00369,India
556164,2023-04-24,210,mountain dew,75,100,25,2,00134,India
697185,2023-04-24,209,pepsi,75,100,25,2,00083,India
697185,2023-04-24,207,coca cola,75,100,25,2,00083,India
697185,2023-04-24,212,amul cheese,250,315,65,1,00083,India
103702,2023-04-24,203,mango yogurt,50,60,10,2,00489,India
103702,2023-04-24,204,strawberry yogurt,50,60,10,2,00489,India
103702,2023-04-24,211,red bull,90,125,35,2,00489,India
207887,2023-04-24,212,amul cheese,250,315,65,1,00066,India
207887,2023-04-24,205,classic yogurt,45,60,15,2,00066,India
207887,2023-04-24,209,pepsi,75,100,25,2,00066,India
260649,2023-04-24,213,bisleri,6,15,9,2,00329,India
260649,2023-04-24,204,strawberry yogurt,50,60,10,2,00329,India
260649,2023-04-24,209,pepsi,75,100,25,2,00329,India
260649,2023-04-24,208,sprite,75,100,25,2,00329,India
201952,2023-04-24,209,pepsi,75,100,25,2,00061,India
368813,2023-04-24,210,mountain dew,75,100,25,2,00217,India
368813,2023-04-24,204,strawberry yogurt,50,60,10,2,00217,India
368813,2023-04-24,202,milk,12,27,15,1,00217,India
368813,2023-04-24,203,mango yogurt,50,60,10,2,00217,India
112325,2023-04-24,202,milk,12,27,15,1,00348,India
112325,2023-04-24,209,pepsi,75,100,25,2,00348,India
112325,2023-04-24,210,mountain dew,75,100,25,2,00348,India
892179,2023-04-24,202,milk,12,27,15,1,00169,India
892179,2023-04-24,212,amul cheese,250,315,65,1,00169,India
892179,2023-04-24,208,sprite,75,100,25,2,00169,India
892179,2023-04-24,213,bisleri,6,15,9,2,00169,India
916868,2023-04-24,211,red bull,90,125,35,2,00128,India
916868,2023-04-24,209,pepsi,75,100,25,2,00128,India
916868,2023-04-24,210,mountain dew,75,100,25,2,00128,India
916868,2023-04-24,201,paneer,210,340,130,1,00128,India
480303,2023-04-24,210,mountain dew,75,100,25,2,00498,India
480303,2023-04-24,211,red bull,90,125,35,2,00498,India
520658,2023-04-24,203,mango yogurt,50,60,10,2,00358,India
520658,2023-04-24,213,bisleri,6,15,9,2,00358,India
520658,2023-04-24,212,amul cheese,250,315,65,1,00358,India
659911,2023-04-24,211,red bull,90,125,35,2,00492,India
659911,2023-04-24,212,amul cheese,250,315,65,1,00492,India
659911,2023-04-24,201,paneer,210,340,130,1,00492,India
203686,2023-04-24,211,red bull,90,125,35,2,00458,India
203686,2023-04-24,209,pepsi,75,100,25,2,00458,India
203686,2023-04-24,210,mountain dew,75,100,25,2,00458,India
832937,2023-04-24,206,yakult,360,400,40,2,00203,India
832937,2023-04-24,209,pepsi,75,100,25,2,00203,India
157502,2023-04-24,213,bisleri,6,15,9,2,00440,India
157502,2023-04-24,201,paneer,210,340,130,1,00440,India
157502,2023-04-24,202,milk,12,27,15,1,00440,India
903575,2023-04-24,213,bisleri,6,15,9,2,00313,India
903575,2023-04-24,212,amul cheese,250,315,65,1,00313,India
903575,2023-04-24,206,yakult,360,400,40,2,00313,India
307002,2023-04-24,205,classic yogurt,45,60,15,2,00499,India
307002,2023-04-24,213,bisleri,6,15,9,2,00499,India
307002,2023-04-24,212,amul cheese,250,315,65,1,00499,India
307002,2023-04-24,201,paneer,210,340,130,1,00499,India
307002,2023-04-24,203,mango yogurt,50,60,10,2,00499,India
322366,2023-04-24,204,strawberry yogurt,50,60,10,2,00415,India
154941,2023-04-24,204,strawberry yogurt,50,60,10,2,00385,India
154941,2023-04-24,202,milk,12,27,15,1,00385,India
154941,2023-04-24,208,sprite,75,100,25,2,00385,India
154941,2023-04-24,206,yakult,360,400,40,2,00385,India
671311,2023-04-24,206,yakult,360,400,40,2,00411,India
671311,2023-04-24,205,classic yogurt,45,60,15,2,00411,India
671311,2023-04-24,203,mango yogurt,50,60,10,2,00411,India
671311,2023-04-24,204,strawberry yogurt,50,60,10,2,00411,India
159765,2023-04-24,212,amul cheese,250,315,65,1,00258,India
159765,2023-04-24,204,strawberry yogurt,50,60,10,2,00258,India
506744,2023-04-24,208,sprite,75,100,25,2,00411,India
506744,2023-04-24,212,amul cheese,250,315,65,1,00411,India
457117,2023-04-24,210,mountain dew,75,100,25,2,00190,India
457117,2023-04-24,209,pepsi,75,100,25,2,00190,India
371240,2023-04-24,203,mango yogurt,50,60,10,2,00416,India
371240,2023-04-24,204,strawberry yogurt,50,60,10,2,00416,India
774211,2023-04-24,205,classic yogurt,45,60,15,2,00060,India
774211,2023-04-24,206,yakult,360,400,40,2,00060,India
774211,2023-04-24,203,mango yogurt,50,60,10,2,00060,India
774211,2023-04-24,208,sprite,75,100,25,2,00060,India
787053,2023-04-24,206,yakult,360,400,40,2,00363,India
787053,2023-04-24,212,amul cheese,250,315,65,1,00363,India
876018,2023-04-24,206,yakult,360,400,40,2,00422,India
876018,2023-04-24,205,classic yogurt,45,60,15,2,00422,India
876018,2023-04-24,209,pepsi,75,100,25,2,00422,India
876018,2023-04-24,204,strawberry yogurt,50,60,10,2,00422,India
876018,2023-04-24,203,mango yogurt,50,60,10,2,00422,India
717247,2023-04-24,213,bisleri,6,15,9,2,00423,India
717247,2023-04-24,205,classic yogurt,45,60,15,2,00423,India
717247,2023-04-24,202,milk,12,27,15,1,00423,India
764504,2023-04-24,203,mango yogurt,50,60,10,2,00192,India
746029,2023-04-24,207,coca cola,75,100,25,2,00423,India
762814,2023-04-24,208,sprite,75,100,25,2,00282,India
762814,2023-04-24,212,amul cheese,250,315,65,1,00282,India
762814,2023-04-24,213,bisleri,6,15,9,2,00282,India
230516,2023-04-24,208,sprite,75,100,25,2,00347,India
230516,2023-04-24,210,mountain dew,75,100,25,2,00347,India
230516,2023-04-24,205,classic yogurt,45,60,15,2,00347,India
749497,2023-04-24,203,mango yogurt,50,60,10,2,00102,India
578662,2023-04-24,204,strawberry yogurt,50,60,10,2,00032,India
578662,2023-04-24,203,mango yogurt,50,60,10,2,00032,India
578662,2023-04-24,212,amul cheese,250,315,65,1,00032,India
578662,2023-04-24,208,sprite,75,100,25,2,00032,India
447428,2023-04-24,213,bisleri,6,15,9,2,00182,India
803993,2023-04-24,204,strawberry yogurt,50,60,10,2,00325,India
803993,2023-04-24,208,sprite,75,100,25,2,00325,India
101455,2023-04-24,204,strawberry yogurt,50,60,10,2,00373,India
101455,2023-04-24,212,amul cheese,250,315,65,1,00373,India
358844,2023-04-24,203,mango yogurt,50,60,10,2,00186,India
358844,2023-04-24,213,bisleri,6,15,9,2,00186,India
358844,2023-04-24,202,milk,12,27,15,1,00186,India
322897,2023-04-24,212,amul cheese,250,315,65,1,00415,India
322897,2023-04-24,204,strawberry yogurt,50,60,10,2,00415,India
599605,2023-04-24,205,classic yogurt,45,60,15,2,00472,India
562877,2023-04-24,211,red bull,90,125,35,2,00406,India
562877,2023-04-24,204,strawberry yogurt,50,60,10,2,00406,India
562877,2023-04-24,202,milk,12,27,15,1,00406,India
562877,2023-04-24,206,yakult,360,400,40,2,00406,India
221240,2023-04-24,204,strawberry yogurt,50,60,10,2,00075,India
224281,2023-04-24,205,classic yogurt,45,60,15,2,00362,India
224281,2023-04-24,210,mountain dew,75,100,25,2,00362,India
224281,2023-04-24,212,amul cheese,250,315,65,1,00362,India
675273,2023-04-24,207,coca cola,75,100,25,2,00268,India
675273,2023-04-24,205,classic yogurt,45,60,15,2,00268,India
675273,2023-04-24,202,milk,12,27,15,1,00268,India
675273,2023-04-24,210,mountain dew,75,100,25,2,00268,India
611753,2023-04-24,205,classic yogurt,45,60,15,2,00018,India
611753,2023-04-24,207,coca cola,75,100,25,2,00018,India
611753,2023-04-24,201,paneer,210,340,130,1,00018,India
184496,2023-04-24,206,yakult,360,400,40,2,00064,India
184496,2023-04-24,202,milk,12,27,15,1,00064,India
184496,2023-04-24,207,coca cola,75,100,25,2,00064,India
184496,2023-04-24,203,mango yogurt,50,60,10,2,00064,India
748393,2023-04-24,202,milk,12,27,15,1,00478,India
156367,2023-04-24,204,strawberry yogurt,50,60,10,2,00080,India
483060,2023-04-24,209,pepsi,75,100,25,2,00050,India
483060,2023-04-24,213,bisleri,6,15,9,2,00050,India
483060,2023-04-24,210,mountain dew,75,100,25,2,00050,India
271714,2023-04-24,208,sprite,75,100,25,2,00433,India
271714,2023-04-24,206,yakult,360,400,40,2,00433,India
271714,2023-04-24,207,coca cola,75,100,25,2,00433,India
145688,2023-04-24,202,milk,12,27,15,1,00386,India
145688,2023-04-24,210,mountain dew,75,100,25,2,00386,India
145688,2023-04-24,203,mango yogurt,50,60,10,2,00386,India
662957,2023-04-24,206,yakult,360,400,40,2,00100,India
662957,2023-04-24,213,bisleri,6,15,9,2,00100,India
662957,2023-04-24,205,classic yogurt,45,60,15,2,00100,India
662957,2023-04-24,204,strawberry yogurt,50,60,10,2,00100,India
840986,2023-04-24,210,mountain dew,75,100,25,2,00137,India
539919,2023-04-24,207,coca cola,75,100,25,2,00422,India
539919,2023-04-24,206,yakult,360,400,40,2,00422,India
539919,2023-04-24,213,bisleri,6,15,9,2,00422,India
825920,2023-04-24,211,red bull,90,125,35,2,00326,India
264929,2023-04-24,207,coca cola,75,100,25,2,00044,India
264929,2023-04-24,205,classic yogurt,45,60,15,2,00044,India
264929,2023-04-24,209,pepsi,75,100,25,2,00044,India
264929,2023-04-24,206,yakult,360,400,40,2,00044,India
264929,2023-04-24,213,bisleri,6,15,9,2,00044,India
532472,2023-04-24,205,classic yogurt,45,60,15,2,00386,India
532472,2023-04-24,208,sprite,75,100,25,2,00386,India
532472,2023-04-24,209,pepsi,75,100,25,2,00386,India
532472,2023-04-24,204,strawberry yogurt,50,60,10,2,00386,India
532472,2023-04-24,210,mountain dew,75,100,25,2,00386,India
285930,2023-04-24,208,sprite,75,100,25,2,00175,India
285930,2023-04-24,211,red bull,90,125,35,2,00175,India
285930,2023-04-24,205,classic yogurt,45,60,15,2,00175,India
285930,2023-04-24,203,mango yogurt,50,60,10,2,00175,India
861670,2023-04-24,203,mango yogurt,50,60,10,2,00296,India
861670,2023-04-24,207,coca cola,75,100,25,2,00296,India
861670,2023-04-24,204,strawberry yogurt,50,60,10,2,00296,India
861670,2023-04-24,212,amul cheese,250,315,65,1,00296,India
690906,2023-04-25,212,amul cheese,250,315,65,1,00214,India
690906,2023-04-25,204,strawberry yogurt,50,60,10,2,00214,India
690906,2023-04-25,213,bisleri,6,15,9,2,00214,India
690906,2023-04-25,207,coca cola,75,100,25,2,00214,India
877142,2023-04-25,204,strawberry yogurt,50,60,10,2,00201,India
190752,2023-04-25,207,coca cola,75,100,25,2,00252,India
190752,2023-04-25,208,sprite,75,100,25,2,00252,India
190752,2023-04-25,211,red bull,90,125,35,2,00252,India
190752,2023-04-25,205,classic yogurt,45,60,15,2,00252,India
913267,2023-04-25,204,strawberry yogurt,50,60,10,2,00308,India
946062,2023-04-25,206,yakult,360,400,40,2,00298,India
946062,2023-04-25,211,red bull,90,125,35,2,00298,India
946062,2023-04-25,208,sprite,75,100,25,2,00298,India
323888,2023-04-25,207,coca cola,75,100,25,2,00376,India
394300,2023-04-25,204,strawberry yogurt,50,60,10,2,00067,India
394300,2023-04-25,207,coca cola,75,100,25,2,00067,India
497762,2023-04-25,208,sprite,75,100,25,2,00118,India
497762,2023-04-25,205,classic yogurt,45,60,15,2,00118,India
497762,2023-04-25,206,yakult,360,400,40,2,00118,India
247100,2023-04-25,209,pepsi,75,100,25,2,00037,India
247100,2023-04-25,202,milk,12,27,15,1,00037,India
247100,2023-04-25,208,sprite,75,100,25,2,00037,India
247100,2023-04-25,203,mango yogurt,50,60,10,2,00037,India
478604,2023-04-25,201,paneer,210,340,130,1,00424,India
461071,2023-04-25,212,amul cheese,250,315,65,1,00122,India
461071,2023-04-25,204,strawberry yogurt,50,60,10,2,00122,India
461071,2023-04-25,202,milk,12,27,15,1,00122,India
461071,2023-04-25,210,mountain dew,75,100,25,2,00122,India
146613,2023-04-25,205,classic yogurt,45,60,15,2,00215,India
100358,2023-04-25,204,strawberry yogurt,50,60,10,2,00063,India
100358,2023-04-25,205,classic yogurt,45,60,15,2,00063,India
782828,2023-04-25,208,sprite,75,100,25,2,00009,India
782828,2023-04-25,201,paneer,210,340,130,1,00009,India
782828,2023-04-25,202,milk,12,27,15,1,00009,India
782828,2023-04-25,211,red bull,90,125,35,2,00009,India
214749,2023-04-25,210,mountain dew,75,100,25,2,00181,India
214749,2023-04-25,212,amul cheese,250,315,65,1,00181,India
972263,2023-04-25,209,pepsi,75,100,25,2,00204,India
949791,2023-04-25,211,red bull,90,125,35,2,00480,India
949791,2023-04-25,208,sprite,75,100,25,2,00480,India
949791,2023-04-25,212,amul cheese,250,315,65,1,00480,India
746731,2023-04-25,211,red bull,90,125,35,2,00343,India
976520,2023-04-25,210,mountain dew,75,100,25,2,00317,India
976520,2023-04-25,205,classic yogurt,45,60,15,2,00317,India
148431,2023-04-25,209,pepsi,75,100,25,2,00050,India
148431,2023-04-25,212,amul cheese,250,315,65,1,00050,India
510309,2023-04-25,207,coca cola,75,100,25,2,00078,India
510309,2023-04-25,213,bisleri,6,15,9,2,00078,India
510309,2023-04-25,201,paneer,210,340,130,1,00078,India
510309,2023-04-25,204,strawberry yogurt,50,60,10,2,00078,India
276221,2023-04-25,203,mango yogurt,50,60,10,2,00066,India
276221,2023-04-25,209,pepsi,75,100,25,2,00066,India
551564,2023-04-25,202,milk,12,27,15,1,00401,India
551564,2023-04-25,203,mango yogurt,50,60,10,2,00401,India
551564,2023-04-25,210,mountain dew,75,100,25,2,00401,India
551564,2023-04-25,204,strawberry yogurt,50,60,10,2,00401,India
137654,2023-04-25,213,bisleri,6,15,9,2,00142,India
137654,2023-04-25,204,strawberry yogurt,50,60,10,2,00142,India
137654,2023-04-25,206,yakult,360,400,40,2,00142,India
651130,2023-04-25,208,sprite,75,100,25,2,00358,India
651130,2023-04-25,202,milk,12,27,15,1,00358,India
651130,2023-04-25,212,amul cheese,250,315,65,1,00358,India
551813,2023-04-25,207,coca cola,75,100,25,2,00492,India
976202,2023-04-25,211,red bull,90,125,35,2,00303,India
976202,2023-04-25,212,amul cheese,250,315,65,1,00303,India
976202,2023-04-25,208,sprite,75,100,25,2,00303,India
518455,2023-04-25,205,classic yogurt,45,60,15,2,00450,India
518455,2023-04-25,213,bisleri,6,15,9,2,00450,India
518455,2023-04-25,202,milk,12,27,15,1,00450,India
390098,2023-04-25,212,amul cheese,250,315,65,1,00098,India
390098,2023-04-25,211,red bull,90,125,35,2,00098,India
390098,2023-04-25,208,sprite,75,100,25,2,00098,India
879294,2023-04-25,210,mountain dew,75,100,25,2,00126,India
879294,2023-04-25,211,red bull,90,125,35,2,00126,India
879294,2023-04-25,201,paneer,210,340,130,1,00126,India
879294,2023-04-25,204,strawberry yogurt,50,60,10,2,00126,India
879294,2023-04-25,213,bisleri,6,15,9,2,00126,India
168308,2023-04-25,204,strawberry yogurt,50,60,10,2,00109,India
168308,2023-04-25,212,amul cheese,250,315,65,1,00109,India
168308,2023-04-25,205,classic yogurt,45,60,15,2,00109,India
168308,2023-04-25,202,milk,12,27,15,1,00109,India
223421,2023-04-25,209,pepsi,75,100,25,2,00320,India
223421,2023-04-25,202,milk,12,27,15,1,00320,India
223421,2023-04-25,207,coca cola,75,100,25,2,00320,India
600411,2023-04-25,213,bisleri,6,15,9,2,00150,India
600411,2023-04-25,210,mountain dew,75,100,25,2,00150,India
600411,2023-04-25,211,red bull,90,125,35,2,00150,India
600411,2023-04-25,208,sprite,75,100,25,2,00150,India
793767,2023-04-25,207,coca cola,75,100,25,2,00286,India
793767,2023-04-25,210,mountain dew,75,100,25,2,00286,India
793767,2023-04-25,208,sprite,75,100,25,2,00286,India
793767,2023-04-25,212,amul cheese,250,315,65,1,00286,India
793767,2023-04-25,209,pepsi,75,100,25,2,00286,India
672739,2023-04-25,202,milk,12,27,15,1,00181,India
110549,2023-04-25,201,paneer,210,340,130,1,00246,India
110549,2023-04-25,205,classic yogurt,45,60,15,2,00246,India
820559,2023-04-25,211,red bull,90,125,35,2,00355,India
820559,2023-04-25,212,amul cheese,250,315,65,1,00355,India
820559,2023-04-25,209,pepsi,75,100,25,2,00355,India
820559,2023-04-25,208,sprite,75,100,25,2,00355,India
820559,2023-04-25,206,yakult,360,400,40,2,00355,India
665805,2023-04-25,210,mountain dew,75,100,25,2,00019,India
665805,2023-04-25,202,milk,12,27,15,1,00019,India
662368,2023-04-25,205,classic yogurt,45,60,15,2,00485,India
662368,2023-04-25,211,red bull,90,125,35,2,00485,India
567335,2023-04-25,213,bisleri,6,15,9,2,00110,India
567335,2023-04-25,207,coca cola,75,100,25,2,00110,India
567335,2023-04-25,209,pepsi,75,100,25,2,00110,India
567335,2023-04-25,204,strawberry yogurt,50,60,10,2,00110,India
913060,2023-04-25,210,mountain dew,75,100,25,2,00028,India
913060,2023-04-25,209,pepsi,75,100,25,2,00028,India
913060,2023-04-25,204,strawberry yogurt,50,60,10,2,00028,India
121246,2023-04-25,207,coca cola,75,100,25,2,00407,India
121246,2023-04-25,205,classic yogurt,45,60,15,2,00407,India
579773,2023-04-25,203,mango yogurt,50,60,10,2,00476,India
579773,2023-04-25,213,bisleri,6,15,9,2,00476,India
579773,2023-04-25,207,coca cola,75,100,25,2,00476,India
453795,2023-04-25,205,classic yogurt,45,60,15,2,00248,India
453795,2023-04-25,206,yakult,360,400,40,2,00248,India
453795,2023-04-25,204,strawberry yogurt,50,60,10,2,00248,India
453795,2023-04-25,207,coca cola,75,100,25,2,00248,India
349801,2023-04-25,203,mango yogurt,50,60,10,2,00339,India
349801,2023-04-25,205,classic yogurt,45,60,15,2,00339,India
349801,2023-04-25,213,bisleri,6,15,9,2,00339,India
706268,2023-04-25,207,coca cola,75,100,25,2,00068,India
706268,2023-04-25,209,pepsi,75,100,25,2,00068,India
706268,2023-04-25,213,bisleri,6,15,9,2,00068,India
706268,2023-04-25,201,paneer,210,340,130,1,00068,India
875226,2023-04-25,213,bisleri,6,15,9,2,00079,India
466158,2023-04-25,203,mango yogurt,50,60,10,2,00098,India
466158,2023-04-25,206,yakult,360,400,40,2,00098,India
404309,2023-04-25,201,paneer,210,340,130,1,00389,India
842525,2023-04-25,204,strawberry yogurt,50,60,10,2,00052,India
842525,2023-04-25,201,paneer,210,340,130,1,00052,India
842525,2023-04-25,202,milk,12,27,15,1,00052,India
363634,2023-04-25,202,milk,12,27,15,1,00193,India
363634,2023-04-25,213,bisleri,6,15,9,2,00193,India
129951,2023-04-25,205,classic yogurt,45,60,15,2,00126,India
242695,2023-04-25,213,bisleri,6,15,9,2,00376,India
242695,2023-04-25,203,mango yogurt,50,60,10,2,00376,India
242695,2023-04-25,209,pepsi,75,100,25,2,00376,India
717489,2023-04-25,213,bisleri,6,15,9,2,00178,India
740374,2023-04-25,204,strawberry yogurt,50,60,10,2,00379,India
740374,2023-04-25,210,mountain dew,75,100,25,2,00379,India
740374,2023-04-25,207,coca cola,75,100,25,2,00379,India
740374,2023-04-25,205,classic yogurt,45,60,15,2,00379,India
740374,2023-04-25,203,mango yogurt,50,60,10,2,00379,India
124666,2023-04-25,212,amul cheese,250,315,65,1,00030,India
590406,2023-04-25,213,bisleri,6,15,9,2,00327,India
309482,2023-04-25,210,mountain dew,75,100,25,2,00077,India
309482,2023-04-25,205,classic yogurt,45,60,15,2,00077,India
309482,2023-04-25,207,coca cola,75,100,25,2,00077,India
309482,2023-04-25,213,bisleri,6,15,9,2,00077,India
722959,2023-04-25,202,milk,12,27,15,1,00271,India
381388,2023-04-25,203,mango yogurt,50,60,10,2,00185,India
898878,2023-04-25,212,amul cheese,250,315,65,1,00074,India
898878,2023-04-25,209,pepsi,75,100,25,2,00074,India
947287,2023-04-25,213,bisleri,6,15,9,2,00157,India
947287,2023-04-25,209,pepsi,75,100,25,2,00157,India
947287,2023-04-25,211,red bull,90,125,35,2,00157,India
243654,2023-04-25,205,classic yogurt,45,60,15,2,00016,India
243654,2023-04-25,209,pepsi,75,100,25,2,00016,India
243654,2023-04-25,204,strawberry yogurt,50,60,10,2,00016,India
243654,2023-04-25,203,mango yogurt,50,60,10,2,00016,India
195885,2023-04-25,203,mango yogurt,50,60,10,2,00384,India
195885,2023-04-25,204,strawberry yogurt,50,60,10,2,00384,India
126714,2023-04-25,204,strawberry yogurt,50,60,10,2,00280,India
126714,2023-04-25,201,paneer,210,340,130,1,00280,India
126714,2023-04-25,203,mango yogurt,50,60,10,2,00280,India
373186,2023-04-25,206,yakult,360,400,40,2,00404,India
373186,2023-04-25,201,paneer,210,340,130,1,00404,India
373186,2023-04-25,202,milk,12,27,15,1,00404,India
591166,2023-04-25,211,red bull,90,125,35,2,00448,India
591166,2023-04-25,210,mountain dew,75,100,25,2,00448,India
591166,2023-04-25,204,strawberry yogurt,50,60,10,2,00448,India
125695,2023-04-25,211,red bull,90,125,35,2,00172,India
125695,2023-04-25,212,amul cheese,250,315,65,1,00172,India
125695,2023-04-25,209,pepsi,75,100,25,2,00172,India
645534,2023-04-26,203,mango yogurt,50,60,10,2,00330,India
645534,2023-04-26,201,paneer,210,340,130,1,00330,India
645534,2023-04-26,202,milk,12,27,15,1,00330,India
645534,2023-04-26,204,strawberry yogurt,50,60,10,2,00330,India
645534,2023-04-26,210,mountain dew,75,100,25,2,00330,India
498506,2023-04-26,209,pepsi,75,100,25,2,00291,India
498506,2023-04-26,201,paneer,210,340,130,1,00291,India
498506,2023-04-26,206,yakult,360,400,40,2,00291,India
498506,2023-04-26,210,mountain dew,75,100,25,2,00291,India
398021,2023-04-26,205,classic yogurt,45,60,15,2,00277,India
136765,2023-04-26,209,pepsi,75,100,25,2,00014,India
136765,2023-04-26,211,red bull,90,125,35,2,00014,India
136765,2023-04-26,204,strawberry yogurt,50,60,10,2,00014,India
582986,2023-04-26,208,sprite,75,100,25,2,00488,India
582986,2023-04-26,212,amul cheese,250,315,65,1,00488,India
582986,2023-04-26,213,bisleri,6,15,9,2,00488,India
582986,2023-04-26,209,pepsi,75,100,25,2,00488,India
582986,2023-04-26,207,coca cola,75,100,25,2,00488,India
647759,2023-04-26,208,sprite,75,100,25,2,00100,India
647759,2023-04-26,202,milk,12,27,15,1,00100,India
647759,2023-04-26,201,paneer,210,340,130,1,00100,India
647759,2023-04-26,212,amul cheese,250,315,65,1,00100,India
837877,2023-04-26,201,paneer,210,340,130,1,00286,India
837877,2023-04-26,206,yakult,360,400,40,2,00286,India
837877,2023-04-26,209,pepsi,75,100,25,2,00286,India
837877,2023-04-26,212,amul cheese,250,315,65,1,00286,India
837877,2023-04-26,213,bisleri,6,15,9,2,00286,India
327508,2023-04-26,212,amul cheese,250,315,65,1,00462,India
327508,2023-04-26,209,pepsi,75,100,25,2,00462,India
908707,2023-04-26,202,milk,12,27,15,1,00449,India
265864,2023-04-26,210,mountain dew,75,100,25,2,00107,India
265864,2023-04-26,207,coca cola,75,100,25,2,00107,India
265864,2023-04-26,213,bisleri,6,15,9,2,00107,India
265864,2023-04-26,204,strawberry yogurt,50,60,10,2,00107,India
265864,2023-04-26,203,mango yogurt,50,60,10,2,00107,India
881189,2023-04-26,202,milk,12,27,15,1,00012,India
881189,2023-04-26,206,yakult,360,400,40,2,00012,India
881189,2023-04-26,209,pepsi,75,100,25,2,00012,India
881189,2023-04-26,207,coca cola,75,100,25,2,00012,India
256532,2023-04-26,211,red bull,90,125,35,2,00283,India
256532,2023-04-26,205,classic yogurt,45,60,15,2,00283,India
256532,2023-04-26,213,bisleri,6,15,9,2,00283,India
211247,2023-04-26,212,amul cheese,250,315,65,1,00116,India
213257,2023-04-26,211,red bull,90,125,35,2,00399,India
213257,2023-04-26,201,paneer,210,340,130,1,00399,India
213257,2023-04-26,212,amul cheese,250,315,65,1,00399,India
339768,2023-04-26,208,sprite,75,100,25,2,00147,India
339768,2023-04-26,210,mountain dew,75,100,25,2,00147,India
666661,2023-04-26,201,paneer,210,340,130,1,00482,India
926601,2023-04-26,208,sprite,75,100,25,2,00095,India
926601,2023-04-26,204,strawberry yogurt,50,60,10,2,00095,India
926601,2023-04-26,202,milk,12,27,15,1,00095,India
926601,2023-04-26,209,pepsi,75,100,25,2,00095,India
436222,2023-04-26,211,red bull,90,125,35,2,00335,India
436222,2023-04-26,205,classic yogurt,45,60,15,2,00335,India
436222,2023-04-26,212,amul cheese,250,315,65,1,00335,India
436222,2023-04-26,213,bisleri,6,15,9,2,00335,India
436222,2023-04-26,202,milk,12,27,15,1,00335,India
622778,2023-04-26,208,sprite,75,100,25,2,00228,India
622778,2023-04-26,207,coca cola,75,100,25,2,00228,India
622778,2023-04-26,209,pepsi,75,100,25,2,00228,India
622778,2023-04-26,212,amul cheese,250,315,65,1,00228,India
622778,2023-04-26,210,mountain dew,75,100,25,2,00228,India
109017,2023-04-26,202,milk,12,27,15,1,00412,India
109017,2023-04-26,207,coca cola,75,100,25,2,00412,India
772162,2023-04-26,211,red bull,90,125,35,2,00092,India
135761,2023-04-26,209,pepsi,75,100,25,2,00375,India
135761,2023-04-26,211,red bull,90,125,35,2,00375,India
135761,2023-04-26,201,paneer,210,340,130,1,00375,India
433729,2023-04-26,213,bisleri,6,15,9,2,00170,India
794339,2023-04-26,212,amul cheese,250,315,65,1,00472,India
794339,2023-04-26,209,pepsi,75,100,25,2,00472,India
794339,2023-04-26,208,sprite,75,100,25,2,00472,India
584251,2023-04-26,204,strawberry yogurt,50,60,10,2,00278,India
584251,2023-04-26,212,amul cheese,250,315,65,1,00278,India
584251,2023-04-26,211,red bull,90,125,35,2,00278,India
958543,2023-04-26,201,paneer,210,340,130,1,00435,India
223158,2023-04-26,204,strawberry yogurt,50,60,10,2,00170,India
223158,2023-04-26,209,pepsi,75,100,25,2,00170,India
223158,2023-04-26,205,classic yogurt,45,60,15,2,00170,India
320155,2023-04-26,211,red bull,90,125,35,2,00051,India
320155,2023-04-26,210,mountain dew,75,100,25,2,00051,India
285019,2023-04-26,213,bisleri,6,15,9,2,00338,India
285019,2023-04-26,203,mango yogurt,50,60,10,2,00338,India
285019,2023-04-26,205,classic yogurt,45,60,15,2,00338,India
285019,2023-04-26,211,red bull,90,125,35,2,00338,India
285019,2023-04-26,209,pepsi,75,100,25,2,00338,India
315335,2023-04-26,212,amul cheese,250,315,65,1,00422,India
315335,2023-04-26,202,milk,12,27,15,1,00422,India
315335,2023-04-26,210,mountain dew,75,100,25,2,00422,India
877121,2023-04-26,205,classic yogurt,45,60,15,2,00121,India
749011,2023-04-26,207,coca cola,75,100,25,2,00091,India
173212,2023-04-26,201,paneer,210,340,130,1,00151,India
173212,2023-04-26,209,pepsi,75,100,25,2,00151,India
173212,2023-04-26,207,coca cola,75,100,25,2,00151,India
488312,2023-04-26,204,strawberry yogurt,50,60,10,2,00151,India
788685,2023-04-26,202,milk,12,27,15,1,00055,India
788685,2023-04-26,204,strawberry yogurt,50,60,10,2,00055,India
788685,2023-04-26,206,yakult,360,400,40,2,00055,India
102810,2023-04-26,207,coca cola,75,100,25,2,00378,India
102810,2023-04-26,213,bisleri,6,15,9,2,00378,India
868940,2023-04-26,207,coca cola,75,100,25,2,00164,India
868940,2023-04-26,208,sprite,75,100,25,2,00164,India
868940,2023-04-26,202,milk,12,27,15,1,00164,India
868940,2023-04-26,209,pepsi,75,100,25,2,00164,India
377082,2023-04-26,211,red bull,90,125,35,2,00021,India
377082,2023-04-26,213,bisleri,6,15,9,2,00021,India
377082,2023-04-26,207,coca cola,75,100,25,2,00021,India
101338,2023-04-26,209,pepsi,75,100,25,2,00392,India
145503,2023-04-26,213,bisleri,6,15,9,2,00113,India
819396,2023-04-26,212,amul cheese,250,315,65,1,00457,India
204986,2023-04-26,208,sprite,75,100,25,2,00296,India
204986,2023-04-26,209,pepsi,75,100,25,2,00296,India
204986,2023-04-26,201,paneer,210,340,130,1,00296,India
478189,2023-04-26,212,amul cheese,250,315,65,1,00247,India
478189,2023-04-26,202,milk,12,27,15,1,00247,India
478189,2023-04-26,206,yakult,360,400,40,2,00247,India
478189,2023-04-26,207,coca cola,75,100,25,2,00247,India
354189,2023-04-26,203,mango yogurt,50,60,10,2,00308,India
779233,2023-04-26,212,amul cheese,250,315,65,1,00381,India
779233,2023-04-26,203,mango yogurt,50,60,10,2,00381,India
881185,2023-04-26,204,strawberry yogurt,50,60,10,2,00150,India
881185,2023-04-26,203,mango yogurt,50,60,10,2,00150,India
881185,2023-04-26,205,classic yogurt,45,60,15,2,00150,India
439929,2023-04-26,204,strawberry yogurt,50,60,10,2,00479,India
439929,2023-04-26,212,amul cheese,250,315,65,1,00479,India
796958,2023-04-26,212,amul cheese,250,315,65,1,00243,India
569974,2023-04-26,212,amul cheese,250,315,65,1,00485,India
569974,2023-04-26,205,classic yogurt,45,60,15,2,00485,India
569974,2023-04-26,210,mountain dew,75,100,25,2,00485,India
568320,2023-04-26,202,milk,12,27,15,1,00420,India
623674,2023-04-26,203,mango yogurt,50,60,10,2,00314,India
623674,2023-04-26,205,classic yogurt,45,60,15,2,00314,India
497741,2023-04-26,202,milk,12,27,15,1,00065,India
497741,2023-04-26,212,amul cheese,250,315,65,1,00065,India
497741,2023-04-26,201,paneer,210,340,130,1,00065,India
497741,2023-04-26,206,yakult,360,400,40,2,00065,India
746163,2023-04-26,210,mountain dew,75,100,25,2,00125,India
580829,2023-04-26,202,milk,12,27,15,1,00420,India
580829,2023-04-26,206,yakult,360,400,40,2,00420,India
929745,2023-04-26,209,pepsi,75,100,25,2,00124,India
929745,2023-04-26,210,mountain dew,75,100,25,2,00124,India
317337,2023-04-26,208,sprite,75,100,25,2,00409,India
317337,2023-04-26,213,bisleri,6,15,9,2,00409,India
199215,2023-04-26,202,milk,12,27,15,1,00409,India
273944,2023-04-26,205,classic yogurt,45,60,15,2,00282,India
273944,2023-04-26,207,coca cola,75,100,25,2,00282,India
273944,2023-04-26,202,milk,12,27,15,1,00282,India
284881,2023-04-27,204,strawberry yogurt,50,60,10,2,00284,India
615687,2023-04-27,208,sprite,75,100,25,2,00075,India
615687,2023-04-27,206,yakult,360,400,40,2,00075,India
843653,2023-04-27,212,amul cheese,250,315,65,1,00023,India
843653,2023-04-27,204,strawberry yogurt,50,60,10,2,00023,India
843653,2023-04-27,213,bisleri,6,15,9,2,00023,India
194565,2023-04-27,201,paneer,210,340,130,1,00209,India
693091,2023-04-27,209,pepsi,75,100,25,2,00195,India
693091,2023-04-27,210,mountain dew,75,100,25,2,00195,India
693091,2023-04-27,201,paneer,210,340,130,1,00195,India
693091,2023-04-27,205,classic yogurt,45,60,15,2,00195,India
239352,2023-04-27,207,coca cola,75,100,25,2,00023,India
239352,2023-04-27,205,classic yogurt,45,60,15,2,00023,India
239352,2023-04-27,210,mountain dew,75,100,25,2,00023,India
672360,2023-04-27,212,amul cheese,250,315,65,1,00322,India
672360,2023-04-27,202,milk,12,27,15,1,00322,India
672360,2023-04-27,213,bisleri,6,15,9,2,00322,India
672360,2023-04-27,205,classic yogurt,45,60,15,2,00322,India
446337,2023-04-27,211,red bull,90,125,35,2,00417,India
446337,2023-04-27,201,paneer,210,340,130,1,00417,India
446337,2023-04-27,208,sprite,75,100,25,2,00417,India
462164,2023-04-27,205,classic yogurt,45,60,15,2,00108,India
376135,2023-04-27,204,strawberry yogurt,50,60,10,2,00364,India
376135,2023-04-27,207,coca cola,75,100,25,2,00364,India
376135,2023-04-27,201,paneer,210,340,130,1,00364,India
376135,2023-04-27,203,mango yogurt,50,60,10,2,00364,India
755027,2023-04-27,201,paneer,210,340,130,1,00344,India
755027,2023-04-27,204,strawberry yogurt,50,60,10,2,00344,India
755027,2023-04-27,213,bisleri,6,15,9,2,00344,India
723107,2023-04-27,201,paneer,210,340,130,1,00218,India
766171,2023-04-27,204,strawberry yogurt,50,60,10,2,00018,India
264910,2023-04-27,213,bisleri,6,15,9,2,00404,India
838479,2023-04-27,209,pepsi,75,100,25,2,00309,India
838479,2023-04-27,211,red bull,90,125,35,2,00309,India
838479,2023-04-27,204,strawberry yogurt,50,60,10,2,00309,India
838479,2023-04-27,212,amul cheese,250,315,65,1,00309,India
785876,2023-04-27,210,mountain dew,75,100,25,2,00335,India
785876,2023-04-27,207,coca cola,75,100,25,2,00335,India
785876,2023-04-27,211,red bull,90,125,35,2,00335,India
785876,2023-04-27,202,milk,12,27,15,1,00335,India
212196,2023-04-27,207,coca cola,75,100,25,2,00350,India
212196,2023-04-27,213,bisleri,6,15,9,2,00350,India
212196,2023-04-27,212,amul cheese,250,315,65,1,00350,India
605328,2023-04-27,208,sprite,75,100,25,2,00316,India
405171,2023-04-27,201,paneer,210,340,130,1,00472,India
359739,2023-04-27,211,red bull,90,125,35,2,00082,India
359739,2023-04-27,206,yakult,360,400,40,2,00082,India
345329,2023-04-27,206,yakult,360,400,40,2,00399,India
345329,2023-04-27,202,milk,12,27,15,1,00399,India
345329,2023-04-27,210,mountain dew,75,100,25,2,00399,India
884897,2023-04-27,208,sprite,75,100,25,2,00041,India
884897,2023-04-27,204,strawberry yogurt,50,60,10,2,00041,India
884897,2023-04-27,210,mountain dew,75,100,25,2,00041,India
571213,2023-04-27,211,red bull,90,125,35,2,00056,India
424201,2023-04-27,213,bisleri,6,15,9,2,00444,India
424201,2023-04-27,208,sprite,75,100,25,2,00444,India
554418,2023-04-27,211,red bull,90,125,35,2,00059,India
554418,2023-04-27,207,coca cola,75,100,25,2,00059,India
446726,2023-04-27,201,paneer,210,340,130,1,00234,India
446726,2023-04-27,208,sprite,75,100,25,2,00234,India
446726,2023-04-27,211,red bull,90,125,35,2,00234,India
381794,2023-04-27,206,yakult,360,400,40,2,00466,India
381794,2023-04-27,208,sprite,75,100,25,2,00466,India
381794,2023-04-27,211,red bull,90,125,35,2,00466,India
381794,2023-04-27,213,bisleri,6,15,9,2,00466,India
381794,2023-04-27,202,milk,12,27,15,1,00466,India
409426,2023-04-27,212,amul cheese,250,315,65,1,00223,India
409426,2023-04-27,208,sprite,75,100,25,2,00223,India
409426,2023-04-27,202,milk,12,27,15,1,00223,India
748824,2023-04-27,201,paneer,210,340,130,1,00116,India
346091,2023-04-27,208,sprite,75,100,25,2,00211,India
346091,2023-04-27,206,yakult,360,400,40,2,00211,India
346091,2023-04-27,209,pepsi,75,100,25,2,00211,India
346091,2023-04-27,201,paneer,210,340,130,1,00211,India
385857,2023-04-27,205,classic yogurt,45,60,15,2,00105,India
385857,2023-04-27,209,pepsi,75,100,25,2,00105,India
385857,2023-04-27,210,mountain dew,75,100,25,2,00105,India
385857,2023-04-27,208,sprite,75,100,25,2,00105,India
385857,2023-04-27,202,milk,12,27,15,1,00105,India
629762,2023-04-27,204,strawberry yogurt,50,60,10,2,00031,India
629762,2023-04-27,210,mountain dew,75,100,25,2,00031,India
629762,2023-04-27,205,classic yogurt,45,60,15,2,00031,India
629762,2023-04-27,206,yakult,360,400,40,2,00031,India
445066,2023-04-27,208,sprite,75,100,25,2,00458,India
445066,2023-04-27,202,milk,12,27,15,1,00458,India
445066,2023-04-27,203,mango yogurt,50,60,10,2,00458,India
125979,2023-04-27,204,strawberry yogurt,50,60,10,2,00185,India
125979,2023-04-27,208,sprite,75,100,25,2,00185,India
750971,2023-04-27,212,amul cheese,250,315,65,1,00420,India
750971,2023-04-27,210,mountain dew,75,100,25,2,00420,India
805577,2023-04-27,208,sprite,75,100,25,2,00352,India
805577,2023-04-27,206,yakult,360,400,40,2,00352,India
805577,2023-04-27,202,milk,12,27,15,1,00352,India
926430,2023-04-27,201,paneer,210,340,130,1,00292,India
926430,2023-04-27,208,sprite,75,100,25,2,00292,India
926430,2023-04-27,205,classic yogurt,45,60,15,2,00292,India
926430,2023-04-27,212,amul cheese,250,315,65,1,00292,India
782896,2023-04-27,212,amul cheese,250,315,65,1,00216,India
782896,2023-04-27,213,bisleri,6,15,9,2,00216,India
782896,2023-04-27,204,strawberry yogurt,50,60,10,2,00216,India
782896,2023-04-27,210,mountain dew,75,100,25,2,00216,India
782896,2023-04-27,209,pepsi,75,100,25,2,00216,India
709954,2023-04-27,213,bisleri,6,15,9,2,00495,India
709954,2023-04-27,212,amul cheese,250,315,65,1,00495,India
974215,2023-04-27,203,mango yogurt,50,60,10,2,00380,India
968812,2023-04-27,202,milk,12,27,15,1,00063,India
109309,2023-04-27,208,sprite,75,100,25,2,00296,India
334351,2023-04-27,208,sprite,75,100,25,2,00039,India
334351,2023-04-27,204,strawberry yogurt,50,60,10,2,00039,India
334351,2023-04-27,209,pepsi,75,100,25,2,00039,India
334351,2023-04-27,205,classic yogurt,45,60,15,2,00039,India
169157,2023-04-27,204,strawberry yogurt,50,60,10,2,00103,India
169157,2023-04-27,209,pepsi,75,100,25,2,00103,India
169157,2023-04-27,213,bisleri,6,15,9,2,00103,India
438013,2023-04-27,202,milk,12,27,15,1,00041,India
438013,2023-04-27,212,amul cheese,250,315,65,1,00041,India
438013,2023-04-27,208,sprite,75,100,25,2,00041,India
991644,2023-04-27,210,mountain dew,75,100,25,2,00223,India
991644,2023-04-27,205,classic yogurt,45,60,15,2,00223,India
776743,2023-04-27,201,paneer,210,340,130,1,00166,India
776743,2023-04-27,202,milk,12,27,15,1,00166,India
914373,2023-04-27,210,mountain dew,75,100,25,2,00335,India
927971,2023-04-27,209,pepsi,75,100,25,2,00155,India
927971,2023-04-27,201,paneer,210,340,130,1,00155,India
551725,2023-04-27,202,milk,12,27,15,1,00254,India
551725,2023-04-27,206,yakult,360,400,40,2,00254,India
551725,2023-04-27,207,coca cola,75,100,25,2,00254,India
104447,2023-04-27,205,classic yogurt,45,60,15,2,00129,India
104447,2023-04-27,212,amul cheese,250,315,65,1,00129,India
104447,2023-04-27,206,yakult,360,400,40,2,00129,India
805954,2023-04-27,213,bisleri,6,15,9,2,00028,India
805954,2023-04-27,206,yakult,360,400,40,2,00028,India
805954,2023-04-27,203,mango yogurt,50,60,10,2,00028,India
805954,2023-04-27,211,red bull,90,125,35,2,00028,India
664058,2023-04-27,201,paneer,210,340,130,1,00337,India
664058,2023-04-27,207,coca cola,75,100,25,2,00337,India
664058,2023-04-27,211,red bull,90,125,35,2,00337,India
664058,2023-04-27,210,mountain dew,75,100,25,2,00337,India
180179,2023-04-27,202,milk,12,27,15,1,00188,India
633791,2023-04-27,208,sprite,75,100,25,2,00093,India
346526,2023-04-27,213,bisleri,6,15,9,2,00205,India
293316,2023-04-27,203,mango yogurt,50,60,10,2,00337,India
293316,2023-04-27,201,paneer,210,340,130,1,00337,India
293316,2023-04-27,207,coca cola,75,100,25,2,00337,India
293316,2023-04-27,211,red bull,90,125,35,2,00337,India
371132,2023-04-27,211,red bull,90,125,35,2,00138,India
371132,2023-04-27,212,amul cheese,250,315,65,1,00138,India
544257,2023-04-27,201,paneer,210,340,130,1,00382,India
506630,2023-04-27,201,paneer,210,340,130,1,00458,India
506630,2023-04-27,207,coca cola,75,100,25,2,00458,India
506630,2023-04-27,212,amul cheese,250,315,65,1,00458,India
506630,2023-04-27,210,mountain dew,75,100,25,2,00458,India
506630,2023-04-27,205,classic yogurt,45,60,15,2,00458,India
123130,2023-04-27,209,pepsi,75,100,25,2,00019,India
715470,2023-04-27,212,amul cheese,250,315,65,1,00432,India
715470,2023-04-27,205,classic yogurt,45,60,15,2,00432,India
715470,2023-04-27,210,mountain dew,75,100,25,2,00432,India
715470,2023-04-27,202,milk,12,27,15,1,00432,India
530307,2023-04-27,204,strawberry yogurt,50,60,10,2,00098,India
530307,2023-04-27,207,coca cola,75,100,25,2,00098,India
710792,2023-04-27,211,red bull,90,125,35,2,00471,India
710792,2023-04-27,212,amul cheese,250,315,65,1,00471,India
710792,2023-04-27,204,strawberry yogurt,50,60,10,2,00471,India
710792,2023-04-27,208,sprite,75,100,25,2,00471,India
710792,2023-04-27,210,mountain dew,75,100,25,2,00471,India
130492,2023-04-27,212,amul cheese,250,315,65,1,00225,India
130492,2023-04-27,204,strawberry yogurt,50,60,10,2,00225,India
130492,2023-04-27,211,red bull,90,125,35,2,00225,India
381917,2023-04-27,213,bisleri,6,15,9,2,00492,India
381917,2023-04-27,207,coca cola,75,100,25,2,00492,India
381917,2023-04-27,204,strawberry yogurt,50,60,10,2,00492,India
821630,2023-04-27,212,amul cheese,250,315,65,1,00484,India
821630,2023-04-27,207,coca cola,75,100,25,2,00484,India
821630,2023-04-27,206,yakult,360,400,40,2,00484,India
821630,2023-04-27,213,bisleri,6,15,9,2,00484,India
850061,2023-04-27,210,mountain dew,75,100,25,2,00161,India
850061,2023-04-27,212,amul cheese,250,315,65,1,00161,India
799832,2023-04-27,213,bisleri,6,15,9,2,00257,India
799832,2023-04-27,201,paneer,210,340,130,1,00257,India
734297,2023-04-27,201,paneer,210,340,130,1,00096,India
734297,2023-04-27,203,mango yogurt,50,60,10,2,00096,India
734297,2023-04-27,212,amul cheese,250,315,65,1,00096,India
183451,2023-04-27,210,mountain dew,75,100,25,2,00019,India
183451,2023-04-27,204,strawberry yogurt,50,60,10,2,00019,India
196365,2023-04-27,208,sprite,75,100,25,2,00048,India
196365,2023-04-27,203,mango yogurt,50,60,10,2,00048,India
196365,2023-04-27,210,mountain dew,75,100,25,2,00048,India
196365,2023-04-27,206,yakult,360,400,40,2,00048,India
196365,2023-04-27,204,strawberry yogurt,50,60,10,2,00048,India
111812,2023-04-27,201,paneer,210,340,130,1,00277,India
111812,2023-04-27,205,classic yogurt,45,60,15,2,00277,India
111812,2023-04-27,206,yakult,360,400,40,2,00277,India
111812,2023-04-27,208,sprite,75,100,25,2,00277,India
111812,2023-04-27,212,amul cheese,250,315,65,1,00277,India
502394,2023-04-27,205,classic yogurt,45,60,15,2,00300,India
502394,2023-04-27,202,milk,12,27,15,1,00300,India
502394,2023-04-27,203,mango yogurt,50,60,10,2,00300,India
804670,2023-04-27,208,sprite,75,100,25,2,00390,India
804670,2023-04-27,213,bisleri,6,15,9,2,00390,India
804670,2023-04-27,204,strawberry yogurt,50,60,10,2,00390,India
804670,2023-04-27,206,yakult,360,400,40,2,00390,India
447921,2023-04-27,210,mountain dew,75,100,25,2,00408,India
447921,2023-04-27,207,coca cola,75,100,25,2,00408,India
447921,2023-04-27,209,pepsi,75,100,25,2,00408,India
447921,2023-04-27,204,strawberry yogurt,50,60,10,2,00408,India
705790,2023-04-27,201,paneer,210,340,130,1,00103,India
705790,2023-04-27,205,classic yogurt,45,60,15,2,00103,India
705790,2023-04-27,207,coca cola,75,100,25,2,00103,India
705790,2023-04-27,208,sprite,75,100,25,2,00103,India
114033,2023-04-27,213,bisleri,6,15,9,2,00437,India
152196,2023-04-27,204,strawberry yogurt,50,60,10,2,00201,India
152196,2023-04-27,207,coca cola,75,100,25,2,00201,India
152196,2023-04-27,202,milk,12,27,15,1,00201,India
152196,2023-04-27,210,mountain dew,75,100,25,2,00201,India
838479,2023-04-27,207,coca cola,75,100,25,2,00309,India
838479,2023-04-27,206,yakult,360,400,40,2,00309,India
325387,2023-04-27,212,amul cheese,250,315,65,1,00377,India
325387,2023-04-27,211,red bull,90,125,35,2,00377,India
325387,2023-04-27,206,yakult,360,400,40,2,00377,India
325387,2023-04-27,213,bisleri,6,15,9,2,00377,India
149673,2023-04-27,204,strawberry yogurt,50,60,10,2,00209,India
149673,2023-04-27,211,red bull,90,125,35,2,00209,India
149673,2023-04-27,206,yakult,360,400,40,2,00209,India
365916,2023-04-27,202,milk,12,27,15,1,00394,India
365916,2023-04-27,209,pepsi,75,100,25,2,00394,India
365916,2023-04-27,203,mango yogurt,50,60,10,2,00394,India
365916,2023-04-27,205,classic yogurt,45,60,15,2,00394,India
970196,2023-04-27,212,amul cheese,250,315,65,1,00432,India
970196,2023-04-27,202,milk,12,27,15,1,00432,India
970196,2023-04-27,210,mountain dew,75,100,25,2,00432,India
970196,2023-04-27,211,red bull,90,125,35,2,00432,India
322245,2023-04-27,205,classic yogurt,45,60,15,2,00500,India
322245,2023-04-27,203,mango yogurt,50,60,10,2,00500,India
383364,2023-04-27,209,pepsi,75,100,25,2,00105,India
383364,2023-04-27,211,red bull,90,125,35,2,00105,India
383364,2023-04-27,213,bisleri,6,15,9,2,00105,India
383364,2023-04-27,207,coca cola,75,100,25,2,00105,India
706896,2023-04-27,211,red bull,90,125,35,2,00453,India
594458,2023-04-27,204,strawberry yogurt,50,60,10,2,00023,India
594458,2023-04-27,206,yakult,360,400,40,2,00023,India
594458,2023-04-27,209,pepsi,75,100,25,2,00023,India
594458,2023-04-27,208,sprite,75,100,25,2,00023,India
729990,2023-04-27,206,yakult,360,400,40,2,00049,India
729990,2023-04-27,210,mountain dew,75,100,25,2,00049,India
729990,2023-04-27,208,sprite,75,100,25,2,00049,India
433131,2023-04-27,206,yakult,360,400,40,2,00048,India
353740,2023-04-27,208,sprite,75,100,25,2,00144,India
353740,2023-04-27,201,paneer,210,340,130,1,00144,India
353740,2023-04-27,203,mango yogurt,50,60,10,2,00144,India
353740,2023-04-27,209,pepsi,75,100,25,2,00144,India
316498,2023-04-27,202,milk,12,27,15,1,00442,India
722819,2023-04-27,208,sprite,75,100,25,2,00101,India
722819,2023-04-27,206,yakult,360,400,40,2,00101,India
722819,2023-04-27,209,pepsi,75,100,25,2,00101,India
722819,2023-04-27,203,mango yogurt,50,60,10,2,00101,India
722819,2023-04-27,204,strawberry yogurt,50,60,10,2,00101,India
642714,2023-04-28,203,mango yogurt,50,60,10,2,00358,India
821920,2023-04-28,203,mango yogurt,50,60,10,2,00466,India
860018,2023-04-28,201,paneer,210,340,130,1,00462,India
860018,2023-04-28,204,strawberry yogurt,50,60,10,2,00462,India
860018,2023-04-28,202,milk,12,27,15,1,00462,India
860018,2023-04-28,211,red bull,90,125,35,2,00462,India
424281,2023-04-28,213,bisleri,6,15,9,2,00180,India
424281,2023-04-28,212,amul cheese,250,315,65,1,00180,India
424281,2023-04-28,205,classic yogurt,45,60,15,2,00180,India
876587,2023-04-28,203,mango yogurt,50,60,10,2,00483,India
188415,2023-04-28,201,paneer,210,340,130,1,00148,India
188415,2023-04-28,211,red bull,90,125,35,2,00148,India
188415,2023-04-28,205,classic yogurt,45,60,15,2,00148,India
188415,2023-04-28,206,yakult,360,400,40,2,00148,India
339277,2023-04-28,203,mango yogurt,50,60,10,2,00223,India
339277,2023-04-28,208,sprite,75,100,25,2,00223,India
385972,2023-04-28,209,pepsi,75,100,25,2,00390,India
572432,2023-04-28,206,yakult,360,400,40,2,00129,India
572432,2023-04-28,203,mango yogurt,50,60,10,2,00129,India
572432,2023-04-28,204,strawberry yogurt,50,60,10,2,00129,India
572432,2023-04-28,213,bisleri,6,15,9,2,00129,India
594597,2023-04-28,210,mountain dew,75,100,25,2,00165,India
594597,2023-04-28,201,paneer,210,340,130,1,00165,India
594597,2023-04-28,212,amul cheese,250,315,65,1,00165,India
594597,2023-04-28,211,red bull,90,125,35,2,00165,India
751828,2023-04-28,203,mango yogurt,50,60,10,2,00147,India
751828,2023-04-28,206,yakult,360,400,40,2,00147,India
751828,2023-04-28,204,strawberry yogurt,50,60,10,2,00147,India
751828,2023-04-28,209,pepsi,75,100,25,2,00147,India
806784,2023-04-28,210,mountain dew,75,100,25,2,00328,India
806784,2023-04-28,202,milk,12,27,15,1,00328,India
806784,2023-04-28,207,coca cola,75,100,25,2,00328,India
872911,2023-04-28,212,amul cheese,250,315,65,1,00096,India
749679,2023-04-28,201,paneer,210,340,130,1,00151,India
749679,2023-04-28,208,sprite,75,100,25,2,00151,India
749679,2023-04-28,209,pepsi,75,100,25,2,00151,India
749679,2023-04-28,206,yakult,360,400,40,2,00151,India
319813,2023-04-28,204,strawberry yogurt,50,60,10,2,00322,India
319813,2023-04-28,209,pepsi,75,100,25,2,00322,India
976289,2023-04-28,207,coca cola,75,100,25,2,00481,India
230193,2023-04-28,209,pepsi,75,100,25,2,00469,India
230193,2023-04-28,203,mango yogurt,50,60,10,2,00469,India
230193,2023-04-28,208,sprite,75,100,25,2,00469,India
247571,2023-04-28,209,pepsi,75,100,25,2,00344,India
247571,2023-04-28,204,strawberry yogurt,50,60,10,2,00344,India
247571,2023-04-28,213,bisleri,6,15,9,2,00344,India
323548,2023-04-28,209,pepsi,75,100,25,2,00075,India
323548,2023-04-28,201,paneer,210,340,130,1,00075,India
323548,2023-04-28,202,milk,12,27,15,1,00075,India
963391,2023-04-28,201,paneer,210,340,130,1,00444,India
963391,2023-04-28,212,amul cheese,250,315,65,1,00444,India
963391,2023-04-28,207,coca cola,75,100,25,2,00444,India
963391,2023-04-28,213,bisleri,6,15,9,2,00444,India
787602,2023-04-28,212,amul cheese,250,315,65,1,00146,India
787602,2023-04-28,209,pepsi,75,100,25,2,00146,India
787602,2023-04-28,205,classic yogurt,45,60,15,2,00146,India
637693,2023-04-28,206,yakult,360,400,40,2,00126,India
637693,2023-04-28,207,coca cola,75,100,25,2,00126,India
989999,2023-04-28,209,pepsi,75,100,25,2,00488,India
889992,2023-04-28,211,red bull,90,125,35,2,00377,India
889992,2023-04-28,210,mountain dew,75,100,25,2,00377,India
889992,2023-04-28,213,bisleri,6,15,9,2,00377,India
889992,2023-04-28,208,sprite,75,100,25,2,00377,India
889992,2023-04-28,204,strawberry yogurt,50,60,10,2,00377,India
510238,2023-04-28,204,strawberry yogurt,50,60,10,2,00322,India
573702,2023-04-28,205,classic yogurt,45,60,15,2,00130,India
573702,2023-04-28,209,pepsi,75,100,25,2,00130,India
573702,2023-04-28,210,mountain dew,75,100,25,2,00130,India
573702,2023-04-28,212,amul cheese,250,315,65,1,00130,India
573702,2023-04-28,207,coca cola,75,100,25,2,00130,India
929338,2023-04-28,213,bisleri,6,15,9,2,00033,India
395919,2023-04-28,212,amul cheese,250,315,65,1,00389,India
395919,2023-04-28,206,yakult,360,400,40,2,00389,India
395919,2023-04-28,207,coca cola,75,100,25,2,00389,India
395919,2023-04-28,204,strawberry yogurt,50,60,10,2,00389,India
395919,2023-04-28,203,mango yogurt,50,60,10,2,00389,India
560124,2023-04-28,203,mango yogurt,50,60,10,2,00437,India
753302,2023-04-28,201,paneer,210,340,130,1,00343,India
639032,2023-04-28,211,red bull,90,125,35,2,00154,India
639032,2023-04-28,206,yakult,360,400,40,2,00154,India
639032,2023-04-28,210,mountain dew,75,100,25,2,00154,India
639032,2023-04-28,202,milk,12,27,15,1,00154,India
131918,2023-04-28,208,sprite,75,100,25,2,00224,India
131918,2023-04-28,203,mango yogurt,50,60,10,2,00224,India
131918,2023-04-28,204,strawberry yogurt,50,60,10,2,00224,India
131918,2023-04-28,201,paneer,210,340,130,1,00224,India
356957,2023-04-28,211,red bull,90,125,35,2,00098,India
832465,2023-04-28,211,red bull,90,125,35,2,00446,India
832465,2023-04-28,201,paneer,210,340,130,1,00446,India
832465,2023-04-28,212,amul cheese,250,315,65,1,00446,India
832465,2023-04-28,203,mango yogurt,50,60,10,2,00446,India
832465,2023-04-28,202,milk,12,27,15,1,00446,India
494330,2023-04-28,207,coca cola,75,100,25,2,00438,India
494330,2023-04-28,206,yakult,360,400,40,2,00438,India
494330,2023-04-28,211,red bull,90,125,35,2,00438,India
283047,2023-04-28,213,bisleri,6,15,9,2,00227,India
461177,2023-04-28,205,classic yogurt,45,60,15,2,00015,India
461177,2023-04-28,211,red bull,90,125,35,2,00015,India
461177,2023-04-28,203,mango yogurt,50,60,10,2,00015,India
461177,2023-04-28,204,strawberry yogurt,50,60,10,2,00015,India
753899,2023-04-28,204,strawberry yogurt,50,60,10,2,00190,India
753899,2023-04-28,203,mango yogurt,50,60,10,2,00190,India
926266,2023-04-28,202,milk,12,27,15,1,00236,India
926266,2023-04-28,208,sprite,75,100,25,2,00236,India
926266,2023-04-28,201,paneer,210,340,130,1,00236,India
248920,2023-04-28,202,milk,12,27,15,1,00279,India
248920,2023-04-28,207,coca cola,75,100,25,2,00279,India
828802,2023-04-28,204,strawberry yogurt,50,60,10,2,00139,India
527813,2023-04-28,211,red bull,90,125,35,2,00396,India
527813,2023-04-28,202,milk,12,27,15,1,00396,India
527813,2023-04-28,203,mango yogurt,50,60,10,2,00396,India
527813,2023-04-28,208,sprite,75,100,25,2,00396,India
474512,2023-04-28,203,mango yogurt,50,60,10,2,00115,India
474512,2023-04-28,213,bisleri,6,15,9,2,00115,India
474512,2023-04-28,207,coca cola,75,100,25,2,00115,India
474512,2023-04-28,204,strawberry yogurt,50,60,10,2,00115,India
474512,2023-04-28,211,red bull,90,125,35,2,00115,India
538076,2023-04-28,201,paneer,210,340,130,1,00257,India
538076,2023-04-28,207,coca cola,75,100,25,2,00257,India
436090,2023-04-28,210,mountain dew,75,100,25,2,00020,India
436090,2023-04-28,211,red bull,90,125,35,2,00020,India
399527,2023-04-28,205,classic yogurt,45,60,15,2,00265,India
399527,2023-04-28,208,sprite,75,100,25,2,00265,India
399527,2023-04-28,201,paneer,210,340,130,1,00265,India
303862,2023-04-28,212,amul cheese,250,315,65,1,00426,India
303862,2023-04-28,207,coca cola,75,100,25,2,00426,India
889828,2023-04-28,213,bisleri,6,15,9,2,00468,India
889828,2023-04-28,201,paneer,210,340,130,1,00468,India
889828,2023-04-28,211,red bull,90,125,35,2,00468,India
889828,2023-04-28,209,pepsi,75,100,25,2,00468,India
385608,2023-04-28,201,paneer,210,340,130,1,00205,India
385608,2023-04-28,211,red bull,90,125,35,2,00205,India
872948,2023-04-28,210,mountain dew,75,100,25,2,00245,India
872948,2023-04-28,203,mango yogurt,50,60,10,2,00245,India
740348,2023-04-28,208,sprite,75,100,25,2,00036,India
570225,2023-04-29,204,strawberry yogurt,50,60,10,2,00001,India
570225,2023-04-29,210,mountain dew,75,100,25,2,00001,India
719894,2023-04-29,212,amul cheese,250,315,65,1,00093,India
719894,2023-04-29,203,mango yogurt,50,60,10,2,00093,India
719894,2023-04-29,202,milk,12,27,15,1,00093,India
910599,2023-04-29,208,sprite,75,100,25,2,00285,India
910599,2023-04-29,210,mountain dew,75,100,25,2,00285,India
823125,2023-04-29,202,milk,12,27,15,1,00062,India
823125,2023-04-29,207,coca cola,75,100,25,2,00062,India
823125,2023-04-29,209,pepsi,75,100,25,2,00062,India
627822,2023-04-29,206,yakult,360,400,40,2,00397,India
627822,2023-04-29,207,coca cola,75,100,25,2,00397,India
627822,2023-04-29,209,pepsi,75,100,25,2,00397,India
951066,2023-04-29,211,red bull,90,125,35,2,00392,India
951066,2023-04-29,202,milk,12,27,15,1,00392,India
951066,2023-04-29,205,classic yogurt,45,60,15,2,00392,India
951066,2023-04-29,204,strawberry yogurt,50,60,10,2,00392,India
951066,2023-04-29,212,amul cheese,250,315,65,1,00392,India
249770,2023-04-29,206,yakult,360,400,40,2,00482,India
507272,2023-04-29,206,yakult,360,400,40,2,00034,India
697332,2023-04-29,210,mountain dew,75,100,25,2,00417,India
697332,2023-04-29,207,coca cola,75,100,25,2,00417,India
697332,2023-04-29,204,strawberry yogurt,50,60,10,2,00417,India
502600,2023-04-29,213,bisleri,6,15,9,2,00493,India
262516,2023-04-29,210,mountain dew,75,100,25,2,00399,India
262516,2023-04-29,212,amul cheese,250,315,65,1,00399,India
262516,2023-04-29,211,red bull,90,125,35,2,00399,India
262516,2023-04-29,203,mango yogurt,50,60,10,2,00399,India
605925,2023-04-29,201,paneer,210,340,130,1,00421,India
605925,2023-04-29,210,mountain dew,75,100,25,2,00421,India
605925,2023-04-29,207,coca cola,75,100,25,2,00421,India
648599,2023-04-29,208,sprite,75,100,25,2,00192,India
648599,2023-04-29,209,pepsi,75,100,25,2,00192,India
648599,2023-04-29,203,mango yogurt,50,60,10,2,00192,India
648599,2023-04-29,204,strawberry yogurt,50,60,10,2,00192,India
877365,2023-04-29,209,pepsi,75,100,25,2,00383,India
877365,2023-04-29,213,bisleri,6,15,9,2,00383,India
877365,2023-04-29,206,yakult,360,400,40,2,00383,India
131689,2023-04-29,206,yakult,360,400,40,2,00492,India
131689,2023-04-29,210,mountain dew,75,100,25,2,00492,India
263472,2023-04-29,205,classic yogurt,45,60,15,2,00427,India
263472,2023-04-29,202,milk,12,27,15,1,00427,India
263472,2023-04-29,207,coca cola,75,100,25,2,00427,India
263472,2023-04-29,210,mountain dew,75,100,25,2,00427,India
326384,2023-04-29,204,strawberry yogurt,50,60,10,2,00180,India
326384,2023-04-29,211,red bull,90,125,35,2,00180,India
326384,2023-04-29,201,paneer,210,340,130,1,00180,India
326384,2023-04-29,206,yakult,360,400,40,2,00180,India
818057,2023-04-29,203,mango yogurt,50,60,10,2,00021,India
818057,2023-04-29,205,classic yogurt,45,60,15,2,00021,India
487025,2023-04-29,209,pepsi,75,100,25,2,00212,India
487025,2023-04-29,213,bisleri,6,15,9,2,00212,India
487025,2023-04-29,207,coca cola,75,100,25,2,00212,India
487025,2023-04-29,211,red bull,90,125,35,2,00212,India
807981,2023-04-29,208,sprite,75,100,25,2,00260,India
807981,2023-04-29,202,milk,12,27,15,1,00260,India
807981,2023-04-29,205,classic yogurt,45,60,15,2,00260,India
807981,2023-04-29,211,red bull,90,125,35,2,00260,India
906616,2023-04-29,208,sprite,75,100,25,2,00286,India
906616,2023-04-29,213,bisleri,6,15,9,2,00286,India
906616,2023-04-29,207,coca cola,75,100,25,2,00286,India
906616,2023-04-29,212,amul cheese,250,315,65,1,00286,India
649493,2023-04-29,207,coca cola,75,100,25,2,00306,India
649493,2023-04-29,203,mango yogurt,50,60,10,2,00306,India
269301,2023-04-29,211,red bull,90,125,35,2,00008,India
269301,2023-04-29,213,bisleri,6,15,9,2,00008,India
485550,2023-04-29,205,classic yogurt,45,60,15,2,00377,India
485550,2023-04-29,207,coca cola,75,100,25,2,00377,India
164378,2023-04-29,213,bisleri,6,15,9,2,00462,India
164378,2023-04-29,207,coca cola,75,100,25,2,00462,India
164378,2023-04-29,210,mountain dew,75,100,25,2,00462,India
164378,2023-04-29,208,sprite,75,100,25,2,00462,India
972159,2023-04-29,208,sprite,75,100,25,2,00411,India
449964,2023-04-29,202,milk,12,27,15,1,00085,India
449964,2023-04-29,210,mountain dew,75,100,25,2,00085,India
449964,2023-04-29,205,classic yogurt,45,60,15,2,00085,India
201808,2023-04-29,209,pepsi,75,100,25,2,00152,India
201808,2023-04-29,213,bisleri,6,15,9,2,00152,India
201808,2023-04-29,202,milk,12,27,15,1,00152,India
201808,2023-04-29,212,amul cheese,250,315,65,1,00152,India
201808,2023-04-29,207,coca cola,75,100,25,2,00152,India
203102,2023-04-29,209,pepsi,75,100,25,2,00088,India
203102,2023-04-29,204,strawberry yogurt,50,60,10,2,00088,India
203102,2023-04-29,210,mountain dew,75,100,25,2,00088,India
292127,2023-04-29,212,amul cheese,250,315,65,1,00174,India
292127,2023-04-29,210,mountain dew,75,100,25,2,00174,India
292127,2023-04-29,207,coca cola,75,100,25,2,00174,India
292127,2023-04-29,205,classic yogurt,45,60,15,2,00174,India
399198,2023-04-29,205,classic yogurt,45,60,15,2,00070,India
896875,2023-04-29,212,amul cheese,250,315,65,1,00094,India
701855,2023-04-29,209,pepsi,75,100,25,2,00264,India
701855,2023-04-29,201,paneer,210,340,130,1,00264,India
701855,2023-04-29,206,yakult,360,400,40,2,00264,India
701855,2023-04-29,202,milk,12,27,15,1,00264,India
701855,2023-04-29,213,bisleri,6,15,9,2,00264,India
265920,2023-04-29,204,strawberry yogurt,50,60,10,2,00077,India
351790,2023-04-29,210,mountain dew,75,100,25,2,00225,India
322149,2023-04-29,212,amul cheese,250,315,65,1,00353,India
322149,2023-04-29,202,milk,12,27,15,1,00353,India
286088,2023-04-29,204,strawberry yogurt,50,60,10,2,00189,India
286088,2023-04-29,209,pepsi,75,100,25,2,00189,India
286088,2023-04-29,212,amul cheese,250,315,65,1,00189,India
751660,2023-04-29,212,amul cheese,250,315,65,1,00232,India
751660,2023-04-29,211,red bull,90,125,35,2,00232,India
828182,2023-04-29,201,paneer,210,340,130,1,00424,India
843477,2023-04-29,202,milk,12,27,15,1,00150,India
843477,2023-04-29,209,pepsi,75,100,25,2,00150,India
843477,2023-04-29,203,mango yogurt,50,60,10,2,00150,India
843477,2023-04-29,201,paneer,210,340,130,1,00150,India
843477,2023-04-29,206,yakult,360,400,40,2,00150,India
543479,2023-04-29,205,classic yogurt,45,60,15,2,00103,India
543479,2023-04-29,211,red bull,90,125,35,2,00103,India
543479,2023-04-29,201,paneer,210,340,130,1,00103,India
543479,2023-04-29,204,strawberry yogurt,50,60,10,2,00103,India
516211,2023-04-29,201,paneer,210,340,130,1,00229,India
157682,2023-04-29,213,bisleri,6,15,9,2,00119,India
841933,2023-04-29,207,coca cola,75,100,25,2,00050,India
841933,2023-04-29,203,mango yogurt,50,60,10,2,00050,India
841933,2023-04-29,205,classic yogurt,45,60,15,2,00050,India
469451,2023-04-29,207,coca cola,75,100,25,2,00049,India
469451,2023-04-29,205,classic yogurt,45,60,15,2,00049,India
469451,2023-04-29,204,strawberry yogurt,50,60,10,2,00049,India
940037,2023-04-29,212,amul cheese,250,315,65,1,00396,India
940037,2023-04-29,210,mountain dew,75,100,25,2,00396,India
940037,2023-04-29,205,classic yogurt,45,60,15,2,00396,India
940037,2023-04-29,208,sprite,75,100,25,2,00396,India
940037,2023-04-29,204,strawberry yogurt,50,60,10,2,00396,India
379332,2023-04-29,213,bisleri,6,15,9,2,00029,India
463961,2023-04-29,212,amul cheese,250,315,65,1,00198,India
463961,2023-04-29,203,mango yogurt,50,60,10,2,00198,India
463961,2023-04-29,206,yakult,360,400,40,2,00198,India
463961,2023-04-29,207,coca cola,75,100,25,2,00198,India
176140,2023-04-29,213,bisleri,6,15,9,2,00265,India
176140,2023-04-29,201,paneer,210,340,130,1,00265,India
176140,2023-04-29,210,mountain dew,75,100,25,2,00265,India
176140,2023-04-29,209,pepsi,75,100,25,2,00265,India
665015,2023-04-29,203,mango yogurt,50,60,10,2,00293,India
837006,2023-04-29,203,mango yogurt,50,60,10,2,00456,India
837006,2023-04-29,208,sprite,75,100,25,2,00456,India
574298,2023-04-29,210,mountain dew,75,100,25,2,00062,India
574298,2023-04-29,212,amul cheese,250,315,65,1,00062,India
306546,2023-04-29,211,red bull,90,125,35,2,00341,India
306546,2023-04-29,212,amul cheese,250,315,65,1,00341,India
468335,2023-04-29,208,sprite,75,100,25,2,00083,India
468335,2023-04-29,210,mountain dew,75,100,25,2,00083,India
468335,2023-04-29,209,pepsi,75,100,25,2,00083,India
468335,2023-04-29,202,milk,12,27,15,1,00083,India
371164,2023-04-29,201,paneer,210,340,130,1,00083,India
324972,2023-04-29,213,bisleri,6,15,9,2,00149,India
324972,2023-04-29,212,amul cheese,250,315,65,1,00149,India
324972,2023-04-29,207,coca cola,75,100,25,2,00149,India
254182,2023-04-29,213,bisleri,6,15,9,2,00350,India
254182,2023-04-29,209,pepsi,75,100,25,2,00350,India
254182,2023-04-29,207,coca cola,75,100,25,2,00350,India
320945,2023-04-29,208,sprite,75,100,25,2,00034,India
320945,2023-04-29,209,pepsi,75,100,25,2,00034,India
320945,2023-04-29,204,strawberry yogurt,50,60,10,2,00034,India
148904,2023-04-29,203,mango yogurt,50,60,10,2,00150,India
148904,2023-04-29,211,red bull,90,125,35,2,00150,India
148904,2023-04-29,204,strawberry yogurt,50,60,10,2,00150,India
148904,2023-04-29,207,coca cola,75,100,25,2,00150,India
129235,2023-04-29,207,coca cola,75,100,25,2,00015,India
589117,2023-04-30,207,coca cola,75,100,25,2,00220,India
589117,2023-04-30,213,bisleri,6,15,9,2,00220,India
589117,2023-04-30,204,strawberry yogurt,50,60,10,2,00220,India
589117,2023-04-30,211,red bull,90,125,35,2,00220,India
589117,2023-04-30,210,mountain dew,75,100,25,2,00220,India
620064,2023-04-30,201,paneer,210,340,130,1,00245,India
620064,2023-04-30,210,mountain dew,75,100,25,2,00245,India
620064,2023-04-30,208,sprite,75,100,25,2,00245,India
620064,2023-04-30,207,coca cola,75,100,25,2,00245,India
320719,2023-04-30,203,mango yogurt,50,60,10,2,00026,India
320719,2023-04-30,207,coca cola,75,100,25,2,00026,India
320719,2023-04-30,210,mountain dew,75,100,25,2,00026,India
804102,2023-04-30,202,milk,12,27,15,1,00386,India
804102,2023-04-30,203,mango yogurt,50,60,10,2,00386,India
804102,2023-04-30,211,red bull,90,125,35,2,00386,India
804102,2023-04-30,206,yakult,360,400,40,2,00386,India
804102,2023-04-30,209,pepsi,75,100,25,2,00386,India
987586,2023-04-30,201,paneer,210,340,130,1,00375,India
987586,2023-04-30,207,coca cola,75,100,25,2,00375,India
987586,2023-04-30,210,mountain dew,75,100,25,2,00375,India
772267,2023-04-30,211,red bull,90,125,35,2,00049,India
772267,2023-04-30,207,coca cola,75,100,25,2,00049,India
772267,2023-04-30,203,mango yogurt,50,60,10,2,00049,India
716825,2023-04-30,211,red bull,90,125,35,2,00224,India
525241,2023-04-30,210,mountain dew,75,100,25,2,00469,India
525241,2023-04-30,207,coca cola,75,100,25,2,00469,India
811066,2023-04-30,208,sprite,75,100,25,2,00073,India
811066,2023-04-30,201,paneer,210,340,130,1,00073,India
569090,2023-04-30,201,paneer,210,340,130,1,00164,India
637333,2023-04-30,211,red bull,90,125,35,2,00140,India
637333,2023-04-30,206,yakult,360,400,40,2,00140,India
637333,2023-04-30,210,mountain dew,75,100,25,2,00140,India
417972,2023-04-30,201,paneer,210,340,130,1,00473,India
417972,2023-04-30,209,pepsi,75,100,25,2,00473,India
936686,2023-04-30,208,sprite,75,100,25,2,00131,India
936686,2023-04-30,207,coca cola,75,100,25,2,00131,India
740385,2023-04-30,207,coca cola,75,100,25,2,00376,India
740385,2023-04-30,203,mango yogurt,50,60,10,2,00376,India
740385,2023-04-30,201,paneer,210,340,130,1,00376,India
775996,2023-04-30,209,pepsi,75,100,25,2,00073,India
775996,2023-04-30,204,strawberry yogurt,50,60,10,2,00073,India
775996,2023-04-30,208,sprite,75,100,25,2,00073,India
704123,2023-04-30,211,red bull,90,125,35,2,00111,India
704123,2023-04-30,204,strawberry yogurt,50,60,10,2,00111,India
704123,2023-04-30,201,paneer,210,340,130,1,00111,India
262881,2023-04-30,210,mountain dew,75,100,25,2,00086,India
262881,2023-04-30,211,red bull,90,125,35,2,00086,India
127140,2023-04-30,205,classic yogurt,45,60,15,2,00071,India
127140,2023-04-30,206,yakult,360,400,40,2,00071,India
871394,2023-04-30,213,bisleri,6,15,9,2,00143,India
871394,2023-04-30,212,amul cheese,250,315,65,1,00143,India
871394,2023-04-30,206,yakult,360,400,40,2,00143,India
871394,2023-04-30,209,pepsi,75,100,25,2,00143,India
976824,2023-04-30,204,strawberry yogurt,50,60,10,2,00031,India
976824,2023-04-30,211,red bull,90,125,35,2,00031,India
976824,2023-04-30,202,milk,12,27,15,1,00031,India
726616,2023-04-30,212,amul cheese,250,315,65,1,00299,India
726616,2023-04-30,208,sprite,75,100,25,2,00299,India
747795,2023-04-30,213,bisleri,6,15,9,2,00102,India
747795,2023-04-30,205,classic yogurt,45,60,15,2,00102,India
747795,2023-04-30,203,mango yogurt,50,60,10,2,00102,India
747795,2023-04-30,211,red bull,90,125,35,2,00102,India
747795,2023-04-30,202,milk,12,27,15,1,00102,India
149015,2023-04-30,213,bisleri,6,15,9,2,00113,India
226307,2023-04-30,212,amul cheese,250,315,65,1,00005,India
226307,2023-04-30,213,bisleri,6,15,9,2,00005,India
568013,2023-04-30,209,pepsi,75,100,25,2,00364,India
466925,2023-04-30,205,classic yogurt,45,60,15,2,00371,India
466925,2023-04-30,213,bisleri,6,15,9,2,00371,India
855430,2023-04-30,208,sprite,75,100,25,2,00160,India
855430,2023-04-30,203,mango yogurt,50,60,10,2,00160,India
855430,2023-04-30,205,classic yogurt,45,60,15,2,00160,India
132199,2023-04-30,204,strawberry yogurt,50,60,10,2,00349,India
926591,2023-04-30,213,bisleri,6,15,9,2,00102,India
926591,2023-04-30,208,sprite,75,100,25,2,00102,India
926591,2023-04-30,209,pepsi,75,100,25,2,00102,India
878151,2023-04-30,201,paneer,210,340,130,1,00218,India
878151,2023-04-30,203,mango yogurt,50,60,10,2,00218,India
622889,2023-04-30,209,pepsi,75,100,25,2,00476,India
622889,2023-04-30,207,coca cola,75,100,25,2,00476,India
622889,2023-04-30,204,strawberry yogurt,50,60,10,2,00476,India
364091,2023-04-30,205,classic yogurt,45,60,15,2,00427,India
364091,2023-04-30,209,pepsi,75,100,25,2,00427,India
299185,2023-04-30,210,mountain dew,75,100,25,2,00392,India
299185,2023-04-30,204,strawberry yogurt,50,60,10,2,00392,India
299185,2023-04-30,213,bisleri,6,15,9,2,00392,India
222894,2023-04-30,212,amul cheese,250,315,65,1,00114,India
222894,2023-04-30,209,pepsi,75,100,25,2,00114,India
294393,2023-04-30,209,pepsi,75,100,25,2,00200,India
294393,2023-04-30,213,bisleri,6,15,9,2,00200,India
294393,2023-04-30,204,strawberry yogurt,50,60,10,2,00200,India
225217,2023-04-30,211,red bull,90,125,35,2,00176,India
225217,2023-04-30,209,pepsi,75,100,25,2,00176,India
376463,2023-04-30,212,amul cheese,250,315,65,1,00442,India
376463,2023-04-30,211,red bull,90,125,35,2,00442,India
376463,2023-04-30,213,bisleri,6,15,9,2,00442,India
785832,2023-04-30,208,sprite,75,100,25,2,00008,India
930059,2023-04-30,209,pepsi,75,100,25,2,00378,India
949744,2023-04-30,211,red bull,90,125,35,2,00389,India
949744,2023-04-30,209,pepsi,75,100,25,2,00389,India
523451,2023-04-30,206,yakult,360,400,40,2,00355,India
523451,2023-04-30,201,paneer,210,340,130,1,00355,India
523451,2023-04-30,204,strawberry yogurt,50,60,10,2,00355,India
523451,2023-04-30,208,sprite,75,100,25,2,00355,India
523451,2023-04-30,202,milk,12,27,15,1,00355,India
561472,2023-04-30,203,mango yogurt,50,60,10,2,00445,India
561472,2023-04-30,206,yakult,360,400,40,2,00445,India
561472,2023-04-30,208,sprite,75,100,25,2,00445,India
616218,2023-04-30,208,sprite,75,100,25,2,00046,India
206058,2023-04-30,207,coca cola,75,100,25,2,00180,India
206058,2023-04-30,210,mountain dew,75,100,25,2,00180,India
645700,2023-04-30,206,yakult,360,400,40,2,00127,India
645700,2023-04-30,211,red bull,90,125,35,2,00127,India
645700,2023-04-30,213,bisleri,6,15,9,2,00127,India
582829,2023-04-30,206,yakult,360,400,40,2,00269,India
582829,2023-04-30,211,red bull,90,125,35,2,00269,India
582829,2023-04-30,204,strawberry yogurt,50,60,10,2,00269,India
621106,2023-04-30,203,mango yogurt,50,60,10,2,00166,India
794172,2023-04-30,207,coca cola,75,100,25,2,00296,India
179613,2023-04-30,206,yakult,360,400,40,2,00151,India
179613,2023-04-30,212,amul cheese,250,315,65,1,00151,India
179613,2023-04-30,202,milk,12,27,15,1,00151,India
179613,2023-04-30,208,sprite,75,100,25,2,00151,India
173805,2023-04-30,209,pepsi,75,100,25,2,00105,India
173805,2023-04-30,210,mountain dew,75,100,25,2,00105,India
586430,2023-04-30,212,amul cheese,250,315,65,1,00472,India
586430,2023-04-30,201,paneer,210,340,130,1,00472,India
586430,2023-04-30,209,pepsi,75,100,25,2,00472,India
586430,2023-04-30,204,strawberry yogurt,50,60,10,2,00472,India
935601,2023-04-30,209,pepsi,75,100,25,2,00216,India
935601,2023-04-30,213,bisleri,6,15,9,2,00216,India
935601,2023-04-30,208,sprite,75,100,25,2,00216,India
935601,2023-04-30,210,mountain dew,75,100,25,2,00216,India
705068,2023-04-30,210,mountain dew,75,100,25,2,00313,India
705068,2023-04-30,201,paneer,210,340,130,1,00313,India
705068,2023-04-30,207,coca cola,75,100,25,2,00313,India
257526,2023-04-30,207,coca cola,75,100,25,2,00114,India
687361,2023-04-30,206,yakult,360,400,40,2,00465,India
832031,2023-04-30,213,bisleri,6,15,9,2,00237,India
832031,2023-04-30,210,mountain dew,75,100,25,2,00237,India
874201,2023-04-30,201,paneer,210,340,130,1,00338,India
306054,2023-04-30,211,red bull,90,125,35,2,00119,India
515460,2023-04-30,205,classic yogurt,45,60,15,2,00189,India
515460,2023-04-30,212,amul cheese,250,315,65,1,00189,India
515460,2023-04-30,207,coca cola,75,100,25,2,00189,India
767348,2023-04-30,205,classic yogurt,45,60,15,2,00193,India
767348,2023-04-30,206,yakult,360,400,40,2,00193,India
767348,2023-04-30,204,strawberry yogurt,50,60,10,2,00193,India
708266,2023-04-30,201,paneer,210,340,130,1,00204,India
708266,2023-04-30,204,strawberry yogurt,50,60,10,2,00204,India
708266,2023-04-30,203,mango yogurt,50,60,10,2,00204,India
708266,2023-04-30,212,amul cheese,250,315,65,1,00204,India
663006,2023-04-30,206,yakult,360,400,40,2,00438,India
663006,2023-04-30,204,strawberry yogurt,50,60,10,2,00438,India
738898,2023-04-30,202,milk,12,27,15,1,00460,India
611603,2023-04-30,202,milk,12,27,15,1,00018,India
611603,2023-04-30,211,red bull,90,125,35,2,00018,India
611603,2023-04-30,207,coca cola,75,100,25,2,00018,India
554758,2023-04-30,205,classic yogurt,45,60,15,2,00248,India
554758,2023-04-30,201,paneer,210,340,130,1,00248,India
554758,2023-04-30,207,coca cola,75,100,25,2,00248,India
554758,2023-04-30,208,sprite,75,100,25,2,00248,India
554758,2023-04-30,211,red bull,90,125,35,2,00248,India
789573,2023-04-30,207,coca cola,75,100,25,2,00386,India
789573,2023-04-30,210,mountain dew,75,100,25,2,00386,India
789573,2023-04-30,212,amul cheese,250,315,65,1,00386,India
369495,2023-04-30,204,strawberry yogurt,50,60,10,2,00244,India
369495,2023-04-30,203,mango yogurt,50,60,10,2,00244,India
369495,2023-04-30,209,pepsi,75,100,25,2,00244,India
369495,2023-04-30,206,yakult,360,400,40,2,00244,India
439327,2023-04-30,213,bisleri,6,15,9,2,00448,India
439327,2023-04-30,210,mountain dew,75,100,25,2,00448,India
439327,2023-04-30,202,milk,12,27,15,1,00448,India
625654,2023-04-30,208,sprite,75,100,25,2,00384,India
625654,2023-04-30,209,pepsi,75,100,25,2,00384,India
625654,2023-04-30,211,red bull,90,125,35,2,00384,India
625654,2023-04-30,210,mountain dew,75,100,25,2,00384,India
766673,2023-04-30,204,strawberry yogurt,50,60,10,2,00345,India
766673,2023-04-30,201,paneer,210,340,130,1,00345,India
783205,2023-04-30,204,strawberry yogurt,50,60,10,2,00469,India
783205,2023-04-30,209,pepsi,75,100,25,2,00469,India
783205,2023-04-30,208,sprite,75,100,25,2,00469,India
783205,2023-04-30,205,classic yogurt,45,60,15,2,00469,India
856551,2023-04-30,202,milk,12,27,15,1,00025,India
698591,2023-04-30,201,paneer,210,340,130,1,00461,India
698591,2023-04-30,212,amul cheese,250,315,65,1,00461,India
698591,2023-04-30,211,red bull,90,125,35,2,00461,India
804125,2023-04-30,202,milk,12,27,15,1,00004,India
804125,2023-04-30,204,strawberry yogurt,50,60,10,2,00004,India
804125,2023-04-30,209,pepsi,75,100,25,2,00004,India
804125,2023-04-30,207,coca cola,75,100,25,2,00004,India
429140,2023-04-30,211,red bull,90,125,35,2,00222,India
429140,2023-04-30,201,paneer,210,340,130,1,00222,India
182642,2023-04-30,201,paneer,210,340,130,1,00464,India
182642,2023-04-30,202,milk,12,27,15,1,00464,India
739986,2023-04-30,203,mango yogurt,50,60,10,2,00482,India
739986,2023-04-30,202,milk,12,27,15,1,00482,India
739986,2023-04-30,212,amul cheese,250,315,65,1,00482,India
739986,2023-04-30,210,mountain dew,75,100,25,2,00482,India
536509,2023-04-30,208,sprite,75,100,25,2,00211,India
305544,2023-04-30,203,mango yogurt,50,60,10,2,00382,India
305544,2023-04-30,207,coca cola,75,100,25,2,00382,India
570736,2023-04-30,202,milk,12,27,15,1,00401,India
570736,2023-04-30,201,paneer,210,340,130,1,00401,India
570736,2023-04-30,207,coca cola,75,100,25,2,00401,India
570736,2023-04-30,206,yakult,360,400,40,2,00401,India
570736,2023-04-30,208,sprite,75,100,25,2,00401,India
355610,2023-04-30,212,amul cheese,250,315,65,1,00422,India
355610,2023-04-30,205,classic yogurt,45,60,15,2,00422,India
541080,2023-04-30,204,strawberry yogurt,50,60,10,2,00022,India
541080,2023-04-30,213,bisleri,6,15,9,2,00022,India
987718,2023-04-30,208,sprite,75,100,25,2,00485,India
987718,2023-04-30,210,mountain dew,75,100,25,2,00485,India
987718,2023-04-30,206,yakult,360,400,40,2,00485,India
626995,2023-04-30,204,strawberry yogurt,50,60,10,2,00389,India
626995,2023-04-30,201,paneer,210,340,130,1,00389,India
626995,2023-04-30,210,mountain dew,75,100,25,2,00389,India
626995,2023-04-30,205,classic yogurt,45,60,15,2,00389,India
270239,2023-04-30,206,yakult,360,400,40,2,00123,India
604157,2023-04-30,213,bisleri,6,15,9,2,00413,India
604157,2023-04-30,207,coca cola,75,100,25,2,00413,India
604157,2023-04-30,210,mountain dew,75,100,25,2,00413,India
549168,2023-04-30,212,amul cheese,250,315,65,1,00426,India
549168,2023-04-30,211,red bull,90,125,35,2,00426,India
549168,2023-04-30,209,pepsi,75,100,25,2,00426,India
347485,2023-04-30,211,red bull,90,125,35,2,00195,India
836132,2023-04-30,211,red bull,90,125,35,2,00344,India
836132,2023-04-30,205,classic yogurt,45,60,15,2,00344,India
836132,2023-04-30,210,mountain dew,75,100,25,2,00344,India
836132,2023-04-30,209,pepsi,75,100,25,2,00344,India
904994,2023-05-01,211,red bull,90,125,35,2,00004,India
904994,2023-05-01,209,pepsi,75,100,25,2,00004,India
769670,2023-05-01,206,yakult,360,400,40,2,00372,India
769670,2023-05-01,211,red bull,90,125,35,2,00372,India
769670,2023-05-01,209,pepsi,75,100,25,2,00372,India
922056,2023-05-01,201,paneer,210,340,130,1,00416,India
922056,2023-05-01,206,yakult,360,400,40,2,00416,India
180155,2023-05-01,210,mountain dew,75,100,25,2,00373,India
180155,2023-05-01,201,paneer,210,340,130,1,00373,India
392238,2023-05-01,209,pepsi,75,100,25,2,00264,India
768431,2023-05-01,202,milk,12,27,15,1,00059,India
768431,2023-05-01,205,classic yogurt,45,60,15,2,00059,India
768431,2023-05-01,213,bisleri,6,15,9,2,00059,India
768431,2023-05-01,209,pepsi,75,100,25,2,00059,India
630143,2023-05-01,204,strawberry yogurt,50,60,10,2,00314,India
534366,2023-05-01,210,mountain dew,75,100,25,2,00144,India
534366,2023-05-01,201,paneer,210,340,130,1,00144,India
784736,2023-05-01,213,bisleri,6,15,9,2,00258,India
784736,2023-05-01,208,sprite,75,100,25,2,00258,India
784736,2023-05-01,202,milk,12,27,15,1,00258,India
784736,2023-05-01,212,amul cheese,250,315,65,1,00258,India
409083,2023-05-01,211,red bull,90,125,35,2,00327,India
409083,2023-05-01,202,milk,12,27,15,1,00327,India
409083,2023-05-01,208,sprite,75,100,25,2,00327,India
409083,2023-05-01,201,paneer,210,340,130,1,00327,India
727034,2023-05-01,207,coca cola,75,100,25,2,00277,India
727034,2023-05-01,213,bisleri,6,15,9,2,00277,India
727034,2023-05-01,212,amul cheese,250,315,65,1,00277,India
727034,2023-05-01,206,yakult,360,400,40,2,00277,India
727613,2023-05-01,211,red bull,90,125,35,2,00184,India
727613,2023-05-01,210,mountain dew,75,100,25,2,00184,India
727613,2023-05-01,205,classic yogurt,45,60,15,2,00184,India
341630,2023-05-01,203,mango yogurt,50,60,10,2,00222,India
341630,2023-05-01,202,milk,12,27,15,1,00222,India
341630,2023-05-01,204,strawberry yogurt,50,60,10,2,00222,India
341630,2023-05-01,206,yakult,360,400,40,2,00222,India
156016,2023-05-01,204,strawberry yogurt,50,60,10,2,00322,India
156016,2023-05-01,203,mango yogurt,50,60,10,2,00322,India
156016,2023-05-01,211,red bull,90,125,35,2,00322,India
622916,2023-05-01,206,yakult,360,400,40,2,00356,India
622916,2023-05-01,204,strawberry yogurt,50,60,10,2,00356,India
622916,2023-05-01,207,coca cola,75,100,25,2,00356,India
622916,2023-05-01,213,bisleri,6,15,9,2,00356,India
622916,2023-05-01,208,sprite,75,100,25,2,00356,India
890040,2023-05-01,204,strawberry yogurt,50,60,10,2,00032,India
890040,2023-05-01,205,classic yogurt,45,60,15,2,00032,India
890040,2023-05-01,212,amul cheese,250,315,65,1,00032,India
872849,2023-05-01,206,yakult,360,400,40,2,00496,India
872849,2023-05-01,207,coca cola,75,100,25,2,00496,India
872849,2023-05-01,201,paneer,210,340,130,1,00496,India
845513,2023-05-01,205,classic yogurt,45,60,15,2,00045,India
845513,2023-05-01,202,milk,12,27,15,1,00045,India
917401,2023-05-01,211,red bull,90,125,35,2,00324,India
917401,2023-05-01,212,amul cheese,250,315,65,1,00324,India
917401,2023-05-01,201,paneer,210,340,130,1,00324,India
917401,2023-05-01,210,mountain dew,75,100,25,2,00324,India
374759,2023-05-01,209,pepsi,75,100,25,2,00017,India
374759,2023-05-01,204,strawberry yogurt,50,60,10,2,00017,India
681796,2023-05-01,209,pepsi,75,100,25,2,00189,India
681796,2023-05-01,202,milk,12,27,15,1,00189,India
681796,2023-05-01,213,bisleri,6,15,9,2,00189,India
681796,2023-05-01,206,yakult,360,400,40,2,00189,India
968694,2023-05-01,211,red bull,90,125,35,2,00059,India
968694,2023-05-01,208,sprite,75,100,25,2,00059,India
968694,2023-05-01,210,mountain dew,75,100,25,2,00059,India
205607,2023-05-01,212,amul cheese,250,315,65,1,00484,India
205607,2023-05-01,210,mountain dew,75,100,25,2,00484,India
205607,2023-05-01,209,pepsi,75,100,25,2,00484,India
205607,2023-05-01,205,classic yogurt,45,60,15,2,00484,India
642129,2023-05-01,205,classic yogurt,45,60,15,2,00485,India
642129,2023-05-01,207,coca cola,75,100,25,2,00485,India
324895,2023-05-01,213,bisleri,6,15,9,2,00031,India
324895,2023-05-01,210,mountain dew,75,100,25,2,00031,India
324895,2023-05-01,201,paneer,210,340,130,1,00031,India
324895,2023-05-01,209,pepsi,75,100,25,2,00031,India
245460,2023-05-01,201,paneer,210,340,130,1,00102,India
245460,2023-05-01,208,sprite,75,100,25,2,00102,India
245460,2023-05-01,204,strawberry yogurt,50,60,10,2,00102,India
245460,2023-05-01,212,amul cheese,250,315,65,1,00102,India
418413,2023-05-01,210,mountain dew,75,100,25,2,00361,India
478701,2023-05-01,203,mango yogurt,50,60,10,2,00042,India
478701,2023-05-01,204,strawberry yogurt,50,60,10,2,00042,India
352816,2023-05-01,204,strawberry yogurt,50,60,10,2,00228,India
807898,2023-05-01,210,mountain dew,75,100,25,2,00296,India
976773,2023-05-01,211,red bull,90,125,35,2,00281,India
976773,2023-05-01,203,mango yogurt,50,60,10,2,00281,India
976773,2023-05-01,209,pepsi,75,100,25,2,00281,India
976773,2023-05-01,201,paneer,210,340,130,1,00281,India
909693,2023-05-01,208,sprite,75,100,25,2,00131,India
465764,2023-05-01,202,milk,12,27,15,1,00392,India
465764,2023-05-01,207,coca cola,75,100,25,2,00392,India
465764,2023-05-01,201,paneer,210,340,130,1,00392,India
465764,2023-05-01,205,classic yogurt,45,60,15,2,00392,India
587814,2023-05-01,211,red bull,90,125,35,2,00085,India
928266,2023-05-01,203,mango yogurt,50,60,10,2,00339,India
928266,2023-05-01,210,mountain dew,75,100,25,2,00339,India
928266,2023-05-01,207,coca cola,75,100,25,2,00339,India
928266,2023-05-01,211,red bull,90,125,35,2,00339,India
929737,2023-05-01,203,mango yogurt,50,60,10,2,00148,India
711785,2023-05-01,202,milk,12,27,15,1,00480,India
711785,2023-05-01,207,coca cola,75,100,25,2,00480,India
711785,2023-05-01,203,mango yogurt,50,60,10,2,00480,India
711785,2023-05-01,208,sprite,75,100,25,2,00480,India
443218,2023-05-01,203,mango yogurt,50,60,10,2,00233,India
443218,2023-05-01,210,mountain dew,75,100,25,2,00233,India
443218,2023-05-01,201,paneer,210,340,130,1,00233,India
326765,2023-05-01,206,yakult,360,400,40,2,00363,India
823291,2023-05-01,211,red bull,90,125,35,2,00084,India
823291,2023-05-01,206,yakult,360,400,40,2,00084,India
272974,2023-05-01,212,amul cheese,250,315,65,1,00248,India
272974,2023-05-01,203,mango yogurt,50,60,10,2,00248,India
272974,2023-05-01,204,strawberry yogurt,50,60,10,2,00248,India
272974,2023-05-01,201,paneer,210,340,130,1,00248,India
272974,2023-05-01,209,pepsi,75,100,25,2,00248,India
151240,2023-05-01,207,coca cola,75,100,25,2,00226,India
151240,2023-05-01,206,yakult,360,400,40,2,00226,India
151240,2023-05-01,213,bisleri,6,15,9,2,00226,India
692325,2023-05-01,205,classic yogurt,45,60,15,2,00237,India
692325,2023-05-01,203,mango yogurt,50,60,10,2,00237,India
692325,2023-05-01,212,amul cheese,250,315,65,1,00237,India
405741,2023-05-01,202,milk,12,27,15,1,00250,India
405741,2023-05-01,206,yakult,360,400,40,2,00250,India
810930,2023-05-01,202,milk,12,27,15,1,00101,India
810930,2023-05-01,203,mango yogurt,50,60,10,2,00101,India
810930,2023-05-01,201,paneer,210,340,130,1,00101,India
809936,2023-05-01,206,yakult,360,400,40,2,00365,India
809936,2023-05-01,201,paneer,210,340,130,1,00365,India
814356,2023-05-01,202,milk,12,27,15,1,00137,India
814356,2023-05-01,205,classic yogurt,45,60,15,2,00137,India
814356,2023-05-01,213,bisleri,6,15,9,2,00137,India
814356,2023-05-01,206,yakult,360,400,40,2,00137,India
814356,2023-05-01,211,red bull,90,125,35,2,00137,India
304091,2023-05-01,212,amul cheese,250,315,65,1,00440,India
211170,2023-05-01,204,strawberry yogurt,50,60,10,2,00067,India
211170,2023-05-01,207,coca cola,75,100,25,2,00067,India
635845,2023-05-01,202,milk,12,27,15,1,00079,India
635845,2023-05-01,213,bisleri,6,15,9,2,00079,India
640336,2023-05-01,208,sprite,75,100,25,2,00354,India
640336,2023-05-01,213,bisleri,6,15,9,2,00354,India
640336,2023-05-01,209,pepsi,75,100,25,2,00354,India
640336,2023-05-01,212,amul cheese,250,315,65,1,00354,India
159668,2023-05-01,205,classic yogurt,45,60,15,2,00354,India
371812,2023-05-01,213,bisleri,6,15,9,2,00124,India
371812,2023-05-01,211,red bull,90,125,35,2,00124,India
558030,2023-05-01,202,milk,12,27,15,1,00390,India
558030,2023-05-01,210,mountain dew,75,100,25,2,00390,India
558030,2023-05-01,209,pepsi,75,100,25,2,00390,India
758339,2023-05-01,213,bisleri,6,15,9,2,00059,India
758339,2023-05-01,208,sprite,75,100,25,2,00059,India
758339,2023-05-01,202,milk,12,27,15,1,00059,India
758339,2023-05-01,203,mango yogurt,50,60,10,2,00059,India
327662,2023-05-01,202,milk,12,27,15,1,00134,India
327662,2023-05-01,208,sprite,75,100,25,2,00134,India
327662,2023-05-01,206,yakult,360,400,40,2,00134,India
401320,2023-05-01,208,sprite,75,100,25,2,00281,India
675886,2023-05-02,205,classic yogurt,45,60,15,2,00020,India
675886,2023-05-02,209,pepsi,75,100,25,2,00020,India
675886,2023-05-02,213,bisleri,6,15,9,2,00020,India
675886,2023-05-02,207,coca cola,75,100,25,2,00020,India
853460,2023-05-02,211,red bull,90,125,35,2,00187,India
853460,2023-05-02,204,strawberry yogurt,50,60,10,2,00187,India
853460,2023-05-02,206,yakult,360,400,40,2,00187,India
730912,2023-05-02,211,red bull,90,125,35,2,00182,India
730912,2023-05-02,205,classic yogurt,45,60,15,2,00182,India
730912,2023-05-02,204,strawberry yogurt,50,60,10,2,00182,India
730912,2023-05-02,201,paneer,210,340,130,1,00182,India
853065,2023-05-02,210,mountain dew,75,100,25,2,00351,India
853065,2023-05-02,205,classic yogurt,45,60,15,2,00351,India
853065,2023-05-02,202,milk,12,27,15,1,00351,India
853065,2023-05-02,212,amul cheese,250,315,65,1,00351,India
173926,2023-05-02,201,paneer,210,340,130,1,00215,India
173926,2023-05-02,207,coca cola,75,100,25,2,00215,India
173926,2023-05-02,204,strawberry yogurt,50,60,10,2,00215,India
173926,2023-05-02,209,pepsi,75,100,25,2,00215,India
762289,2023-05-02,203,mango yogurt,50,60,10,2,00370,India
762289,2023-05-02,211,red bull,90,125,35,2,00370,India
762289,2023-05-02,207,coca cola,75,100,25,2,00370,India
757171,2023-05-02,201,paneer,210,340,130,1,00119,India
757171,2023-05-02,203,mango yogurt,50,60,10,2,00119,India
220021,2023-05-02,204,strawberry yogurt,50,60,10,2,00449,India
220021,2023-05-02,212,amul cheese,250,315,65,1,00449,India
220021,2023-05-02,201,paneer,210,340,130,1,00449,India
220021,2023-05-02,209,pepsi,75,100,25,2,00449,India
220021,2023-05-02,202,milk,12,27,15,1,00449,India
687814,2023-05-02,208,sprite,75,100,25,2,00105,India
687814,2023-05-02,210,mountain dew,75,100,25,2,00105,India
687814,2023-05-02,206,yakult,360,400,40,2,00105,India
851815,2023-05-02,201,paneer,210,340,130,1,00145,India
851815,2023-05-02,208,sprite,75,100,25,2,00145,India
851815,2023-05-02,212,amul cheese,250,315,65,1,00145,India
914887,2023-05-02,201,paneer,210,340,130,1,00071,India
914887,2023-05-02,204,strawberry yogurt,50,60,10,2,00071,India
914887,2023-05-02,206,yakult,360,400,40,2,00071,India
774536,2023-05-02,206,yakult,360,400,40,2,00076,India
588161,2023-05-02,204,strawberry yogurt,50,60,10,2,00386,India
588161,2023-05-02,205,classic yogurt,45,60,15,2,00386,India
588161,2023-05-02,201,paneer,210,340,130,1,00386,India
818785,2023-05-02,202,milk,12,27,15,1,00314,India
818785,2023-05-02,203,mango yogurt,50,60,10,2,00314,India
538967,2023-05-02,208,sprite,75,100,25,2,00002,India
538967,2023-05-02,205,classic yogurt,45,60,15,2,00002,India
735312,2023-05-02,207,coca cola,75,100,25,2,00173,India
735312,2023-05-02,202,milk,12,27,15,1,00173,India
619138,2023-05-02,204,strawberry yogurt,50,60,10,2,00244,India
619138,2023-05-02,207,coca cola,75,100,25,2,00244,India
619138,2023-05-02,209,pepsi,75,100,25,2,00244,India
619138,2023-05-02,206,yakult,360,400,40,2,00244,India
619138,2023-05-02,208,sprite,75,100,25,2,00244,India
358854,2023-05-02,207,coca cola,75,100,25,2,00097,India
358854,2023-05-02,212,amul cheese,250,315,65,1,00097,India
358854,2023-05-02,203,mango yogurt,50,60,10,2,00097,India
358854,2023-05-02,206,yakult,360,400,40,2,00097,India
999755,2023-05-02,206,yakult,360,400,40,2,00258,India
104937,2023-05-02,210,mountain dew,75,100,25,2,00029,India
848975,2023-05-02,213,bisleri,6,15,9,2,00257,India
848975,2023-05-02,208,sprite,75,100,25,2,00257,India
848975,2023-05-02,206,yakult,360,400,40,2,00257,India
496867,2023-05-02,205,classic yogurt,45,60,15,2,00428,India
150450,2023-05-02,211,red bull,90,125,35,2,00457,India
150450,2023-05-02,210,mountain dew,75,100,25,2,00457,India
150450,2023-05-02,206,yakult,360,400,40,2,00457,India
150450,2023-05-02,205,classic yogurt,45,60,15,2,00457,India
263129,2023-05-02,209,pepsi,75,100,25,2,00339,India
263129,2023-05-02,211,red bull,90,125,35,2,00339,India
802824,2023-05-02,212,amul cheese,250,315,65,1,00278,India
802824,2023-05-02,206,yakult,360,400,40,2,00278,India
802824,2023-05-02,202,milk,12,27,15,1,00278,India
735893,2023-05-02,208,sprite,75,100,25,2,00339,India
623566,2023-05-02,208,sprite,75,100,25,2,00271,India
952674,2023-05-02,201,paneer,210,340,130,1,00359,India
952674,2023-05-02,202,milk,12,27,15,1,00359,India
952674,2023-05-02,213,bisleri,6,15,9,2,00359,India
952674,2023-05-02,204,strawberry yogurt,50,60,10,2,00359,India
106433,2023-05-02,208,sprite,75,100,25,2,00391,India
106433,2023-05-02,207,coca cola,75,100,25,2,00391,India
106433,2023-05-02,209,pepsi,75,100,25,2,00391,India
106433,2023-05-02,205,classic yogurt,45,60,15,2,00391,India
312210,2023-05-02,210,mountain dew,75,100,25,2,00353,India
312210,2023-05-02,213,bisleri,6,15,9,2,00353,India
312210,2023-05-02,205,classic yogurt,45,60,15,2,00353,India
892986,2023-05-02,202,milk,12,27,15,1,00371,India
892986,2023-05-02,209,pepsi,75,100,25,2,00371,India
892986,2023-05-02,205,classic yogurt,45,60,15,2,00371,India
248806,2023-05-02,201,paneer,210,340,130,1,00020,India
248806,2023-05-02,208,sprite,75,100,25,2,00020,India
248806,2023-05-02,211,red bull,90,125,35,2,00020,India
237815,2023-05-02,204,strawberry yogurt,50,60,10,2,00172,India
637537,2023-05-02,204,strawberry yogurt,50,60,10,2,00091,India
960953,2023-05-02,212,amul cheese,250,315,65,1,00388,India
960953,2023-05-02,207,coca cola,75,100,25,2,00388,India
417877,2023-05-02,210,mountain dew,75,100,25,2,00173,India
417877,2023-05-02,208,sprite,75,100,25,2,00173,India
417877,2023-05-02,209,pepsi,75,100,25,2,00173,India
417877,2023-05-02,201,paneer,210,340,130,1,00173,India
417877,2023-05-02,211,red bull,90,125,35,2,00173,India
210873,2023-05-02,203,mango yogurt,50,60,10,2,00181,India
210873,2023-05-02,210,mountain dew,75,100,25,2,00181,India
210873,2023-05-02,208,sprite,75,100,25,2,00181,India
210873,2023-05-02,213,bisleri,6,15,9,2,00181,India
435828,2023-05-02,208,sprite,75,100,25,2,00251,India
435828,2023-05-02,211,red bull,90,125,35,2,00251,India
435828,2023-05-02,213,bisleri,6,15,9,2,00251,India
825998,2023-05-02,203,mango yogurt,50,60,10,2,00188,India
716979,2023-05-02,213,bisleri,6,15,9,2,00158,India
716979,2023-05-02,203,mango yogurt,50,60,10,2,00158,India
465382,2023-05-02,209,pepsi,75,100,25,2,00001,India
465382,2023-05-02,210,mountain dew,75,100,25,2,00001,India
924901,2023-05-02,210,mountain dew,75,100,25,2,00116,India
709246,2023-05-02,207,coca cola,75,100,25,2,00176,India
709246,2023-05-02,204,strawberry yogurt,50,60,10,2,00176,India
709246,2023-05-02,206,yakult,360,400,40,2,00176,India
361675,2023-05-02,211,red bull,90,125,35,2,00427,India
361675,2023-05-02,205,classic yogurt,45,60,15,2,00427,India
361675,2023-05-02,209,pepsi,75,100,25,2,00427,India
314115,2023-05-02,213,bisleri,6,15,9,2,00064,India
314115,2023-05-02,206,yakult,360,400,40,2,00064,India
314115,2023-05-02,204,strawberry yogurt,50,60,10,2,00064,India
314115,2023-05-02,209,pepsi,75,100,25,2,00064,India
314115,2023-05-02,212,amul cheese,250,315,65,1,00064,India
355637,2023-05-02,205,classic yogurt,45,60,15,2,00020,India
355637,2023-05-02,204,strawberry yogurt,50,60,10,2,00020,India
355637,2023-05-02,213,bisleri,6,15,9,2,00020,India
433918,2023-05-02,205,classic yogurt,45,60,15,2,00284,India
433918,2023-05-02,203,mango yogurt,50,60,10,2,00284,India
433918,2023-05-02,201,paneer,210,340,130,1,00284,India
758207,2023-05-02,208,sprite,75,100,25,2,00441,India
758207,2023-05-02,206,yakult,360,400,40,2,00441,India
758207,2023-05-02,204,strawberry yogurt,50,60,10,2,00441,India
758207,2023-05-02,201,paneer,210,340,130,1,00441,India
437437,2023-05-02,211,red bull,90,125,35,2,00412,India
437437,2023-05-02,201,paneer,210,340,130,1,00412,India
437437,2023-05-02,205,classic yogurt,45,60,15,2,00412,India
244085,2023-05-02,211,red bull,90,125,35,2,00473,India
829064,2023-05-02,202,milk,12,27,15,1,00032,India
829064,2023-05-02,205,classic yogurt,45,60,15,2,00032,India
141491,2023-05-02,208,sprite,75,100,25,2,00495,India
141491,2023-05-02,212,amul cheese,250,315,65,1,00495,India
141491,2023-05-02,202,milk,12,27,15,1,00495,India
238519,2023-05-02,202,milk,12,27,15,1,00438,India
238519,2023-05-02,212,amul cheese,250,315,65,1,00438,India
238519,2023-05-02,208,sprite,75,100,25,2,00438,India
238519,2023-05-02,209,pepsi,75,100,25,2,00438,India
406917,2023-05-02,208,sprite,75,100,25,2,00289,India
406917,2023-05-02,201,paneer,210,340,130,1,00289,India
406917,2023-05-02,213,bisleri,6,15,9,2,00289,India
406917,2023-05-02,204,strawberry yogurt,50,60,10,2,00289,India
406917,2023-05-02,205,classic yogurt,45,60,15,2,00289,India
368516,2023-05-02,204,strawberry yogurt,50,60,10,2,00270,India
142522,2023-05-02,202,milk,12,27,15,1,00093,India
631309,2023-05-02,204,strawberry yogurt,50,60,10,2,00461,India
631309,2023-05-02,210,mountain dew,75,100,25,2,00461,India
663352,2023-05-02,203,mango yogurt,50,60,10,2,00471,India
663352,2023-05-02,201,paneer,210,340,130,1,00471,India
663352,2023-05-02,209,pepsi,75,100,25,2,00471,India
567336,2023-05-02,209,pepsi,75,100,25,2,00499,India
567336,2023-05-02,211,red bull,90,125,35,2,00499,India
567336,2023-05-02,201,paneer,210,340,130,1,00499,India
567336,2023-05-02,204,strawberry yogurt,50,60,10,2,00499,India
986629,2023-05-02,211,red bull,90,125,35,2,00363,India
986629,2023-05-02,204,strawberry yogurt,50,60,10,2,00363,India
137962,2023-05-02,204,strawberry yogurt,50,60,10,2,00306,India
137962,2023-05-02,206,yakult,360,400,40,2,00306,India
343467,2023-05-02,204,strawberry yogurt,50,60,10,2,00249,India
343467,2023-05-02,208,sprite,75,100,25,2,00249,India
343467,2023-05-02,203,mango yogurt,50,60,10,2,00249,India
343467,2023-05-02,210,mountain dew,75,100,25,2,00249,India
674727,2023-05-02,205,classic yogurt,45,60,15,2,00308,India
380966,2023-05-02,210,mountain dew,75,100,25,2,00365,India
616602,2023-05-02,207,coca cola,75,100,25,2,00319,India
616602,2023-05-02,204,strawberry yogurt,50,60,10,2,00319,India
857652,2023-05-02,203,mango yogurt,50,60,10,2,00406,India
857652,2023-05-02,211,red bull,90,125,35,2,00406,India
578120,2023-05-02,205,classic yogurt,45,60,15,2,00373,India
578120,2023-05-02,206,yakult,360,400,40,2,00373,India
578120,2023-05-02,212,amul cheese,250,315,65,1,00373,India
109446,2023-05-02,208,sprite,75,100,25,2,00479,India
109446,2023-05-02,204,strawberry yogurt,50,60,10,2,00479,India
109446,2023-05-02,207,coca cola,75,100,25,2,00479,India
165431,2023-05-02,202,milk,12,27,15,1,00244,India
165431,2023-05-02,210,mountain dew,75,100,25,2,00244,India
165431,2023-05-02,213,bisleri,6,15,9,2,00244,India
172434,2023-05-02,213,bisleri,6,15,9,2,00483,India
172434,2023-05-02,205,classic yogurt,45,60,15,2,00483,India
172434,2023-05-02,204,strawberry yogurt,50,60,10,2,00483,India
971837,2023-05-02,204,strawberry yogurt,50,60,10,2,00365,India
971837,2023-05-02,209,pepsi,75,100,25,2,00365,India
971837,2023-05-02,201,paneer,210,340,130,1,00365,India
423816,2023-05-02,211,red bull,90,125,35,2,00310,India
423816,2023-05-02,212,amul cheese,250,315,65,1,00310,India
146111,2023-05-02,210,mountain dew,75,100,25,2,00066,India
146111,2023-05-02,206,yakult,360,400,40,2,00066,India
146111,2023-05-02,202,milk,12,27,15,1,00066,India
970883,2023-05-02,211,red bull,90,125,35,2,00164,India
970883,2023-05-02,202,milk,12,27,15,1,00164,India
546620,2023-05-02,202,milk,12,27,15,1,00051,India
546620,2023-05-02,205,classic yogurt,45,60,15,2,00051,India
546620,2023-05-02,208,sprite,75,100,25,2,00051,India
713610,2023-05-02,209,pepsi,75,100,25,2,00323,India
713610,2023-05-02,213,bisleri,6,15,9,2,00323,India
713610,2023-05-02,206,yakult,360,400,40,2,00323,India
713610,2023-05-02,201,paneer,210,340,130,1,00323,India
127091,2023-05-02,202,milk,12,27,15,1,00358,India
127091,2023-05-02,210,mountain dew,75,100,25,2,00358,India
127091,2023-05-02,204,strawberry yogurt,50,60,10,2,00358,India
369094,2023-05-02,210,mountain dew,75,100,25,2,00462,India
650953,2023-05-02,202,milk,12,27,15,1,00096,India
902099,2023-05-02,213,bisleri,6,15,9,2,00127,India
902099,2023-05-02,203,mango yogurt,50,60,10,2,00127,India
346463,2023-05-02,205,classic yogurt,45,60,15,2,00330,India
346463,2023-05-02,212,amul cheese,250,315,65,1,00330,India
346463,2023-05-02,213,bisleri,6,15,9,2,00330,India
617640,2023-05-03,203,mango yogurt,50,60,10,2,00332,India
617640,2023-05-03,202,milk,12,27,15,1,00332,India
617640,2023-05-03,208,sprite,75,100,25,2,00332,India
910519,2023-05-03,201,paneer,210,340,130,1,00309,India
910519,2023-05-03,202,milk,12,27,15,1,00309,India
910519,2023-05-03,210,mountain dew,75,100,25,2,00309,India
286469,2023-05-03,206,yakult,360,400,40,2,00154,India
286469,2023-05-03,208,sprite,75,100,25,2,00154,India
935247,2023-05-03,211,red bull,90,125,35,2,00335,India
935247,2023-05-03,204,strawberry yogurt,50,60,10,2,00335,India
935247,2023-05-03,213,bisleri,6,15,9,2,00335,India
935247,2023-05-03,210,mountain dew,75,100,25,2,00335,India
373458,2023-05-03,203,mango yogurt,50,60,10,2,00426,India
373458,2023-05-03,211,red bull,90,125,35,2,00426,India
373458,2023-05-03,213,bisleri,6,15,9,2,00426,India
373458,2023-05-03,206,yakult,360,400,40,2,00426,India
423893,2023-05-03,203,mango yogurt,50,60,10,2,00264,India
423893,2023-05-03,205,classic yogurt,45,60,15,2,00264,India
693024,2023-05-03,202,milk,12,27,15,1,00345,India
693024,2023-05-03,211,red bull,90,125,35,2,00345,India
693024,2023-05-03,210,mountain dew,75,100,25,2,00345,India
693024,2023-05-03,206,yakult,360,400,40,2,00345,India
391517,2023-05-03,208,sprite,75,100,25,2,00219,India
391517,2023-05-03,212,amul cheese,250,315,65,1,00219,India
391517,2023-05-03,203,mango yogurt,50,60,10,2,00219,India
391517,2023-05-03,209,pepsi,75,100,25,2,00219,India
593955,2023-05-03,209,pepsi,75,100,25,2,00119,India
593955,2023-05-03,213,bisleri,6,15,9,2,00119,India
593955,2023-05-03,205,classic yogurt,45,60,15,2,00119,India
912358,2023-05-03,204,strawberry yogurt,50,60,10,2,00297,India
912358,2023-05-03,211,red bull,90,125,35,2,00297,India
912358,2023-05-03,208,sprite,75,100,25,2,00297,India
174117,2023-05-03,203,mango yogurt,50,60,10,2,00338,India
174117,2023-05-03,209,pepsi,75,100,25,2,00338,India
174117,2023-05-03,204,strawberry yogurt,50,60,10,2,00338,India
574832,2023-05-03,205,classic yogurt,45,60,15,2,00431,India
574832,2023-05-03,209,pepsi,75,100,25,2,00431,India
574832,2023-05-03,202,milk,12,27,15,1,00431,India
584640,2023-05-03,206,yakult,360,400,40,2,00056,India
584640,2023-05-03,205,classic yogurt,45,60,15,2,00056,India
584640,2023-05-03,201,paneer,210,340,130,1,00056,India
921520,2023-05-03,209,pepsi,75,100,25,2,00118,India
921520,2023-05-03,201,paneer,210,340,130,1,00118,India
672013,2023-05-03,206,yakult,360,400,40,2,00197,India
672013,2023-05-03,204,strawberry yogurt,50,60,10,2,00197,India
672013,2023-05-03,207,coca cola,75,100,25,2,00197,India
672013,2023-05-03,211,red bull,90,125,35,2,00197,India
757542,2023-05-03,212,amul cheese,250,315,65,1,00108,India
757542,2023-05-03,207,coca cola,75,100,25,2,00108,India
540436,2023-05-03,202,milk,12,27,15,1,00403,India
540436,2023-05-03,212,amul cheese,250,315,65,1,00403,India
540436,2023-05-03,207,coca cola,75,100,25,2,00403,India
191934,2023-05-03,202,milk,12,27,15,1,00446,India
191934,2023-05-03,201,paneer,210,340,130,1,00446,India
185357,2023-05-03,203,mango yogurt,50,60,10,2,00139,India
185357,2023-05-03,204,strawberry yogurt,50,60,10,2,00139,India
185357,2023-05-03,209,pepsi,75,100,25,2,00139,India
185357,2023-05-03,201,paneer,210,340,130,1,00139,India
685787,2023-05-03,202,milk,12,27,15,1,00283,India
777537,2023-05-03,213,bisleri,6,15,9,2,00287,India
777537,2023-05-03,204,strawberry yogurt,50,60,10,2,00287,India
777537,2023-05-03,201,paneer,210,340,130,1,00287,India
777537,2023-05-03,202,milk,12,27,15,1,00287,India
777537,2023-05-03,208,sprite,75,100,25,2,00287,India
617061,2023-05-03,201,paneer,210,340,130,1,00438,India
617061,2023-05-03,212,amul cheese,250,315,65,1,00438,India
617061,2023-05-03,207,coca cola,75,100,25,2,00438,India
198878,2023-05-03,204,strawberry yogurt,50,60,10,2,00098,India
198878,2023-05-03,211,red bull,90,125,35,2,00098,India
198878,2023-05-03,208,sprite,75,100,25,2,00098,India
198878,2023-05-03,205,classic yogurt,45,60,15,2,00098,India
198878,2023-05-03,201,paneer,210,340,130,1,00098,India
349746,2023-05-03,204,strawberry yogurt,50,60,10,2,00420,India
126765,2023-05-03,206,yakult,360,400,40,2,00294,India
126765,2023-05-03,204,strawberry yogurt,50,60,10,2,00294,India
126765,2023-05-03,211,red bull,90,125,35,2,00294,India
126765,2023-05-03,203,mango yogurt,50,60,10,2,00294,India
534804,2023-05-03,211,red bull,90,125,35,2,00155,India
534804,2023-05-03,206,yakult,360,400,40,2,00155,India
683135,2023-05-03,210,mountain dew,75,100,25,2,00138,India
683135,2023-05-03,206,yakult,360,400,40,2,00138,India
683135,2023-05-03,211,red bull,90,125,35,2,00138,India
542556,2023-05-03,206,yakult,360,400,40,2,00362,India
542556,2023-05-03,213,bisleri,6,15,9,2,00362,India
542556,2023-05-03,207,coca cola,75,100,25,2,00362,India
542556,2023-05-03,209,pepsi,75,100,25,2,00362,India
885300,2023-05-03,210,mountain dew,75,100,25,2,00311,India
885300,2023-05-03,213,bisleri,6,15,9,2,00311,India
885300,2023-05-03,212,amul cheese,250,315,65,1,00311,India
885300,2023-05-03,205,classic yogurt,45,60,15,2,00311,India
885300,2023-05-03,207,coca cola,75,100,25,2,00311,India
229635,2023-05-03,211,red bull,90,125,35,2,00175,India
229635,2023-05-03,202,milk,12,27,15,1,00175,India
682989,2023-05-03,213,bisleri,6,15,9,2,00179,India
682989,2023-05-03,205,classic yogurt,45,60,15,2,00179,India
714428,2023-05-03,206,yakult,360,400,40,2,00430,India
506827,2023-05-03,201,paneer,210,340,130,1,00131,India
506827,2023-05-03,211,red bull,90,125,35,2,00131,India
506827,2023-05-03,207,coca cola,75,100,25,2,00131,India
309047,2023-05-03,208,sprite,75,100,25,2,00204,India
309047,2023-05-03,203,mango yogurt,50,60,10,2,00204,India
309047,2023-05-03,210,mountain dew,75,100,25,2,00204,India
309047,2023-05-03,206,yakult,360,400,40,2,00204,India
309047,2023-05-03,212,amul cheese,250,315,65,1,00204,India
465297,2023-05-03,204,strawberry yogurt,50,60,10,2,00323,India
465297,2023-05-03,203,mango yogurt,50,60,10,2,00323,India
465297,2023-05-03,206,yakult,360,400,40,2,00323,India
465297,2023-05-03,201,paneer,210,340,130,1,00323,India
962832,2023-05-03,203,mango yogurt,50,60,10,2,00408,India
962832,2023-05-03,213,bisleri,6,15,9,2,00408,India
962832,2023-05-03,207,coca cola,75,100,25,2,00408,India
962832,2023-05-03,201,paneer,210,340,130,1,00408,India
207637,2023-05-03,209,pepsi,75,100,25,2,00410,India
207637,2023-05-03,202,milk,12,27,15,1,00410,India
558344,2023-05-03,202,milk,12,27,15,1,00068,India
558344,2023-05-03,204,strawberry yogurt,50,60,10,2,00068,India
911487,2023-05-03,206,yakult,360,400,40,2,00410,India
911487,2023-05-03,202,milk,12,27,15,1,00410,India
911487,2023-05-03,213,bisleri,6,15,9,2,00410,India
114533,2023-05-03,207,coca cola,75,100,25,2,00136,India
468744,2023-05-03,209,pepsi,75,100,25,2,00367,India
969530,2023-05-03,203,mango yogurt,50,60,10,2,00425,India
600246,2023-05-03,207,coca cola,75,100,25,2,00479,India
600246,2023-05-03,213,bisleri,6,15,9,2,00479,India
600246,2023-05-03,208,sprite,75,100,25,2,00479,India
578860,2023-05-03,206,yakult,360,400,40,2,00437,India
578860,2023-05-03,203,mango yogurt,50,60,10,2,00437,India
578860,2023-05-03,205,classic yogurt,45,60,15,2,00437,India
744117,2023-05-03,203,mango yogurt,50,60,10,2,00157,India
844418,2023-05-03,206,yakult,360,400,40,2,00036,India
394122,2023-05-03,202,milk,12,27,15,1,00436,India
394122,2023-05-03,203,mango yogurt,50,60,10,2,00436,India
394122,2023-05-03,205,classic yogurt,45,60,15,2,00436,India
394122,2023-05-03,204,strawberry yogurt,50,60,10,2,00436,India
330508,2023-05-03,210,mountain dew,75,100,25,2,00098,India
330508,2023-05-03,211,red bull,90,125,35,2,00098,India
330508,2023-05-03,208,sprite,75,100,25,2,00098,India
936785,2023-05-03,213,bisleri,6,15,9,2,00457,India
936785,2023-05-03,212,amul cheese,250,315,65,1,00457,India
936785,2023-05-03,209,pepsi,75,100,25,2,00457,India
749778,2023-05-03,211,red bull,90,125,35,2,00286,India
749778,2023-05-03,203,mango yogurt,50,60,10,2,00286,India
749778,2023-05-03,202,milk,12,27,15,1,00286,India
962549,2023-05-03,201,paneer,210,340,130,1,00244,India
515795,2023-05-03,206,yakult,360,400,40,2,00356,India
515795,2023-05-03,202,milk,12,27,15,1,00356,India
180279,2023-05-03,213,bisleri,6,15,9,2,00324,India
180279,2023-05-03,202,milk,12,27,15,1,00324,India
180279,2023-05-03,210,mountain dew,75,100,25,2,00324,India
180279,2023-05-03,211,red bull,90,125,35,2,00324,India
699830,2023-05-03,201,paneer,210,340,130,1,00230,India
731516,2023-05-03,212,amul cheese,250,315,65,1,00062,India
751921,2023-05-03,211,red bull,90,125,35,2,00341,India
991917,2023-05-03,213,bisleri,6,15,9,2,00109,India
991917,2023-05-03,205,classic yogurt,45,60,15,2,00109,India
813710,2023-05-03,207,coca cola,75,100,25,2,00189,India
813710,2023-05-03,211,red bull,90,125,35,2,00189,India
813710,2023-05-03,213,bisleri,6,15,9,2,00189,India
813710,2023-05-03,201,paneer,210,340,130,1,00189,India
813710,2023-05-03,204,strawberry yogurt,50,60,10,2,00189,India
901923,2023-05-03,211,red bull,90,125,35,2,00001,India
901923,2023-05-03,202,milk,12,27,15,1,00001,India
901923,2023-05-03,201,paneer,210,340,130,1,00001,India
807284,2023-05-03,207,coca cola,75,100,25,2,00047,India
807284,2023-05-03,206,yakult,360,400,40,2,00047,India
807284,2023-05-03,209,pepsi,75,100,25,2,00047,India
225362,2023-05-03,207,coca cola,75,100,25,2,00286,India
225362,2023-05-03,206,yakult,360,400,40,2,00286,India
529161,2023-05-03,210,mountain dew,75,100,25,2,00430,India
529161,2023-05-03,213,bisleri,6,15,9,2,00430,India
529161,2023-05-03,203,mango yogurt,50,60,10,2,00430,India
529161,2023-05-03,201,paneer,210,340,130,1,00430,India
983262,2023-05-03,206,yakult,360,400,40,2,00307,India
983262,2023-05-03,201,paneer,210,340,130,1,00307,India
983262,2023-05-03,212,amul cheese,250,315,65,1,00307,India
403875,2023-05-03,213,bisleri,6,15,9,2,00293,India
403875,2023-05-03,201,paneer,210,340,130,1,00293,India
403875,2023-05-03,207,coca cola,75,100,25,2,00293,India
403875,2023-05-03,205,classic yogurt,45,60,15,2,00293,India
872423,2023-05-03,206,yakult,360,400,40,2,00130,India
872423,2023-05-03,213,bisleri,6,15,9,2,00130,India
872423,2023-05-03,205,classic yogurt,45,60,15,2,00130,India
591400,2023-05-03,203,mango yogurt,50,60,10,2,00113,India
589484,2023-05-03,206,yakult,360,400,40,2,00314,India
589484,2023-05-03,208,sprite,75,100,25,2,00314,India
589484,2023-05-03,205,classic yogurt,45,60,15,2,00314,India
232660,2023-05-03,209,pepsi,75,100,25,2,00332,India
734757,2023-05-03,201,paneer,210,340,130,1,00322,India
734757,2023-05-03,202,milk,12,27,15,1,00322,India
463176,2023-05-03,211,red bull,90,125,35,2,00112,India
200969,2023-05-03,213,bisleri,6,15,9,2,00204,India
605946,2023-05-03,213,bisleri,6,15,9,2,00066,India
605946,2023-05-03,208,sprite,75,100,25,2,00066,India
605946,2023-05-03,210,mountain dew,75,100,25,2,00066,India
938352,2023-05-03,203,mango yogurt,50,60,10,2,00070,India
938352,2023-05-03,208,sprite,75,100,25,2,00070,India
938352,2023-05-03,209,pepsi,75,100,25,2,00070,India
938352,2023-05-03,202,milk,12,27,15,1,00070,India
992938,2023-05-03,206,yakult,360,400,40,2,00263,India
992938,2023-05-03,203,mango yogurt,50,60,10,2,00263,India
186549,2023-05-03,207,coca cola,75,100,25,2,00365,India
958336,2023-05-03,201,paneer,210,340,130,1,00348,India
958336,2023-05-03,213,bisleri,6,15,9,2,00348,India
958336,2023-05-03,205,classic yogurt,45,60,15,2,00348,India
958336,2023-05-03,208,sprite,75,100,25,2,00348,India
958336,2023-05-03,203,mango yogurt,50,60,10,2,00348,India
769211,2023-05-03,213,bisleri,6,15,9,2,00281,India
769211,2023-05-03,206,yakult,360,400,40,2,00281,India
769211,2023-05-03,203,mango yogurt,50,60,10,2,00281,India
769211,2023-05-03,204,strawberry yogurt,50,60,10,2,00281,India
554783,2023-05-03,207,coca cola,75,100,25,2,00298,India
554783,2023-05-03,203,mango yogurt,50,60,10,2,00298,India
906411,2023-05-03,211,red bull,90,125,35,2,00176,India
906411,2023-05-03,210,mountain dew,75,100,25,2,00176,India
630305,2023-05-03,210,mountain dew,75,100,25,2,00482,India
658264,2023-05-03,203,mango yogurt,50,60,10,2,00468,India
658264,2023-05-03,206,yakult,360,400,40,2,00468,India
658264,2023-05-03,212,amul cheese,250,315,65,1,00468,India
384143,2023-05-03,206,yakult,360,400,40,2,00142,India
384143,2023-05-03,202,milk,12,27,15,1,00142,India
760230,2023-05-03,209,pepsi,75,100,25,2,00048,India
760230,2023-05-03,208,sprite,75,100,25,2,00048,India
760230,2023-05-03,203,mango yogurt,50,60,10,2,00048,India
760230,2023-05-03,213,bisleri,6,15,9,2,00048,India
760230,2023-05-03,201,paneer,210,340,130,1,00048,India
554056,2023-05-03,204,strawberry yogurt,50,60,10,2,00429,India
554056,2023-05-03,209,pepsi,75,100,25,2,00429,India
184168,2023-05-03,210,mountain dew,75,100,25,2,00285,India
184168,2023-05-03,211,red bull,90,125,35,2,00285,India
184168,2023-05-03,201,paneer,210,340,130,1,00285,India
656180,2023-05-03,203,mango yogurt,50,60,10,2,00265,India
656180,2023-05-03,209,pepsi,75,100,25,2,00265,India
656180,2023-05-03,211,red bull,90,125,35,2,00265,India
656180,2023-05-03,205,classic yogurt,45,60,15,2,00265,India
744228,2023-05-03,211,red bull,90,125,35,2,00102,India
221625,2023-05-03,207,coca cola,75,100,25,2,00139,India
221625,2023-05-03,206,yakult,360,400,40,2,00139,India
285076,2023-05-03,205,classic yogurt,45,60,15,2,00406,India
285076,2023-05-03,206,yakult,360,400,40,2,00406,India
970309,2023-05-03,211,red bull,90,125,35,2,00007,India
729698,2023-05-03,210,mountain dew,75,100,25,2,00235,India
376067,2023-05-03,208,sprite,75,100,25,2,00182,India
376067,2023-05-03,203,mango yogurt,50,60,10,2,00182,India
376067,2023-05-03,212,amul cheese,250,315,65,1,00182,India
376067,2023-05-03,209,pepsi,75,100,25,2,00182,India
729856,2023-05-03,212,amul cheese,250,315,65,1,00192,India
729856,2023-05-03,210,mountain dew,75,100,25,2,00192,India
609864,2023-05-03,213,bisleri,6,15,9,2,00316,India
975820,2023-05-04,204,strawberry yogurt,50,60,10,2,00072,India
975820,2023-05-04,205,classic yogurt,45,60,15,2,00072,India
975820,2023-05-04,212,amul cheese,250,315,65,1,00072,India
838129,2023-05-04,211,red bull,90,125,35,2,00294,India
838129,2023-05-04,208,sprite,75,100,25,2,00294,India
838129,2023-05-04,212,amul cheese,250,315,65,1,00294,India
532273,2023-05-04,206,yakult,360,400,40,2,00034,India
524912,2023-05-04,209,pepsi,75,100,25,2,00232,India
763329,2023-05-04,209,pepsi,75,100,25,2,00218,India
763329,2023-05-04,204,strawberry yogurt,50,60,10,2,00218,India
763329,2023-05-04,210,mountain dew,75,100,25,2,00218,India
943720,2023-05-04,205,classic yogurt,45,60,15,2,00477,India
513824,2023-05-04,209,pepsi,75,100,25,2,00144,India
513824,2023-05-04,211,red bull,90,125,35,2,00144,India
513824,2023-05-04,206,yakult,360,400,40,2,00144,India
513824,2023-05-04,202,milk,12,27,15,1,00144,India
513824,2023-05-04,204,strawberry yogurt,50,60,10,2,00144,India
230927,2023-05-04,211,red bull,90,125,35,2,00143,India
230927,2023-05-04,205,classic yogurt,45,60,15,2,00143,India
889118,2023-05-04,211,red bull,90,125,35,2,00010,India
889118,2023-05-04,213,bisleri,6,15,9,2,00010,India
800810,2023-05-04,210,mountain dew,75,100,25,2,00479,India
800810,2023-05-04,201,paneer,210,340,130,1,00479,India
800810,2023-05-04,211,red bull,90,125,35,2,00479,India
981023,2023-05-04,210,mountain dew,75,100,25,2,00337,India
326666,2023-05-04,210,mountain dew,75,100,25,2,00175,India
430098,2023-05-04,205,classic yogurt,45,60,15,2,00354,India
430098,2023-05-04,210,mountain dew,75,100,25,2,00354,India
430098,2023-05-04,203,mango yogurt,50,60,10,2,00354,India
962735,2023-05-04,204,strawberry yogurt,50,60,10,2,00192,India
962735,2023-05-04,212,amul cheese,250,315,65,1,00192,India
962735,2023-05-04,205,classic yogurt,45,60,15,2,00192,India
962735,2023-05-04,201,paneer,210,340,130,1,00192,India
791751,2023-05-04,204,strawberry yogurt,50,60,10,2,00210,India
401423,2023-05-04,213,bisleri,6,15,9,2,00484,India
401423,2023-05-04,205,classic yogurt,45,60,15,2,00484,India
401423,2023-05-04,209,pepsi,75,100,25,2,00484,India
623867,2023-05-04,212,amul cheese,250,315,65,1,00385,India
623867,2023-05-04,213,bisleri,6,15,9,2,00385,India
623867,2023-05-04,206,yakult,360,400,40,2,00385,India
623867,2023-05-04,201,paneer,210,340,130,1,00385,India
135207,2023-05-04,209,pepsi,75,100,25,2,00187,India
135207,2023-05-04,213,bisleri,6,15,9,2,00187,India
135207,2023-05-04,205,classic yogurt,45,60,15,2,00187,India
135207,2023-05-04,206,yakult,360,400,40,2,00187,India
231292,2023-05-04,205,classic yogurt,45,60,15,2,00136,India
231292,2023-05-04,203,mango yogurt,50,60,10,2,00136,India
231292,2023-05-04,212,amul cheese,250,315,65,1,00136,India
710067,2023-05-04,211,red bull,90,125,35,2,00013,India
710067,2023-05-04,210,mountain dew,75,100,25,2,00013,India
771815,2023-05-04,205,classic yogurt,45,60,15,2,00155,India
771815,2023-05-04,213,bisleri,6,15,9,2,00155,India
771815,2023-05-04,207,coca cola,75,100,25,2,00155,India
771815,2023-05-04,202,milk,12,27,15,1,00155,India
111568,2023-05-04,201,paneer,210,340,130,1,00408,India
111568,2023-05-04,209,pepsi,75,100,25,2,00408,India
242591,2023-05-04,210,mountain dew,75,100,25,2,00478,India
242591,2023-05-04,207,coca cola,75,100,25,2,00478,India
242591,2023-05-04,202,milk,12,27,15,1,00478,India
242591,2023-05-04,206,yakult,360,400,40,2,00478,India
878275,2023-05-04,208,sprite,75,100,25,2,00433,India
878275,2023-05-04,206,yakult,360,400,40,2,00433,India
863741,2023-05-04,211,red bull,90,125,35,2,00321,India
863741,2023-05-04,204,strawberry yogurt,50,60,10,2,00321,India
863741,2023-05-04,207,coca cola,75,100,25,2,00321,India
863741,2023-05-04,205,classic yogurt,45,60,15,2,00321,India
203606,2023-05-04,207,coca cola,75,100,25,2,00332,India
203606,2023-05-04,210,mountain dew,75,100,25,2,00332,India
203606,2023-05-04,204,strawberry yogurt,50,60,10,2,00332,India
203606,2023-05-04,208,sprite,75,100,25,2,00332,India
222117,2023-05-04,212,amul cheese,250,315,65,1,00484,India
222117,2023-05-04,204,strawberry yogurt,50,60,10,2,00484,India
222117,2023-05-04,202,milk,12,27,15,1,00484,India
698752,2023-05-04,213,bisleri,6,15,9,2,00499,India
698752,2023-05-04,212,amul cheese,250,315,65,1,00499,India
698752,2023-05-04,205,classic yogurt,45,60,15,2,00499,India
698752,2023-05-04,211,red bull,90,125,35,2,00499,India
698752,2023-05-04,206,yakult,360,400,40,2,00499,India
461600,2023-05-04,204,strawberry yogurt,50,60,10,2,00336,India
967003,2023-05-04,207,coca cola,75,100,25,2,00426,India
967003,2023-05-04,209,pepsi,75,100,25,2,00426,India
560575,2023-05-04,201,paneer,210,340,130,1,00491,India
500708,2023-05-04,208,sprite,75,100,25,2,00357,India
897435,2023-05-04,204,strawberry yogurt,50,60,10,2,00145,India
897435,2023-05-04,212,amul cheese,250,315,65,1,00145,India
656704,2023-05-04,208,sprite,75,100,25,2,00486,India
543681,2023-05-04,204,strawberry yogurt,50,60,10,2,00226,India
543681,2023-05-04,209,pepsi,75,100,25,2,00226,India
170933,2023-05-04,201,paneer,210,340,130,1,00368,India
378203,2023-05-04,208,sprite,75,100,25,2,00479,India
378203,2023-05-04,202,milk,12,27,15,1,00479,India
689119,2023-05-04,208,sprite,75,100,25,2,00269,India
689119,2023-05-04,209,pepsi,75,100,25,2,00269,India
119272,2023-05-04,201,paneer,210,340,130,1,00095,India
643192,2023-05-04,208,sprite,75,100,25,2,00453,India
643192,2023-05-04,210,mountain dew,75,100,25,2,00453,India
643192,2023-05-04,213,bisleri,6,15,9,2,00453,India
439162,2023-05-04,211,red bull,90,125,35,2,00100,India
439162,2023-05-04,212,amul cheese,250,315,65,1,00100,India
439162,2023-05-04,205,classic yogurt,45,60,15,2,00100,India
161221,2023-05-04,210,mountain dew,75,100,25,2,00162,India
161221,2023-05-04,209,pepsi,75,100,25,2,00162,India
161221,2023-05-04,205,classic yogurt,45,60,15,2,00162,India
398470,2023-05-04,205,classic yogurt,45,60,15,2,00400,India
398470,2023-05-04,213,bisleri,6,15,9,2,00400,India
398470,2023-05-04,212,amul cheese,250,315,65,1,00400,India
398470,2023-05-04,209,pepsi,75,100,25,2,00400,India
265986,2023-05-04,207,coca cola,75,100,25,2,00206,India
265986,2023-05-04,209,pepsi,75,100,25,2,00206,India
872119,2023-05-04,212,amul cheese,250,315,65,1,00320,India
872119,2023-05-04,201,paneer,210,340,130,1,00320,India
872119,2023-05-04,204,strawberry yogurt,50,60,10,2,00320,India
872119,2023-05-04,202,milk,12,27,15,1,00320,India
139075,2023-05-04,206,yakult,360,400,40,2,00354,India
139075,2023-05-04,203,mango yogurt,50,60,10,2,00354,India
482513,2023-05-04,211,red bull,90,125,35,2,00244,India
487911,2023-05-04,207,coca cola,75,100,25,2,00110,India
487911,2023-05-04,209,pepsi,75,100,25,2,00110,India
487911,2023-05-04,208,sprite,75,100,25,2,00110,India
550176,2023-05-04,204,strawberry yogurt,50,60,10,2,00256,India
550176,2023-05-04,205,classic yogurt,45,60,15,2,00256,India
550176,2023-05-04,210,mountain dew,75,100,25,2,00256,India
550176,2023-05-04,207,coca cola,75,100,25,2,00256,India
770843,2023-05-04,208,sprite,75,100,25,2,00086,India
770843,2023-05-04,204,strawberry yogurt,50,60,10,2,00086,India
335455,2023-05-04,211,red bull,90,125,35,2,00161,India
335455,2023-05-04,206,yakult,360,400,40,2,00161,India
335455,2023-05-04,209,pepsi,75,100,25,2,00161,India
113563,2023-05-04,210,mountain dew,75,100,25,2,00094,India
113563,2023-05-04,208,sprite,75,100,25,2,00094,India
915201,2023-05-04,203,mango yogurt,50,60,10,2,00333,India
915201,2023-05-04,208,sprite,75,100,25,2,00333,India
915201,2023-05-04,207,coca cola,75,100,25,2,00333,India
915201,2023-05-04,201,paneer,210,340,130,1,00333,India
437716,2023-05-04,202,milk,12,27,15,1,00306,India
437716,2023-05-04,205,classic yogurt,45,60,15,2,00306,India
437716,2023-05-04,209,pepsi,75,100,25,2,00306,India
432695,2023-05-04,209,pepsi,75,100,25,2,00259,India
432695,2023-05-04,206,yakult,360,400,40,2,00259,India
530026,2023-05-04,210,mountain dew,75,100,25,2,00453,India
530026,2023-05-04,211,red bull,90,125,35,2,00453,India
530026,2023-05-04,213,bisleri,6,15,9,2,00453,India
653958,2023-05-04,213,bisleri,6,15,9,2,00484,India
525776,2023-05-04,208,sprite,75,100,25,2,00042,India
525776,2023-05-04,203,mango yogurt,50,60,10,2,00042,India
698758,2023-05-04,204,strawberry yogurt,50,60,10,2,00359,India
144907,2023-05-04,203,mango yogurt,50,60,10,2,00379,India
144907,2023-05-04,210,mountain dew,75,100,25,2,00379,India
144907,2023-05-04,201,paneer,210,340,130,1,00379,India
103940,2023-05-04,203,mango yogurt,50,60,10,2,00158,India
119476,2023-05-04,207,coca cola,75,100,25,2,00281,India
119476,2023-05-04,203,mango yogurt,50,60,10,2,00281,India
623839,2023-05-04,207,coca cola,75,100,25,2,00154,India
623839,2023-05-04,209,pepsi,75,100,25,2,00154,India
623839,2023-05-04,204,strawberry yogurt,50,60,10,2,00154,India
623839,2023-05-04,206,yakult,360,400,40,2,00154,India
623839,2023-05-04,201,paneer,210,340,130,1,00154,India
573656,2023-05-04,206,yakult,360,400,40,2,00388,India
296026,2023-05-04,205,classic yogurt,45,60,15,2,00252,India
296026,2023-05-04,202,milk,12,27,15,1,00252,India
296026,2023-05-04,211,red bull,90,125,35,2,00252,India
100267,2023-05-04,209,pepsi,75,100,25,2,00328,India
100267,2023-05-04,208,sprite,75,100,25,2,00328,India
554375,2023-05-04,208,sprite,75,100,25,2,00245,India
554375,2023-05-04,211,red bull,90,125,35,2,00245,India
554375,2023-05-04,206,yakult,360,400,40,2,00245,India
554375,2023-05-04,201,paneer,210,340,130,1,00245,India
680413,2023-05-04,210,mountain dew,75,100,25,2,00383,India
680413,2023-05-04,202,milk,12,27,15,1,00383,India
680413,2023-05-04,206,yakult,360,400,40,2,00383,India
680413,2023-05-04,212,amul cheese,250,315,65,1,00383,India
940765,2023-05-04,204,strawberry yogurt,50,60,10,2,00109,India
406912,2023-05-04,206,yakult,360,400,40,2,00351,India
406912,2023-05-04,202,milk,12,27,15,1,00351,India
406912,2023-05-04,212,amul cheese,250,315,65,1,00351,India
406912,2023-05-04,210,mountain dew,75,100,25,2,00351,India
406912,2023-05-04,211,red bull,90,125,35,2,00351,India
549173,2023-05-04,205,classic yogurt,45,60,15,2,00062,India
549173,2023-05-04,203,mango yogurt,50,60,10,2,00062,India
549173,2023-05-04,202,milk,12,27,15,1,00062,India
549173,2023-05-04,208,sprite,75,100,25,2,00062,India
549173,2023-05-04,206,yakult,360,400,40,2,00062,India
596567,2023-05-04,210,mountain dew,75,100,25,2,00270,India
929044,2023-05-04,205,classic yogurt,45,60,15,2,00308,India
929044,2023-05-04,202,milk,12,27,15,1,00308,India
929044,2023-05-04,211,red bull,90,125,35,2,00308,India
660508,2023-05-04,207,coca cola,75,100,25,2,00388,India
660508,2023-05-04,210,mountain dew,75,100,25,2,00388,India
660508,2023-05-04,208,sprite,75,100,25,2,00388,India
660508,2023-05-04,201,paneer,210,340,130,1,00388,India
203115,2023-05-04,205,classic yogurt,45,60,15,2,00214,India
203115,2023-05-04,207,coca cola,75,100,25,2,00214,India
203115,2023-05-04,201,paneer,210,340,130,1,00214,India
905940,2023-05-04,211,red bull,90,125,35,2,00297,India
905940,2023-05-04,201,paneer,210,340,130,1,00297,India
905940,2023-05-04,209,pepsi,75,100,25,2,00297,India
905940,2023-05-04,206,yakult,360,400,40,2,00297,India
322464,2023-05-04,205,classic yogurt,45,60,15,2,00016,India
322464,2023-05-04,202,milk,12,27,15,1,00016,India
322464,2023-05-04,212,amul cheese,250,315,65,1,00016,India
979466,2023-05-04,201,paneer,210,340,130,1,00054,India
979466,2023-05-04,210,mountain dew,75,100,25,2,00054,India
979466,2023-05-04,207,coca cola,75,100,25,2,00054,India
480244,2023-05-04,209,pepsi,75,100,25,2,00340,India
480244,2023-05-04,201,paneer,210,340,130,1,00340,India
480244,2023-05-04,203,mango yogurt,50,60,10,2,00340,India
480244,2023-05-04,206,yakult,360,400,40,2,00340,India
109097,2023-05-04,201,paneer,210,340,130,1,00162,India
109097,2023-05-04,205,classic yogurt,45,60,15,2,00162,India
109097,2023-05-04,212,amul cheese,250,315,65,1,00162,India
989559,2023-05-04,212,amul cheese,250,315,65,1,00251,India
989559,2023-05-04,207,coca cola,75,100,25,2,00251,India
989559,2023-05-04,213,bisleri,6,15,9,2,00251,India
989559,2023-05-04,209,pepsi,75,100,25,2,00251,India
662430,2023-05-04,204,strawberry yogurt,50,60,10,2,00031,India
662430,2023-05-04,205,classic yogurt,45,60,15,2,00031,India
292421,2023-05-04,212,amul cheese,250,315,65,1,00188,India
292421,2023-05-04,201,paneer,210,340,130,1,00188,India
292421,2023-05-04,210,mountain dew,75,100,25,2,00188,India
292421,2023-05-04,205,classic yogurt,45,60,15,2,00188,India
868475,2023-05-04,204,strawberry yogurt,50,60,10,2,00159,India
868475,2023-05-04,209,pepsi,75,100,25,2,00159,India
868475,2023-05-04,201,paneer,210,340,130,1,00159,India
691038,2023-05-05,211,red bull,90,125,35,2,00295,India
691038,2023-05-05,213,bisleri,6,15,9,2,00295,India
751472,2023-05-05,211,red bull,90,125,35,2,00233,India
811213,2023-05-05,201,paneer,210,340,130,1,00475,India
124640,2023-05-05,206,yakult,360,400,40,2,00041,India
124640,2023-05-05,209,pepsi,75,100,25,2,00041,India
124640,2023-05-05,207,coca cola,75,100,25,2,00041,India
276214,2023-05-05,203,mango yogurt,50,60,10,2,00043,India
276214,2023-05-05,205,classic yogurt,45,60,15,2,00043,India
551959,2023-05-05,202,milk,12,27,15,1,00372,India
551959,2023-05-05,207,coca cola,75,100,25,2,00372,India
551959,2023-05-05,204,strawberry yogurt,50,60,10,2,00372,India
349003,2023-05-05,204,strawberry yogurt,50,60,10,2,00455,India
349003,2023-05-05,211,red bull,90,125,35,2,00455,India
323455,2023-05-05,203,mango yogurt,50,60,10,2,00063,India
323455,2023-05-05,202,milk,12,27,15,1,00063,India
323455,2023-05-05,210,mountain dew,75,100,25,2,00063,India
323455,2023-05-05,207,coca cola,75,100,25,2,00063,India
492132,2023-05-05,210,mountain dew,75,100,25,2,00464,India
826187,2023-05-05,211,red bull,90,125,35,2,00191,India
826187,2023-05-05,208,sprite,75,100,25,2,00191,India
826187,2023-05-05,210,mountain dew,75,100,25,2,00191,India
826187,2023-05-05,201,paneer,210,340,130,1,00191,India
508372,2023-05-05,201,paneer,210,340,130,1,00063,India
508372,2023-05-05,210,mountain dew,75,100,25,2,00063,India
508372,2023-05-05,207,coca cola,75,100,25,2,00063,India
508372,2023-05-05,203,mango yogurt,50,60,10,2,00063,India
508372,2023-05-05,206,yakult,360,400,40,2,00063,India
930046,2023-05-05,208,sprite,75,100,25,2,00068,India
930046,2023-05-05,212,amul cheese,250,315,65,1,00068,India
930046,2023-05-05,209,pepsi,75,100,25,2,00068,India
381043,2023-05-05,206,yakult,360,400,40,2,00197,India
381043,2023-05-05,205,classic yogurt,45,60,15,2,00197,India
381043,2023-05-05,211,red bull,90,125,35,2,00197,India
725884,2023-05-05,208,sprite,75,100,25,2,00053,India
725884,2023-05-05,211,red bull,90,125,35,2,00053,India
725884,2023-05-05,209,pepsi,75,100,25,2,00053,India
725884,2023-05-05,205,classic yogurt,45,60,15,2,00053,India
317736,2023-05-05,201,paneer,210,340,130,1,00422,India
748686,2023-05-05,211,red bull,90,125,35,2,00416,India
748686,2023-05-05,208,sprite,75,100,25,2,00416,India
748686,2023-05-05,202,milk,12,27,15,1,00416,India
157797,2023-05-05,202,milk,12,27,15,1,00087,India
234721,2023-05-05,211,red bull,90,125,35,2,00461,India
234721,2023-05-05,208,sprite,75,100,25,2,00461,India
234721,2023-05-05,213,bisleri,6,15,9,2,00461,India
234721,2023-05-05,205,classic yogurt,45,60,15,2,00461,India
746306,2023-05-05,212,amul cheese,250,315,65,1,00098,India
746306,2023-05-05,204,strawberry yogurt,50,60,10,2,00098,India
707810,2023-05-05,202,milk,12,27,15,1,00464,India
707810,2023-05-05,212,amul cheese,250,315,65,1,00464,India
707810,2023-05-05,204,strawberry yogurt,50,60,10,2,00464,India
972561,2023-05-05,203,mango yogurt,50,60,10,2,00326,India
699406,2023-05-05,205,classic yogurt,45,60,15,2,00212,India
699406,2023-05-05,213,bisleri,6,15,9,2,00212,India
632195,2023-05-05,203,mango yogurt,50,60,10,2,00205,India
632195,2023-05-05,206,yakult,360,400,40,2,00205,India
632195,2023-05-05,213,bisleri,6,15,9,2,00205,India
598445,2023-05-05,204,strawberry yogurt,50,60,10,2,00062,India
562401,2023-05-05,206,yakult,360,400,40,2,00421,India
311248,2023-05-05,212,amul cheese,250,315,65,1,00076,India
311248,2023-05-05,206,yakult,360,400,40,2,00076,India
311248,2023-05-05,211,red bull,90,125,35,2,00076,India
767875,2023-05-05,205,classic yogurt,45,60,15,2,00167,India
767875,2023-05-05,203,mango yogurt,50,60,10,2,00167,India
767875,2023-05-05,202,milk,12,27,15,1,00167,India
767875,2023-05-05,209,pepsi,75,100,25,2,00167,India
323212,2023-05-05,209,pepsi,75,100,25,2,00007,India
323212,2023-05-05,210,mountain dew,75,100,25,2,00007,India
466703,2023-05-05,205,classic yogurt,45,60,15,2,00108,India
466703,2023-05-05,204,strawberry yogurt,50,60,10,2,00108,India
466703,2023-05-05,212,amul cheese,250,315,65,1,00108,India
324848,2023-05-05,210,mountain dew,75,100,25,2,00065,India
593783,2023-05-05,207,coca cola,75,100,25,2,00141,India
189526,2023-05-05,202,milk,12,27,15,1,00210,India
189526,2023-05-05,208,sprite,75,100,25,2,00210,India
189526,2023-05-05,205,classic yogurt,45,60,15,2,00210,India
189526,2023-05-05,206,yakult,360,400,40,2,00210,India
189526,2023-05-05,210,mountain dew,75,100,25,2,00210,India
780108,2023-05-05,213,bisleri,6,15,9,2,00200,India
613562,2023-05-05,211,red bull,90,125,35,2,00440,India
613562,2023-05-05,206,yakult,360,400,40,2,00440,India
613562,2023-05-05,212,amul cheese,250,315,65,1,00440,India
147381,2023-05-05,206,yakult,360,400,40,2,00464,India
207364,2023-05-05,201,paneer,210,340,130,1,00221,India
207364,2023-05-05,207,coca cola,75,100,25,2,00221,India
207364,2023-05-05,213,bisleri,6,15,9,2,00221,India
207364,2023-05-05,205,classic yogurt,45,60,15,2,00221,India
721574,2023-05-05,203,mango yogurt,50,60,10,2,00151,India
721574,2023-05-05,206,yakult,360,400,40,2,00151,India
405273,2023-05-05,211,red bull,90,125,35,2,00366,India
405273,2023-05-05,203,mango yogurt,50,60,10,2,00366,India
774413,2023-05-05,206,yakult,360,400,40,2,00309,India
774413,2023-05-05,213,bisleri,6,15,9,2,00309,India
774413,2023-05-05,207,coca cola,75,100,25,2,00309,India
774413,2023-05-05,205,classic yogurt,45,60,15,2,00309,India
774413,2023-05-05,204,strawberry yogurt,50,60,10,2,00309,India
302266,2023-05-05,203,mango yogurt,50,60,10,2,00466,India
304457,2023-05-05,202,milk,12,27,15,1,00380,India
304457,2023-05-05,209,pepsi,75,100,25,2,00380,India
304457,2023-05-05,206,yakult,360,400,40,2,00380,India
304457,2023-05-05,207,coca cola,75,100,25,2,00380,India
304457,2023-05-05,208,sprite,75,100,25,2,00380,India
411246,2023-05-05,202,milk,12,27,15,1,00249,India
411246,2023-05-05,204,strawberry yogurt,50,60,10,2,00249,India
955009,2023-05-05,203,mango yogurt,50,60,10,2,00366,India
955009,2023-05-05,209,pepsi,75,100,25,2,00366,India
955009,2023-05-05,201,paneer,210,340,130,1,00366,India
739099,2023-05-05,212,amul cheese,250,315,65,1,00491,India
739099,2023-05-05,210,mountain dew,75,100,25,2,00491,India
739099,2023-05-05,209,pepsi,75,100,25,2,00491,India
739099,2023-05-05,205,classic yogurt,45,60,15,2,00491,India
199653,2023-05-05,208,sprite,75,100,25,2,00078,India
199653,2023-05-05,210,mountain dew,75,100,25,2,00078,India
199653,2023-05-05,212,amul cheese,250,315,65,1,00078,India
699823,2023-05-05,202,milk,12,27,15,1,00182,India
699823,2023-05-05,210,mountain dew,75,100,25,2,00182,India
775658,2023-05-05,211,red bull,90,125,35,2,00002,India
775658,2023-05-05,203,mango yogurt,50,60,10,2,00002,India
775658,2023-05-05,202,milk,12,27,15,1,00002,India
775658,2023-05-05,207,coca cola,75,100,25,2,00002,India
775658,2023-05-05,208,sprite,75,100,25,2,00002,India
566941,2023-05-05,211,red bull,90,125,35,2,00218,India
566941,2023-05-05,205,classic yogurt,45,60,15,2,00218,India
405039,2023-05-05,212,amul cheese,250,315,65,1,00212,India
405039,2023-05-05,204,strawberry yogurt,50,60,10,2,00212,India
405039,2023-05-05,213,bisleri,6,15,9,2,00212,India
405039,2023-05-05,210,mountain dew,75,100,25,2,00212,India
267893,2023-05-05,210,mountain dew,75,100,25,2,00198,India
267893,2023-05-05,209,pepsi,75,100,25,2,00198,India
267893,2023-05-05,212,amul cheese,250,315,65,1,00198,India
267893,2023-05-05,202,milk,12,27,15,1,00198,India
387840,2023-05-06,209,pepsi,75,100,25,2,00323,India
387840,2023-05-06,208,sprite,75,100,25,2,00323,India
387840,2023-05-06,202,milk,12,27,15,1,00323,India
469698,2023-05-06,212,amul cheese,250,315,65,1,00280,India
469698,2023-05-06,201,paneer,210,340,130,1,00280,India
469698,2023-05-06,210,mountain dew,75,100,25,2,00280,India
469698,2023-05-06,203,mango yogurt,50,60,10,2,00280,India
550406,2023-05-06,211,red bull,90,125,35,2,00025,India
550406,2023-05-06,204,strawberry yogurt,50,60,10,2,00025,India
550406,2023-05-06,213,bisleri,6,15,9,2,00025,India
550406,2023-05-06,203,mango yogurt,50,60,10,2,00025,India
223195,2023-05-06,203,mango yogurt,50,60,10,2,00313,India
223195,2023-05-06,212,amul cheese,250,315,65,1,00313,India
223195,2023-05-06,207,coca cola,75,100,25,2,00313,India
840246,2023-05-06,207,coca cola,75,100,25,2,00334,India
840246,2023-05-06,206,yakult,360,400,40,2,00334,India
840246,2023-05-06,209,pepsi,75,100,25,2,00334,India
757053,2023-05-06,201,paneer,210,340,130,1,00404,India
757053,2023-05-06,213,bisleri,6,15,9,2,00404,India
485504,2023-05-06,204,strawberry yogurt,50,60,10,2,00120,India
485504,2023-05-06,203,mango yogurt,50,60,10,2,00120,India
733906,2023-05-06,203,mango yogurt,50,60,10,2,00190,India
733906,2023-05-06,201,paneer,210,340,130,1,00190,India
733906,2023-05-06,210,mountain dew,75,100,25,2,00190,India
733906,2023-05-06,207,coca cola,75,100,25,2,00190,India
658253,2023-05-06,213,bisleri,6,15,9,2,00406,India
658253,2023-05-06,201,paneer,210,340,130,1,00406,India
658253,2023-05-06,205,classic yogurt,45,60,15,2,00406,India
810277,2023-05-06,207,coca cola,75,100,25,2,00421,India
810277,2023-05-06,213,bisleri,6,15,9,2,00421,India
810277,2023-05-06,212,amul cheese,250,315,65,1,00421,India
810277,2023-05-06,202,milk,12,27,15,1,00421,India
263300,2023-05-06,203,mango yogurt,50,60,10,2,00270,India
263300,2023-05-06,213,bisleri,6,15,9,2,00270,India
263300,2023-05-06,201,paneer,210,340,130,1,00270,India
462032,2023-05-06,207,coca cola,75,100,25,2,00352,India
462032,2023-05-06,213,bisleri,6,15,9,2,00352,India
462032,2023-05-06,210,mountain dew,75,100,25,2,00352,India
462032,2023-05-06,208,sprite,75,100,25,2,00352,India
824904,2023-05-06,207,coca cola,75,100,25,2,00266,India
824904,2023-05-06,211,red bull,90,125,35,2,00266,India
824904,2023-05-06,203,mango yogurt,50,60,10,2,00266,India
824904,2023-05-06,210,mountain dew,75,100,25,2,00266,India
824904,2023-05-06,209,pepsi,75,100,25,2,00266,India
445947,2023-05-06,201,paneer,210,340,130,1,00476,India
238215,2023-05-06,210,mountain dew,75,100,25,2,00040,India
238215,2023-05-06,202,milk,12,27,15,1,00040,India
496343,2023-05-06,205,classic yogurt,45,60,15,2,00159,India
207408,2023-05-06,206,yakult,360,400,40,2,00303,India
386907,2023-05-06,202,milk,12,27,15,1,00359,India
386907,2023-05-06,213,bisleri,6,15,9,2,00359,India
386907,2023-05-06,205,classic yogurt,45,60,15,2,00359,India
386907,2023-05-06,208,sprite,75,100,25,2,00359,India
433357,2023-05-06,204,strawberry yogurt,50,60,10,2,00048,India
433357,2023-05-06,208,sprite,75,100,25,2,00048,India
373233,2023-05-06,209,pepsi,75,100,25,2,00146,India
373233,2023-05-06,208,sprite,75,100,25,2,00146,India
373233,2023-05-06,201,paneer,210,340,130,1,00146,India
373233,2023-05-06,213,bisleri,6,15,9,2,00146,India
373233,2023-05-06,210,mountain dew,75,100,25,2,00146,India
157305,2023-05-06,211,red bull,90,125,35,2,00473,India
980677,2023-05-06,211,red bull,90,125,35,2,00245,India
980677,2023-05-06,204,strawberry yogurt,50,60,10,2,00245,India
980677,2023-05-06,202,milk,12,27,15,1,00245,India
633734,2023-05-06,203,mango yogurt,50,60,10,2,00138,India
633734,2023-05-06,206,yakult,360,400,40,2,00138,India
618647,2023-05-06,202,milk,12,27,15,1,00239,India
618647,2023-05-06,209,pepsi,75,100,25,2,00239,India
330284,2023-05-06,213,bisleri,6,15,9,2,00306,India
980480,2023-05-06,208,sprite,75,100,25,2,00159,India
980480,2023-05-06,211,red bull,90,125,35,2,00159,India
980480,2023-05-06,210,mountain dew,75,100,25,2,00159,India
980480,2023-05-06,212,amul cheese,250,315,65,1,00159,India
565719,2023-05-06,208,sprite,75,100,25,2,00064,India
565719,2023-05-06,205,classic yogurt,45,60,15,2,00064,India
745990,2023-05-06,202,milk,12,27,15,1,00252,India
745990,2023-05-06,209,pepsi,75,100,25,2,00252,India
745990,2023-05-06,213,bisleri,6,15,9,2,00252,India
654335,2023-05-06,211,red bull,90,125,35,2,00436,India
654335,2023-05-06,212,amul cheese,250,315,65,1,00436,India
580896,2023-05-06,204,strawberry yogurt,50,60,10,2,00119,India
580896,2023-05-06,212,amul cheese,250,315,65,1,00119,India
401910,2023-05-06,208,sprite,75,100,25,2,00243,India
401910,2023-05-06,203,mango yogurt,50,60,10,2,00243,India
261369,2023-05-06,207,coca cola,75,100,25,2,00128,India
261369,2023-05-06,202,milk,12,27,15,1,00128,India
261369,2023-05-06,210,mountain dew,75,100,25,2,00128,India
261369,2023-05-06,208,sprite,75,100,25,2,00128,India
261369,2023-05-06,205,classic yogurt,45,60,15,2,00128,India
744512,2023-05-06,207,coca cola,75,100,25,2,00126,India
744512,2023-05-06,211,red bull,90,125,35,2,00126,India
270793,2023-05-06,201,paneer,210,340,130,1,00067,India
270793,2023-05-06,207,coca cola,75,100,25,2,00067,India
270793,2023-05-06,204,strawberry yogurt,50,60,10,2,00067,India
622866,2023-05-06,212,amul cheese,250,315,65,1,00333,India
622866,2023-05-06,203,mango yogurt,50,60,10,2,00333,India
622866,2023-05-06,211,red bull,90,125,35,2,00333,India
622866,2023-05-06,201,paneer,210,340,130,1,00333,India
622866,2023-05-06,204,strawberry yogurt,50,60,10,2,00333,India
983237,2023-05-06,210,mountain dew,75,100,25,2,00173,India
983237,2023-05-06,208,sprite,75,100,25,2,00173,India
983237,2023-05-06,211,red bull,90,125,35,2,00173,India
983237,2023-05-06,213,bisleri,6,15,9,2,00173,India
503525,2023-05-06,206,yakult,360,400,40,2,00204,India
503525,2023-05-06,203,mango yogurt,50,60,10,2,00204,India
503525,2023-05-06,209,pepsi,75,100,25,2,00204,India
503525,2023-05-06,213,bisleri,6,15,9,2,00204,India
313078,2023-05-06,208,sprite,75,100,25,2,00170,India
313078,2023-05-06,201,paneer,210,340,130,1,00170,India
313078,2023-05-06,211,red bull,90,125,35,2,00170,India
313078,2023-05-06,204,strawberry yogurt,50,60,10,2,00170,India
379532,2023-05-06,207,coca cola,75,100,25,2,00160,India
379532,2023-05-06,210,mountain dew,75,100,25,2,00160,India
379532,2023-05-06,213,bisleri,6,15,9,2,00160,India
957563,2023-05-06,207,coca cola,75,100,25,2,00404,India
632154,2023-05-06,203,mango yogurt,50,60,10,2,00206,India
104144,2023-05-06,201,paneer,210,340,130,1,00173,India
988662,2023-05-06,202,milk,12,27,15,1,00031,India
988662,2023-05-06,205,classic yogurt,45,60,15,2,00031,India
241747,2023-05-06,210,mountain dew,75,100,25,2,00176,India
241747,2023-05-06,213,bisleri,6,15,9,2,00176,India
241747,2023-05-06,208,sprite,75,100,25,2,00176,India
241747,2023-05-06,204,strawberry yogurt,50,60,10,2,00176,India
227235,2023-05-06,201,paneer,210,340,130,1,00381,India
227235,2023-05-06,210,mountain dew,75,100,25,2,00381,India
227235,2023-05-06,206,yakult,360,400,40,2,00381,India
772300,2023-05-06,207,coca cola,75,100,25,2,00333,India
772300,2023-05-06,205,classic yogurt,45,60,15,2,00333,India
740741,2023-05-06,213,bisleri,6,15,9,2,00091,India
740741,2023-05-06,208,sprite,75,100,25,2,00091,India
740741,2023-05-06,202,milk,12,27,15,1,00091,India
477192,2023-05-06,201,paneer,210,340,130,1,00017,India
743680,2023-05-06,210,mountain dew,75,100,25,2,00095,India
743680,2023-05-06,209,pepsi,75,100,25,2,00095,India
743680,2023-05-06,208,sprite,75,100,25,2,00095,India
978926,2023-05-06,213,bisleri,6,15,9,2,00209,India
978926,2023-05-06,204,strawberry yogurt,50,60,10,2,00209,India
978926,2023-05-06,212,amul cheese,250,315,65,1,00209,India
978926,2023-05-06,208,sprite,75,100,25,2,00209,India
978926,2023-05-06,205,classic yogurt,45,60,15,2,00209,India
950062,2023-05-06,206,yakult,360,400,40,2,00278,India
950062,2023-05-06,208,sprite,75,100,25,2,00278,India
950062,2023-05-06,209,pepsi,75,100,25,2,00278,India
950062,2023-05-06,201,paneer,210,340,130,1,00278,India
287842,2023-05-06,213,bisleri,6,15,9,2,00011,India
287842,2023-05-06,208,sprite,75,100,25,2,00011,India
287842,2023-05-06,206,yakult,360,400,40,2,00011,India
287842,2023-05-06,205,classic yogurt,45,60,15,2,00011,India
397055,2023-05-06,208,sprite,75,100,25,2,00476,India
397055,2023-05-06,202,milk,12,27,15,1,00476,India
397055,2023-05-06,213,bisleri,6,15,9,2,00476,India
397055,2023-05-06,201,paneer,210,340,130,1,00476,India
731466,2023-05-06,203,mango yogurt,50,60,10,2,00452,India
532046,2023-05-06,201,paneer,210,340,130,1,00035,India
532046,2023-05-06,205,classic yogurt,45,60,15,2,00035,India
532046,2023-05-06,203,mango yogurt,50,60,10,2,00035,India
455378,2023-05-06,209,pepsi,75,100,25,2,00278,India
455378,2023-05-06,203,mango yogurt,50,60,10,2,00278,India
455378,2023-05-06,205,classic yogurt,45,60,15,2,00278,India
455378,2023-05-06,202,milk,12,27,15,1,00278,India
740735,2023-05-06,202,milk,12,27,15,1,00055,India
769552,2023-05-06,213,bisleri,6,15,9,2,00500,India
769552,2023-05-06,201,paneer,210,340,130,1,00500,India
769552,2023-05-06,211,red bull,90,125,35,2,00500,India
769552,2023-05-06,202,milk,12,27,15,1,00500,India
149118,2023-05-06,211,red bull,90,125,35,2,00235,India
149118,2023-05-06,202,milk,12,27,15,1,00235,India
149118,2023-05-06,205,classic yogurt,45,60,15,2,00235,India
897854,2023-05-06,209,pepsi,75,100,25,2,00242,India
897854,2023-05-06,201,paneer,210,340,130,1,00242,India
804532,2023-05-06,210,mountain dew,75,100,25,2,00246,India
804532,2023-05-06,208,sprite,75,100,25,2,00246,India
804532,2023-05-06,205,classic yogurt,45,60,15,2,00246,India
804532,2023-05-06,202,milk,12,27,15,1,00246,India
382432,2023-05-06,204,strawberry yogurt,50,60,10,2,00355,India
382432,2023-05-06,201,paneer,210,340,130,1,00355,India
382432,2023-05-06,207,coca cola,75,100,25,2,00355,India
382432,2023-05-06,213,bisleri,6,15,9,2,00355,India
192776,2023-05-06,204,strawberry yogurt,50,60,10,2,00320,India
278839,2023-05-06,207,coca cola,75,100,25,2,00436,India
278839,2023-05-06,213,bisleri,6,15,9,2,00436,India
278839,2023-05-06,205,classic yogurt,45,60,15,2,00436,India
678916,2023-05-06,210,mountain dew,75,100,25,2,00474,India
678916,2023-05-06,201,paneer,210,340,130,1,00474,India
678916,2023-05-06,205,classic yogurt,45,60,15,2,00474,India
133637,2023-05-06,213,bisleri,6,15,9,2,00471,India
297211,2023-05-06,206,yakult,360,400,40,2,00093,India
297211,2023-05-06,208,sprite,75,100,25,2,00093,India
267760,2023-05-06,206,yakult,360,400,40,2,00488,India
267760,2023-05-06,212,amul cheese,250,315,65,1,00488,India
267760,2023-05-06,204,strawberry yogurt,50,60,10,2,00488,India
532067,2023-05-06,202,milk,12,27,15,1,00318,India
532067,2023-05-06,212,amul cheese,250,315,65,1,00318,India
532067,2023-05-06,209,pepsi,75,100,25,2,00318,India
581376,2023-05-06,204,strawberry yogurt,50,60,10,2,00437,India
581376,2023-05-06,211,red bull,90,125,35,2,00437,India
581376,2023-05-06,202,milk,12,27,15,1,00437,India
581376,2023-05-06,207,coca cola,75,100,25,2,00437,India
581376,2023-05-06,210,mountain dew,75,100,25,2,00437,India
658824,2023-05-06,206,yakult,360,400,40,2,00054,India
658824,2023-05-06,212,amul cheese,250,315,65,1,00054,India
658824,2023-05-06,209,pepsi,75,100,25,2,00054,India
658824,2023-05-06,202,milk,12,27,15,1,00054,India
230179,2023-05-06,213,bisleri,6,15,9,2,00457,India
230179,2023-05-06,203,mango yogurt,50,60,10,2,00457,India
230179,2023-05-06,209,pepsi,75,100,25,2,00457,India
645195,2023-05-06,204,strawberry yogurt,50,60,10,2,00085,India
511276,2023-05-06,207,coca cola,75,100,25,2,00070,India
511276,2023-05-06,212,amul cheese,250,315,65,1,00070,India
511276,2023-05-06,213,bisleri,6,15,9,2,00070,India
511276,2023-05-06,204,strawberry yogurt,50,60,10,2,00070,India
525985,2023-05-06,213,bisleri,6,15,9,2,00339,India
525985,2023-05-06,209,pepsi,75,100,25,2,00339,India
399863,2023-05-06,208,sprite,75,100,25,2,00414,India
782746,2023-05-06,212,amul cheese,250,315,65,1,00442,India
759269,2023-05-06,213,bisleri,6,15,9,2,00395,India
759269,2023-05-06,207,coca cola,75,100,25,2,00395,India
759269,2023-05-06,201,paneer,210,340,130,1,00395,India
759269,2023-05-06,204,strawberry yogurt,50,60,10,2,00395,India
759269,2023-05-06,212,amul cheese,250,315,65,1,00395,India
537523,2023-05-06,213,bisleri,6,15,9,2,00227,India
537523,2023-05-06,202,milk,12,27,15,1,00227,India
537523,2023-05-06,209,pepsi,75,100,25,2,00227,India
537523,2023-05-06,212,amul cheese,250,315,65,1,00227,India
460369,2023-05-06,208,sprite,75,100,25,2,00452,India
690147,2023-05-06,206,yakult,360,400,40,2,00434,India
725110,2023-05-06,205,classic yogurt,45,60,15,2,00295,India
725110,2023-05-06,202,milk,12,27,15,1,00295,India
725110,2023-05-06,211,red bull,90,125,35,2,00295,India
793073,2023-05-06,209,pepsi,75,100,25,2,00456,India
793073,2023-05-06,206,yakult,360,400,40,2,00456,India
793073,2023-05-06,205,classic yogurt,45,60,15,2,00456,India
793073,2023-05-06,212,amul cheese,250,315,65,1,00456,India
828098,2023-05-06,205,classic yogurt,45,60,15,2,00388,India
828098,2023-05-06,208,sprite,75,100,25,2,00388,India
828098,2023-05-06,201,paneer,210,340,130,1,00388,India
828098,2023-05-06,206,yakult,360,400,40,2,00388,India
993867,2023-05-06,202,milk,12,27,15,1,00202,India
993867,2023-05-06,207,coca cola,75,100,25,2,00202,India
257110,2023-05-06,208,sprite,75,100,25,2,00213,India
257110,2023-05-06,212,amul cheese,250,315,65,1,00213,India
257110,2023-05-06,205,classic yogurt,45,60,15,2,00213,India
257110,2023-05-06,203,mango yogurt,50,60,10,2,00213,India
782211,2023-05-06,213,bisleri,6,15,9,2,00228,India
782211,2023-05-06,207,coca cola,75,100,25,2,00228,India
782211,2023-05-06,212,amul cheese,250,315,65,1,00228,India
782211,2023-05-06,202,milk,12,27,15,1,00228,India
414892,2023-05-06,203,mango yogurt,50,60,10,2,00051,India
883595,2023-05-06,210,mountain dew,75,100,25,2,00275,India
883595,2023-05-06,212,amul cheese,250,315,65,1,00275,India
883595,2023-05-06,213,bisleri,6,15,9,2,00275,India
883595,2023-05-06,206,yakult,360,400,40,2,00275,India
771416,2023-05-07,205,classic yogurt,45,60,15,2,00050,India
771416,2023-05-07,213,bisleri,6,15,9,2,00050,India
771416,2023-05-07,201,paneer,210,340,130,1,00050,India
771416,2023-05-07,203,mango yogurt,50,60,10,2,00050,India
771416,2023-05-07,207,coca cola,75,100,25,2,00050,India
989953,2023-05-07,212,amul cheese,250,315,65,1,00226,India
989953,2023-05-07,206,yakult,360,400,40,2,00226,India
989953,2023-05-07,203,mango yogurt,50,60,10,2,00226,India
989953,2023-05-07,213,bisleri,6,15,9,2,00226,India
863993,2023-05-07,212,amul cheese,250,315,65,1,00379,India
863993,2023-05-07,211,red bull,90,125,35,2,00379,India
676573,2023-05-07,202,milk,12,27,15,1,00155,India
676573,2023-05-07,203,mango yogurt,50,60,10,2,00155,India
676573,2023-05-07,213,bisleri,6,15,9,2,00155,India
676573,2023-05-07,211,red bull,90,125,35,2,00155,India
688054,2023-05-07,206,yakult,360,400,40,2,00496,India
688054,2023-05-07,213,bisleri,6,15,9,2,00496,India
688054,2023-05-07,209,pepsi,75,100,25,2,00496,India
688054,2023-05-07,204,strawberry yogurt,50,60,10,2,00496,India
706059,2023-05-07,207,coca cola,75,100,25,2,00376,India
706059,2023-05-07,205,classic yogurt,45,60,15,2,00376,India
706059,2023-05-07,203,mango yogurt,50,60,10,2,00376,India
380859,2023-05-07,206,yakult,360,400,40,2,00015,India
380859,2023-05-07,213,bisleri,6,15,9,2,00015,India
380859,2023-05-07,210,mountain dew,75,100,25,2,00015,India
414596,2023-05-07,212,amul cheese,250,315,65,1,00369,India
414596,2023-05-07,203,mango yogurt,50,60,10,2,00369,India
414596,2023-05-07,204,strawberry yogurt,50,60,10,2,00369,India
414596,2023-05-07,207,coca cola,75,100,25,2,00369,India
155287,2023-05-07,202,milk,12,27,15,1,00043,India
155287,2023-05-07,207,coca cola,75,100,25,2,00043,India
316446,2023-05-07,204,strawberry yogurt,50,60,10,2,00083,India
316446,2023-05-07,208,sprite,75,100,25,2,00083,India
904753,2023-05-07,201,paneer,210,340,130,1,00257,India
904753,2023-05-07,210,mountain dew,75,100,25,2,00257,India
904753,2023-05-07,202,milk,12,27,15,1,00257,India
904753,2023-05-07,205,classic yogurt,45,60,15,2,00257,India
124411,2023-05-07,203,mango yogurt,50,60,10,2,00039,India
124411,2023-05-07,208,sprite,75,100,25,2,00039,India
124411,2023-05-07,210,mountain dew,75,100,25,2,00039,India
124411,2023-05-07,202,milk,12,27,15,1,00039,India
124411,2023-05-07,201,paneer,210,340,130,1,00039,India
341998,2023-05-07,213,bisleri,6,15,9,2,00207,India
341998,2023-05-07,203,mango yogurt,50,60,10,2,00207,India
341998,2023-05-07,212,amul cheese,250,315,65,1,00207,India
341998,2023-05-07,204,strawberry yogurt,50,60,10,2,00207,India
388909,2023-05-07,206,yakult,360,400,40,2,00194,India
976217,2023-05-07,206,yakult,360,400,40,2,00219,India
619232,2023-05-07,207,coca cola,75,100,25,2,00261,India
619232,2023-05-07,209,pepsi,75,100,25,2,00261,India
687399,2023-05-07,209,pepsi,75,100,25,2,00103,India
588167,2023-05-07,201,paneer,210,340,130,1,00318,India
588167,2023-05-07,211,red bull,90,125,35,2,00318,India
588167,2023-05-07,208,sprite,75,100,25,2,00318,India
536458,2023-05-07,207,coca cola,75,100,25,2,00028,India
593874,2023-05-07,202,milk,12,27,15,1,00460,India
593874,2023-05-07,209,pepsi,75,100,25,2,00460,India
593874,2023-05-07,205,classic yogurt,45,60,15,2,00460,India
813711,2023-05-07,206,yakult,360,400,40,2,00109,India
633594,2023-05-07,210,mountain dew,75,100,25,2,00408,India
108808,2023-05-07,208,sprite,75,100,25,2,00320,India
108808,2023-05-07,213,bisleri,6,15,9,2,00320,India
158343,2023-05-07,206,yakult,360,400,40,2,00385,India
307665,2023-05-07,208,sprite,75,100,25,2,00179,India
307665,2023-05-07,202,milk,12,27,15,1,00179,India
307665,2023-05-07,212,amul cheese,250,315,65,1,00179,India
307665,2023-05-07,203,mango yogurt,50,60,10,2,00179,India
307665,2023-05-07,201,paneer,210,340,130,1,00179,India
450083,2023-05-07,208,sprite,75,100,25,2,00399,India
269650,2023-05-07,203,mango yogurt,50,60,10,2,00156,India
269650,2023-05-07,205,classic yogurt,45,60,15,2,00156,India
351030,2023-05-07,201,paneer,210,340,130,1,00098,India
351030,2023-05-07,206,yakult,360,400,40,2,00098,India
794849,2023-05-07,201,paneer,210,340,130,1,00142,India
794849,2023-05-07,203,mango yogurt,50,60,10,2,00142,India
802091,2023-05-07,208,sprite,75,100,25,2,00394,India
802091,2023-05-07,203,mango yogurt,50,60,10,2,00394,India
163633,2023-05-07,204,strawberry yogurt,50,60,10,2,00319,India
163633,2023-05-07,203,mango yogurt,50,60,10,2,00319,India
163633,2023-05-07,212,amul cheese,250,315,65,1,00319,India
163633,2023-05-07,205,classic yogurt,45,60,15,2,00319,India
437822,2023-05-07,202,milk,12,27,15,1,00249,India
437822,2023-05-07,213,bisleri,6,15,9,2,00249,India
865157,2023-05-07,203,mango yogurt,50,60,10,2,00452,India
865157,2023-05-07,208,sprite,75,100,25,2,00452,India
331207,2023-05-07,211,red bull,90,125,35,2,00325,India
331207,2023-05-07,202,milk,12,27,15,1,00325,India
331207,2023-05-07,208,sprite,75,100,25,2,00325,India
331207,2023-05-07,205,classic yogurt,45,60,15,2,00325,India
969400,2023-05-07,206,yakult,360,400,40,2,00098,India
969400,2023-05-07,210,mountain dew,75,100,25,2,00098,India
969400,2023-05-07,202,milk,12,27,15,1,00098,India
840643,2023-05-07,213,bisleri,6,15,9,2,00137,India
840643,2023-05-07,212,amul cheese,250,315,65,1,00137,India
637665,2023-05-07,210,mountain dew,75,100,25,2,00369,India
781068,2023-05-07,207,coca cola,75,100,25,2,00140,India
781068,2023-05-07,209,pepsi,75,100,25,2,00140,India
781068,2023-05-07,201,paneer,210,340,130,1,00140,India
781068,2023-05-07,210,mountain dew,75,100,25,2,00140,India
867758,2023-05-07,212,amul cheese,250,315,65,1,00464,India
867758,2023-05-07,203,mango yogurt,50,60,10,2,00464,India
867758,2023-05-07,208,sprite,75,100,25,2,00464,India
687791,2023-05-07,205,classic yogurt,45,60,15,2,00474,India
687791,2023-05-07,206,yakult,360,400,40,2,00474,India
687791,2023-05-07,203,mango yogurt,50,60,10,2,00474,India
731087,2023-05-07,212,amul cheese,250,315,65,1,00498,India
731087,2023-05-07,204,strawberry yogurt,50,60,10,2,00498,India
731087,2023-05-07,201,paneer,210,340,130,1,00498,India
731087,2023-05-07,211,red bull,90,125,35,2,00498,India
374775,2023-05-07,208,sprite,75,100,25,2,00312,India
374775,2023-05-07,202,milk,12,27,15,1,00312,India
374775,2023-05-07,205,classic yogurt,45,60,15,2,00312,India
374775,2023-05-07,209,pepsi,75,100,25,2,00312,India
878271,2023-05-07,208,sprite,75,100,25,2,00094,India
878271,2023-05-07,203,mango yogurt,50,60,10,2,00094,India
878271,2023-05-07,206,yakult,360,400,40,2,00094,India
878271,2023-05-07,213,bisleri,6,15,9,2,00094,India
878271,2023-05-07,211,red bull,90,125,35,2,00094,India
521314,2023-05-07,204,strawberry yogurt,50,60,10,2,00177,India
299006,2023-05-07,208,sprite,75,100,25,2,00062,India
299006,2023-05-07,205,classic yogurt,45,60,15,2,00062,India
299006,2023-05-07,204,strawberry yogurt,50,60,10,2,00062,India
713456,2023-05-07,205,classic yogurt,45,60,15,2,00316,India
713456,2023-05-07,207,coca cola,75,100,25,2,00316,India
713456,2023-05-07,206,yakult,360,400,40,2,00316,India
710863,2023-05-07,212,amul cheese,250,315,65,1,00082,India
710863,2023-05-07,211,red bull,90,125,35,2,00082,India
711396,2023-05-07,210,mountain dew,75,100,25,2,00155,India
133385,2023-05-07,208,sprite,75,100,25,2,00363,India
133385,2023-05-07,202,milk,12,27,15,1,00363,India
133385,2023-05-07,212,amul cheese,250,315,65,1,00363,India
133385,2023-05-07,204,strawberry yogurt,50,60,10,2,00363,India
831344,2023-05-07,210,mountain dew,75,100,25,2,00125,India
868055,2023-05-07,203,mango yogurt,50,60,10,2,00387,India
868055,2023-05-07,209,pepsi,75,100,25,2,00387,India
868055,2023-05-07,207,coca cola,75,100,25,2,00387,India
888667,2023-05-07,203,mango yogurt,50,60,10,2,00168,India
888667,2023-05-07,210,mountain dew,75,100,25,2,00168,India
888667,2023-05-07,209,pepsi,75,100,25,2,00168,India
945435,2023-05-07,209,pepsi,75,100,25,2,00250,India
945435,2023-05-07,211,red bull,90,125,35,2,00250,India
338320,2023-05-07,204,strawberry yogurt,50,60,10,2,00219,India
338320,2023-05-07,206,yakult,360,400,40,2,00219,India
782492,2023-05-07,212,amul cheese,250,315,65,1,00460,India
999718,2023-05-07,204,strawberry yogurt,50,60,10,2,00155,India
864994,2023-05-07,210,mountain dew,75,100,25,2,00309,India
864994,2023-05-07,212,amul cheese,250,315,65,1,00309,India
864994,2023-05-07,203,mango yogurt,50,60,10,2,00309,India
249583,2023-05-07,209,pepsi,75,100,25,2,00270,India
249583,2023-05-07,212,amul cheese,250,315,65,1,00270,India
249583,2023-05-07,206,yakult,360,400,40,2,00270,India
364348,2023-05-07,207,coca cola,75,100,25,2,00437,India
364348,2023-05-07,206,yakult,360,400,40,2,00437,India
364348,2023-05-07,204,strawberry yogurt,50,60,10,2,00437,India
556592,2023-05-07,204,strawberry yogurt,50,60,10,2,00440,India
556592,2023-05-07,207,coca cola,75,100,25,2,00440,India
556592,2023-05-07,211,red bull,90,125,35,2,00440,India
556592,2023-05-07,208,sprite,75,100,25,2,00440,India
190151,2023-05-07,213,bisleri,6,15,9,2,00282,India
190151,2023-05-07,211,red bull,90,125,35,2,00282,India
190151,2023-05-07,212,amul cheese,250,315,65,1,00282,India
245223,2023-05-07,201,paneer,210,340,130,1,00245,India
245223,2023-05-07,205,classic yogurt,45,60,15,2,00245,India
838928,2023-05-07,204,strawberry yogurt,50,60,10,2,00101,India
578147,2023-05-07,208,sprite,75,100,25,2,00345,India
578147,2023-05-07,210,mountain dew,75,100,25,2,00345,India
578147,2023-05-07,203,mango yogurt,50,60,10,2,00345,India
605035,2023-05-07,213,bisleri,6,15,9,2,00007,India
605035,2023-05-07,205,classic yogurt,45,60,15,2,00007,India
605035,2023-05-07,201,paneer,210,340,130,1,00007,India
605035,2023-05-07,212,amul cheese,250,315,65,1,00007,India
875820,2023-05-07,202,milk,12,27,15,1,00017,India
333732,2023-05-07,202,milk,12,27,15,1,00371,India
333732,2023-05-07,212,amul cheese,250,315,65,1,00371,India
333732,2023-05-07,208,sprite,75,100,25,2,00371,India
499370,2023-05-07,204,strawberry yogurt,50,60,10,2,00440,India
499370,2023-05-07,202,milk,12,27,15,1,00440,India
499370,2023-05-07,211,red bull,90,125,35,2,00440,India
858422,2023-05-07,213,bisleri,6,15,9,2,00252,India
858422,2023-05-07,204,strawberry yogurt,50,60,10,2,00252,India
858422,2023-05-07,212,amul cheese,250,315,65,1,00252,India
858422,2023-05-07,205,classic yogurt,45,60,15,2,00252,India
525434,2023-05-07,206,yakult,360,400,40,2,00015,India
525434,2023-05-07,202,milk,12,27,15,1,00015,India
525434,2023-05-07,208,sprite,75,100,25,2,00015,India
525434,2023-05-07,201,paneer,210,340,130,1,00015,India
252708,2023-05-07,207,coca cola,75,100,25,2,00172,India
252708,2023-05-07,202,milk,12,27,15,1,00172,India
645934,2023-05-07,211,red bull,90,125,35,2,00371,India
645934,2023-05-07,208,sprite,75,100,25,2,00371,India
645934,2023-05-07,207,coca cola,75,100,25,2,00371,India
645934,2023-05-07,212,amul cheese,250,315,65,1,00371,India
520328,2023-05-07,211,red bull,90,125,35,2,00301,India
520328,2023-05-07,208,sprite,75,100,25,2,00301,India
520328,2023-05-07,202,milk,12,27,15,1,00301,India
212062,2023-05-07,207,coca cola,75,100,25,2,00149,India
212062,2023-05-07,202,milk,12,27,15,1,00149,India
212062,2023-05-07,205,classic yogurt,45,60,15,2,00149,India
215439,2023-05-07,204,strawberry yogurt,50,60,10,2,00250,India
215439,2023-05-07,210,mountain dew,75,100,25,2,00250,India
215439,2023-05-07,205,classic yogurt,45,60,15,2,00250,India
215439,2023-05-07,207,coca cola,75,100,25,2,00250,India
344586,2023-05-07,202,milk,12,27,15,1,00043,India
344586,2023-05-07,203,mango yogurt,50,60,10,2,00043,India
729276,2023-05-07,213,bisleri,6,15,9,2,00199,India
729276,2023-05-07,211,red bull,90,125,35,2,00199,India
954682,2023-05-07,203,mango yogurt,50,60,10,2,00301,India
954682,2023-05-07,209,pepsi,75,100,25,2,00301,India
954682,2023-05-07,202,milk,12,27,15,1,00301,India
954682,2023-05-07,212,amul cheese,250,315,65,1,00301,India
954682,2023-05-07,206,yakult,360,400,40,2,00301,India
788521,2023-05-08,211,red bull,90,125,35,2,00021,India
788521,2023-05-08,203,mango yogurt,50,60,10,2,00021,India
788521,2023-05-08,205,classic yogurt,45,60,15,2,00021,India
788521,2023-05-08,210,mountain dew,75,100,25,2,00021,India
188912,2023-05-08,211,red bull,90,125,35,2,00285,India
188912,2023-05-08,207,coca cola,75,100,25,2,00285,India
188912,2023-05-08,208,sprite,75,100,25,2,00285,India
188912,2023-05-08,213,bisleri,6,15,9,2,00285,India
306806,2023-05-08,210,mountain dew,75,100,25,2,00213,India
306806,2023-05-08,202,milk,12,27,15,1,00213,India
989759,2023-05-08,203,mango yogurt,50,60,10,2,00425,India
989759,2023-05-08,201,paneer,210,340,130,1,00425,India
154951,2023-05-08,212,amul cheese,250,315,65,1,00369,India
214970,2023-05-08,209,pepsi,75,100,25,2,00036,India
214970,2023-05-08,211,red bull,90,125,35,2,00036,India
214970,2023-05-08,205,classic yogurt,45,60,15,2,00036,India
214970,2023-05-08,207,coca cola,75,100,25,2,00036,India
464952,2023-05-08,202,milk,12,27,15,1,00096,India
464952,2023-05-08,206,yakult,360,400,40,2,00096,India
464952,2023-05-08,205,classic yogurt,45,60,15,2,00096,India
464952,2023-05-08,203,mango yogurt,50,60,10,2,00096,India
458683,2023-05-08,207,coca cola,75,100,25,2,00072,India
458683,2023-05-08,213,bisleri,6,15,9,2,00072,India
458683,2023-05-08,202,milk,12,27,15,1,00072,India
458683,2023-05-08,206,yakult,360,400,40,2,00072,India
458683,2023-05-08,204,strawberry yogurt,50,60,10,2,00072,India
555840,2023-05-08,213,bisleri,6,15,9,2,00200,India
804647,2023-05-08,206,yakult,360,400,40,2,00141,India
320462,2023-05-08,213,bisleri,6,15,9,2,00228,India
320462,2023-05-08,202,milk,12,27,15,1,00228,India
320462,2023-05-08,203,mango yogurt,50,60,10,2,00228,India
320462,2023-05-08,204,strawberry yogurt,50,60,10,2,00228,India
320462,2023-05-08,205,classic yogurt,45,60,15,2,00228,India
404066,2023-05-08,211,red bull,90,125,35,2,00215,India
404066,2023-05-08,208,sprite,75,100,25,2,00215,India
404066,2023-05-08,202,milk,12,27,15,1,00215,India
100603,2023-05-08,207,coca cola,75,100,25,2,00393,India
100603,2023-05-08,211,red bull,90,125,35,2,00393,India
100603,2023-05-08,205,classic yogurt,45,60,15,2,00393,India
100603,2023-05-08,208,sprite,75,100,25,2,00393,India
448946,2023-05-08,203,mango yogurt,50,60,10,2,00345,India
448946,2023-05-08,208,sprite,75,100,25,2,00345,India
379172,2023-05-08,213,bisleri,6,15,9,2,00351,India
379172,2023-05-08,206,yakult,360,400,40,2,00351,India
379172,2023-05-08,207,coca cola,75,100,25,2,00351,India
673138,2023-05-08,204,strawberry yogurt,50,60,10,2,00245,India
673138,2023-05-08,209,pepsi,75,100,25,2,00245,India
673138,2023-05-08,207,coca cola,75,100,25,2,00245,India
893394,2023-05-08,207,coca cola,75,100,25,2,00484,India
893394,2023-05-08,201,paneer,210,340,130,1,00484,India
893394,2023-05-08,211,red bull,90,125,35,2,00484,India
893394,2023-05-08,204,strawberry yogurt,50,60,10,2,00484,India
962986,2023-05-08,201,paneer,210,340,130,1,00313,India
962986,2023-05-08,210,mountain dew,75,100,25,2,00313,India
962986,2023-05-08,202,milk,12,27,15,1,00313,India
962986,2023-05-08,209,pepsi,75,100,25,2,00313,India
256174,2023-05-08,213,bisleri,6,15,9,2,00053,India
256174,2023-05-08,203,mango yogurt,50,60,10,2,00053,India
501057,2023-05-08,212,amul cheese,250,315,65,1,00340,India
501057,2023-05-08,205,classic yogurt,45,60,15,2,00340,India
870681,2023-05-08,206,yakult,360,400,40,2,00331,India
870681,2023-05-08,204,strawberry yogurt,50,60,10,2,00331,India
430207,2023-05-08,208,sprite,75,100,25,2,00334,India
430207,2023-05-08,207,coca cola,75,100,25,2,00334,India
430207,2023-05-08,210,mountain dew,75,100,25,2,00334,India
512072,2023-05-08,211,red bull,90,125,35,2,00256,India
512072,2023-05-08,204,strawberry yogurt,50,60,10,2,00256,India
550901,2023-05-08,209,pepsi,75,100,25,2,00338,India
550901,2023-05-08,206,yakult,360,400,40,2,00338,India
832366,2023-05-08,201,paneer,210,340,130,1,00335,India
832366,2023-05-08,209,pepsi,75,100,25,2,00335,India
231132,2023-05-08,210,mountain dew,75,100,25,2,00263,India
231132,2023-05-08,212,amul cheese,250,315,65,1,00263,India
248706,2023-05-08,202,milk,12,27,15,1,00020,India
248706,2023-05-08,212,amul cheese,250,315,65,1,00020,India
248706,2023-05-08,210,mountain dew,75,100,25,2,00020,India
248706,2023-05-08,201,paneer,210,340,130,1,00020,India
248706,2023-05-08,206,yakult,360,400,40,2,00020,India
116668,2023-05-08,207,coca cola,75,100,25,2,00029,India
328858,2023-05-08,202,milk,12,27,15,1,00216,India
328858,2023-05-08,209,pepsi,75,100,25,2,00216,India
328858,2023-05-08,208,sprite,75,100,25,2,00216,India
328858,2023-05-08,203,mango yogurt,50,60,10,2,00216,India
541727,2023-05-08,208,sprite,75,100,25,2,00282,India
541727,2023-05-08,212,amul cheese,250,315,65,1,00282,India
541727,2023-05-08,205,classic yogurt,45,60,15,2,00282,India
541727,2023-05-08,209,pepsi,75,100,25,2,00282,India
541727,2023-05-08,210,mountain dew,75,100,25,2,00282,India
632078,2023-05-08,213,bisleri,6,15,9,2,00405,India
632078,2023-05-08,211,red bull,90,125,35,2,00405,India
632078,2023-05-08,208,sprite,75,100,25,2,00405,India
632078,2023-05-08,201,paneer,210,340,130,1,00405,India
662936,2023-05-08,209,pepsi,75,100,25,2,00054,India
662936,2023-05-08,211,red bull,90,125,35,2,00054,India
662936,2023-05-08,202,milk,12,27,15,1,00054,India
299488,2023-05-08,202,milk,12,27,15,1,00275,India
299488,2023-05-08,210,mountain dew,75,100,25,2,00275,India
299488,2023-05-08,203,mango yogurt,50,60,10,2,00275,India
299488,2023-05-08,212,amul cheese,250,315,65,1,00275,India
299488,2023-05-08,211,red bull,90,125,35,2,00275,India
522795,2023-05-08,204,strawberry yogurt,50,60,10,2,00224,India
522795,2023-05-08,210,mountain dew,75,100,25,2,00224,India
326080,2023-05-08,206,yakult,360,400,40,2,00466,India
326080,2023-05-08,202,milk,12,27,15,1,00466,India
950777,2023-05-08,210,mountain dew,75,100,25,2,00241,India
950777,2023-05-08,201,paneer,210,340,130,1,00241,India
950777,2023-05-08,206,yakult,360,400,40,2,00241,India
950777,2023-05-08,212,amul cheese,250,315,65,1,00241,India
312836,2023-05-08,207,coca cola,75,100,25,2,00039,India
312836,2023-05-08,204,strawberry yogurt,50,60,10,2,00039,India
312836,2023-05-08,205,classic yogurt,45,60,15,2,00039,India
312836,2023-05-08,206,yakult,360,400,40,2,00039,India
585462,2023-05-08,206,yakult,360,400,40,2,00010,India
585462,2023-05-08,205,classic yogurt,45,60,15,2,00010,India
585462,2023-05-08,209,pepsi,75,100,25,2,00010,India
585462,2023-05-08,208,sprite,75,100,25,2,00010,India
997280,2023-05-08,209,pepsi,75,100,25,2,00188,India
997280,2023-05-08,202,milk,12,27,15,1,00188,India
997280,2023-05-08,212,amul cheese,250,315,65,1,00188,India
293262,2023-05-08,204,strawberry yogurt,50,60,10,2,00177,India
293262,2023-05-08,212,amul cheese,250,315,65,1,00177,India
293262,2023-05-08,206,yakult,360,400,40,2,00177,India
175836,2023-05-08,213,bisleri,6,15,9,2,00132,India
175836,2023-05-08,207,coca cola,75,100,25,2,00132,India
175836,2023-05-08,210,mountain dew,75,100,25,2,00132,India
175836,2023-05-08,212,amul cheese,250,315,65,1,00132,India
175836,2023-05-08,202,milk,12,27,15,1,00132,India
357028,2023-05-08,207,coca cola,75,100,25,2,00412,India
357028,2023-05-08,209,pepsi,75,100,25,2,00412,India
844831,2023-05-08,213,bisleri,6,15,9,2,00126,India
844831,2023-05-08,212,amul cheese,250,315,65,1,00126,India
844831,2023-05-08,209,pepsi,75,100,25,2,00126,India
741144,2023-05-08,210,mountain dew,75,100,25,2,00066,India
966988,2023-05-08,213,bisleri,6,15,9,2,00040,India
790872,2023-05-08,205,classic yogurt,45,60,15,2,00071,India
790872,2023-05-08,203,mango yogurt,50,60,10,2,00071,India
785949,2023-05-08,206,yakult,360,400,40,2,00373,India
785949,2023-05-08,211,red bull,90,125,35,2,00373,India
785949,2023-05-08,202,milk,12,27,15,1,00373,India
785949,2023-05-08,209,pepsi,75,100,25,2,00373,India
785949,2023-05-08,210,mountain dew,75,100,25,2,00373,India
717393,2023-05-08,206,yakult,360,400,40,2,00044,India
127467,2023-05-08,203,mango yogurt,50,60,10,2,00338,India
127467,2023-05-08,205,classic yogurt,45,60,15,2,00338,India
559982,2023-05-08,201,paneer,210,340,130,1,00025,India
857333,2023-05-08,209,pepsi,75,100,25,2,00021,India
857333,2023-05-08,202,milk,12,27,15,1,00021,India
857333,2023-05-08,206,yakult,360,400,40,2,00021,India
671544,2023-05-08,213,bisleri,6,15,9,2,00384,India
671544,2023-05-08,206,yakult,360,400,40,2,00384,India
671544,2023-05-08,204,strawberry yogurt,50,60,10,2,00384,India
379524,2023-05-08,207,coca cola,75,100,25,2,00319,India
523337,2023-05-08,210,mountain dew,75,100,25,2,00012,India
523337,2023-05-08,208,sprite,75,100,25,2,00012,India
523337,2023-05-08,202,milk,12,27,15,1,00012,India
523337,2023-05-08,204,strawberry yogurt,50,60,10,2,00012,India
475388,2023-05-08,213,bisleri,6,15,9,2,00349,India
475388,2023-05-08,206,yakult,360,400,40,2,00349,India
140497,2023-05-08,206,yakult,360,400,40,2,00307,India
140497,2023-05-08,213,bisleri,6,15,9,2,00307,India
216000,2023-05-08,209,pepsi,75,100,25,2,00273,India
718193,2023-05-08,206,yakult,360,400,40,2,00016,India
718193,2023-05-08,204,strawberry yogurt,50,60,10,2,00016,India
963080,2023-05-08,209,pepsi,75,100,25,2,00278,India
963080,2023-05-08,206,yakult,360,400,40,2,00278,India
963080,2023-05-08,213,bisleri,6,15,9,2,00278,India
146806,2023-05-08,206,yakult,360,400,40,2,00277,India
146806,2023-05-08,211,red bull,90,125,35,2,00277,India
146806,2023-05-08,204,strawberry yogurt,50,60,10,2,00277,India
146806,2023-05-08,203,mango yogurt,50,60,10,2,00277,India
612653,2023-05-08,202,milk,12,27,15,1,00175,India
612653,2023-05-08,203,mango yogurt,50,60,10,2,00175,India
851194,2023-05-08,205,classic yogurt,45,60,15,2,00146,India
851194,2023-05-08,204,strawberry yogurt,50,60,10,2,00146,India
851194,2023-05-08,213,bisleri,6,15,9,2,00146,India
540413,2023-05-08,201,paneer,210,340,130,1,00138,India
553683,2023-05-08,212,amul cheese,250,315,65,1,00095,India
553683,2023-05-08,211,red bull,90,125,35,2,00095,India
553683,2023-05-08,204,strawberry yogurt,50,60,10,2,00095,India
553683,2023-05-08,205,classic yogurt,45,60,15,2,00095,India
553683,2023-05-08,213,bisleri,6,15,9,2,00095,India
203104,2023-05-08,210,mountain dew,75,100,25,2,00359,India
203104,2023-05-08,205,classic yogurt,45,60,15,2,00359,India
949675,2023-05-08,213,bisleri,6,15,9,2,00372,India
949675,2023-05-08,201,paneer,210,340,130,1,00372,India
751059,2023-05-08,213,bisleri,6,15,9,2,00367,India
751059,2023-05-08,204,strawberry yogurt,50,60,10,2,00367,India
751059,2023-05-08,209,pepsi,75,100,25,2,00367,India
751059,2023-05-08,202,milk,12,27,15,1,00367,India
751059,2023-05-08,211,red bull,90,125,35,2,00367,India
100332,2023-05-08,207,coca cola,75,100,25,2,00432,India
100332,2023-05-08,202,milk,12,27,15,1,00432,India
100332,2023-05-08,201,paneer,210,340,130,1,00432,India
541028,2023-05-08,202,milk,12,27,15,1,00041,India
541028,2023-05-08,212,amul cheese,250,315,65,1,00041,India
541028,2023-05-08,210,mountain dew,75,100,25,2,00041,India
541028,2023-05-08,204,strawberry yogurt,50,60,10,2,00041,India
788603,2023-05-08,211,red bull,90,125,35,2,00361,India
788603,2023-05-08,213,bisleri,6,15,9,2,00361,India
788603,2023-05-08,201,paneer,210,340,130,1,00361,India
788603,2023-05-08,204,strawberry yogurt,50,60,10,2,00361,India
788603,2023-05-08,208,sprite,75,100,25,2,00361,India
684530,2023-05-08,205,classic yogurt,45,60,15,2,00047,India
684530,2023-05-08,209,pepsi,75,100,25,2,00047,India
684530,2023-05-08,207,coca cola,75,100,25,2,00047,India
443275,2023-05-08,213,bisleri,6,15,9,2,00369,India
443275,2023-05-08,206,yakult,360,400,40,2,00369,India
770876,2023-05-08,210,mountain dew,75,100,25,2,00073,India
770876,2023-05-08,213,bisleri,6,15,9,2,00073,India
770876,2023-05-08,206,yakult,360,400,40,2,00073,India
770876,2023-05-08,205,classic yogurt,45,60,15,2,00073,India
943129,2023-05-09,202,milk,12,27,15,1,00445,India
943129,2023-05-09,209,pepsi,75,100,25,2,00445,India
881209,2023-05-09,211,red bull,90,125,35,2,00325,India
881209,2023-05-09,201,paneer,210,340,130,1,00325,India
517383,2023-05-09,207,coca cola,75,100,25,2,00186,India
517383,2023-05-09,211,red bull,90,125,35,2,00186,India
298692,2023-05-09,205,classic yogurt,45,60,15,2,00459,India
298692,2023-05-09,206,yakult,360,400,40,2,00459,India
298692,2023-05-09,204,strawberry yogurt,50,60,10,2,00459,India
503597,2023-05-09,208,sprite,75,100,25,2,00049,India
503597,2023-05-09,211,red bull,90,125,35,2,00049,India
503597,2023-05-09,203,mango yogurt,50,60,10,2,00049,India
503597,2023-05-09,213,bisleri,6,15,9,2,00049,India
513725,2023-05-09,212,amul cheese,250,315,65,1,00136,India
513725,2023-05-09,208,sprite,75,100,25,2,00136,India
513725,2023-05-09,203,mango yogurt,50,60,10,2,00136,India
513725,2023-05-09,209,pepsi,75,100,25,2,00136,India
513725,2023-05-09,213,bisleri,6,15,9,2,00136,India
304107,2023-05-09,207,coca cola,75,100,25,2,00122,India
792344,2023-05-09,206,yakult,360,400,40,2,00480,India
792344,2023-05-09,207,coca cola,75,100,25,2,00480,India
920567,2023-05-09,208,sprite,75,100,25,2,00109,India
920567,2023-05-09,212,amul cheese,250,315,65,1,00109,India
920567,2023-05-09,210,mountain dew,75,100,25,2,00109,India
908411,2023-05-09,203,mango yogurt,50,60,10,2,00186,India
908411,2023-05-09,201,paneer,210,340,130,1,00186,India
615002,2023-05-09,205,classic yogurt,45,60,15,2,00070,India
615002,2023-05-09,204,strawberry yogurt,50,60,10,2,00070,India
616919,2023-05-09,208,sprite,75,100,25,2,00274,India
616919,2023-05-09,206,yakult,360,400,40,2,00274,India
616919,2023-05-09,207,coca cola,75,100,25,2,00274,India
755852,2023-05-09,206,yakult,360,400,40,2,00207,India
755852,2023-05-09,202,milk,12,27,15,1,00207,India
755852,2023-05-09,201,paneer,210,340,130,1,00207,India
468027,2023-05-09,207,coca cola,75,100,25,2,00364,India
468027,2023-05-09,208,sprite,75,100,25,2,00364,India
468027,2023-05-09,203,mango yogurt,50,60,10,2,00364,India
419859,2023-05-09,205,classic yogurt,45,60,15,2,00181,India
419859,2023-05-09,211,red bull,90,125,35,2,00181,India
787816,2023-05-09,211,red bull,90,125,35,2,00094,India
298224,2023-05-09,208,sprite,75,100,25,2,00410,India
298224,2023-05-09,201,paneer,210,340,130,1,00410,India
298224,2023-05-09,204,strawberry yogurt,50,60,10,2,00410,India
298224,2023-05-09,209,pepsi,75,100,25,2,00410,India
145302,2023-05-09,207,coca cola,75,100,25,2,00093,India
145302,2023-05-09,213,bisleri,6,15,9,2,00093,India
145302,2023-05-09,204,strawberry yogurt,50,60,10,2,00093,India
748100,2023-05-09,208,sprite,75,100,25,2,00033,India
748100,2023-05-09,206,yakult,360,400,40,2,00033,India
748100,2023-05-09,201,paneer,210,340,130,1,00033,India
184944,2023-05-09,210,mountain dew,75,100,25,2,00499,India
184944,2023-05-09,204,strawberry yogurt,50,60,10,2,00499,India
184944,2023-05-09,209,pepsi,75,100,25,2,00499,India
184944,2023-05-09,206,yakult,360,400,40,2,00499,India
969854,2023-05-09,202,milk,12,27,15,1,00468,India
969854,2023-05-09,201,paneer,210,340,130,1,00468,India
151913,2023-05-09,205,classic yogurt,45,60,15,2,00381,India
151913,2023-05-09,207,coca cola,75,100,25,2,00381,India
845559,2023-05-09,207,coca cola,75,100,25,2,00460,India
845559,2023-05-09,202,milk,12,27,15,1,00460,India
845559,2023-05-09,210,mountain dew,75,100,25,2,00460,India
530793,2023-05-09,208,sprite,75,100,25,2,00215,India
530793,2023-05-09,207,coca cola,75,100,25,2,00215,India
105918,2023-05-09,212,amul cheese,250,315,65,1,00151,India
105918,2023-05-09,202,milk,12,27,15,1,00151,India
105918,2023-05-09,206,yakult,360,400,40,2,00151,India
105918,2023-05-09,213,bisleri,6,15,9,2,00151,India
534953,2023-05-09,213,bisleri,6,15,9,2,00212,India
534953,2023-05-09,203,mango yogurt,50,60,10,2,00212,India
298594,2023-05-09,210,mountain dew,75,100,25,2,00381,India
298594,2023-05-09,212,amul cheese,250,315,65,1,00381,India
298594,2023-05-09,203,mango yogurt,50,60,10,2,00381,India
298594,2023-05-09,205,classic yogurt,45,60,15,2,00381,India
298594,2023-05-09,201,paneer,210,340,130,1,00381,India
732442,2023-05-09,212,amul cheese,250,315,65,1,00091,India
931617,2023-05-09,212,amul cheese,250,315,65,1,00439,India
931617,2023-05-09,206,yakult,360,400,40,2,00439,India
931617,2023-05-09,210,mountain dew,75,100,25,2,00439,India
230455,2023-05-09,212,amul cheese,250,315,65,1,00064,India
230455,2023-05-09,206,yakult,360,400,40,2,00064,India
716965,2023-05-09,207,coca cola,75,100,25,2,00318,India
546174,2023-05-09,204,strawberry yogurt,50,60,10,2,00406,India
546174,2023-05-09,208,sprite,75,100,25,2,00406,India
546174,2023-05-09,202,milk,12,27,15,1,00406,India
167698,2023-05-09,203,mango yogurt,50,60,10,2,00297,India
299597,2023-05-09,207,coca cola,75,100,25,2,00039,India
299597,2023-05-09,210,mountain dew,75,100,25,2,00039,India
657282,2023-05-09,201,paneer,210,340,130,1,00177,India
657282,2023-05-09,210,mountain dew,75,100,25,2,00177,India
657282,2023-05-09,212,amul cheese,250,315,65,1,00177,India
657282,2023-05-09,203,mango yogurt,50,60,10,2,00177,India
657282,2023-05-09,209,pepsi,75,100,25,2,00177,India
460037,2023-05-09,202,milk,12,27,15,1,00003,India
460037,2023-05-09,209,pepsi,75,100,25,2,00003,India
460037,2023-05-09,207,coca cola,75,100,25,2,00003,India
460037,2023-05-09,213,bisleri,6,15,9,2,00003,India
905644,2023-05-09,207,coca cola,75,100,25,2,00112,India
905644,2023-05-09,213,bisleri,6,15,9,2,00112,India
689284,2023-05-09,213,bisleri,6,15,9,2,00264,India
307789,2023-05-09,205,classic yogurt,45,60,15,2,00211,India
307789,2023-05-09,207,coca cola,75,100,25,2,00211,India
307789,2023-05-09,210,mountain dew,75,100,25,2,00211,India
307789,2023-05-09,202,milk,12,27,15,1,00211,India
783708,2023-05-09,207,coca cola,75,100,25,2,00041,India
783708,2023-05-09,203,mango yogurt,50,60,10,2,00041,India
783708,2023-05-09,209,pepsi,75,100,25,2,00041,India
783708,2023-05-09,202,milk,12,27,15,1,00041,India
783708,2023-05-09,210,mountain dew,75,100,25,2,00041,India
355370,2023-05-09,203,mango yogurt,50,60,10,2,00167,India
355370,2023-05-09,212,amul cheese,250,315,65,1,00167,India
355370,2023-05-09,213,bisleri,6,15,9,2,00167,India
355370,2023-05-09,205,classic yogurt,45,60,15,2,00167,India
217184,2023-05-09,203,mango yogurt,50,60,10,2,00217,India
217184,2023-05-09,202,milk,12,27,15,1,00217,India
217184,2023-05-09,205,classic yogurt,45,60,15,2,00217,India
534024,2023-05-09,208,sprite,75,100,25,2,00213,India
534024,2023-05-09,212,amul cheese,250,315,65,1,00213,India
534024,2023-05-09,204,strawberry yogurt,50,60,10,2,00213,India
705248,2023-05-09,204,strawberry yogurt,50,60,10,2,00353,India
705248,2023-05-09,213,bisleri,6,15,9,2,00353,India
705248,2023-05-09,211,red bull,90,125,35,2,00353,India
705248,2023-05-09,202,milk,12,27,15,1,00353,India
884501,2023-05-09,209,pepsi,75,100,25,2,00155,India
884501,2023-05-09,203,mango yogurt,50,60,10,2,00155,India
884501,2023-05-09,208,sprite,75,100,25,2,00155,India
884501,2023-05-09,204,strawberry yogurt,50,60,10,2,00155,India
618785,2023-05-09,212,amul cheese,250,315,65,1,00137,India
618785,2023-05-09,209,pepsi,75,100,25,2,00137,India
618785,2023-05-09,206,yakult,360,400,40,2,00137,India
618785,2023-05-09,203,mango yogurt,50,60,10,2,00137,India
618785,2023-05-09,207,coca cola,75,100,25,2,00137,India
196901,2023-05-09,206,yakult,360,400,40,2,00467,India
196901,2023-05-09,209,pepsi,75,100,25,2,00467,India
196901,2023-05-09,213,bisleri,6,15,9,2,00467,India
300503,2023-05-09,212,amul cheese,250,315,65,1,00075,India
300503,2023-05-09,205,classic yogurt,45,60,15,2,00075,India
562266,2023-05-09,201,paneer,210,340,130,1,00393,India
562266,2023-05-09,205,classic yogurt,45,60,15,2,00393,India
562266,2023-05-09,212,amul cheese,250,315,65,1,00393,India
562266,2023-05-09,206,yakult,360,400,40,2,00393,India
508259,2023-05-09,206,yakult,360,400,40,2,00251,India
508259,2023-05-09,205,classic yogurt,45,60,15,2,00251,India
508259,2023-05-09,201,paneer,210,340,130,1,00251,India
508259,2023-05-09,202,milk,12,27,15,1,00251,India
334602,2023-05-09,202,milk,12,27,15,1,00090,India
334602,2023-05-09,210,mountain dew,75,100,25,2,00090,India
574675,2023-05-09,210,mountain dew,75,100,25,2,00133,India
574675,2023-05-09,207,coca cola,75,100,25,2,00133,India
574675,2023-05-09,212,amul cheese,250,315,65,1,00133,India
574675,2023-05-09,209,pepsi,75,100,25,2,00133,India
574675,2023-05-09,206,yakult,360,400,40,2,00133,India
931649,2023-05-09,201,paneer,210,340,130,1,00376,India
931649,2023-05-09,213,bisleri,6,15,9,2,00376,India
931649,2023-05-09,207,coca cola,75,100,25,2,00376,India
931649,2023-05-09,205,classic yogurt,45,60,15,2,00376,India
258736,2023-05-09,205,classic yogurt,45,60,15,2,00146,India
258736,2023-05-09,201,paneer,210,340,130,1,00146,India
258736,2023-05-09,210,mountain dew,75,100,25,2,00146,India
258736,2023-05-09,213,bisleri,6,15,9,2,00146,India
706097,2023-05-09,206,yakult,360,400,40,2,00301,India
943585,2023-05-09,211,red bull,90,125,35,2,00217,India
831992,2023-05-09,207,coca cola,75,100,25,2,00177,India
831992,2023-05-09,205,classic yogurt,45,60,15,2,00177,India
947150,2023-05-09,209,pepsi,75,100,25,2,00339,India
947150,2023-05-09,212,amul cheese,250,315,65,1,00339,India
947150,2023-05-09,202,milk,12,27,15,1,00339,India
947150,2023-05-09,211,red bull,90,125,35,2,00339,India
947150,2023-05-09,210,mountain dew,75,100,25,2,00339,India
409107,2023-05-09,203,mango yogurt,50,60,10,2,00255,India
409107,2023-05-09,205,classic yogurt,45,60,15,2,00255,India
345718,2023-05-09,210,mountain dew,75,100,25,2,00221,India
345718,2023-05-09,202,milk,12,27,15,1,00221,India
345718,2023-05-09,201,paneer,210,340,130,1,00221,India
333130,2023-05-09,207,coca cola,75,100,25,2,00148,India
333130,2023-05-09,209,pepsi,75,100,25,2,00148,India
333130,2023-05-09,201,paneer,210,340,130,1,00148,India
333130,2023-05-09,211,red bull,90,125,35,2,00148,India
597028,2023-05-09,203,mango yogurt,50,60,10,2,00285,India
597028,2023-05-09,208,sprite,75,100,25,2,00285,India
597028,2023-05-09,205,classic yogurt,45,60,15,2,00285,India
597028,2023-05-09,212,amul cheese,250,315,65,1,00285,India
597028,2023-05-09,211,red bull,90,125,35,2,00285,India
225686,2023-05-09,203,mango yogurt,50,60,10,2,00049,India
785670,2023-05-09,201,paneer,210,340,130,1,00093,India
785670,2023-05-09,207,coca cola,75,100,25,2,00093,India
785670,2023-05-09,209,pepsi,75,100,25,2,00093,India
933037,2023-05-09,211,red bull,90,125,35,2,00291,India
933037,2023-05-09,207,coca cola,75,100,25,2,00291,India
322024,2023-05-09,212,amul cheese,250,315,65,1,00496,India
322024,2023-05-09,202,milk,12,27,15,1,00496,India
322024,2023-05-09,211,red bull,90,125,35,2,00496,India
322024,2023-05-09,203,mango yogurt,50,60,10,2,00496,India
937971,2023-05-09,210,mountain dew,75,100,25,2,00014,India
937971,2023-05-09,207,coca cola,75,100,25,2,00014,India
386748,2023-05-09,207,coca cola,75,100,25,2,00349,India
386748,2023-05-09,206,yakult,360,400,40,2,00349,India
386748,2023-05-09,202,milk,12,27,15,1,00349,India
386748,2023-05-09,208,sprite,75,100,25,2,00349,India
386748,2023-05-09,204,strawberry yogurt,50,60,10,2,00349,India
337914,2023-05-09,203,mango yogurt,50,60,10,2,00141,India
337914,2023-05-09,204,strawberry yogurt,50,60,10,2,00141,India
337914,2023-05-09,208,sprite,75,100,25,2,00141,India
209301,2023-05-09,201,paneer,210,340,130,1,00372,India
209301,2023-05-09,213,bisleri,6,15,9,2,00372,India
827833,2023-05-09,204,strawberry yogurt,50,60,10,2,00338,India
827833,2023-05-09,205,classic yogurt,45,60,15,2,00338,India
710065,2023-05-09,211,red bull,90,125,35,2,00191,India
642771,2023-05-09,204,strawberry yogurt,50,60,10,2,00466,India
642771,2023-05-09,213,bisleri,6,15,9,2,00466,India
958500,2023-05-09,206,yakult,360,400,40,2,00422,India
137775,2023-05-09,206,yakult,360,400,40,2,00254,India
284071,2023-05-09,205,classic yogurt,45,60,15,2,00473,India
945800,2023-05-09,208,sprite,75,100,25,2,00306,India
945800,2023-05-09,212,amul cheese,250,315,65,1,00306,India
342683,2023-05-09,211,red bull,90,125,35,2,00472,India
342683,2023-05-09,212,amul cheese,250,315,65,1,00472,India
342683,2023-05-09,203,mango yogurt,50,60,10,2,00472,India
166717,2023-05-09,207,coca cola,75,100,25,2,00117,India
166717,2023-05-09,205,classic yogurt,45,60,15,2,00117,India
133000,2023-05-09,206,yakult,360,400,40,2,00058,India
133000,2023-05-09,203,mango yogurt,50,60,10,2,00058,India
396755,2023-05-09,212,amul cheese,250,315,65,1,00096,India
396755,2023-05-09,203,mango yogurt,50,60,10,2,00096,India
852193,2023-05-10,211,red bull,90,125,35,2,00347,India
852193,2023-05-10,202,milk,12,27,15,1,00347,India
670222,2023-05-10,201,paneer,210,340,130,1,00090,India
670222,2023-05-10,205,classic yogurt,45,60,15,2,00090,India
670222,2023-05-10,206,yakult,360,400,40,2,00090,India
103657,2023-05-10,204,strawberry yogurt,50,60,10,2,00002,India
103657,2023-05-10,211,red bull,90,125,35,2,00002,India
103657,2023-05-10,207,coca cola,75,100,25,2,00002,India
156753,2023-05-10,207,coca cola,75,100,25,2,00390,India
156753,2023-05-10,205,classic yogurt,45,60,15,2,00390,India
156753,2023-05-10,204,strawberry yogurt,50,60,10,2,00390,India
156753,2023-05-10,203,mango yogurt,50,60,10,2,00390,India
553652,2023-05-10,201,paneer,210,340,130,1,00113,India
553652,2023-05-10,212,amul cheese,250,315,65,1,00113,India
553652,2023-05-10,213,bisleri,6,15,9,2,00113,India
266392,2023-05-10,204,strawberry yogurt,50,60,10,2,00192,India
266392,2023-05-10,213,bisleri,6,15,9,2,00192,India
362202,2023-05-10,209,pepsi,75,100,25,2,00071,India
362202,2023-05-10,208,sprite,75,100,25,2,00071,India
362202,2023-05-10,202,milk,12,27,15,1,00071,India
362202,2023-05-10,206,yakult,360,400,40,2,00071,India
728455,2023-05-10,203,mango yogurt,50,60,10,2,00325,India
728455,2023-05-10,205,classic yogurt,45,60,15,2,00325,India
728455,2023-05-10,208,sprite,75,100,25,2,00325,India
728455,2023-05-10,202,milk,12,27,15,1,00325,India
728455,2023-05-10,201,paneer,210,340,130,1,00325,India
647721,2023-05-10,203,mango yogurt,50,60,10,2,00137,India
647721,2023-05-10,204,strawberry yogurt,50,60,10,2,00137,India
647721,2023-05-10,206,yakult,360,400,40,2,00137,India
562678,2023-05-10,201,paneer,210,340,130,1,00355,India
562678,2023-05-10,203,mango yogurt,50,60,10,2,00355,India
562678,2023-05-10,205,classic yogurt,45,60,15,2,00355,India
562678,2023-05-10,208,sprite,75,100,25,2,00355,India
360811,2023-05-10,209,pepsi,75,100,25,2,00204,India
360811,2023-05-10,210,mountain dew,75,100,25,2,00204,India
360811,2023-05-10,213,bisleri,6,15,9,2,00204,India
360811,2023-05-10,204,strawberry yogurt,50,60,10,2,00204,India
360811,2023-05-10,211,red bull,90,125,35,2,00204,India
826062,2023-05-10,206,yakult,360,400,40,2,00406,India
826062,2023-05-10,210,mountain dew,75,100,25,2,00406,India
826062,2023-05-10,209,pepsi,75,100,25,2,00406,India
826062,2023-05-10,203,mango yogurt,50,60,10,2,00406,India
688224,2023-05-10,208,sprite,75,100,25,2,00408,India
688224,2023-05-10,207,coca cola,75,100,25,2,00408,India
688224,2023-05-10,210,mountain dew,75,100,25,2,00408,India
335758,2023-05-10,205,classic yogurt,45,60,15,2,00314,India
335758,2023-05-10,206,yakult,360,400,40,2,00314,India
335758,2023-05-10,209,pepsi,75,100,25,2,00314,India
335758,2023-05-10,207,coca cola,75,100,25,2,00314,India
623667,2023-05-10,209,pepsi,75,100,25,2,00065,India
623667,2023-05-10,211,red bull,90,125,35,2,00065,India
623667,2023-05-10,204,strawberry yogurt,50,60,10,2,00065,India
242571,2023-05-10,209,pepsi,75,100,25,2,00465,India
242571,2023-05-10,203,mango yogurt,50,60,10,2,00465,India
242571,2023-05-10,210,mountain dew,75,100,25,2,00465,India
246845,2023-05-10,206,yakult,360,400,40,2,00014,India
246845,2023-05-10,202,milk,12,27,15,1,00014,India
246845,2023-05-10,213,bisleri,6,15,9,2,00014,India
620399,2023-05-10,213,bisleri,6,15,9,2,00302,India
620399,2023-05-10,202,milk,12,27,15,1,00302,India
620399,2023-05-10,208,sprite,75,100,25,2,00302,India
955698,2023-05-10,213,bisleri,6,15,9,2,00070,India
955698,2023-05-10,209,pepsi,75,100,25,2,00070,India
955698,2023-05-10,205,classic yogurt,45,60,15,2,00070,India
955698,2023-05-10,206,yakult,360,400,40,2,00070,India
955698,2023-05-10,212,amul cheese,250,315,65,1,00070,India
350223,2023-05-10,210,mountain dew,75,100,25,2,00130,India
350223,2023-05-10,213,bisleri,6,15,9,2,00130,India
350223,2023-05-10,207,coca cola,75,100,25,2,00130,India
350223,2023-05-10,212,amul cheese,250,315,65,1,00130,India
350223,2023-05-10,203,mango yogurt,50,60,10,2,00130,India
274160,2023-05-10,211,red bull,90,125,35,2,00498,India
274160,2023-05-10,205,classic yogurt,45,60,15,2,00498,India
274160,2023-05-10,202,milk,12,27,15,1,00498,India
721910,2023-05-10,207,coca cola,75,100,25,2,00344,India
721910,2023-05-10,206,yakult,360,400,40,2,00344,India
721910,2023-05-10,202,milk,12,27,15,1,00344,India
334791,2023-05-10,205,classic yogurt,45,60,15,2,00494,India
334791,2023-05-10,206,yakult,360,400,40,2,00494,India
334791,2023-05-10,201,paneer,210,340,130,1,00494,India
334791,2023-05-10,208,sprite,75,100,25,2,00494,India
496838,2023-05-10,204,strawberry yogurt,50,60,10,2,00055,India
496838,2023-05-10,205,classic yogurt,45,60,15,2,00055,India
496838,2023-05-10,209,pepsi,75,100,25,2,00055,India
496838,2023-05-10,211,red bull,90,125,35,2,00055,India
172947,2023-05-10,203,mango yogurt,50,60,10,2,00097,India
172947,2023-05-10,210,mountain dew,75,100,25,2,00097,India
569546,2023-05-10,212,amul cheese,250,315,65,1,00085,India
919374,2023-05-10,206,yakult,360,400,40,2,00376,India
919374,2023-05-10,208,sprite,75,100,25,2,00376,India
919374,2023-05-10,210,mountain dew,75,100,25,2,00376,India
598564,2023-05-10,208,sprite,75,100,25,2,00489,India
808746,2023-05-10,208,sprite,75,100,25,2,00057,India
808746,2023-05-10,206,yakult,360,400,40,2,00057,India
808746,2023-05-10,207,coca cola,75,100,25,2,00057,India
879675,2023-05-10,203,mango yogurt,50,60,10,2,00220,India
879675,2023-05-10,213,bisleri,6,15,9,2,00220,India
879675,2023-05-10,209,pepsi,75,100,25,2,00220,India
879675,2023-05-10,202,milk,12,27,15,1,00220,India
130643,2023-05-10,210,mountain dew,75,100,25,2,00209,India
130643,2023-05-10,208,sprite,75,100,25,2,00209,India
130643,2023-05-10,203,mango yogurt,50,60,10,2,00209,India
130643,2023-05-10,204,strawberry yogurt,50,60,10,2,00209,India
998795,2023-05-10,202,milk,12,27,15,1,00177,India
998795,2023-05-10,210,mountain dew,75,100,25,2,00177,India
998795,2023-05-10,201,paneer,210,340,130,1,00177,India
876151,2023-05-10,203,mango yogurt,50,60,10,2,00260,India
876151,2023-05-10,202,milk,12,27,15,1,00260,India
619701,2023-05-10,213,bisleri,6,15,9,2,00365,India
146684,2023-05-10,203,mango yogurt,50,60,10,2,00396,India
316129,2023-05-10,203,mango yogurt,50,60,10,2,00149,India
316129,2023-05-10,204,strawberry yogurt,50,60,10,2,00149,India
316129,2023-05-10,206,yakult,360,400,40,2,00149,India
646649,2023-05-10,203,mango yogurt,50,60,10,2,00073,India
646649,2023-05-10,208,sprite,75,100,25,2,00073,India
646649,2023-05-10,210,mountain dew,75,100,25,2,00073,India
945520,2023-05-10,203,mango yogurt,50,60,10,2,00441,India
945520,2023-05-10,211,red bull,90,125,35,2,00441,India
945520,2023-05-10,201,paneer,210,340,130,1,00441,India
945520,2023-05-10,212,amul cheese,250,315,65,1,00441,India
346635,2023-05-10,211,red bull,90,125,35,2,00266,India
346635,2023-05-10,205,classic yogurt,45,60,15,2,00266,India
346635,2023-05-10,210,mountain dew,75,100,25,2,00266,India
680611,2023-05-10,204,strawberry yogurt,50,60,10,2,00123,India
680611,2023-05-10,203,mango yogurt,50,60,10,2,00123,India
337966,2023-05-10,207,coca cola,75,100,25,2,00455,India
144102,2023-05-10,208,sprite,75,100,25,2,00011,India
144102,2023-05-10,212,amul cheese,250,315,65,1,00011,India
240949,2023-05-10,209,pepsi,75,100,25,2,00256,India
240949,2023-05-10,203,mango yogurt,50,60,10,2,00256,India
240949,2023-05-10,202,milk,12,27,15,1,00256,India
445206,2023-05-10,206,yakult,360,400,40,2,00083,India
949654,2023-05-10,203,mango yogurt,50,60,10,2,00291,India
949654,2023-05-10,201,paneer,210,340,130,1,00291,India
949654,2023-05-10,202,milk,12,27,15,1,00291,India
949654,2023-05-10,208,sprite,75,100,25,2,00291,India
397799,2023-05-10,202,milk,12,27,15,1,00497,India
709375,2023-05-10,210,mountain dew,75,100,25,2,00256,India
625422,2023-05-10,205,classic yogurt,45,60,15,2,00207,India
700091,2023-05-10,207,coca cola,75,100,25,2,00108,India
700091,2023-05-10,204,strawberry yogurt,50,60,10,2,00108,India
700091,2023-05-10,201,paneer,210,340,130,1,00108,India
700091,2023-05-10,203,mango yogurt,50,60,10,2,00108,India
902218,2023-05-10,212,amul cheese,250,315,65,1,00025,India
522656,2023-05-10,207,coca cola,75,100,25,2,00042,India
310775,2023-05-10,211,red bull,90,125,35,2,00455,India
310775,2023-05-10,207,coca cola,75,100,25,2,00455,India
310775,2023-05-10,204,strawberry yogurt,50,60,10,2,00455,India
456727,2023-05-10,212,amul cheese,250,315,65,1,00240,India
456727,2023-05-10,207,coca cola,75,100,25,2,00240,India
456727,2023-05-10,209,pepsi,75,100,25,2,00240,India
456727,2023-05-10,201,paneer,210,340,130,1,00240,India
322986,2023-05-10,207,coca cola,75,100,25,2,00141,India
322986,2023-05-10,210,mountain dew,75,100,25,2,00141,India
322986,2023-05-10,212,amul cheese,250,315,65,1,00141,India
322986,2023-05-10,213,bisleri,6,15,9,2,00141,India
977723,2023-05-10,209,pepsi,75,100,25,2,00356,India
977723,2023-05-10,206,yakult,360,400,40,2,00356,India
297593,2023-05-10,206,yakult,360,400,40,2,00292,India
297593,2023-05-10,207,coca cola,75,100,25,2,00292,India
297593,2023-05-10,203,mango yogurt,50,60,10,2,00292,India
297593,2023-05-10,211,red bull,90,125,35,2,00292,India
828808,2023-05-10,210,mountain dew,75,100,25,2,00491,India
828808,2023-05-10,208,sprite,75,100,25,2,00491,India
828808,2023-05-10,206,yakult,360,400,40,2,00491,India
828808,2023-05-10,201,paneer,210,340,130,1,00491,India
828808,2023-05-10,211,red bull,90,125,35,2,00491,India
500552,2023-05-10,211,red bull,90,125,35,2,00078,India
500552,2023-05-10,210,mountain dew,75,100,25,2,00078,India
500552,2023-05-10,204,strawberry yogurt,50,60,10,2,00078,India
564719,2023-05-10,206,yakult,360,400,40,2,00189,India
564719,2023-05-10,201,paneer,210,340,130,1,00189,India
564719,2023-05-10,208,sprite,75,100,25,2,00189,India
948757,2023-05-10,212,amul cheese,250,315,65,1,00238,India
948757,2023-05-10,206,yakult,360,400,40,2,00238,India
248394,2023-05-10,205,classic yogurt,45,60,15,2,00329,India
269073,2023-05-10,207,coca cola,75,100,25,2,00381,India
269073,2023-05-10,205,classic yogurt,45,60,15,2,00381,India
269073,2023-05-10,202,milk,12,27,15,1,00381,India
269073,2023-05-10,209,pepsi,75,100,25,2,00381,India
775381,2023-05-10,206,yakult,360,400,40,2,00252,India
775381,2023-05-10,213,bisleri,6,15,9,2,00252,India
561645,2023-05-10,211,red bull,90,125,35,2,00470,India
561645,2023-05-10,210,mountain dew,75,100,25,2,00470,India
561645,2023-05-10,202,milk,12,27,15,1,00470,India
470863,2023-05-10,209,pepsi,75,100,25,2,00423,India
470863,2023-05-10,212,amul cheese,250,315,65,1,00423,India
470863,2023-05-10,210,mountain dew,75,100,25,2,00423,India
470863,2023-05-10,201,paneer,210,340,130,1,00423,India
942953,2023-05-10,207,coca cola,75,100,25,2,00413,India
938248,2023-05-10,202,milk,12,27,15,1,00289,India
938248,2023-05-10,206,yakult,360,400,40,2,00289,India
815614,2023-05-10,208,sprite,75,100,25,2,00029,India
815614,2023-05-10,210,mountain dew,75,100,25,2,00029,India
815614,2023-05-10,207,coca cola,75,100,25,2,00029,India
905980,2023-05-10,209,pepsi,75,100,25,2,00483,India
905980,2023-05-10,210,mountain dew,75,100,25,2,00483,India
134899,2023-05-10,204,strawberry yogurt,50,60,10,2,00288,India
134899,2023-05-10,213,bisleri,6,15,9,2,00288,India
191137,2023-05-10,206,yakult,360,400,40,2,00250,India
191137,2023-05-10,203,mango yogurt,50,60,10,2,00250,India
213439,2023-05-10,209,pepsi,75,100,25,2,00260,India
213439,2023-05-10,202,milk,12,27,15,1,00260,India
213439,2023-05-10,206,yakult,360,400,40,2,00260,India
213439,2023-05-10,201,paneer,210,340,130,1,00260,India
641330,2023-05-10,207,coca cola,75,100,25,2,00008,India
641330,2023-05-10,206,yakult,360,400,40,2,00008,India
641330,2023-05-10,208,sprite,75,100,25,2,00008,India
367763,2023-05-10,210,mountain dew,75,100,25,2,00203,India
367763,2023-05-10,204,strawberry yogurt,50,60,10,2,00203,India
367763,2023-05-10,208,sprite,75,100,25,2,00203,India
368353,2023-05-10,211,red bull,90,125,35,2,00497,India
368353,2023-05-10,208,sprite,75,100,25,2,00497,India
368353,2023-05-10,205,classic yogurt,45,60,15,2,00497,India
368353,2023-05-10,202,milk,12,27,15,1,00497,India
368353,2023-05-10,210,mountain dew,75,100,25,2,00497,India
680277,2023-05-10,212,amul cheese,250,315,65,1,00038,India
217416,2023-05-10,203,mango yogurt,50,60,10,2,00422,India
217416,2023-05-10,206,yakult,360,400,40,2,00422,India
217416,2023-05-10,211,red bull,90,125,35,2,00422,India
997821,2023-05-10,205,classic yogurt,45,60,15,2,00410,India
997821,2023-05-10,211,red bull,90,125,35,2,00410,India
997821,2023-05-10,209,pepsi,75,100,25,2,00410,India
765236,2023-05-10,208,sprite,75,100,25,2,00342,India
765236,2023-05-10,204,strawberry yogurt,50,60,10,2,00342,India
765236,2023-05-10,207,coca cola,75,100,25,2,00342,India
765236,2023-05-10,213,bisleri,6,15,9,2,00342,India
627272,2023-05-10,209,pepsi,75,100,25,2,00006,India
627272,2023-05-10,205,classic yogurt,45,60,15,2,00006,India
627272,2023-05-10,202,milk,12,27,15,1,00006,India
568261,2023-05-10,205,classic yogurt,45,60,15,2,00084,India
568261,2023-05-10,206,yakult,360,400,40,2,00084,India
567497,2023-05-10,213,bisleri,6,15,9,2,00236,India
567497,2023-05-10,212,amul cheese,250,315,65,1,00236,India
567497,2023-05-10,203,mango yogurt,50,60,10,2,00236,India
988468,2023-05-10,203,mango yogurt,50,60,10,2,00063,India
988468,2023-05-10,213,bisleri,6,15,9,2,00063,India
988468,2023-05-10,202,milk,12,27,15,1,00063,India
988468,2023-05-10,205,classic yogurt,45,60,15,2,00063,India
579740,2023-05-10,205,classic yogurt,45,60,15,2,00273,India
579740,2023-05-10,209,pepsi,75,100,25,2,00273,India
579740,2023-05-10,212,amul cheese,250,315,65,1,00273,India
906349,2023-05-11,205,classic yogurt,45,60,15,2,00134,India
906349,2023-05-11,210,mountain dew,75,100,25,2,00134,India
906349,2023-05-11,204,strawberry yogurt,50,60,10,2,00134,India
748765,2023-05-11,205,classic yogurt,45,60,15,2,00209,India
748765,2023-05-11,213,bisleri,6,15,9,2,00209,India
748765,2023-05-11,206,yakult,360,400,40,2,00209,India
748765,2023-05-11,209,pepsi,75,100,25,2,00209,India
748765,2023-05-11,210,mountain dew,75,100,25,2,00209,India
519679,2023-05-11,211,red bull,90,125,35,2,00375,India
519679,2023-05-11,203,mango yogurt,50,60,10,2,00375,India
519679,2023-05-11,205,classic yogurt,45,60,15,2,00375,India
519679,2023-05-11,210,mountain dew,75,100,25,2,00375,India
261440,2023-05-11,209,pepsi,75,100,25,2,00413,India
261440,2023-05-11,211,red bull,90,125,35,2,00413,India
261440,2023-05-11,201,paneer,210,340,130,1,00413,India
261440,2023-05-11,212,amul cheese,250,315,65,1,00413,India
694324,2023-05-11,207,coca cola,75,100,25,2,00366,India
141945,2023-05-11,213,bisleri,6,15,9,2,00424,India
141945,2023-05-11,208,sprite,75,100,25,2,00424,India
141945,2023-05-11,212,amul cheese,250,315,65,1,00424,India
303354,2023-05-11,203,mango yogurt,50,60,10,2,00411,India
303354,2023-05-11,201,paneer,210,340,130,1,00411,India
467960,2023-05-11,213,bisleri,6,15,9,2,00414,India
467960,2023-05-11,212,amul cheese,250,315,65,1,00414,India
467960,2023-05-11,204,strawberry yogurt,50,60,10,2,00414,India
544942,2023-05-11,207,coca cola,75,100,25,2,00039,India
544942,2023-05-11,201,paneer,210,340,130,1,00039,India
544942,2023-05-11,209,pepsi,75,100,25,2,00039,India
552607,2023-05-11,210,mountain dew,75,100,25,2,00175,India
552607,2023-05-11,209,pepsi,75,100,25,2,00175,India
694805,2023-05-11,209,pepsi,75,100,25,2,00156,India
694805,2023-05-11,205,classic yogurt,45,60,15,2,00156,India
668044,2023-05-11,207,coca cola,75,100,25,2,00358,India
668044,2023-05-11,206,yakult,360,400,40,2,00358,India
668044,2023-05-11,202,milk,12,27,15,1,00358,India
597613,2023-05-11,205,classic yogurt,45,60,15,2,00474,India
597613,2023-05-11,209,pepsi,75,100,25,2,00474,India
597613,2023-05-11,204,strawberry yogurt,50,60,10,2,00474,India
361655,2023-05-11,203,mango yogurt,50,60,10,2,00270,India
361655,2023-05-11,202,milk,12,27,15,1,00270,India
361655,2023-05-11,201,paneer,210,340,130,1,00270,India
481846,2023-05-11,210,mountain dew,75,100,25,2,00276,India
885990,2023-05-11,205,classic yogurt,45,60,15,2,00060,India
885990,2023-05-11,206,yakult,360,400,40,2,00060,India
885990,2023-05-11,213,bisleri,6,15,9,2,00060,India
892908,2023-05-11,213,bisleri,6,15,9,2,00288,India
892908,2023-05-11,201,paneer,210,340,130,1,00288,India
892908,2023-05-11,205,classic yogurt,45,60,15,2,00288,India
201477,2023-05-11,211,red bull,90,125,35,2,00350,India
201477,2023-05-11,205,classic yogurt,45,60,15,2,00350,India
201477,2023-05-11,201,paneer,210,340,130,1,00350,India
201477,2023-05-11,207,coca cola,75,100,25,2,00350,India
383254,2023-05-11,202,milk,12,27,15,1,00136,India
383254,2023-05-11,204,strawberry yogurt,50,60,10,2,00136,India
228981,2023-05-11,207,coca cola,75,100,25,2,00491,India
228981,2023-05-11,203,mango yogurt,50,60,10,2,00491,India
664428,2023-05-11,207,coca cola,75,100,25,2,00016,India
664428,2023-05-11,204,strawberry yogurt,50,60,10,2,00016,India
136156,2023-05-11,201,paneer,210,340,130,1,00386,India
136156,2023-05-11,209,pepsi,75,100,25,2,00386,India
136156,2023-05-11,206,yakult,360,400,40,2,00386,India
343244,2023-05-11,213,bisleri,6,15,9,2,00426,India
689918,2023-05-11,208,sprite,75,100,25,2,00217,India
378510,2023-05-11,212,amul cheese,250,315,65,1,00182,India
513456,2023-05-11,203,mango yogurt,50,60,10,2,00411,India
513456,2023-05-11,208,sprite,75,100,25,2,00411,India
513456,2023-05-11,202,milk,12,27,15,1,00411,India
271898,2023-05-11,213,bisleri,6,15,9,2,00103,India
271898,2023-05-11,211,red bull,90,125,35,2,00103,India
271898,2023-05-11,204,strawberry yogurt,50,60,10,2,00103,India
235418,2023-05-11,207,coca cola,75,100,25,2,00450,India
235418,2023-05-11,210,mountain dew,75,100,25,2,00450,India
930084,2023-05-11,213,bisleri,6,15,9,2,00407,India
930084,2023-05-11,207,coca cola,75,100,25,2,00407,India
930084,2023-05-11,202,milk,12,27,15,1,00407,India
930084,2023-05-11,209,pepsi,75,100,25,2,00407,India
728395,2023-05-11,213,bisleri,6,15,9,2,00228,India
728395,2023-05-11,208,sprite,75,100,25,2,00228,India
516303,2023-05-11,207,coca cola,75,100,25,2,00318,India
904296,2023-05-11,204,strawberry yogurt,50,60,10,2,00166,India
904296,2023-05-11,207,coca cola,75,100,25,2,00166,India
904296,2023-05-11,205,classic yogurt,45,60,15,2,00166,India
325381,2023-05-11,209,pepsi,75,100,25,2,00423,India
325381,2023-05-11,204,strawberry yogurt,50,60,10,2,00423,India
164381,2023-05-11,212,amul cheese,250,315,65,1,00100,India
164381,2023-05-11,211,red bull,90,125,35,2,00100,India
164381,2023-05-11,204,strawberry yogurt,50,60,10,2,00100,India
978390,2023-05-11,209,pepsi,75,100,25,2,00238,India
978390,2023-05-11,210,mountain dew,75,100,25,2,00238,India
978390,2023-05-11,201,paneer,210,340,130,1,00238,India
978390,2023-05-11,204,strawberry yogurt,50,60,10,2,00238,India
443403,2023-05-11,212,amul cheese,250,315,65,1,00273,India
128624,2023-05-11,202,milk,12,27,15,1,00039,India
128624,2023-05-11,210,mountain dew,75,100,25,2,00039,India
128624,2023-05-11,204,strawberry yogurt,50,60,10,2,00039,India
551940,2023-05-11,210,mountain dew,75,100,25,2,00197,India
551940,2023-05-11,201,paneer,210,340,130,1,00197,India
551940,2023-05-11,213,bisleri,6,15,9,2,00197,India
551940,2023-05-11,205,classic yogurt,45,60,15,2,00197,India
754681,2023-05-11,202,milk,12,27,15,1,00112,India
754681,2023-05-11,206,yakult,360,400,40,2,00112,India
754681,2023-05-11,205,classic yogurt,45,60,15,2,00112,India
754681,2023-05-11,207,coca cola,75,100,25,2,00112,India
981266,2023-05-11,206,yakult,360,400,40,2,00242,India
981266,2023-05-11,208,sprite,75,100,25,2,00242,India
981266,2023-05-11,212,amul cheese,250,315,65,1,00242,India
981266,2023-05-11,201,paneer,210,340,130,1,00242,India
450668,2023-05-11,213,bisleri,6,15,9,2,00048,India
450668,2023-05-11,204,strawberry yogurt,50,60,10,2,00048,India
450668,2023-05-11,201,paneer,210,340,130,1,00048,India
450668,2023-05-11,205,classic yogurt,45,60,15,2,00048,India
450668,2023-05-11,203,mango yogurt,50,60,10,2,00048,India
291981,2023-05-11,207,coca cola,75,100,25,2,00278,India
291981,2023-05-11,208,sprite,75,100,25,2,00278,India
882818,2023-05-11,206,yakult,360,400,40,2,00281,India
639966,2023-05-11,204,strawberry yogurt,50,60,10,2,00227,India
639966,2023-05-11,203,mango yogurt,50,60,10,2,00227,India
863073,2023-05-11,206,yakult,360,400,40,2,00042,India
863073,2023-05-11,202,milk,12,27,15,1,00042,India
863073,2023-05-11,212,amul cheese,250,315,65,1,00042,India
863073,2023-05-11,211,red bull,90,125,35,2,00042,India
854132,2023-05-11,208,sprite,75,100,25,2,00472,India
854132,2023-05-11,211,red bull,90,125,35,2,00472,India
854132,2023-05-11,207,coca cola,75,100,25,2,00472,India
356573,2023-05-11,201,paneer,210,340,130,1,00365,India
356573,2023-05-11,204,strawberry yogurt,50,60,10,2,00365,India
356573,2023-05-11,211,red bull,90,125,35,2,00365,India
343555,2023-05-11,213,bisleri,6,15,9,2,00372,India
343555,2023-05-11,211,red bull,90,125,35,2,00372,India
197709,2023-05-11,208,sprite,75,100,25,2,00284,India
197709,2023-05-11,213,bisleri,6,15,9,2,00284,India
197709,2023-05-11,204,strawberry yogurt,50,60,10,2,00284,India
197709,2023-05-11,207,coca cola,75,100,25,2,00284,India
825652,2023-05-11,205,classic yogurt,45,60,15,2,00014,India
825652,2023-05-11,212,amul cheese,250,315,65,1,00014,India
825652,2023-05-11,209,pepsi,75,100,25,2,00014,India
547137,2023-05-11,209,pepsi,75,100,25,2,00035,India
217951,2023-05-11,205,classic yogurt,45,60,15,2,00417,India
553942,2023-05-11,213,bisleri,6,15,9,2,00048,India
553942,2023-05-11,205,classic yogurt,45,60,15,2,00048,India
531538,2023-05-11,209,pepsi,75,100,25,2,00201,India
429706,2023-05-11,208,sprite,75,100,25,2,00109,India
429706,2023-05-11,213,bisleri,6,15,9,2,00109,India
990977,2023-05-12,212,amul cheese,250,315,65,1,00202,India
449533,2023-05-12,212,amul cheese,250,315,65,1,00325,India
449533,2023-05-12,202,milk,12,27,15,1,00325,India
449533,2023-05-12,210,mountain dew,75,100,25,2,00325,India
171302,2023-05-12,202,milk,12,27,15,1,00492,India
171302,2023-05-12,212,amul cheese,250,315,65,1,00492,India
171302,2023-05-12,207,coca cola,75,100,25,2,00492,India
673409,2023-05-12,205,classic yogurt,45,60,15,2,00260,India
673409,2023-05-12,202,milk,12,27,15,1,00260,India
673409,2023-05-12,203,mango yogurt,50,60,10,2,00260,India
673409,2023-05-12,210,mountain dew,75,100,25,2,00260,India
911448,2023-05-12,202,milk,12,27,15,1,00347,India
911448,2023-05-12,207,coca cola,75,100,25,2,00347,India
119325,2023-05-12,213,bisleri,6,15,9,2,00335,India
290291,2023-05-12,201,paneer,210,340,130,1,00226,India
290291,2023-05-12,205,classic yogurt,45,60,15,2,00226,India
448796,2023-05-12,201,paneer,210,340,130,1,00421,India
448796,2023-05-12,209,pepsi,75,100,25,2,00421,India
448796,2023-05-12,212,amul cheese,250,315,65,1,00421,India
448796,2023-05-12,206,yakult,360,400,40,2,00421,India
945715,2023-05-12,211,red bull,90,125,35,2,00496,India
945715,2023-05-12,203,mango yogurt,50,60,10,2,00496,India
945715,2023-05-12,213,bisleri,6,15,9,2,00496,India
945715,2023-05-12,206,yakult,360,400,40,2,00496,India
636699,2023-05-12,208,sprite,75,100,25,2,00418,India
636699,2023-05-12,207,coca cola,75,100,25,2,00418,India
636699,2023-05-12,212,amul cheese,250,315,65,1,00418,India
636699,2023-05-12,210,mountain dew,75,100,25,2,00418,India
490276,2023-05-12,203,mango yogurt,50,60,10,2,00086,India
724208,2023-05-12,210,mountain dew,75,100,25,2,00256,India
724208,2023-05-12,208,sprite,75,100,25,2,00256,India
724208,2023-05-12,212,amul cheese,250,315,65,1,00256,India
107675,2023-05-12,204,strawberry yogurt,50,60,10,2,00214,India
107675,2023-05-12,213,bisleri,6,15,9,2,00214,India
107675,2023-05-12,203,mango yogurt,50,60,10,2,00214,India
446632,2023-05-12,211,red bull,90,125,35,2,00016,India
446632,2023-05-12,204,strawberry yogurt,50,60,10,2,00016,India
576007,2023-05-12,207,coca cola,75,100,25,2,00422,India
576007,2023-05-12,206,yakult,360,400,40,2,00422,India
576007,2023-05-12,212,amul cheese,250,315,65,1,00422,India
888420,2023-05-12,213,bisleri,6,15,9,2,00450,India
888420,2023-05-12,204,strawberry yogurt,50,60,10,2,00450,India
888420,2023-05-12,208,sprite,75,100,25,2,00450,India
457915,2023-05-12,208,sprite,75,100,25,2,00308,India
457915,2023-05-12,202,milk,12,27,15,1,00308,India
457915,2023-05-12,206,yakult,360,400,40,2,00308,India
254583,2023-05-12,203,mango yogurt,50,60,10,2,00286,India
254583,2023-05-12,209,pepsi,75,100,25,2,00286,India
464079,2023-05-12,208,sprite,75,100,25,2,00385,India
464079,2023-05-12,201,paneer,210,340,130,1,00385,India
464079,2023-05-12,211,red bull,90,125,35,2,00385,India
793934,2023-05-12,206,yakult,360,400,40,2,00015,India
793934,2023-05-12,202,milk,12,27,15,1,00015,India
793934,2023-05-12,201,paneer,210,340,130,1,00015,India
793934,2023-05-12,203,mango yogurt,50,60,10,2,00015,India
288644,2023-05-12,201,paneer,210,340,130,1,00222,India
288644,2023-05-12,203,mango yogurt,50,60,10,2,00222,India
758297,2023-05-12,202,milk,12,27,15,1,00430,India
758297,2023-05-12,207,coca cola,75,100,25,2,00430,India
758297,2023-05-12,201,paneer,210,340,130,1,00430,India
356268,2023-05-12,202,milk,12,27,15,1,00132,India
356268,2023-05-12,212,amul cheese,250,315,65,1,00132,India
356268,2023-05-12,206,yakult,360,400,40,2,00132,India
356268,2023-05-12,211,red bull,90,125,35,2,00132,India
356268,2023-05-12,209,pepsi,75,100,25,2,00132,India
676225,2023-05-12,203,mango yogurt,50,60,10,2,00172,India
676225,2023-05-12,207,coca cola,75,100,25,2,00172,India
284119,2023-05-12,204,strawberry yogurt,50,60,10,2,00052,India
284119,2023-05-12,203,mango yogurt,50,60,10,2,00052,India
284119,2023-05-12,208,sprite,75,100,25,2,00052,India
596740,2023-05-12,212,amul cheese,250,315,65,1,00398,India
918966,2023-05-12,202,milk,12,27,15,1,00284,India
918966,2023-05-12,205,classic yogurt,45,60,15,2,00284,India
287942,2023-05-12,208,sprite,75,100,25,2,00439,India
287942,2023-05-12,204,strawberry yogurt,50,60,10,2,00439,India
778518,2023-05-12,203,mango yogurt,50,60,10,2,00222,India
340868,2023-05-12,203,mango yogurt,50,60,10,2,00421,India
340868,2023-05-12,206,yakult,360,400,40,2,00421,India
383926,2023-05-12,207,coca cola,75,100,25,2,00156,India
383926,2023-05-12,203,mango yogurt,50,60,10,2,00156,India
374802,2023-05-12,213,bisleri,6,15,9,2,00467,India
374802,2023-05-12,211,red bull,90,125,35,2,00467,India
374802,2023-05-12,202,milk,12,27,15,1,00467,India
374802,2023-05-12,206,yakult,360,400,40,2,00467,India
771542,2023-05-12,206,yakult,360,400,40,2,00043,India
771542,2023-05-12,204,strawberry yogurt,50,60,10,2,00043,India
771542,2023-05-12,209,pepsi,75,100,25,2,00043,India
588996,2023-05-12,212,amul cheese,250,315,65,1,00344,India
588996,2023-05-12,201,paneer,210,340,130,1,00344,India
588996,2023-05-12,211,red bull,90,125,35,2,00344,India
588996,2023-05-12,206,yakult,360,400,40,2,00344,India
352932,2023-05-12,204,strawberry yogurt,50,60,10,2,00288,India
704880,2023-05-12,206,yakult,360,400,40,2,00330,India
704880,2023-05-12,201,paneer,210,340,130,1,00330,India
704880,2023-05-12,209,pepsi,75,100,25,2,00330,India
495452,2023-05-12,201,paneer,210,340,130,1,00447,India
238136,2023-05-12,203,mango yogurt,50,60,10,2,00489,India
238136,2023-05-12,209,pepsi,75,100,25,2,00489,India
238136,2023-05-12,206,yakult,360,400,40,2,00489,India
238136,2023-05-12,207,coca cola,75,100,25,2,00489,India
766046,2023-05-12,212,amul cheese,250,315,65,1,00007,India
766046,2023-05-12,213,bisleri,6,15,9,2,00007,India
766046,2023-05-12,206,yakult,360,400,40,2,00007,India
766046,2023-05-12,201,paneer,210,340,130,1,00007,India
519127,2023-05-12,210,mountain dew,75,100,25,2,00143,India
519127,2023-05-12,211,red bull,90,125,35,2,00143,India
519127,2023-05-12,212,amul cheese,250,315,65,1,00143,India
663005,2023-05-12,208,sprite,75,100,25,2,00271,India
663005,2023-05-12,209,pepsi,75,100,25,2,00271,India
238674,2023-05-12,205,classic yogurt,45,60,15,2,00163,India
741166,2023-05-12,213,bisleri,6,15,9,2,00446,India
294984,2023-05-12,201,paneer,210,340,130,1,00115,India
294984,2023-05-12,210,mountain dew,75,100,25,2,00115,India
294984,2023-05-12,203,mango yogurt,50,60,10,2,00115,India
294984,2023-05-12,206,yakult,360,400,40,2,00115,India
839072,2023-05-12,206,yakult,360,400,40,2,00053,India
839072,2023-05-12,212,amul cheese,250,315,65,1,00053,India
149745,2023-05-12,207,coca cola,75,100,25,2,00251,India
149745,2023-05-12,212,amul cheese,250,315,65,1,00251,India
149745,2023-05-12,211,red bull,90,125,35,2,00251,India
149745,2023-05-12,210,mountain dew,75,100,25,2,00251,India
149745,2023-05-12,208,sprite,75,100,25,2,00251,India
769575,2023-05-12,202,milk,12,27,15,1,00164,India
268295,2023-05-12,211,red bull,90,125,35,2,00447,India
268295,2023-05-12,213,bisleri,6,15,9,2,00447,India
249157,2023-05-12,207,coca cola,75,100,25,2,00099,India
249157,2023-05-12,201,paneer,210,340,130,1,00099,India
212632,2023-05-12,202,milk,12,27,15,1,00007,India
212632,2023-05-12,212,amul cheese,250,315,65,1,00007,India
549244,2023-05-12,206,yakult,360,400,40,2,00178,India
549244,2023-05-12,210,mountain dew,75,100,25,2,00178,India
549244,2023-05-12,204,strawberry yogurt,50,60,10,2,00178,India
751278,2023-05-12,201,paneer,210,340,130,1,00404,India
751278,2023-05-12,212,amul cheese,250,315,65,1,00404,India
751278,2023-05-12,205,classic yogurt,45,60,15,2,00404,India
751278,2023-05-12,211,red bull,90,125,35,2,00404,India
578748,2023-05-12,202,milk,12,27,15,1,00111,India
578748,2023-05-12,205,classic yogurt,45,60,15,2,00111,India
578748,2023-05-12,204,strawberry yogurt,50,60,10,2,00111,India
578748,2023-05-12,211,red bull,90,125,35,2,00111,India
355061,2023-05-12,202,milk,12,27,15,1,00158,India
355061,2023-05-12,206,yakult,360,400,40,2,00158,India
355061,2023-05-12,207,coca cola,75,100,25,2,00158,India
724093,2023-05-12,201,paneer,210,340,130,1,00457,India
724093,2023-05-12,211,red bull,90,125,35,2,00457,India
343823,2023-05-12,204,strawberry yogurt,50,60,10,2,00498,India
343823,2023-05-12,213,bisleri,6,15,9,2,00498,India
343823,2023-05-12,201,paneer,210,340,130,1,00498,India
661186,2023-05-12,202,milk,12,27,15,1,00473,India
661186,2023-05-12,212,amul cheese,250,315,65,1,00473,India
661186,2023-05-12,201,paneer,210,340,130,1,00473,India
661186,2023-05-12,208,sprite,75,100,25,2,00473,India
425325,2023-05-12,208,sprite,75,100,25,2,00204,India
516081,2023-05-12,207,coca cola,75,100,25,2,00145,India
516081,2023-05-12,203,mango yogurt,50,60,10,2,00145,India
516081,2023-05-12,211,red bull,90,125,35,2,00145,India
516081,2023-05-12,208,sprite,75,100,25,2,00145,India
206115,2023-05-12,207,coca cola,75,100,25,2,00306,India
206115,2023-05-12,204,strawberry yogurt,50,60,10,2,00306,India
206115,2023-05-12,208,sprite,75,100,25,2,00306,India
206115,2023-05-12,213,bisleri,6,15,9,2,00306,India
425503,2023-05-13,209,pepsi,75,100,25,2,00301,India
425503,2023-05-13,210,mountain dew,75,100,25,2,00301,India
660383,2023-05-13,213,bisleri,6,15,9,2,00301,India
660383,2023-05-13,204,strawberry yogurt,50,60,10,2,00301,India
660383,2023-05-13,212,amul cheese,250,315,65,1,00301,India
660383,2023-05-13,207,coca cola,75,100,25,2,00301,India
188339,2023-05-13,212,amul cheese,250,315,65,1,00339,India
188339,2023-05-13,208,sprite,75,100,25,2,00339,India
188339,2023-05-13,211,red bull,90,125,35,2,00339,India
352741,2023-05-13,212,amul cheese,250,315,65,1,00367,India
352741,2023-05-13,206,yakult,360,400,40,2,00367,India
352741,2023-05-13,208,sprite,75,100,25,2,00367,India
352741,2023-05-13,207,coca cola,75,100,25,2,00367,India
991950,2023-05-13,208,sprite,75,100,25,2,00071,India
991950,2023-05-13,203,mango yogurt,50,60,10,2,00071,India
991950,2023-05-13,204,strawberry yogurt,50,60,10,2,00071,India
991950,2023-05-13,202,milk,12,27,15,1,00071,India
991950,2023-05-13,205,classic yogurt,45,60,15,2,00071,India
298229,2023-05-13,209,pepsi,75,100,25,2,00385,India
298229,2023-05-13,206,yakult,360,400,40,2,00385,India
554915,2023-05-13,202,milk,12,27,15,1,00484,India
496329,2023-05-13,210,mountain dew,75,100,25,2,00269,India
300219,2023-05-13,203,mango yogurt,50,60,10,2,00073,India
300219,2023-05-13,210,mountain dew,75,100,25,2,00073,India
300219,2023-05-13,211,red bull,90,125,35,2,00073,India
300219,2023-05-13,213,bisleri,6,15,9,2,00073,India
300219,2023-05-13,206,yakult,360,400,40,2,00073,India
822333,2023-05-13,203,mango yogurt,50,60,10,2,00085,India
822333,2023-05-13,201,paneer,210,340,130,1,00085,India
822333,2023-05-13,209,pepsi,75,100,25,2,00085,India
822333,2023-05-13,207,coca cola,75,100,25,2,00085,India
822333,2023-05-13,202,milk,12,27,15,1,00085,India
965917,2023-05-13,204,strawberry yogurt,50,60,10,2,00081,India
965917,2023-05-13,211,red bull,90,125,35,2,00081,India
127315,2023-05-13,203,mango yogurt,50,60,10,2,00490,India
127315,2023-05-13,210,mountain dew,75,100,25,2,00490,India
127315,2023-05-13,205,classic yogurt,45,60,15,2,00490,India
127315,2023-05-13,213,bisleri,6,15,9,2,00490,India
918128,2023-05-13,213,bisleri,6,15,9,2,00158,India
918128,2023-05-13,208,sprite,75,100,25,2,00158,India
918128,2023-05-13,206,yakult,360,400,40,2,00158,India
918128,2023-05-13,201,paneer,210,340,130,1,00158,India
592550,2023-05-13,203,mango yogurt,50,60,10,2,00371,India
883281,2023-05-13,207,coca cola,75,100,25,2,00047,India
879275,2023-05-13,210,mountain dew,75,100,25,2,00020,India
879275,2023-05-13,205,classic yogurt,45,60,15,2,00020,India
879275,2023-05-13,203,mango yogurt,50,60,10,2,00020,India
879275,2023-05-13,202,milk,12,27,15,1,00020,India
879275,2023-05-13,212,amul cheese,250,315,65,1,00020,India
891028,2023-05-13,204,strawberry yogurt,50,60,10,2,00191,India
523423,2023-05-13,213,bisleri,6,15,9,2,00459,India
523423,2023-05-13,208,sprite,75,100,25,2,00459,India
523423,2023-05-13,205,classic yogurt,45,60,15,2,00459,India
258444,2023-05-13,209,pepsi,75,100,25,2,00258,India
258444,2023-05-13,207,coca cola,75,100,25,2,00258,India
258444,2023-05-13,210,mountain dew,75,100,25,2,00258,India
258444,2023-05-13,212,amul cheese,250,315,65,1,00258,India
474631,2023-05-13,204,strawberry yogurt,50,60,10,2,00240,India
166246,2023-05-13,213,bisleri,6,15,9,2,00082,India
158900,2023-05-13,201,paneer,210,340,130,1,00220,India
158900,2023-05-13,211,red bull,90,125,35,2,00220,India
658133,2023-05-13,212,amul cheese,250,315,65,1,00265,India
658133,2023-05-13,210,mountain dew,75,100,25,2,00265,India
720838,2023-05-13,201,paneer,210,340,130,1,00488,India
720838,2023-05-13,206,yakult,360,400,40,2,00488,India
720838,2023-05-13,213,bisleri,6,15,9,2,00488,India
731225,2023-05-13,202,milk,12,27,15,1,00215,India
731225,2023-05-13,201,paneer,210,340,130,1,00215,India
815711,2023-05-13,208,sprite,75,100,25,2,00335,India
859895,2023-05-13,202,milk,12,27,15,1,00094,India
475659,2023-05-13,210,mountain dew,75,100,25,2,00410,India
475659,2023-05-13,204,strawberry yogurt,50,60,10,2,00410,India
948155,2023-05-13,210,mountain dew,75,100,25,2,00345,India
948155,2023-05-13,201,paneer,210,340,130,1,00345,India
948155,2023-05-13,203,mango yogurt,50,60,10,2,00345,India
699837,2023-05-13,206,yakult,360,400,40,2,00387,India
699837,2023-05-13,204,strawberry yogurt,50,60,10,2,00387,India
699837,2023-05-13,210,mountain dew,75,100,25,2,00387,India
998663,2023-05-13,206,yakult,360,400,40,2,00423,India
998663,2023-05-13,209,pepsi,75,100,25,2,00423,India
426921,2023-05-13,202,milk,12,27,15,1,00444,India
935131,2023-05-13,210,mountain dew,75,100,25,2,00397,India
935131,2023-05-13,203,mango yogurt,50,60,10,2,00397,India
147146,2023-05-13,212,amul cheese,250,315,65,1,00021,India
147146,2023-05-13,210,mountain dew,75,100,25,2,00021,India
147146,2023-05-13,211,red bull,90,125,35,2,00021,India
147146,2023-05-13,213,bisleri,6,15,9,2,00021,India
518096,2023-05-13,204,strawberry yogurt,50,60,10,2,00371,India
518096,2023-05-13,213,bisleri,6,15,9,2,00371,India
518096,2023-05-13,201,paneer,210,340,130,1,00371,India
227465,2023-05-13,206,yakult,360,400,40,2,00227,India
227465,2023-05-13,205,classic yogurt,45,60,15,2,00227,India
227465,2023-05-13,207,coca cola,75,100,25,2,00227,India
227465,2023-05-13,212,amul cheese,250,315,65,1,00227,India
227465,2023-05-13,203,mango yogurt,50,60,10,2,00227,India
967372,2023-05-13,213,bisleri,6,15,9,2,00246,India
967372,2023-05-13,211,red bull,90,125,35,2,00246,India
605536,2023-05-13,211,red bull,90,125,35,2,00259,India
605536,2023-05-13,208,sprite,75,100,25,2,00259,India
605536,2023-05-13,201,paneer,210,340,130,1,00259,India
605536,2023-05-13,205,classic yogurt,45,60,15,2,00259,India
605536,2023-05-13,212,amul cheese,250,315,65,1,00259,India
790703,2023-05-13,206,yakult,360,400,40,2,00244,India
790703,2023-05-13,208,sprite,75,100,25,2,00244,India
790703,2023-05-13,205,classic yogurt,45,60,15,2,00244,India
369871,2023-05-13,209,pepsi,75,100,25,2,00022,India
369871,2023-05-13,206,yakult,360,400,40,2,00022,India
630002,2023-05-13,206,yakult,360,400,40,2,00164,India
630002,2023-05-13,209,pepsi,75,100,25,2,00164,India
802532,2023-05-13,201,paneer,210,340,130,1,00149,India
802532,2023-05-13,207,coca cola,75,100,25,2,00149,India
802532,2023-05-13,205,classic yogurt,45,60,15,2,00149,India
802532,2023-05-13,202,milk,12,27,15,1,00149,India
802532,2023-05-13,211,red bull,90,125,35,2,00149,India
455889,2023-05-13,203,mango yogurt,50,60,10,2,00263,India
455889,2023-05-13,201,paneer,210,340,130,1,00263,India
455889,2023-05-13,207,coca cola,75,100,25,2,00263,India
455889,2023-05-13,202,milk,12,27,15,1,00263,India
775831,2023-05-13,213,bisleri,6,15,9,2,00113,India
675646,2023-05-13,210,mountain dew,75,100,25,2,00075,India
675646,2023-05-13,207,coca cola,75,100,25,2,00075,India
941086,2023-05-13,211,red bull,90,125,35,2,00017,India
941086,2023-05-13,201,paneer,210,340,130,1,00017,India
941086,2023-05-13,204,strawberry yogurt,50,60,10,2,00017,India
631790,2023-05-13,202,milk,12,27,15,1,00235,India
631790,2023-05-13,206,yakult,360,400,40,2,00235,India
436723,2023-05-13,212,amul cheese,250,315,65,1,00273,India
436723,2023-05-13,207,coca cola,75,100,25,2,00273,India
436723,2023-05-13,209,pepsi,75,100,25,2,00273,India
488617,2023-05-13,206,yakult,360,400,40,2,00365,India
488617,2023-05-13,209,pepsi,75,100,25,2,00365,India
131061,2023-05-13,207,coca cola,75,100,25,2,00461,India
131061,2023-05-13,206,yakult,360,400,40,2,00461,India
131061,2023-05-13,209,pepsi,75,100,25,2,00461,India
742299,2023-05-13,213,bisleri,6,15,9,2,00469,India
742299,2023-05-13,203,mango yogurt,50,60,10,2,00469,India
467984,2023-05-13,206,yakult,360,400,40,2,00105,India
316091,2023-05-13,211,red bull,90,125,35,2,00158,India
316091,2023-05-13,206,yakult,360,400,40,2,00158,India
624005,2023-05-13,203,mango yogurt,50,60,10,2,00050,India
624005,2023-05-13,212,amul cheese,250,315,65,1,00050,India
575416,2023-05-13,213,bisleri,6,15,9,2,00180,India
575416,2023-05-13,208,sprite,75,100,25,2,00180,India
193220,2023-05-13,212,amul cheese,250,315,65,1,00043,India
193220,2023-05-13,206,yakult,360,400,40,2,00043,India
193220,2023-05-13,213,bisleri,6,15,9,2,00043,India
193220,2023-05-13,203,mango yogurt,50,60,10,2,00043,India
572655,2023-05-13,205,classic yogurt,45,60,15,2,00356,India
572655,2023-05-13,212,amul cheese,250,315,65,1,00356,India
572655,2023-05-13,206,yakult,360,400,40,2,00356,India
572655,2023-05-13,201,paneer,210,340,130,1,00356,India
940899,2023-05-13,205,classic yogurt,45,60,15,2,00014,India
940899,2023-05-13,212,amul cheese,250,315,65,1,00014,India
914501,2023-05-13,212,amul cheese,250,315,65,1,00077,India
914501,2023-05-13,210,mountain dew,75,100,25,2,00077,India
949690,2023-05-13,206,yakult,360,400,40,2,00446,India
949690,2023-05-13,203,mango yogurt,50,60,10,2,00446,India
949690,2023-05-13,205,classic yogurt,45,60,15,2,00446,India
949690,2023-05-13,204,strawberry yogurt,50,60,10,2,00446,India
374585,2023-05-13,205,classic yogurt,45,60,15,2,00278,India
374585,2023-05-13,203,mango yogurt,50,60,10,2,00278,India
374585,2023-05-13,209,pepsi,75,100,25,2,00278,India
374585,2023-05-13,210,mountain dew,75,100,25,2,00278,India
717865,2023-05-13,202,milk,12,27,15,1,00169,India
717865,2023-05-13,201,paneer,210,340,130,1,00169,India
717865,2023-05-13,208,sprite,75,100,25,2,00169,India
506551,2023-05-13,205,classic yogurt,45,60,15,2,00280,India
673021,2023-05-13,210,mountain dew,75,100,25,2,00139,India
673021,2023-05-13,209,pepsi,75,100,25,2,00139,India
673021,2023-05-13,212,amul cheese,250,315,65,1,00139,India
673021,2023-05-13,203,mango yogurt,50,60,10,2,00139,India
983789,2023-05-13,210,mountain dew,75,100,25,2,00032,India
983789,2023-05-13,202,milk,12,27,15,1,00032,India
939337,2023-05-13,202,milk,12,27,15,1,00317,India
302220,2023-05-13,203,mango yogurt,50,60,10,2,00070,India
302220,2023-05-13,213,bisleri,6,15,9,2,00070,India
302220,2023-05-13,208,sprite,75,100,25,2,00070,India
373477,2023-05-13,213,bisleri,6,15,9,2,00150,India
373477,2023-05-13,204,strawberry yogurt,50,60,10,2,00150,India
373477,2023-05-13,202,milk,12,27,15,1,00150,India
373477,2023-05-13,203,mango yogurt,50,60,10,2,00150,India
373477,2023-05-13,212,amul cheese,250,315,65,1,00150,India
264603,2023-05-13,209,pepsi,75,100,25,2,00360,India
264603,2023-05-13,204,strawberry yogurt,50,60,10,2,00360,India
294964,2023-05-13,204,strawberry yogurt,50,60,10,2,00399,India
294964,2023-05-13,203,mango yogurt,50,60,10,2,00399,India
294964,2023-05-13,210,mountain dew,75,100,25,2,00399,India
700337,2023-05-13,213,bisleri,6,15,9,2,00252,India
700337,2023-05-13,202,milk,12,27,15,1,00252,India
700337,2023-05-13,209,pepsi,75,100,25,2,00252,India
700337,2023-05-13,206,yakult,360,400,40,2,00252,India
648281,2023-05-13,210,mountain dew,75,100,25,2,00259,India
648281,2023-05-13,204,strawberry yogurt,50,60,10,2,00259,India
648281,2023-05-13,211,red bull,90,125,35,2,00259,India
306841,2023-05-13,210,mountain dew,75,100,25,2,00404,India
306841,2023-05-13,208,sprite,75,100,25,2,00404,India
306841,2023-05-13,201,paneer,210,340,130,1,00404,India
862478,2023-05-13,209,pepsi,75,100,25,2,00182,India
862478,2023-05-13,212,amul cheese,250,315,65,1,00182,India
862478,2023-05-13,202,milk,12,27,15,1,00182,India
862478,2023-05-13,206,yakult,360,400,40,2,00182,India
862478,2023-05-13,205,classic yogurt,45,60,15,2,00182,India
135390,2023-05-13,211,red bull,90,125,35,2,00493,India
322623,2023-05-13,209,pepsi,75,100,25,2,00079,India
322623,2023-05-13,204,strawberry yogurt,50,60,10,2,00079,India
322623,2023-05-13,210,mountain dew,75,100,25,2,00079,India
797766,2023-05-13,202,milk,12,27,15,1,00244,India
238548,2023-05-13,210,mountain dew,75,100,25,2,00163,India
238548,2023-05-13,211,red bull,90,125,35,2,00163,India
238548,2023-05-13,213,bisleri,6,15,9,2,00163,India
406781,2023-05-13,211,red bull,90,125,35,2,00236,India
406781,2023-05-13,203,mango yogurt,50,60,10,2,00236,India
395179,2023-05-13,205,classic yogurt,45,60,15,2,00267,India
282861,2023-05-13,204,strawberry yogurt,50,60,10,2,00066,India
282861,2023-05-13,211,red bull,90,125,35,2,00066,India
858949,2023-05-13,203,mango yogurt,50,60,10,2,00042,India
639709,2023-05-13,203,mango yogurt,50,60,10,2,00138,India
639709,2023-05-13,209,pepsi,75,100,25,2,00138,India
639709,2023-05-13,202,milk,12,27,15,1,00138,India
639709,2023-05-13,201,paneer,210,340,130,1,00138,India
931471,2023-05-13,210,mountain dew,75,100,25,2,00027,India
931471,2023-05-13,208,sprite,75,100,25,2,00027,India
931471,2023-05-13,202,milk,12,27,15,1,00027,India
774218,2023-05-13,213,bisleri,6,15,9,2,00132,India
774218,2023-05-13,202,milk,12,27,15,1,00132,India
774218,2023-05-13,211,red bull,90,125,35,2,00132,India
774218,2023-05-13,207,coca cola,75,100,25,2,00132,India
774218,2023-05-13,201,paneer,210,340,130,1,00132,India
124173,2023-05-13,213,bisleri,6,15,9,2,00028,India
124173,2023-05-13,201,paneer,210,340,130,1,00028,India
140510,2023-05-13,205,classic yogurt,45,60,15,2,00233,India
140510,2023-05-13,203,mango yogurt,50,60,10,2,00233,India
140510,2023-05-13,210,mountain dew,75,100,25,2,00233,India
140510,2023-05-13,211,red bull,90,125,35,2,00233,India
819956,2023-05-13,211,red bull,90,125,35,2,00324,India
280896,2023-05-13,203,mango yogurt,50,60,10,2,00246,India
280896,2023-05-13,209,pepsi,75,100,25,2,00246,India
280896,2023-05-13,206,yakult,360,400,40,2,00246,India
152634,2023-05-14,206,yakult,360,400,40,2,00309,India
152634,2023-05-14,204,strawberry yogurt,50,60,10,2,00309,India
152634,2023-05-14,212,amul cheese,250,315,65,1,00309,India
152634,2023-05-14,213,bisleri,6,15,9,2,00309,India
120986,2023-05-14,208,sprite,75,100,25,2,00065,India
120986,2023-05-14,204,strawberry yogurt,50,60,10,2,00065,India
679025,2023-05-14,203,mango yogurt,50,60,10,2,00093,India
679025,2023-05-14,209,pepsi,75,100,25,2,00093,India
679025,2023-05-14,204,strawberry yogurt,50,60,10,2,00093,India
101785,2023-05-14,212,amul cheese,250,315,65,1,00109,India
101785,2023-05-14,205,classic yogurt,45,60,15,2,00109,India
347008,2023-05-14,207,coca cola,75,100,25,2,00041,India
347008,2023-05-14,202,milk,12,27,15,1,00041,India
347008,2023-05-14,201,paneer,210,340,130,1,00041,India
347008,2023-05-14,205,classic yogurt,45,60,15,2,00041,India
897491,2023-05-14,208,sprite,75,100,25,2,00276,India
897491,2023-05-14,212,amul cheese,250,315,65,1,00276,India
897491,2023-05-14,213,bisleri,6,15,9,2,00276,India
897491,2023-05-14,210,mountain dew,75,100,25,2,00276,India
174318,2023-05-14,201,paneer,210,340,130,1,00320,India
174318,2023-05-14,211,red bull,90,125,35,2,00320,India
174318,2023-05-14,204,strawberry yogurt,50,60,10,2,00320,India
174318,2023-05-14,207,coca cola,75,100,25,2,00320,India
174318,2023-05-14,209,pepsi,75,100,25,2,00320,India
552881,2023-05-14,202,milk,12,27,15,1,00331,India
552881,2023-05-14,211,red bull,90,125,35,2,00331,India
464523,2023-05-14,208,sprite,75,100,25,2,00370,India
700427,2023-05-14,204,strawberry yogurt,50,60,10,2,00362,India
700427,2023-05-14,206,yakult,360,400,40,2,00362,India
700427,2023-05-14,213,bisleri,6,15,9,2,00362,India
986985,2023-05-14,203,mango yogurt,50,60,10,2,00309,India
986985,2023-05-14,207,coca cola,75,100,25,2,00309,India
649481,2023-05-14,211,red bull,90,125,35,2,00314,India
649481,2023-05-14,205,classic yogurt,45,60,15,2,00314,India
649481,2023-05-14,207,coca cola,75,100,25,2,00314,India
314785,2023-05-14,204,strawberry yogurt,50,60,10,2,00414,India
314785,2023-05-14,213,bisleri,6,15,9,2,00414,India
703056,2023-05-14,208,sprite,75,100,25,2,00475,India
703056,2023-05-14,205,classic yogurt,45,60,15,2,00475,India
241219,2023-05-14,210,mountain dew,75,100,25,2,00398,India
241219,2023-05-14,201,paneer,210,340,130,1,00398,India
241219,2023-05-14,212,amul cheese,250,315,65,1,00398,India
241219,2023-05-14,205,classic yogurt,45,60,15,2,00398,India
512048,2023-05-14,210,mountain dew,75,100,25,2,00219,India
512048,2023-05-14,203,mango yogurt,50,60,10,2,00219,India
512048,2023-05-14,212,amul cheese,250,315,65,1,00219,India
526298,2023-05-14,201,paneer,210,340,130,1,00046,India
526298,2023-05-14,207,coca cola,75,100,25,2,00046,India
526298,2023-05-14,202,milk,12,27,15,1,00046,India
526298,2023-05-14,205,classic yogurt,45,60,15,2,00046,India
706006,2023-05-14,210,mountain dew,75,100,25,2,00381,India
706006,2023-05-14,207,coca cola,75,100,25,2,00381,India
706006,2023-05-14,209,pepsi,75,100,25,2,00381,India
371200,2023-05-14,203,mango yogurt,50,60,10,2,00312,India
119419,2023-05-14,202,milk,12,27,15,1,00449,India
119419,2023-05-14,203,mango yogurt,50,60,10,2,00449,India
791570,2023-05-14,208,sprite,75,100,25,2,00419,India
791570,2023-05-14,209,pepsi,75,100,25,2,00419,India
791570,2023-05-14,202,milk,12,27,15,1,00419,India
791570,2023-05-14,203,mango yogurt,50,60,10,2,00419,India
634561,2023-05-14,204,strawberry yogurt,50,60,10,2,00422,India
413938,2023-05-14,211,red bull,90,125,35,2,00387,India
413938,2023-05-14,209,pepsi,75,100,25,2,00387,India
413938,2023-05-14,208,sprite,75,100,25,2,00387,India
413938,2023-05-14,201,paneer,210,340,130,1,00387,India
837311,2023-05-14,209,pepsi,75,100,25,2,00290,India
153454,2023-05-14,204,strawberry yogurt,50,60,10,2,00235,India
153454,2023-05-14,208,sprite,75,100,25,2,00235,India
153454,2023-05-14,202,milk,12,27,15,1,00235,India
153454,2023-05-14,205,classic yogurt,45,60,15,2,00235,India
153454,2023-05-14,211,red bull,90,125,35,2,00235,India
469998,2023-05-14,210,mountain dew,75,100,25,2,00036,India
469998,2023-05-14,211,red bull,90,125,35,2,00036,India
618604,2023-05-14,206,yakult,360,400,40,2,00302,India
618604,2023-05-14,210,mountain dew,75,100,25,2,00302,India
618604,2023-05-14,205,classic yogurt,45,60,15,2,00302,India
618604,2023-05-14,213,bisleri,6,15,9,2,00302,India
828450,2023-05-14,209,pepsi,75,100,25,2,00252,India
828450,2023-05-14,206,yakult,360,400,40,2,00252,India
828450,2023-05-14,208,sprite,75,100,25,2,00252,India
828450,2023-05-14,212,amul cheese,250,315,65,1,00252,India
483505,2023-05-14,201,paneer,210,340,130,1,00065,India
483505,2023-05-14,211,red bull,90,125,35,2,00065,India
483505,2023-05-14,213,bisleri,6,15,9,2,00065,India
483505,2023-05-14,202,milk,12,27,15,1,00065,India
777470,2023-05-14,212,amul cheese,250,315,65,1,00412,India
777470,2023-05-14,210,mountain dew,75,100,25,2,00412,India
777470,2023-05-14,209,pepsi,75,100,25,2,00412,India
777470,2023-05-14,211,red bull,90,125,35,2,00412,India
973075,2023-05-14,201,paneer,210,340,130,1,00042,India
741455,2023-05-14,212,amul cheese,250,315,65,1,00107,India
741455,2023-05-14,204,strawberry yogurt,50,60,10,2,00107,India
741455,2023-05-14,207,coca cola,75,100,25,2,00107,India
454112,2023-05-14,205,classic yogurt,45,60,15,2,00330,India
454112,2023-05-14,202,milk,12,27,15,1,00330,India
454112,2023-05-14,201,paneer,210,340,130,1,00330,India
454112,2023-05-14,213,bisleri,6,15,9,2,00330,India
454112,2023-05-14,210,mountain dew,75,100,25,2,00330,India
202334,2023-05-14,211,red bull,90,125,35,2,00419,India
202334,2023-05-14,209,pepsi,75,100,25,2,00419,India
202334,2023-05-14,204,strawberry yogurt,50,60,10,2,00419,India
202334,2023-05-14,212,amul cheese,250,315,65,1,00419,India
822661,2023-05-14,209,pepsi,75,100,25,2,00020,India
822661,2023-05-14,205,classic yogurt,45,60,15,2,00020,India
390971,2023-05-14,207,coca cola,75,100,25,2,00448,India
390971,2023-05-14,209,pepsi,75,100,25,2,00448,India
390971,2023-05-14,206,yakult,360,400,40,2,00448,India
642792,2023-05-14,211,red bull,90,125,35,2,00302,India
642792,2023-05-14,203,mango yogurt,50,60,10,2,00302,India
642792,2023-05-14,212,amul cheese,250,315,65,1,00302,India
682907,2023-05-14,204,strawberry yogurt,50,60,10,2,00434,India
682907,2023-05-14,202,milk,12,27,15,1,00434,India
682907,2023-05-14,212,amul cheese,250,315,65,1,00434,India
682907,2023-05-14,206,yakult,360,400,40,2,00434,India
344920,2023-05-14,204,strawberry yogurt,50,60,10,2,00241,India
344920,2023-05-14,206,yakult,360,400,40,2,00241,India
344920,2023-05-14,208,sprite,75,100,25,2,00241,India
944445,2023-05-14,207,coca cola,75,100,25,2,00498,India
944445,2023-05-14,212,amul cheese,250,315,65,1,00498,India
944445,2023-05-14,205,classic yogurt,45,60,15,2,00498,India
768600,2023-05-14,207,coca cola,75,100,25,2,00158,India
897154,2023-05-14,202,milk,12,27,15,1,00183,India
897154,2023-05-14,212,amul cheese,250,315,65,1,00183,India
749463,2023-05-14,208,sprite,75,100,25,2,00033,India
749463,2023-05-14,205,classic yogurt,45,60,15,2,00033,India
749463,2023-05-14,209,pepsi,75,100,25,2,00033,India
749463,2023-05-14,207,coca cola,75,100,25,2,00033,India
197001,2023-05-14,210,mountain dew,75,100,25,2,00242,India
879336,2023-05-14,203,mango yogurt,50,60,10,2,00038,India
879336,2023-05-14,208,sprite,75,100,25,2,00038,India
873767,2023-05-14,210,mountain dew,75,100,25,2,00023,India
754651,2023-05-14,205,classic yogurt,45,60,15,2,00308,India
754651,2023-05-14,208,sprite,75,100,25,2,00308,India
754651,2023-05-14,206,yakult,360,400,40,2,00308,India
461025,2023-05-14,202,milk,12,27,15,1,00338,India
461025,2023-05-14,203,mango yogurt,50,60,10,2,00338,India
117133,2023-05-14,201,paneer,210,340,130,1,00306,India
117133,2023-05-14,210,mountain dew,75,100,25,2,00306,India
117133,2023-05-14,207,coca cola,75,100,25,2,00306,India
117133,2023-05-14,203,mango yogurt,50,60,10,2,00306,India
368330,2023-05-14,212,amul cheese,250,315,65,1,00436,India
330458,2023-05-14,212,amul cheese,250,315,65,1,00348,India
803031,2023-05-14,205,classic yogurt,45,60,15,2,00482,India
803031,2023-05-14,204,strawberry yogurt,50,60,10,2,00482,India
803031,2023-05-14,210,mountain dew,75,100,25,2,00482,India
803031,2023-05-14,209,pepsi,75,100,25,2,00482,India
144876,2023-05-14,213,bisleri,6,15,9,2,00138,India
144876,2023-05-14,204,strawberry yogurt,50,60,10,2,00138,India
144876,2023-05-14,211,red bull,90,125,35,2,00138,India
144876,2023-05-14,209,pepsi,75,100,25,2,00138,India
959742,2023-05-14,204,strawberry yogurt,50,60,10,2,00024,India
959742,2023-05-14,213,bisleri,6,15,9,2,00024,India
959742,2023-05-14,206,yakult,360,400,40,2,00024,India
214277,2023-05-14,210,mountain dew,75,100,25,2,00216,India
214277,2023-05-14,205,classic yogurt,45,60,15,2,00216,India
214277,2023-05-14,213,bisleri,6,15,9,2,00216,India
214277,2023-05-14,202,milk,12,27,15,1,00216,India
214277,2023-05-14,201,paneer,210,340,130,1,00216,India
577140,2023-05-14,207,coca cola,75,100,25,2,00016,India
328026,2023-05-14,211,red bull,90,125,35,2,00288,India
925209,2023-05-14,212,amul cheese,250,315,65,1,00249,India
925209,2023-05-14,202,milk,12,27,15,1,00249,India
925209,2023-05-14,211,red bull,90,125,35,2,00249,India
995557,2023-05-14,213,bisleri,6,15,9,2,00177,India
719041,2023-05-14,211,red bull,90,125,35,2,00270,India
910656,2023-05-14,212,amul cheese,250,315,65,1,00110,India
910656,2023-05-14,210,mountain dew,75,100,25,2,00110,India
910656,2023-05-14,211,red bull,90,125,35,2,00110,India
748226,2023-05-14,202,milk,12,27,15,1,00115,India
748226,2023-05-14,210,mountain dew,75,100,25,2,00115,India
748226,2023-05-14,213,bisleri,6,15,9,2,00115,India
748226,2023-05-14,209,pepsi,75,100,25,2,00115,India
268880,2023-05-14,211,red bull,90,125,35,2,00285,India
892846,2023-05-14,212,amul cheese,250,315,65,1,00449,India
892846,2023-05-14,201,paneer,210,340,130,1,00449,India
635179,2023-05-14,201,paneer,210,340,130,1,00020,India
652117,2023-05-14,201,paneer,210,340,130,1,00039,India
652117,2023-05-14,213,bisleri,6,15,9,2,00039,India
940600,2023-05-14,208,sprite,75,100,25,2,00310,India
940600,2023-05-14,205,classic yogurt,45,60,15,2,00310,India
940600,2023-05-14,209,pepsi,75,100,25,2,00310,India
940600,2023-05-14,212,amul cheese,250,315,65,1,00310,India
326681,2023-05-14,208,sprite,75,100,25,2,00049,India
326681,2023-05-14,206,yakult,360,400,40,2,00049,India
326681,2023-05-14,212,amul cheese,250,315,65,1,00049,India
326681,2023-05-14,204,strawberry yogurt,50,60,10,2,00049,India
326681,2023-05-14,210,mountain dew,75,100,25,2,00049,India
165747,2023-05-14,209,pepsi,75,100,25,2,00256,India
165747,2023-05-14,210,mountain dew,75,100,25,2,00256,India
165747,2023-05-14,203,mango yogurt,50,60,10,2,00256,India
165747,2023-05-14,205,classic yogurt,45,60,15,2,00256,India
165747,2023-05-14,204,strawberry yogurt,50,60,10,2,00256,India
539307,2023-05-14,210,mountain dew,75,100,25,2,00284,India
879576,2023-05-14,211,red bull,90,125,35,2,00210,India
879576,2023-05-14,203,mango yogurt,50,60,10,2,00210,India
879576,2023-05-14,204,strawberry yogurt,50,60,10,2,00210,India
828927,2023-05-14,209,pepsi,75,100,25,2,00228,India
828927,2023-05-14,207,coca cola,75,100,25,2,00228,India
828927,2023-05-14,202,milk,12,27,15,1,00228,India
828927,2023-05-14,212,amul cheese,250,315,65,1,00228,India
482219,2023-05-14,208,sprite,75,100,25,2,00399,India
482219,2023-05-14,204,strawberry yogurt,50,60,10,2,00399,India
482219,2023-05-14,211,red bull,90,125,35,2,00399,India
164060,2023-05-14,207,coca cola,75,100,25,2,00016,India
164060,2023-05-14,208,sprite,75,100,25,2,00016,India
539194,2023-05-14,204,strawberry yogurt,50,60,10,2,00250,India
539194,2023-05-14,208,sprite,75,100,25,2,00250,India
356698,2023-05-14,201,paneer,210,340,130,1,00370,India
356698,2023-05-14,205,classic yogurt,45,60,15,2,00370,India
356698,2023-05-14,212,amul cheese,250,315,65,1,00370,India
993218,2023-05-14,212,amul cheese,250,315,65,1,00030,India
993218,2023-05-14,208,sprite,75,100,25,2,00030,India
993218,2023-05-14,213,bisleri,6,15,9,2,00030,India
203096,2023-05-14,207,coca cola,75,100,25,2,00328,India
203096,2023-05-14,209,pepsi,75,100,25,2,00328,India
203096,2023-05-14,206,yakult,360,400,40,2,00328,India
444890,2023-05-15,208,sprite,75,100,25,2,00225,India
444890,2023-05-15,207,coca cola,75,100,25,2,00225,India
444890,2023-05-15,201,paneer,210,340,130,1,00225,India
426100,2023-05-15,211,red bull,90,125,35,2,00216,India
704458,2023-05-15,205,classic yogurt,45,60,15,2,00024,India
704458,2023-05-15,207,coca cola,75,100,25,2,00024,India
704458,2023-05-15,206,yakult,360,400,40,2,00024,India
671046,2023-05-15,211,red bull,90,125,35,2,00062,India
671046,2023-05-15,210,mountain dew,75,100,25,2,00062,India
671046,2023-05-15,203,mango yogurt,50,60,10,2,00062,India
967441,2023-05-15,206,yakult,360,400,40,2,00130,India
967441,2023-05-15,207,coca cola,75,100,25,2,00130,India
474400,2023-05-15,202,milk,12,27,15,1,00170,India
474400,2023-05-15,208,sprite,75,100,25,2,00170,India
183499,2023-05-15,208,sprite,75,100,25,2,00427,India
780812,2023-05-15,213,bisleri,6,15,9,2,00329,India
200493,2023-05-15,207,coca cola,75,100,25,2,00342,India
200493,2023-05-15,213,bisleri,6,15,9,2,00342,India
200493,2023-05-15,203,mango yogurt,50,60,10,2,00342,India
200493,2023-05-15,206,yakult,360,400,40,2,00342,India
200493,2023-05-15,208,sprite,75,100,25,2,00342,India
202400,2023-05-15,212,amul cheese,250,315,65,1,00310,India
202400,2023-05-15,213,bisleri,6,15,9,2,00310,India
117462,2023-05-15,210,mountain dew,75,100,25,2,00229,India
117462,2023-05-15,211,red bull,90,125,35,2,00229,India
117462,2023-05-15,213,bisleri,6,15,9,2,00229,India
945683,2023-05-15,210,mountain dew,75,100,25,2,00093,India
945683,2023-05-15,201,paneer,210,340,130,1,00093,India
945683,2023-05-15,202,milk,12,27,15,1,00093,India
945683,2023-05-15,209,pepsi,75,100,25,2,00093,India
945683,2023-05-15,204,strawberry yogurt,50,60,10,2,00093,India
842424,2023-05-15,205,classic yogurt,45,60,15,2,00354,India
842424,2023-05-15,203,mango yogurt,50,60,10,2,00354,India
842424,2023-05-15,206,yakult,360,400,40,2,00354,India
936235,2023-05-15,206,yakult,360,400,40,2,00051,India
936235,2023-05-15,210,mountain dew,75,100,25,2,00051,India
497254,2023-05-15,209,pepsi,75,100,25,2,00492,India
497254,2023-05-15,210,mountain dew,75,100,25,2,00492,India
497254,2023-05-15,211,red bull,90,125,35,2,00492,India
497254,2023-05-15,201,paneer,210,340,130,1,00492,India
267593,2023-05-15,213,bisleri,6,15,9,2,00076,India
267593,2023-05-15,206,yakult,360,400,40,2,00076,India
267593,2023-05-15,207,coca cola,75,100,25,2,00076,India
267593,2023-05-15,205,classic yogurt,45,60,15,2,00076,India
445846,2023-05-15,205,classic yogurt,45,60,15,2,00473,India
969600,2023-05-15,206,yakult,360,400,40,2,00295,India
969600,2023-05-15,213,bisleri,6,15,9,2,00295,India
969600,2023-05-15,209,pepsi,75,100,25,2,00295,India
969600,2023-05-15,211,red bull,90,125,35,2,00295,India
901091,2023-05-15,209,pepsi,75,100,25,2,00237,India
901091,2023-05-15,213,bisleri,6,15,9,2,00237,India
865257,2023-05-15,213,bisleri,6,15,9,2,00418,India
865257,2023-05-15,207,coca cola,75,100,25,2,00418,India
432332,2023-05-15,201,paneer,210,340,130,1,00308,India
456354,2023-05-15,203,mango yogurt,50,60,10,2,00023,India
716930,2023-05-15,210,mountain dew,75,100,25,2,00059,India
716930,2023-05-15,202,milk,12,27,15,1,00059,India
807805,2023-05-15,211,red bull,90,125,35,2,00138,India
807805,2023-05-15,203,mango yogurt,50,60,10,2,00138,India
807805,2023-05-15,204,strawberry yogurt,50,60,10,2,00138,India
429323,2023-05-15,210,mountain dew,75,100,25,2,00383,India
429323,2023-05-15,202,milk,12,27,15,1,00383,India
429323,2023-05-15,203,mango yogurt,50,60,10,2,00383,India
509791,2023-05-15,206,yakult,360,400,40,2,00255,India
509791,2023-05-15,204,strawberry yogurt,50,60,10,2,00255,India
509791,2023-05-15,205,classic yogurt,45,60,15,2,00255,India
509791,2023-05-15,209,pepsi,75,100,25,2,00255,India
509791,2023-05-15,202,milk,12,27,15,1,00255,India
759847,2023-05-15,213,bisleri,6,15,9,2,00484,India
759847,2023-05-15,206,yakult,360,400,40,2,00484,India
759847,2023-05-15,202,milk,12,27,15,1,00484,India
397278,2023-05-15,206,yakult,360,400,40,2,00066,India
397278,2023-05-15,201,paneer,210,340,130,1,00066,India
397278,2023-05-15,213,bisleri,6,15,9,2,00066,India
320336,2023-05-15,203,mango yogurt,50,60,10,2,00422,India
320336,2023-05-15,204,strawberry yogurt,50,60,10,2,00422,India
320336,2023-05-15,212,amul cheese,250,315,65,1,00422,India
708754,2023-05-15,204,strawberry yogurt,50,60,10,2,00349,India
228051,2023-05-15,203,mango yogurt,50,60,10,2,00142,India
228051,2023-05-15,208,sprite,75,100,25,2,00142,India
228051,2023-05-15,209,pepsi,75,100,25,2,00142,India
821670,2023-05-15,205,classic yogurt,45,60,15,2,00392,India
435055,2023-05-15,213,bisleri,6,15,9,2,00158,India
435055,2023-05-15,203,mango yogurt,50,60,10,2,00158,India
435055,2023-05-15,202,milk,12,27,15,1,00158,India
435055,2023-05-15,204,strawberry yogurt,50,60,10,2,00158,India
717747,2023-05-15,212,amul cheese,250,315,65,1,00373,India
717747,2023-05-15,213,bisleri,6,15,9,2,00373,India
717747,2023-05-15,205,classic yogurt,45,60,15,2,00373,India
984906,2023-05-15,213,bisleri,6,15,9,2,00326,India
984906,2023-05-15,206,yakult,360,400,40,2,00326,India
984906,2023-05-15,203,mango yogurt,50,60,10,2,00326,India
984906,2023-05-15,211,red bull,90,125,35,2,00326,India
288098,2023-05-15,210,mountain dew,75,100,25,2,00248,India
859416,2023-05-15,213,bisleri,6,15,9,2,00366,India
859416,2023-05-15,210,mountain dew,75,100,25,2,00366,India
859416,2023-05-15,211,red bull,90,125,35,2,00366,India
711894,2023-05-15,211,red bull,90,125,35,2,00252,India
711894,2023-05-15,201,paneer,210,340,130,1,00252,India
711894,2023-05-15,202,milk,12,27,15,1,00252,India
711894,2023-05-15,207,coca cola,75,100,25,2,00252,India
966531,2023-05-15,201,paneer,210,340,130,1,00174,India
966531,2023-05-15,212,amul cheese,250,315,65,1,00174,India
966531,2023-05-15,206,yakult,360,400,40,2,00174,India
630836,2023-05-15,211,red bull,90,125,35,2,00120,India
630836,2023-05-15,203,mango yogurt,50,60,10,2,00120,India
630836,2023-05-15,209,pepsi,75,100,25,2,00120,India
630836,2023-05-15,210,mountain dew,75,100,25,2,00120,India
271437,2023-05-15,206,yakult,360,400,40,2,00091,India
271437,2023-05-15,208,sprite,75,100,25,2,00091,India
271437,2023-05-15,207,coca cola,75,100,25,2,00091,India
357025,2023-05-15,205,classic yogurt,45,60,15,2,00096,India
680068,2023-05-15,213,bisleri,6,15,9,2,00472,India
680068,2023-05-15,208,sprite,75,100,25,2,00472,India
680068,2023-05-15,201,paneer,210,340,130,1,00472,India
625868,2023-05-15,208,sprite,75,100,25,2,00227,India
625868,2023-05-15,207,coca cola,75,100,25,2,00227,India
625868,2023-05-15,213,bisleri,6,15,9,2,00227,India
935676,2023-05-15,211,red bull,90,125,35,2,00364,India
935676,2023-05-15,205,classic yogurt,45,60,15,2,00364,India
935676,2023-05-15,212,amul cheese,250,315,65,1,00364,India
312093,2023-05-15,205,classic yogurt,45,60,15,2,00041,India
312093,2023-05-15,210,mountain dew,75,100,25,2,00041,India
493596,2023-05-15,208,sprite,75,100,25,2,00388,India
498909,2023-05-15,208,sprite,75,100,25,2,00344,India
498909,2023-05-15,209,pepsi,75,100,25,2,00344,India
593794,2023-05-15,204,strawberry yogurt,50,60,10,2,00199,India
593794,2023-05-15,203,mango yogurt,50,60,10,2,00199,India
593794,2023-05-15,210,mountain dew,75,100,25,2,00199,India
593794,2023-05-15,208,sprite,75,100,25,2,00199,India
593794,2023-05-15,209,pepsi,75,100,25,2,00199,India
853570,2023-05-15,205,classic yogurt,45,60,15,2,00393,India
853570,2023-05-15,202,milk,12,27,15,1,00393,India
853570,2023-05-15,208,sprite,75,100,25,2,00393,India
853570,2023-05-15,213,bisleri,6,15,9,2,00393,India
226189,2023-05-15,201,paneer,210,340,130,1,00348,India
226189,2023-05-15,213,bisleri,6,15,9,2,00348,India
251358,2023-05-15,213,bisleri,6,15,9,2,00488,India
251358,2023-05-15,201,paneer,210,340,130,1,00488,India
221142,2023-05-15,205,classic yogurt,45,60,15,2,00258,India
221142,2023-05-15,204,strawberry yogurt,50,60,10,2,00258,India
221142,2023-05-15,212,amul cheese,250,315,65,1,00258,India
221142,2023-05-15,209,pepsi,75,100,25,2,00258,India
406242,2023-05-15,205,classic yogurt,45,60,15,2,00039,India
406242,2023-05-15,213,bisleri,6,15,9,2,00039,India
969585,2023-05-15,212,amul cheese,250,315,65,1,00212,India
969585,2023-05-15,213,bisleri,6,15,9,2,00212,India
969585,2023-05-15,207,coca cola,75,100,25,2,00212,India
969585,2023-05-15,205,classic yogurt,45,60,15,2,00212,India
969585,2023-05-15,206,yakult,360,400,40,2,00212,India
508996,2023-05-15,213,bisleri,6,15,9,2,00357,India
508996,2023-05-15,204,strawberry yogurt,50,60,10,2,00357,India
508996,2023-05-15,205,classic yogurt,45,60,15,2,00357,India
508996,2023-05-15,212,amul cheese,250,315,65,1,00357,India
727084,2023-05-15,204,strawberry yogurt,50,60,10,2,00377,India
727084,2023-05-15,201,paneer,210,340,130,1,00377,India
727084,2023-05-15,207,coca cola,75,100,25,2,00377,India
727084,2023-05-15,202,milk,12,27,15,1,00377,India
371727,2023-05-15,209,pepsi,75,100,25,2,00105,India
371727,2023-05-15,213,bisleri,6,15,9,2,00105,India
371727,2023-05-15,208,sprite,75,100,25,2,00105,India
371727,2023-05-15,211,red bull,90,125,35,2,00105,India
200202,2023-05-15,203,mango yogurt,50,60,10,2,00102,India
397564,2023-05-15,202,milk,12,27,15,1,00472,India
397564,2023-05-15,205,classic yogurt,45,60,15,2,00472,India
397564,2023-05-15,207,coca cola,75,100,25,2,00472,India
553200,2023-05-15,204,strawberry yogurt,50,60,10,2,00245,India
553200,2023-05-15,202,milk,12,27,15,1,00245,India
553200,2023-05-15,201,paneer,210,340,130,1,00245,India
553200,2023-05-15,206,yakult,360,400,40,2,00245,India
134231,2023-05-15,203,mango yogurt,50,60,10,2,00231,India
134231,2023-05-15,211,red bull,90,125,35,2,00231,India
134231,2023-05-15,201,paneer,210,340,130,1,00231,India
472709,2023-05-15,206,yakult,360,400,40,2,00465,India
472709,2023-05-15,213,bisleri,6,15,9,2,00465,India
472709,2023-05-15,211,red bull,90,125,35,2,00465,India
472709,2023-05-15,207,coca cola,75,100,25,2,00465,India
472709,2023-05-15,209,pepsi,75,100,25,2,00465,India
374305,2023-05-16,207,coca cola,75,100,25,2,00499,India
958399,2023-05-16,208,sprite,75,100,25,2,00028,India
958399,2023-05-16,204,strawberry yogurt,50,60,10,2,00028,India
651121,2023-05-16,208,sprite,75,100,25,2,00216,India
677329,2023-05-16,202,milk,12,27,15,1,00152,India
316039,2023-05-16,203,mango yogurt,50,60,10,2,00447,India
316039,2023-05-16,211,red bull,90,125,35,2,00447,India
712562,2023-05-16,208,sprite,75,100,25,2,00091,India
117217,2023-05-16,201,paneer,210,340,130,1,00449,India
828486,2023-05-16,213,bisleri,6,15,9,2,00002,India
892672,2023-05-16,210,mountain dew,75,100,25,2,00063,India
892672,2023-05-16,202,milk,12,27,15,1,00063,India
892672,2023-05-16,211,red bull,90,125,35,2,00063,India
892672,2023-05-16,206,yakult,360,400,40,2,00063,India
950033,2023-05-16,203,mango yogurt,50,60,10,2,00032,India
950033,2023-05-16,211,red bull,90,125,35,2,00032,India
950033,2023-05-16,202,milk,12,27,15,1,00032,India
857942,2023-05-16,206,yakult,360,400,40,2,00492,India
857942,2023-05-16,207,coca cola,75,100,25,2,00492,India
857942,2023-05-16,201,paneer,210,340,130,1,00492,India
814934,2023-05-16,210,mountain dew,75,100,25,2,00425,India
814934,2023-05-16,206,yakult,360,400,40,2,00425,India
814934,2023-05-16,208,sprite,75,100,25,2,00425,India
831127,2023-05-16,208,sprite,75,100,25,2,00492,India
831127,2023-05-16,204,strawberry yogurt,50,60,10,2,00492,India
831127,2023-05-16,212,amul cheese,250,315,65,1,00492,India
831127,2023-05-16,203,mango yogurt,50,60,10,2,00492,India
831127,2023-05-16,206,yakult,360,400,40,2,00492,India
518846,2023-05-16,210,mountain dew,75,100,25,2,00372,India
518846,2023-05-16,203,mango yogurt,50,60,10,2,00372,India
447689,2023-05-16,205,classic yogurt,45,60,15,2,00285,India
447689,2023-05-16,204,strawberry yogurt,50,60,10,2,00285,India
447689,2023-05-16,206,yakult,360,400,40,2,00285,India
447689,2023-05-16,212,amul cheese,250,315,65,1,00285,India
678761,2023-05-16,204,strawberry yogurt,50,60,10,2,00486,India
267595,2023-05-16,206,yakult,360,400,40,2,00259,India
267595,2023-05-16,207,coca cola,75,100,25,2,00259,India
267595,2023-05-16,209,pepsi,75,100,25,2,00259,India
267595,2023-05-16,202,milk,12,27,15,1,00259,India
692606,2023-05-16,202,milk,12,27,15,1,00280,India
692606,2023-05-16,206,yakult,360,400,40,2,00280,India
885065,2023-05-16,208,sprite,75,100,25,2,00048,India
885065,2023-05-16,201,paneer,210,340,130,1,00048,India
885065,2023-05-16,213,bisleri,6,15,9,2,00048,India
885065,2023-05-16,204,strawberry yogurt,50,60,10,2,00048,India
293256,2023-05-16,202,milk,12,27,15,1,00476,India
293256,2023-05-16,203,mango yogurt,50,60,10,2,00476,India
293256,2023-05-16,208,sprite,75,100,25,2,00476,India
293256,2023-05-16,211,red bull,90,125,35,2,00476,India
567211,2023-05-16,206,yakult,360,400,40,2,00195,India
567211,2023-05-16,212,amul cheese,250,315,65,1,00195,India
567211,2023-05-16,205,classic yogurt,45,60,15,2,00195,India
567211,2023-05-16,203,mango yogurt,50,60,10,2,00195,India
567211,2023-05-16,213,bisleri,6,15,9,2,00195,India
185296,2023-05-16,205,classic yogurt,45,60,15,2,00094,India
371491,2023-05-16,213,bisleri,6,15,9,2,00040,India
371491,2023-05-16,209,pepsi,75,100,25,2,00040,India
371491,2023-05-16,204,strawberry yogurt,50,60,10,2,00040,India
798310,2023-05-16,205,classic yogurt,45,60,15,2,00264,India
953763,2023-05-16,202,milk,12,27,15,1,00051,India
953763,2023-05-16,201,paneer,210,340,130,1,00051,India
953763,2023-05-16,213,bisleri,6,15,9,2,00051,India
181929,2023-05-16,212,amul cheese,250,315,65,1,00453,India
181929,2023-05-16,210,mountain dew,75,100,25,2,00453,India
518016,2023-05-16,201,paneer,210,340,130,1,00370,India
518016,2023-05-16,204,strawberry yogurt,50,60,10,2,00370,India
518016,2023-05-16,207,coca cola,75,100,25,2,00370,India
518016,2023-05-16,209,pepsi,75,100,25,2,00370,India
234361,2023-05-16,207,coca cola,75,100,25,2,00047,India
234361,2023-05-16,211,red bull,90,125,35,2,00047,India
821492,2023-05-16,210,mountain dew,75,100,25,2,00399,India
821492,2023-05-16,213,bisleri,6,15,9,2,00399,India
821492,2023-05-16,204,strawberry yogurt,50,60,10,2,00399,India
991744,2023-05-16,210,mountain dew,75,100,25,2,00009,India
991744,2023-05-16,209,pepsi,75,100,25,2,00009,India
991744,2023-05-16,211,red bull,90,125,35,2,00009,India
740813,2023-05-16,204,strawberry yogurt,50,60,10,2,00498,India
740813,2023-05-16,209,pepsi,75,100,25,2,00498,India
740813,2023-05-16,211,red bull,90,125,35,2,00498,India
740813,2023-05-16,203,mango yogurt,50,60,10,2,00498,India
406749,2023-05-16,213,bisleri,6,15,9,2,00097,India
626077,2023-05-16,201,paneer,210,340,130,1,00346,India
626077,2023-05-16,204,strawberry yogurt,50,60,10,2,00346,India
626077,2023-05-16,206,yakult,360,400,40,2,00346,India
230491,2023-05-16,206,yakult,360,400,40,2,00337,India
975448,2023-05-16,213,bisleri,6,15,9,2,00416,India
975448,2023-05-16,204,strawberry yogurt,50,60,10,2,00416,India
975448,2023-05-16,206,yakult,360,400,40,2,00416,India
382897,2023-05-16,213,bisleri,6,15,9,2,00384,India
923470,2023-05-16,212,amul cheese,250,315,65,1,00212,India
923470,2023-05-16,202,milk,12,27,15,1,00212,India
923470,2023-05-16,210,mountain dew,75,100,25,2,00212,India
696905,2023-05-16,210,mountain dew,75,100,25,2,00305,India
696905,2023-05-16,206,yakult,360,400,40,2,00305,India
696905,2023-05-16,207,coca cola,75,100,25,2,00305,India
696905,2023-05-16,205,classic yogurt,45,60,15,2,00305,India
984636,2023-05-16,211,red bull,90,125,35,2,00374,India
984636,2023-05-16,213,bisleri,6,15,9,2,00374,India
984636,2023-05-16,205,classic yogurt,45,60,15,2,00374,India
984636,2023-05-16,203,mango yogurt,50,60,10,2,00374,India
173065,2023-05-16,203,mango yogurt,50,60,10,2,00274,India
173065,2023-05-16,212,amul cheese,250,315,65,1,00274,India
622333,2023-05-16,209,pepsi,75,100,25,2,00110,India
133389,2023-05-16,203,mango yogurt,50,60,10,2,00111,India
383669,2023-05-16,209,pepsi,75,100,25,2,00106,India
383669,2023-05-16,202,milk,12,27,15,1,00106,India
383669,2023-05-16,210,mountain dew,75,100,25,2,00106,India
383669,2023-05-16,213,bisleri,6,15,9,2,00106,India
624964,2023-05-16,203,mango yogurt,50,60,10,2,00277,India
624964,2023-05-16,201,paneer,210,340,130,1,00277,India
995576,2023-05-16,205,classic yogurt,45,60,15,2,00147,India
107725,2023-05-16,203,mango yogurt,50,60,10,2,00433,India
107725,2023-05-16,207,coca cola,75,100,25,2,00433,India
107725,2023-05-16,201,paneer,210,340,130,1,00433,India
134282,2023-05-16,211,red bull,90,125,35,2,00233,India
134282,2023-05-16,204,strawberry yogurt,50,60,10,2,00233,India
134282,2023-05-16,207,coca cola,75,100,25,2,00233,India
134282,2023-05-16,201,paneer,210,340,130,1,00233,India
911045,2023-05-16,207,coca cola,75,100,25,2,00474,India
811058,2023-05-16,213,bisleri,6,15,9,2,00435,India
503290,2023-05-16,211,red bull,90,125,35,2,00478,India
503290,2023-05-16,209,pepsi,75,100,25,2,00478,India
351324,2023-05-16,205,classic yogurt,45,60,15,2,00359,India
351324,2023-05-16,204,strawberry yogurt,50,60,10,2,00359,India
351324,2023-05-16,202,milk,12,27,15,1,00359,India
351324,2023-05-16,206,yakult,360,400,40,2,00359,India
351324,2023-05-16,212,amul cheese,250,315,65,1,00359,India
336423,2023-05-16,211,red bull,90,125,35,2,00009,India
336423,2023-05-16,210,mountain dew,75,100,25,2,00009,India
336423,2023-05-16,209,pepsi,75,100,25,2,00009,India
336423,2023-05-16,204,strawberry yogurt,50,60,10,2,00009,India
954537,2023-05-16,201,paneer,210,340,130,1,00153,India
954537,2023-05-16,203,mango yogurt,50,60,10,2,00153,India
954537,2023-05-16,202,milk,12,27,15,1,00153,India
666652,2023-05-16,212,amul cheese,250,315,65,1,00050,India
669639,2023-05-16,203,mango yogurt,50,60,10,2,00124,India
669639,2023-05-16,208,sprite,75,100,25,2,00124,India
669639,2023-05-16,209,pepsi,75,100,25,2,00124,India
151977,2023-05-16,209,pepsi,75,100,25,2,00206,India
151977,2023-05-16,212,amul cheese,250,315,65,1,00206,India
151977,2023-05-16,204,strawberry yogurt,50,60,10,2,00206,India
124461,2023-05-16,203,mango yogurt,50,60,10,2,00302,India
475272,2023-05-16,208,sprite,75,100,25,2,00285,India
475272,2023-05-16,204,strawberry yogurt,50,60,10,2,00285,India
475272,2023-05-16,212,amul cheese,250,315,65,1,00285,India
443599,2023-05-16,207,coca cola,75,100,25,2,00001,India
443599,2023-05-16,211,red bull,90,125,35,2,00001,India
443599,2023-05-16,203,mango yogurt,50,60,10,2,00001,India
443599,2023-05-16,208,sprite,75,100,25,2,00001,India
344318,2023-05-16,208,sprite,75,100,25,2,00161,India
344318,2023-05-16,213,bisleri,6,15,9,2,00161,India
344318,2023-05-16,210,mountain dew,75,100,25,2,00161,India
344318,2023-05-16,204,strawberry yogurt,50,60,10,2,00161,India
344318,2023-05-16,203,mango yogurt,50,60,10,2,00161,India
878021,2023-05-16,203,mango yogurt,50,60,10,2,00198,India
878021,2023-05-16,208,sprite,75,100,25,2,00198,India
878021,2023-05-16,202,milk,12,27,15,1,00198,India
878021,2023-05-16,213,bisleri,6,15,9,2,00198,India
253127,2023-05-16,202,milk,12,27,15,1,00054,India
253127,2023-05-16,210,mountain dew,75,100,25,2,00054,India
162343,2023-05-16,212,amul cheese,250,315,65,1,00500,India
506596,2023-05-16,205,classic yogurt,45,60,15,2,00062,India
506596,2023-05-16,203,mango yogurt,50,60,10,2,00062,India
506596,2023-05-16,209,pepsi,75,100,25,2,00062,India
803892,2023-05-16,208,sprite,75,100,25,2,00135,India
803892,2023-05-16,212,amul cheese,250,315,65,1,00135,India
803892,2023-05-16,213,bisleri,6,15,9,2,00135,India
803892,2023-05-16,204,strawberry yogurt,50,60,10,2,00135,India
992070,2023-05-16,208,sprite,75,100,25,2,00070,India
992070,2023-05-16,205,classic yogurt,45,60,15,2,00070,India
980392,2023-05-16,206,yakult,360,400,40,2,00376,India
980392,2023-05-16,201,paneer,210,340,130,1,00376,India
980392,2023-05-16,209,pepsi,75,100,25,2,00376,India
980392,2023-05-16,213,bisleri,6,15,9,2,00376,India
534399,2023-05-16,211,red bull,90,125,35,2,00007,India
534399,2023-05-16,206,yakult,360,400,40,2,00007,India
534399,2023-05-16,212,amul cheese,250,315,65,1,00007,India
534399,2023-05-16,203,mango yogurt,50,60,10,2,00007,India
534399,2023-05-16,202,milk,12,27,15,1,00007,India
446487,2023-05-16,209,pepsi,75,100,25,2,00213,India
446487,2023-05-16,207,coca cola,75,100,25,2,00213,India
446487,2023-05-16,213,bisleri,6,15,9,2,00213,India
207302,2023-05-16,210,mountain dew,75,100,25,2,00366,India
207302,2023-05-16,208,sprite,75,100,25,2,00366,India
207302,2023-05-16,203,mango yogurt,50,60,10,2,00366,India
890755,2023-05-16,204,strawberry yogurt,50,60,10,2,00370,India
971884,2023-05-16,206,yakult,360,400,40,2,00141,India
971884,2023-05-16,212,amul cheese,250,315,65,1,00141,India
971884,2023-05-16,205,classic yogurt,45,60,15,2,00141,India
971884,2023-05-16,211,red bull,90,125,35,2,00141,India
184723,2023-05-16,205,classic yogurt,45,60,15,2,00203,India
184723,2023-05-16,202,milk,12,27,15,1,00203,India
184723,2023-05-16,212,amul cheese,250,315,65,1,00203,India
393280,2023-05-16,209,pepsi,75,100,25,2,00129,India
393280,2023-05-16,202,milk,12,27,15,1,00129,India
393280,2023-05-16,201,paneer,210,340,130,1,00129,India
108876,2023-05-17,206,yakult,360,400,40,2,00221,India
355021,2023-05-17,213,bisleri,6,15,9,2,00408,India
409679,2023-05-17,208,sprite,75,100,25,2,00372,India
409679,2023-05-17,209,pepsi,75,100,25,2,00372,India
409679,2023-05-17,206,yakult,360,400,40,2,00372,India
409679,2023-05-17,205,classic yogurt,45,60,15,2,00372,India
409679,2023-05-17,207,coca cola,75,100,25,2,00372,India
569368,2023-05-17,205,classic yogurt,45,60,15,2,00171,India
569368,2023-05-17,210,mountain dew,75,100,25,2,00171,India
569368,2023-05-17,212,amul cheese,250,315,65,1,00171,India
569368,2023-05-17,213,bisleri,6,15,9,2,00171,India
606180,2023-05-17,208,sprite,75,100,25,2,00373,India
606180,2023-05-17,209,pepsi,75,100,25,2,00373,India
606180,2023-05-17,202,milk,12,27,15,1,00373,India
658491,2023-05-17,208,sprite,75,100,25,2,00078,India
658491,2023-05-17,201,paneer,210,340,130,1,00078,India
895405,2023-05-17,208,sprite,75,100,25,2,00016,India
895405,2023-05-17,203,mango yogurt,50,60,10,2,00016,India
815807,2023-05-17,208,sprite,75,100,25,2,00122,India
815807,2023-05-17,210,mountain dew,75,100,25,2,00122,India
815807,2023-05-17,202,milk,12,27,15,1,00122,India
578426,2023-05-17,212,amul cheese,250,315,65,1,00242,India
578426,2023-05-17,209,pepsi,75,100,25,2,00242,India
578426,2023-05-17,208,sprite,75,100,25,2,00242,India
578426,2023-05-17,203,mango yogurt,50,60,10,2,00242,India
118005,2023-05-17,207,coca cola,75,100,25,2,00272,India
118005,2023-05-17,202,milk,12,27,15,1,00272,India
600498,2023-05-17,208,sprite,75,100,25,2,00244,India
654243,2023-05-17,210,mountain dew,75,100,25,2,00102,India
654243,2023-05-17,208,sprite,75,100,25,2,00102,India
654243,2023-05-17,205,classic yogurt,45,60,15,2,00102,India
403478,2023-05-17,208,sprite,75,100,25,2,00474,India
403478,2023-05-17,209,pepsi,75,100,25,2,00474,India
642744,2023-05-17,205,classic yogurt,45,60,15,2,00071,India
642744,2023-05-17,213,bisleri,6,15,9,2,00071,India
642744,2023-05-17,201,paneer,210,340,130,1,00071,India
642744,2023-05-17,204,strawberry yogurt,50,60,10,2,00071,India
279781,2023-05-17,205,classic yogurt,45,60,15,2,00014,India
279781,2023-05-17,212,amul cheese,250,315,65,1,00014,India
660270,2023-05-17,209,pepsi,75,100,25,2,00300,India
794421,2023-05-17,213,bisleri,6,15,9,2,00376,India
794421,2023-05-17,212,amul cheese,250,315,65,1,00376,India
794421,2023-05-17,202,milk,12,27,15,1,00376,India
794421,2023-05-17,205,classic yogurt,45,60,15,2,00376,India
794421,2023-05-17,208,sprite,75,100,25,2,00376,India
207783,2023-05-17,204,strawberry yogurt,50,60,10,2,00406,India
207783,2023-05-17,205,classic yogurt,45,60,15,2,00406,India
207783,2023-05-17,203,mango yogurt,50,60,10,2,00406,India
524800,2023-05-17,211,red bull,90,125,35,2,00367,India
524800,2023-05-17,210,mountain dew,75,100,25,2,00367,India
524800,2023-05-17,213,bisleri,6,15,9,2,00367,India
524800,2023-05-17,204,strawberry yogurt,50,60,10,2,00367,India
798137,2023-05-17,210,mountain dew,75,100,25,2,00217,India
798137,2023-05-17,213,bisleri,6,15,9,2,00217,India
286177,2023-05-17,204,strawberry yogurt,50,60,10,2,00376,India
286177,2023-05-17,201,paneer,210,340,130,1,00376,India
286177,2023-05-17,211,red bull,90,125,35,2,00376,India
286177,2023-05-17,207,coca cola,75,100,25,2,00376,India
706086,2023-05-17,213,bisleri,6,15,9,2,00468,India
706086,2023-05-17,206,yakult,360,400,40,2,00468,India
706086,2023-05-17,205,classic yogurt,45,60,15,2,00468,India
706086,2023-05-17,203,mango yogurt,50,60,10,2,00468,India
220639,2023-05-17,211,red bull,90,125,35,2,00229,India
220639,2023-05-17,205,classic yogurt,45,60,15,2,00229,India
220639,2023-05-17,207,coca cola,75,100,25,2,00229,India
368555,2023-05-17,209,pepsi,75,100,25,2,00172,India
368555,2023-05-17,204,strawberry yogurt,50,60,10,2,00172,India
368555,2023-05-17,202,milk,12,27,15,1,00172,India
368555,2023-05-17,213,bisleri,6,15,9,2,00172,India
232261,2023-05-17,201,paneer,210,340,130,1,00296,India
232261,2023-05-17,212,amul cheese,250,315,65,1,00296,India
232261,2023-05-17,210,mountain dew,75,100,25,2,00296,India
232261,2023-05-17,211,red bull,90,125,35,2,00296,India
232261,2023-05-17,204,strawberry yogurt,50,60,10,2,00296,India
122963,2023-05-17,201,paneer,210,340,130,1,00316,India
122963,2023-05-17,209,pepsi,75,100,25,2,00316,India
750686,2023-05-17,210,mountain dew,75,100,25,2,00171,India
236241,2023-05-17,205,classic yogurt,45,60,15,2,00226,India
236241,2023-05-17,212,amul cheese,250,315,65,1,00226,India
236241,2023-05-17,201,paneer,210,340,130,1,00226,India
236241,2023-05-17,208,sprite,75,100,25,2,00226,India
887133,2023-05-17,205,classic yogurt,45,60,15,2,00079,India
887133,2023-05-17,211,red bull,90,125,35,2,00079,India
887133,2023-05-17,203,mango yogurt,50,60,10,2,00079,India
302602,2023-05-17,211,red bull,90,125,35,2,00427,India
771855,2023-05-17,205,classic yogurt,45,60,15,2,00312,India
771855,2023-05-17,211,red bull,90,125,35,2,00312,India
228566,2023-05-17,204,strawberry yogurt,50,60,10,2,00346,India
849864,2023-05-17,201,paneer,210,340,130,1,00239,India
849864,2023-05-17,210,mountain dew,75,100,25,2,00239,India
849864,2023-05-17,204,strawberry yogurt,50,60,10,2,00239,India
849864,2023-05-17,206,yakult,360,400,40,2,00239,India
849864,2023-05-17,207,coca cola,75,100,25,2,00239,India
366384,2023-05-17,213,bisleri,6,15,9,2,00472,India
920015,2023-05-17,206,yakult,360,400,40,2,00205,India
920015,2023-05-17,211,red bull,90,125,35,2,00205,India
607913,2023-05-17,205,classic yogurt,45,60,15,2,00441,India
607913,2023-05-17,208,sprite,75,100,25,2,00441,India
607913,2023-05-17,203,mango yogurt,50,60,10,2,00441,India
607913,2023-05-17,209,pepsi,75,100,25,2,00441,India
617422,2023-05-17,204,strawberry yogurt,50,60,10,2,00259,India
617422,2023-05-17,202,milk,12,27,15,1,00259,India
617422,2023-05-17,208,sprite,75,100,25,2,00259,India
908925,2023-05-17,213,bisleri,6,15,9,2,00176,India
908925,2023-05-17,211,red bull,90,125,35,2,00176,India
908925,2023-05-17,202,milk,12,27,15,1,00176,India
547411,2023-05-17,211,red bull,90,125,35,2,00254,India
459375,2023-05-17,203,mango yogurt,50,60,10,2,00311,India
459375,2023-05-17,205,classic yogurt,45,60,15,2,00311,India
459375,2023-05-17,204,strawberry yogurt,50,60,10,2,00311,India
459375,2023-05-17,209,pepsi,75,100,25,2,00311,India
355669,2023-05-17,205,classic yogurt,45,60,15,2,00210,India
355669,2023-05-17,207,coca cola,75,100,25,2,00210,India
355669,2023-05-17,206,yakult,360,400,40,2,00210,India
365358,2023-05-17,204,strawberry yogurt,50,60,10,2,00429,India
365358,2023-05-17,210,mountain dew,75,100,25,2,00429,India
402622,2023-05-17,213,bisleri,6,15,9,2,00022,India
402622,2023-05-17,210,mountain dew,75,100,25,2,00022,India
402622,2023-05-17,208,sprite,75,100,25,2,00022,India
514045,2023-05-17,208,sprite,75,100,25,2,00204,India
514045,2023-05-17,205,classic yogurt,45,60,15,2,00204,India
514045,2023-05-17,206,yakult,360,400,40,2,00204,India
514045,2023-05-17,212,amul cheese,250,315,65,1,00204,India
122466,2023-05-17,203,mango yogurt,50,60,10,2,00026,India
122466,2023-05-17,207,coca cola,75,100,25,2,00026,India
814399,2023-05-17,201,paneer,210,340,130,1,00144,India
814399,2023-05-17,210,mountain dew,75,100,25,2,00144,India
814399,2023-05-17,204,strawberry yogurt,50,60,10,2,00144,India
814399,2023-05-17,208,sprite,75,100,25,2,00144,India
405193,2023-05-17,202,milk,12,27,15,1,00234,India
405193,2023-05-17,205,classic yogurt,45,60,15,2,00234,India
405193,2023-05-17,204,strawberry yogurt,50,60,10,2,00234,India
405193,2023-05-17,207,coca cola,75,100,25,2,00234,India
674401,2023-05-17,208,sprite,75,100,25,2,00208,India
674401,2023-05-17,211,red bull,90,125,35,2,00208,India
674401,2023-05-17,201,paneer,210,340,130,1,00208,India
674401,2023-05-17,209,pepsi,75,100,25,2,00208,India
196316,2023-05-17,205,classic yogurt,45,60,15,2,00007,India
196316,2023-05-17,204,strawberry yogurt,50,60,10,2,00007,India
196316,2023-05-17,212,amul cheese,250,315,65,1,00007,India
291673,2023-05-17,207,coca cola,75,100,25,2,00069,India
291673,2023-05-17,211,red bull,90,125,35,2,00069,India
291673,2023-05-17,206,yakult,360,400,40,2,00069,India
161097,2023-05-17,213,bisleri,6,15,9,2,00221,India
161097,2023-05-17,205,classic yogurt,45,60,15,2,00221,India
161097,2023-05-17,208,sprite,75,100,25,2,00221,India
920509,2023-05-17,207,coca cola,75,100,25,2,00199,India
920509,2023-05-17,202,milk,12,27,15,1,00199,India
920509,2023-05-17,201,paneer,210,340,130,1,00199,India
394927,2023-05-17,202,milk,12,27,15,1,00301,India
394927,2023-05-17,206,yakult,360,400,40,2,00301,India
394927,2023-05-17,210,mountain dew,75,100,25,2,00301,India
688034,2023-05-17,203,mango yogurt,50,60,10,2,00443,India
688034,2023-05-17,202,milk,12,27,15,1,00443,India
334181,2023-05-17,205,classic yogurt,45,60,15,2,00371,India
334181,2023-05-17,206,yakult,360,400,40,2,00371,India
334181,2023-05-17,201,paneer,210,340,130,1,00371,India
859620,2023-05-17,208,sprite,75,100,25,2,00376,India
859620,2023-05-17,207,coca cola,75,100,25,2,00376,India
859620,2023-05-17,211,red bull,90,125,35,2,00376,India
859620,2023-05-17,209,pepsi,75,100,25,2,00376,India
616931,2023-05-17,207,coca cola,75,100,25,2,00191,India
616931,2023-05-17,212,amul cheese,250,315,65,1,00191,India
686102,2023-05-17,203,mango yogurt,50,60,10,2,00180,India
686102,2023-05-17,206,yakult,360,400,40,2,00180,India
380789,2023-05-17,205,classic yogurt,45,60,15,2,00063,India
380789,2023-05-17,213,bisleri,6,15,9,2,00063,India
380789,2023-05-17,203,mango yogurt,50,60,10,2,00063,India
254225,2023-05-17,209,pepsi,75,100,25,2,00351,India
254225,2023-05-17,207,coca cola,75,100,25,2,00351,India
254225,2023-05-17,203,mango yogurt,50,60,10,2,00351,India
325124,2023-05-17,206,yakult,360,400,40,2,00152,India
325124,2023-05-17,201,paneer,210,340,130,1,00152,India
325124,2023-05-17,211,red bull,90,125,35,2,00152,India
997499,2023-05-17,209,pepsi,75,100,25,2,00295,India
997499,2023-05-17,206,yakult,360,400,40,2,00295,India
310518,2023-05-17,208,sprite,75,100,25,2,00041,India
310518,2023-05-17,206,yakult,360,400,40,2,00041,India
310518,2023-05-17,209,pepsi,75,100,25,2,00041,India
895898,2023-05-17,212,amul cheese,250,315,65,1,00335,India
895898,2023-05-17,209,pepsi,75,100,25,2,00335,India
895898,2023-05-17,205,classic yogurt,45,60,15,2,00335,India
895898,2023-05-17,206,yakult,360,400,40,2,00335,India
689468,2023-05-17,211,red bull,90,125,35,2,00244,India
689468,2023-05-17,205,classic yogurt,45,60,15,2,00244,India
689468,2023-05-17,201,paneer,210,340,130,1,00244,India
689468,2023-05-17,206,yakult,360,400,40,2,00244,India
689468,2023-05-17,207,coca cola,75,100,25,2,00244,India
639362,2023-05-17,207,coca cola,75,100,25,2,00222,India
639362,2023-05-17,208,sprite,75,100,25,2,00222,India
639362,2023-05-17,212,amul cheese,250,315,65,1,00222,India
797226,2023-05-17,201,paneer,210,340,130,1,00443,India
797226,2023-05-17,209,pepsi,75,100,25,2,00443,India
571789,2023-05-17,206,yakult,360,400,40,2,00306,India
571789,2023-05-17,210,mountain dew,75,100,25,2,00306,India
571789,2023-05-17,204,strawberry yogurt,50,60,10,2,00306,India
946713,2023-05-17,201,paneer,210,340,130,1,00487,India
946713,2023-05-17,206,yakult,360,400,40,2,00487,India
946713,2023-05-17,212,amul cheese,250,315,65,1,00487,India
687467,2023-05-17,213,bisleri,6,15,9,2,00478,India
687467,2023-05-17,211,red bull,90,125,35,2,00478,India
687467,2023-05-17,201,paneer,210,340,130,1,00478,India
853196,2023-05-17,205,classic yogurt,45,60,15,2,00148,India
853196,2023-05-17,208,sprite,75,100,25,2,00148,India
853196,2023-05-17,207,coca cola,75,100,25,2,00148,India
853196,2023-05-17,202,milk,12,27,15,1,00148,India
853196,2023-05-17,201,paneer,210,340,130,1,00148,India
883843,2023-05-17,206,yakult,360,400,40,2,00084,India
883843,2023-05-17,212,amul cheese,250,315,65,1,00084,India
883843,2023-05-17,211,red bull,90,125,35,2,00084,India
883843,2023-05-17,201,paneer,210,340,130,1,00084,India
393600,2023-05-17,204,strawberry yogurt,50,60,10,2,00348,India
393600,2023-05-17,211,red bull,90,125,35,2,00348,India
427531,2023-05-17,209,pepsi,75,100,25,2,00016,India
427531,2023-05-17,211,red bull,90,125,35,2,00016,India
427531,2023-05-17,213,bisleri,6,15,9,2,00016,India
244592,2023-05-17,211,red bull,90,125,35,2,00298,India
244592,2023-05-17,204,strawberry yogurt,50,60,10,2,00298,India
605233,2023-05-17,209,pepsi,75,100,25,2,00243,India
605233,2023-05-17,202,milk,12,27,15,1,00243,India
605233,2023-05-17,210,mountain dew,75,100,25,2,00243,India
731174,2023-05-17,205,classic yogurt,45,60,15,2,00487,India
731174,2023-05-17,202,milk,12,27,15,1,00487,India
731174,2023-05-17,204,strawberry yogurt,50,60,10,2,00487,India
731174,2023-05-17,211,red bull,90,125,35,2,00487,India
515090,2023-05-17,209,pepsi,75,100,25,2,00274,India
515090,2023-05-17,211,red bull,90,125,35,2,00274,India
515090,2023-05-17,206,yakult,360,400,40,2,00274,India
860414,2023-05-17,211,red bull,90,125,35,2,00185,India
104958,2023-05-17,207,coca cola,75,100,25,2,00215,India
104958,2023-05-17,211,red bull,90,125,35,2,00215,India
751992,2023-05-17,209,pepsi,75,100,25,2,00031,India
751992,2023-05-17,210,mountain dew,75,100,25,2,00031,India
751992,2023-05-17,213,bisleri,6,15,9,2,00031,India
751992,2023-05-17,204,strawberry yogurt,50,60,10,2,00031,India
507656,2023-05-17,208,sprite,75,100,25,2,00193,India
507656,2023-05-17,206,yakult,360,400,40,2,00193,India
507656,2023-05-17,201,paneer,210,340,130,1,00193,India
507656,2023-05-17,207,coca cola,75,100,25,2,00193,India
832815,2023-05-17,212,amul cheese,250,315,65,1,00127,India
766677,2023-05-17,203,mango yogurt,50,60,10,2,00471,India
385035,2023-05-17,211,red bull,90,125,35,2,00305,India
518296,2023-05-17,211,red bull,90,125,35,2,00163,India
518296,2023-05-17,210,mountain dew,75,100,25,2,00163,India
513852,2023-05-17,202,milk,12,27,15,1,00069,India
342686,2023-05-17,205,classic yogurt,45,60,15,2,00499,India
342686,2023-05-17,208,sprite,75,100,25,2,00499,India
342686,2023-05-17,204,strawberry yogurt,50,60,10,2,00499,India
945921,2023-05-17,202,milk,12,27,15,1,00426,India
945921,2023-05-17,208,sprite,75,100,25,2,00426,India
945921,2023-05-17,212,amul cheese,250,315,65,1,00426,India
299583,2023-05-17,213,bisleri,6,15,9,2,00171,India
299583,2023-05-17,204,strawberry yogurt,50,60,10,2,00171,India
299583,2023-05-17,208,sprite,75,100,25,2,00171,India
299583,2023-05-17,201,paneer,210,340,130,1,00171,India
299583,2023-05-17,212,amul cheese,250,315,65,1,00171,India
549797,2023-05-17,204,strawberry yogurt,50,60,10,2,00392,India
549797,2023-05-17,203,mango yogurt,50,60,10,2,00392,India
549797,2023-05-17,202,milk,12,27,15,1,00392,India
574821,2023-05-17,213,bisleri,6,15,9,2,00486,India
459499,2023-05-17,202,milk,12,27,15,1,00014,India
459499,2023-05-17,205,classic yogurt,45,60,15,2,00014,India
229169,2023-05-17,208,sprite,75,100,25,2,00260,India
229169,2023-05-17,211,red bull,90,125,35,2,00260,India
229169,2023-05-17,201,paneer,210,340,130,1,00260,India
229169,2023-05-17,210,mountain dew,75,100,25,2,00260,India
642449,2023-05-17,205,classic yogurt,45,60,15,2,00369,India
642449,2023-05-17,203,mango yogurt,50,60,10,2,00369,India
642449,2023-05-17,201,paneer,210,340,130,1,00369,India
642449,2023-05-17,209,pepsi,75,100,25,2,00369,India
243427,2023-05-17,207,coca cola,75,100,25,2,00017,India
243427,2023-05-17,212,amul cheese,250,315,65,1,00017,India
243427,2023-05-17,205,classic yogurt,45,60,15,2,00017,India
243427,2023-05-17,210,mountain dew,75,100,25,2,00017,India
701278,2023-05-17,209,pepsi,75,100,25,2,00249,India
701278,2023-05-17,206,yakult,360,400,40,2,00249,India
701278,2023-05-17,213,bisleri,6,15,9,2,00249,India
701278,2023-05-17,212,amul cheese,250,315,65,1,00249,India
701278,2023-05-17,201,paneer,210,340,130,1,00249,India
131572,2023-05-18,206,yakult,360,400,40,2,00189,India
131572,2023-05-18,210,mountain dew,75,100,25,2,00189,India
131572,2023-05-18,207,coca cola,75,100,25,2,00189,India
131572,2023-05-18,205,classic yogurt,45,60,15,2,00189,India
472834,2023-05-18,203,mango yogurt,50,60,10,2,00458,India
423346,2023-05-18,205,classic yogurt,45,60,15,2,00343,India
423346,2023-05-18,212,amul cheese,250,315,65,1,00343,India
551436,2023-05-18,206,yakult,360,400,40,2,00310,India
551436,2023-05-18,213,bisleri,6,15,9,2,00310,India
112323,2023-05-18,213,bisleri,6,15,9,2,00435,India
112323,2023-05-18,203,mango yogurt,50,60,10,2,00435,India
173782,2023-05-18,206,yakult,360,400,40,2,00277,India
173782,2023-05-18,212,amul cheese,250,315,65,1,00277,India
173782,2023-05-18,207,coca cola,75,100,25,2,00277,India
173782,2023-05-18,213,bisleri,6,15,9,2,00277,India
173782,2023-05-18,202,milk,12,27,15,1,00277,India
887681,2023-05-18,201,paneer,210,340,130,1,00299,India
687335,2023-05-18,203,mango yogurt,50,60,10,2,00010,India
952954,2023-05-18,201,paneer,210,340,130,1,00430,India
952954,2023-05-18,205,classic yogurt,45,60,15,2,00430,India
455094,2023-05-18,207,coca cola,75,100,25,2,00384,India
455094,2023-05-18,202,milk,12,27,15,1,00384,India
455094,2023-05-18,203,mango yogurt,50,60,10,2,00384,India
455094,2023-05-18,201,paneer,210,340,130,1,00384,India
455094,2023-05-18,206,yakult,360,400,40,2,00384,India
584494,2023-05-18,210,mountain dew,75,100,25,2,00074,India
987184,2023-05-18,204,strawberry yogurt,50,60,10,2,00094,India
987184,2023-05-18,203,mango yogurt,50,60,10,2,00094,India
987184,2023-05-18,208,sprite,75,100,25,2,00094,India
987184,2023-05-18,206,yakult,360,400,40,2,00094,India
727174,2023-05-18,201,paneer,210,340,130,1,00168,India
727174,2023-05-18,211,red bull,90,125,35,2,00168,India
727174,2023-05-18,202,milk,12,27,15,1,00168,India
727174,2023-05-18,209,pepsi,75,100,25,2,00168,India
278102,2023-05-18,203,mango yogurt,50,60,10,2,00436,India
278102,2023-05-18,211,red bull,90,125,35,2,00436,India
278102,2023-05-18,210,mountain dew,75,100,25,2,00436,India
540445,2023-05-18,212,amul cheese,250,315,65,1,00310,India
540445,2023-05-18,208,sprite,75,100,25,2,00310,India
667980,2023-05-18,207,coca cola,75,100,25,2,00401,India
667980,2023-05-18,209,pepsi,75,100,25,2,00401,India
577451,2023-05-18,205,classic yogurt,45,60,15,2,00155,India
577451,2023-05-18,212,amul cheese,250,315,65,1,00155,India
577451,2023-05-18,204,strawberry yogurt,50,60,10,2,00155,India
577451,2023-05-18,211,red bull,90,125,35,2,00155,India
442772,2023-05-18,202,milk,12,27,15,1,00026,India
442772,2023-05-18,208,sprite,75,100,25,2,00026,India
442772,2023-05-18,213,bisleri,6,15,9,2,00026,India
442772,2023-05-18,201,paneer,210,340,130,1,00026,India
518205,2023-05-18,210,mountain dew,75,100,25,2,00270,India
950022,2023-05-18,205,classic yogurt,45,60,15,2,00395,India
950022,2023-05-18,211,red bull,90,125,35,2,00395,India
833248,2023-05-18,202,milk,12,27,15,1,00193,India
833248,2023-05-18,206,yakult,360,400,40,2,00193,India
833248,2023-05-18,204,strawberry yogurt,50,60,10,2,00193,India
833248,2023-05-18,211,red bull,90,125,35,2,00193,India
830247,2023-05-18,213,bisleri,6,15,9,2,00151,India
830247,2023-05-18,201,paneer,210,340,130,1,00151,India
830247,2023-05-18,203,mango yogurt,50,60,10,2,00151,India
830247,2023-05-18,211,red bull,90,125,35,2,00151,India
694031,2023-05-18,201,paneer,210,340,130,1,00255,India
671126,2023-05-18,208,sprite,75,100,25,2,00427,India
671126,2023-05-18,204,strawberry yogurt,50,60,10,2,00427,India
671126,2023-05-18,213,bisleri,6,15,9,2,00427,India
170569,2023-05-18,210,mountain dew,75,100,25,2,00076,India
291644,2023-05-18,205,classic yogurt,45,60,15,2,00295,India
299601,2023-05-18,203,mango yogurt,50,60,10,2,00100,India
299601,2023-05-18,201,paneer,210,340,130,1,00100,India
299601,2023-05-18,212,amul cheese,250,315,65,1,00100,India
299601,2023-05-18,213,bisleri,6,15,9,2,00100,India
859260,2023-05-18,205,classic yogurt,45,60,15,2,00215,India
859260,2023-05-18,204,strawberry yogurt,50,60,10,2,00215,India
303972,2023-05-18,212,amul cheese,250,315,65,1,00346,India
303972,2023-05-18,213,bisleri,6,15,9,2,00346,India
303972,2023-05-18,204,strawberry yogurt,50,60,10,2,00346,India
303972,2023-05-18,206,yakult,360,400,40,2,00346,India
302461,2023-05-18,209,pepsi,75,100,25,2,00192,India
302461,2023-05-18,206,yakult,360,400,40,2,00192,India
126781,2023-05-18,202,milk,12,27,15,1,00093,India
126781,2023-05-18,213,bisleri,6,15,9,2,00093,India
126781,2023-05-18,207,coca cola,75,100,25,2,00093,India
308660,2023-05-18,201,paneer,210,340,130,1,00302,India
308660,2023-05-18,203,mango yogurt,50,60,10,2,00302,India
308660,2023-05-18,206,yakult,360,400,40,2,00302,India
308660,2023-05-18,204,strawberry yogurt,50,60,10,2,00302,India
308660,2023-05-18,211,red bull,90,125,35,2,00302,India
514276,2023-05-18,210,mountain dew,75,100,25,2,00119,India
514276,2023-05-18,202,milk,12,27,15,1,00119,India
514276,2023-05-18,212,amul cheese,250,315,65,1,00119,India
514276,2023-05-18,211,red bull,90,125,35,2,00119,India
355687,2023-05-18,212,amul cheese,250,315,65,1,00104,India
355687,2023-05-18,211,red bull,90,125,35,2,00104,India
786850,2023-05-18,203,mango yogurt,50,60,10,2,00394,India
786850,2023-05-18,202,milk,12,27,15,1,00394,India
786850,2023-05-18,212,amul cheese,250,315,65,1,00394,India
786850,2023-05-18,213,bisleri,6,15,9,2,00394,India
180092,2023-05-18,213,bisleri,6,15,9,2,00133,India
180092,2023-05-18,210,mountain dew,75,100,25,2,00133,India
180092,2023-05-18,207,coca cola,75,100,25,2,00133,India
972752,2023-05-18,208,sprite,75,100,25,2,00110,India
972752,2023-05-18,212,amul cheese,250,315,65,1,00110,India
972752,2023-05-18,213,bisleri,6,15,9,2,00110,India
972752,2023-05-18,202,milk,12,27,15,1,00110,India
929750,2023-05-18,204,strawberry yogurt,50,60,10,2,00499,India
929750,2023-05-18,206,yakult,360,400,40,2,00499,India
929750,2023-05-18,211,red bull,90,125,35,2,00499,India
929750,2023-05-18,210,mountain dew,75,100,25,2,00499,India
998666,2023-05-18,203,mango yogurt,50,60,10,2,00254,India
998666,2023-05-18,211,red bull,90,125,35,2,00254,India
998666,2023-05-18,208,sprite,75,100,25,2,00254,India
205576,2023-05-18,203,mango yogurt,50,60,10,2,00424,India
205576,2023-05-18,210,mountain dew,75,100,25,2,00424,India
205576,2023-05-18,209,pepsi,75,100,25,2,00424,India
105475,2023-05-18,204,strawberry yogurt,50,60,10,2,00078,India
105475,2023-05-18,208,sprite,75,100,25,2,00078,India
105475,2023-05-18,209,pepsi,75,100,25,2,00078,India
748208,2023-05-18,203,mango yogurt,50,60,10,2,00302,India
507879,2023-05-18,203,mango yogurt,50,60,10,2,00341,India
507879,2023-05-18,205,classic yogurt,45,60,15,2,00341,India
507879,2023-05-18,202,milk,12,27,15,1,00341,India
550313,2023-05-18,211,red bull,90,125,35,2,00438,India
550313,2023-05-18,203,mango yogurt,50,60,10,2,00438,India
996524,2023-05-18,206,yakult,360,400,40,2,00477,India
996524,2023-05-18,203,mango yogurt,50,60,10,2,00477,India
996524,2023-05-18,213,bisleri,6,15,9,2,00477,India
107422,2023-05-18,206,yakult,360,400,40,2,00070,India
107422,2023-05-18,201,paneer,210,340,130,1,00070,India
914117,2023-05-18,205,classic yogurt,45,60,15,2,00131,India
914117,2023-05-18,212,amul cheese,250,315,65,1,00131,India
914117,2023-05-18,201,paneer,210,340,130,1,00131,India
914117,2023-05-18,213,bisleri,6,15,9,2,00131,India
914117,2023-05-18,204,strawberry yogurt,50,60,10,2,00131,India
335117,2023-05-18,205,classic yogurt,45,60,15,2,00108,India
651967,2023-05-18,211,red bull,90,125,35,2,00298,India
651967,2023-05-18,202,milk,12,27,15,1,00298,India
651967,2023-05-18,205,classic yogurt,45,60,15,2,00298,India
651967,2023-05-18,213,bisleri,6,15,9,2,00298,India
671273,2023-05-18,204,strawberry yogurt,50,60,10,2,00095,India
715655,2023-05-18,209,pepsi,75,100,25,2,00080,India
212267,2023-05-18,210,mountain dew,75,100,25,2,00327,India
192312,2023-05-18,203,mango yogurt,50,60,10,2,00421,India
192312,2023-05-18,207,coca cola,75,100,25,2,00421,India
192312,2023-05-18,213,bisleri,6,15,9,2,00421,India
903087,2023-05-18,206,yakult,360,400,40,2,00012,India
903087,2023-05-18,204,strawberry yogurt,50,60,10,2,00012,India
833175,2023-05-18,209,pepsi,75,100,25,2,00442,India
242789,2023-05-18,201,paneer,210,340,130,1,00411,India
242789,2023-05-18,208,sprite,75,100,25,2,00411,India
242789,2023-05-18,203,mango yogurt,50,60,10,2,00411,India
361203,2023-05-19,210,mountain dew,75,100,25,2,00050,India
361203,2023-05-19,202,milk,12,27,15,1,00050,India
361203,2023-05-19,211,red bull,90,125,35,2,00050,India
361203,2023-05-19,208,sprite,75,100,25,2,00050,India
589985,2023-05-19,206,yakult,360,400,40,2,00112,India
156794,2023-05-19,208,sprite,75,100,25,2,00141,India
146463,2023-05-19,205,classic yogurt,45,60,15,2,00276,India
146463,2023-05-19,210,mountain dew,75,100,25,2,00276,India
146463,2023-05-19,209,pepsi,75,100,25,2,00276,India
146463,2023-05-19,203,mango yogurt,50,60,10,2,00276,India
143680,2023-05-19,211,red bull,90,125,35,2,00303,India
548536,2023-05-19,210,mountain dew,75,100,25,2,00015,India
548536,2023-05-19,209,pepsi,75,100,25,2,00015,India
548536,2023-05-19,203,mango yogurt,50,60,10,2,00015,India
548536,2023-05-19,202,milk,12,27,15,1,00015,India
548536,2023-05-19,206,yakult,360,400,40,2,00015,India
589490,2023-05-19,202,milk,12,27,15,1,00327,India
589490,2023-05-19,205,classic yogurt,45,60,15,2,00327,India
344068,2023-05-19,210,mountain dew,75,100,25,2,00354,India
344068,2023-05-19,206,yakult,360,400,40,2,00354,India
344068,2023-05-19,201,paneer,210,340,130,1,00354,India
906834,2023-05-19,206,yakult,360,400,40,2,00314,India
906834,2023-05-19,204,strawberry yogurt,50,60,10,2,00314,India
612506,2023-05-19,211,red bull,90,125,35,2,00425,India
612506,2023-05-19,212,amul cheese,250,315,65,1,00425,India
612506,2023-05-19,205,classic yogurt,45,60,15,2,00425,India
728404,2023-05-19,202,milk,12,27,15,1,00449,India
728404,2023-05-19,204,strawberry yogurt,50,60,10,2,00449,India
728404,2023-05-19,206,yakult,360,400,40,2,00449,India
728404,2023-05-19,208,sprite,75,100,25,2,00449,India
285113,2023-05-19,210,mountain dew,75,100,25,2,00403,India
285113,2023-05-19,213,bisleri,6,15,9,2,00403,India
285113,2023-05-19,207,coca cola,75,100,25,2,00403,India
828166,2023-05-19,205,classic yogurt,45,60,15,2,00345,India
828166,2023-05-19,207,coca cola,75,100,25,2,00345,India
485837,2023-05-19,212,amul cheese,250,315,65,1,00139,India
485837,2023-05-19,205,classic yogurt,45,60,15,2,00139,India
988253,2023-05-19,207,coca cola,75,100,25,2,00394,India
988253,2023-05-19,202,milk,12,27,15,1,00394,India
988253,2023-05-19,204,strawberry yogurt,50,60,10,2,00394,India
988253,2023-05-19,201,paneer,210,340,130,1,00394,India
376501,2023-05-19,212,amul cheese,250,315,65,1,00366,India
376501,2023-05-19,211,red bull,90,125,35,2,00366,India
376501,2023-05-19,207,coca cola,75,100,25,2,00366,India
947301,2023-05-19,209,pepsi,75,100,25,2,00127,India
947301,2023-05-19,211,red bull,90,125,35,2,00127,India
947301,2023-05-19,206,yakult,360,400,40,2,00127,India
947301,2023-05-19,202,milk,12,27,15,1,00127,India
935355,2023-05-19,210,mountain dew,75,100,25,2,00331,India
935355,2023-05-19,205,classic yogurt,45,60,15,2,00331,India
935355,2023-05-19,208,sprite,75,100,25,2,00331,India
935355,2023-05-19,212,amul cheese,250,315,65,1,00331,India
578640,2023-05-19,208,sprite,75,100,25,2,00326,India
578640,2023-05-19,203,mango yogurt,50,60,10,2,00326,India
578640,2023-05-19,212,amul cheese,250,315,65,1,00326,India
326450,2023-05-19,213,bisleri,6,15,9,2,00270,India
326450,2023-05-19,210,mountain dew,75,100,25,2,00270,India
326450,2023-05-19,207,coca cola,75,100,25,2,00270,India
807442,2023-05-19,202,milk,12,27,15,1,00029,India
807442,2023-05-19,212,amul cheese,250,315,65,1,00029,India
807442,2023-05-19,211,red bull,90,125,35,2,00029,India
914359,2023-05-19,212,amul cheese,250,315,65,1,00491,India
914359,2023-05-19,206,yakult,360,400,40,2,00491,India
661577,2023-05-19,212,amul cheese,250,315,65,1,00003,India
661577,2023-05-19,205,classic yogurt,45,60,15,2,00003,India
661577,2023-05-19,203,mango yogurt,50,60,10,2,00003,India
104857,2023-05-19,213,bisleri,6,15,9,2,00113,India
104857,2023-05-19,204,strawberry yogurt,50,60,10,2,00113,India
104857,2023-05-19,203,mango yogurt,50,60,10,2,00113,India
104857,2023-05-19,201,paneer,210,340,130,1,00113,India
651933,2023-05-19,208,sprite,75,100,25,2,00203,India
915884,2023-05-19,207,coca cola,75,100,25,2,00427,India
915884,2023-05-19,201,paneer,210,340,130,1,00427,India
915884,2023-05-19,205,classic yogurt,45,60,15,2,00427,India
915884,2023-05-19,213,bisleri,6,15,9,2,00427,India
951051,2023-05-19,201,paneer,210,340,130,1,00039,India
951051,2023-05-19,213,bisleri,6,15,9,2,00039,India
951051,2023-05-19,203,mango yogurt,50,60,10,2,00039,India
951051,2023-05-19,208,sprite,75,100,25,2,00039,India
521685,2023-05-19,205,classic yogurt,45,60,15,2,00253,India
521685,2023-05-19,203,mango yogurt,50,60,10,2,00253,India
521685,2023-05-19,204,strawberry yogurt,50,60,10,2,00253,India
930444,2023-05-19,213,bisleri,6,15,9,2,00170,India
930444,2023-05-19,212,amul cheese,250,315,65,1,00170,India
930444,2023-05-19,203,mango yogurt,50,60,10,2,00170,India
930444,2023-05-19,207,coca cola,75,100,25,2,00170,India
930444,2023-05-19,209,pepsi,75,100,25,2,00170,India
439972,2023-05-19,205,classic yogurt,45,60,15,2,00418,India
439972,2023-05-19,211,red bull,90,125,35,2,00418,India
439972,2023-05-19,208,sprite,75,100,25,2,00418,India
439972,2023-05-19,201,paneer,210,340,130,1,00418,India
245929,2023-05-19,213,bisleri,6,15,9,2,00488,India
245929,2023-05-19,204,strawberry yogurt,50,60,10,2,00488,India
245929,2023-05-19,207,coca cola,75,100,25,2,00488,India
245929,2023-05-19,205,classic yogurt,45,60,15,2,00488,India
686697,2023-05-19,203,mango yogurt,50,60,10,2,00047,India
686697,2023-05-19,207,coca cola,75,100,25,2,00047,India
686697,2023-05-19,210,mountain dew,75,100,25,2,00047,India
686697,2023-05-19,213,bisleri,6,15,9,2,00047,India
137613,2023-05-19,206,yakult,360,400,40,2,00305,India
137613,2023-05-19,209,pepsi,75,100,25,2,00305,India
137613,2023-05-19,210,mountain dew,75,100,25,2,00305,India
137613,2023-05-19,208,sprite,75,100,25,2,00305,India
137613,2023-05-19,207,coca cola,75,100,25,2,00305,India
675755,2023-05-19,201,paneer,210,340,130,1,00297,India
675755,2023-05-19,204,strawberry yogurt,50,60,10,2,00297,India
675755,2023-05-19,209,pepsi,75,100,25,2,00297,India
675755,2023-05-19,212,amul cheese,250,315,65,1,00297,India
971217,2023-05-19,204,strawberry yogurt,50,60,10,2,00329,India
435996,2023-05-19,207,coca cola,75,100,25,2,00148,India
435996,2023-05-19,202,milk,12,27,15,1,00148,India
435996,2023-05-19,208,sprite,75,100,25,2,00148,India
435996,2023-05-19,205,classic yogurt,45,60,15,2,00148,India
435996,2023-05-19,203,mango yogurt,50,60,10,2,00148,India
908294,2023-05-19,212,amul cheese,250,315,65,1,00375,India
908294,2023-05-19,213,bisleri,6,15,9,2,00375,India
908294,2023-05-19,210,mountain dew,75,100,25,2,00375,India
343755,2023-05-19,201,paneer,210,340,130,1,00016,India
343755,2023-05-19,209,pepsi,75,100,25,2,00016,India
343755,2023-05-19,204,strawberry yogurt,50,60,10,2,00016,India
920888,2023-05-19,206,yakult,360,400,40,2,00474,India
920888,2023-05-19,202,milk,12,27,15,1,00474,India
259052,2023-05-19,208,sprite,75,100,25,2,00014,India
259052,2023-05-19,204,strawberry yogurt,50,60,10,2,00014,India
259052,2023-05-19,206,yakult,360,400,40,2,00014,India
319067,2023-05-19,212,amul cheese,250,315,65,1,00455,India
319067,2023-05-19,209,pepsi,75,100,25,2,00455,India
319067,2023-05-19,211,red bull,90,125,35,2,00455,India
787324,2023-05-19,203,mango yogurt,50,60,10,2,00346,India
787324,2023-05-19,201,paneer,210,340,130,1,00346,India
787324,2023-05-19,212,amul cheese,250,315,65,1,00346,India
142250,2023-05-19,210,mountain dew,75,100,25,2,00343,India
142250,2023-05-19,204,strawberry yogurt,50,60,10,2,00343,India
142250,2023-05-19,211,red bull,90,125,35,2,00343,India
142250,2023-05-19,203,mango yogurt,50,60,10,2,00343,India
162506,2023-05-19,212,amul cheese,250,315,65,1,00456,India
162506,2023-05-19,207,coca cola,75,100,25,2,00456,India
162506,2023-05-19,201,paneer,210,340,130,1,00456,India
883769,2023-05-19,203,mango yogurt,50,60,10,2,00016,India
883769,2023-05-19,204,strawberry yogurt,50,60,10,2,00016,India
996512,2023-05-19,213,bisleri,6,15,9,2,00009,India
443333,2023-05-19,209,pepsi,75,100,25,2,00356,India
189055,2023-05-19,207,coca cola,75,100,25,2,00370,India
189055,2023-05-19,212,amul cheese,250,315,65,1,00370,India
189055,2023-05-19,210,mountain dew,75,100,25,2,00370,India
956119,2023-05-19,205,classic yogurt,45,60,15,2,00188,India
525781,2023-05-19,213,bisleri,6,15,9,2,00089,India
525781,2023-05-19,212,amul cheese,250,315,65,1,00089,India
525781,2023-05-19,207,coca cola,75,100,25,2,00089,India
525781,2023-05-19,201,paneer,210,340,130,1,00089,India
249186,2023-05-19,204,strawberry yogurt,50,60,10,2,00046,India
249186,2023-05-19,205,classic yogurt,45,60,15,2,00046,India
249186,2023-05-19,211,red bull,90,125,35,2,00046,India
931071,2023-05-19,213,bisleri,6,15,9,2,00226,India
931071,2023-05-19,211,red bull,90,125,35,2,00226,India
516170,2023-05-19,209,pepsi,75,100,25,2,00277,India
516170,2023-05-19,206,yakult,360,400,40,2,00277,India
516170,2023-05-19,203,mango yogurt,50,60,10,2,00277,India
516170,2023-05-19,211,red bull,90,125,35,2,00277,India
516170,2023-05-19,213,bisleri,6,15,9,2,00277,India
302089,2023-05-19,212,amul cheese,250,315,65,1,00228,India
302089,2023-05-19,205,classic yogurt,45,60,15,2,00228,India
302089,2023-05-19,209,pepsi,75,100,25,2,00228,India
302089,2023-05-19,204,strawberry yogurt,50,60,10,2,00228,India
226001,2023-05-19,211,red bull,90,125,35,2,00237,India
226001,2023-05-19,210,mountain dew,75,100,25,2,00237,India
226001,2023-05-19,206,yakult,360,400,40,2,00237,India
782225,2023-05-19,207,coca cola,75,100,25,2,00197,India
386213,2023-05-19,205,classic yogurt,45,60,15,2,00331,India
318303,2023-05-19,203,mango yogurt,50,60,10,2,00297,India
318303,2023-05-19,207,coca cola,75,100,25,2,00297,India
318303,2023-05-19,204,strawberry yogurt,50,60,10,2,00297,India
318303,2023-05-19,206,yakult,360,400,40,2,00297,India
826846,2023-05-19,206,yakult,360,400,40,2,00077,India
703178,2023-05-19,213,bisleri,6,15,9,2,00383,India
703178,2023-05-19,206,yakult,360,400,40,2,00383,India
703178,2023-05-19,205,classic yogurt,45,60,15,2,00383,India
703178,2023-05-19,211,red bull,90,125,35,2,00383,India
525352,2023-05-19,212,amul cheese,250,315,65,1,00142,India
236032,2023-05-19,201,paneer,210,340,130,1,00217,India
236032,2023-05-19,212,amul cheese,250,315,65,1,00217,India
236032,2023-05-19,207,coca cola,75,100,25,2,00217,India
236032,2023-05-19,205,classic yogurt,45,60,15,2,00217,India
236032,2023-05-19,210,mountain dew,75,100,25,2,00217,India
531609,2023-05-19,206,yakult,360,400,40,2,00011,India
531609,2023-05-19,204,strawberry yogurt,50,60,10,2,00011,India
377643,2023-05-19,210,mountain dew,75,100,25,2,00468,India
927162,2023-05-19,201,paneer,210,340,130,1,00260,India
927162,2023-05-19,210,mountain dew,75,100,25,2,00260,India
259777,2023-05-19,213,bisleri,6,15,9,2,00096,India
259777,2023-05-19,209,pepsi,75,100,25,2,00096,India
259777,2023-05-19,203,mango yogurt,50,60,10,2,00096,India
843426,2023-05-19,203,mango yogurt,50,60,10,2,00223,India
843426,2023-05-19,208,sprite,75,100,25,2,00223,India
525987,2023-05-19,204,strawberry yogurt,50,60,10,2,00029,India
525987,2023-05-19,208,sprite,75,100,25,2,00029,India
525987,2023-05-19,201,paneer,210,340,130,1,00029,India
525987,2023-05-19,207,coca cola,75,100,25,2,00029,India
337325,2023-05-19,203,mango yogurt,50,60,10,2,00115,India
221473,2023-05-19,209,pepsi,75,100,25,2,00012,India
343201,2023-05-19,205,classic yogurt,45,60,15,2,00026,India
343201,2023-05-19,209,pepsi,75,100,25,2,00026,India
343201,2023-05-19,203,mango yogurt,50,60,10,2,00026,India
337220,2023-05-19,213,bisleri,6,15,9,2,00285,India
337220,2023-05-19,202,milk,12,27,15,1,00285,India
337220,2023-05-19,204,strawberry yogurt,50,60,10,2,00285,India
337220,2023-05-19,211,red bull,90,125,35,2,00285,India
337220,2023-05-19,209,pepsi,75,100,25,2,00285,India
985020,2023-05-19,213,bisleri,6,15,9,2,00402,India
985020,2023-05-19,211,red bull,90,125,35,2,00402,India
727308,2023-05-19,213,bisleri,6,15,9,2,00237,India
727308,2023-05-19,201,paneer,210,340,130,1,00237,India
727308,2023-05-19,208,sprite,75,100,25,2,00237,India
727308,2023-05-19,212,amul cheese,250,315,65,1,00237,India
616526,2023-05-19,209,pepsi,75,100,25,2,00067,India
282428,2023-05-19,207,coca cola,75,100,25,2,00220,India
282428,2023-05-19,205,classic yogurt,45,60,15,2,00220,India
282428,2023-05-19,212,amul cheese,250,315,65,1,00220,India
282428,2023-05-19,206,yakult,360,400,40,2,00220,India
282428,2023-05-19,202,milk,12,27,15,1,00220,India
477215,2023-05-19,205,classic yogurt,45,60,15,2,00214,India
477215,2023-05-19,211,red bull,90,125,35,2,00214,India
477215,2023-05-19,206,yakult,360,400,40,2,00214,India
477215,2023-05-19,201,paneer,210,340,130,1,00214,India
500416,2023-05-19,212,amul cheese,250,315,65,1,00405,India
500416,2023-05-19,210,mountain dew,75,100,25,2,00405,India
500416,2023-05-19,209,pepsi,75,100,25,2,00405,India
500416,2023-05-19,208,sprite,75,100,25,2,00405,India
500416,2023-05-19,206,yakult,360,400,40,2,00405,India
751576,2023-05-19,205,classic yogurt,45,60,15,2,00215,India
751576,2023-05-19,206,yakult,360,400,40,2,00215,India
751576,2023-05-19,207,coca cola,75,100,25,2,00215,India
156182,2023-05-19,201,paneer,210,340,130,1,00164,India
156182,2023-05-19,204,strawberry yogurt,50,60,10,2,00164,India
156182,2023-05-19,206,yakult,360,400,40,2,00164,India
156182,2023-05-19,210,mountain dew,75,100,25,2,00164,India
756188,2023-05-19,203,mango yogurt,50,60,10,2,00449,India
756188,2023-05-19,209,pepsi,75,100,25,2,00449,India
809250,2023-05-19,210,mountain dew,75,100,25,2,00484,India
809250,2023-05-19,213,bisleri,6,15,9,2,00484,India
593970,2023-05-19,205,classic yogurt,45,60,15,2,00390,India
593970,2023-05-19,209,pepsi,75,100,25,2,00390,India
593970,2023-05-19,211,red bull,90,125,35,2,00390,India
593970,2023-05-19,208,sprite,75,100,25,2,00390,India
706377,2023-05-19,204,strawberry yogurt,50,60,10,2,00307,India
706377,2023-05-19,211,red bull,90,125,35,2,00307,India
706377,2023-05-19,208,sprite,75,100,25,2,00307,India
706377,2023-05-19,207,coca cola,75,100,25,2,00307,India
849017,2023-05-19,204,strawberry yogurt,50,60,10,2,00056,India
520364,2023-05-19,209,pepsi,75,100,25,2,00081,India
512245,2023-05-19,212,amul cheese,250,315,65,1,00375,India
728043,2023-05-19,211,red bull,90,125,35,2,00224,India
829348,2023-05-19,202,milk,12,27,15,1,00073,India
829348,2023-05-19,203,mango yogurt,50,60,10,2,00073,India
829348,2023-05-19,206,yakult,360,400,40,2,00073,India
829348,2023-05-19,208,sprite,75,100,25,2,00073,India
829348,2023-05-19,207,coca cola,75,100,25,2,00073,India
408822,2023-05-19,206,yakult,360,400,40,2,00041,India
408822,2023-05-19,204,strawberry yogurt,50,60,10,2,00041,India
408822,2023-05-19,212,amul cheese,250,315,65,1,00041,India
408822,2023-05-19,201,paneer,210,340,130,1,00041,India
503221,2023-05-19,202,milk,12,27,15,1,00405,India
503221,2023-05-19,205,classic yogurt,45,60,15,2,00405,India
721469,2023-05-19,210,mountain dew,75,100,25,2,00481,India
721469,2023-05-19,212,amul cheese,250,315,65,1,00481,India
721469,2023-05-19,213,bisleri,6,15,9,2,00481,India
721469,2023-05-19,202,milk,12,27,15,1,00481,India
174693,2023-05-19,213,bisleri,6,15,9,2,00414,India
739852,2023-05-19,203,mango yogurt,50,60,10,2,00322,India
739852,2023-05-19,212,amul cheese,250,315,65,1,00322,India
620355,2023-05-19,211,red bull,90,125,35,2,00312,India
522582,2023-05-19,210,mountain dew,75,100,25,2,00431,India
522582,2023-05-19,209,pepsi,75,100,25,2,00431,India
561349,2023-05-19,201,paneer,210,340,130,1,00119,India
561349,2023-05-19,213,bisleri,6,15,9,2,00119,India
561349,2023-05-19,208,sprite,75,100,25,2,00119,India
867662,2023-05-19,201,paneer,210,340,130,1,00377,India
867662,2023-05-19,209,pepsi,75,100,25,2,00377,India
867662,2023-05-19,208,sprite,75,100,25,2,00377,India
142121,2023-05-19,206,yakult,360,400,40,2,00198,India
142121,2023-05-19,201,paneer,210,340,130,1,00198,India
142121,2023-05-19,211,red bull,90,125,35,2,00198,India
369914,2023-05-19,206,yakult,360,400,40,2,00279,India
369914,2023-05-19,210,mountain dew,75,100,25,2,00279,India
369914,2023-05-19,209,pepsi,75,100,25,2,00279,India
369914,2023-05-19,207,coca cola,75,100,25,2,00279,India
669322,2023-05-20,204,strawberry yogurt,50,60,10,2,00258,India
669322,2023-05-20,211,red bull,90,125,35,2,00258,India
669322,2023-05-20,208,sprite,75,100,25,2,00258,India
669322,2023-05-20,213,bisleri,6,15,9,2,00258,India
692045,2023-05-20,212,amul cheese,250,315,65,1,00189,India
692045,2023-05-20,208,sprite,75,100,25,2,00189,India
215947,2023-05-20,207,coca cola,75,100,25,2,00299,India
932407,2023-05-20,207,coca cola,75,100,25,2,00080,India
932407,2023-05-20,213,bisleri,6,15,9,2,00080,India
932407,2023-05-20,210,mountain dew,75,100,25,2,00080,India
932407,2023-05-20,212,amul cheese,250,315,65,1,00080,India
496950,2023-05-20,204,strawberry yogurt,50,60,10,2,00130,India
496950,2023-05-20,207,coca cola,75,100,25,2,00130,India
532219,2023-05-20,201,paneer,210,340,130,1,00202,India
532219,2023-05-20,202,milk,12,27,15,1,00202,India
323710,2023-05-20,207,coca cola,75,100,25,2,00074,India
491825,2023-05-20,208,sprite,75,100,25,2,00019,India
491825,2023-05-20,204,strawberry yogurt,50,60,10,2,00019,India
707112,2023-05-20,212,amul cheese,250,315,65,1,00303,India
707112,2023-05-20,205,classic yogurt,45,60,15,2,00303,India
347444,2023-05-20,205,classic yogurt,45,60,15,2,00160,India
259491,2023-05-20,212,amul cheese,250,315,65,1,00465,India
259491,2023-05-20,211,red bull,90,125,35,2,00465,India
388703,2023-05-20,212,amul cheese,250,315,65,1,00096,India
297084,2023-05-20,211,red bull,90,125,35,2,00374,India
297084,2023-05-20,212,amul cheese,250,315,65,1,00374,India
297084,2023-05-20,206,yakult,360,400,40,2,00374,India
297084,2023-05-20,202,milk,12,27,15,1,00374,India
297084,2023-05-20,213,bisleri,6,15,9,2,00374,India
813051,2023-05-20,207,coca cola,75,100,25,2,00423,India
813051,2023-05-20,211,red bull,90,125,35,2,00423,India
813051,2023-05-20,209,pepsi,75,100,25,2,00423,India
967179,2023-05-20,202,milk,12,27,15,1,00298,India
628099,2023-05-20,204,strawberry yogurt,50,60,10,2,00287,India
628099,2023-05-20,205,classic yogurt,45,60,15,2,00287,India
628099,2023-05-20,210,mountain dew,75,100,25,2,00287,India
387654,2023-05-20,204,strawberry yogurt,50,60,10,2,00243,India
387654,2023-05-20,203,mango yogurt,50,60,10,2,00243,India
387654,2023-05-20,201,paneer,210,340,130,1,00243,India
777266,2023-05-20,208,sprite,75,100,25,2,00322,India
777266,2023-05-20,211,red bull,90,125,35,2,00322,India
777266,2023-05-20,206,yakult,360,400,40,2,00322,India
777266,2023-05-20,204,strawberry yogurt,50,60,10,2,00322,India
956981,2023-05-20,207,coca cola,75,100,25,2,00469,India
956981,2023-05-20,213,bisleri,6,15,9,2,00469,India
135936,2023-05-20,206,yakult,360,400,40,2,00032,India
135936,2023-05-20,203,mango yogurt,50,60,10,2,00032,India
135936,2023-05-20,209,pepsi,75,100,25,2,00032,India
135936,2023-05-20,201,paneer,210,340,130,1,00032,India
625760,2023-05-20,204,strawberry yogurt,50,60,10,2,00183,India
625760,2023-05-20,201,paneer,210,340,130,1,00183,India
625760,2023-05-20,203,mango yogurt,50,60,10,2,00183,India
460465,2023-05-20,206,yakult,360,400,40,2,00432,India
460465,2023-05-20,209,pepsi,75,100,25,2,00432,India
510602,2023-05-20,208,sprite,75,100,25,2,00402,India
510602,2023-05-20,213,bisleri,6,15,9,2,00402,India
754505,2023-05-20,211,red bull,90,125,35,2,00357,India
754505,2023-05-20,208,sprite,75,100,25,2,00357,India
754505,2023-05-20,206,yakult,360,400,40,2,00357,India
134621,2023-05-20,208,sprite,75,100,25,2,00418,India
134621,2023-05-20,204,strawberry yogurt,50,60,10,2,00418,India
412495,2023-05-20,204,strawberry yogurt,50,60,10,2,00466,India
412495,2023-05-20,211,red bull,90,125,35,2,00466,India
412495,2023-05-20,209,pepsi,75,100,25,2,00466,India
412495,2023-05-20,207,coca cola,75,100,25,2,00466,India
183181,2023-05-20,209,pepsi,75,100,25,2,00057,India
183181,2023-05-20,207,coca cola,75,100,25,2,00057,India
183181,2023-05-20,211,red bull,90,125,35,2,00057,India
245283,2023-05-20,210,mountain dew,75,100,25,2,00148,India
245283,2023-05-20,209,pepsi,75,100,25,2,00148,India
522084,2023-05-20,206,yakult,360,400,40,2,00346,India
522084,2023-05-20,208,sprite,75,100,25,2,00346,India
522084,2023-05-20,211,red bull,90,125,35,2,00346,India
522084,2023-05-20,202,milk,12,27,15,1,00346,India
522084,2023-05-20,209,pepsi,75,100,25,2,00346,India
163624,2023-05-20,202,milk,12,27,15,1,00441,India
163624,2023-05-20,211,red bull,90,125,35,2,00441,India
163624,2023-05-20,205,classic yogurt,45,60,15,2,00441,India
360022,2023-05-20,202,milk,12,27,15,1,00396,India
360022,2023-05-20,201,paneer,210,340,130,1,00396,India
360022,2023-05-20,207,coca cola,75,100,25,2,00396,India
360022,2023-05-20,213,bisleri,6,15,9,2,00396,India
360022,2023-05-20,210,mountain dew,75,100,25,2,00396,India
612049,2023-05-20,203,mango yogurt,50,60,10,2,00400,India
642966,2023-05-20,203,mango yogurt,50,60,10,2,00298,India
642966,2023-05-20,207,coca cola,75,100,25,2,00298,India
642966,2023-05-20,213,bisleri,6,15,9,2,00298,India
642966,2023-05-20,201,paneer,210,340,130,1,00298,India
900417,2023-05-20,204,strawberry yogurt,50,60,10,2,00393,India
900417,2023-05-20,206,yakult,360,400,40,2,00393,India
900417,2023-05-20,210,mountain dew,75,100,25,2,00393,India
412810,2023-05-20,205,classic yogurt,45,60,15,2,00172,India
412810,2023-05-20,211,red bull,90,125,35,2,00172,India
296431,2023-05-20,208,sprite,75,100,25,2,00376,India
296431,2023-05-20,210,mountain dew,75,100,25,2,00376,India
296431,2023-05-20,206,yakult,360,400,40,2,00376,India
296431,2023-05-20,205,classic yogurt,45,60,15,2,00376,India
468069,2023-05-20,202,milk,12,27,15,1,00171,India
468069,2023-05-20,213,bisleri,6,15,9,2,00171,India
551352,2023-05-20,211,red bull,90,125,35,2,00280,India
458590,2023-05-20,209,pepsi,75,100,25,2,00473,India
458590,2023-05-20,210,mountain dew,75,100,25,2,00473,India
458590,2023-05-20,208,sprite,75,100,25,2,00473,India
823814,2023-05-20,207,coca cola,75,100,25,2,00500,India
211462,2023-05-20,209,pepsi,75,100,25,2,00208,India
211462,2023-05-20,201,paneer,210,340,130,1,00208,India
211462,2023-05-20,202,milk,12,27,15,1,00208,India
211462,2023-05-20,207,coca cola,75,100,25,2,00208,India
409609,2023-05-20,203,mango yogurt,50,60,10,2,00206,India
409609,2023-05-20,211,red bull,90,125,35,2,00206,India
409609,2023-05-20,209,pepsi,75,100,25,2,00206,India
846336,2023-05-20,208,sprite,75,100,25,2,00441,India
846336,2023-05-20,209,pepsi,75,100,25,2,00441,India
123541,2023-05-20,205,classic yogurt,45,60,15,2,00152,India
123541,2023-05-20,210,mountain dew,75,100,25,2,00152,India
744358,2023-05-20,205,classic yogurt,45,60,15,2,00209,India
744358,2023-05-20,212,amul cheese,250,315,65,1,00209,India
744358,2023-05-20,203,mango yogurt,50,60,10,2,00209,India
744358,2023-05-20,202,milk,12,27,15,1,00209,India
545268,2023-05-20,212,amul cheese,250,315,65,1,00284,India
499153,2023-05-20,205,classic yogurt,45,60,15,2,00057,India
582156,2023-05-20,208,sprite,75,100,25,2,00067,India
582156,2023-05-20,207,coca cola,75,100,25,2,00067,India
582156,2023-05-20,212,amul cheese,250,315,65,1,00067,India
619729,2023-05-20,209,pepsi,75,100,25,2,00258,India
619729,2023-05-20,212,amul cheese,250,315,65,1,00258,India
619729,2023-05-20,213,bisleri,6,15,9,2,00258,India
619729,2023-05-20,203,mango yogurt,50,60,10,2,00258,India
634203,2023-05-20,211,red bull,90,125,35,2,00333,India
634203,2023-05-20,205,classic yogurt,45,60,15,2,00333,India
634203,2023-05-20,207,coca cola,75,100,25,2,00333,India
634203,2023-05-20,212,amul cheese,250,315,65,1,00333,India
765400,2023-05-20,206,yakult,360,400,40,2,00121,India
765400,2023-05-20,202,milk,12,27,15,1,00121,India
587215,2023-05-20,213,bisleri,6,15,9,2,00228,India
587215,2023-05-20,201,paneer,210,340,130,1,00228,India
587215,2023-05-20,202,milk,12,27,15,1,00228,India
587215,2023-05-20,206,yakult,360,400,40,2,00228,India
693814,2023-05-20,209,pepsi,75,100,25,2,00253,India
188847,2023-05-20,203,mango yogurt,50,60,10,2,00416,India
188847,2023-05-20,206,yakult,360,400,40,2,00416,India
188847,2023-05-20,212,amul cheese,250,315,65,1,00416,India
960384,2023-05-20,210,mountain dew,75,100,25,2,00214,India
960384,2023-05-20,211,red bull,90,125,35,2,00214,India
820561,2023-05-20,204,strawberry yogurt,50,60,10,2,00486,India
820561,2023-05-20,211,red bull,90,125,35,2,00486,India
973241,2023-05-20,206,yakult,360,400,40,2,00476,India
973241,2023-05-20,208,sprite,75,100,25,2,00476,India
973241,2023-05-20,213,bisleri,6,15,9,2,00476,India
973241,2023-05-20,209,pepsi,75,100,25,2,00476,India
693087,2023-05-20,213,bisleri,6,15,9,2,00453,India
521353,2023-05-20,208,sprite,75,100,25,2,00313,India
521353,2023-05-20,205,classic yogurt,45,60,15,2,00313,India
908053,2023-05-20,202,milk,12,27,15,1,00062,India
908053,2023-05-20,203,mango yogurt,50,60,10,2,00062,India
303490,2023-05-20,212,amul cheese,250,315,65,1,00135,India
303490,2023-05-20,207,coca cola,75,100,25,2,00135,India
303490,2023-05-20,201,paneer,210,340,130,1,00135,India
736004,2023-05-20,204,strawberry yogurt,50,60,10,2,00466,India
736004,2023-05-20,201,paneer,210,340,130,1,00466,India
736004,2023-05-20,206,yakult,360,400,40,2,00466,India
736004,2023-05-20,213,bisleri,6,15,9,2,00466,India
548816,2023-05-20,209,pepsi,75,100,25,2,00422,India
548816,2023-05-20,205,classic yogurt,45,60,15,2,00422,India
298721,2023-05-20,213,bisleri,6,15,9,2,00279,India
298721,2023-05-20,202,milk,12,27,15,1,00279,India
953699,2023-05-20,211,red bull,90,125,35,2,00356,India
953699,2023-05-20,208,sprite,75,100,25,2,00356,India
953699,2023-05-20,212,amul cheese,250,315,65,1,00356,India
953699,2023-05-20,203,mango yogurt,50,60,10,2,00356,India
953699,2023-05-20,202,milk,12,27,15,1,00356,India
940771,2023-05-20,211,red bull,90,125,35,2,00423,India
672795,2023-05-20,209,pepsi,75,100,25,2,00496,India
672795,2023-05-20,208,sprite,75,100,25,2,00496,India
672795,2023-05-20,207,coca cola,75,100,25,2,00496,India
672795,2023-05-20,210,mountain dew,75,100,25,2,00496,India
978939,2023-05-20,212,amul cheese,250,315,65,1,00473,India
936987,2023-05-21,211,red bull,90,125,35,2,00072,India
936987,2023-05-21,213,bisleri,6,15,9,2,00072,India
577956,2023-05-21,202,milk,12,27,15,1,00344,India
577956,2023-05-21,213,bisleri,6,15,9,2,00344,India
577956,2023-05-21,207,coca cola,75,100,25,2,00344,India
859095,2023-05-21,209,pepsi,75,100,25,2,00130,India
859095,2023-05-21,211,red bull,90,125,35,2,00130,India
859095,2023-05-21,202,milk,12,27,15,1,00130,India
859095,2023-05-21,213,bisleri,6,15,9,2,00130,India
200985,2023-05-21,203,mango yogurt,50,60,10,2,00227,India
322589,2023-05-21,201,paneer,210,340,130,1,00123,India
322589,2023-05-21,210,mountain dew,75,100,25,2,00123,India
278986,2023-05-21,202,milk,12,27,15,1,00172,India
278986,2023-05-21,213,bisleri,6,15,9,2,00172,India
278986,2023-05-21,209,pepsi,75,100,25,2,00172,India
278986,2023-05-21,208,sprite,75,100,25,2,00172,India
485435,2023-05-21,213,bisleri,6,15,9,2,00310,India
485435,2023-05-21,211,red bull,90,125,35,2,00310,India
485435,2023-05-21,212,amul cheese,250,315,65,1,00310,India
485435,2023-05-21,206,yakult,360,400,40,2,00310,India
485435,2023-05-21,203,mango yogurt,50,60,10,2,00310,India
708509,2023-05-21,204,strawberry yogurt,50,60,10,2,00011,India
708509,2023-05-21,201,paneer,210,340,130,1,00011,India
708509,2023-05-21,210,mountain dew,75,100,25,2,00011,India
993173,2023-05-21,205,classic yogurt,45,60,15,2,00472,India
993173,2023-05-21,212,amul cheese,250,315,65,1,00472,India
101988,2023-05-21,206,yakult,360,400,40,2,00029,India
101988,2023-05-21,202,milk,12,27,15,1,00029,India
101988,2023-05-21,201,paneer,210,340,130,1,00029,India
101988,2023-05-21,203,mango yogurt,50,60,10,2,00029,India
827264,2023-05-21,202,milk,12,27,15,1,00495,India
872483,2023-05-21,211,red bull,90,125,35,2,00049,India
872483,2023-05-21,206,yakult,360,400,40,2,00049,India
382909,2023-05-21,203,mango yogurt,50,60,10,2,00044,India
504712,2023-05-21,213,bisleri,6,15,9,2,00363,India
145884,2023-05-21,202,milk,12,27,15,1,00095,India
639735,2023-05-21,205,classic yogurt,45,60,15,2,00473,India
793556,2023-05-21,203,mango yogurt,50,60,10,2,00472,India
476931,2023-05-21,203,mango yogurt,50,60,10,2,00341,India
476931,2023-05-21,207,coca cola,75,100,25,2,00341,India
476931,2023-05-21,206,yakult,360,400,40,2,00341,India
830717,2023-05-21,209,pepsi,75,100,25,2,00266,India
830717,2023-05-21,210,mountain dew,75,100,25,2,00266,India
918022,2023-05-21,205,classic yogurt,45,60,15,2,00231,India
918022,2023-05-21,208,sprite,75,100,25,2,00231,India
918022,2023-05-21,203,mango yogurt,50,60,10,2,00231,India
972525,2023-05-21,205,classic yogurt,45,60,15,2,00294,India
972525,2023-05-21,206,yakult,360,400,40,2,00294,India
972525,2023-05-21,212,amul cheese,250,315,65,1,00294,India
972525,2023-05-21,213,bisleri,6,15,9,2,00294,India
550210,2023-05-21,211,red bull,90,125,35,2,00475,India
550210,2023-05-21,208,sprite,75,100,25,2,00475,India
550210,2023-05-21,207,coca cola,75,100,25,2,00475,India
790029,2023-05-21,210,mountain dew,75,100,25,2,00486,India
994339,2023-05-21,207,coca cola,75,100,25,2,00426,India
994339,2023-05-21,213,bisleri,6,15,9,2,00426,India
994339,2023-05-21,201,paneer,210,340,130,1,00426,India
848202,2023-05-21,206,yakult,360,400,40,2,00176,India
848202,2023-05-21,208,sprite,75,100,25,2,00176,India
468947,2023-05-21,207,coca cola,75,100,25,2,00305,India
510023,2023-05-21,212,amul cheese,250,315,65,1,00417,India
510023,2023-05-21,202,milk,12,27,15,1,00417,India
510023,2023-05-21,201,paneer,210,340,130,1,00417,India
936902,2023-05-21,203,mango yogurt,50,60,10,2,00257,India
104128,2023-05-21,202,milk,12,27,15,1,00311,India
104128,2023-05-21,213,bisleri,6,15,9,2,00311,India
104128,2023-05-21,205,classic yogurt,45,60,15,2,00311,India
104128,2023-05-21,203,mango yogurt,50,60,10,2,00311,India
848356,2023-05-21,212,amul cheese,250,315,65,1,00363,India
556365,2023-05-21,212,amul cheese,250,315,65,1,00292,India
556365,2023-05-21,202,milk,12,27,15,1,00292,India
556365,2023-05-21,204,strawberry yogurt,50,60,10,2,00292,India
976742,2023-05-21,213,bisleri,6,15,9,2,00134,India
976742,2023-05-21,211,red bull,90,125,35,2,00134,India
453271,2023-05-21,213,bisleri,6,15,9,2,00015,India
453271,2023-05-21,208,sprite,75,100,25,2,00015,India
453271,2023-05-21,207,coca cola,75,100,25,2,00015,India
453271,2023-05-21,203,mango yogurt,50,60,10,2,00015,India
859023,2023-05-21,208,sprite,75,100,25,2,00380,India
859023,2023-05-21,209,pepsi,75,100,25,2,00380,India
859023,2023-05-21,203,mango yogurt,50,60,10,2,00380,India
474652,2023-05-21,204,strawberry yogurt,50,60,10,2,00434,India
873558,2023-05-21,210,mountain dew,75,100,25,2,00195,India
873558,2023-05-21,206,yakult,360,400,40,2,00195,India
873558,2023-05-21,212,amul cheese,250,315,65,1,00195,India
873558,2023-05-21,208,sprite,75,100,25,2,00195,India
997313,2023-05-21,206,yakult,360,400,40,2,00426,India
997313,2023-05-21,201,paneer,210,340,130,1,00426,India
300929,2023-05-21,204,strawberry yogurt,50,60,10,2,00233,India
300929,2023-05-21,202,milk,12,27,15,1,00233,India
300929,2023-05-21,211,red bull,90,125,35,2,00233,India
300929,2023-05-21,201,paneer,210,340,130,1,00233,India
300929,2023-05-21,210,mountain dew,75,100,25,2,00233,India
765386,2023-05-21,205,classic yogurt,45,60,15,2,00359,India
765386,2023-05-21,206,yakult,360,400,40,2,00359,India
765386,2023-05-21,207,coca cola,75,100,25,2,00359,India
223204,2023-05-21,208,sprite,75,100,25,2,00426,India
223204,2023-05-21,204,strawberry yogurt,50,60,10,2,00426,India
223204,2023-05-21,209,pepsi,75,100,25,2,00426,India
223204,2023-05-21,201,paneer,210,340,130,1,00426,India
523696,2023-05-21,208,sprite,75,100,25,2,00327,India
523696,2023-05-21,201,paneer,210,340,130,1,00327,India
523696,2023-05-21,202,milk,12,27,15,1,00327,India
523696,2023-05-21,205,classic yogurt,45,60,15,2,00327,India
742506,2023-05-21,209,pepsi,75,100,25,2,00174,India
742506,2023-05-21,201,paneer,210,340,130,1,00174,India
742506,2023-05-21,211,red bull,90,125,35,2,00174,India
742506,2023-05-21,207,coca cola,75,100,25,2,00174,India
742506,2023-05-21,212,amul cheese,250,315,65,1,00174,India
327133,2023-05-21,211,red bull,90,125,35,2,00413,India
327133,2023-05-21,201,paneer,210,340,130,1,00413,India
765817,2023-05-21,208,sprite,75,100,25,2,00032,India
765817,2023-05-21,211,red bull,90,125,35,2,00032,India
765817,2023-05-21,202,milk,12,27,15,1,00032,India
765817,2023-05-21,206,yakult,360,400,40,2,00032,India
765817,2023-05-21,210,mountain dew,75,100,25,2,00032,India
705952,2023-05-21,208,sprite,75,100,25,2,00193,India
705952,2023-05-21,209,pepsi,75,100,25,2,00193,India
443497,2023-05-21,209,pepsi,75,100,25,2,00481,India
443497,2023-05-21,205,classic yogurt,45,60,15,2,00481,India
968227,2023-05-21,206,yakult,360,400,40,2,00219,India
968227,2023-05-21,209,pepsi,75,100,25,2,00219,India
277312,2023-05-21,206,yakult,360,400,40,2,00191,India
277312,2023-05-21,213,bisleri,6,15,9,2,00191,India
277312,2023-05-21,209,pepsi,75,100,25,2,00191,India
277312,2023-05-21,202,milk,12,27,15,1,00191,India
626387,2023-05-21,204,strawberry yogurt,50,60,10,2,00422,India
626387,2023-05-21,205,classic yogurt,45,60,15,2,00422,India
626387,2023-05-21,208,sprite,75,100,25,2,00422,India
266653,2023-05-21,206,yakult,360,400,40,2,00078,India
266653,2023-05-21,204,strawberry yogurt,50,60,10,2,00078,India
795256,2023-05-21,205,classic yogurt,45,60,15,2,00351,India
654164,2023-05-21,207,coca cola,75,100,25,2,00285,India
654164,2023-05-21,211,red bull,90,125,35,2,00285,India
190821,2023-05-21,202,milk,12,27,15,1,00196,India
860893,2023-05-21,207,coca cola,75,100,25,2,00408,India
860893,2023-05-21,212,amul cheese,250,315,65,1,00408,India
860893,2023-05-21,202,milk,12,27,15,1,00408,India
860893,2023-05-21,203,mango yogurt,50,60,10,2,00408,India
774766,2023-05-21,213,bisleri,6,15,9,2,00148,India
377838,2023-05-21,203,mango yogurt,50,60,10,2,00446,India
377838,2023-05-21,209,pepsi,75,100,25,2,00446,India
377838,2023-05-21,202,milk,12,27,15,1,00446,India
312883,2023-05-21,212,amul cheese,250,315,65,1,00416,India
219981,2023-05-21,207,coca cola,75,100,25,2,00213,India
219981,2023-05-21,209,pepsi,75,100,25,2,00213,India
959583,2023-05-21,207,coca cola,75,100,25,2,00282,India
656629,2023-05-21,204,strawberry yogurt,50,60,10,2,00456,India
656629,2023-05-21,203,mango yogurt,50,60,10,2,00456,India
287270,2023-05-21,201,paneer,210,340,130,1,00177,India
287270,2023-05-21,206,yakult,360,400,40,2,00177,India
287270,2023-05-21,203,mango yogurt,50,60,10,2,00177,India
287270,2023-05-21,212,amul cheese,250,315,65,1,00177,India
287270,2023-05-21,211,red bull,90,125,35,2,00177,India
234800,2023-05-21,210,mountain dew,75,100,25,2,00188,India
234800,2023-05-21,211,red bull,90,125,35,2,00188,India
822344,2023-05-21,205,classic yogurt,45,60,15,2,00181,India
201016,2023-05-22,205,classic yogurt,45,60,15,2,00099,India
211202,2023-05-22,202,milk,12,27,15,1,00173,India
862649,2023-05-22,213,bisleri,6,15,9,2,00114,India
862649,2023-05-22,212,amul cheese,250,315,65,1,00114,India
862649,2023-05-22,202,milk,12,27,15,1,00114,India
888125,2023-05-22,202,milk,12,27,15,1,00024,India
888125,2023-05-22,201,paneer,210,340,130,1,00024,India
888125,2023-05-22,211,red bull,90,125,35,2,00024,India
888125,2023-05-22,210,mountain dew,75,100,25,2,00024,India
888125,2023-05-22,207,coca cola,75,100,25,2,00024,India
290711,2023-05-22,204,strawberry yogurt,50,60,10,2,00155,India
412300,2023-05-22,205,classic yogurt,45,60,15,2,00419,India
412300,2023-05-22,207,coca cola,75,100,25,2,00419,India
412300,2023-05-22,202,milk,12,27,15,1,00419,India
858416,2023-05-22,212,amul cheese,250,315,65,1,00358,India
560671,2023-05-22,213,bisleri,6,15,9,2,00038,India
560671,2023-05-22,202,milk,12,27,15,1,00038,India
384691,2023-05-22,211,red bull,90,125,35,2,00335,India
384691,2023-05-22,209,pepsi,75,100,25,2,00335,India
384691,2023-05-22,204,strawberry yogurt,50,60,10,2,00335,India
384691,2023-05-22,203,mango yogurt,50,60,10,2,00335,India
998202,2023-05-22,207,coca cola,75,100,25,2,00350,India
998202,2023-05-22,210,mountain dew,75,100,25,2,00350,India
998202,2023-05-22,212,amul cheese,250,315,65,1,00350,India
166219,2023-05-22,208,sprite,75,100,25,2,00320,India
166219,2023-05-22,204,strawberry yogurt,50,60,10,2,00320,India
182195,2023-05-22,204,strawberry yogurt,50,60,10,2,00454,India
182195,2023-05-22,205,classic yogurt,45,60,15,2,00454,India
182195,2023-05-22,207,coca cola,75,100,25,2,00454,India
182195,2023-05-22,212,amul cheese,250,315,65,1,00454,India
713038,2023-05-22,209,pepsi,75,100,25,2,00124,India
713038,2023-05-22,213,bisleri,6,15,9,2,00124,India
713038,2023-05-22,212,amul cheese,250,315,65,1,00124,India
713038,2023-05-22,211,red bull,90,125,35,2,00124,India
492657,2023-05-22,204,strawberry yogurt,50,60,10,2,00001,India
492657,2023-05-22,202,milk,12,27,15,1,00001,India
492657,2023-05-22,201,paneer,210,340,130,1,00001,India
492657,2023-05-22,207,coca cola,75,100,25,2,00001,India
284794,2023-05-22,209,pepsi,75,100,25,2,00352,India
516393,2023-05-22,202,milk,12,27,15,1,00359,India
516393,2023-05-22,212,amul cheese,250,315,65,1,00359,India
516393,2023-05-22,205,classic yogurt,45,60,15,2,00359,India
516393,2023-05-22,203,mango yogurt,50,60,10,2,00359,India
261275,2023-05-22,207,coca cola,75,100,25,2,00403,India
261275,2023-05-22,202,milk,12,27,15,1,00403,India
261275,2023-05-22,205,classic yogurt,45,60,15,2,00403,India
536541,2023-05-22,205,classic yogurt,45,60,15,2,00017,India
676089,2023-05-22,201,paneer,210,340,130,1,00362,India
129088,2023-05-22,202,milk,12,27,15,1,00298,India
129088,2023-05-22,211,red bull,90,125,35,2,00298,India
129088,2023-05-22,201,paneer,210,340,130,1,00298,India
129088,2023-05-22,212,amul cheese,250,315,65,1,00298,India
498078,2023-05-22,206,yakult,360,400,40,2,00160,India
498078,2023-05-22,213,bisleri,6,15,9,2,00160,India
498078,2023-05-22,207,coca cola,75,100,25,2,00160,India
498078,2023-05-22,201,paneer,210,340,130,1,00160,India
498078,2023-05-22,212,amul cheese,250,315,65,1,00160,India
475470,2023-05-22,203,mango yogurt,50,60,10,2,00461,India
475470,2023-05-22,206,yakult,360,400,40,2,00461,India
475470,2023-05-22,210,mountain dew,75,100,25,2,00461,India
475470,2023-05-22,209,pepsi,75,100,25,2,00461,India
174013,2023-05-22,208,sprite,75,100,25,2,00400,India
174013,2023-05-22,204,strawberry yogurt,50,60,10,2,00400,India
929957,2023-05-22,207,coca cola,75,100,25,2,00241,India
843248,2023-05-22,206,yakult,360,400,40,2,00238,India
843248,2023-05-22,205,classic yogurt,45,60,15,2,00238,India
843248,2023-05-22,211,red bull,90,125,35,2,00238,India
796838,2023-05-22,208,sprite,75,100,25,2,00247,India
796838,2023-05-22,210,mountain dew,75,100,25,2,00247,India
796838,2023-05-22,203,mango yogurt,50,60,10,2,00247,India
796838,2023-05-22,201,paneer,210,340,130,1,00247,India
357170,2023-05-22,203,mango yogurt,50,60,10,2,00485,India
357170,2023-05-22,210,mountain dew,75,100,25,2,00485,India
357170,2023-05-22,211,red bull,90,125,35,2,00485,India
357170,2023-05-22,202,milk,12,27,15,1,00485,India
357170,2023-05-22,204,strawberry yogurt,50,60,10,2,00485,India
720300,2023-05-22,212,amul cheese,250,315,65,1,00050,India
720300,2023-05-22,210,mountain dew,75,100,25,2,00050,India
408723,2023-05-22,208,sprite,75,100,25,2,00392,India
408723,2023-05-22,211,red bull,90,125,35,2,00392,India
408723,2023-05-22,207,coca cola,75,100,25,2,00392,India
283691,2023-05-22,205,classic yogurt,45,60,15,2,00288,India
283691,2023-05-22,209,pepsi,75,100,25,2,00288,India
283691,2023-05-22,201,paneer,210,340,130,1,00288,India
403427,2023-05-22,203,mango yogurt,50,60,10,2,00362,India
403427,2023-05-22,207,coca cola,75,100,25,2,00362,India
403427,2023-05-22,213,bisleri,6,15,9,2,00362,India
975309,2023-05-22,208,sprite,75,100,25,2,00480,India
692468,2023-05-22,211,red bull,90,125,35,2,00150,India
692468,2023-05-22,209,pepsi,75,100,25,2,00150,India
692468,2023-05-22,208,sprite,75,100,25,2,00150,India
692468,2023-05-22,210,mountain dew,75,100,25,2,00150,India
563342,2023-05-22,205,classic yogurt,45,60,15,2,00288,India
563342,2023-05-22,212,amul cheese,250,315,65,1,00288,India
625393,2023-05-22,201,paneer,210,340,130,1,00120,India
755102,2023-05-22,213,bisleri,6,15,9,2,00357,India
511736,2023-05-22,202,milk,12,27,15,1,00277,India
511736,2023-05-22,207,coca cola,75,100,25,2,00277,India
288037,2023-05-22,205,classic yogurt,45,60,15,2,00386,India
288037,2023-05-22,213,bisleri,6,15,9,2,00386,India
288037,2023-05-22,210,mountain dew,75,100,25,2,00386,India
288037,2023-05-22,202,milk,12,27,15,1,00386,India
288037,2023-05-22,204,strawberry yogurt,50,60,10,2,00386,India
132651,2023-05-22,202,milk,12,27,15,1,00469,India
132651,2023-05-22,213,bisleri,6,15,9,2,00469,India
132651,2023-05-22,204,strawberry yogurt,50,60,10,2,00469,India
928965,2023-05-22,211,red bull,90,125,35,2,00169,India
928965,2023-05-22,212,amul cheese,250,315,65,1,00169,India
482618,2023-05-22,204,strawberry yogurt,50,60,10,2,00380,India
482618,2023-05-22,201,paneer,210,340,130,1,00380,India
482618,2023-05-22,208,sprite,75,100,25,2,00380,India
482618,2023-05-22,213,bisleri,6,15,9,2,00380,India
399533,2023-05-22,210,mountain dew,75,100,25,2,00492,India
399533,2023-05-22,212,amul cheese,250,315,65,1,00492,India
399533,2023-05-22,205,classic yogurt,45,60,15,2,00492,India
343332,2023-05-22,211,red bull,90,125,35,2,00108,India
160811,2023-05-22,211,red bull,90,125,35,2,00300,India
892990,2023-05-22,209,pepsi,75,100,25,2,00429,India
892990,2023-05-22,206,yakult,360,400,40,2,00429,India
373396,2023-05-22,207,coca cola,75,100,25,2,00071,India
373396,2023-05-22,204,strawberry yogurt,50,60,10,2,00071,India
373396,2023-05-22,205,classic yogurt,45,60,15,2,00071,India
373396,2023-05-22,210,mountain dew,75,100,25,2,00071,India
608754,2023-05-22,204,strawberry yogurt,50,60,10,2,00086,India
608754,2023-05-22,210,mountain dew,75,100,25,2,00086,India
608754,2023-05-22,213,bisleri,6,15,9,2,00086,India
608754,2023-05-22,205,classic yogurt,45,60,15,2,00086,India
959617,2023-05-22,211,red bull,90,125,35,2,00414,India
959617,2023-05-22,203,mango yogurt,50,60,10,2,00414,India
959617,2023-05-22,210,mountain dew,75,100,25,2,00414,India
959617,2023-05-22,208,sprite,75,100,25,2,00414,India
216315,2023-05-22,210,mountain dew,75,100,25,2,00007,India
216315,2023-05-22,213,bisleri,6,15,9,2,00007,India
216315,2023-05-22,204,strawberry yogurt,50,60,10,2,00007,India
680083,2023-05-22,207,coca cola,75,100,25,2,00386,India
680083,2023-05-22,213,bisleri,6,15,9,2,00386,India
680083,2023-05-22,204,strawberry yogurt,50,60,10,2,00386,India
979960,2023-05-22,206,yakult,360,400,40,2,00226,India
979960,2023-05-22,204,strawberry yogurt,50,60,10,2,00226,India
777743,2023-05-22,202,milk,12,27,15,1,00351,India
777743,2023-05-22,206,yakult,360,400,40,2,00351,India
777743,2023-05-22,210,mountain dew,75,100,25,2,00351,India
777743,2023-05-22,211,red bull,90,125,35,2,00351,India
623144,2023-05-22,209,pepsi,75,100,25,2,00204,India
623144,2023-05-22,212,amul cheese,250,315,65,1,00204,India
623144,2023-05-22,203,mango yogurt,50,60,10,2,00204,India
447547,2023-05-22,212,amul cheese,250,315,65,1,00254,India
447547,2023-05-22,208,sprite,75,100,25,2,00254,India
344029,2023-05-22,201,paneer,210,340,130,1,00041,India
644705,2023-05-22,205,classic yogurt,45,60,15,2,00152,India
644705,2023-05-22,209,pepsi,75,100,25,2,00152,India
644705,2023-05-22,207,coca cola,75,100,25,2,00152,India
308177,2023-05-22,203,mango yogurt,50,60,10,2,00446,India
308177,2023-05-22,206,yakult,360,400,40,2,00446,India
308177,2023-05-22,201,paneer,210,340,130,1,00446,India
487527,2023-05-22,205,classic yogurt,45,60,15,2,00297,India
487527,2023-05-22,213,bisleri,6,15,9,2,00297,India
487527,2023-05-22,209,pepsi,75,100,25,2,00297,India
705715,2023-05-22,211,red bull,90,125,35,2,00223,India
705715,2023-05-22,202,milk,12,27,15,1,00223,India
705715,2023-05-22,213,bisleri,6,15,9,2,00223,India
705715,2023-05-22,203,mango yogurt,50,60,10,2,00223,India
939908,2023-05-22,202,milk,12,27,15,1,00454,India
939908,2023-05-22,212,amul cheese,250,315,65,1,00454,India
939908,2023-05-22,211,red bull,90,125,35,2,00454,India
366571,2023-05-22,209,pepsi,75,100,25,2,00470,India
375984,2023-05-22,202,milk,12,27,15,1,00189,India
375984,2023-05-22,212,amul cheese,250,315,65,1,00189,India
250266,2023-05-22,211,red bull,90,125,35,2,00007,India
250266,2023-05-22,202,milk,12,27,15,1,00007,India
250266,2023-05-22,205,classic yogurt,45,60,15,2,00007,India
250266,2023-05-22,208,sprite,75,100,25,2,00007,India
250266,2023-05-22,213,bisleri,6,15,9,2,00007,India
191054,2023-05-22,202,milk,12,27,15,1,00454,India
937027,2023-05-22,213,bisleri,6,15,9,2,00241,India
937027,2023-05-22,202,milk,12,27,15,1,00241,India
937027,2023-05-22,206,yakult,360,400,40,2,00241,India
869235,2023-05-22,202,milk,12,27,15,1,00369,India
869235,2023-05-22,213,bisleri,6,15,9,2,00369,India
869235,2023-05-22,210,mountain dew,75,100,25,2,00369,India
869235,2023-05-22,205,classic yogurt,45,60,15,2,00369,India
869235,2023-05-22,207,coca cola,75,100,25,2,00369,India
144268,2023-05-22,204,strawberry yogurt,50,60,10,2,00286,India
144268,2023-05-22,212,amul cheese,250,315,65,1,00286,India
144268,2023-05-22,207,coca cola,75,100,25,2,00286,India
907564,2023-05-22,204,strawberry yogurt,50,60,10,2,00209,India
907564,2023-05-22,213,bisleri,6,15,9,2,00209,India
907564,2023-05-22,207,coca cola,75,100,25,2,00209,India
907564,2023-05-22,206,yakult,360,400,40,2,00209,India
301197,2023-05-22,212,amul cheese,250,315,65,1,00321,India
301197,2023-05-22,211,red bull,90,125,35,2,00321,India
301197,2023-05-22,205,classic yogurt,45,60,15,2,00321,India
301197,2023-05-22,202,milk,12,27,15,1,00321,India
441815,2023-05-22,213,bisleri,6,15,9,2,00150,India
441815,2023-05-22,212,amul cheese,250,315,65,1,00150,India
441815,2023-05-22,208,sprite,75,100,25,2,00150,India
441815,2023-05-22,207,coca cola,75,100,25,2,00150,India
441815,2023-05-22,201,paneer,210,340,130,1,00150,India
593928,2023-05-22,208,sprite,75,100,25,2,00038,India
102220,2023-05-22,208,sprite,75,100,25,2,00131,India
102220,2023-05-22,210,mountain dew,75,100,25,2,00131,India
102220,2023-05-22,207,coca cola,75,100,25,2,00131,India
102220,2023-05-22,206,yakult,360,400,40,2,00131,India
102220,2023-05-22,202,milk,12,27,15,1,00131,India
855957,2023-05-22,202,milk,12,27,15,1,00129,India
855957,2023-05-22,213,bisleri,6,15,9,2,00129,India
154573,2023-05-22,213,bisleri,6,15,9,2,00145,India
154573,2023-05-22,205,classic yogurt,45,60,15,2,00145,India
218507,2023-05-22,202,milk,12,27,15,1,00337,India
218507,2023-05-22,210,mountain dew,75,100,25,2,00337,India
218507,2023-05-22,211,red bull,90,125,35,2,00337,India
650015,2023-05-22,207,coca cola,75,100,25,2,00101,India
650015,2023-05-22,212,amul cheese,250,315,65,1,00101,India
606160,2023-05-22,205,classic yogurt,45,60,15,2,00029,India
606160,2023-05-22,203,mango yogurt,50,60,10,2,00029,India
860572,2023-05-22,209,pepsi,75,100,25,2,00058,India
860572,2023-05-22,205,classic yogurt,45,60,15,2,00058,India
860572,2023-05-22,208,sprite,75,100,25,2,00058,India
860572,2023-05-22,211,red bull,90,125,35,2,00058,India
830037,2023-05-22,209,pepsi,75,100,25,2,00386,India
830037,2023-05-22,202,milk,12,27,15,1,00386,India
830037,2023-05-22,203,mango yogurt,50,60,10,2,00386,India
830037,2023-05-22,207,coca cola,75,100,25,2,00386,India
500434,2023-05-22,205,classic yogurt,45,60,15,2,00165,India
809862,2023-05-22,207,coca cola,75,100,25,2,00163,India
809862,2023-05-22,212,amul cheese,250,315,65,1,00163,India
189388,2023-05-22,210,mountain dew,75,100,25,2,00157,India
189388,2023-05-22,205,classic yogurt,45,60,15,2,00157,India
189388,2023-05-22,206,yakult,360,400,40,2,00157,India
873975,2023-05-22,203,mango yogurt,50,60,10,2,00388,India
873975,2023-05-22,206,yakult,360,400,40,2,00388,India
873975,2023-05-22,201,paneer,210,340,130,1,00388,India
873975,2023-05-22,204,strawberry yogurt,50,60,10,2,00388,India
873975,2023-05-22,202,milk,12,27,15,1,00388,India
874618,2023-05-22,212,amul cheese,250,315,65,1,00494,India
874618,2023-05-22,202,milk,12,27,15,1,00494,India
874618,2023-05-22,213,bisleri,6,15,9,2,00494,India
874618,2023-05-22,207,coca cola,75,100,25,2,00494,India
651921,2023-05-22,201,paneer,210,340,130,1,00213,India
651921,2023-05-22,208,sprite,75,100,25,2,00213,India
658366,2023-05-22,207,coca cola,75,100,25,2,00418,India
576481,2023-05-22,212,amul cheese,250,315,65,1,00043,India
576481,2023-05-22,205,classic yogurt,45,60,15,2,00043,India
576481,2023-05-22,211,red bull,90,125,35,2,00043,India
576481,2023-05-22,206,yakult,360,400,40,2,00043,India
576481,2023-05-22,202,milk,12,27,15,1,00043,India
772564,2023-05-22,205,classic yogurt,45,60,15,2,00145,India
772564,2023-05-22,210,mountain dew,75,100,25,2,00145,India
164785,2023-05-22,203,mango yogurt,50,60,10,2,00224,India
164785,2023-05-22,211,red bull,90,125,35,2,00224,India
472778,2023-05-22,204,strawberry yogurt,50,60,10,2,00148,India
472778,2023-05-22,208,sprite,75,100,25,2,00148,India
472778,2023-05-22,207,coca cola,75,100,25,2,00148,India
472778,2023-05-22,205,classic yogurt,45,60,15,2,00148,India
177062,2023-05-22,205,classic yogurt,45,60,15,2,00075,India
177062,2023-05-22,212,amul cheese,250,315,65,1,00075,India
177062,2023-05-22,209,pepsi,75,100,25,2,00075,India
297765,2023-05-22,206,yakult,360,400,40,2,00364,India
437850,2023-05-22,206,yakult,360,400,40,2,00044,India
437850,2023-05-22,207,coca cola,75,100,25,2,00044,India
437850,2023-05-22,208,sprite,75,100,25,2,00044,India
437850,2023-05-22,205,classic yogurt,45,60,15,2,00044,India
437850,2023-05-22,213,bisleri,6,15,9,2,00044,India
695356,2023-05-22,211,red bull,90,125,35,2,00305,India
695356,2023-05-22,208,sprite,75,100,25,2,00305,India
695356,2023-05-22,202,milk,12,27,15,1,00305,India
407976,2023-05-22,202,milk,12,27,15,1,00020,India
206111,2023-05-22,207,coca cola,75,100,25,2,00011,India
206111,2023-05-22,209,pepsi,75,100,25,2,00011,India
836403,2023-05-23,208,sprite,75,100,25,2,00260,India
836403,2023-05-23,206,yakult,360,400,40,2,00260,India
836403,2023-05-23,209,pepsi,75,100,25,2,00260,India
353330,2023-05-23,202,milk,12,27,15,1,00151,India
636792,2023-05-23,204,strawberry yogurt,50,60,10,2,00136,India
636792,2023-05-23,213,bisleri,6,15,9,2,00136,India
236991,2023-05-23,209,pepsi,75,100,25,2,00420,India
366892,2023-05-23,204,strawberry yogurt,50,60,10,2,00131,India
894125,2023-05-23,204,strawberry yogurt,50,60,10,2,00106,India
894125,2023-05-23,208,sprite,75,100,25,2,00106,India
596566,2023-05-23,206,yakult,360,400,40,2,00124,India
627415,2023-05-23,210,mountain dew,75,100,25,2,00117,India
627415,2023-05-23,213,bisleri,6,15,9,2,00117,India
987963,2023-05-23,203,mango yogurt,50,60,10,2,00017,India
987963,2023-05-23,204,strawberry yogurt,50,60,10,2,00017,India
987963,2023-05-23,202,milk,12,27,15,1,00017,India
987963,2023-05-23,213,bisleri,6,15,9,2,00017,India
596426,2023-05-23,209,pepsi,75,100,25,2,00043,India
361606,2023-05-23,210,mountain dew,75,100,25,2,00401,India
168271,2023-05-23,204,strawberry yogurt,50,60,10,2,00173,India
168271,2023-05-23,211,red bull,90,125,35,2,00173,India
183366,2023-05-23,210,mountain dew,75,100,25,2,00485,India
183366,2023-05-23,201,paneer,210,340,130,1,00485,India
183366,2023-05-23,211,red bull,90,125,35,2,00485,India
518009,2023-05-23,206,yakult,360,400,40,2,00200,India
518009,2023-05-23,202,milk,12,27,15,1,00200,India
488894,2023-05-23,211,red bull,90,125,35,2,00375,India
488894,2023-05-23,202,milk,12,27,15,1,00375,India
543590,2023-05-23,203,mango yogurt,50,60,10,2,00140,India
543590,2023-05-23,210,mountain dew,75,100,25,2,00140,India
543590,2023-05-23,209,pepsi,75,100,25,2,00140,India
543590,2023-05-23,202,milk,12,27,15,1,00140,India
598088,2023-05-23,212,amul cheese,250,315,65,1,00247,India
979264,2023-05-23,205,classic yogurt,45,60,15,2,00107,India
979264,2023-05-23,203,mango yogurt,50,60,10,2,00107,India
979264,2023-05-23,201,paneer,210,340,130,1,00107,India
781525,2023-05-23,208,sprite,75,100,25,2,00359,India
781525,2023-05-23,206,yakult,360,400,40,2,00359,India
781525,2023-05-23,203,mango yogurt,50,60,10,2,00359,India
781525,2023-05-23,207,coca cola,75,100,25,2,00359,India
790853,2023-05-23,203,mango yogurt,50,60,10,2,00372,India
790853,2023-05-23,201,paneer,210,340,130,1,00372,India
920519,2023-05-23,203,mango yogurt,50,60,10,2,00023,India
920519,2023-05-23,212,amul cheese,250,315,65,1,00023,India
920519,2023-05-23,201,paneer,210,340,130,1,00023,India
707804,2023-05-23,201,paneer,210,340,130,1,00414,India
707804,2023-05-23,202,milk,12,27,15,1,00414,India
707804,2023-05-23,203,mango yogurt,50,60,10,2,00414,India
237624,2023-05-23,205,classic yogurt,45,60,15,2,00281,India
146480,2023-05-23,203,mango yogurt,50,60,10,2,00116,India
146480,2023-05-23,209,pepsi,75,100,25,2,00116,India
815294,2023-05-23,213,bisleri,6,15,9,2,00476,India
815294,2023-05-23,207,coca cola,75,100,25,2,00476,India
815294,2023-05-23,204,strawberry yogurt,50,60,10,2,00476,India
709387,2023-05-23,212,amul cheese,250,315,65,1,00362,India
709387,2023-05-23,213,bisleri,6,15,9,2,00362,India
709387,2023-05-23,202,milk,12,27,15,1,00362,India
709387,2023-05-23,207,coca cola,75,100,25,2,00362,India
560726,2023-05-23,213,bisleri,6,15,9,2,00300,India
560726,2023-05-23,207,coca cola,75,100,25,2,00300,India
560726,2023-05-23,204,strawberry yogurt,50,60,10,2,00300,India
560726,2023-05-23,211,red bull,90,125,35,2,00300,India
311273,2023-05-23,201,paneer,210,340,130,1,00103,India
311273,2023-05-23,202,milk,12,27,15,1,00103,India
311273,2023-05-23,209,pepsi,75,100,25,2,00103,India
311273,2023-05-23,212,amul cheese,250,315,65,1,00103,India
198721,2023-05-23,210,mountain dew,75,100,25,2,00438,India
198721,2023-05-23,203,mango yogurt,50,60,10,2,00438,India
562125,2023-05-23,213,bisleri,6,15,9,2,00267,India
562125,2023-05-23,208,sprite,75,100,25,2,00267,India
238415,2023-05-23,203,mango yogurt,50,60,10,2,00460,India
238415,2023-05-23,211,red bull,90,125,35,2,00460,India
238415,2023-05-23,204,strawberry yogurt,50,60,10,2,00460,India
238415,2023-05-23,210,mountain dew,75,100,25,2,00460,India
711958,2023-05-23,206,yakult,360,400,40,2,00421,India
711958,2023-05-23,209,pepsi,75,100,25,2,00421,India
711958,2023-05-23,207,coca cola,75,100,25,2,00421,India
800323,2023-05-23,212,amul cheese,250,315,65,1,00166,India
800323,2023-05-23,206,yakult,360,400,40,2,00166,India
979529,2023-05-23,202,milk,12,27,15,1,00420,India
979529,2023-05-23,201,paneer,210,340,130,1,00420,India
979529,2023-05-23,209,pepsi,75,100,25,2,00420,India
979529,2023-05-23,207,coca cola,75,100,25,2,00420,India
986994,2023-05-23,209,pepsi,75,100,25,2,00008,India
986994,2023-05-23,205,classic yogurt,45,60,15,2,00008,India
986994,2023-05-23,207,coca cola,75,100,25,2,00008,India
986994,2023-05-23,210,mountain dew,75,100,25,2,00008,India
125186,2023-05-23,204,strawberry yogurt,50,60,10,2,00081,India
125186,2023-05-23,205,classic yogurt,45,60,15,2,00081,India
125186,2023-05-23,213,bisleri,6,15,9,2,00081,India
125186,2023-05-23,202,milk,12,27,15,1,00081,India
534496,2023-05-23,207,coca cola,75,100,25,2,00191,India
534496,2023-05-23,208,sprite,75,100,25,2,00191,India
534496,2023-05-23,212,amul cheese,250,315,65,1,00191,India
186982,2023-05-23,211,red bull,90,125,35,2,00338,India
186982,2023-05-23,207,coca cola,75,100,25,2,00338,India
186982,2023-05-23,204,strawberry yogurt,50,60,10,2,00338,India
409155,2023-05-23,201,paneer,210,340,130,1,00369,India
822079,2023-05-23,205,classic yogurt,45,60,15,2,00193,India
822079,2023-05-23,208,sprite,75,100,25,2,00193,India
822079,2023-05-23,204,strawberry yogurt,50,60,10,2,00193,India
350363,2023-05-23,208,sprite,75,100,25,2,00315,India
350363,2023-05-23,202,milk,12,27,15,1,00315,India
350363,2023-05-23,213,bisleri,6,15,9,2,00315,India
350363,2023-05-23,206,yakult,360,400,40,2,00315,India
322129,2023-05-23,202,milk,12,27,15,1,00164,India
322129,2023-05-23,213,bisleri,6,15,9,2,00164,India
322129,2023-05-23,208,sprite,75,100,25,2,00164,India
322129,2023-05-23,207,coca cola,75,100,25,2,00164,India
356808,2023-05-23,208,sprite,75,100,25,2,00331,India
825567,2023-05-23,201,paneer,210,340,130,1,00080,India
619129,2023-05-23,201,paneer,210,340,130,1,00186,India
619129,2023-05-23,211,red bull,90,125,35,2,00186,India
619129,2023-05-23,210,mountain dew,75,100,25,2,00186,India
619129,2023-05-23,202,milk,12,27,15,1,00186,India
893220,2023-05-23,211,red bull,90,125,35,2,00026,India
893220,2023-05-23,203,mango yogurt,50,60,10,2,00026,India
185112,2023-05-23,202,milk,12,27,15,1,00351,India
185112,2023-05-23,206,yakult,360,400,40,2,00351,India
185112,2023-05-23,211,red bull,90,125,35,2,00351,India
962166,2023-05-23,207,coca cola,75,100,25,2,00277,India
962166,2023-05-23,205,classic yogurt,45,60,15,2,00277,India
962166,2023-05-23,202,milk,12,27,15,1,00277,India
379736,2023-05-23,202,milk,12,27,15,1,00177,India
379736,2023-05-23,209,pepsi,75,100,25,2,00177,India
999166,2023-05-23,201,paneer,210,340,130,1,00004,India
999166,2023-05-23,202,milk,12,27,15,1,00004,India
717091,2023-05-23,206,yakult,360,400,40,2,00009,India
539834,2023-05-23,209,pepsi,75,100,25,2,00043,India
539834,2023-05-23,210,mountain dew,75,100,25,2,00043,India
713707,2023-05-24,213,bisleri,6,15,9,2,00412,India
713707,2023-05-24,208,sprite,75,100,25,2,00412,India
713707,2023-05-24,209,pepsi,75,100,25,2,00412,India
713707,2023-05-24,207,coca cola,75,100,25,2,00412,India
327902,2023-05-24,208,sprite,75,100,25,2,00104,India
327902,2023-05-24,207,coca cola,75,100,25,2,00104,India
327902,2023-05-24,203,mango yogurt,50,60,10,2,00104,India
769542,2023-05-24,201,paneer,210,340,130,1,00162,India
769542,2023-05-24,204,strawberry yogurt,50,60,10,2,00162,India
552133,2023-05-24,201,paneer,210,340,130,1,00340,India
552133,2023-05-24,207,coca cola,75,100,25,2,00340,India
451546,2023-05-24,212,amul cheese,250,315,65,1,00011,India
451546,2023-05-24,206,yakult,360,400,40,2,00011,India
451546,2023-05-24,208,sprite,75,100,25,2,00011,India
165381,2023-05-24,210,mountain dew,75,100,25,2,00219,India
165381,2023-05-24,208,sprite,75,100,25,2,00219,India
165381,2023-05-24,209,pepsi,75,100,25,2,00219,India
165381,2023-05-24,203,mango yogurt,50,60,10,2,00219,India
357459,2023-05-24,204,strawberry yogurt,50,60,10,2,00185,India
432296,2023-05-24,211,red bull,90,125,35,2,00193,India
432296,2023-05-24,202,milk,12,27,15,1,00193,India
432296,2023-05-24,212,amul cheese,250,315,65,1,00193,India
773328,2023-05-24,204,strawberry yogurt,50,60,10,2,00045,India
697299,2023-05-24,206,yakult,360,400,40,2,00438,India
697299,2023-05-24,213,bisleri,6,15,9,2,00438,India
697299,2023-05-24,202,milk,12,27,15,1,00438,India
290419,2023-05-24,205,classic yogurt,45,60,15,2,00443,India
290419,2023-05-24,207,coca cola,75,100,25,2,00443,India
290419,2023-05-24,203,mango yogurt,50,60,10,2,00443,India
290419,2023-05-24,201,paneer,210,340,130,1,00443,India
961597,2023-05-24,201,paneer,210,340,130,1,00420,India
961597,2023-05-24,213,bisleri,6,15,9,2,00420,India
961597,2023-05-24,212,amul cheese,250,315,65,1,00420,India
961597,2023-05-24,206,yakult,360,400,40,2,00420,India
961597,2023-05-24,211,red bull,90,125,35,2,00420,India
689929,2023-05-24,207,coca cola,75,100,25,2,00246,India
342125,2023-05-24,201,paneer,210,340,130,1,00466,India
342125,2023-05-24,210,mountain dew,75,100,25,2,00466,India
342125,2023-05-24,206,yakult,360,400,40,2,00466,India
342125,2023-05-24,211,red bull,90,125,35,2,00466,India
278583,2023-05-24,212,amul cheese,250,315,65,1,00133,India
366054,2023-05-24,203,mango yogurt,50,60,10,2,00484,India
366054,2023-05-24,205,classic yogurt,45,60,15,2,00484,India
692780,2023-05-24,207,coca cola,75,100,25,2,00380,India
692780,2023-05-24,210,mountain dew,75,100,25,2,00380,India
692780,2023-05-24,208,sprite,75,100,25,2,00380,India
964421,2023-05-24,207,coca cola,75,100,25,2,00428,India
964421,2023-05-24,210,mountain dew,75,100,25,2,00428,India
277182,2023-05-24,210,mountain dew,75,100,25,2,00423,India
277182,2023-05-24,211,red bull,90,125,35,2,00423,India
277182,2023-05-24,208,sprite,75,100,25,2,00423,India
277182,2023-05-24,201,paneer,210,340,130,1,00423,India
113280,2023-05-24,202,milk,12,27,15,1,00022,India
113280,2023-05-24,205,classic yogurt,45,60,15,2,00022,India
113280,2023-05-24,213,bisleri,6,15,9,2,00022,India
774735,2023-05-24,202,milk,12,27,15,1,00382,India
774735,2023-05-24,209,pepsi,75,100,25,2,00382,India
774735,2023-05-24,212,amul cheese,250,315,65,1,00382,India
469578,2023-05-24,201,paneer,210,340,130,1,00178,India
469578,2023-05-24,209,pepsi,75,100,25,2,00178,India
665691,2023-05-24,204,strawberry yogurt,50,60,10,2,00144,India
665691,2023-05-24,207,coca cola,75,100,25,2,00144,India
665691,2023-05-24,211,red bull,90,125,35,2,00144,India
959965,2023-05-24,203,mango yogurt,50,60,10,2,00459,India
836177,2023-05-24,210,mountain dew,75,100,25,2,00018,India
534483,2023-05-24,212,amul cheese,250,315,65,1,00306,India
534483,2023-05-24,208,sprite,75,100,25,2,00306,India
534483,2023-05-24,211,red bull,90,125,35,2,00306,India
822843,2023-05-24,206,yakult,360,400,40,2,00268,India
822843,2023-05-24,210,mountain dew,75,100,25,2,00268,India
822843,2023-05-24,213,bisleri,6,15,9,2,00268,India
822843,2023-05-24,201,paneer,210,340,130,1,00268,India
822843,2023-05-24,205,classic yogurt,45,60,15,2,00268,India
314626,2023-05-24,212,amul cheese,250,315,65,1,00173,India
333094,2023-05-24,207,coca cola,75,100,25,2,00034,India
333094,2023-05-24,204,strawberry yogurt,50,60,10,2,00034,India
329443,2023-05-24,211,red bull,90,125,35,2,00073,India
329443,2023-05-24,205,classic yogurt,45,60,15,2,00073,India
329443,2023-05-24,208,sprite,75,100,25,2,00073,India
683226,2023-05-24,213,bisleri,6,15,9,2,00009,India
138993,2023-05-24,204,strawberry yogurt,50,60,10,2,00122,India
138993,2023-05-24,201,paneer,210,340,130,1,00122,India
138993,2023-05-24,207,coca cola,75,100,25,2,00122,India
964517,2023-05-24,212,amul cheese,250,315,65,1,00490,India
964517,2023-05-24,205,classic yogurt,45,60,15,2,00490,India
964517,2023-05-24,207,coca cola,75,100,25,2,00490,India
964517,2023-05-24,211,red bull,90,125,35,2,00490,India
401139,2023-05-24,204,strawberry yogurt,50,60,10,2,00218,India
401139,2023-05-24,209,pepsi,75,100,25,2,00218,India
401139,2023-05-24,202,milk,12,27,15,1,00218,India
983056,2023-05-24,213,bisleri,6,15,9,2,00138,India
983056,2023-05-24,211,red bull,90,125,35,2,00138,India
983056,2023-05-24,210,mountain dew,75,100,25,2,00138,India
983056,2023-05-24,201,paneer,210,340,130,1,00138,India
903763,2023-05-24,204,strawberry yogurt,50,60,10,2,00056,India
638656,2023-05-24,211,red bull,90,125,35,2,00104,India
864452,2023-05-24,205,classic yogurt,45,60,15,2,00060,India
864452,2023-05-24,211,red bull,90,125,35,2,00060,India
864452,2023-05-24,210,mountain dew,75,100,25,2,00060,India
864452,2023-05-24,203,mango yogurt,50,60,10,2,00060,India
637708,2023-05-24,204,strawberry yogurt,50,60,10,2,00019,India
637708,2023-05-24,210,mountain dew,75,100,25,2,00019,India
290866,2023-05-24,207,coca cola,75,100,25,2,00494,India
290866,2023-05-24,204,strawberry yogurt,50,60,10,2,00494,India
290866,2023-05-24,205,classic yogurt,45,60,15,2,00494,India
290866,2023-05-24,208,sprite,75,100,25,2,00494,India
777610,2023-05-24,211,red bull,90,125,35,2,00355,India
777610,2023-05-24,205,classic yogurt,45,60,15,2,00355,India
777610,2023-05-24,203,mango yogurt,50,60,10,2,00355,India
777610,2023-05-24,209,pepsi,75,100,25,2,00355,India
657586,2023-05-24,205,classic yogurt,45,60,15,2,00072,India
657586,2023-05-24,211,red bull,90,125,35,2,00072,India
657586,2023-05-24,208,sprite,75,100,25,2,00072,India
657586,2023-05-24,207,coca cola,75,100,25,2,00072,India
742621,2023-05-24,206,yakult,360,400,40,2,00435,India
742621,2023-05-24,202,milk,12,27,15,1,00435,India
505650,2023-05-24,204,strawberry yogurt,50,60,10,2,00369,India
505650,2023-05-24,211,red bull,90,125,35,2,00369,India
907540,2023-05-24,213,bisleri,6,15,9,2,00038,India
907540,2023-05-24,211,red bull,90,125,35,2,00038,India
907540,2023-05-24,205,classic yogurt,45,60,15,2,00038,India
644955,2023-05-24,202,milk,12,27,15,1,00465,India
639112,2023-05-24,211,red bull,90,125,35,2,00279,India
812667,2023-05-24,203,mango yogurt,50,60,10,2,00008,India
812667,2023-05-24,209,pepsi,75,100,25,2,00008,India
812667,2023-05-24,201,paneer,210,340,130,1,00008,India
812667,2023-05-24,204,strawberry yogurt,50,60,10,2,00008,India
824550,2023-05-24,203,mango yogurt,50,60,10,2,00156,India
528379,2023-05-24,213,bisleri,6,15,9,2,00165,India
528379,2023-05-24,201,paneer,210,340,130,1,00165,India
528379,2023-05-24,205,classic yogurt,45,60,15,2,00165,India
528379,2023-05-24,211,red bull,90,125,35,2,00165,India
969522,2023-05-24,207,coca cola,75,100,25,2,00166,India
800048,2023-05-24,203,mango yogurt,50,60,10,2,00016,India
800048,2023-05-24,206,yakult,360,400,40,2,00016,India
800048,2023-05-24,207,coca cola,75,100,25,2,00016,India
800048,2023-05-24,213,bisleri,6,15,9,2,00016,India
581441,2023-05-24,212,amul cheese,250,315,65,1,00009,India
588901,2023-05-24,213,bisleri,6,15,9,2,00288,India
588901,2023-05-24,212,amul cheese,250,315,65,1,00288,India
536171,2023-05-24,204,strawberry yogurt,50,60,10,2,00184,India
536171,2023-05-24,209,pepsi,75,100,25,2,00184,India
738047,2023-05-24,206,yakult,360,400,40,2,00413,India
738047,2023-05-24,210,mountain dew,75,100,25,2,00413,India
876223,2023-05-24,213,bisleri,6,15,9,2,00227,India
876223,2023-05-24,209,pepsi,75,100,25,2,00227,India
876223,2023-05-24,207,coca cola,75,100,25,2,00227,India
876223,2023-05-24,206,yakult,360,400,40,2,00227,India
966920,2023-05-24,212,amul cheese,250,315,65,1,00230,India
767953,2023-05-24,206,yakult,360,400,40,2,00077,India
767953,2023-05-24,202,milk,12,27,15,1,00077,India
834892,2023-05-24,202,milk,12,27,15,1,00393,India
834892,2023-05-24,210,mountain dew,75,100,25,2,00393,India
834892,2023-05-24,206,yakult,360,400,40,2,00393,India
834892,2023-05-24,205,classic yogurt,45,60,15,2,00393,India
416255,2023-05-24,201,paneer,210,340,130,1,00210,India
681103,2023-05-24,203,mango yogurt,50,60,10,2,00437,India
681103,2023-05-24,208,sprite,75,100,25,2,00437,India
681103,2023-05-24,213,bisleri,6,15,9,2,00437,India
681103,2023-05-24,207,coca cola,75,100,25,2,00437,India
864402,2023-05-24,203,mango yogurt,50,60,10,2,00339,India
897040,2023-05-24,205,classic yogurt,45,60,15,2,00402,India
855419,2023-05-24,210,mountain dew,75,100,25,2,00343,India
355114,2023-05-24,211,red bull,90,125,35,2,00455,India
355114,2023-05-24,202,milk,12,27,15,1,00455,India
355114,2023-05-24,206,yakult,360,400,40,2,00455,India
555782,2023-05-24,212,amul cheese,250,315,65,1,00075,India
654727,2023-05-24,211,red bull,90,125,35,2,00352,India
654727,2023-05-24,206,yakult,360,400,40,2,00352,India
654727,2023-05-24,208,sprite,75,100,25,2,00352,India
654727,2023-05-24,201,paneer,210,340,130,1,00352,India
934143,2023-05-24,206,yakult,360,400,40,2,00045,India
934143,2023-05-24,213,bisleri,6,15,9,2,00045,India
934143,2023-05-24,212,amul cheese,250,315,65,1,00045,India
105546,2023-05-24,202,milk,12,27,15,1,00408,India
105546,2023-05-24,204,strawberry yogurt,50,60,10,2,00408,India
105546,2023-05-24,212,amul cheese,250,315,65,1,00408,India
105546,2023-05-24,211,red bull,90,125,35,2,00408,India
789920,2023-05-24,208,sprite,75,100,25,2,00056,India
231735,2023-05-24,212,amul cheese,250,315,65,1,00009,India
414592,2023-05-24,212,amul cheese,250,315,65,1,00078,India
414592,2023-05-24,204,strawberry yogurt,50,60,10,2,00078,India
253284,2023-05-24,205,classic yogurt,45,60,15,2,00405,India
253284,2023-05-24,204,strawberry yogurt,50,60,10,2,00405,India
253284,2023-05-24,208,sprite,75,100,25,2,00405,India
253284,2023-05-24,212,amul cheese,250,315,65,1,00405,India
274445,2023-05-24,212,amul cheese,250,315,65,1,00289,India
277912,2023-05-24,206,yakult,360,400,40,2,00090,India
277912,2023-05-24,210,mountain dew,75,100,25,2,00090,India
277912,2023-05-24,207,coca cola,75,100,25,2,00090,India
277912,2023-05-24,202,milk,12,27,15,1,00090,India
645018,2023-05-24,213,bisleri,6,15,9,2,00385,India
220044,2023-05-24,206,yakult,360,400,40,2,00059,India
220044,2023-05-24,212,amul cheese,250,315,65,1,00059,India
681065,2023-05-24,209,pepsi,75,100,25,2,00318,India
681065,2023-05-24,211,red bull,90,125,35,2,00318,India
876445,2023-05-24,208,sprite,75,100,25,2,00173,India
357995,2023-05-24,206,yakult,360,400,40,2,00102,India
641244,2023-05-24,211,red bull,90,125,35,2,00007,India
134644,2023-05-24,207,coca cola,75,100,25,2,00165,India
134644,2023-05-24,204,strawberry yogurt,50,60,10,2,00165,India
134644,2023-05-24,201,paneer,210,340,130,1,00165,India
134644,2023-05-24,213,bisleri,6,15,9,2,00165,India
785404,2023-05-24,207,coca cola,75,100,25,2,00376,India
785404,2023-05-24,211,red bull,90,125,35,2,00376,India
594127,2023-05-24,204,strawberry yogurt,50,60,10,2,00114,India
594127,2023-05-24,213,bisleri,6,15,9,2,00114,India
594127,2023-05-24,207,coca cola,75,100,25,2,00114,India
594127,2023-05-24,202,milk,12,27,15,1,00114,India
518535,2023-05-24,209,pepsi,75,100,25,2,00290,India
518535,2023-05-24,203,mango yogurt,50,60,10,2,00290,India
518535,2023-05-24,202,milk,12,27,15,1,00290,India
518535,2023-05-24,212,amul cheese,250,315,65,1,00290,India
874947,2023-05-25,212,amul cheese,250,315,65,1,00157,India
615663,2023-05-25,204,strawberry yogurt,50,60,10,2,00217,India
615663,2023-05-25,213,bisleri,6,15,9,2,00217,India
615663,2023-05-25,205,classic yogurt,45,60,15,2,00217,India
369995,2023-05-25,203,mango yogurt,50,60,10,2,00169,India
369995,2023-05-25,204,strawberry yogurt,50,60,10,2,00169,India
369995,2023-05-25,205,classic yogurt,45,60,15,2,00169,India
245328,2023-05-25,201,paneer,210,340,130,1,00373,India
245328,2023-05-25,209,pepsi,75,100,25,2,00373,India
445661,2023-05-25,201,paneer,210,340,130,1,00280,India
445661,2023-05-25,209,pepsi,75,100,25,2,00280,India
569354,2023-05-25,208,sprite,75,100,25,2,00441,India
569354,2023-05-25,212,amul cheese,250,315,65,1,00441,India
569354,2023-05-25,209,pepsi,75,100,25,2,00441,India
654306,2023-05-25,209,pepsi,75,100,25,2,00361,India
654306,2023-05-25,212,amul cheese,250,315,65,1,00361,India
654306,2023-05-25,204,strawberry yogurt,50,60,10,2,00361,India
654306,2023-05-25,208,sprite,75,100,25,2,00361,India
591763,2023-05-25,206,yakult,360,400,40,2,00482,India
591763,2023-05-25,208,sprite,75,100,25,2,00482,India
720329,2023-05-25,201,paneer,210,340,130,1,00336,India
720329,2023-05-25,203,mango yogurt,50,60,10,2,00336,India
720329,2023-05-25,208,sprite,75,100,25,2,00336,India
720329,2023-05-25,210,mountain dew,75,100,25,2,00336,India
689197,2023-05-25,211,red bull,90,125,35,2,00422,India
689197,2023-05-25,202,milk,12,27,15,1,00422,India
689197,2023-05-25,205,classic yogurt,45,60,15,2,00422,India
689197,2023-05-25,208,sprite,75,100,25,2,00422,India
689197,2023-05-25,210,mountain dew,75,100,25,2,00422,India
926537,2023-05-25,205,classic yogurt,45,60,15,2,00389,India
924980,2023-05-25,212,amul cheese,250,315,65,1,00273,India
924980,2023-05-25,209,pepsi,75,100,25,2,00273,India
924980,2023-05-25,204,strawberry yogurt,50,60,10,2,00273,India
243457,2023-05-25,210,mountain dew,75,100,25,2,00102,India
243457,2023-05-25,208,sprite,75,100,25,2,00102,India
401265,2023-05-25,205,classic yogurt,45,60,15,2,00428,India
401265,2023-05-25,211,red bull,90,125,35,2,00428,India
102342,2023-05-25,203,mango yogurt,50,60,10,2,00117,India
102342,2023-05-25,213,bisleri,6,15,9,2,00117,India
102342,2023-05-25,202,milk,12,27,15,1,00117,India
930837,2023-05-25,208,sprite,75,100,25,2,00482,India
930837,2023-05-25,206,yakult,360,400,40,2,00482,India
930837,2023-05-25,201,paneer,210,340,130,1,00482,India
930837,2023-05-25,207,coca cola,75,100,25,2,00482,India
760348,2023-05-25,202,milk,12,27,15,1,00331,India
204721,2023-05-25,212,amul cheese,250,315,65,1,00423,India
871954,2023-05-25,208,sprite,75,100,25,2,00044,India
462064,2023-05-25,207,coca cola,75,100,25,2,00224,India
462064,2023-05-25,212,amul cheese,250,315,65,1,00224,India
998814,2023-05-25,202,milk,12,27,15,1,00103,India
998814,2023-05-25,207,coca cola,75,100,25,2,00103,India
228720,2023-05-25,212,amul cheese,250,315,65,1,00471,India
228720,2023-05-25,204,strawberry yogurt,50,60,10,2,00471,India
228720,2023-05-25,202,milk,12,27,15,1,00471,India
606451,2023-05-25,212,amul cheese,250,315,65,1,00369,India
606451,2023-05-25,202,milk,12,27,15,1,00369,India
606451,2023-05-25,210,mountain dew,75,100,25,2,00369,India
529804,2023-05-25,205,classic yogurt,45,60,15,2,00241,India
529804,2023-05-25,208,sprite,75,100,25,2,00241,India
105840,2023-05-25,210,mountain dew,75,100,25,2,00150,India
105840,2023-05-25,208,sprite,75,100,25,2,00150,India
105840,2023-05-25,207,coca cola,75,100,25,2,00150,India
105840,2023-05-25,201,paneer,210,340,130,1,00150,India
105840,2023-05-25,212,amul cheese,250,315,65,1,00150,India
583939,2023-05-25,205,classic yogurt,45,60,15,2,00496,India
583939,2023-05-25,212,amul cheese,250,315,65,1,00496,India
802046,2023-05-25,207,coca cola,75,100,25,2,00058,India
802046,2023-05-25,208,sprite,75,100,25,2,00058,India
802046,2023-05-25,212,amul cheese,250,315,65,1,00058,India
446586,2023-05-25,208,sprite,75,100,25,2,00344,India
465159,2023-05-25,206,yakult,360,400,40,2,00052,India
465159,2023-05-25,212,amul cheese,250,315,65,1,00052,India
465159,2023-05-25,204,strawberry yogurt,50,60,10,2,00052,India
465159,2023-05-25,203,mango yogurt,50,60,10,2,00052,India
465159,2023-05-25,208,sprite,75,100,25,2,00052,India
412646,2023-05-25,205,classic yogurt,45,60,15,2,00486,India
258458,2023-05-25,207,coca cola,75,100,25,2,00395,India
258458,2023-05-25,206,yakult,360,400,40,2,00395,India
258458,2023-05-25,203,mango yogurt,50,60,10,2,00395,India
186338,2023-05-25,201,paneer,210,340,130,1,00500,India
634879,2023-05-25,208,sprite,75,100,25,2,00213,India
634879,2023-05-25,209,pepsi,75,100,25,2,00213,India
654058,2023-05-25,213,bisleri,6,15,9,2,00322,India
654058,2023-05-25,212,amul cheese,250,315,65,1,00322,India
654058,2023-05-25,210,mountain dew,75,100,25,2,00322,India
521118,2023-05-25,209,pepsi,75,100,25,2,00146,India
521118,2023-05-25,210,mountain dew,75,100,25,2,00146,India
521118,2023-05-25,208,sprite,75,100,25,2,00146,India
825747,2023-05-25,203,mango yogurt,50,60,10,2,00223,India
667988,2023-05-25,203,mango yogurt,50,60,10,2,00293,India
667988,2023-05-25,208,sprite,75,100,25,2,00293,India
593967,2023-05-25,205,classic yogurt,45,60,15,2,00364,India
312480,2023-05-25,207,coca cola,75,100,25,2,00170,India
606146,2023-05-25,209,pepsi,75,100,25,2,00295,India
606146,2023-05-25,208,sprite,75,100,25,2,00295,India
181909,2023-05-25,210,mountain dew,75,100,25,2,00029,India
181909,2023-05-25,211,red bull,90,125,35,2,00029,India
181909,2023-05-25,208,sprite,75,100,25,2,00029,India
181909,2023-05-25,207,coca cola,75,100,25,2,00029,India
333697,2023-05-25,205,classic yogurt,45,60,15,2,00277,India
333697,2023-05-25,206,yakult,360,400,40,2,00277,India
333697,2023-05-25,207,coca cola,75,100,25,2,00277,India
333697,2023-05-25,212,amul cheese,250,315,65,1,00277,India
459171,2023-05-25,201,paneer,210,340,130,1,00086,India
459171,2023-05-25,209,pepsi,75,100,25,2,00086,India
427525,2023-05-25,203,mango yogurt,50,60,10,2,00058,India
427525,2023-05-25,211,red bull,90,125,35,2,00058,India
427525,2023-05-25,201,paneer,210,340,130,1,00058,India
381431,2023-05-25,203,mango yogurt,50,60,10,2,00455,India
381431,2023-05-25,213,bisleri,6,15,9,2,00455,India
381431,2023-05-25,205,classic yogurt,45,60,15,2,00455,India
381431,2023-05-25,211,red bull,90,125,35,2,00455,India
149085,2023-05-25,201,paneer,210,340,130,1,00274,India
149085,2023-05-25,206,yakult,360,400,40,2,00274,India
149085,2023-05-25,207,coca cola,75,100,25,2,00274,India
328871,2023-05-25,201,paneer,210,340,130,1,00481,India
328871,2023-05-25,206,yakult,360,400,40,2,00481,India
328871,2023-05-25,212,amul cheese,250,315,65,1,00481,India
464803,2023-05-25,208,sprite,75,100,25,2,00264,India
464803,2023-05-25,210,mountain dew,75,100,25,2,00264,India
116269,2023-05-25,207,coca cola,75,100,25,2,00244,India
116269,2023-05-25,203,mango yogurt,50,60,10,2,00244,India
116269,2023-05-25,212,amul cheese,250,315,65,1,00244,India
116269,2023-05-25,204,strawberry yogurt,50,60,10,2,00244,India
510277,2023-05-25,211,red bull,90,125,35,2,00131,India
510277,2023-05-25,210,mountain dew,75,100,25,2,00131,India
510277,2023-05-25,204,strawberry yogurt,50,60,10,2,00131,India
364783,2023-05-25,201,paneer,210,340,130,1,00135,India
364783,2023-05-25,208,sprite,75,100,25,2,00135,India
364783,2023-05-25,202,milk,12,27,15,1,00135,India
650670,2023-05-25,203,mango yogurt,50,60,10,2,00184,India
629384,2023-05-26,209,pepsi,75,100,25,2,00325,India
629384,2023-05-26,211,red bull,90,125,35,2,00325,India
629384,2023-05-26,206,yakult,360,400,40,2,00325,India
629384,2023-05-26,205,classic yogurt,45,60,15,2,00325,India
816229,2023-05-26,213,bisleri,6,15,9,2,00335,India
816229,2023-05-26,203,mango yogurt,50,60,10,2,00335,India
816229,2023-05-26,205,classic yogurt,45,60,15,2,00335,India
816229,2023-05-26,207,coca cola,75,100,25,2,00335,India
662078,2023-05-26,205,classic yogurt,45,60,15,2,00271,India
662078,2023-05-26,209,pepsi,75,100,25,2,00271,India
662078,2023-05-26,211,red bull,90,125,35,2,00271,India
662078,2023-05-26,203,mango yogurt,50,60,10,2,00271,India
662078,2023-05-26,212,amul cheese,250,315,65,1,00271,India
199238,2023-05-26,207,coca cola,75,100,25,2,00058,India
156636,2023-05-26,209,pepsi,75,100,25,2,00026,India
156636,2023-05-26,212,amul cheese,250,315,65,1,00026,India
156636,2023-05-26,202,milk,12,27,15,1,00026,India
156636,2023-05-26,205,classic yogurt,45,60,15,2,00026,India
891296,2023-05-26,205,classic yogurt,45,60,15,2,00161,India
988548,2023-05-26,203,mango yogurt,50,60,10,2,00381,India
988548,2023-05-26,205,classic yogurt,45,60,15,2,00381,India
342262,2023-05-26,205,classic yogurt,45,60,15,2,00261,India
342262,2023-05-26,201,paneer,210,340,130,1,00261,India
342262,2023-05-26,211,red bull,90,125,35,2,00261,India
342262,2023-05-26,209,pepsi,75,100,25,2,00261,India
323903,2023-05-26,201,paneer,210,340,130,1,00097,India
250238,2023-05-26,211,red bull,90,125,35,2,00047,India
250238,2023-05-26,208,sprite,75,100,25,2,00047,India
641053,2023-05-26,213,bisleri,6,15,9,2,00138,India
196299,2023-05-26,205,classic yogurt,45,60,15,2,00204,India
196299,2023-05-26,202,milk,12,27,15,1,00204,India
196299,2023-05-26,203,mango yogurt,50,60,10,2,00204,India
160076,2023-05-26,210,mountain dew,75,100,25,2,00464,India
160076,2023-05-26,201,paneer,210,340,130,1,00464,India
160076,2023-05-26,202,milk,12,27,15,1,00464,India
278112,2023-05-26,210,mountain dew,75,100,25,2,00398,India
278112,2023-05-26,211,red bull,90,125,35,2,00398,India
914245,2023-05-26,201,paneer,210,340,130,1,00403,India
914245,2023-05-26,212,amul cheese,250,315,65,1,00403,India
914245,2023-05-26,208,sprite,75,100,25,2,00403,India
914245,2023-05-26,211,red bull,90,125,35,2,00403,India
914245,2023-05-26,205,classic yogurt,45,60,15,2,00403,India
280273,2023-05-26,210,mountain dew,75,100,25,2,00011,India
125090,2023-05-26,205,classic yogurt,45,60,15,2,00324,India
125090,2023-05-26,202,milk,12,27,15,1,00324,India
125090,2023-05-26,213,bisleri,6,15,9,2,00324,India
739989,2023-05-26,209,pepsi,75,100,25,2,00217,India
739989,2023-05-26,202,milk,12,27,15,1,00217,India
739989,2023-05-26,207,coca cola,75,100,25,2,00217,India
739989,2023-05-26,206,yakult,360,400,40,2,00217,India
739989,2023-05-26,205,classic yogurt,45,60,15,2,00217,India
982530,2023-05-26,213,bisleri,6,15,9,2,00375,India
982530,2023-05-26,208,sprite,75,100,25,2,00375,India
982530,2023-05-26,211,red bull,90,125,35,2,00375,India
982530,2023-05-26,209,pepsi,75,100,25,2,00375,India
804607,2023-05-26,202,milk,12,27,15,1,00446,India
804607,2023-05-26,211,red bull,90,125,35,2,00446,India
885977,2023-05-26,207,coca cola,75,100,25,2,00331,India
885977,2023-05-26,201,paneer,210,340,130,1,00331,India
885977,2023-05-26,206,yakult,360,400,40,2,00331,India
885977,2023-05-26,213,bisleri,6,15,9,2,00331,India
379463,2023-05-26,207,coca cola,75,100,25,2,00401,India
379463,2023-05-26,205,classic yogurt,45,60,15,2,00401,India
379463,2023-05-26,202,milk,12,27,15,1,00401,India
379463,2023-05-26,213,bisleri,6,15,9,2,00401,India
379463,2023-05-26,209,pepsi,75,100,25,2,00401,India
183780,2023-05-26,203,mango yogurt,50,60,10,2,00429,India
183780,2023-05-26,208,sprite,75,100,25,2,00429,India
183780,2023-05-26,204,strawberry yogurt,50,60,10,2,00429,India
183780,2023-05-26,202,milk,12,27,15,1,00429,India
987608,2023-05-26,212,amul cheese,250,315,65,1,00200,India
987608,2023-05-26,202,milk,12,27,15,1,00200,India
987608,2023-05-26,201,paneer,210,340,130,1,00200,India
724663,2023-05-26,211,red bull,90,125,35,2,00404,India
724663,2023-05-26,203,mango yogurt,50,60,10,2,00404,India
724663,2023-05-26,204,strawberry yogurt,50,60,10,2,00404,India
987160,2023-05-26,208,sprite,75,100,25,2,00457,India
987160,2023-05-26,201,paneer,210,340,130,1,00457,India
987160,2023-05-26,206,yakult,360,400,40,2,00457,India
326110,2023-05-26,207,coca cola,75,100,25,2,00098,India
326110,2023-05-26,213,bisleri,6,15,9,2,00098,India
326110,2023-05-26,210,mountain dew,75,100,25,2,00098,India
326110,2023-05-26,209,pepsi,75,100,25,2,00098,India
303751,2023-05-26,210,mountain dew,75,100,25,2,00436,India
726277,2023-05-26,205,classic yogurt,45,60,15,2,00161,India
726277,2023-05-26,213,bisleri,6,15,9,2,00161,India
726277,2023-05-26,210,mountain dew,75,100,25,2,00161,India
409517,2023-05-26,201,paneer,210,340,130,1,00376,India
695998,2023-05-26,204,strawberry yogurt,50,60,10,2,00064,India
695998,2023-05-26,202,milk,12,27,15,1,00064,India
695998,2023-05-26,213,bisleri,6,15,9,2,00064,India
502204,2023-05-26,202,milk,12,27,15,1,00191,India
502204,2023-05-26,210,mountain dew,75,100,25,2,00191,India
502204,2023-05-26,201,paneer,210,340,130,1,00191,India
831661,2023-05-26,211,red bull,90,125,35,2,00352,India
831661,2023-05-26,210,mountain dew,75,100,25,2,00352,India
831661,2023-05-26,204,strawberry yogurt,50,60,10,2,00352,India
831661,2023-05-26,201,paneer,210,340,130,1,00352,India
445403,2023-05-26,210,mountain dew,75,100,25,2,00493,India
445403,2023-05-26,203,mango yogurt,50,60,10,2,00493,India
445403,2023-05-26,205,classic yogurt,45,60,15,2,00493,India
445403,2023-05-26,211,red bull,90,125,35,2,00493,India
618943,2023-05-26,203,mango yogurt,50,60,10,2,00298,India
642855,2023-05-26,204,strawberry yogurt,50,60,10,2,00442,India
642855,2023-05-26,201,paneer,210,340,130,1,00442,India
642855,2023-05-26,205,classic yogurt,45,60,15,2,00442,India
947833,2023-05-26,203,mango yogurt,50,60,10,2,00106,India
947833,2023-05-26,210,mountain dew,75,100,25,2,00106,India
193945,2023-05-26,213,bisleri,6,15,9,2,00118,India
193945,2023-05-26,207,coca cola,75,100,25,2,00118,India
193945,2023-05-26,205,classic yogurt,45,60,15,2,00118,India
193945,2023-05-26,209,pepsi,75,100,25,2,00118,India
872747,2023-05-26,208,sprite,75,100,25,2,00291,India
872747,2023-05-26,204,strawberry yogurt,50,60,10,2,00291,India
443130,2023-05-26,208,sprite,75,100,25,2,00272,India
443130,2023-05-26,202,milk,12,27,15,1,00272,India
443130,2023-05-26,210,mountain dew,75,100,25,2,00272,India
646927,2023-05-26,212,amul cheese,250,315,65,1,00481,India
646927,2023-05-26,203,mango yogurt,50,60,10,2,00481,India
646927,2023-05-26,204,strawberry yogurt,50,60,10,2,00481,India
646927,2023-05-26,211,red bull,90,125,35,2,00481,India
646927,2023-05-26,213,bisleri,6,15,9,2,00481,India
580437,2023-05-26,209,pepsi,75,100,25,2,00070,India
462568,2023-05-26,205,classic yogurt,45,60,15,2,00450,India
462568,2023-05-26,202,milk,12,27,15,1,00450,India
484849,2023-05-26,210,mountain dew,75,100,25,2,00374,India
484849,2023-05-26,205,classic yogurt,45,60,15,2,00374,India
484849,2023-05-26,207,coca cola,75,100,25,2,00374,India
627201,2023-05-26,208,sprite,75,100,25,2,00278,India
627201,2023-05-26,210,mountain dew,75,100,25,2,00278,India
627201,2023-05-26,201,paneer,210,340,130,1,00278,India
627201,2023-05-26,205,classic yogurt,45,60,15,2,00278,India
627201,2023-05-26,206,yakult,360,400,40,2,00278,India
969454,2023-05-26,207,coca cola,75,100,25,2,00243,India
213662,2023-05-26,209,pepsi,75,100,25,2,00058,India
213662,2023-05-26,203,mango yogurt,50,60,10,2,00058,India
213662,2023-05-26,206,yakult,360,400,40,2,00058,India
840766,2023-05-26,212,amul cheese,250,315,65,1,00386,India
377231,2023-05-26,206,yakult,360,400,40,2,00047,India
377231,2023-05-26,208,sprite,75,100,25,2,00047,India
377231,2023-05-26,210,mountain dew,75,100,25,2,00047,India
491000,2023-05-26,213,bisleri,6,15,9,2,00214,India
277871,2023-05-26,207,coca cola,75,100,25,2,00165,India
751220,2023-05-26,203,mango yogurt,50,60,10,2,00351,India
751220,2023-05-26,211,red bull,90,125,35,2,00351,India
751220,2023-05-26,206,yakult,360,400,40,2,00351,India
561728,2023-05-26,211,red bull,90,125,35,2,00041,India
561728,2023-05-26,202,milk,12,27,15,1,00041,India
467470,2023-05-26,210,mountain dew,75,100,25,2,00258,India
467470,2023-05-26,205,classic yogurt,45,60,15,2,00258,India
467470,2023-05-26,204,strawberry yogurt,50,60,10,2,00258,India
467470,2023-05-26,212,amul cheese,250,315,65,1,00258,India
233499,2023-05-26,212,amul cheese,250,315,65,1,00041,India
233499,2023-05-26,211,red bull,90,125,35,2,00041,India
233499,2023-05-26,213,bisleri,6,15,9,2,00041,India
233499,2023-05-26,209,pepsi,75,100,25,2,00041,India
699623,2023-05-26,209,pepsi,75,100,25,2,00047,India
479744,2023-05-26,201,paneer,210,340,130,1,00334,India
479744,2023-05-26,206,yakult,360,400,40,2,00334,India
847133,2023-05-26,203,mango yogurt,50,60,10,2,00121,India
411227,2023-05-26,209,pepsi,75,100,25,2,00124,India
411227,2023-05-26,202,milk,12,27,15,1,00124,India
411227,2023-05-26,207,coca cola,75,100,25,2,00124,India
411227,2023-05-26,212,amul cheese,250,315,65,1,00124,India
254837,2023-05-26,203,mango yogurt,50,60,10,2,00260,India
254837,2023-05-26,207,coca cola,75,100,25,2,00260,India
254837,2023-05-26,202,milk,12,27,15,1,00260,India
254837,2023-05-26,208,sprite,75,100,25,2,00260,India
210544,2023-05-26,209,pepsi,75,100,25,2,00397,India
986895,2023-05-26,203,mango yogurt,50,60,10,2,00408,India
986895,2023-05-26,208,sprite,75,100,25,2,00408,India
986895,2023-05-26,213,bisleri,6,15,9,2,00408,India
789319,2023-05-26,212,amul cheese,250,315,65,1,00043,India
789319,2023-05-26,202,milk,12,27,15,1,00043,India
789319,2023-05-26,211,red bull,90,125,35,2,00043,India
789319,2023-05-26,204,strawberry yogurt,50,60,10,2,00043,India
463776,2023-05-26,209,pepsi,75,100,25,2,00246,India
463776,2023-05-26,204,strawberry yogurt,50,60,10,2,00246,India
463776,2023-05-26,211,red bull,90,125,35,2,00246,India
972992,2023-05-26,205,classic yogurt,45,60,15,2,00316,India
972992,2023-05-26,208,sprite,75,100,25,2,00316,India
830188,2023-05-26,202,milk,12,27,15,1,00043,India
830188,2023-05-26,212,amul cheese,250,315,65,1,00043,India
830188,2023-05-26,208,sprite,75,100,25,2,00043,India
197204,2023-05-26,211,red bull,90,125,35,2,00395,India
197204,2023-05-26,201,paneer,210,340,130,1,00395,India
197204,2023-05-26,205,classic yogurt,45,60,15,2,00395,India
307038,2023-05-26,209,pepsi,75,100,25,2,00134,India
307038,2023-05-26,213,bisleri,6,15,9,2,00134,India
307038,2023-05-26,207,coca cola,75,100,25,2,00134,India
307038,2023-05-26,212,amul cheese,250,315,65,1,00134,India
894689,2023-05-26,205,classic yogurt,45,60,15,2,00189,India
894689,2023-05-26,212,amul cheese,250,315,65,1,00189,India
894689,2023-05-26,213,bisleri,6,15,9,2,00189,India
894689,2023-05-26,204,strawberry yogurt,50,60,10,2,00189,India
688497,2023-05-26,207,coca cola,75,100,25,2,00199,India
688497,2023-05-26,205,classic yogurt,45,60,15,2,00199,India
688497,2023-05-26,202,milk,12,27,15,1,00199,India
796965,2023-05-26,201,paneer,210,340,130,1,00399,India
796965,2023-05-26,209,pepsi,75,100,25,2,00399,India
796965,2023-05-26,206,yakult,360,400,40,2,00399,India
796965,2023-05-26,212,amul cheese,250,315,65,1,00399,India
325357,2023-05-26,210,mountain dew,75,100,25,2,00360,India
325357,2023-05-26,212,amul cheese,250,315,65,1,00360,India
325357,2023-05-26,203,mango yogurt,50,60,10,2,00360,India
325357,2023-05-26,208,sprite,75,100,25,2,00360,India
825429,2023-05-26,210,mountain dew,75,100,25,2,00467,India
825429,2023-05-26,212,amul cheese,250,315,65,1,00467,India
825429,2023-05-26,209,pepsi,75,100,25,2,00467,India
825429,2023-05-26,201,paneer,210,340,130,1,00467,India
825429,2023-05-26,204,strawberry yogurt,50,60,10,2,00467,India
907262,2023-05-26,206,yakult,360,400,40,2,00256,India
907262,2023-05-26,212,amul cheese,250,315,65,1,00256,India
907262,2023-05-26,210,mountain dew,75,100,25,2,00256,India
907262,2023-05-26,213,bisleri,6,15,9,2,00256,India
416504,2023-05-26,201,paneer,210,340,130,1,00123,India
416504,2023-05-26,213,bisleri,6,15,9,2,00123,India
416504,2023-05-26,205,classic yogurt,45,60,15,2,00123,India
225356,2023-05-26,210,mountain dew,75,100,25,2,00052,India
225356,2023-05-26,212,amul cheese,250,315,65,1,00052,India
435588,2023-05-26,212,amul cheese,250,315,65,1,00336,India
435588,2023-05-26,203,mango yogurt,50,60,10,2,00336,India
435588,2023-05-26,205,classic yogurt,45,60,15,2,00336,India
567280,2023-05-26,208,sprite,75,100,25,2,00476,India
652329,2023-05-26,201,paneer,210,340,130,1,00109,India
652329,2023-05-26,204,strawberry yogurt,50,60,10,2,00109,India
144282,2023-05-26,207,coca cola,75,100,25,2,00069,India
144282,2023-05-26,205,classic yogurt,45,60,15,2,00069,India
144282,2023-05-26,208,sprite,75,100,25,2,00069,India
711697,2023-05-26,203,mango yogurt,50,60,10,2,00027,India
711697,2023-05-26,204,strawberry yogurt,50,60,10,2,00027,India
770944,2023-05-26,205,classic yogurt,45,60,15,2,00187,India
296803,2023-05-26,210,mountain dew,75,100,25,2,00023,India
296803,2023-05-26,209,pepsi,75,100,25,2,00023,India
529664,2023-05-26,208,sprite,75,100,25,2,00273,India
529664,2023-05-26,213,bisleri,6,15,9,2,00273,India
529664,2023-05-26,211,red bull,90,125,35,2,00273,India
529664,2023-05-26,204,strawberry yogurt,50,60,10,2,00273,India
213810,2023-05-26,202,milk,12,27,15,1,00216,India
213810,2023-05-26,201,paneer,210,340,130,1,00216,India
352644,2023-05-26,207,coca cola,75,100,25,2,00373,India
352644,2023-05-26,205,classic yogurt,45,60,15,2,00373,India
352644,2023-05-26,211,red bull,90,125,35,2,00373,India
146930,2023-05-26,208,sprite,75,100,25,2,00338,India
146930,2023-05-26,213,bisleri,6,15,9,2,00338,India
146930,2023-05-26,207,coca cola,75,100,25,2,00338,India
927625,2023-05-26,208,sprite,75,100,25,2,00394,India
927625,2023-05-26,210,mountain dew,75,100,25,2,00394,India
927625,2023-05-26,206,yakult,360,400,40,2,00394,India
927625,2023-05-26,211,red bull,90,125,35,2,00394,India
927625,2023-05-26,205,classic yogurt,45,60,15,2,00394,India
275439,2023-05-26,202,milk,12,27,15,1,00197,India
275439,2023-05-26,208,sprite,75,100,25,2,00197,India
275439,2023-05-26,201,paneer,210,340,130,1,00197,India
275439,2023-05-26,211,red bull,90,125,35,2,00197,India
213264,2023-05-26,213,bisleri,6,15,9,2,00238,India
213264,2023-05-26,201,paneer,210,340,130,1,00238,India
518957,2023-05-26,205,classic yogurt,45,60,15,2,00266,India
518957,2023-05-26,203,mango yogurt,50,60,10,2,00266,India
518957,2023-05-26,206,yakult,360,400,40,2,00266,India
518957,2023-05-26,208,sprite,75,100,25,2,00266,India
680955,2023-05-26,202,milk,12,27,15,1,00291,India
680955,2023-05-26,211,red bull,90,125,35,2,00291,India
680955,2023-05-26,205,classic yogurt,45,60,15,2,00291,India
680955,2023-05-26,209,pepsi,75,100,25,2,00291,India
189802,2023-05-26,210,mountain dew,75,100,25,2,00237,India
189802,2023-05-26,205,classic yogurt,45,60,15,2,00237,India
189802,2023-05-26,207,coca cola,75,100,25,2,00237,India
189802,2023-05-26,208,sprite,75,100,25,2,00237,India
300522,2023-05-26,208,sprite,75,100,25,2,00389,India
300522,2023-05-26,201,paneer,210,340,130,1,00389,India
300522,2023-05-26,210,mountain dew,75,100,25,2,00389,India
300522,2023-05-26,212,amul cheese,250,315,65,1,00389,India
678936,2023-05-26,206,yakult,360,400,40,2,00071,India
578033,2023-05-26,206,yakult,360,400,40,2,00414,India
578033,2023-05-26,203,mango yogurt,50,60,10,2,00414,India
578033,2023-05-26,212,amul cheese,250,315,65,1,00414,India
673362,2023-05-26,203,mango yogurt,50,60,10,2,00255,India
673362,2023-05-26,207,coca cola,75,100,25,2,00255,India
673362,2023-05-26,213,bisleri,6,15,9,2,00255,India
730507,2023-05-26,213,bisleri,6,15,9,2,00332,India
730507,2023-05-26,201,paneer,210,340,130,1,00332,India
513328,2023-05-27,210,mountain dew,75,100,25,2,00123,India
276451,2023-05-27,213,bisleri,6,15,9,2,00398,India
276451,2023-05-27,209,pepsi,75,100,25,2,00398,India
276451,2023-05-27,206,yakult,360,400,40,2,00398,India
981637,2023-05-27,210,mountain dew,75,100,25,2,00200,India
981637,2023-05-27,209,pepsi,75,100,25,2,00200,India
740381,2023-05-27,208,sprite,75,100,25,2,00178,India
740381,2023-05-27,204,strawberry yogurt,50,60,10,2,00178,India
481583,2023-05-27,209,pepsi,75,100,25,2,00292,India
481583,2023-05-27,213,bisleri,6,15,9,2,00292,India
481583,2023-05-27,207,coca cola,75,100,25,2,00292,India
671600,2023-05-27,210,mountain dew,75,100,25,2,00389,India
671600,2023-05-27,204,strawberry yogurt,50,60,10,2,00389,India
777816,2023-05-27,206,yakult,360,400,40,2,00318,India
612454,2023-05-27,201,paneer,210,340,130,1,00265,India
612454,2023-05-27,204,strawberry yogurt,50,60,10,2,00265,India
612454,2023-05-27,203,mango yogurt,50,60,10,2,00265,India
979836,2023-05-27,212,amul cheese,250,315,65,1,00377,India
979836,2023-05-27,213,bisleri,6,15,9,2,00377,India
979836,2023-05-27,211,red bull,90,125,35,2,00377,India
991585,2023-05-27,209,pepsi,75,100,25,2,00019,India
991585,2023-05-27,213,bisleri,6,15,9,2,00019,India
991585,2023-05-27,203,mango yogurt,50,60,10,2,00019,India
991585,2023-05-27,207,coca cola,75,100,25,2,00019,India
691284,2023-05-27,207,coca cola,75,100,25,2,00153,India
691284,2023-05-27,212,amul cheese,250,315,65,1,00153,India
691284,2023-05-27,206,yakult,360,400,40,2,00153,India
691284,2023-05-27,205,classic yogurt,45,60,15,2,00153,India
560237,2023-05-27,204,strawberry yogurt,50,60,10,2,00140,India
560237,2023-05-27,202,milk,12,27,15,1,00140,India
787868,2023-05-27,205,classic yogurt,45,60,15,2,00046,India
787868,2023-05-27,212,amul cheese,250,315,65,1,00046,India
787868,2023-05-27,208,sprite,75,100,25,2,00046,India
466848,2023-05-27,205,classic yogurt,45,60,15,2,00271,India
115442,2023-05-27,205,classic yogurt,45,60,15,2,00249,India
115442,2023-05-27,213,bisleri,6,15,9,2,00249,India
115442,2023-05-27,203,mango yogurt,50,60,10,2,00249,India
823719,2023-05-27,213,bisleri,6,15,9,2,00498,India
823719,2023-05-27,202,milk,12,27,15,1,00498,India
823719,2023-05-27,208,sprite,75,100,25,2,00498,India
823719,2023-05-27,201,paneer,210,340,130,1,00498,India
317128,2023-05-27,206,yakult,360,400,40,2,00249,India
317128,2023-05-27,204,strawberry yogurt,50,60,10,2,00249,India
317128,2023-05-27,202,milk,12,27,15,1,00249,India
317128,2023-05-27,203,mango yogurt,50,60,10,2,00249,India
308729,2023-05-27,202,milk,12,27,15,1,00369,India
308729,2023-05-27,204,strawberry yogurt,50,60,10,2,00369,India
308729,2023-05-27,201,paneer,210,340,130,1,00369,India
781178,2023-05-27,205,classic yogurt,45,60,15,2,00274,India
781178,2023-05-27,208,sprite,75,100,25,2,00274,India
781178,2023-05-27,210,mountain dew,75,100,25,2,00274,India
781178,2023-05-27,209,pepsi,75,100,25,2,00274,India
299866,2023-05-27,202,milk,12,27,15,1,00227,India
299866,2023-05-27,204,strawberry yogurt,50,60,10,2,00227,India
299866,2023-05-27,207,coca cola,75,100,25,2,00227,India
299866,2023-05-27,213,bisleri,6,15,9,2,00227,India
212094,2023-05-27,202,milk,12,27,15,1,00132,India
212094,2023-05-27,209,pepsi,75,100,25,2,00132,India
845262,2023-05-27,213,bisleri,6,15,9,2,00392,India
845262,2023-05-27,204,strawberry yogurt,50,60,10,2,00392,India
891871,2023-05-27,201,paneer,210,340,130,1,00397,India
891871,2023-05-27,206,yakult,360,400,40,2,00397,India
891871,2023-05-27,205,classic yogurt,45,60,15,2,00397,India
298739,2023-05-27,204,strawberry yogurt,50,60,10,2,00336,India
306336,2023-05-27,202,milk,12,27,15,1,00360,India
335566,2023-05-27,207,coca cola,75,100,25,2,00102,India
335566,2023-05-27,203,mango yogurt,50,60,10,2,00102,India
335566,2023-05-27,212,amul cheese,250,315,65,1,00102,India
335566,2023-05-27,210,mountain dew,75,100,25,2,00102,India
340302,2023-05-27,212,amul cheese,250,315,65,1,00260,India
340302,2023-05-27,208,sprite,75,100,25,2,00260,India
340302,2023-05-27,209,pepsi,75,100,25,2,00260,India
364965,2023-05-27,210,mountain dew,75,100,25,2,00103,India
364965,2023-05-27,208,sprite,75,100,25,2,00103,India
364965,2023-05-27,209,pepsi,75,100,25,2,00103,India
129963,2023-05-27,204,strawberry yogurt,50,60,10,2,00146,India
772283,2023-05-27,211,red bull,90,125,35,2,00167,India
772283,2023-05-27,212,amul cheese,250,315,65,1,00167,India
772283,2023-05-27,207,coca cola,75,100,25,2,00167,India
772283,2023-05-27,209,pepsi,75,100,25,2,00167,India
976649,2023-05-27,204,strawberry yogurt,50,60,10,2,00345,India
976649,2023-05-27,205,classic yogurt,45,60,15,2,00345,India
976649,2023-05-27,207,coca cola,75,100,25,2,00345,India
829746,2023-05-27,204,strawberry yogurt,50,60,10,2,00271,India
829746,2023-05-27,211,red bull,90,125,35,2,00271,India
829746,2023-05-27,209,pepsi,75,100,25,2,00271,India
829746,2023-05-27,210,mountain dew,75,100,25,2,00271,India
829746,2023-05-27,207,coca cola,75,100,25,2,00271,India
310420,2023-05-27,202,milk,12,27,15,1,00091,India
310420,2023-05-27,207,coca cola,75,100,25,2,00091,India
842498,2023-05-27,205,classic yogurt,45,60,15,2,00042,India
844812,2023-05-27,207,coca cola,75,100,25,2,00367,India
844812,2023-05-27,204,strawberry yogurt,50,60,10,2,00367,India
844812,2023-05-27,202,milk,12,27,15,1,00367,India
844812,2023-05-27,205,classic yogurt,45,60,15,2,00367,India
429500,2023-05-27,210,mountain dew,75,100,25,2,00010,India
429500,2023-05-27,212,amul cheese,250,315,65,1,00010,India
429500,2023-05-27,203,mango yogurt,50,60,10,2,00010,India
429500,2023-05-27,207,coca cola,75,100,25,2,00010,India
591188,2023-05-27,206,yakult,360,400,40,2,00264,India
591188,2023-05-27,208,sprite,75,100,25,2,00264,India
591188,2023-05-27,213,bisleri,6,15,9,2,00264,India
663946,2023-05-27,207,coca cola,75,100,25,2,00376,India
663946,2023-05-27,212,amul cheese,250,315,65,1,00376,India
240470,2023-05-27,209,pepsi,75,100,25,2,00349,India
240470,2023-05-27,213,bisleri,6,15,9,2,00349,India
240470,2023-05-27,201,paneer,210,340,130,1,00349,India
118365,2023-05-27,204,strawberry yogurt,50,60,10,2,00310,India
421647,2023-05-27,209,pepsi,75,100,25,2,00473,India
421647,2023-05-27,202,milk,12,27,15,1,00473,India
331916,2023-05-27,202,milk,12,27,15,1,00024,India
331916,2023-05-27,203,mango yogurt,50,60,10,2,00024,India
331916,2023-05-27,201,paneer,210,340,130,1,00024,India
330473,2023-05-27,207,coca cola,75,100,25,2,00408,India
363771,2023-05-27,211,red bull,90,125,35,2,00010,India
736741,2023-05-27,206,yakult,360,400,40,2,00020,India
736741,2023-05-27,201,paneer,210,340,130,1,00020,India
736741,2023-05-27,209,pepsi,75,100,25,2,00020,India
736741,2023-05-27,213,bisleri,6,15,9,2,00020,India
953348,2023-05-27,202,milk,12,27,15,1,00461,India
953348,2023-05-27,203,mango yogurt,50,60,10,2,00461,India
953348,2023-05-27,211,red bull,90,125,35,2,00461,India
363815,2023-05-27,203,mango yogurt,50,60,10,2,00136,India
363815,2023-05-27,207,coca cola,75,100,25,2,00136,India
597333,2023-05-27,208,sprite,75,100,25,2,00377,India
597333,2023-05-27,207,coca cola,75,100,25,2,00377,India
597333,2023-05-27,206,yakult,360,400,40,2,00377,India
597333,2023-05-27,211,red bull,90,125,35,2,00377,India
201734,2023-05-27,201,paneer,210,340,130,1,00464,India
136530,2023-05-27,212,amul cheese,250,315,65,1,00130,India
136530,2023-05-27,204,strawberry yogurt,50,60,10,2,00130,India
136530,2023-05-27,207,coca cola,75,100,25,2,00130,India
468677,2023-05-27,209,pepsi,75,100,25,2,00280,India
468677,2023-05-27,212,amul cheese,250,315,65,1,00280,India
468677,2023-05-27,204,strawberry yogurt,50,60,10,2,00280,India
468677,2023-05-27,202,milk,12,27,15,1,00280,India
468677,2023-05-27,207,coca cola,75,100,25,2,00280,India
282286,2023-05-27,210,mountain dew,75,100,25,2,00049,India
282286,2023-05-27,204,strawberry yogurt,50,60,10,2,00049,India
282286,2023-05-27,211,red bull,90,125,35,2,00049,India
316333,2023-05-27,209,pepsi,75,100,25,2,00099,India
316333,2023-05-27,203,mango yogurt,50,60,10,2,00099,India
316333,2023-05-27,210,mountain dew,75,100,25,2,00099,India
191240,2023-05-27,210,mountain dew,75,100,25,2,00456,India
191240,2023-05-27,205,classic yogurt,45,60,15,2,00456,India
826547,2023-05-27,208,sprite,75,100,25,2,00328,India
826547,2023-05-27,202,milk,12,27,15,1,00328,India
729287,2023-05-27,206,yakult,360,400,40,2,00182,India
729287,2023-05-27,209,pepsi,75,100,25,2,00182,India
729287,2023-05-27,211,red bull,90,125,35,2,00182,India
609781,2023-05-27,202,milk,12,27,15,1,00348,India
609781,2023-05-27,205,classic yogurt,45,60,15,2,00348,India
609781,2023-05-27,203,mango yogurt,50,60,10,2,00348,India
970928,2023-05-27,203,mango yogurt,50,60,10,2,00472,India
297048,2023-05-27,206,yakult,360,400,40,2,00437,India
297048,2023-05-27,207,coca cola,75,100,25,2,00437,India
571599,2023-05-27,213,bisleri,6,15,9,2,00267,India
571599,2023-05-27,207,coca cola,75,100,25,2,00267,India
571599,2023-05-27,210,mountain dew,75,100,25,2,00267,India
571599,2023-05-27,202,milk,12,27,15,1,00267,India
702410,2023-05-27,207,coca cola,75,100,25,2,00435,India
702410,2023-05-27,209,pepsi,75,100,25,2,00435,India
364565,2023-05-27,202,milk,12,27,15,1,00459,India
364565,2023-05-27,207,coca cola,75,100,25,2,00459,India
364565,2023-05-27,205,classic yogurt,45,60,15,2,00459,India
385857,2023-05-27,203,mango yogurt,50,60,10,2,00105,India
385857,2023-05-27,209,pepsi,75,100,25,2,00105,India
470412,2023-05-27,211,red bull,90,125,35,2,00237,India
470412,2023-05-27,202,milk,12,27,15,1,00237,India
690079,2023-05-27,212,amul cheese,250,315,65,1,00021,India
690079,2023-05-27,210,mountain dew,75,100,25,2,00021,India
690079,2023-05-27,203,mango yogurt,50,60,10,2,00021,India
832783,2023-05-27,205,classic yogurt,45,60,15,2,00302,India
832783,2023-05-27,202,milk,12,27,15,1,00302,India
832783,2023-05-27,212,amul cheese,250,315,65,1,00302,India
172644,2023-05-27,210,mountain dew,75,100,25,2,00071,India
312128,2023-05-27,204,strawberry yogurt,50,60,10,2,00369,India
312128,2023-05-27,201,paneer,210,340,130,1,00369,India
312128,2023-05-27,209,pepsi,75,100,25,2,00369,India
729477,2023-05-27,210,mountain dew,75,100,25,2,00315,India
729477,2023-05-27,203,mango yogurt,50,60,10,2,00315,India
729477,2023-05-27,211,red bull,90,125,35,2,00315,India
792827,2023-05-27,208,sprite,75,100,25,2,00130,India
792827,2023-05-27,212,amul cheese,250,315,65,1,00130,India
792827,2023-05-27,209,pepsi,75,100,25,2,00130,India
792827,2023-05-27,206,yakult,360,400,40,2,00130,India
243953,2023-05-27,210,mountain dew,75,100,25,2,00185,India
243953,2023-05-27,204,strawberry yogurt,50,60,10,2,00185,India
461051,2023-05-27,203,mango yogurt,50,60,10,2,00098,India
461051,2023-05-27,208,sprite,75,100,25,2,00098,India
461051,2023-05-27,207,coca cola,75,100,25,2,00098,India
461051,2023-05-27,211,red bull,90,125,35,2,00098,India
461051,2023-05-27,210,mountain dew,75,100,25,2,00098,India
422384,2023-05-27,203,mango yogurt,50,60,10,2,00384,India
422384,2023-05-27,210,mountain dew,75,100,25,2,00384,India
422384,2023-05-27,208,sprite,75,100,25,2,00384,India
422384,2023-05-27,209,pepsi,75,100,25,2,00384,India
454597,2023-05-27,201,paneer,210,340,130,1,00206,India
454597,2023-05-27,213,bisleri,6,15,9,2,00206,India
454597,2023-05-27,205,classic yogurt,45,60,15,2,00206,India
454597,2023-05-27,208,sprite,75,100,25,2,00206,India
718336,2023-05-27,211,red bull,90,125,35,2,00414,India
718336,2023-05-27,201,paneer,210,340,130,1,00414,India
718336,2023-05-27,213,bisleri,6,15,9,2,00414,India
718336,2023-05-27,212,amul cheese,250,315,65,1,00414,India
425798,2023-05-27,209,pepsi,75,100,25,2,00305,India
425798,2023-05-27,201,paneer,210,340,130,1,00305,India
425798,2023-05-27,206,yakult,360,400,40,2,00305,India
425798,2023-05-27,208,sprite,75,100,25,2,00305,India
877224,2023-05-27,208,sprite,75,100,25,2,00435,India
877224,2023-05-27,210,mountain dew,75,100,25,2,00435,India
933203,2023-05-27,209,pepsi,75,100,25,2,00024,India
933203,2023-05-27,207,coca cola,75,100,25,2,00024,India
945122,2023-05-27,207,coca cola,75,100,25,2,00475,India
945122,2023-05-27,201,paneer,210,340,130,1,00475,India
945122,2023-05-27,209,pepsi,75,100,25,2,00475,India
945122,2023-05-27,210,mountain dew,75,100,25,2,00475,India
467154,2023-05-27,212,amul cheese,250,315,65,1,00125,India
467154,2023-05-27,204,strawberry yogurt,50,60,10,2,00125,India
467154,2023-05-27,201,paneer,210,340,130,1,00125,India
474052,2023-05-28,201,paneer,210,340,130,1,00455,India
474052,2023-05-28,211,red bull,90,125,35,2,00455,India
474052,2023-05-28,212,amul cheese,250,315,65,1,00455,India
474052,2023-05-28,209,pepsi,75,100,25,2,00455,India
760947,2023-05-28,209,pepsi,75,100,25,2,00134,India
760947,2023-05-28,201,paneer,210,340,130,1,00134,India
760947,2023-05-28,210,mountain dew,75,100,25,2,00134,India
831583,2023-05-28,204,strawberry yogurt,50,60,10,2,00407,India
831583,2023-05-28,203,mango yogurt,50,60,10,2,00407,India
831583,2023-05-28,213,bisleri,6,15,9,2,00407,India
237627,2023-05-28,201,paneer,210,340,130,1,00419,India
237627,2023-05-28,209,pepsi,75,100,25,2,00419,India
207474,2023-05-28,209,pepsi,75,100,25,2,00198,India
207474,2023-05-28,205,classic yogurt,45,60,15,2,00198,India
207474,2023-05-28,201,paneer,210,340,130,1,00198,India
481844,2023-05-28,201,paneer,210,340,130,1,00349,India
481844,2023-05-28,206,yakult,360,400,40,2,00349,India
481844,2023-05-28,213,bisleri,6,15,9,2,00349,India
645749,2023-05-28,210,mountain dew,75,100,25,2,00300,India
645749,2023-05-28,205,classic yogurt,45,60,15,2,00300,India
645749,2023-05-28,213,bisleri,6,15,9,2,00300,India
194901,2023-05-28,201,paneer,210,340,130,1,00476,India
706832,2023-05-28,210,mountain dew,75,100,25,2,00265,India
706832,2023-05-28,208,sprite,75,100,25,2,00265,India
706832,2023-05-28,211,red bull,90,125,35,2,00265,India
736065,2023-05-28,212,amul cheese,250,315,65,1,00440,India
736065,2023-05-28,207,coca cola,75,100,25,2,00440,India
635289,2023-05-28,209,pepsi,75,100,25,2,00278,India
635289,2023-05-28,213,bisleri,6,15,9,2,00278,India
635289,2023-05-28,202,milk,12,27,15,1,00278,India
635289,2023-05-28,206,yakult,360,400,40,2,00278,India
635289,2023-05-28,205,classic yogurt,45,60,15,2,00278,India
719195,2023-05-28,209,pepsi,75,100,25,2,00468,India
719195,2023-05-28,212,amul cheese,250,315,65,1,00468,India
719195,2023-05-28,203,mango yogurt,50,60,10,2,00468,India
719195,2023-05-28,211,red bull,90,125,35,2,00468,India
309448,2023-05-28,205,classic yogurt,45,60,15,2,00158,India
309448,2023-05-28,202,milk,12,27,15,1,00158,India
587152,2023-05-28,207,coca cola,75,100,25,2,00094,India
587152,2023-05-28,206,yakult,360,400,40,2,00094,India
587152,2023-05-28,205,classic yogurt,45,60,15,2,00094,India
587152,2023-05-28,201,paneer,210,340,130,1,00094,India
970691,2023-05-28,211,red bull,90,125,35,2,00252,India
970691,2023-05-28,206,yakult,360,400,40,2,00252,India
566542,2023-05-28,206,yakult,360,400,40,2,00050,India
566542,2023-05-28,207,coca cola,75,100,25,2,00050,India
540166,2023-05-28,203,mango yogurt,50,60,10,2,00306,India
540166,2023-05-28,205,classic yogurt,45,60,15,2,00306,India
340973,2023-05-28,201,paneer,210,340,130,1,00085,India
340973,2023-05-28,213,bisleri,6,15,9,2,00085,India
340973,2023-05-28,202,milk,12,27,15,1,00085,India
287621,2023-05-28,210,mountain dew,75,100,25,2,00403,India
233028,2023-05-28,212,amul cheese,250,315,65,1,00008,India
233028,2023-05-28,201,paneer,210,340,130,1,00008,India
151170,2023-05-28,212,amul cheese,250,315,65,1,00485,India
668058,2023-05-28,211,red bull,90,125,35,2,00062,India
668058,2023-05-28,201,paneer,210,340,130,1,00062,India
668058,2023-05-28,212,amul cheese,250,315,65,1,00062,India
312143,2023-05-28,204,strawberry yogurt,50,60,10,2,00279,India
568619,2023-05-28,209,pepsi,75,100,25,2,00415,India
568619,2023-05-28,213,bisleri,6,15,9,2,00415,India
297110,2023-05-28,203,mango yogurt,50,60,10,2,00285,India
297110,2023-05-28,213,bisleri,6,15,9,2,00285,India
297110,2023-05-28,207,coca cola,75,100,25,2,00285,India
407106,2023-05-28,210,mountain dew,75,100,25,2,00337,India
407106,2023-05-28,203,mango yogurt,50,60,10,2,00337,India
407106,2023-05-28,209,pepsi,75,100,25,2,00337,India
838832,2023-05-28,202,milk,12,27,15,1,00313,India
838832,2023-05-28,206,yakult,360,400,40,2,00313,India
344888,2023-05-28,211,red bull,90,125,35,2,00176,India
297091,2023-05-28,201,paneer,210,340,130,1,00076,India
297091,2023-05-28,202,milk,12,27,15,1,00076,India
322102,2023-05-28,210,mountain dew,75,100,25,2,00411,India
322102,2023-05-28,212,amul cheese,250,315,65,1,00411,India
322102,2023-05-28,205,classic yogurt,45,60,15,2,00411,India
322102,2023-05-28,213,bisleri,6,15,9,2,00411,India
674399,2023-05-28,208,sprite,75,100,25,2,00018,India
674399,2023-05-28,213,bisleri,6,15,9,2,00018,India
697797,2023-05-28,206,yakult,360,400,40,2,00192,India
697797,2023-05-28,213,bisleri,6,15,9,2,00192,India
697797,2023-05-28,208,sprite,75,100,25,2,00192,India
700346,2023-05-28,207,coca cola,75,100,25,2,00180,India
700346,2023-05-28,201,paneer,210,340,130,1,00180,India
661780,2023-05-28,206,yakult,360,400,40,2,00180,India
661780,2023-05-28,203,mango yogurt,50,60,10,2,00180,India
661780,2023-05-28,210,mountain dew,75,100,25,2,00180,India
217067,2023-05-28,203,mango yogurt,50,60,10,2,00464,India
217067,2023-05-28,201,paneer,210,340,130,1,00464,India
217067,2023-05-28,211,red bull,90,125,35,2,00464,India
217067,2023-05-28,206,yakult,360,400,40,2,00464,India
259688,2023-05-28,204,strawberry yogurt,50,60,10,2,00240,India
259688,2023-05-28,207,coca cola,75,100,25,2,00240,India
980481,2023-05-28,201,paneer,210,340,130,1,00093,India
980481,2023-05-28,204,strawberry yogurt,50,60,10,2,00093,India
980481,2023-05-28,213,bisleri,6,15,9,2,00093,India
980481,2023-05-28,206,yakult,360,400,40,2,00093,India
155624,2023-05-28,201,paneer,210,340,130,1,00372,India
155624,2023-05-28,213,bisleri,6,15,9,2,00372,India
155624,2023-05-28,209,pepsi,75,100,25,2,00372,India
155624,2023-05-28,212,amul cheese,250,315,65,1,00372,India
155624,2023-05-28,208,sprite,75,100,25,2,00372,India
536773,2023-05-28,212,amul cheese,250,315,65,1,00178,India
536773,2023-05-28,205,classic yogurt,45,60,15,2,00178,India
536773,2023-05-28,213,bisleri,6,15,9,2,00178,India
536773,2023-05-28,207,coca cola,75,100,25,2,00178,India
536773,2023-05-28,208,sprite,75,100,25,2,00178,India
893732,2023-05-28,204,strawberry yogurt,50,60,10,2,00332,India
893732,2023-05-28,212,amul cheese,250,315,65,1,00332,India
893732,2023-05-28,207,coca cola,75,100,25,2,00332,India
893732,2023-05-28,205,classic yogurt,45,60,15,2,00332,India
862649,2023-05-28,212,amul cheese,250,315,65,1,00114,India
862649,2023-05-28,213,bisleri,6,15,9,2,00114,India
862649,2023-05-28,205,classic yogurt,45,60,15,2,00114,India
862649,2023-05-28,206,yakult,360,400,40,2,00114,India
862649,2023-05-28,208,sprite,75,100,25,2,00114,India
424095,2023-05-28,202,milk,12,27,15,1,00342,India
424095,2023-05-28,209,pepsi,75,100,25,2,00342,India
505197,2023-05-28,201,paneer,210,340,130,1,00140,India
505197,2023-05-28,205,classic yogurt,45,60,15,2,00140,India
505197,2023-05-28,209,pepsi,75,100,25,2,00140,India
505197,2023-05-28,211,red bull,90,125,35,2,00140,India
505197,2023-05-28,206,yakult,360,400,40,2,00140,India
699153,2023-05-28,209,pepsi,75,100,25,2,00318,India
699153,2023-05-28,210,mountain dew,75,100,25,2,00318,India
699153,2023-05-28,213,bisleri,6,15,9,2,00318,India
525487,2023-05-28,209,pepsi,75,100,25,2,00159,India
747086,2023-05-28,201,paneer,210,340,130,1,00428,India
747086,2023-05-28,207,coca cola,75,100,25,2,00428,India
747086,2023-05-28,209,pepsi,75,100,25,2,00428,India
909045,2023-05-28,212,amul cheese,250,315,65,1,00193,India
909045,2023-05-28,205,classic yogurt,45,60,15,2,00193,India
909045,2023-05-28,210,mountain dew,75,100,25,2,00193,India
909045,2023-05-28,208,sprite,75,100,25,2,00193,India
286709,2023-05-28,211,red bull,90,125,35,2,00374,India
286709,2023-05-28,203,mango yogurt,50,60,10,2,00374,India
286709,2023-05-28,207,coca cola,75,100,25,2,00374,India
286709,2023-05-28,201,paneer,210,340,130,1,00374,India
584105,2023-05-28,207,coca cola,75,100,25,2,00412,India
838775,2023-05-28,205,classic yogurt,45,60,15,2,00363,India
838775,2023-05-28,204,strawberry yogurt,50,60,10,2,00363,India
838775,2023-05-28,210,mountain dew,75,100,25,2,00363,India
838775,2023-05-28,212,amul cheese,250,315,65,1,00363,India
838775,2023-05-28,213,bisleri,6,15,9,2,00363,India
939210,2023-05-28,203,mango yogurt,50,60,10,2,00297,India
939210,2023-05-28,209,pepsi,75,100,25,2,00297,India
574704,2023-05-28,204,strawberry yogurt,50,60,10,2,00337,India
574704,2023-05-28,201,paneer,210,340,130,1,00337,India
574704,2023-05-28,210,mountain dew,75,100,25,2,00337,India
574704,2023-05-28,206,yakult,360,400,40,2,00337,India
144455,2023-05-28,211,red bull,90,125,35,2,00122,India
144455,2023-05-28,207,coca cola,75,100,25,2,00122,India
144455,2023-05-28,210,mountain dew,75,100,25,2,00122,India
144455,2023-05-28,206,yakult,360,400,40,2,00122,India
273721,2023-05-28,210,mountain dew,75,100,25,2,00169,India
273721,2023-05-28,208,sprite,75,100,25,2,00169,India
273721,2023-05-28,203,mango yogurt,50,60,10,2,00169,India
273721,2023-05-28,204,strawberry yogurt,50,60,10,2,00169,India
396626,2023-05-28,209,pepsi,75,100,25,2,00197,India
396626,2023-05-28,205,classic yogurt,45,60,15,2,00197,India
396626,2023-05-28,213,bisleri,6,15,9,2,00197,India
396626,2023-05-28,210,mountain dew,75,100,25,2,00197,India
987792,2023-05-28,210,mountain dew,75,100,25,2,00129,India
987792,2023-05-28,212,amul cheese,250,315,65,1,00129,India
987792,2023-05-28,211,red bull,90,125,35,2,00129,India
987792,2023-05-28,207,coca cola,75,100,25,2,00129,India
181991,2023-05-28,206,yakult,360,400,40,2,00333,India
181991,2023-05-28,202,milk,12,27,15,1,00333,India
181991,2023-05-28,207,coca cola,75,100,25,2,00333,India
181991,2023-05-28,201,paneer,210,340,130,1,00333,India
181991,2023-05-28,204,strawberry yogurt,50,60,10,2,00333,India
843744,2023-05-28,202,milk,12,27,15,1,00419,India
363855,2023-05-28,207,coca cola,75,100,25,2,00348,India
363855,2023-05-28,201,paneer,210,340,130,1,00348,India
363855,2023-05-28,211,red bull,90,125,35,2,00348,India
609727,2023-05-28,203,mango yogurt,50,60,10,2,00201,India
609727,2023-05-28,209,pepsi,75,100,25,2,00201,India
377764,2023-05-28,211,red bull,90,125,35,2,00155,India
377764,2023-05-28,212,amul cheese,250,315,65,1,00155,India
377764,2023-05-28,207,coca cola,75,100,25,2,00155,India
377764,2023-05-28,208,sprite,75,100,25,2,00155,India
377764,2023-05-28,210,mountain dew,75,100,25,2,00155,India
722109,2023-05-28,210,mountain dew,75,100,25,2,00282,India
722109,2023-05-28,213,bisleri,6,15,9,2,00282,India
722109,2023-05-28,212,amul cheese,250,315,65,1,00282,India
722109,2023-05-28,202,milk,12,27,15,1,00282,India
309578,2023-05-28,209,pepsi,75,100,25,2,00337,India
309578,2023-05-28,213,bisleri,6,15,9,2,00337,India
309578,2023-05-28,210,mountain dew,75,100,25,2,00337,India
309578,2023-05-28,205,classic yogurt,45,60,15,2,00337,India
512947,2023-05-28,206,yakult,360,400,40,2,00357,India
512947,2023-05-28,205,classic yogurt,45,60,15,2,00357,India
572767,2023-05-28,202,milk,12,27,15,1,00049,India
572767,2023-05-28,208,sprite,75,100,25,2,00049,India
572767,2023-05-28,210,mountain dew,75,100,25,2,00049,India
994061,2023-05-28,203,mango yogurt,50,60,10,2,00118,India
994061,2023-05-28,206,yakult,360,400,40,2,00118,India
994061,2023-05-28,212,amul cheese,250,315,65,1,00118,India
994061,2023-05-28,204,strawberry yogurt,50,60,10,2,00118,India
516320,2023-05-28,201,paneer,210,340,130,1,00272,India
516320,2023-05-28,210,mountain dew,75,100,25,2,00272,India
516320,2023-05-28,202,milk,12,27,15,1,00272,India
516320,2023-05-28,205,classic yogurt,45,60,15,2,00272,India
193225,2023-05-28,201,paneer,210,340,130,1,00248,India
193225,2023-05-28,208,sprite,75,100,25,2,00248,India
193225,2023-05-28,211,red bull,90,125,35,2,00248,India
193225,2023-05-28,210,mountain dew,75,100,25,2,00248,India
440441,2023-05-28,207,coca cola,75,100,25,2,00281,India
270285,2023-05-28,210,mountain dew,75,100,25,2,00250,India
270285,2023-05-28,208,sprite,75,100,25,2,00250,India
270285,2023-05-28,205,classic yogurt,45,60,15,2,00250,India
270285,2023-05-28,212,amul cheese,250,315,65,1,00250,India
945411,2023-05-28,208,sprite,75,100,25,2,00131,India
420183,2023-05-28,206,yakult,360,400,40,2,00131,India
420183,2023-05-28,212,amul cheese,250,315,65,1,00131,India
997608,2023-05-29,204,strawberry yogurt,50,60,10,2,00015,India
997608,2023-05-29,209,pepsi,75,100,25,2,00015,India
997608,2023-05-29,202,milk,12,27,15,1,00015,India
484145,2023-05-29,211,red bull,90,125,35,2,00485,India
484145,2023-05-29,202,milk,12,27,15,1,00485,India
484145,2023-05-29,203,mango yogurt,50,60,10,2,00485,India
484145,2023-05-29,212,amul cheese,250,315,65,1,00485,India
484145,2023-05-29,208,sprite,75,100,25,2,00485,India
850641,2023-05-29,202,milk,12,27,15,1,00104,India
850641,2023-05-29,204,strawberry yogurt,50,60,10,2,00104,India
850641,2023-05-29,207,coca cola,75,100,25,2,00104,India
554512,2023-05-29,204,strawberry yogurt,50,60,10,2,00355,India
554512,2023-05-29,212,amul cheese,250,315,65,1,00355,India
746019,2023-05-29,206,yakult,360,400,40,2,00148,India
746019,2023-05-29,207,coca cola,75,100,25,2,00148,India
805428,2023-05-29,205,classic yogurt,45,60,15,2,00206,India
805428,2023-05-29,203,mango yogurt,50,60,10,2,00206,India
925479,2023-05-29,212,amul cheese,250,315,65,1,00185,India
925479,2023-05-29,208,sprite,75,100,25,2,00185,India
925479,2023-05-29,203,mango yogurt,50,60,10,2,00185,India
266215,2023-05-29,212,amul cheese,250,315,65,1,00257,India
266215,2023-05-29,201,paneer,210,340,130,1,00257,India
266215,2023-05-29,202,milk,12,27,15,1,00257,India
266215,2023-05-29,211,red bull,90,125,35,2,00257,India
523811,2023-05-29,210,mountain dew,75,100,25,2,00437,India
523811,2023-05-29,209,pepsi,75,100,25,2,00437,India
523811,2023-05-29,207,coca cola,75,100,25,2,00437,India
946405,2023-05-29,210,mountain dew,75,100,25,2,00440,India
946405,2023-05-29,206,yakult,360,400,40,2,00440,India
946405,2023-05-29,201,paneer,210,340,130,1,00440,India
946405,2023-05-29,205,classic yogurt,45,60,15,2,00440,India
946405,2023-05-29,202,milk,12,27,15,1,00440,India
563310,2023-05-29,204,strawberry yogurt,50,60,10,2,00130,India
563310,2023-05-29,201,paneer,210,340,130,1,00130,India
563310,2023-05-29,213,bisleri,6,15,9,2,00130,India
563310,2023-05-29,203,mango yogurt,50,60,10,2,00130,India
388671,2023-05-29,213,bisleri,6,15,9,2,00139,India
388671,2023-05-29,202,milk,12,27,15,1,00139,India
388671,2023-05-29,203,mango yogurt,50,60,10,2,00139,India
268288,2023-05-29,212,amul cheese,250,315,65,1,00025,India
310974,2023-05-29,204,strawberry yogurt,50,60,10,2,00097,India
310974,2023-05-29,210,mountain dew,75,100,25,2,00097,India
695229,2023-05-29,209,pepsi,75,100,25,2,00249,India
279651,2023-05-29,211,red bull,90,125,35,2,00097,India
377485,2023-05-29,201,paneer,210,340,130,1,00207,India
377485,2023-05-29,212,amul cheese,250,315,65,1,00207,India
377485,2023-05-29,203,mango yogurt,50,60,10,2,00207,India
607831,2023-05-29,205,classic yogurt,45,60,15,2,00061,India
607831,2023-05-29,203,mango yogurt,50,60,10,2,00061,India
607831,2023-05-29,201,paneer,210,340,130,1,00061,India
607831,2023-05-29,209,pepsi,75,100,25,2,00061,India
540666,2023-05-29,209,pepsi,75,100,25,2,00447,India
540666,2023-05-29,203,mango yogurt,50,60,10,2,00447,India
540666,2023-05-29,206,yakult,360,400,40,2,00447,India
716425,2023-05-29,207,coca cola,75,100,25,2,00280,India
716425,2023-05-29,202,milk,12,27,15,1,00280,India
716425,2023-05-29,203,mango yogurt,50,60,10,2,00280,India
778005,2023-05-29,207,coca cola,75,100,25,2,00395,India
778005,2023-05-29,213,bisleri,6,15,9,2,00395,India
887480,2023-05-29,203,mango yogurt,50,60,10,2,00387,India
887480,2023-05-29,209,pepsi,75,100,25,2,00387,India
206356,2023-05-29,211,red bull,90,125,35,2,00367,India
206356,2023-05-29,212,amul cheese,250,315,65,1,00367,India
206356,2023-05-29,213,bisleri,6,15,9,2,00367,India
206356,2023-05-29,203,mango yogurt,50,60,10,2,00367,India
681451,2023-05-29,210,mountain dew,75,100,25,2,00325,India
681451,2023-05-29,204,strawberry yogurt,50,60,10,2,00325,India
681451,2023-05-29,208,sprite,75,100,25,2,00325,India
681451,2023-05-29,201,paneer,210,340,130,1,00325,India
482324,2023-05-29,210,mountain dew,75,100,25,2,00335,India
482324,2023-05-29,213,bisleri,6,15,9,2,00335,India
482324,2023-05-29,204,strawberry yogurt,50,60,10,2,00335,India
482324,2023-05-29,208,sprite,75,100,25,2,00335,India
235110,2023-05-29,210,mountain dew,75,100,25,2,00061,India
235110,2023-05-29,213,bisleri,6,15,9,2,00061,India
861436,2023-05-29,202,milk,12,27,15,1,00361,India
861436,2023-05-29,210,mountain dew,75,100,25,2,00361,India
861436,2023-05-29,212,amul cheese,250,315,65,1,00361,India
787294,2023-05-29,206,yakult,360,400,40,2,00058,India
787294,2023-05-29,211,red bull,90,125,35,2,00058,India
787294,2023-05-29,207,coca cola,75,100,25,2,00058,India
787294,2023-05-29,203,mango yogurt,50,60,10,2,00058,India
663660,2023-05-29,210,mountain dew,75,100,25,2,00109,India
663660,2023-05-29,208,sprite,75,100,25,2,00109,India
737787,2023-05-29,211,red bull,90,125,35,2,00411,India
737787,2023-05-29,210,mountain dew,75,100,25,2,00411,India
141995,2023-05-29,210,mountain dew,75,100,25,2,00205,India
141995,2023-05-29,201,paneer,210,340,130,1,00205,India
141995,2023-05-29,208,sprite,75,100,25,2,00205,India
137839,2023-05-29,208,sprite,75,100,25,2,00195,India
137839,2023-05-29,211,red bull,90,125,35,2,00195,India
137839,2023-05-29,204,strawberry yogurt,50,60,10,2,00195,India
137839,2023-05-29,210,mountain dew,75,100,25,2,00195,India
137839,2023-05-29,205,classic yogurt,45,60,15,2,00195,India
192908,2023-05-29,208,sprite,75,100,25,2,00333,India
192908,2023-05-29,205,classic yogurt,45,60,15,2,00333,India
192908,2023-05-29,202,milk,12,27,15,1,00333,India
192908,2023-05-29,209,pepsi,75,100,25,2,00333,India
132960,2023-05-29,204,strawberry yogurt,50,60,10,2,00263,India
132960,2023-05-29,209,pepsi,75,100,25,2,00263,India
132960,2023-05-29,213,bisleri,6,15,9,2,00263,India
132960,2023-05-29,205,classic yogurt,45,60,15,2,00263,India
914411,2023-05-29,212,amul cheese,250,315,65,1,00280,India
914411,2023-05-29,208,sprite,75,100,25,2,00280,India
421037,2023-05-29,211,red bull,90,125,35,2,00422,India
421037,2023-05-29,206,yakult,360,400,40,2,00422,India
421037,2023-05-29,203,mango yogurt,50,60,10,2,00422,India
830086,2023-05-29,208,sprite,75,100,25,2,00213,India
830086,2023-05-29,206,yakult,360,400,40,2,00213,India
745930,2023-05-29,208,sprite,75,100,25,2,00439,India
935086,2023-05-29,208,sprite,75,100,25,2,00292,India
935086,2023-05-29,201,paneer,210,340,130,1,00292,India
935086,2023-05-29,204,strawberry yogurt,50,60,10,2,00292,India
935086,2023-05-29,213,bisleri,6,15,9,2,00292,India
157926,2023-05-29,209,pepsi,75,100,25,2,00141,India
157926,2023-05-29,210,mountain dew,75,100,25,2,00141,India
157926,2023-05-29,208,sprite,75,100,25,2,00141,India
849858,2023-05-29,211,red bull,90,125,35,2,00239,India
811430,2023-05-29,206,yakult,360,400,40,2,00461,India
811430,2023-05-29,210,mountain dew,75,100,25,2,00461,India
811430,2023-05-29,211,red bull,90,125,35,2,00461,India
864612,2023-05-29,207,coca cola,75,100,25,2,00325,India
864612,2023-05-29,212,amul cheese,250,315,65,1,00325,India
864612,2023-05-29,213,bisleri,6,15,9,2,00325,India
961850,2023-05-29,208,sprite,75,100,25,2,00149,India
961850,2023-05-29,213,bisleri,6,15,9,2,00149,India
961850,2023-05-29,201,paneer,210,340,130,1,00149,India
961850,2023-05-29,209,pepsi,75,100,25,2,00149,India
961850,2023-05-29,202,milk,12,27,15,1,00149,India
293199,2023-05-29,211,red bull,90,125,35,2,00254,India
293199,2023-05-29,206,yakult,360,400,40,2,00254,India
696953,2023-05-29,206,yakult,360,400,40,2,00246,India
696953,2023-05-29,207,coca cola,75,100,25,2,00246,India
696953,2023-05-29,213,bisleri,6,15,9,2,00246,India
561861,2023-05-29,204,strawberry yogurt,50,60,10,2,00023,India
606621,2023-05-29,208,sprite,75,100,25,2,00132,India
606621,2023-05-29,206,yakult,360,400,40,2,00132,India
606621,2023-05-29,211,red bull,90,125,35,2,00132,India
192522,2023-05-29,203,mango yogurt,50,60,10,2,00089,India
448576,2023-05-29,203,mango yogurt,50,60,10,2,00208,India
448576,2023-05-29,205,classic yogurt,45,60,15,2,00208,India
448576,2023-05-29,204,strawberry yogurt,50,60,10,2,00208,India
149080,2023-05-29,212,amul cheese,250,315,65,1,00278,India
149080,2023-05-29,213,bisleri,6,15,9,2,00278,India
149080,2023-05-29,201,paneer,210,340,130,1,00278,India
972723,2023-05-29,208,sprite,75,100,25,2,00003,India
972723,2023-05-29,203,mango yogurt,50,60,10,2,00003,India
972723,2023-05-29,204,strawberry yogurt,50,60,10,2,00003,India
972723,2023-05-29,211,red bull,90,125,35,2,00003,India
522859,2023-05-29,211,red bull,90,125,35,2,00276,India
522859,2023-05-29,208,sprite,75,100,25,2,00276,India
522859,2023-05-29,204,strawberry yogurt,50,60,10,2,00276,India
522859,2023-05-29,212,amul cheese,250,315,65,1,00276,India
870286,2023-05-29,211,red bull,90,125,35,2,00244,India
870286,2023-05-29,210,mountain dew,75,100,25,2,00244,India
509032,2023-05-29,201,paneer,210,340,130,1,00298,India
509032,2023-05-29,206,yakult,360,400,40,2,00298,India
509032,2023-05-29,208,sprite,75,100,25,2,00298,India
155402,2023-05-29,210,mountain dew,75,100,25,2,00252,India
155402,2023-05-29,212,amul cheese,250,315,65,1,00252,India
155402,2023-05-29,203,mango yogurt,50,60,10,2,00252,India
920964,2023-05-29,208,sprite,75,100,25,2,00467,India
920964,2023-05-29,209,pepsi,75,100,25,2,00467,India
920964,2023-05-29,202,milk,12,27,15,1,00467,India
406799,2023-05-29,202,milk,12,27,15,1,00297,India
406799,2023-05-29,213,bisleri,6,15,9,2,00297,India
406799,2023-05-29,212,amul cheese,250,315,65,1,00297,India
406799,2023-05-29,206,yakult,360,400,40,2,00297,India
541181,2023-05-29,202,milk,12,27,15,1,00219,India
541181,2023-05-29,213,bisleri,6,15,9,2,00219,India
541181,2023-05-29,210,mountain dew,75,100,25,2,00219,India
541181,2023-05-29,205,classic yogurt,45,60,15,2,00219,India
676762,2023-05-29,203,mango yogurt,50,60,10,2,00359,India
817896,2023-05-29,213,bisleri,6,15,9,2,00331,India
817896,2023-05-29,209,pepsi,75,100,25,2,00331,India
817896,2023-05-29,204,strawberry yogurt,50,60,10,2,00331,India
817896,2023-05-29,205,classic yogurt,45,60,15,2,00331,India
992864,2023-05-29,213,bisleri,6,15,9,2,00376,India
992864,2023-05-29,206,yakult,360,400,40,2,00376,India
992864,2023-05-29,202,milk,12,27,15,1,00376,India
992864,2023-05-29,204,strawberry yogurt,50,60,10,2,00376,India
526600,2023-05-29,203,mango yogurt,50,60,10,2,00191,India
910800,2023-05-29,206,yakult,360,400,40,2,00201,India
910800,2023-05-29,207,coca cola,75,100,25,2,00201,India
519703,2023-05-29,213,bisleri,6,15,9,2,00121,India
519703,2023-05-29,209,pepsi,75,100,25,2,00121,India
519703,2023-05-29,202,milk,12,27,15,1,00121,India
519703,2023-05-29,206,yakult,360,400,40,2,00121,India
155836,2023-05-29,201,paneer,210,340,130,1,00138,India
155836,2023-05-29,202,milk,12,27,15,1,00138,India
155836,2023-05-29,208,sprite,75,100,25,2,00138,India
155836,2023-05-29,206,yakult,360,400,40,2,00138,India
155836,2023-05-29,210,mountain dew,75,100,25,2,00138,India
711336,2023-05-29,210,mountain dew,75,100,25,2,00277,India
711336,2023-05-29,204,strawberry yogurt,50,60,10,2,00277,India
843263,2023-05-29,212,amul cheese,250,315,65,1,00370,India
252946,2023-05-29,211,red bull,90,125,35,2,00199,India
252946,2023-05-29,206,yakult,360,400,40,2,00199,India
252946,2023-05-29,212,amul cheese,250,315,65,1,00199,India
252946,2023-05-29,209,pepsi,75,100,25,2,00199,India
959378,2023-05-29,210,mountain dew,75,100,25,2,00175,India
959378,2023-05-29,207,coca cola,75,100,25,2,00175,India
526707,2023-05-29,210,mountain dew,75,100,25,2,00435,India
526707,2023-05-29,201,paneer,210,340,130,1,00435,India
526707,2023-05-29,213,bisleri,6,15,9,2,00435,India
526707,2023-05-29,203,mango yogurt,50,60,10,2,00435,India
740285,2023-05-29,207,coca cola,75,100,25,2,00113,India
446487,2023-05-29,207,coca cola,75,100,25,2,00213,India
446487,2023-05-29,209,pepsi,75,100,25,2,00213,India
446487,2023-05-29,212,amul cheese,250,315,65,1,00213,India
568338,2023-05-29,205,classic yogurt,45,60,15,2,00044,India
568338,2023-05-29,211,red bull,90,125,35,2,00044,India
568338,2023-05-29,204,strawberry yogurt,50,60,10,2,00044,India
339310,2023-05-29,213,bisleri,6,15,9,2,00282,India
339310,2023-05-29,206,yakult,360,400,40,2,00282,India
339310,2023-05-29,209,pepsi,75,100,25,2,00282,India
629572,2023-05-29,207,coca cola,75,100,25,2,00015,India
629572,2023-05-29,213,bisleri,6,15,9,2,00015,India
629572,2023-05-29,212,amul cheese,250,315,65,1,00015,India
629572,2023-05-29,205,classic yogurt,45,60,15,2,00015,India
631550,2023-05-29,211,red bull,90,125,35,2,00130,India
631550,2023-05-29,204,strawberry yogurt,50,60,10,2,00130,India
407246,2023-05-29,201,paneer,210,340,130,1,00172,India
407246,2023-05-29,209,pepsi,75,100,25,2,00172,India
407246,2023-05-29,207,coca cola,75,100,25,2,00172,India
407246,2023-05-29,208,sprite,75,100,25,2,00172,India
965019,2023-05-29,205,classic yogurt,45,60,15,2,00354,India
965019,2023-05-29,201,paneer,210,340,130,1,00354,India
205366,2023-05-29,212,amul cheese,250,315,65,1,00035,India
205366,2023-05-29,201,paneer,210,340,130,1,00035,India
205366,2023-05-29,202,milk,12,27,15,1,00035,India
319965,2023-05-29,202,milk,12,27,15,1,00094,India
319965,2023-05-29,207,coca cola,75,100,25,2,00094,India
415734,2023-05-29,207,coca cola,75,100,25,2,00284,India
273583,2023-05-29,201,paneer,210,340,130,1,00061,India
273583,2023-05-29,204,strawberry yogurt,50,60,10,2,00061,India
273583,2023-05-29,203,mango yogurt,50,60,10,2,00061,India
218448,2023-05-29,207,coca cola,75,100,25,2,00281,India
218448,2023-05-29,202,milk,12,27,15,1,00281,India
218448,2023-05-29,211,red bull,90,125,35,2,00281,India
218448,2023-05-29,212,amul cheese,250,315,65,1,00281,India
405189,2023-05-29,213,bisleri,6,15,9,2,00234,India
405189,2023-05-29,204,strawberry yogurt,50,60,10,2,00234,India
405189,2023-05-29,202,milk,12,27,15,1,00234,India
387531,2023-05-29,211,red bull,90,125,35,2,00443,India
387531,2023-05-29,212,amul cheese,250,315,65,1,00443,India
500285,2023-05-29,201,paneer,210,340,130,1,00254,India
513176,2023-05-29,213,bisleri,6,15,9,2,00228,India
513176,2023-05-29,208,sprite,75,100,25,2,00228,India
800225,2023-05-29,209,pepsi,75,100,25,2,00231,India
800225,2023-05-29,207,coca cola,75,100,25,2,00231,India
616965,2023-05-29,204,strawberry yogurt,50,60,10,2,00331,India
616965,2023-05-29,210,mountain dew,75,100,25,2,00331,India
616965,2023-05-29,213,bisleri,6,15,9,2,00331,India
616965,2023-05-29,209,pepsi,75,100,25,2,00331,India
689625,2023-05-29,204,strawberry yogurt,50,60,10,2,00038,India
689625,2023-05-29,211,red bull,90,125,35,2,00038,India
689625,2023-05-29,203,mango yogurt,50,60,10,2,00038,India
424964,2023-05-29,207,coca cola,75,100,25,2,00176,India
424964,2023-05-29,202,milk,12,27,15,1,00176,India
424964,2023-05-29,204,strawberry yogurt,50,60,10,2,00176,India
424964,2023-05-29,209,pepsi,75,100,25,2,00176,India
788988,2023-05-29,202,milk,12,27,15,1,00033,India
788988,2023-05-29,211,red bull,90,125,35,2,00033,India
788988,2023-05-29,203,mango yogurt,50,60,10,2,00033,India
846226,2023-05-29,207,coca cola,75,100,25,2,00489,India
846226,2023-05-29,210,mountain dew,75,100,25,2,00489,India
846226,2023-05-29,203,mango yogurt,50,60,10,2,00489,India
846226,2023-05-29,205,classic yogurt,45,60,15,2,00489,India
846226,2023-05-29,209,pepsi,75,100,25,2,00489,India
585889,2023-05-29,203,mango yogurt,50,60,10,2,00026,India
585889,2023-05-29,210,mountain dew,75,100,25,2,00026,India
585889,2023-05-29,212,amul cheese,250,315,65,1,00026,India
585889,2023-05-29,201,paneer,210,340,130,1,00026,India
547032,2023-05-29,202,milk,12,27,15,1,00473,India
547032,2023-05-29,201,paneer,210,340,130,1,00473,India
547032,2023-05-29,209,pepsi,75,100,25,2,00473,India
872886,2023-05-30,204,strawberry yogurt,50,60,10,2,00315,India
894271,2023-05-30,205,classic yogurt,45,60,15,2,00148,India
894271,2023-05-30,202,milk,12,27,15,1,00148,India
894271,2023-05-30,209,pepsi,75,100,25,2,00148,India
894271,2023-05-30,207,coca cola,75,100,25,2,00148,India
201314,2023-05-30,203,mango yogurt,50,60,10,2,00210,India
201314,2023-05-30,201,paneer,210,340,130,1,00210,India
532019,2023-05-30,205,classic yogurt,45,60,15,2,00295,India
918926,2023-05-30,203,mango yogurt,50,60,10,2,00146,India
918926,2023-05-30,211,red bull,90,125,35,2,00146,India
918926,2023-05-30,204,strawberry yogurt,50,60,10,2,00146,India
918926,2023-05-30,207,coca cola,75,100,25,2,00146,India
108136,2023-05-30,206,yakult,360,400,40,2,00184,India
362424,2023-05-30,204,strawberry yogurt,50,60,10,2,00052,India
362424,2023-05-30,209,pepsi,75,100,25,2,00052,India
999360,2023-05-30,212,amul cheese,250,315,65,1,00151,India
999360,2023-05-30,208,sprite,75,100,25,2,00151,India
999360,2023-05-30,213,bisleri,6,15,9,2,00151,India
830485,2023-05-30,201,paneer,210,340,130,1,00357,India
830485,2023-05-30,210,mountain dew,75,100,25,2,00357,India
830485,2023-05-30,204,strawberry yogurt,50,60,10,2,00357,India
157177,2023-05-30,201,paneer,210,340,130,1,00199,India
157177,2023-05-30,208,sprite,75,100,25,2,00199,India
157177,2023-05-30,202,milk,12,27,15,1,00199,India
157177,2023-05-30,206,yakult,360,400,40,2,00199,India
282996,2023-05-30,204,strawberry yogurt,50,60,10,2,00023,India
282996,2023-05-30,203,mango yogurt,50,60,10,2,00023,India
471152,2023-05-30,203,mango yogurt,50,60,10,2,00049,India
471152,2023-05-30,212,amul cheese,250,315,65,1,00049,India
471152,2023-05-30,206,yakult,360,400,40,2,00049,India
687674,2023-05-30,213,bisleri,6,15,9,2,00399,India
687674,2023-05-30,205,classic yogurt,45,60,15,2,00399,India
687674,2023-05-30,209,pepsi,75,100,25,2,00399,India
757102,2023-05-30,202,milk,12,27,15,1,00005,India
757102,2023-05-30,208,sprite,75,100,25,2,00005,India
757102,2023-05-30,206,yakult,360,400,40,2,00005,India
774826,2023-05-30,207,coca cola,75,100,25,2,00191,India
769629,2023-05-30,204,strawberry yogurt,50,60,10,2,00204,India
769629,2023-05-30,212,amul cheese,250,315,65,1,00204,India
769629,2023-05-30,205,classic yogurt,45,60,15,2,00204,India
969406,2023-05-30,208,sprite,75,100,25,2,00186,India
969406,2023-05-30,211,red bull,90,125,35,2,00186,India
971151,2023-05-30,206,yakult,360,400,40,2,00313,India
971151,2023-05-30,207,coca cola,75,100,25,2,00313,India
971151,2023-05-30,213,bisleri,6,15,9,2,00313,India
971151,2023-05-30,209,pepsi,75,100,25,2,00313,India
213997,2023-05-30,207,coca cola,75,100,25,2,00310,India
213997,2023-05-30,204,strawberry yogurt,50,60,10,2,00310,India
208092,2023-05-30,206,yakult,360,400,40,2,00495,India
208092,2023-05-30,208,sprite,75,100,25,2,00495,India
208092,2023-05-30,201,paneer,210,340,130,1,00495,India
381588,2023-05-30,209,pepsi,75,100,25,2,00121,India
381588,2023-05-30,203,mango yogurt,50,60,10,2,00121,India
381588,2023-05-30,212,amul cheese,250,315,65,1,00121,India
934022,2023-05-30,201,paneer,210,340,130,1,00368,India
934022,2023-05-30,202,milk,12,27,15,1,00368,India
137579,2023-05-30,203,mango yogurt,50,60,10,2,00279,India
166239,2023-05-30,203,mango yogurt,50,60,10,2,00229,India
166239,2023-05-30,210,mountain dew,75,100,25,2,00229,India
675896,2023-05-30,210,mountain dew,75,100,25,2,00008,India
180948,2023-05-30,203,mango yogurt,50,60,10,2,00453,India
180948,2023-05-30,212,amul cheese,250,315,65,1,00453,India
180948,2023-05-30,205,classic yogurt,45,60,15,2,00453,India
180948,2023-05-30,209,pepsi,75,100,25,2,00453,India
978666,2023-05-30,211,red bull,90,125,35,2,00202,India
978666,2023-05-30,207,coca cola,75,100,25,2,00202,India
435507,2023-05-30,207,coca cola,75,100,25,2,00066,India
435507,2023-05-30,202,milk,12,27,15,1,00066,India
435507,2023-05-30,206,yakult,360,400,40,2,00066,India
478576,2023-05-30,201,paneer,210,340,130,1,00074,India
478576,2023-05-30,206,yakult,360,400,40,2,00074,India
478576,2023-05-30,203,mango yogurt,50,60,10,2,00074,India
478576,2023-05-30,207,coca cola,75,100,25,2,00074,India
107870,2023-05-30,210,mountain dew,75,100,25,2,00227,India
107870,2023-05-30,205,classic yogurt,45,60,15,2,00227,India
107870,2023-05-30,213,bisleri,6,15,9,2,00227,India
170442,2023-05-30,206,yakult,360,400,40,2,00073,India
922782,2023-05-30,210,mountain dew,75,100,25,2,00014,India
922782,2023-05-30,201,paneer,210,340,130,1,00014,India
922782,2023-05-30,202,milk,12,27,15,1,00014,India
922782,2023-05-30,203,mango yogurt,50,60,10,2,00014,India
219289,2023-05-30,210,mountain dew,75,100,25,2,00485,India
219289,2023-05-30,211,red bull,90,125,35,2,00485,India
219289,2023-05-30,208,sprite,75,100,25,2,00485,India
939412,2023-05-30,202,milk,12,27,15,1,00495,India
939412,2023-05-30,207,coca cola,75,100,25,2,00495,India
939412,2023-05-30,213,bisleri,6,15,9,2,00495,India
939412,2023-05-30,208,sprite,75,100,25,2,00495,India
939412,2023-05-30,209,pepsi,75,100,25,2,00495,India
830206,2023-05-30,205,classic yogurt,45,60,15,2,00031,India
830206,2023-05-30,209,pepsi,75,100,25,2,00031,India
830206,2023-05-30,207,coca cola,75,100,25,2,00031,India
300412,2023-05-30,209,pepsi,75,100,25,2,00442,India
300412,2023-05-30,203,mango yogurt,50,60,10,2,00442,India
300412,2023-05-30,206,yakult,360,400,40,2,00442,India
150203,2023-05-30,207,coca cola,75,100,25,2,00090,India
688128,2023-05-30,209,pepsi,75,100,25,2,00033,India
688128,2023-05-30,208,sprite,75,100,25,2,00033,India
525877,2023-05-30,213,bisleri,6,15,9,2,00260,India
525877,2023-05-30,203,mango yogurt,50,60,10,2,00260,India
525877,2023-05-30,206,yakult,360,400,40,2,00260,India
525877,2023-05-30,212,amul cheese,250,315,65,1,00260,India
242715,2023-05-30,209,pepsi,75,100,25,2,00171,India
242715,2023-05-30,204,strawberry yogurt,50,60,10,2,00171,India
242715,2023-05-30,203,mango yogurt,50,60,10,2,00171,India
242715,2023-05-30,208,sprite,75,100,25,2,00171,India
993347,2023-05-30,202,milk,12,27,15,1,00090,India
993347,2023-05-30,212,amul cheese,250,315,65,1,00090,India
993347,2023-05-30,208,sprite,75,100,25,2,00090,India
993347,2023-05-30,207,coca cola,75,100,25,2,00090,India
630246,2023-05-30,210,mountain dew,75,100,25,2,00441,India
630246,2023-05-30,209,pepsi,75,100,25,2,00441,India
630246,2023-05-30,201,paneer,210,340,130,1,00441,India
581273,2023-05-30,209,pepsi,75,100,25,2,00212,India
711700,2023-05-30,212,amul cheese,250,315,65,1,00358,India
711700,2023-05-30,208,sprite,75,100,25,2,00358,India
711700,2023-05-30,211,red bull,90,125,35,2,00358,India
711700,2023-05-30,210,mountain dew,75,100,25,2,00358,India
642164,2023-05-30,203,mango yogurt,50,60,10,2,00103,India
642164,2023-05-30,210,mountain dew,75,100,25,2,00103,India
462175,2023-05-30,213,bisleri,6,15,9,2,00326,India
462175,2023-05-30,206,yakult,360,400,40,2,00326,India
188109,2023-05-30,205,classic yogurt,45,60,15,2,00221,India
775873,2023-05-30,204,strawberry yogurt,50,60,10,2,00367,India
775873,2023-05-30,212,amul cheese,250,315,65,1,00367,India
906162,2023-05-30,210,mountain dew,75,100,25,2,00009,India
906162,2023-05-30,206,yakult,360,400,40,2,00009,India
906162,2023-05-30,212,amul cheese,250,315,65,1,00009,India
640176,2023-05-30,203,mango yogurt,50,60,10,2,00194,India
640176,2023-05-30,210,mountain dew,75,100,25,2,00194,India
640176,2023-05-30,213,bisleri,6,15,9,2,00194,India
185922,2023-05-30,205,classic yogurt,45,60,15,2,00420,India
185922,2023-05-30,210,mountain dew,75,100,25,2,00420,India
185922,2023-05-30,203,mango yogurt,50,60,10,2,00420,India
185922,2023-05-30,206,yakult,360,400,40,2,00420,India
185922,2023-05-30,201,paneer,210,340,130,1,00420,India
630124,2023-05-30,207,coca cola,75,100,25,2,00390,India
630124,2023-05-30,205,classic yogurt,45,60,15,2,00390,India
630124,2023-05-30,208,sprite,75,100,25,2,00390,India
630124,2023-05-30,202,milk,12,27,15,1,00390,India
561244,2023-05-30,205,classic yogurt,45,60,15,2,00171,India
561244,2023-05-30,201,paneer,210,340,130,1,00171,India
561244,2023-05-30,210,mountain dew,75,100,25,2,00171,India
725768,2023-05-30,207,coca cola,75,100,25,2,00346,India
725768,2023-05-30,213,bisleri,6,15,9,2,00346,India
725768,2023-05-30,204,strawberry yogurt,50,60,10,2,00346,India
725768,2023-05-30,202,milk,12,27,15,1,00346,India
994042,2023-05-30,208,sprite,75,100,25,2,00003,India
994042,2023-05-30,206,yakult,360,400,40,2,00003,India
994042,2023-05-30,201,paneer,210,340,130,1,00003,India
573908,2023-05-30,206,yakult,360,400,40,2,00036,India
573908,2023-05-30,203,mango yogurt,50,60,10,2,00036,India
573908,2023-05-30,208,sprite,75,100,25,2,00036,India
573908,2023-05-30,201,paneer,210,340,130,1,00036,India
573908,2023-05-30,213,bisleri,6,15,9,2,00036,India
847075,2023-05-30,206,yakult,360,400,40,2,00258,India
806297,2023-05-31,209,pepsi,75,100,25,2,00052,India
540437,2023-05-31,210,mountain dew,75,100,25,2,00465,India
540437,2023-05-31,209,pepsi,75,100,25,2,00465,India
540437,2023-05-31,211,red bull,90,125,35,2,00465,India
617135,2023-05-31,205,classic yogurt,45,60,15,2,00374,India
111878,2023-05-31,208,sprite,75,100,25,2,00041,India
111878,2023-05-31,209,pepsi,75,100,25,2,00041,India
743982,2023-05-31,213,bisleri,6,15,9,2,00276,India
743982,2023-05-31,210,mountain dew,75,100,25,2,00276,India
743982,2023-05-31,204,strawberry yogurt,50,60,10,2,00276,India
890869,2023-05-31,211,red bull,90,125,35,2,00378,India
331609,2023-05-31,209,pepsi,75,100,25,2,00278,India
331609,2023-05-31,211,red bull,90,125,35,2,00278,India
331609,2023-05-31,202,milk,12,27,15,1,00278,India
706023,2023-05-31,209,pepsi,75,100,25,2,00427,India
408947,2023-05-31,211,red bull,90,125,35,2,00125,India
664046,2023-05-31,205,classic yogurt,45,60,15,2,00073,India
664046,2023-05-31,208,sprite,75,100,25,2,00073,India
664046,2023-05-31,213,bisleri,6,15,9,2,00073,India
147914,2023-05-31,205,classic yogurt,45,60,15,2,00243,India
147914,2023-05-31,203,mango yogurt,50,60,10,2,00243,India
147914,2023-05-31,210,mountain dew,75,100,25,2,00243,India
139649,2023-05-31,210,mountain dew,75,100,25,2,00354,India
139649,2023-05-31,204,strawberry yogurt,50,60,10,2,00354,India
139649,2023-05-31,208,sprite,75,100,25,2,00354,India
351944,2023-05-31,209,pepsi,75,100,25,2,00152,India
118737,2023-05-31,213,bisleri,6,15,9,2,00316,India
118737,2023-05-31,210,mountain dew,75,100,25,2,00316,India
118737,2023-05-31,207,coca cola,75,100,25,2,00316,India
118737,2023-05-31,211,red bull,90,125,35,2,00316,India
118737,2023-05-31,202,milk,12,27,15,1,00316,India
345450,2023-05-31,203,mango yogurt,50,60,10,2,00057,India
487495,2023-05-31,205,classic yogurt,45,60,15,2,00296,India
487495,2023-05-31,207,coca cola,75,100,25,2,00296,India
729133,2023-05-31,205,classic yogurt,45,60,15,2,00042,India
729133,2023-05-31,201,paneer,210,340,130,1,00042,India
729133,2023-05-31,210,mountain dew,75,100,25,2,00042,India
238739,2023-05-31,209,pepsi,75,100,25,2,00331,India
970259,2023-05-31,202,milk,12,27,15,1,00171,India
970259,2023-05-31,206,yakult,360,400,40,2,00171,India
970259,2023-05-31,212,amul cheese,250,315,65,1,00171,India
186666,2023-05-31,209,pepsi,75,100,25,2,00483,India
186666,2023-05-31,206,yakult,360,400,40,2,00483,India
186666,2023-05-31,213,bisleri,6,15,9,2,00483,India
980622,2023-05-31,213,bisleri,6,15,9,2,00352,India
190169,2023-05-31,205,classic yogurt,45,60,15,2,00075,India
190169,2023-05-31,201,paneer,210,340,130,1,00075,India
190169,2023-05-31,211,red bull,90,125,35,2,00075,India
897177,2023-05-31,212,amul cheese,250,315,65,1,00482,India
897177,2023-05-31,204,strawberry yogurt,50,60,10,2,00482,India
922213,2023-05-31,206,yakult,360,400,40,2,00329,India
470619,2023-05-31,210,mountain dew,75,100,25,2,00415,India
470619,2023-05-31,213,bisleri,6,15,9,2,00415,India
560541,2023-05-31,209,pepsi,75,100,25,2,00074,India
560541,2023-05-31,202,milk,12,27,15,1,00074,India
887779,2023-05-31,209,pepsi,75,100,25,2,00171,India
887779,2023-05-31,213,bisleri,6,15,9,2,00171,India
887779,2023-05-31,211,red bull,90,125,35,2,00171,India
887779,2023-05-31,208,sprite,75,100,25,2,00171,India
887779,2023-05-31,207,coca cola,75,100,25,2,00171,India
488324,2023-05-31,205,classic yogurt,45,60,15,2,00419,India
488324,2023-05-31,206,yakult,360,400,40,2,00419,India
848464,2023-05-31,212,amul cheese,250,315,65,1,00077,India
848464,2023-05-31,207,coca cola,75,100,25,2,00077,India
848464,2023-05-31,213,bisleri,6,15,9,2,00077,India
294809,2023-05-31,209,pepsi,75,100,25,2,00348,India
669838,2023-05-31,210,mountain dew,75,100,25,2,00335,India
669838,2023-05-31,204,strawberry yogurt,50,60,10,2,00335,India
669838,2023-05-31,201,paneer,210,340,130,1,00335,India
170934,2023-05-31,208,sprite,75,100,25,2,00491,India
170934,2023-05-31,213,bisleri,6,15,9,2,00491,India
248744,2023-05-31,213,bisleri,6,15,9,2,00416,India
175676,2023-05-31,211,red bull,90,125,35,2,00045,India
945376,2023-05-31,202,milk,12,27,15,1,00247,India
562131,2023-05-31,208,sprite,75,100,25,2,00372,India
562131,2023-05-31,204,strawberry yogurt,50,60,10,2,00372,India
562131,2023-05-31,207,coca cola,75,100,25,2,00372,India
562131,2023-05-31,203,mango yogurt,50,60,10,2,00372,India
562131,2023-05-31,209,pepsi,75,100,25,2,00372,India
163398,2023-05-31,209,pepsi,75,100,25,2,00338,India
163398,2023-05-31,212,amul cheese,250,315,65,1,00338,India
163398,2023-05-31,202,milk,12,27,15,1,00338,India
647045,2023-05-31,211,red bull,90,125,35,2,00457,India
647045,2023-05-31,213,bisleri,6,15,9,2,00457,India
647045,2023-05-31,202,milk,12,27,15,1,00457,India
647045,2023-05-31,206,yakult,360,400,40,2,00457,India
145124,2023-05-31,212,amul cheese,250,315,65,1,00175,India
145124,2023-05-31,207,coca cola,75,100,25,2,00175,India
145124,2023-05-31,203,mango yogurt,50,60,10,2,00175,India
145124,2023-05-31,209,pepsi,75,100,25,2,00175,India
145124,2023-05-31,208,sprite,75,100,25,2,00175,India
291099,2023-05-31,203,mango yogurt,50,60,10,2,00400,India
486584,2023-05-31,213,bisleri,6,15,9,2,00375,India
449188,2023-05-31,201,paneer,210,340,130,1,00444,India
155396,2023-05-31,206,yakult,360,400,40,2,00466,India
287070,2023-05-31,202,milk,12,27,15,1,00454,India
287070,2023-05-31,208,sprite,75,100,25,2,00454,India
163542,2023-05-31,201,paneer,210,340,130,1,00038,India
163542,2023-05-31,208,sprite,75,100,25,2,00038,India
771699,2023-05-31,204,strawberry yogurt,50,60,10,2,00242,India
771699,2023-05-31,210,mountain dew,75,100,25,2,00242,India
703925,2023-05-31,201,paneer,210,340,130,1,00061,India
703925,2023-05-31,210,mountain dew,75,100,25,2,00061,India
703925,2023-05-31,208,sprite,75,100,25,2,00061,India
703925,2023-05-31,211,red bull,90,125,35,2,00061,India
990048,2023-05-31,202,milk,12,27,15,1,00324,India
990048,2023-05-31,204,strawberry yogurt,50,60,10,2,00324,India
990048,2023-05-31,201,paneer,210,340,130,1,00324,India
500894,2023-05-31,206,yakult,360,400,40,2,00314,India
500894,2023-05-31,205,classic yogurt,45,60,15,2,00314,India
500894,2023-05-31,203,mango yogurt,50,60,10,2,00314,India
513950,2023-05-31,212,amul cheese,250,315,65,1,00473,India
513950,2023-05-31,205,classic yogurt,45,60,15,2,00473,India
513950,2023-05-31,206,yakult,360,400,40,2,00473,India
528324,2023-05-31,207,coca cola,75,100,25,2,00203,India
977687,2023-05-31,205,classic yogurt,45,60,15,2,00287,India
977687,2023-05-31,212,amul cheese,250,315,65,1,00287,India
977687,2023-05-31,202,milk,12,27,15,1,00287,India
495737,2023-05-31,213,bisleri,6,15,9,2,00281,India
844278,2023-05-31,207,coca cola,75,100,25,2,00132,India
287288,2023-05-31,211,red bull,90,125,35,2,00124,India
287288,2023-05-31,202,milk,12,27,15,1,00124,India
287288,2023-05-31,208,sprite,75,100,25,2,00124,India
908216,2023-05-31,201,paneer,210,340,130,1,00307,India
908216,2023-05-31,210,mountain dew,75,100,25,2,00307,India
908216,2023-05-31,208,sprite,75,100,25,2,00307,India
908216,2023-05-31,205,classic yogurt,45,60,15,2,00307,India
644153,2023-05-31,213,bisleri,6,15,9,2,00264,India
276220,2023-05-31,202,milk,12,27,15,1,00123,India
686763,2023-05-31,202,milk,12,27,15,1,00270,India
686763,2023-05-31,206,yakult,360,400,40,2,00270,India
686763,2023-05-31,208,sprite,75,100,25,2,00270,India
348634,2023-05-31,207,coca cola,75,100,25,2,00052,India
362825,2023-05-31,201,paneer,210,340,130,1,00046,India
896170,2023-05-31,203,mango yogurt,50,60,10,2,00089,India
896170,2023-05-31,210,mountain dew,75,100,25,2,00089,India
774321,2023-05-31,213,bisleri,6,15,9,2,00089,India
774321,2023-05-31,203,mango yogurt,50,60,10,2,00089,India
762677,2023-05-31,208,sprite,75,100,25,2,00379,India
927042,2023-05-31,212,amul cheese,250,315,65,1,00233,India
927042,2023-05-31,210,mountain dew,75,100,25,2,00233,India
927042,2023-05-31,201,paneer,210,340,130,1,00233,India
927042,2023-05-31,204,strawberry yogurt,50,60,10,2,00233,India
988380,2023-05-31,205,classic yogurt,45,60,15,2,00392,India
988380,2023-05-31,204,strawberry yogurt,50,60,10,2,00392,India
988380,2023-05-31,206,yakult,360,400,40,2,00392,India
988380,2023-05-31,201,paneer,210,340,130,1,00392,India
849882,2023-05-31,202,milk,12,27,15,1,00046,India
849882,2023-05-31,211,red bull,90,125,35,2,00046,India
849882,2023-05-31,209,pepsi,75,100,25,2,00046,India
849882,2023-05-31,206,yakult,360,400,40,2,00046,India
831326,2023-05-31,202,milk,12,27,15,1,00258,India
831326,2023-05-31,204,strawberry yogurt,50,60,10,2,00258,India
597232,2023-05-31,211,red bull,90,125,35,2,00155,India
597232,2023-05-31,208,sprite,75,100,25,2,00155,India
597232,2023-05-31,201,paneer,210,340,130,1,00155,India
597232,2023-05-31,204,strawberry yogurt,50,60,10,2,00155,India
597232,2023-05-31,205,classic yogurt,45,60,15,2,00155,India
320720,2023-05-31,206,yakult,360,400,40,2,00169,India
834028,2023-05-31,207,coca cola,75,100,25,2,00123,India
477127,2023-05-31,207,coca cola,75,100,25,2,00201,India
477127,2023-05-31,210,mountain dew,75,100,25,2,00201,India
477127,2023-05-31,208,sprite,75,100,25,2,00201,India
625249,2023-05-31,204,strawberry yogurt,50,60,10,2,00292,India
625249,2023-05-31,207,coca cola,75,100,25,2,00292,India
487571,2023-05-31,213,bisleri,6,15,9,2,00476,India
949932,2023-05-31,205,classic yogurt,45,60,15,2,00139,India
949932,2023-05-31,209,pepsi,75,100,25,2,00139,India
949932,2023-05-31,211,red bull,90,125,35,2,00139,India
855630,2023-05-31,204,strawberry yogurt,50,60,10,2,00081,India
998685,2023-05-31,208,sprite,75,100,25,2,00198,India
998685,2023-05-31,207,coca cola,75,100,25,2,00198,India
998685,2023-05-31,205,classic yogurt,45,60,15,2,00198,India
356856,2023-05-31,210,mountain dew,75,100,25,2,00109,India
356856,2023-05-31,208,sprite,75,100,25,2,00109,India
356856,2023-05-31,211,red bull,90,125,35,2,00109,India
356856,2023-05-31,203,mango yogurt,50,60,10,2,00109,India
474578,2023-05-31,208,sprite,75,100,25,2,00162,India
474578,2023-05-31,212,amul cheese,250,315,65,1,00162,India
474578,2023-05-31,201,paneer,210,340,130,1,00162,India
434737,2023-05-31,204,strawberry yogurt,50,60,10,2,00152,India
434737,2023-05-31,203,mango yogurt,50,60,10,2,00152,India
434737,2023-05-31,205,classic yogurt,45,60,15,2,00152,India
957996,2023-05-31,212,amul cheese,250,315,65,1,00247,India
957996,2023-05-31,210,mountain dew,75,100,25,2,00247,India
957996,2023-05-31,203,mango yogurt,50,60,10,2,00247,India
957996,2023-05-31,201,paneer,210,340,130,1,00247,India
210242,2023-05-31,204,strawberry yogurt,50,60,10,2,00153,India
210242,2023-05-31,210,mountain dew,75,100,25,2,00153,India
210242,2023-05-31,212,amul cheese,250,315,65,1,00153,India
154235,2023-05-31,208,sprite,75,100,25,2,00028,India
291885,2023-05-31,212,amul cheese,250,315,65,1,00224,India
291885,2023-05-31,208,sprite,75,100,25,2,00224,India
291885,2023-05-31,207,coca cola,75,100,25,2,00224,India
445094,2023-06-01,207,coca cola,75,100,25,1,00500,India
445094,2023-06-01,209,pepsi,75,100,25,1,00500,India
445094,2023-06-01,206,yakult,360,400,40,1,00500,India
445094,2023-06-01,213,bisleri,6,15,9,1,00500,India
498522,2023-06-01,209,pepsi,75,100,25,1,00356,India
498522,2023-06-01,212,amul cheese,250,315,65,1,00356,India
498522,2023-06-01,205,classic yogurt,45,60,15,1,00356,India
614662,2023-06-01,206,yakult,360,400,40,1,00133,India
614662,2023-06-01,205,classic yogurt,45,60,15,1,00133,India
614662,2023-06-01,203,mango yogurt,50,60,10,1,00133,India
614662,2023-06-01,212,amul cheese,250,315,65,1,00133,India
673172,2023-06-01,210,mountain dew,75,100,25,1,00433,India
673172,2023-06-01,208,sprite,75,100,25,1,00433,India
673172,2023-06-01,207,coca cola,75,100,25,1,00433,India
673172,2023-06-01,203,mango yogurt,50,60,10,1,00433,India
673172,2023-06-01,206,yakult,360,400,40,1,00433,India
508403,2023-06-01,210,mountain dew,75,100,25,1,00194,India
566380,2023-06-01,205,classic yogurt,45,60,15,1,00495,India
744621,2023-06-01,208,sprite,75,100,25,1,00052,India
744621,2023-06-01,205,classic yogurt,45,60,15,1,00052,India
715800,2023-06-01,206,yakult,360,400,40,1,00110,India
715800,2023-06-01,209,pepsi,75,100,25,1,00110,India
715800,2023-06-01,207,coca cola,75,100,25,1,00110,India
655274,2023-06-01,207,coca cola,75,100,25,1,00064,India
655274,2023-06-01,206,yakult,360,400,40,1,00064,India
689132,2023-06-01,203,mango yogurt,50,60,10,1,00265,India
689132,2023-06-01,209,pepsi,75,100,25,1,00265,India
784693,2023-06-01,211,red bull,90,125,35,1,00308,India
784693,2023-06-01,202,milk,12,27,15,1,00308,India
784693,2023-06-01,206,yakult,360,400,40,1,00308,India
895892,2023-06-01,207,coca cola,75,100,25,1,00082,India
895892,2023-06-01,211,red bull,90,125,35,1,00082,India
895892,2023-06-01,205,classic yogurt,45,60,15,1,00082,India
895892,2023-06-01,206,yakult,360,400,40,1,00082,India
652242,2023-06-01,203,mango yogurt,50,60,10,1,00488,India
652242,2023-06-01,211,red bull,90,125,35,1,00488,India
652242,2023-06-01,204,strawberry yogurt,50,60,10,1,00488,India
150985,2023-06-01,202,milk,12,27,15,1,00339,India
150985,2023-06-01,206,yakult,360,400,40,1,00339,India
710962,2023-06-01,210,mountain dew,75,100,25,1,00112,India
710962,2023-06-01,206,yakult,360,400,40,1,00112,India
761924,2023-06-01,213,bisleri,6,15,9,1,00051,India
123401,2023-06-01,207,coca cola,75,100,25,1,00045,India
123401,2023-06-01,213,bisleri,6,15,9,1,00045,India
123401,2023-06-01,206,yakult,360,400,40,1,00045,India
123401,2023-06-01,204,strawberry yogurt,50,60,10,1,00045,India
266269,2023-06-01,209,pepsi,75,100,25,1,00299,India
641391,2023-06-01,207,coca cola,75,100,25,1,00193,India
641391,2023-06-01,210,mountain dew,75,100,25,1,00193,India
641391,2023-06-01,201,paneer,210,340,130,1,00193,India
104957,2023-06-01,201,paneer,210,340,130,1,00028,India
104957,2023-06-01,210,mountain dew,75,100,25,1,00028,India
447458,2023-06-01,201,paneer,210,340,130,1,00029,India
447458,2023-06-01,209,pepsi,75,100,25,1,00029,India
447458,2023-06-01,212,amul cheese,250,315,65,1,00029,India
447458,2023-06-01,202,milk,12,27,15,1,00029,India
357377,2023-06-01,208,sprite,75,100,25,1,00495,India
357377,2023-06-01,204,strawberry yogurt,50,60,10,1,00495,India
357377,2023-06-01,201,paneer,210,340,130,1,00495,India
100067,2023-06-01,204,strawberry yogurt,50,60,10,1,00483,India
100067,2023-06-01,202,milk,12,27,15,1,00483,India
100067,2023-06-01,205,classic yogurt,45,60,15,1,00483,India
677881,2023-06-01,213,bisleri,6,15,9,1,00377,India
677881,2023-06-01,209,pepsi,75,100,25,1,00377,India
677881,2023-06-01,206,yakult,360,400,40,1,00377,India
677881,2023-06-01,204,strawberry yogurt,50,60,10,1,00377,India
688233,2023-06-01,213,bisleri,6,15,9,1,00036,India
688233,2023-06-01,206,yakult,360,400,40,1,00036,India
688233,2023-06-01,205,classic yogurt,45,60,15,1,00036,India
608384,2023-06-01,203,mango yogurt,50,60,10,1,00072,India
608384,2023-06-01,213,bisleri,6,15,9,1,00072,India
608384,2023-06-01,209,pepsi,75,100,25,1,00072,India
614383,2023-06-01,204,strawberry yogurt,50,60,10,1,00031,India
614383,2023-06-01,210,mountain dew,75,100,25,1,00031,India
614383,2023-06-01,211,red bull,90,125,35,1,00031,India
614383,2023-06-01,206,yakult,360,400,40,1,00031,India
614383,2023-06-01,203,mango yogurt,50,60,10,1,00031,India
374582,2023-06-01,201,paneer,210,340,130,1,00191,India
374582,2023-06-01,212,amul cheese,250,315,65,1,00191,India
374582,2023-06-01,206,yakult,360,400,40,1,00191,India
879482,2023-06-01,208,sprite,75,100,25,1,00492,India
898818,2023-06-01,212,amul cheese,250,315,65,1,00347,India
775677,2023-06-01,203,mango yogurt,50,60,10,1,00483,India
775677,2023-06-01,209,pepsi,75,100,25,1,00483,India
775677,2023-06-01,205,classic yogurt,45,60,15,1,00483,India
964100,2023-06-01,203,mango yogurt,50,60,10,1,00222,India
963452,2023-06-01,211,red bull,90,125,35,1,00001,India
579738,2023-06-01,205,classic yogurt,45,60,15,1,00194,India
579738,2023-06-01,212,amul cheese,250,315,65,1,00194,India
579738,2023-06-01,208,sprite,75,100,25,1,00194,India
660222,2023-06-01,203,mango yogurt,50,60,10,1,00011,India
660222,2023-06-01,211,red bull,90,125,35,1,00011,India
660222,2023-06-01,205,classic yogurt,45,60,15,1,00011,India
660222,2023-06-01,210,mountain dew,75,100,25,1,00011,India
707339,2023-06-01,205,classic yogurt,45,60,15,1,00274,India
707339,2023-06-01,207,coca cola,75,100,25,1,00274,India
107409,2023-06-01,201,paneer,210,340,130,1,00405,India
107409,2023-06-01,213,bisleri,6,15,9,1,00405,India
107409,2023-06-01,202,milk,12,27,15,1,00405,India
107409,2023-06-01,205,classic yogurt,45,60,15,1,00405,India
107409,2023-06-01,203,mango yogurt,50,60,10,1,00405,India
386798,2023-06-01,206,yakult,360,400,40,1,00003,India
386798,2023-06-01,207,coca cola,75,100,25,1,00003,India
386798,2023-06-01,201,paneer,210,340,130,1,00003,India
223596,2023-06-01,209,pepsi,75,100,25,1,00224,India
223596,2023-06-01,206,yakult,360,400,40,1,00224,India
223596,2023-06-01,204,strawberry yogurt,50,60,10,1,00224,India
223596,2023-06-01,210,mountain dew,75,100,25,1,00224,India
553117,2023-06-01,213,bisleri,6,15,9,1,00378,India
553117,2023-06-01,201,paneer,210,340,130,1,00378,India
553117,2023-06-01,205,classic yogurt,45,60,15,1,00378,India
462844,2023-06-01,206,yakult,360,400,40,1,00074,India
207479,2023-06-01,209,pepsi,75,100,25,1,00123,India
207479,2023-06-01,213,bisleri,6,15,9,1,00123,India
207479,2023-06-01,212,amul cheese,250,315,65,1,00123,India
632810,2023-06-01,209,pepsi,75,100,25,1,00214,India
632810,2023-06-01,206,yakult,360,400,40,1,00214,India
632810,2023-06-01,212,amul cheese,250,315,65,1,00214,India
405195,2023-06-01,212,amul cheese,250,315,65,1,00494,India
405195,2023-06-01,207,coca cola,75,100,25,1,00494,India
405195,2023-06-01,206,yakult,360,400,40,1,00494,India
227845,2023-06-01,201,paneer,210,340,130,1,00071,India
227845,2023-06-01,210,mountain dew,75,100,25,1,00071,India
227845,2023-06-01,202,milk,12,27,15,1,00071,India
227845,2023-06-01,213,bisleri,6,15,9,1,00071,India
227845,2023-06-01,207,coca cola,75,100,25,1,00071,India
437867,2023-06-01,211,red bull,90,125,35,1,00342,India
437867,2023-06-01,210,mountain dew,75,100,25,1,00342,India
437867,2023-06-01,212,amul cheese,250,315,65,1,00342,India
183893,2023-06-01,201,paneer,210,340,130,1,00012,India
183893,2023-06-01,206,yakult,360,400,40,1,00012,India
183893,2023-06-01,208,sprite,75,100,25,1,00012,India
183893,2023-06-01,207,coca cola,75,100,25,1,00012,India
470298,2023-06-01,205,classic yogurt,45,60,15,1,00485,India
973842,2023-06-01,204,strawberry yogurt,50,60,10,1,00342,India
973842,2023-06-01,210,mountain dew,75,100,25,1,00342,India
468892,2023-06-01,202,milk,12,27,15,1,00401,India
166388,2023-06-01,205,classic yogurt,45,60,15,1,00045,India
166388,2023-06-01,209,pepsi,75,100,25,1,00045,India
868591,2023-06-01,207,coca cola,75,100,25,1,00092,India
868591,2023-06-01,203,mango yogurt,50,60,10,1,00092,India
868591,2023-06-01,201,paneer,210,340,130,1,00092,India
868591,2023-06-01,204,strawberry yogurt,50,60,10,1,00092,India
868591,2023-06-01,209,pepsi,75,100,25,1,00092,India
538224,2023-06-01,201,paneer,210,340,130,1,00414,India
538224,2023-06-01,203,mango yogurt,50,60,10,1,00414,India
538224,2023-06-01,210,mountain dew,75,100,25,1,00414,India
740887,2023-06-01,212,amul cheese,250,315,65,1,00488,India
121282,2023-06-01,212,amul cheese,250,315,65,1,00003,India
121282,2023-06-01,201,paneer,210,340,130,1,00003,India
121282,2023-06-01,204,strawberry yogurt,50,60,10,1,00003,India
121282,2023-06-01,202,milk,12,27,15,1,00003,India
121282,2023-06-01,205,classic yogurt,45,60,15,1,00003,India
196092,2023-06-01,202,milk,12,27,15,1,00412,India
196092,2023-06-01,207,coca cola,75,100,25,1,00412,India
196092,2023-06-01,210,mountain dew,75,100,25,1,00412,India
196092,2023-06-01,213,bisleri,6,15,9,1,00412,India
727029,2023-06-01,204,strawberry yogurt,50,60,10,1,00274,India
727029,2023-06-01,213,bisleri,6,15,9,1,00274,India
727029,2023-06-01,201,paneer,210,340,130,1,00274,India
283192,2023-06-01,212,amul cheese,250,315,65,1,00117,India
283192,2023-06-01,204,strawberry yogurt,50,60,10,1,00117,India
283192,2023-06-01,207,coca cola,75,100,25,1,00117,India
765348,2023-06-01,203,mango yogurt,50,60,10,1,00446,India
765348,2023-06-01,205,classic yogurt,45,60,15,1,00446,India
765348,2023-06-01,202,milk,12,27,15,1,00446,India
879912,2023-06-01,201,paneer,210,340,130,1,00039,India
879912,2023-06-01,210,mountain dew,75,100,25,1,00039,India
879912,2023-06-01,212,amul cheese,250,315,65,1,00039,India
879912,2023-06-01,211,red bull,90,125,35,1,00039,India
919821,2023-06-01,213,bisleri,6,15,9,1,00174,India
919821,2023-06-01,209,pepsi,75,100,25,1,00174,India
919821,2023-06-01,212,amul cheese,250,315,65,1,00174,India
817625,2023-06-01,205,classic yogurt,45,60,15,1,00220,India
254410,2023-06-01,210,mountain dew,75,100,25,1,00093,India
270990,2023-06-01,212,amul cheese,250,315,65,1,00432,India
270990,2023-06-01,206,yakult,360,400,40,1,00432,India
270990,2023-06-01,205,classic yogurt,45,60,15,1,00432,India
564930,2023-06-01,208,sprite,75,100,25,1,00499,India
293804,2023-06-01,213,bisleri,6,15,9,1,00409,India
293804,2023-06-01,212,amul cheese,250,315,65,1,00409,India
293804,2023-06-01,205,classic yogurt,45,60,15,1,00409,India
293804,2023-06-01,208,sprite,75,100,25,1,00409,India
696854,2023-06-01,208,sprite,75,100,25,1,00302,India
696854,2023-06-01,209,pepsi,75,100,25,1,00302,India
449937,2023-06-01,213,bisleri,6,15,9,1,00218,India
449937,2023-06-01,210,mountain dew,75,100,25,1,00218,India
449937,2023-06-01,208,sprite,75,100,25,1,00218,India
863315,2023-06-01,213,bisleri,6,15,9,1,00051,India
863315,2023-06-01,206,yakult,360,400,40,1,00051,India
863315,2023-06-01,211,red bull,90,125,35,1,00051,India
863315,2023-06-01,212,amul cheese,250,315,65,1,00051,India
863315,2023-06-01,210,mountain dew,75,100,25,1,00051,India
532982,2023-06-01,210,mountain dew,75,100,25,1,00229,India
532982,2023-06-01,212,amul cheese,250,315,65,1,00229,India
532982,2023-06-01,209,pepsi,75,100,25,1,00229,India
532982,2023-06-01,207,coca cola,75,100,25,1,00229,India
315259,2023-06-01,208,sprite,75,100,25,1,00264,India
315259,2023-06-01,201,paneer,210,340,130,1,00264,India
766633,2023-06-01,208,sprite,75,100,25,1,00160,India
911432,2023-06-01,212,amul cheese,250,315,65,1,00119,India
911432,2023-06-01,208,sprite,75,100,25,1,00119,India
911432,2023-06-01,209,pepsi,75,100,25,1,00119,India
550672,2023-06-01,213,bisleri,6,15,9,1,00461,India
550672,2023-06-01,212,amul cheese,250,315,65,1,00461,India
946931,2023-06-01,210,mountain dew,75,100,25,1,00133,India
946931,2023-06-01,206,yakult,360,400,40,1,00133,India
375772,2023-06-01,213,bisleri,6,15,9,1,00222,India
375772,2023-06-01,212,amul cheese,250,315,65,1,00222,India
375772,2023-06-01,209,pepsi,75,100,25,1,00222,India
375772,2023-06-01,208,sprite,75,100,25,1,00222,India
578931,2023-06-02,201,paneer,210,340,130,1,00471,India
578931,2023-06-02,210,mountain dew,75,100,25,1,00471,India
742995,2023-06-02,204,strawberry yogurt,50,60,10,1,00242,India
202607,2023-06-02,207,coca cola,75,100,25,1,00484,India
202607,2023-06-02,209,pepsi,75,100,25,1,00484,India
587008,2023-06-02,202,milk,12,27,15,1,00247,India
587008,2023-06-02,210,mountain dew,75,100,25,1,00247,India
587008,2023-06-02,209,pepsi,75,100,25,1,00247,India
587008,2023-06-02,211,red bull,90,125,35,1,00247,India
392459,2023-06-02,208,sprite,75,100,25,1,00417,India
392459,2023-06-02,206,yakult,360,400,40,1,00417,India
990658,2023-06-02,201,paneer,210,340,130,1,00226,India
990658,2023-06-02,207,coca cola,75,100,25,1,00226,India
990658,2023-06-02,213,bisleri,6,15,9,1,00226,India
990658,2023-06-02,211,red bull,90,125,35,1,00226,India
128904,2023-06-02,210,mountain dew,75,100,25,1,00188,India
655573,2023-06-02,203,mango yogurt,50,60,10,1,00059,India
655573,2023-06-02,207,coca cola,75,100,25,1,00059,India
529806,2023-06-02,211,red bull,90,125,35,1,00127,India
529806,2023-06-02,201,paneer,210,340,130,1,00127,India
966735,2023-06-02,206,yakult,360,400,40,1,00327,India
966735,2023-06-02,210,mountain dew,75,100,25,1,00327,India
966735,2023-06-02,207,coca cola,75,100,25,1,00327,India
966735,2023-06-02,201,paneer,210,340,130,1,00327,India
452697,2023-06-02,210,mountain dew,75,100,25,1,00054,India
344870,2023-06-02,202,milk,12,27,15,1,00035,India
416730,2023-06-02,204,strawberry yogurt,50,60,10,1,00206,India
416730,2023-06-02,209,pepsi,75,100,25,1,00206,India
416730,2023-06-02,206,yakult,360,400,40,1,00206,India
416730,2023-06-02,210,mountain dew,75,100,25,1,00206,India
236867,2023-06-02,201,paneer,210,340,130,1,00487,India
236867,2023-06-02,204,strawberry yogurt,50,60,10,1,00487,India
236867,2023-06-02,212,amul cheese,250,315,65,1,00487,India
236867,2023-06-02,209,pepsi,75,100,25,1,00487,India
236867,2023-06-02,208,sprite,75,100,25,1,00487,India
986020,2023-06-02,203,mango yogurt,50,60,10,1,00251,India
986020,2023-06-02,202,milk,12,27,15,1,00251,India
986020,2023-06-02,208,sprite,75,100,25,1,00251,India
986020,2023-06-02,211,red bull,90,125,35,1,00251,India
430731,2023-06-02,207,coca cola,75,100,25,1,00110,India
161385,2023-06-02,212,amul cheese,250,315,65,1,00048,India
161385,2023-06-02,210,mountain dew,75,100,25,1,00048,India
161385,2023-06-02,206,yakult,360,400,40,1,00048,India
938430,2023-06-02,211,red bull,90,125,35,1,00422,India
938430,2023-06-02,213,bisleri,6,15,9,1,00422,India
938430,2023-06-02,207,coca cola,75,100,25,1,00422,India
803755,2023-06-02,204,strawberry yogurt,50,60,10,1,00434,India
803755,2023-06-02,212,amul cheese,250,315,65,1,00434,India
711015,2023-06-02,210,mountain dew,75,100,25,1,00234,India
711015,2023-06-02,213,bisleri,6,15,9,1,00234,India
851836,2023-06-02,205,classic yogurt,45,60,15,1,00109,India
700422,2023-06-02,201,paneer,210,340,130,1,00027,India
700422,2023-06-02,209,pepsi,75,100,25,1,00027,India
700422,2023-06-02,210,mountain dew,75,100,25,1,00027,India
281321,2023-06-02,207,coca cola,75,100,25,1,00075,India
281321,2023-06-02,201,paneer,210,340,130,1,00075,India
246079,2023-06-02,201,paneer,210,340,130,1,00291,India
131780,2023-06-02,202,milk,12,27,15,1,00350,India
131780,2023-06-02,203,mango yogurt,50,60,10,1,00350,India
131780,2023-06-02,205,classic yogurt,45,60,15,1,00350,India
131780,2023-06-02,207,coca cola,75,100,25,1,00350,India
934848,2023-06-02,205,classic yogurt,45,60,15,1,00031,India
934848,2023-06-02,206,yakult,360,400,40,1,00031,India
934848,2023-06-02,211,red bull,90,125,35,1,00031,India
934848,2023-06-02,203,mango yogurt,50,60,10,1,00031,India
934848,2023-06-02,202,milk,12,27,15,1,00031,India
279083,2023-06-02,210,mountain dew,75,100,25,1,00287,India
279083,2023-06-02,201,paneer,210,340,130,1,00287,India
133612,2023-06-02,202,milk,12,27,15,1,00262,India
504031,2023-06-02,209,pepsi,75,100,25,1,00289,India
504031,2023-06-02,202,milk,12,27,15,1,00289,India
181826,2023-06-02,204,strawberry yogurt,50,60,10,1,00043,India
181826,2023-06-02,212,amul cheese,250,315,65,1,00043,India
892848,2023-06-02,206,yakult,360,400,40,1,00326,India
892848,2023-06-02,210,mountain dew,75,100,25,1,00326,India
892848,2023-06-02,213,bisleri,6,15,9,1,00326,India
741983,2023-06-02,211,red bull,90,125,35,1,00074,India
741983,2023-06-02,203,mango yogurt,50,60,10,1,00074,India
741983,2023-06-02,213,bisleri,6,15,9,1,00074,India
741983,2023-06-02,201,paneer,210,340,130,1,00074,India
700114,2023-06-02,206,yakult,360,400,40,1,00078,India
700114,2023-06-02,203,mango yogurt,50,60,10,1,00078,India
700114,2023-06-02,204,strawberry yogurt,50,60,10,1,00078,India
750777,2023-06-02,209,pepsi,75,100,25,1,00282,India
369275,2023-06-02,207,coca cola,75,100,25,1,00269,India
369275,2023-06-02,211,red bull,90,125,35,1,00269,India
369275,2023-06-02,204,strawberry yogurt,50,60,10,1,00269,India
369275,2023-06-02,205,classic yogurt,45,60,15,1,00269,India
464338,2023-06-02,213,bisleri,6,15,9,1,00242,India
464338,2023-06-02,204,strawberry yogurt,50,60,10,1,00242,India
182147,2023-06-02,210,mountain dew,75,100,25,1,00376,India
182147,2023-06-02,207,coca cola,75,100,25,1,00376,India
182147,2023-06-02,202,milk,12,27,15,1,00376,India
182147,2023-06-02,204,strawberry yogurt,50,60,10,1,00376,India
182147,2023-06-02,208,sprite,75,100,25,1,00376,India
740051,2023-06-02,202,milk,12,27,15,1,00297,India
740051,2023-06-02,212,amul cheese,250,315,65,1,00297,India
899657,2023-06-02,205,classic yogurt,45,60,15,1,00378,India
899657,2023-06-02,208,sprite,75,100,25,1,00378,India
899657,2023-06-02,213,bisleri,6,15,9,1,00378,India
899657,2023-06-02,212,amul cheese,250,315,65,1,00378,India
549894,2023-06-02,203,mango yogurt,50,60,10,1,00238,India
549894,2023-06-02,208,sprite,75,100,25,1,00238,India
549894,2023-06-02,210,mountain dew,75,100,25,1,00238,India
549894,2023-06-02,213,bisleri,6,15,9,1,00238,India
549894,2023-06-02,205,classic yogurt,45,60,15,1,00238,India
314066,2023-06-02,202,milk,12,27,15,1,00331,India
314066,2023-06-02,210,mountain dew,75,100,25,1,00331,India
261564,2023-06-02,204,strawberry yogurt,50,60,10,1,00129,India
882487,2023-06-02,204,strawberry yogurt,50,60,10,1,00268,India
882487,2023-06-02,201,paneer,210,340,130,1,00268,India
948533,2023-06-02,210,mountain dew,75,100,25,1,00096,India
948533,2023-06-02,204,strawberry yogurt,50,60,10,1,00096,India
948533,2023-06-02,213,bisleri,6,15,9,1,00096,India
948533,2023-06-02,209,pepsi,75,100,25,1,00096,India
948533,2023-06-02,205,classic yogurt,45,60,15,1,00096,India
681436,2023-06-02,211,red bull,90,125,35,1,00147,India
681436,2023-06-02,202,milk,12,27,15,1,00147,India
681436,2023-06-02,213,bisleri,6,15,9,1,00147,India
376475,2023-06-02,211,red bull,90,125,35,1,00130,India
376475,2023-06-02,206,yakult,360,400,40,1,00130,India
376475,2023-06-02,208,sprite,75,100,25,1,00130,India
946893,2023-06-02,206,yakult,360,400,40,1,00275,India
946893,2023-06-02,203,mango yogurt,50,60,10,1,00275,India
959531,2023-06-02,207,coca cola,75,100,25,1,00057,India
959531,2023-06-02,212,amul cheese,250,315,65,1,00057,India
999712,2023-06-02,209,pepsi,75,100,25,1,00118,India
999712,2023-06-02,205,classic yogurt,45,60,15,1,00118,India
999712,2023-06-02,203,mango yogurt,50,60,10,1,00118,India
999712,2023-06-02,208,sprite,75,100,25,1,00118,India
897784,2023-06-02,212,amul cheese,250,315,65,1,00389,India
897784,2023-06-02,205,classic yogurt,45,60,15,1,00389,India
281764,2023-06-02,202,milk,12,27,15,1,00045,India
281764,2023-06-02,213,bisleri,6,15,9,1,00045,India
281764,2023-06-02,212,amul cheese,250,315,65,1,00045,India
281764,2023-06-02,206,yakult,360,400,40,1,00045,India
281764,2023-06-02,205,classic yogurt,45,60,15,1,00045,India
878865,2023-06-02,213,bisleri,6,15,9,1,00222,India
878865,2023-06-02,211,red bull,90,125,35,1,00222,India
878865,2023-06-02,207,coca cola,75,100,25,1,00222,India
878865,2023-06-02,208,sprite,75,100,25,1,00222,India
878865,2023-06-02,202,milk,12,27,15,1,00222,India
794382,2023-06-02,204,strawberry yogurt,50,60,10,1,00440,India
794382,2023-06-02,207,coca cola,75,100,25,1,00440,India
651498,2023-06-02,204,strawberry yogurt,50,60,10,1,00097,India
651498,2023-06-02,207,coca cola,75,100,25,1,00097,India
651498,2023-06-02,206,yakult,360,400,40,1,00097,India
651498,2023-06-02,201,paneer,210,340,130,1,00097,India
769969,2023-06-02,213,bisleri,6,15,9,1,00382,India
452699,2023-06-02,213,bisleri,6,15,9,1,00310,India
351184,2023-06-02,202,milk,12,27,15,1,00266,India
616540,2023-06-02,212,amul cheese,250,315,65,1,00243,India
616540,2023-06-02,210,mountain dew,75,100,25,1,00243,India
616540,2023-06-02,205,classic yogurt,45,60,15,1,00243,India
521478,2023-06-02,207,coca cola,75,100,25,1,00498,India
521478,2023-06-02,213,bisleri,6,15,9,1,00498,India
521478,2023-06-02,205,classic yogurt,45,60,15,1,00498,India
773866,2023-06-02,212,amul cheese,250,315,65,1,00464,India
773866,2023-06-02,211,red bull,90,125,35,1,00464,India
773866,2023-06-02,204,strawberry yogurt,50,60,10,1,00464,India
773866,2023-06-02,213,bisleri,6,15,9,1,00464,India
359965,2023-06-02,205,classic yogurt,45,60,15,1,00192,India
359965,2023-06-02,211,red bull,90,125,35,1,00192,India
762428,2023-06-02,212,amul cheese,250,315,65,1,00359,India
762428,2023-06-02,211,red bull,90,125,35,1,00359,India
762428,2023-06-02,204,strawberry yogurt,50,60,10,1,00359,India
440778,2023-06-02,208,sprite,75,100,25,1,00454,India
440778,2023-06-02,211,red bull,90,125,35,1,00454,India
440778,2023-06-02,205,classic yogurt,45,60,15,1,00454,India
152766,2023-06-02,205,classic yogurt,45,60,15,1,00006,India
152766,2023-06-02,206,yakult,360,400,40,1,00006,India
672517,2023-06-02,213,bisleri,6,15,9,1,00156,India
672517,2023-06-02,209,pepsi,75,100,25,1,00156,India
672517,2023-06-02,205,classic yogurt,45,60,15,1,00156,India
672517,2023-06-02,210,mountain dew,75,100,25,1,00156,India
715961,2023-06-02,202,milk,12,27,15,1,00066,India
715961,2023-06-02,205,classic yogurt,45,60,15,1,00066,India
715961,2023-06-02,210,mountain dew,75,100,25,1,00066,India
715961,2023-06-02,201,paneer,210,340,130,1,00066,India
547573,2023-06-02,212,amul cheese,250,315,65,1,00131,India
547573,2023-06-02,205,classic yogurt,45,60,15,1,00131,India
942706,2023-06-02,209,pepsi,75,100,25,1,00073,India
942706,2023-06-02,206,yakult,360,400,40,1,00073,India
942706,2023-06-02,203,mango yogurt,50,60,10,1,00073,India
942706,2023-06-02,213,bisleri,6,15,9,1,00073,India
878387,2023-06-02,210,mountain dew,75,100,25,1,00005,India
691428,2023-06-02,209,pepsi,75,100,25,1,00257,India
691428,2023-06-02,210,mountain dew,75,100,25,1,00257,India
391123,2023-06-02,212,amul cheese,250,315,65,1,00250,India
391123,2023-06-02,205,classic yogurt,45,60,15,1,00250,India
391123,2023-06-02,211,red bull,90,125,35,1,00250,India
391123,2023-06-02,209,pepsi,75,100,25,1,00250,India
223236,2023-06-02,202,milk,12,27,15,1,00362,India
223236,2023-06-02,212,amul cheese,250,315,65,1,00362,India
223236,2023-06-02,210,mountain dew,75,100,25,1,00362,India
509566,2023-06-02,213,bisleri,6,15,9,1,00402,India
509566,2023-06-02,207,coca cola,75,100,25,1,00402,India
509566,2023-06-02,209,pepsi,75,100,25,1,00402,India
509566,2023-06-02,211,red bull,90,125,35,1,00402,India
559343,2023-06-02,208,sprite,75,100,25,1,00250,India
559343,2023-06-02,204,strawberry yogurt,50,60,10,1,00250,India
544251,2023-06-02,211,red bull,90,125,35,1,00039,India
544251,2023-06-02,208,sprite,75,100,25,1,00039,India
544251,2023-06-02,210,mountain dew,75,100,25,1,00039,India
544251,2023-06-02,209,pepsi,75,100,25,1,00039,India
523107,2023-06-02,203,mango yogurt,50,60,10,1,00184,India
131384,2023-06-02,211,red bull,90,125,35,1,00208,India
131384,2023-06-02,206,yakult,360,400,40,1,00208,India
131384,2023-06-02,207,coca cola,75,100,25,1,00208,India
131384,2023-06-02,201,paneer,210,340,130,1,00208,India
627350,2023-06-02,204,strawberry yogurt,50,60,10,1,00173,India
627350,2023-06-02,206,yakult,360,400,40,1,00173,India
627350,2023-06-02,213,bisleri,6,15,9,1,00173,India
653711,2023-06-02,212,amul cheese,250,315,65,1,00347,India
653711,2023-06-02,209,pepsi,75,100,25,1,00347,India
653711,2023-06-02,207,coca cola,75,100,25,1,00347,India
653711,2023-06-02,213,bisleri,6,15,9,1,00347,India
932935,2023-06-02,201,paneer,210,340,130,1,00009,India
959912,2023-06-02,212,amul cheese,250,315,65,1,00039,India
959912,2023-06-02,207,coca cola,75,100,25,1,00039,India
959912,2023-06-02,210,mountain dew,75,100,25,1,00039,India
234282,2023-06-02,204,strawberry yogurt,50,60,10,1,00186,India
234282,2023-06-02,207,coca cola,75,100,25,1,00186,India
234282,2023-06-02,213,bisleri,6,15,9,1,00186,India
234282,2023-06-02,205,classic yogurt,45,60,15,1,00186,India
787344,2023-06-02,208,sprite,75,100,25,1,00288,India
787344,2023-06-02,207,coca cola,75,100,25,1,00288,India
787344,2023-06-02,209,pepsi,75,100,25,1,00288,India
681676,2023-06-02,212,amul cheese,250,315,65,1,00025,India
681676,2023-06-02,205,classic yogurt,45,60,15,1,00025,India
681676,2023-06-02,210,mountain dew,75,100,25,1,00025,India
681676,2023-06-02,209,pepsi,75,100,25,1,00025,India
725386,2023-06-02,204,strawberry yogurt,50,60,10,1,00223,India
725386,2023-06-02,210,mountain dew,75,100,25,1,00223,India
725386,2023-06-02,206,yakult,360,400,40,1,00223,India
725386,2023-06-02,201,paneer,210,340,130,1,00223,India
826349,2023-06-02,205,classic yogurt,45,60,15,1,00329,India
826349,2023-06-02,206,yakult,360,400,40,1,00329,India
826349,2023-06-02,211,red bull,90,125,35,1,00329,India
305076,2023-06-02,213,bisleri,6,15,9,1,00294,India
190784,2023-06-02,212,amul cheese,250,315,65,1,00418,India
190784,2023-06-02,205,classic yogurt,45,60,15,1,00418,India
562099,2023-06-02,208,sprite,75,100,25,1,00128,India
562099,2023-06-02,209,pepsi,75,100,25,1,00128,India
562099,2023-06-02,202,milk,12,27,15,1,00128,India
243775,2023-06-02,210,mountain dew,75,100,25,1,00446,India
243775,2023-06-02,202,milk,12,27,15,1,00446,India
243775,2023-06-02,203,mango yogurt,50,60,10,1,00446,India
243775,2023-06-02,211,red bull,90,125,35,1,00446,India
562356,2023-06-02,201,paneer,210,340,130,1,00035,India
562356,2023-06-02,204,strawberry yogurt,50,60,10,1,00035,India
562356,2023-06-02,211,red bull,90,125,35,1,00035,India
737514,2023-06-02,203,mango yogurt,50,60,10,1,00015,India
737514,2023-06-02,213,bisleri,6,15,9,1,00015,India
737514,2023-06-02,211,red bull,90,125,35,1,00015,India
321056,2023-06-02,201,paneer,210,340,130,1,00439,India
321056,2023-06-02,204,strawberry yogurt,50,60,10,1,00439,India
321056,2023-06-02,207,coca cola,75,100,25,1,00439,India
232958,2023-06-02,210,mountain dew,75,100,25,1,00004,India
310865,2023-06-02,202,milk,12,27,15,1,00345,India
496526,2023-06-02,207,coca cola,75,100,25,1,00216,India
496526,2023-06-02,208,sprite,75,100,25,1,00216,India
496526,2023-06-02,212,amul cheese,250,315,65,1,00216,India
902705,2023-06-02,203,mango yogurt,50,60,10,1,00418,India
902705,2023-06-02,209,pepsi,75,100,25,1,00418,India
902705,2023-06-02,211,red bull,90,125,35,1,00418,India
902705,2023-06-02,206,yakult,360,400,40,1,00418,India
830752,2023-06-02,209,pepsi,75,100,25,1,00247,India
830752,2023-06-02,210,mountain dew,75,100,25,1,00247,India
830752,2023-06-02,208,sprite,75,100,25,1,00247,India
971933,2023-06-02,210,mountain dew,75,100,25,1,00140,India
381733,2023-06-02,209,pepsi,75,100,25,1,00203,India
381733,2023-06-02,212,amul cheese,250,315,65,1,00203,India
381733,2023-06-02,206,yakult,360,400,40,1,00203,India
185660,2023-06-03,211,red bull,90,125,35,1,00171,India
185660,2023-06-03,202,milk,12,27,15,1,00171,India
185660,2023-06-03,208,sprite,75,100,25,1,00171,India
185660,2023-06-03,210,mountain dew,75,100,25,1,00171,India
897347,2023-06-03,209,pepsi,75,100,25,1,00274,India
897347,2023-06-03,206,yakult,360,400,40,1,00274,India
897347,2023-06-03,203,mango yogurt,50,60,10,1,00274,India
897347,2023-06-03,211,red bull,90,125,35,1,00274,India
897347,2023-06-03,205,classic yogurt,45,60,15,1,00274,India
459611,2023-06-03,213,bisleri,6,15,9,1,00479,India
626349,2023-06-03,202,milk,12,27,15,1,00262,India
626349,2023-06-03,209,pepsi,75,100,25,1,00262,India
626349,2023-06-03,203,mango yogurt,50,60,10,1,00262,India
771890,2023-06-03,206,yakult,360,400,40,1,00458,India
507325,2023-06-03,206,yakult,360,400,40,1,00397,India
507325,2023-06-03,201,paneer,210,340,130,1,00397,India
507325,2023-06-03,207,coca cola,75,100,25,1,00397,India
345938,2023-06-03,209,pepsi,75,100,25,1,00059,India
345938,2023-06-03,208,sprite,75,100,25,1,00059,India
345938,2023-06-03,204,strawberry yogurt,50,60,10,1,00059,India
345938,2023-06-03,205,classic yogurt,45,60,15,1,00059,India
345938,2023-06-03,210,mountain dew,75,100,25,1,00059,India
309075,2023-06-03,207,coca cola,75,100,25,1,00445,India
309075,2023-06-03,202,milk,12,27,15,1,00445,India
241157,2023-06-03,205,classic yogurt,45,60,15,1,00008,India
241157,2023-06-03,210,mountain dew,75,100,25,1,00008,India
569530,2023-06-03,213,bisleri,6,15,9,1,00482,India
569530,2023-06-03,202,milk,12,27,15,1,00482,India
569530,2023-06-03,210,mountain dew,75,100,25,1,00482,India
569530,2023-06-03,211,red bull,90,125,35,1,00482,India
569530,2023-06-03,201,paneer,210,340,130,1,00482,India
827054,2023-06-03,205,classic yogurt,45,60,15,1,00219,India
827054,2023-06-03,204,strawberry yogurt,50,60,10,1,00219,India
827054,2023-06-03,209,pepsi,75,100,25,1,00219,India
827054,2023-06-03,202,milk,12,27,15,1,00219,India
912368,2023-06-03,202,milk,12,27,15,1,00183,India
912368,2023-06-03,212,amul cheese,250,315,65,1,00183,India
912368,2023-06-03,204,strawberry yogurt,50,60,10,1,00183,India
807660,2023-06-03,205,classic yogurt,45,60,15,1,00411,India
807660,2023-06-03,211,red bull,90,125,35,1,00411,India
807660,2023-06-03,209,pepsi,75,100,25,1,00411,India
855737,2023-06-03,208,sprite,75,100,25,1,00301,India
855737,2023-06-03,204,strawberry yogurt,50,60,10,1,00301,India
855737,2023-06-03,202,milk,12,27,15,1,00301,India
855737,2023-06-03,207,coca cola,75,100,25,1,00301,India
855737,2023-06-03,206,yakult,360,400,40,1,00301,India
403116,2023-06-03,211,red bull,90,125,35,1,00251,India
403116,2023-06-03,208,sprite,75,100,25,1,00251,India
403116,2023-06-03,207,coca cola,75,100,25,1,00251,India
976203,2023-06-03,203,mango yogurt,50,60,10,1,00186,India
976203,2023-06-03,205,classic yogurt,45,60,15,1,00186,India
155390,2023-06-03,208,sprite,75,100,25,1,00107,India
155390,2023-06-03,210,mountain dew,75,100,25,1,00107,India
155390,2023-06-03,209,pepsi,75,100,25,1,00107,India
155390,2023-06-03,203,mango yogurt,50,60,10,1,00107,India
982009,2023-06-03,204,strawberry yogurt,50,60,10,1,00200,India
982009,2023-06-03,211,red bull,90,125,35,1,00200,India
982009,2023-06-03,212,amul cheese,250,315,65,1,00200,India
982009,2023-06-03,203,mango yogurt,50,60,10,1,00200,India
319401,2023-06-03,205,classic yogurt,45,60,15,1,00149,India
319401,2023-06-03,202,milk,12,27,15,1,00149,India
319401,2023-06-03,207,coca cola,75,100,25,1,00149,India
319401,2023-06-03,210,mountain dew,75,100,25,1,00149,India
501423,2023-06-03,202,milk,12,27,15,1,00414,India
219646,2023-06-03,208,sprite,75,100,25,1,00273,India
219646,2023-06-03,202,milk,12,27,15,1,00273,India
432864,2023-06-03,209,pepsi,75,100,25,1,00228,India
355052,2023-06-03,211,red bull,90,125,35,1,00452,India
355052,2023-06-03,207,coca cola,75,100,25,1,00452,India
355052,2023-06-03,204,strawberry yogurt,50,60,10,1,00452,India
355052,2023-06-03,201,paneer,210,340,130,1,00452,India
355052,2023-06-03,212,amul cheese,250,315,65,1,00452,India
687821,2023-06-03,211,red bull,90,125,35,1,00047,India
687821,2023-06-03,207,coca cola,75,100,25,1,00047,India
687821,2023-06-03,205,classic yogurt,45,60,15,1,00047,India
532731,2023-06-03,211,red bull,90,125,35,1,00343,India
589248,2023-06-03,211,red bull,90,125,35,1,00499,India
589248,2023-06-03,209,pepsi,75,100,25,1,00499,India
589248,2023-06-03,204,strawberry yogurt,50,60,10,1,00499,India
456459,2023-06-03,209,pepsi,75,100,25,1,00230,India
456459,2023-06-03,208,sprite,75,100,25,1,00230,India
456459,2023-06-03,203,mango yogurt,50,60,10,1,00230,India
906179,2023-06-03,204,strawberry yogurt,50,60,10,1,00046,India
693114,2023-06-03,206,yakult,360,400,40,1,00335,India
693114,2023-06-03,202,milk,12,27,15,1,00335,India
693114,2023-06-03,205,classic yogurt,45,60,15,1,00335,India
996638,2023-06-03,209,pepsi,75,100,25,1,00068,India
996638,2023-06-03,204,strawberry yogurt,50,60,10,1,00068,India
996638,2023-06-03,213,bisleri,6,15,9,1,00068,India
708554,2023-06-03,202,milk,12,27,15,1,00058,India
708554,2023-06-03,212,amul cheese,250,315,65,1,00058,India
615056,2023-06-03,213,bisleri,6,15,9,1,00046,India
388665,2023-06-03,203,mango yogurt,50,60,10,1,00271,India
388665,2023-06-03,209,pepsi,75,100,25,1,00271,India
388665,2023-06-03,213,bisleri,6,15,9,1,00271,India
388665,2023-06-03,205,classic yogurt,45,60,15,1,00271,India
337862,2023-06-03,203,mango yogurt,50,60,10,1,00417,India
337862,2023-06-03,201,paneer,210,340,130,1,00417,India
337862,2023-06-03,210,mountain dew,75,100,25,1,00417,India
823881,2023-06-03,202,milk,12,27,15,1,00098,India
823881,2023-06-03,210,mountain dew,75,100,25,1,00098,India
823881,2023-06-03,209,pepsi,75,100,25,1,00098,India
728052,2023-06-03,210,mountain dew,75,100,25,1,00276,India
728052,2023-06-03,211,red bull,90,125,35,1,00276,India
728052,2023-06-03,212,amul cheese,250,315,65,1,00276,India
726387,2023-06-03,204,strawberry yogurt,50,60,10,1,00040,India
726387,2023-06-03,212,amul cheese,250,315,65,1,00040,India
726387,2023-06-03,203,mango yogurt,50,60,10,1,00040,India
726387,2023-06-03,205,classic yogurt,45,60,15,1,00040,India
707121,2023-06-03,202,milk,12,27,15,1,00415,India
707121,2023-06-03,207,coca cola,75,100,25,1,00415,India
707121,2023-06-03,208,sprite,75,100,25,1,00415,India
707121,2023-06-03,201,paneer,210,340,130,1,00415,India
707121,2023-06-03,209,pepsi,75,100,25,1,00415,India
197957,2023-06-03,207,coca cola,75,100,25,1,00076,India
197957,2023-06-03,203,mango yogurt,50,60,10,1,00076,India
197957,2023-06-03,204,strawberry yogurt,50,60,10,1,00076,India
197957,2023-06-03,208,sprite,75,100,25,1,00076,India
197957,2023-06-03,209,pepsi,75,100,25,1,00076,India
809136,2023-06-03,201,paneer,210,340,130,1,00330,India
809136,2023-06-03,212,amul cheese,250,315,65,1,00330,India
809136,2023-06-03,205,classic yogurt,45,60,15,1,00330,India
809136,2023-06-03,209,pepsi,75,100,25,1,00330,India
325738,2023-06-03,212,amul cheese,250,315,65,1,00399,India
325738,2023-06-03,203,mango yogurt,50,60,10,1,00399,India
325738,2023-06-03,210,mountain dew,75,100,25,1,00399,India
195622,2023-06-03,204,strawberry yogurt,50,60,10,1,00358,India
195622,2023-06-03,206,yakult,360,400,40,1,00358,India
195622,2023-06-03,201,paneer,210,340,130,1,00358,India
195622,2023-06-03,205,classic yogurt,45,60,15,1,00358,India
635815,2023-06-03,203,mango yogurt,50,60,10,1,00036,India
635815,2023-06-03,210,mountain dew,75,100,25,1,00036,India
635815,2023-06-03,208,sprite,75,100,25,1,00036,India
635815,2023-06-03,205,classic yogurt,45,60,15,1,00036,India
635815,2023-06-03,212,amul cheese,250,315,65,1,00036,India
634955,2023-06-03,213,bisleri,6,15,9,1,00108,India
634955,2023-06-03,203,mango yogurt,50,60,10,1,00108,India
634955,2023-06-03,202,milk,12,27,15,1,00108,India
634955,2023-06-03,207,coca cola,75,100,25,1,00108,India
860746,2023-06-03,208,sprite,75,100,25,1,00194,India
860746,2023-06-03,210,mountain dew,75,100,25,1,00194,India
860746,2023-06-03,207,coca cola,75,100,25,1,00194,India
860746,2023-06-03,204,strawberry yogurt,50,60,10,1,00194,India
873898,2023-06-03,206,yakult,360,400,40,1,00113,India
670799,2023-06-03,210,mountain dew,75,100,25,1,00236,India
670799,2023-06-03,205,classic yogurt,45,60,15,1,00236,India
484340,2023-06-03,206,yakult,360,400,40,1,00025,India
484340,2023-06-03,212,amul cheese,250,315,65,1,00025,India
484340,2023-06-03,210,mountain dew,75,100,25,1,00025,India
484340,2023-06-03,207,coca cola,75,100,25,1,00025,India
484340,2023-06-03,203,mango yogurt,50,60,10,1,00025,India
606528,2023-06-03,201,paneer,210,340,130,1,00299,India
606528,2023-06-03,207,coca cola,75,100,25,1,00299,India
606528,2023-06-03,205,classic yogurt,45,60,15,1,00299,India
936873,2023-06-03,207,coca cola,75,100,25,1,00335,India
936873,2023-06-03,206,yakult,360,400,40,1,00335,India
936873,2023-06-03,210,mountain dew,75,100,25,1,00335,India
936873,2023-06-03,209,pepsi,75,100,25,1,00335,India
885400,2023-06-03,208,sprite,75,100,25,1,00277,India
885400,2023-06-03,201,paneer,210,340,130,1,00277,India
855256,2023-06-03,211,red bull,90,125,35,1,00302,India
855256,2023-06-03,208,sprite,75,100,25,1,00302,India
716424,2023-06-03,205,classic yogurt,45,60,15,1,00037,India
716424,2023-06-03,207,coca cola,75,100,25,1,00037,India
221274,2023-06-03,204,strawberry yogurt,50,60,10,1,00261,India
221274,2023-06-03,202,milk,12,27,15,1,00261,India
610055,2023-06-03,210,mountain dew,75,100,25,1,00093,India
610055,2023-06-03,212,amul cheese,250,315,65,1,00093,India
610055,2023-06-03,208,sprite,75,100,25,1,00093,India
610055,2023-06-03,201,paneer,210,340,130,1,00093,India
676138,2023-06-03,207,coca cola,75,100,25,1,00175,India
901353,2023-06-03,209,pepsi,75,100,25,1,00422,India
901353,2023-06-03,201,paneer,210,340,130,1,00422,India
901353,2023-06-03,207,coca cola,75,100,25,1,00422,India
901353,2023-06-03,208,sprite,75,100,25,1,00422,India
901353,2023-06-03,202,milk,12,27,15,1,00422,India
557618,2023-06-03,205,classic yogurt,45,60,15,1,00490,India
557618,2023-06-03,210,mountain dew,75,100,25,1,00490,India
368137,2023-06-03,210,mountain dew,75,100,25,1,00280,India
230557,2023-06-03,205,classic yogurt,45,60,15,1,00406,India
230557,2023-06-03,201,paneer,210,340,130,1,00406,India
230557,2023-06-03,209,pepsi,75,100,25,1,00406,India
368676,2023-06-03,212,amul cheese,250,315,65,1,00456,India
181553,2023-06-03,209,pepsi,75,100,25,1,00100,India
181553,2023-06-03,205,classic yogurt,45,60,15,1,00100,India
181553,2023-06-03,213,bisleri,6,15,9,1,00100,India
181553,2023-06-03,203,mango yogurt,50,60,10,1,00100,India
415245,2023-06-03,212,amul cheese,250,315,65,1,00344,India
415245,2023-06-03,202,milk,12,27,15,1,00344,India
415245,2023-06-03,206,yakult,360,400,40,1,00344,India
415245,2023-06-03,207,coca cola,75,100,25,1,00344,India
678171,2023-06-03,208,sprite,75,100,25,1,00023,India
678171,2023-06-03,204,strawberry yogurt,50,60,10,1,00023,India
978169,2023-06-03,212,amul cheese,250,315,65,1,00052,India
978169,2023-06-03,205,classic yogurt,45,60,15,1,00052,India
978169,2023-06-03,202,milk,12,27,15,1,00052,India
324785,2023-06-03,205,classic yogurt,45,60,15,1,00377,India
324785,2023-06-03,212,amul cheese,250,315,65,1,00377,India
324785,2023-06-03,210,mountain dew,75,100,25,1,00377,India
324785,2023-06-03,206,yakult,360,400,40,1,00377,India
673310,2023-06-03,205,classic yogurt,45,60,15,1,00349,India
673310,2023-06-03,208,sprite,75,100,25,1,00349,India
673310,2023-06-03,207,coca cola,75,100,25,1,00349,India
630421,2023-06-03,206,yakult,360,400,40,1,00061,India
630421,2023-06-03,205,classic yogurt,45,60,15,1,00061,India
124012,2023-06-03,205,classic yogurt,45,60,15,1,00028,India
584789,2023-06-03,212,amul cheese,250,315,65,1,00137,India
584789,2023-06-03,213,bisleri,6,15,9,1,00137,India
640805,2023-06-03,206,yakult,360,400,40,1,00292,India
640805,2023-06-03,213,bisleri,6,15,9,1,00292,India
640805,2023-06-03,208,sprite,75,100,25,1,00292,India
640805,2023-06-03,205,classic yogurt,45,60,15,1,00292,India
230669,2023-06-03,203,mango yogurt,50,60,10,1,00016,India
230669,2023-06-03,207,coca cola,75,100,25,1,00016,India
230669,2023-06-03,208,sprite,75,100,25,1,00016,India
642407,2023-06-03,209,pepsi,75,100,25,1,00089,India
642407,2023-06-03,203,mango yogurt,50,60,10,1,00089,India
642407,2023-06-03,205,classic yogurt,45,60,15,1,00089,India
642407,2023-06-03,212,amul cheese,250,315,65,1,00089,India
464894,2023-06-03,201,paneer,210,340,130,1,00410,India
464894,2023-06-03,209,pepsi,75,100,25,1,00410,India
464894,2023-06-03,212,amul cheese,250,315,65,1,00410,India
984637,2023-06-03,201,paneer,210,340,130,1,00181,India
435274,2023-06-03,210,mountain dew,75,100,25,1,00184,India
435274,2023-06-03,204,strawberry yogurt,50,60,10,1,00184,India
762486,2023-06-03,208,sprite,75,100,25,1,00169,India
762486,2023-06-03,204,strawberry yogurt,50,60,10,1,00169,India
762486,2023-06-03,213,bisleri,6,15,9,1,00169,India
762486,2023-06-03,203,mango yogurt,50,60,10,1,00169,India
762486,2023-06-03,205,classic yogurt,45,60,15,1,00169,India
280770,2023-06-03,206,yakult,360,400,40,1,00340,India
280770,2023-06-03,204,strawberry yogurt,50,60,10,1,00340,India
280770,2023-06-03,201,paneer,210,340,130,1,00340,India
211340,2023-06-03,212,amul cheese,250,315,65,1,00213,India
211340,2023-06-03,210,mountain dew,75,100,25,1,00213,India
211340,2023-06-03,206,yakult,360,400,40,1,00213,India
371462,2023-06-03,212,amul cheese,250,315,65,1,00091,India
371462,2023-06-03,208,sprite,75,100,25,1,00091,India
782760,2023-06-03,210,mountain dew,75,100,25,1,00362,India
935808,2023-06-03,212,amul cheese,250,315,65,1,00084,India
249694,2023-06-03,204,strawberry yogurt,50,60,10,1,00298,India
249694,2023-06-03,202,milk,12,27,15,1,00298,India
249694,2023-06-03,207,coca cola,75,100,25,1,00298,India
249694,2023-06-03,211,red bull,90,125,35,1,00298,India
758469,2023-06-03,209,pepsi,75,100,25,1,00012,India
758469,2023-06-03,208,sprite,75,100,25,1,00012,India
758469,2023-06-03,202,milk,12,27,15,1,00012,India
576116,2023-06-03,209,pepsi,75,100,25,1,00369,India
206343,2023-06-03,210,mountain dew,75,100,25,1,00460,India
449898,2023-06-03,205,classic yogurt,45,60,15,1,00178,India
449898,2023-06-03,204,strawberry yogurt,50,60,10,1,00178,India
449898,2023-06-03,210,mountain dew,75,100,25,1,00178,India
830663,2023-06-03,211,red bull,90,125,35,1,00256,India
830663,2023-06-03,206,yakult,360,400,40,1,00256,India
593961,2023-06-04,207,coca cola,75,100,25,1,00119,India
593961,2023-06-04,210,mountain dew,75,100,25,1,00119,India
202310,2023-06-04,207,coca cola,75,100,25,1,00333,India
202310,2023-06-04,209,pepsi,75,100,25,1,00333,India
640076,2023-06-04,209,pepsi,75,100,25,1,00393,India
640076,2023-06-04,204,strawberry yogurt,50,60,10,1,00393,India
640076,2023-06-04,213,bisleri,6,15,9,1,00393,India
640076,2023-06-04,210,mountain dew,75,100,25,1,00393,India
285699,2023-06-04,212,amul cheese,250,315,65,1,00362,India
271311,2023-06-04,205,classic yogurt,45,60,15,1,00268,India
341718,2023-06-04,205,classic yogurt,45,60,15,1,00057,India
341718,2023-06-04,207,coca cola,75,100,25,1,00057,India
341718,2023-06-04,208,sprite,75,100,25,1,00057,India
723088,2023-06-04,209,pepsi,75,100,25,1,00310,India
723088,2023-06-04,201,paneer,210,340,130,1,00310,India
723088,2023-06-04,205,classic yogurt,45,60,15,1,00310,India
976801,2023-06-04,205,classic yogurt,45,60,15,1,00391,India
216906,2023-06-04,201,paneer,210,340,130,1,00259,India
216906,2023-06-04,213,bisleri,6,15,9,1,00259,India
216906,2023-06-04,208,sprite,75,100,25,1,00259,India
216906,2023-06-04,202,milk,12,27,15,1,00259,India
915152,2023-06-04,201,paneer,210,340,130,1,00039,India
915152,2023-06-04,204,strawberry yogurt,50,60,10,1,00039,India
915152,2023-06-04,213,bisleri,6,15,9,1,00039,India
706932,2023-06-04,204,strawberry yogurt,50,60,10,1,00454,India
706932,2023-06-04,206,yakult,360,400,40,1,00454,India
706932,2023-06-04,205,classic yogurt,45,60,15,1,00454,India
817089,2023-06-04,206,yakult,360,400,40,1,00077,India
817089,2023-06-04,212,amul cheese,250,315,65,1,00077,India
817089,2023-06-04,203,mango yogurt,50,60,10,1,00077,India
817089,2023-06-04,208,sprite,75,100,25,1,00077,India
817089,2023-06-04,202,milk,12,27,15,1,00077,India
643398,2023-06-04,203,mango yogurt,50,60,10,1,00284,India
643398,2023-06-04,212,amul cheese,250,315,65,1,00284,India
643398,2023-06-04,202,milk,12,27,15,1,00284,India
441532,2023-06-04,205,classic yogurt,45,60,15,1,00489,India
555900,2023-06-04,208,sprite,75,100,25,1,00370,India
555900,2023-06-04,205,classic yogurt,45,60,15,1,00370,India
170042,2023-06-04,201,paneer,210,340,130,1,00491,India
170042,2023-06-04,210,mountain dew,75,100,25,1,00491,India
170042,2023-06-04,205,classic yogurt,45,60,15,1,00491,India
939187,2023-06-04,210,mountain dew,75,100,25,1,00148,India
939187,2023-06-04,213,bisleri,6,15,9,1,00148,India
939187,2023-06-04,203,mango yogurt,50,60,10,1,00148,India
939187,2023-06-04,212,amul cheese,250,315,65,1,00148,India
939187,2023-06-04,211,red bull,90,125,35,1,00148,India
402605,2023-06-04,212,amul cheese,250,315,65,1,00114,India
402605,2023-06-04,204,strawberry yogurt,50,60,10,1,00114,India
290964,2023-06-04,211,red bull,90,125,35,1,00256,India
290964,2023-06-04,201,paneer,210,340,130,1,00256,India
290964,2023-06-04,208,sprite,75,100,25,1,00256,India
290964,2023-06-04,206,yakult,360,400,40,1,00256,India
118962,2023-06-04,205,classic yogurt,45,60,15,1,00208,India
118962,2023-06-04,209,pepsi,75,100,25,1,00208,India
118962,2023-06-04,201,paneer,210,340,130,1,00208,India
118962,2023-06-04,213,bisleri,6,15,9,1,00208,India
277299,2023-06-04,207,coca cola,75,100,25,1,00145,India
277299,2023-06-04,205,classic yogurt,45,60,15,1,00145,India
505604,2023-06-04,208,sprite,75,100,25,1,00020,India
505604,2023-06-04,206,yakult,360,400,40,1,00020,India
505604,2023-06-04,203,mango yogurt,50,60,10,1,00020,India
341974,2023-06-04,202,milk,12,27,15,1,00459,India
341974,2023-06-04,210,mountain dew,75,100,25,1,00459,India
341974,2023-06-04,207,coca cola,75,100,25,1,00459,India
341974,2023-06-04,212,amul cheese,250,315,65,1,00459,India
473494,2023-06-04,203,mango yogurt,50,60,10,1,00470,India
473494,2023-06-04,207,coca cola,75,100,25,1,00470,India
115318,2023-06-04,201,paneer,210,340,130,1,00029,India
115318,2023-06-04,211,red bull,90,125,35,1,00029,India
115318,2023-06-04,207,coca cola,75,100,25,1,00029,India
115318,2023-06-04,204,strawberry yogurt,50,60,10,1,00029,India
115318,2023-06-04,212,amul cheese,250,315,65,1,00029,India
628421,2023-06-04,212,amul cheese,250,315,65,1,00355,India
628421,2023-06-04,205,classic yogurt,45,60,15,1,00355,India
628421,2023-06-04,207,coca cola,75,100,25,1,00355,India
628421,2023-06-04,206,yakult,360,400,40,1,00355,India
539552,2023-06-04,211,red bull,90,125,35,1,00063,India
539552,2023-06-04,201,paneer,210,340,130,1,00063,India
539552,2023-06-04,205,classic yogurt,45,60,15,1,00063,India
539552,2023-06-04,210,mountain dew,75,100,25,1,00063,India
539552,2023-06-04,203,mango yogurt,50,60,10,1,00063,India
558372,2023-06-04,207,coca cola,75,100,25,1,00338,India
558372,2023-06-04,208,sprite,75,100,25,1,00338,India
558372,2023-06-04,206,yakult,360,400,40,1,00338,India
558372,2023-06-04,203,mango yogurt,50,60,10,1,00338,India
489291,2023-06-04,205,classic yogurt,45,60,15,1,00237,India
489291,2023-06-04,212,amul cheese,250,315,65,1,00237,India
796739,2023-06-04,213,bisleri,6,15,9,1,00140,India
796739,2023-06-04,212,amul cheese,250,315,65,1,00140,India
796739,2023-06-04,201,paneer,210,340,130,1,00140,India
796739,2023-06-04,209,pepsi,75,100,25,1,00140,India
735132,2023-06-04,207,coca cola,75,100,25,1,00126,India
304118,2023-06-04,204,strawberry yogurt,50,60,10,1,00415,India
304118,2023-06-04,213,bisleri,6,15,9,1,00415,India
304118,2023-06-04,212,amul cheese,250,315,65,1,00415,India
304118,2023-06-04,203,mango yogurt,50,60,10,1,00415,India
385327,2023-06-04,206,yakult,360,400,40,1,00490,India
385327,2023-06-04,202,milk,12,27,15,1,00490,India
385327,2023-06-04,210,mountain dew,75,100,25,1,00490,India
994358,2023-06-04,203,mango yogurt,50,60,10,1,00070,India
927125,2023-06-04,204,strawberry yogurt,50,60,10,1,00037,India
927125,2023-06-04,202,milk,12,27,15,1,00037,India
927125,2023-06-04,207,coca cola,75,100,25,1,00037,India
115637,2023-06-04,212,amul cheese,250,315,65,1,00457,India
814588,2023-06-04,206,yakult,360,400,40,1,00258,India
489309,2023-06-04,202,milk,12,27,15,1,00031,India
489309,2023-06-04,201,paneer,210,340,130,1,00031,India
489309,2023-06-04,204,strawberry yogurt,50,60,10,1,00031,India
489309,2023-06-04,213,bisleri,6,15,9,1,00031,India
248334,2023-06-04,210,mountain dew,75,100,25,1,00348,India
248334,2023-06-04,204,strawberry yogurt,50,60,10,1,00348,India
248334,2023-06-04,205,classic yogurt,45,60,15,1,00348,India
831503,2023-06-04,206,yakult,360,400,40,1,00478,India
831503,2023-06-04,207,coca cola,75,100,25,1,00478,India
326234,2023-06-04,211,red bull,90,125,35,1,00389,India
326234,2023-06-04,204,strawberry yogurt,50,60,10,1,00389,India
954419,2023-06-04,202,milk,12,27,15,1,00492,India
954419,2023-06-04,208,sprite,75,100,25,1,00492,India
972741,2023-06-04,206,yakult,360,400,40,1,00474,India
739136,2023-06-04,201,paneer,210,340,130,1,00364,India
169356,2023-06-04,201,paneer,210,340,130,1,00363,India
169356,2023-06-04,204,strawberry yogurt,50,60,10,1,00363,India
198184,2023-06-04,203,mango yogurt,50,60,10,1,00354,India
198184,2023-06-04,206,yakult,360,400,40,1,00354,India
198184,2023-06-04,201,paneer,210,340,130,1,00354,India
847582,2023-06-04,207,coca cola,75,100,25,1,00395,India
847582,2023-06-04,205,classic yogurt,45,60,15,1,00395,India
847582,2023-06-04,203,mango yogurt,50,60,10,1,00395,India
646160,2023-06-04,202,milk,12,27,15,1,00263,India
646160,2023-06-04,203,mango yogurt,50,60,10,1,00263,India
275692,2023-06-04,207,coca cola,75,100,25,1,00488,India
275692,2023-06-04,211,red bull,90,125,35,1,00488,India
275692,2023-06-04,205,classic yogurt,45,60,15,1,00488,India
453926,2023-06-04,205,classic yogurt,45,60,15,1,00491,India
645222,2023-06-04,210,mountain dew,75,100,25,1,00141,India
645222,2023-06-04,203,mango yogurt,50,60,10,1,00141,India
645222,2023-06-04,206,yakult,360,400,40,1,00141,India
645222,2023-06-04,208,sprite,75,100,25,1,00141,India
718548,2023-06-04,208,sprite,75,100,25,1,00306,India
718548,2023-06-04,206,yakult,360,400,40,1,00306,India
718548,2023-06-04,207,coca cola,75,100,25,1,00306,India
718548,2023-06-04,213,bisleri,6,15,9,1,00306,India
204970,2023-06-04,207,coca cola,75,100,25,1,00089,India
204970,2023-06-04,202,milk,12,27,15,1,00089,India
204970,2023-06-04,209,pepsi,75,100,25,1,00089,India
618863,2023-06-04,208,sprite,75,100,25,1,00386,India
618863,2023-06-04,209,pepsi,75,100,25,1,00386,India
610274,2023-06-04,212,amul cheese,250,315,65,1,00186,India
610274,2023-06-04,204,strawberry yogurt,50,60,10,1,00186,India
610274,2023-06-04,211,red bull,90,125,35,1,00186,India
610274,2023-06-04,210,mountain dew,75,100,25,1,00186,India
338190,2023-06-04,204,strawberry yogurt,50,60,10,1,00130,India
338190,2023-06-04,207,coca cola,75,100,25,1,00130,India
338190,2023-06-04,213,bisleri,6,15,9,1,00130,India
924221,2023-06-04,211,red bull,90,125,35,1,00270,India
924221,2023-06-04,213,bisleri,6,15,9,1,00270,India
924221,2023-06-04,206,yakult,360,400,40,1,00270,India
924221,2023-06-04,212,amul cheese,250,315,65,1,00270,India
359607,2023-06-04,201,paneer,210,340,130,1,00186,India
359607,2023-06-04,202,milk,12,27,15,1,00186,India
359607,2023-06-04,213,bisleri,6,15,9,1,00186,India
359607,2023-06-04,203,mango yogurt,50,60,10,1,00186,India
268269,2023-06-04,207,coca cola,75,100,25,1,00154,India
268269,2023-06-04,203,mango yogurt,50,60,10,1,00154,India
268269,2023-06-04,208,sprite,75,100,25,1,00154,India
268269,2023-06-04,210,mountain dew,75,100,25,1,00154,India
268269,2023-06-04,209,pepsi,75,100,25,1,00154,India
146685,2023-06-04,202,milk,12,27,15,1,00227,India
146685,2023-06-04,204,strawberry yogurt,50,60,10,1,00227,India
451500,2023-06-04,213,bisleri,6,15,9,1,00258,India
901544,2023-06-04,207,coca cola,75,100,25,1,00314,India
779419,2023-06-04,202,milk,12,27,15,1,00017,India
779419,2023-06-04,205,classic yogurt,45,60,15,1,00017,India
249865,2023-06-04,208,sprite,75,100,25,1,00262,India
660584,2023-06-04,208,sprite,75,100,25,1,00261,India
660584,2023-06-04,209,pepsi,75,100,25,1,00261,India
227638,2023-06-04,203,mango yogurt,50,60,10,1,00198,India
227638,2023-06-04,202,milk,12,27,15,1,00198,India
227638,2023-06-04,201,paneer,210,340,130,1,00198,India
227638,2023-06-04,212,amul cheese,250,315,65,1,00198,India
227638,2023-06-04,210,mountain dew,75,100,25,1,00198,India
518502,2023-06-04,208,sprite,75,100,25,1,00080,India
571340,2023-06-04,206,yakult,360,400,40,1,00396,India
571340,2023-06-04,202,milk,12,27,15,1,00396,India
571340,2023-06-04,211,red bull,90,125,35,1,00396,India
571340,2023-06-04,203,mango yogurt,50,60,10,1,00396,India
571340,2023-06-04,209,pepsi,75,100,25,1,00396,India
362079,2023-06-04,205,classic yogurt,45,60,15,1,00123,India
362079,2023-06-04,203,mango yogurt,50,60,10,1,00123,India
362079,2023-06-04,208,sprite,75,100,25,1,00123,India
496094,2023-06-04,212,amul cheese,250,315,65,1,00228,India
496094,2023-06-04,204,strawberry yogurt,50,60,10,1,00228,India
496094,2023-06-04,211,red bull,90,125,35,1,00228,India
671028,2023-06-04,209,pepsi,75,100,25,1,00478,India
725868,2023-06-04,201,paneer,210,340,130,1,00025,India
633777,2023-06-04,203,mango yogurt,50,60,10,1,00364,India
633777,2023-06-04,205,classic yogurt,45,60,15,1,00364,India
633777,2023-06-04,201,paneer,210,340,130,1,00364,India
203841,2023-06-04,201,paneer,210,340,130,1,00223,India
203841,2023-06-04,204,strawberry yogurt,50,60,10,1,00223,India
642183,2023-06-04,202,milk,12,27,15,1,00409,India
608272,2023-06-04,210,mountain dew,75,100,25,1,00456,India
608272,2023-06-04,204,strawberry yogurt,50,60,10,1,00456,India
608272,2023-06-04,205,classic yogurt,45,60,15,1,00456,India
608272,2023-06-04,212,amul cheese,250,315,65,1,00456,India
298767,2023-06-04,212,amul cheese,250,315,65,1,00123,India
298767,2023-06-04,209,pepsi,75,100,25,1,00123,India
880798,2023-06-04,209,pepsi,75,100,25,1,00387,India
880798,2023-06-04,201,paneer,210,340,130,1,00387,India
880798,2023-06-04,202,milk,12,27,15,1,00387,India
739803,2023-06-04,202,milk,12,27,15,1,00105,India
739803,2023-06-04,206,yakult,360,400,40,1,00105,India
739803,2023-06-04,201,paneer,210,340,130,1,00105,India
739803,2023-06-04,205,classic yogurt,45,60,15,1,00105,India
285292,2023-06-04,208,sprite,75,100,25,1,00415,India
285292,2023-06-04,211,red bull,90,125,35,1,00415,India
285292,2023-06-04,210,mountain dew,75,100,25,1,00415,India
510295,2023-06-04,202,milk,12,27,15,1,00156,India
510295,2023-06-04,203,mango yogurt,50,60,10,1,00156,India
510295,2023-06-04,206,yakult,360,400,40,1,00156,India
510295,2023-06-04,208,sprite,75,100,25,1,00156,India
510295,2023-06-04,204,strawberry yogurt,50,60,10,1,00156,India
819607,2023-06-04,204,strawberry yogurt,50,60,10,1,00181,India
819607,2023-06-04,202,milk,12,27,15,1,00181,India
942122,2023-06-04,212,amul cheese,250,315,65,1,00410,India
942122,2023-06-04,204,strawberry yogurt,50,60,10,1,00410,India
942122,2023-06-04,202,milk,12,27,15,1,00410,India
790822,2023-06-04,204,strawberry yogurt,50,60,10,1,00062,India
790822,2023-06-04,203,mango yogurt,50,60,10,1,00062,India
790822,2023-06-04,207,coca cola,75,100,25,1,00062,India
790822,2023-06-04,201,paneer,210,340,130,1,00062,India
790822,2023-06-04,206,yakult,360,400,40,1,00062,India
646198,2023-06-04,207,coca cola,75,100,25,1,00165,India
646198,2023-06-04,212,amul cheese,250,315,65,1,00165,India
646198,2023-06-04,209,pepsi,75,100,25,1,00165,India
740684,2023-06-04,213,bisleri,6,15,9,1,00037,India
626705,2023-06-05,212,amul cheese,250,315,65,1,00262,India
130355,2023-06-05,203,mango yogurt,50,60,10,1,00020,India
130355,2023-06-05,202,milk,12,27,15,1,00020,India
130355,2023-06-05,204,strawberry yogurt,50,60,10,1,00020,India
130355,2023-06-05,210,mountain dew,75,100,25,1,00020,India
130355,2023-06-05,211,red bull,90,125,35,1,00020,India
414999,2023-06-05,209,pepsi,75,100,25,1,00049,India
414999,2023-06-05,204,strawberry yogurt,50,60,10,1,00049,India
414999,2023-06-05,206,yakult,360,400,40,1,00049,India
414999,2023-06-05,201,paneer,210,340,130,1,00049,India
995361,2023-06-05,201,paneer,210,340,130,1,00396,India
995361,2023-06-05,209,pepsi,75,100,25,1,00396,India
995361,2023-06-05,207,coca cola,75,100,25,1,00396,India
995361,2023-06-05,208,sprite,75,100,25,1,00396,India
524665,2023-06-05,203,mango yogurt,50,60,10,1,00442,India
457143,2023-06-05,207,coca cola,75,100,25,1,00473,India
457143,2023-06-05,204,strawberry yogurt,50,60,10,1,00473,India
457143,2023-06-05,212,amul cheese,250,315,65,1,00473,India
525888,2023-06-05,202,milk,12,27,15,1,00234,India
525888,2023-06-05,205,classic yogurt,45,60,15,1,00234,India
219440,2023-06-05,210,mountain dew,75,100,25,1,00043,India
219440,2023-06-05,206,yakult,360,400,40,1,00043,India
219440,2023-06-05,209,pepsi,75,100,25,1,00043,India
219440,2023-06-05,203,mango yogurt,50,60,10,1,00043,India
320662,2023-06-05,202,milk,12,27,15,1,00498,India
320662,2023-06-05,206,yakult,360,400,40,1,00498,India
291475,2023-06-05,202,milk,12,27,15,1,00315,India
291475,2023-06-05,211,red bull,90,125,35,1,00315,India
291475,2023-06-05,208,sprite,75,100,25,1,00315,India
291475,2023-06-05,213,bisleri,6,15,9,1,00315,India
656096,2023-06-05,213,bisleri,6,15,9,1,00030,India
656096,2023-06-05,208,sprite,75,100,25,1,00030,India
656096,2023-06-05,202,milk,12,27,15,1,00030,India
656096,2023-06-05,206,yakult,360,400,40,1,00030,India
161016,2023-06-05,208,sprite,75,100,25,1,00079,India
161016,2023-06-05,202,milk,12,27,15,1,00079,India
161016,2023-06-05,204,strawberry yogurt,50,60,10,1,00079,India
976844,2023-06-05,204,strawberry yogurt,50,60,10,1,00400,India
976844,2023-06-05,205,classic yogurt,45,60,15,1,00400,India
976844,2023-06-05,202,milk,12,27,15,1,00400,India
736792,2023-06-05,203,mango yogurt,50,60,10,1,00102,India
736792,2023-06-05,210,mountain dew,75,100,25,1,00102,India
331722,2023-06-05,213,bisleri,6,15,9,1,00284,India
836892,2023-06-05,206,yakult,360,400,40,1,00376,India
836892,2023-06-05,211,red bull,90,125,35,1,00376,India
836892,2023-06-05,212,amul cheese,250,315,65,1,00376,India
770940,2023-06-05,205,classic yogurt,45,60,15,1,00473,India
770940,2023-06-05,212,amul cheese,250,315,65,1,00473,India
770940,2023-06-05,206,yakult,360,400,40,1,00473,India
151408,2023-06-05,205,classic yogurt,45,60,15,1,00208,India
151408,2023-06-05,203,mango yogurt,50,60,10,1,00208,India
295405,2023-06-05,210,mountain dew,75,100,25,1,00012,India
527433,2023-06-05,206,yakult,360,400,40,1,00407,India
527433,2023-06-05,210,mountain dew,75,100,25,1,00407,India
527433,2023-06-05,213,bisleri,6,15,9,1,00407,India
527433,2023-06-05,203,mango yogurt,50,60,10,1,00407,India
314402,2023-06-05,208,sprite,75,100,25,1,00444,India
962695,2023-06-05,205,classic yogurt,45,60,15,1,00119,India
962695,2023-06-05,204,strawberry yogurt,50,60,10,1,00119,India
962695,2023-06-05,210,mountain dew,75,100,25,1,00119,India
431058,2023-06-05,201,paneer,210,340,130,1,00151,India
431058,2023-06-05,213,bisleri,6,15,9,1,00151,India
431058,2023-06-05,208,sprite,75,100,25,1,00151,India
431058,2023-06-05,206,yakult,360,400,40,1,00151,India
760965,2023-06-05,210,mountain dew,75,100,25,1,00026,India
760965,2023-06-05,213,bisleri,6,15,9,1,00026,India
760965,2023-06-05,209,pepsi,75,100,25,1,00026,India
760965,2023-06-05,212,amul cheese,250,315,65,1,00026,India
760965,2023-06-05,205,classic yogurt,45,60,15,1,00026,India
687800,2023-06-05,204,strawberry yogurt,50,60,10,1,00081,India
555140,2023-06-05,206,yakult,360,400,40,1,00187,India
555140,2023-06-05,209,pepsi,75,100,25,1,00187,India
321860,2023-06-05,207,coca cola,75,100,25,1,00002,India
282767,2023-06-05,207,coca cola,75,100,25,1,00176,India
282767,2023-06-05,206,yakult,360,400,40,1,00176,India
282767,2023-06-05,211,red bull,90,125,35,1,00176,India
282767,2023-06-05,205,classic yogurt,45,60,15,1,00176,India
838419,2023-06-05,207,coca cola,75,100,25,1,00448,India
838419,2023-06-05,213,bisleri,6,15,9,1,00448,India
838419,2023-06-05,201,paneer,210,340,130,1,00448,India
838419,2023-06-05,212,amul cheese,250,315,65,1,00448,India
263398,2023-06-05,210,mountain dew,75,100,25,1,00224,India
263398,2023-06-05,205,classic yogurt,45,60,15,1,00224,India
604841,2023-06-05,209,pepsi,75,100,25,1,00493,India
648745,2023-06-05,205,classic yogurt,45,60,15,1,00031,India
648745,2023-06-05,202,milk,12,27,15,1,00031,India
648745,2023-06-05,210,mountain dew,75,100,25,1,00031,India
694474,2023-06-05,203,mango yogurt,50,60,10,1,00230,India
694474,2023-06-05,210,mountain dew,75,100,25,1,00230,India
694474,2023-06-05,213,bisleri,6,15,9,1,00230,India
557188,2023-06-05,208,sprite,75,100,25,1,00419,India
339492,2023-06-05,211,red bull,90,125,35,1,00413,India
339492,2023-06-05,203,mango yogurt,50,60,10,1,00413,India
339492,2023-06-05,208,sprite,75,100,25,1,00413,India
168606,2023-06-05,202,milk,12,27,15,1,00103,India
168606,2023-06-05,201,paneer,210,340,130,1,00103,India
168606,2023-06-05,205,classic yogurt,45,60,15,1,00103,India
944861,2023-06-05,208,sprite,75,100,25,1,00360,India
944861,2023-06-05,204,strawberry yogurt,50,60,10,1,00360,India
944861,2023-06-05,210,mountain dew,75,100,25,1,00360,India
704180,2023-06-05,204,strawberry yogurt,50,60,10,1,00231,India
271184,2023-06-05,210,mountain dew,75,100,25,1,00325,India
271184,2023-06-05,209,pepsi,75,100,25,1,00325,India
271184,2023-06-05,202,milk,12,27,15,1,00325,India
971073,2023-06-05,213,bisleri,6,15,9,1,00028,India
971073,2023-06-05,208,sprite,75,100,25,1,00028,India
971073,2023-06-05,202,milk,12,27,15,1,00028,India
971073,2023-06-05,211,red bull,90,125,35,1,00028,India
714947,2023-06-05,206,yakult,360,400,40,1,00143,India
714947,2023-06-05,201,paneer,210,340,130,1,00143,India
714947,2023-06-05,213,bisleri,6,15,9,1,00143,India
714947,2023-06-05,212,amul cheese,250,315,65,1,00143,India
700624,2023-06-05,202,milk,12,27,15,1,00416,India
700624,2023-06-05,209,pepsi,75,100,25,1,00416,India
700624,2023-06-05,203,mango yogurt,50,60,10,1,00416,India
755645,2023-06-05,213,bisleri,6,15,9,1,00025,India
755645,2023-06-05,212,amul cheese,250,315,65,1,00025,India
584081,2023-06-05,201,paneer,210,340,130,1,00041,India
584081,2023-06-05,202,milk,12,27,15,1,00041,India
584081,2023-06-05,212,amul cheese,250,315,65,1,00041,India
400593,2023-06-05,208,sprite,75,100,25,1,00166,India
400593,2023-06-05,206,yakult,360,400,40,1,00166,India
400593,2023-06-05,210,mountain dew,75,100,25,1,00166,India
586742,2023-06-05,206,yakult,360,400,40,1,00082,India
586742,2023-06-05,204,strawberry yogurt,50,60,10,1,00082,India
586742,2023-06-05,210,mountain dew,75,100,25,1,00082,India
294842,2023-06-05,202,milk,12,27,15,1,00467,India
294842,2023-06-05,207,coca cola,75,100,25,1,00467,India
294842,2023-06-05,203,mango yogurt,50,60,10,1,00467,India
475857,2023-06-05,207,coca cola,75,100,25,1,00483,India
925506,2023-06-05,201,paneer,210,340,130,1,00451,India
474605,2023-06-05,201,paneer,210,340,130,1,00047,India
474605,2023-06-05,210,mountain dew,75,100,25,1,00047,India
133663,2023-06-05,208,sprite,75,100,25,1,00277,India
133663,2023-06-05,209,pepsi,75,100,25,1,00277,India
133663,2023-06-05,207,coca cola,75,100,25,1,00277,India
901362,2023-06-05,208,sprite,75,100,25,1,00494,India
901362,2023-06-05,201,paneer,210,340,130,1,00494,India
901362,2023-06-05,209,pepsi,75,100,25,1,00494,India
901362,2023-06-05,207,coca cola,75,100,25,1,00494,India
901362,2023-06-05,204,strawberry yogurt,50,60,10,1,00494,India
815357,2023-06-05,205,classic yogurt,45,60,15,1,00472,India
815357,2023-06-05,203,mango yogurt,50,60,10,1,00472,India
297815,2023-06-05,211,red bull,90,125,35,1,00062,India
297815,2023-06-05,202,milk,12,27,15,1,00062,India
297815,2023-06-05,205,classic yogurt,45,60,15,1,00062,India
297815,2023-06-05,201,paneer,210,340,130,1,00062,India
523094,2023-06-05,212,amul cheese,250,315,65,1,00205,India
957065,2023-06-05,209,pepsi,75,100,25,1,00288,India
829086,2023-06-05,206,yakult,360,400,40,1,00189,India
471941,2023-06-05,204,strawberry yogurt,50,60,10,1,00047,India
471941,2023-06-05,210,mountain dew,75,100,25,1,00047,India
893879,2023-06-05,208,sprite,75,100,25,1,00200,India
893879,2023-06-05,205,classic yogurt,45,60,15,1,00200,India
851979,2023-06-05,206,yakult,360,400,40,1,00398,India
851979,2023-06-05,203,mango yogurt,50,60,10,1,00398,India
851979,2023-06-05,205,classic yogurt,45,60,15,1,00398,India
851979,2023-06-05,213,bisleri,6,15,9,1,00398,India
505362,2023-06-05,201,paneer,210,340,130,1,00382,India
505362,2023-06-05,213,bisleri,6,15,9,1,00382,India
505362,2023-06-05,209,pepsi,75,100,25,1,00382,India
505362,2023-06-05,210,mountain dew,75,100,25,1,00382,India
774394,2023-06-05,204,strawberry yogurt,50,60,10,1,00224,India
774394,2023-06-05,205,classic yogurt,45,60,15,1,00224,India
858382,2023-06-05,212,amul cheese,250,315,65,1,00234,India
858382,2023-06-05,213,bisleri,6,15,9,1,00234,India
858382,2023-06-05,211,red bull,90,125,35,1,00234,India
557924,2023-06-05,212,amul cheese,250,315,65,1,00105,India
557924,2023-06-05,207,coca cola,75,100,25,1,00105,India
557924,2023-06-05,204,strawberry yogurt,50,60,10,1,00105,India
557924,2023-06-05,213,bisleri,6,15,9,1,00105,India
380820,2023-06-05,211,red bull,90,125,35,1,00130,India
489774,2023-06-05,211,red bull,90,125,35,1,00042,India
489774,2023-06-05,206,yakult,360,400,40,1,00042,India
175159,2023-06-05,203,mango yogurt,50,60,10,1,00499,India
175159,2023-06-05,208,sprite,75,100,25,1,00499,India
175159,2023-06-05,205,classic yogurt,45,60,15,1,00499,India
175159,2023-06-05,213,bisleri,6,15,9,1,00499,India
278428,2023-06-05,201,paneer,210,340,130,1,00210,India
278428,2023-06-05,203,mango yogurt,50,60,10,1,00210,India
833576,2023-06-05,201,paneer,210,340,130,1,00112,India
833576,2023-06-05,208,sprite,75,100,25,1,00112,India
833576,2023-06-05,206,yakult,360,400,40,1,00112,India
278958,2023-06-05,201,paneer,210,340,130,1,00465,India
278958,2023-06-05,202,milk,12,27,15,1,00465,India
278958,2023-06-05,211,red bull,90,125,35,1,00465,India
564817,2023-06-05,203,mango yogurt,50,60,10,1,00093,India
564817,2023-06-05,206,yakult,360,400,40,1,00093,India
161929,2023-06-05,213,bisleri,6,15,9,1,00494,India
161929,2023-06-05,206,yakult,360,400,40,1,00494,India
393085,2023-06-05,206,yakult,360,400,40,1,00480,India
393085,2023-06-05,201,paneer,210,340,130,1,00480,India
393085,2023-06-05,204,strawberry yogurt,50,60,10,1,00480,India
393085,2023-06-05,213,bisleri,6,15,9,1,00480,India
157454,2023-06-05,211,red bull,90,125,35,1,00361,India
157454,2023-06-05,202,milk,12,27,15,1,00361,India
157454,2023-06-05,209,pepsi,75,100,25,1,00361,India
157454,2023-06-05,207,coca cola,75,100,25,1,00361,India
157454,2023-06-05,205,classic yogurt,45,60,15,1,00361,India
756064,2023-06-05,202,milk,12,27,15,1,00408,India
470074,2023-06-05,204,strawberry yogurt,50,60,10,1,00484,India
470074,2023-06-05,206,yakult,360,400,40,1,00484,India
470074,2023-06-05,210,mountain dew,75,100,25,1,00484,India
470074,2023-06-05,202,milk,12,27,15,1,00484,India
133222,2023-06-05,205,classic yogurt,45,60,15,1,00478,India
133222,2023-06-05,206,yakult,360,400,40,1,00478,India
643852,2023-06-05,213,bisleri,6,15,9,1,00178,India
643852,2023-06-05,204,strawberry yogurt,50,60,10,1,00178,India
643852,2023-06-05,206,yakult,360,400,40,1,00178,India
643852,2023-06-05,201,paneer,210,340,130,1,00178,India
863253,2023-06-06,207,coca cola,75,100,25,1,00120,India
981959,2023-06-06,204,strawberry yogurt,50,60,10,1,00275,India
981959,2023-06-06,205,classic yogurt,45,60,15,1,00275,India
981959,2023-06-06,203,mango yogurt,50,60,10,1,00275,India
554462,2023-06-06,201,paneer,210,340,130,1,00242,India
554462,2023-06-06,211,red bull,90,125,35,1,00242,India
554462,2023-06-06,204,strawberry yogurt,50,60,10,1,00242,India
554462,2023-06-06,203,mango yogurt,50,60,10,1,00242,India
367050,2023-06-06,205,classic yogurt,45,60,15,1,00351,India
367050,2023-06-06,209,pepsi,75,100,25,1,00351,India
367050,2023-06-06,211,red bull,90,125,35,1,00351,India
367050,2023-06-06,207,coca cola,75,100,25,1,00351,India
367050,2023-06-06,202,milk,12,27,15,1,00351,India
589446,2023-06-06,210,mountain dew,75,100,25,1,00127,India
589446,2023-06-06,209,pepsi,75,100,25,1,00127,India
589446,2023-06-06,212,amul cheese,250,315,65,1,00127,India
589446,2023-06-06,206,yakult,360,400,40,1,00127,India
765522,2023-06-06,203,mango yogurt,50,60,10,1,00276,India
765522,2023-06-06,211,red bull,90,125,35,1,00276,India
765522,2023-06-06,210,mountain dew,75,100,25,1,00276,India
894652,2023-06-06,204,strawberry yogurt,50,60,10,1,00410,India
894652,2023-06-06,205,classic yogurt,45,60,15,1,00410,India
894652,2023-06-06,213,bisleri,6,15,9,1,00410,India
806571,2023-06-06,203,mango yogurt,50,60,10,1,00174,India
806571,2023-06-06,202,milk,12,27,15,1,00174,India
681137,2023-06-06,208,sprite,75,100,25,1,00432,India
681137,2023-06-06,201,paneer,210,340,130,1,00432,India
681137,2023-06-06,212,amul cheese,250,315,65,1,00432,India
681137,2023-06-06,204,strawberry yogurt,50,60,10,1,00432,India
588693,2023-06-06,202,milk,12,27,15,1,00069,India
588693,2023-06-06,213,bisleri,6,15,9,1,00069,India
588693,2023-06-06,207,coca cola,75,100,25,1,00069,India
476341,2023-06-06,211,red bull,90,125,35,1,00092,India
476341,2023-06-06,201,paneer,210,340,130,1,00092,India
476341,2023-06-06,213,bisleri,6,15,9,1,00092,India
476341,2023-06-06,210,mountain dew,75,100,25,1,00092,India
436398,2023-06-06,206,yakult,360,400,40,1,00207,India
436398,2023-06-06,209,pepsi,75,100,25,1,00207,India
963687,2023-06-06,207,coca cola,75,100,25,1,00475,India
630860,2023-06-06,205,classic yogurt,45,60,15,1,00135,India
630860,2023-06-06,206,yakult,360,400,40,1,00135,India
240701,2023-06-06,211,red bull,90,125,35,1,00144,India
625921,2023-06-06,209,pepsi,75,100,25,1,00234,India
625921,2023-06-06,208,sprite,75,100,25,1,00234,India
625921,2023-06-06,202,milk,12,27,15,1,00234,India
625921,2023-06-06,211,red bull,90,125,35,1,00234,India
309133,2023-06-06,206,yakult,360,400,40,1,00393,India
999342,2023-06-06,203,mango yogurt,50,60,10,1,00171,India
699807,2023-06-06,206,yakult,360,400,40,1,00472,India
699807,2023-06-06,204,strawberry yogurt,50,60,10,1,00472,India
699807,2023-06-06,211,red bull,90,125,35,1,00472,India
911289,2023-06-06,204,strawberry yogurt,50,60,10,1,00298,India
911289,2023-06-06,202,milk,12,27,15,1,00298,India
911289,2023-06-06,211,red bull,90,125,35,1,00298,India
364333,2023-06-06,204,strawberry yogurt,50,60,10,1,00039,India
364333,2023-06-06,213,bisleri,6,15,9,1,00039,India
956363,2023-06-06,208,sprite,75,100,25,1,00394,India
956363,2023-06-06,202,milk,12,27,15,1,00394,India
631376,2023-06-06,213,bisleri,6,15,9,1,00449,India
631376,2023-06-06,205,classic yogurt,45,60,15,1,00449,India
671386,2023-06-06,205,classic yogurt,45,60,15,1,00010,India
671386,2023-06-06,211,red bull,90,125,35,1,00010,India
671386,2023-06-06,208,sprite,75,100,25,1,00010,India
671386,2023-06-06,206,yakult,360,400,40,1,00010,India
272184,2023-06-06,203,mango yogurt,50,60,10,1,00242,India
272184,2023-06-06,209,pepsi,75,100,25,1,00242,India
272184,2023-06-06,205,classic yogurt,45,60,15,1,00242,India
272184,2023-06-06,206,yakult,360,400,40,1,00242,India
330859,2023-06-06,209,pepsi,75,100,25,1,00210,India
330859,2023-06-06,213,bisleri,6,15,9,1,00210,India
330859,2023-06-06,202,milk,12,27,15,1,00210,India
334378,2023-06-06,205,classic yogurt,45,60,15,1,00331,India
334378,2023-06-06,203,mango yogurt,50,60,10,1,00331,India
334378,2023-06-06,207,coca cola,75,100,25,1,00331,India
334378,2023-06-06,208,sprite,75,100,25,1,00331,India
868934,2023-06-06,207,coca cola,75,100,25,1,00187,India
868934,2023-06-06,205,classic yogurt,45,60,15,1,00187,India
344035,2023-06-06,210,mountain dew,75,100,25,1,00056,India
982579,2023-06-06,203,mango yogurt,50,60,10,1,00098,India
982579,2023-06-06,213,bisleri,6,15,9,1,00098,India
982579,2023-06-06,210,mountain dew,75,100,25,1,00098,India
407933,2023-06-06,207,coca cola,75,100,25,1,00221,India
951769,2023-06-06,201,paneer,210,340,130,1,00255,India
232533,2023-06-06,205,classic yogurt,45,60,15,1,00341,India
232533,2023-06-06,210,mountain dew,75,100,25,1,00341,India
196487,2023-06-06,205,classic yogurt,45,60,15,1,00267,India
196487,2023-06-06,207,coca cola,75,100,25,1,00267,India
196487,2023-06-06,202,milk,12,27,15,1,00267,India
196487,2023-06-06,208,sprite,75,100,25,1,00267,India
196487,2023-06-06,201,paneer,210,340,130,1,00267,India
946652,2023-06-06,204,strawberry yogurt,50,60,10,1,00154,India
946652,2023-06-06,208,sprite,75,100,25,1,00154,India
806893,2023-06-06,211,red bull,90,125,35,1,00336,India
806893,2023-06-06,212,amul cheese,250,315,65,1,00336,India
806893,2023-06-06,208,sprite,75,100,25,1,00336,India
806893,2023-06-06,206,yakult,360,400,40,1,00336,India
806893,2023-06-06,201,paneer,210,340,130,1,00336,India
701560,2023-06-06,208,sprite,75,100,25,1,00475,India
701560,2023-06-06,202,milk,12,27,15,1,00475,India
701560,2023-06-06,204,strawberry yogurt,50,60,10,1,00475,India
770382,2023-06-06,202,milk,12,27,15,1,00095,India
770382,2023-06-06,207,coca cola,75,100,25,1,00095,India
475922,2023-06-06,207,coca cola,75,100,25,1,00062,India
475922,2023-06-06,202,milk,12,27,15,1,00062,India
629007,2023-06-06,201,paneer,210,340,130,1,00085,India
543027,2023-06-06,212,amul cheese,250,315,65,1,00284,India
543027,2023-06-06,203,mango yogurt,50,60,10,1,00284,India
543027,2023-06-06,209,pepsi,75,100,25,1,00284,India
543027,2023-06-06,201,paneer,210,340,130,1,00284,India
998110,2023-06-06,205,classic yogurt,45,60,15,1,00141,India
546934,2023-06-06,213,bisleri,6,15,9,1,00012,India
131347,2023-06-06,201,paneer,210,340,130,1,00126,India
969475,2023-06-06,204,strawberry yogurt,50,60,10,1,00188,India
969475,2023-06-06,205,classic yogurt,45,60,15,1,00188,India
969475,2023-06-06,209,pepsi,75,100,25,1,00188,India
969475,2023-06-06,202,milk,12,27,15,1,00188,India
720812,2023-06-06,203,mango yogurt,50,60,10,1,00021,India
918417,2023-06-06,201,paneer,210,340,130,1,00277,India
918417,2023-06-06,208,sprite,75,100,25,1,00277,India
918417,2023-06-06,202,milk,12,27,15,1,00277,India
636918,2023-06-06,209,pepsi,75,100,25,1,00219,India
636918,2023-06-06,212,amul cheese,250,315,65,1,00219,India
636918,2023-06-06,204,strawberry yogurt,50,60,10,1,00219,India
178279,2023-06-06,201,paneer,210,340,130,1,00450,India
178279,2023-06-06,207,coca cola,75,100,25,1,00450,India
117197,2023-06-06,208,sprite,75,100,25,1,00002,India
117197,2023-06-06,205,classic yogurt,45,60,15,1,00002,India
535538,2023-06-06,213,bisleri,6,15,9,1,00477,India
535538,2023-06-06,201,paneer,210,340,130,1,00477,India
535538,2023-06-06,206,yakult,360,400,40,1,00477,India
438859,2023-06-06,207,coca cola,75,100,25,1,00295,India
323667,2023-06-06,209,pepsi,75,100,25,1,00349,India
323667,2023-06-06,208,sprite,75,100,25,1,00349,India
323667,2023-06-06,201,paneer,210,340,130,1,00349,India
710379,2023-06-06,209,pepsi,75,100,25,1,00386,India
467284,2023-06-06,208,sprite,75,100,25,1,00049,India
467284,2023-06-06,212,amul cheese,250,315,65,1,00049,India
467284,2023-06-06,204,strawberry yogurt,50,60,10,1,00049,India
467284,2023-06-06,203,mango yogurt,50,60,10,1,00049,India
467284,2023-06-06,213,bisleri,6,15,9,1,00049,India
465635,2023-06-07,209,pepsi,75,100,25,1,00406,India
465635,2023-06-07,203,mango yogurt,50,60,10,1,00406,India
465635,2023-06-07,212,amul cheese,250,315,65,1,00406,India
414005,2023-06-07,213,bisleri,6,15,9,1,00064,India
414005,2023-06-07,206,yakult,360,400,40,1,00064,India
414005,2023-06-07,207,coca cola,75,100,25,1,00064,India
538301,2023-06-07,212,amul cheese,250,315,65,1,00390,India
538301,2023-06-07,208,sprite,75,100,25,1,00390,India
538301,2023-06-07,203,mango yogurt,50,60,10,1,00390,India
538301,2023-06-07,202,milk,12,27,15,1,00390,India
742108,2023-06-07,212,amul cheese,250,315,65,1,00442,India
742108,2023-06-07,210,mountain dew,75,100,25,1,00442,India
597423,2023-06-07,202,milk,12,27,15,1,00057,India
597423,2023-06-07,209,pepsi,75,100,25,1,00057,India
597423,2023-06-07,210,mountain dew,75,100,25,1,00057,India
221581,2023-06-07,211,red bull,90,125,35,1,00186,India
692429,2023-06-07,208,sprite,75,100,25,1,00124,India
692429,2023-06-07,212,amul cheese,250,315,65,1,00124,India
692429,2023-06-07,209,pepsi,75,100,25,1,00124,India
105687,2023-06-07,203,mango yogurt,50,60,10,1,00266,India
555477,2023-06-07,213,bisleri,6,15,9,1,00275,India
971178,2023-06-07,206,yakult,360,400,40,1,00126,India
971178,2023-06-07,211,red bull,90,125,35,1,00126,India
390361,2023-06-07,210,mountain dew,75,100,25,1,00331,India
892507,2023-06-07,208,sprite,75,100,25,1,00237,India
892507,2023-06-07,212,amul cheese,250,315,65,1,00237,India
892507,2023-06-07,206,yakult,360,400,40,1,00237,India
892507,2023-06-07,207,coca cola,75,100,25,1,00237,India
892507,2023-06-07,210,mountain dew,75,100,25,1,00237,India
620128,2023-06-07,201,paneer,210,340,130,1,00481,India
620128,2023-06-07,203,mango yogurt,50,60,10,1,00481,India
226784,2023-06-07,207,coca cola,75,100,25,1,00384,India
455210,2023-06-07,208,sprite,75,100,25,1,00127,India
455210,2023-06-07,204,strawberry yogurt,50,60,10,1,00127,India
623981,2023-06-07,201,paneer,210,340,130,1,00450,India
623981,2023-06-07,211,red bull,90,125,35,1,00450,India
623981,2023-06-07,210,mountain dew,75,100,25,1,00450,India
938193,2023-06-07,205,classic yogurt,45,60,15,1,00276,India
455673,2023-06-07,204,strawberry yogurt,50,60,10,1,00301,India
455673,2023-06-07,203,mango yogurt,50,60,10,1,00301,India
204853,2023-06-07,201,paneer,210,340,130,1,00299,India
204853,2023-06-07,213,bisleri,6,15,9,1,00299,India
204853,2023-06-07,205,classic yogurt,45,60,15,1,00299,India
204853,2023-06-07,206,yakult,360,400,40,1,00299,India
425009,2023-06-07,213,bisleri,6,15,9,1,00218,India
425009,2023-06-07,207,coca cola,75,100,25,1,00218,India
425009,2023-06-07,203,mango yogurt,50,60,10,1,00218,India
425009,2023-06-07,212,amul cheese,250,315,65,1,00218,India
791502,2023-06-07,209,pepsi,75,100,25,1,00432,India
791502,2023-06-07,202,milk,12,27,15,1,00432,India
791502,2023-06-07,212,amul cheese,250,315,65,1,00432,India
412091,2023-06-07,202,milk,12,27,15,1,00388,India
412091,2023-06-07,212,amul cheese,250,315,65,1,00388,India
412091,2023-06-07,209,pepsi,75,100,25,1,00388,India
418484,2023-06-07,203,mango yogurt,50,60,10,1,00187,India
418484,2023-06-07,201,paneer,210,340,130,1,00187,India
636744,2023-06-07,207,coca cola,75,100,25,1,00336,India
331894,2023-06-07,213,bisleri,6,15,9,1,00291,India
481912,2023-06-07,203,mango yogurt,50,60,10,1,00051,India
481912,2023-06-07,207,coca cola,75,100,25,1,00051,India
481912,2023-06-07,202,milk,12,27,15,1,00051,India
481912,2023-06-07,206,yakult,360,400,40,1,00051,India
350691,2023-06-07,205,classic yogurt,45,60,15,1,00296,India
350691,2023-06-07,204,strawberry yogurt,50,60,10,1,00296,India
580715,2023-06-07,205,classic yogurt,45,60,15,1,00378,India
580715,2023-06-07,206,yakult,360,400,40,1,00378,India
337951,2023-06-07,203,mango yogurt,50,60,10,1,00302,India
337951,2023-06-07,210,mountain dew,75,100,25,1,00302,India
635924,2023-06-07,209,pepsi,75,100,25,1,00187,India
635924,2023-06-07,213,bisleri,6,15,9,1,00187,India
635924,2023-06-07,208,sprite,75,100,25,1,00187,India
708808,2023-06-07,205,classic yogurt,45,60,15,1,00007,India
708808,2023-06-07,210,mountain dew,75,100,25,1,00007,India
708808,2023-06-07,207,coca cola,75,100,25,1,00007,India
708808,2023-06-07,204,strawberry yogurt,50,60,10,1,00007,India
604912,2023-06-07,204,strawberry yogurt,50,60,10,1,00468,India
604912,2023-06-07,210,mountain dew,75,100,25,1,00468,India
604912,2023-06-07,207,coca cola,75,100,25,1,00468,India
998792,2023-06-07,204,strawberry yogurt,50,60,10,1,00391,India
998792,2023-06-07,212,amul cheese,250,315,65,1,00391,India
334145,2023-06-07,203,mango yogurt,50,60,10,1,00155,India
334145,2023-06-07,210,mountain dew,75,100,25,1,00155,India
334145,2023-06-07,205,classic yogurt,45,60,15,1,00155,India
334145,2023-06-07,202,milk,12,27,15,1,00155,India
761401,2023-06-07,204,strawberry yogurt,50,60,10,1,00089,India
172766,2023-06-07,210,mountain dew,75,100,25,1,00234,India
469583,2023-06-07,204,strawberry yogurt,50,60,10,1,00046,India
469583,2023-06-07,212,amul cheese,250,315,65,1,00046,India
662138,2023-06-07,205,classic yogurt,45,60,15,1,00096,India
662138,2023-06-07,209,pepsi,75,100,25,1,00096,India
515239,2023-06-07,211,red bull,90,125,35,1,00199,India
515239,2023-06-07,213,bisleri,6,15,9,1,00199,India
515239,2023-06-07,205,classic yogurt,45,60,15,1,00199,India
515239,2023-06-07,209,pepsi,75,100,25,1,00199,India
896703,2023-06-07,204,strawberry yogurt,50,60,10,1,00383,India
896703,2023-06-07,210,mountain dew,75,100,25,1,00383,India
896703,2023-06-07,208,sprite,75,100,25,1,00383,India
666073,2023-06-07,202,milk,12,27,15,1,00078,India
666073,2023-06-07,205,classic yogurt,45,60,15,1,00078,India
879428,2023-06-07,201,paneer,210,340,130,1,00107,India
699560,2023-06-07,203,mango yogurt,50,60,10,1,00202,India
699560,2023-06-07,205,classic yogurt,45,60,15,1,00202,India
699560,2023-06-07,201,paneer,210,340,130,1,00202,India
557975,2023-06-07,206,yakult,360,400,40,1,00214,India
557975,2023-06-07,210,mountain dew,75,100,25,1,00214,India
557975,2023-06-07,203,mango yogurt,50,60,10,1,00214,India
112585,2023-06-07,209,pepsi,75,100,25,1,00487,India
112585,2023-06-07,203,mango yogurt,50,60,10,1,00487,India
112585,2023-06-07,207,coca cola,75,100,25,1,00487,India
186370,2023-06-07,210,mountain dew,75,100,25,1,00268,India
186370,2023-06-07,201,paneer,210,340,130,1,00268,India
195130,2023-06-07,209,pepsi,75,100,25,1,00223,India
339884,2023-06-07,212,amul cheese,250,315,65,1,00298,India
292623,2023-06-07,203,mango yogurt,50,60,10,1,00262,India
959397,2023-06-07,207,coca cola,75,100,25,1,00337,India
135466,2023-06-07,209,pepsi,75,100,25,1,00468,India
135466,2023-06-07,205,classic yogurt,45,60,15,1,00468,India
135466,2023-06-07,212,amul cheese,250,315,65,1,00468,India
135466,2023-06-07,206,yakult,360,400,40,1,00468,India
281065,2023-06-07,207,coca cola,75,100,25,1,00327,India
281065,2023-06-07,205,classic yogurt,45,60,15,1,00327,India
281065,2023-06-07,209,pepsi,75,100,25,1,00327,India
281065,2023-06-07,211,red bull,90,125,35,1,00327,India
160910,2023-06-07,205,classic yogurt,45,60,15,1,00128,India
160910,2023-06-07,211,red bull,90,125,35,1,00128,India
160910,2023-06-07,208,sprite,75,100,25,1,00128,India
903952,2023-06-07,209,pepsi,75,100,25,1,00096,India
903952,2023-06-07,210,mountain dew,75,100,25,1,00096,India
903952,2023-06-07,212,amul cheese,250,315,65,1,00096,India
196541,2023-06-07,203,mango yogurt,50,60,10,1,00268,India
196541,2023-06-07,209,pepsi,75,100,25,1,00268,India
238665,2023-06-07,212,amul cheese,250,315,65,1,00174,India
238665,2023-06-07,210,mountain dew,75,100,25,1,00174,India
238665,2023-06-07,213,bisleri,6,15,9,1,00174,India
359745,2023-06-07,206,yakult,360,400,40,1,00492,India
359745,2023-06-07,201,paneer,210,340,130,1,00492,India
359745,2023-06-07,207,coca cola,75,100,25,1,00492,India
359745,2023-06-07,209,pepsi,75,100,25,1,00492,India
636796,2023-06-07,205,classic yogurt,45,60,15,1,00245,India
636796,2023-06-07,210,mountain dew,75,100,25,1,00245,India
636796,2023-06-07,207,coca cola,75,100,25,1,00245,India
636796,2023-06-07,213,bisleri,6,15,9,1,00245,India
501634,2023-06-07,205,classic yogurt,45,60,15,1,00374,India
501634,2023-06-07,207,coca cola,75,100,25,1,00374,India
662980,2023-06-07,204,strawberry yogurt,50,60,10,1,00210,India
483361,2023-06-07,211,red bull,90,125,35,1,00026,India
678482,2023-06-07,201,paneer,210,340,130,1,00458,India
678482,2023-06-07,209,pepsi,75,100,25,1,00458,India
678482,2023-06-07,211,red bull,90,125,35,1,00458,India
678482,2023-06-07,204,strawberry yogurt,50,60,10,1,00458,India
650975,2023-06-07,208,sprite,75,100,25,1,00282,India
650975,2023-06-07,206,yakult,360,400,40,1,00282,India
650975,2023-06-07,211,red bull,90,125,35,1,00282,India
174601,2023-06-07,208,sprite,75,100,25,1,00104,India
174601,2023-06-07,202,milk,12,27,15,1,00104,India
174601,2023-06-07,204,strawberry yogurt,50,60,10,1,00104,India
294143,2023-06-07,211,red bull,90,125,35,1,00461,India
393190,2023-06-07,209,pepsi,75,100,25,1,00057,India
393190,2023-06-07,206,yakult,360,400,40,1,00057,India
393190,2023-06-07,204,strawberry yogurt,50,60,10,1,00057,India
573948,2023-06-07,209,pepsi,75,100,25,1,00323,India
573948,2023-06-07,203,mango yogurt,50,60,10,1,00323,India
573948,2023-06-07,213,bisleri,6,15,9,1,00323,India
134059,2023-06-07,213,bisleri,6,15,9,1,00498,India
134059,2023-06-07,206,yakult,360,400,40,1,00498,India
577162,2023-06-07,206,yakult,360,400,40,1,00414,India
577162,2023-06-07,211,red bull,90,125,35,1,00414,India
651047,2023-06-07,203,mango yogurt,50,60,10,1,00425,India
903283,2023-06-07,205,classic yogurt,45,60,15,1,00147,India
316093,2023-06-07,202,milk,12,27,15,1,00500,India
650572,2023-06-07,207,coca cola,75,100,25,1,00411,India
650572,2023-06-07,205,classic yogurt,45,60,15,1,00411,India
650572,2023-06-07,213,bisleri,6,15,9,1,00411,India
650572,2023-06-07,206,yakult,360,400,40,1,00411,India
650572,2023-06-07,201,paneer,210,340,130,1,00411,India
578509,2023-06-07,202,milk,12,27,15,1,00215,India
578509,2023-06-07,204,strawberry yogurt,50,60,10,1,00215,India
578509,2023-06-07,210,mountain dew,75,100,25,1,00215,India
543091,2023-06-07,207,coca cola,75,100,25,1,00322,India
543091,2023-06-07,205,classic yogurt,45,60,15,1,00322,India
543091,2023-06-07,203,mango yogurt,50,60,10,1,00322,India
278121,2023-06-07,202,milk,12,27,15,1,00241,India
278121,2023-06-07,204,strawberry yogurt,50,60,10,1,00241,India
278121,2023-06-07,210,mountain dew,75,100,25,1,00241,India
278121,2023-06-07,208,sprite,75,100,25,1,00241,India
990923,2023-06-07,205,classic yogurt,45,60,15,1,00376,India
990923,2023-06-07,203,mango yogurt,50,60,10,1,00376,India
990923,2023-06-07,211,red bull,90,125,35,1,00376,India
990923,2023-06-07,201,paneer,210,340,130,1,00376,India
990923,2023-06-07,207,coca cola,75,100,25,1,00376,India
431901,2023-06-07,203,mango yogurt,50,60,10,1,00148,India
431901,2023-06-07,208,sprite,75,100,25,1,00148,India
431901,2023-06-07,212,amul cheese,250,315,65,1,00148,India
563286,2023-06-07,208,sprite,75,100,25,1,00047,India
563286,2023-06-07,211,red bull,90,125,35,1,00047,India
684454,2023-06-07,213,bisleri,6,15,9,1,00290,India
684454,2023-06-07,207,coca cola,75,100,25,1,00290,India
684454,2023-06-07,212,amul cheese,250,315,65,1,00290,India
684454,2023-06-07,204,strawberry yogurt,50,60,10,1,00290,India
332663,2023-06-07,208,sprite,75,100,25,1,00130,India
332663,2023-06-07,210,mountain dew,75,100,25,1,00130,India
332663,2023-06-07,206,yakult,360,400,40,1,00130,India
332663,2023-06-07,213,bisleri,6,15,9,1,00130,India
332663,2023-06-07,202,milk,12,27,15,1,00130,India
549823,2023-06-07,204,strawberry yogurt,50,60,10,1,00169,India
549823,2023-06-07,202,milk,12,27,15,1,00169,India
549823,2023-06-07,207,coca cola,75,100,25,1,00169,India
549823,2023-06-07,212,amul cheese,250,315,65,1,00169,India
601072,2023-06-07,202,milk,12,27,15,1,00174,India
601072,2023-06-07,205,classic yogurt,45,60,15,1,00174,India
601072,2023-06-07,213,bisleri,6,15,9,1,00174,India
601072,2023-06-07,201,paneer,210,340,130,1,00174,India
601072,2023-06-07,207,coca cola,75,100,25,1,00174,India
200829,2023-06-07,208,sprite,75,100,25,1,00267,India
200829,2023-06-07,201,paneer,210,340,130,1,00267,India
354202,2023-06-07,208,sprite,75,100,25,1,00033,India
354202,2023-06-07,204,strawberry yogurt,50,60,10,1,00033,India
354202,2023-06-07,203,mango yogurt,50,60,10,1,00033,India
354202,2023-06-07,206,yakult,360,400,40,1,00033,India
618977,2023-06-08,206,yakult,360,400,40,1,00473,India
618977,2023-06-08,212,amul cheese,250,315,65,1,00473,India
618977,2023-06-08,201,paneer,210,340,130,1,00473,India
618977,2023-06-08,211,red bull,90,125,35,1,00473,India
618977,2023-06-08,203,mango yogurt,50,60,10,1,00473,India
652816,2023-06-08,211,red bull,90,125,35,1,00089,India
652816,2023-06-08,213,bisleri,6,15,9,1,00089,India
546914,2023-06-08,211,red bull,90,125,35,1,00147,India
546914,2023-06-08,206,yakult,360,400,40,1,00147,India
546914,2023-06-08,207,coca cola,75,100,25,1,00147,India
546914,2023-06-08,203,mango yogurt,50,60,10,1,00147,India
344755,2023-06-08,205,classic yogurt,45,60,15,1,00160,India
169884,2023-06-08,213,bisleri,6,15,9,1,00302,India
169884,2023-06-08,209,pepsi,75,100,25,1,00302,India
169884,2023-06-08,211,red bull,90,125,35,1,00302,India
169884,2023-06-08,210,mountain dew,75,100,25,1,00302,India
169884,2023-06-08,204,strawberry yogurt,50,60,10,1,00302,India
696404,2023-06-08,207,coca cola,75,100,25,1,00279,India
696404,2023-06-08,203,mango yogurt,50,60,10,1,00279,India
696404,2023-06-08,210,mountain dew,75,100,25,1,00279,India
696404,2023-06-08,212,amul cheese,250,315,65,1,00279,India
847136,2023-06-08,206,yakult,360,400,40,1,00478,India
847136,2023-06-08,207,coca cola,75,100,25,1,00478,India
648582,2023-06-08,209,pepsi,75,100,25,1,00263,India
648582,2023-06-08,206,yakult,360,400,40,1,00263,India
587040,2023-06-08,213,bisleri,6,15,9,1,00115,India
223445,2023-06-08,206,yakult,360,400,40,1,00125,India
223445,2023-06-08,202,milk,12,27,15,1,00125,India
223445,2023-06-08,213,bisleri,6,15,9,1,00125,India
285022,2023-06-08,205,classic yogurt,45,60,15,1,00141,India
285022,2023-06-08,203,mango yogurt,50,60,10,1,00141,India
285022,2023-06-08,212,amul cheese,250,315,65,1,00141,India
285022,2023-06-08,207,coca cola,75,100,25,1,00141,India
342748,2023-06-08,208,sprite,75,100,25,1,00451,India
342748,2023-06-08,210,mountain dew,75,100,25,1,00451,India
627264,2023-06-08,206,yakult,360,400,40,1,00041,India
627264,2023-06-08,211,red bull,90,125,35,1,00041,India
940840,2023-06-08,212,amul cheese,250,315,65,1,00102,India
940840,2023-06-08,201,paneer,210,340,130,1,00102,India
775565,2023-06-08,211,red bull,90,125,35,1,00262,India
775565,2023-06-08,201,paneer,210,340,130,1,00262,India
747143,2023-06-08,204,strawberry yogurt,50,60,10,1,00456,India
747143,2023-06-08,212,amul cheese,250,315,65,1,00456,India
747143,2023-06-08,208,sprite,75,100,25,1,00456,India
747143,2023-06-08,202,milk,12,27,15,1,00456,India
131381,2023-06-08,202,milk,12,27,15,1,00053,India
131381,2023-06-08,213,bisleri,6,15,9,1,00053,India
131381,2023-06-08,206,yakult,360,400,40,1,00053,India
556272,2023-06-08,210,mountain dew,75,100,25,1,00188,India
245198,2023-06-08,207,coca cola,75,100,25,1,00232,India
245198,2023-06-08,213,bisleri,6,15,9,1,00232,India
312585,2023-06-08,204,strawberry yogurt,50,60,10,1,00378,India
312585,2023-06-08,205,classic yogurt,45,60,15,1,00378,India
685866,2023-06-08,203,mango yogurt,50,60,10,1,00150,India
286022,2023-06-08,209,pepsi,75,100,25,1,00134,India
286022,2023-06-08,203,mango yogurt,50,60,10,1,00134,India
286022,2023-06-08,212,amul cheese,250,315,65,1,00134,India
286022,2023-06-08,207,coca cola,75,100,25,1,00134,India
286022,2023-06-08,210,mountain dew,75,100,25,1,00134,India
638337,2023-06-08,206,yakult,360,400,40,1,00249,India
398212,2023-06-08,213,bisleri,6,15,9,1,00014,India
398212,2023-06-08,204,strawberry yogurt,50,60,10,1,00014,India
291106,2023-06-08,203,mango yogurt,50,60,10,1,00024,India
291106,2023-06-08,205,classic yogurt,45,60,15,1,00024,India
291106,2023-06-08,208,sprite,75,100,25,1,00024,India
867473,2023-06-08,208,sprite,75,100,25,1,00241,India
867473,2023-06-08,206,yakult,360,400,40,1,00241,India
867473,2023-06-08,207,coca cola,75,100,25,1,00241,India
501020,2023-06-08,210,mountain dew,75,100,25,1,00299,India
501020,2023-06-08,201,paneer,210,340,130,1,00299,India
501020,2023-06-08,204,strawberry yogurt,50,60,10,1,00299,India
900438,2023-06-08,208,sprite,75,100,25,1,00011,India
900438,2023-06-08,202,milk,12,27,15,1,00011,India
902117,2023-06-08,211,red bull,90,125,35,1,00218,India
902117,2023-06-08,203,mango yogurt,50,60,10,1,00218,India
934073,2023-06-08,210,mountain dew,75,100,25,1,00334,India
934073,2023-06-08,201,paneer,210,340,130,1,00334,India
503449,2023-06-08,205,classic yogurt,45,60,15,1,00030,India
503449,2023-06-08,202,milk,12,27,15,1,00030,India
503449,2023-06-08,207,coca cola,75,100,25,1,00030,India
503449,2023-06-08,213,bisleri,6,15,9,1,00030,India
870340,2023-06-08,208,sprite,75,100,25,1,00358,India
722897,2023-06-08,205,classic yogurt,45,60,15,1,00292,India
722897,2023-06-08,204,strawberry yogurt,50,60,10,1,00292,India
722897,2023-06-08,201,paneer,210,340,130,1,00292,India
722897,2023-06-08,208,sprite,75,100,25,1,00292,India
924039,2023-06-08,210,mountain dew,75,100,25,1,00197,India
924039,2023-06-08,207,coca cola,75,100,25,1,00197,India
418203,2023-06-08,210,mountain dew,75,100,25,1,00149,India
418203,2023-06-08,202,milk,12,27,15,1,00149,India
418203,2023-06-08,201,paneer,210,340,130,1,00149,India
604069,2023-06-08,205,classic yogurt,45,60,15,1,00478,India
604069,2023-06-08,204,strawberry yogurt,50,60,10,1,00478,India
604069,2023-06-08,212,amul cheese,250,315,65,1,00478,India
604069,2023-06-08,210,mountain dew,75,100,25,1,00478,India
604069,2023-06-08,213,bisleri,6,15,9,1,00478,India
128532,2023-06-08,203,mango yogurt,50,60,10,1,00031,India
846462,2023-06-08,205,classic yogurt,45,60,15,1,00477,India
389156,2023-06-08,203,mango yogurt,50,60,10,1,00252,India
389156,2023-06-08,205,classic yogurt,45,60,15,1,00252,India
389156,2023-06-08,201,paneer,210,340,130,1,00252,India
167490,2023-06-08,204,strawberry yogurt,50,60,10,1,00130,India
167490,2023-06-08,207,coca cola,75,100,25,1,00130,India
167490,2023-06-08,203,mango yogurt,50,60,10,1,00130,India
167490,2023-06-08,211,red bull,90,125,35,1,00130,India
698957,2023-06-08,210,mountain dew,75,100,25,1,00172,India
533747,2023-06-08,204,strawberry yogurt,50,60,10,1,00072,India
263536,2023-06-08,212,amul cheese,250,315,65,1,00055,India
700671,2023-06-08,203,mango yogurt,50,60,10,1,00314,India
700671,2023-06-08,205,classic yogurt,45,60,15,1,00314,India
700671,2023-06-08,209,pepsi,75,100,25,1,00314,India
700671,2023-06-08,210,mountain dew,75,100,25,1,00314,India
700671,2023-06-08,211,red bull,90,125,35,1,00314,India
368899,2023-06-08,208,sprite,75,100,25,1,00453,India
368899,2023-06-08,205,classic yogurt,45,60,15,1,00453,India
368899,2023-06-08,210,mountain dew,75,100,25,1,00453,India
368899,2023-06-08,203,mango yogurt,50,60,10,1,00453,India
152154,2023-06-08,203,mango yogurt,50,60,10,1,00082,India
210542,2023-06-08,210,mountain dew,75,100,25,1,00265,India
210542,2023-06-08,208,sprite,75,100,25,1,00265,India
210542,2023-06-08,213,bisleri,6,15,9,1,00265,India
529895,2023-06-08,210,mountain dew,75,100,25,1,00458,India
529895,2023-06-08,208,sprite,75,100,25,1,00458,India
529895,2023-06-08,201,paneer,210,340,130,1,00458,India
529895,2023-06-08,212,amul cheese,250,315,65,1,00458,India
529895,2023-06-08,211,red bull,90,125,35,1,00458,India
247803,2023-06-08,209,pepsi,75,100,25,1,00238,India
247803,2023-06-08,213,bisleri,6,15,9,1,00238,India
247803,2023-06-08,208,sprite,75,100,25,1,00238,India
235720,2023-06-08,209,pepsi,75,100,25,1,00164,India
235720,2023-06-08,203,mango yogurt,50,60,10,1,00164,India
814375,2023-06-09,204,strawberry yogurt,50,60,10,1,00061,India
814375,2023-06-09,213,bisleri,6,15,9,1,00061,India
814375,2023-06-09,201,paneer,210,340,130,1,00061,India
814375,2023-06-09,205,classic yogurt,45,60,15,1,00061,India
874410,2023-06-09,202,milk,12,27,15,1,00104,India
874410,2023-06-09,212,amul cheese,250,315,65,1,00104,India
874410,2023-06-09,201,paneer,210,340,130,1,00104,India
874410,2023-06-09,211,red bull,90,125,35,1,00104,India
855872,2023-06-09,210,mountain dew,75,100,25,1,00208,India
264337,2023-06-09,209,pepsi,75,100,25,1,00275,India
264337,2023-06-09,213,bisleri,6,15,9,1,00275,India
264337,2023-06-09,201,paneer,210,340,130,1,00275,India
264337,2023-06-09,211,red bull,90,125,35,1,00275,India
853454,2023-06-09,210,mountain dew,75,100,25,1,00055,India
853454,2023-06-09,209,pepsi,75,100,25,1,00055,India
853454,2023-06-09,205,classic yogurt,45,60,15,1,00055,India
588275,2023-06-09,206,yakult,360,400,40,1,00363,India
588275,2023-06-09,203,mango yogurt,50,60,10,1,00363,India
588275,2023-06-09,205,classic yogurt,45,60,15,1,00363,India
588275,2023-06-09,210,mountain dew,75,100,25,1,00363,India
406817,2023-06-09,207,coca cola,75,100,25,1,00136,India
406817,2023-06-09,208,sprite,75,100,25,1,00136,India
585715,2023-06-09,213,bisleri,6,15,9,1,00026,India
416688,2023-06-09,203,mango yogurt,50,60,10,1,00356,India
416688,2023-06-09,204,strawberry yogurt,50,60,10,1,00356,India
416688,2023-06-09,201,paneer,210,340,130,1,00356,India
416688,2023-06-09,211,red bull,90,125,35,1,00356,India
416688,2023-06-09,209,pepsi,75,100,25,1,00356,India
761132,2023-06-09,203,mango yogurt,50,60,10,1,00256,India
816586,2023-06-09,209,pepsi,75,100,25,1,00459,India
834356,2023-06-09,208,sprite,75,100,25,1,00301,India
834356,2023-06-09,204,strawberry yogurt,50,60,10,1,00301,India
849363,2023-06-09,210,mountain dew,75,100,25,1,00012,India
849363,2023-06-09,209,pepsi,75,100,25,1,00012,India
849363,2023-06-09,204,strawberry yogurt,50,60,10,1,00012,India
907728,2023-06-09,202,milk,12,27,15,1,00106,India
907728,2023-06-09,203,mango yogurt,50,60,10,1,00106,India
907728,2023-06-09,211,red bull,90,125,35,1,00106,India
619433,2023-06-09,205,classic yogurt,45,60,15,1,00056,India
619433,2023-06-09,203,mango yogurt,50,60,10,1,00056,India
639525,2023-06-09,204,strawberry yogurt,50,60,10,1,00247,India
639525,2023-06-09,202,milk,12,27,15,1,00247,India
639525,2023-06-09,207,coca cola,75,100,25,1,00247,India
639525,2023-06-09,206,yakult,360,400,40,1,00247,India
935742,2023-06-09,206,yakult,360,400,40,1,00346,India
935742,2023-06-09,203,mango yogurt,50,60,10,1,00346,India
935742,2023-06-09,209,pepsi,75,100,25,1,00346,India
935742,2023-06-09,208,sprite,75,100,25,1,00346,India
935742,2023-06-09,201,paneer,210,340,130,1,00346,India
365565,2023-06-09,208,sprite,75,100,25,1,00379,India
365565,2023-06-09,209,pepsi,75,100,25,1,00379,India
365565,2023-06-09,204,strawberry yogurt,50,60,10,1,00379,India
434288,2023-06-09,208,sprite,75,100,25,1,00312,India
434288,2023-06-09,205,classic yogurt,45,60,15,1,00312,India
434288,2023-06-09,206,yakult,360,400,40,1,00312,India
434288,2023-06-09,203,mango yogurt,50,60,10,1,00312,India
999721,2023-06-09,205,classic yogurt,45,60,15,1,00304,India
899002,2023-06-09,209,pepsi,75,100,25,1,00237,India
899002,2023-06-09,207,coca cola,75,100,25,1,00237,India
899002,2023-06-09,210,mountain dew,75,100,25,1,00237,India
165983,2023-06-09,206,yakult,360,400,40,1,00455,India
818898,2023-06-09,204,strawberry yogurt,50,60,10,1,00199,India
818898,2023-06-09,211,red bull,90,125,35,1,00199,India
486095,2023-06-09,213,bisleri,6,15,9,1,00463,India
486095,2023-06-09,205,classic yogurt,45,60,15,1,00463,India
330112,2023-06-09,212,amul cheese,250,315,65,1,00318,India
330112,2023-06-09,206,yakult,360,400,40,1,00318,India
330112,2023-06-09,207,coca cola,75,100,25,1,00318,India
330112,2023-06-09,203,mango yogurt,50,60,10,1,00318,India
330112,2023-06-09,208,sprite,75,100,25,1,00318,India
112604,2023-06-09,207,coca cola,75,100,25,1,00135,India
112604,2023-06-09,206,yakult,360,400,40,1,00135,India
139112,2023-06-09,210,mountain dew,75,100,25,1,00465,India
139112,2023-06-09,206,yakult,360,400,40,1,00465,India
139112,2023-06-09,209,pepsi,75,100,25,1,00465,India
139112,2023-06-09,211,red bull,90,125,35,1,00465,India
911860,2023-06-09,207,coca cola,75,100,25,1,00291,India
549407,2023-06-09,204,strawberry yogurt,50,60,10,1,00405,India
549407,2023-06-09,207,coca cola,75,100,25,1,00405,India
910518,2023-06-09,210,mountain dew,75,100,25,1,00393,India
910518,2023-06-09,201,paneer,210,340,130,1,00393,India
910518,2023-06-09,213,bisleri,6,15,9,1,00393,India
910518,2023-06-09,207,coca cola,75,100,25,1,00393,India
703854,2023-06-09,208,sprite,75,100,25,1,00233,India
852597,2023-06-09,213,bisleri,6,15,9,1,00154,India
852597,2023-06-09,206,yakult,360,400,40,1,00154,India
852597,2023-06-09,211,red bull,90,125,35,1,00154,India
852597,2023-06-09,210,mountain dew,75,100,25,1,00154,India
852597,2023-06-09,204,strawberry yogurt,50,60,10,1,00154,India
625962,2023-06-09,208,sprite,75,100,25,1,00323,India
625962,2023-06-09,202,milk,12,27,15,1,00323,India
625962,2023-06-09,212,amul cheese,250,315,65,1,00323,India
166835,2023-06-09,204,strawberry yogurt,50,60,10,1,00435,India
166835,2023-06-09,209,pepsi,75,100,25,1,00435,India
776407,2023-06-09,205,classic yogurt,45,60,15,1,00096,India
776407,2023-06-09,209,pepsi,75,100,25,1,00096,India
546019,2023-06-09,213,bisleri,6,15,9,1,00366,India
546019,2023-06-09,212,amul cheese,250,315,65,1,00366,India
648692,2023-06-09,204,strawberry yogurt,50,60,10,1,00074,India
648692,2023-06-09,209,pepsi,75,100,25,1,00074,India
221159,2023-06-09,206,yakult,360,400,40,1,00294,India
221159,2023-06-09,212,amul cheese,250,315,65,1,00294,India
221159,2023-06-09,204,strawberry yogurt,50,60,10,1,00294,India
836361,2023-06-09,201,paneer,210,340,130,1,00394,India
836361,2023-06-09,205,classic yogurt,45,60,15,1,00394,India
836361,2023-06-09,204,strawberry yogurt,50,60,10,1,00394,India
836361,2023-06-09,212,amul cheese,250,315,65,1,00394,India
638122,2023-06-09,204,strawberry yogurt,50,60,10,1,00489,India
638122,2023-06-09,209,pepsi,75,100,25,1,00489,India
638122,2023-06-09,203,mango yogurt,50,60,10,1,00489,India
233493,2023-06-09,207,coca cola,75,100,25,1,00132,India
233493,2023-06-09,203,mango yogurt,50,60,10,1,00132,India
233493,2023-06-09,211,red bull,90,125,35,1,00132,India
233493,2023-06-09,202,milk,12,27,15,1,00132,India
233493,2023-06-09,209,pepsi,75,100,25,1,00132,India
338698,2023-06-09,211,red bull,90,125,35,1,00366,India
338698,2023-06-09,212,amul cheese,250,315,65,1,00366,India
338698,2023-06-09,201,paneer,210,340,130,1,00366,India
641182,2023-06-09,209,pepsi,75,100,25,1,00285,India
641182,2023-06-09,203,mango yogurt,50,60,10,1,00285,India
641182,2023-06-09,210,mountain dew,75,100,25,1,00285,India
641182,2023-06-09,213,bisleri,6,15,9,1,00285,India
998836,2023-06-09,202,milk,12,27,15,1,00089,India
928477,2023-06-09,206,yakult,360,400,40,1,00163,India
928477,2023-06-09,212,amul cheese,250,315,65,1,00163,India
928477,2023-06-09,208,sprite,75,100,25,1,00163,India
717489,2023-06-09,206,yakult,360,400,40,1,00178,India
717489,2023-06-09,208,sprite,75,100,25,1,00178,India
717489,2023-06-09,212,amul cheese,250,315,65,1,00178,India
167841,2023-06-09,213,bisleri,6,15,9,1,00449,India
167841,2023-06-09,208,sprite,75,100,25,1,00449,India
398506,2023-06-09,203,mango yogurt,50,60,10,1,00254,India
398506,2023-06-09,209,pepsi,75,100,25,1,00254,India
590988,2023-06-09,207,coca cola,75,100,25,1,00140,India
590988,2023-06-09,213,bisleri,6,15,9,1,00140,India
342628,2023-06-09,209,pepsi,75,100,25,1,00441,India
342628,2023-06-09,201,paneer,210,340,130,1,00441,India
600118,2023-06-09,209,pepsi,75,100,25,1,00234,India
600118,2023-06-09,208,sprite,75,100,25,1,00234,India
448467,2023-06-09,212,amul cheese,250,315,65,1,00068,India
655245,2023-06-09,206,yakult,360,400,40,1,00399,India
470827,2023-06-09,204,strawberry yogurt,50,60,10,1,00415,India
470827,2023-06-09,203,mango yogurt,50,60,10,1,00415,India
470827,2023-06-09,206,yakult,360,400,40,1,00415,India
470827,2023-06-09,210,mountain dew,75,100,25,1,00415,India
556697,2023-06-09,205,classic yogurt,45,60,15,1,00140,India
556697,2023-06-09,204,strawberry yogurt,50,60,10,1,00140,India
730400,2023-06-09,204,strawberry yogurt,50,60,10,1,00218,India
730400,2023-06-09,203,mango yogurt,50,60,10,1,00218,India
730400,2023-06-09,205,classic yogurt,45,60,15,1,00218,India
730400,2023-06-09,213,bisleri,6,15,9,1,00218,India
969340,2023-06-09,205,classic yogurt,45,60,15,1,00412,India
969340,2023-06-09,210,mountain dew,75,100,25,1,00412,India
969340,2023-06-09,207,coca cola,75,100,25,1,00412,India
969340,2023-06-09,208,sprite,75,100,25,1,00412,India
311280,2023-06-09,206,yakult,360,400,40,1,00075,India
311280,2023-06-09,212,amul cheese,250,315,65,1,00075,India
859713,2023-06-09,208,sprite,75,100,25,1,00412,India
859713,2023-06-09,205,classic yogurt,45,60,15,1,00412,India
859713,2023-06-09,211,red bull,90,125,35,1,00412,India
859713,2023-06-09,207,coca cola,75,100,25,1,00412,India
256183,2023-06-09,207,coca cola,75,100,25,1,00430,India
178053,2023-06-09,206,yakult,360,400,40,1,00466,India
178053,2023-06-09,202,milk,12,27,15,1,00466,India
178053,2023-06-09,203,mango yogurt,50,60,10,1,00466,India
178053,2023-06-09,208,sprite,75,100,25,1,00466,India
566627,2023-06-09,202,milk,12,27,15,1,00199,India
566627,2023-06-09,210,mountain dew,75,100,25,1,00199,India
566627,2023-06-09,201,paneer,210,340,130,1,00199,India
370806,2023-06-09,204,strawberry yogurt,50,60,10,1,00362,India
370806,2023-06-09,202,milk,12,27,15,1,00362,India
370806,2023-06-09,203,mango yogurt,50,60,10,1,00362,India
370806,2023-06-09,213,bisleri,6,15,9,1,00362,India
141778,2023-06-09,207,coca cola,75,100,25,1,00277,India
141778,2023-06-09,211,red bull,90,125,35,1,00277,India
528708,2023-06-09,207,coca cola,75,100,25,1,00441,India
528708,2023-06-09,209,pepsi,75,100,25,1,00441,India
528708,2023-06-09,208,sprite,75,100,25,1,00441,India
528708,2023-06-09,201,paneer,210,340,130,1,00441,India
863008,2023-06-09,209,pepsi,75,100,25,1,00095,India
863008,2023-06-09,211,red bull,90,125,35,1,00095,India
260319,2023-06-09,210,mountain dew,75,100,25,1,00441,India
260319,2023-06-09,202,milk,12,27,15,1,00441,India
260319,2023-06-09,209,pepsi,75,100,25,1,00441,India
227935,2023-06-09,209,pepsi,75,100,25,1,00165,India
532121,2023-06-09,206,yakult,360,400,40,1,00203,India
532121,2023-06-09,204,strawberry yogurt,50,60,10,1,00203,India
532121,2023-06-09,209,pepsi,75,100,25,1,00203,India
532121,2023-06-09,202,milk,12,27,15,1,00203,India
532121,2023-06-09,213,bisleri,6,15,9,1,00203,India
647914,2023-06-10,210,mountain dew,75,100,25,1,00461,India
647914,2023-06-10,211,red bull,90,125,35,1,00461,India
271505,2023-06-10,212,amul cheese,250,315,65,1,00072,India
271505,2023-06-10,205,classic yogurt,45,60,15,1,00072,India
271505,2023-06-10,209,pepsi,75,100,25,1,00072,India
271505,2023-06-10,208,sprite,75,100,25,1,00072,India
675474,2023-06-10,212,amul cheese,250,315,65,1,00453,India
675474,2023-06-10,206,yakult,360,400,40,1,00453,India
675474,2023-06-10,213,bisleri,6,15,9,1,00453,India
675474,2023-06-10,211,red bull,90,125,35,1,00453,India
439694,2023-06-10,211,red bull,90,125,35,1,00486,India
439694,2023-06-10,203,mango yogurt,50,60,10,1,00486,India
439694,2023-06-10,208,sprite,75,100,25,1,00486,India
464047,2023-06-10,210,mountain dew,75,100,25,1,00313,India
464047,2023-06-10,211,red bull,90,125,35,1,00313,India
464047,2023-06-10,213,bisleri,6,15,9,1,00313,India
464047,2023-06-10,212,amul cheese,250,315,65,1,00313,India
636173,2023-06-10,203,mango yogurt,50,60,10,1,00301,India
636173,2023-06-10,207,coca cola,75,100,25,1,00301,India
636173,2023-06-10,213,bisleri,6,15,9,1,00301,India
636173,2023-06-10,210,mountain dew,75,100,25,1,00301,India
636173,2023-06-10,211,red bull,90,125,35,1,00301,India
845082,2023-06-10,203,mango yogurt,50,60,10,1,00257,India
845082,2023-06-10,205,classic yogurt,45,60,15,1,00257,India
845082,2023-06-10,210,mountain dew,75,100,25,1,00257,India
920859,2023-06-10,205,classic yogurt,45,60,15,1,00374,India
592070,2023-06-10,210,mountain dew,75,100,25,1,00434,India
770046,2023-06-10,206,yakult,360,400,40,1,00202,India
770046,2023-06-10,209,pepsi,75,100,25,1,00202,India
412843,2023-06-10,205,classic yogurt,45,60,15,1,00269,India
412843,2023-06-10,202,milk,12,27,15,1,00269,India
322952,2023-06-10,203,mango yogurt,50,60,10,1,00430,India
121450,2023-06-10,204,strawberry yogurt,50,60,10,1,00369,India
121450,2023-06-10,208,sprite,75,100,25,1,00369,India
381106,2023-06-10,201,paneer,210,340,130,1,00368,India
381106,2023-06-10,211,red bull,90,125,35,1,00368,India
215098,2023-06-10,204,strawberry yogurt,50,60,10,1,00078,India
215098,2023-06-10,209,pepsi,75,100,25,1,00078,India
215098,2023-06-10,205,classic yogurt,45,60,15,1,00078,India
215098,2023-06-10,207,coca cola,75,100,25,1,00078,India
215098,2023-06-10,203,mango yogurt,50,60,10,1,00078,India
409191,2023-06-10,212,amul cheese,250,315,65,1,00414,India
409191,2023-06-10,205,classic yogurt,45,60,15,1,00414,India
409191,2023-06-10,206,yakult,360,400,40,1,00414,India
736852,2023-06-10,212,amul cheese,250,315,65,1,00479,India
736852,2023-06-10,203,mango yogurt,50,60,10,1,00479,India
736852,2023-06-10,210,mountain dew,75,100,25,1,00479,India
736852,2023-06-10,205,classic yogurt,45,60,15,1,00479,India
615621,2023-06-10,211,red bull,90,125,35,1,00237,India
615621,2023-06-10,204,strawberry yogurt,50,60,10,1,00237,India
615621,2023-06-10,201,paneer,210,340,130,1,00237,India
417089,2023-06-10,209,pepsi,75,100,25,1,00477,India
417089,2023-06-10,203,mango yogurt,50,60,10,1,00477,India
417089,2023-06-10,210,mountain dew,75,100,25,1,00477,India
417089,2023-06-10,204,strawberry yogurt,50,60,10,1,00477,India
843396,2023-06-10,213,bisleri,6,15,9,1,00446,India
843396,2023-06-10,202,milk,12,27,15,1,00446,India
843396,2023-06-10,207,coca cola,75,100,25,1,00446,India
283945,2023-06-10,210,mountain dew,75,100,25,1,00375,India
921432,2023-06-10,201,paneer,210,340,130,1,00398,India
921432,2023-06-10,213,bisleri,6,15,9,1,00398,India
921432,2023-06-10,204,strawberry yogurt,50,60,10,1,00398,India
921432,2023-06-10,203,mango yogurt,50,60,10,1,00398,India
105608,2023-06-10,206,yakult,360,400,40,1,00267,India
105608,2023-06-10,210,mountain dew,75,100,25,1,00267,India
105608,2023-06-10,212,amul cheese,250,315,65,1,00267,India
105608,2023-06-10,201,paneer,210,340,130,1,00267,India
105608,2023-06-10,207,coca cola,75,100,25,1,00267,India
144165,2023-06-10,205,classic yogurt,45,60,15,1,00380,India
785953,2023-06-10,206,yakult,360,400,40,1,00356,India
785953,2023-06-10,211,red bull,90,125,35,1,00356,India
785953,2023-06-10,212,amul cheese,250,315,65,1,00356,India
785953,2023-06-10,210,mountain dew,75,100,25,1,00356,India
785953,2023-06-10,201,paneer,210,340,130,1,00356,India
978122,2023-06-10,210,mountain dew,75,100,25,1,00448,India
978122,2023-06-10,213,bisleri,6,15,9,1,00448,India
978122,2023-06-10,204,strawberry yogurt,50,60,10,1,00448,India
978122,2023-06-10,211,red bull,90,125,35,1,00448,India
978122,2023-06-10,209,pepsi,75,100,25,1,00448,India
774378,2023-06-10,212,amul cheese,250,315,65,1,00453,India
498961,2023-06-10,201,paneer,210,340,130,1,00453,India
498961,2023-06-10,212,amul cheese,250,315,65,1,00453,India
498961,2023-06-10,205,classic yogurt,45,60,15,1,00453,India
498961,2023-06-10,211,red bull,90,125,35,1,00453,India
498961,2023-06-10,209,pepsi,75,100,25,1,00453,India
610798,2023-06-10,207,coca cola,75,100,25,1,00409,India
610798,2023-06-10,213,bisleri,6,15,9,1,00409,India
610798,2023-06-10,211,red bull,90,125,35,1,00409,India
610798,2023-06-10,206,yakult,360,400,40,1,00409,India
610798,2023-06-10,210,mountain dew,75,100,25,1,00409,India
233546,2023-06-10,212,amul cheese,250,315,65,1,00107,India
903686,2023-06-10,204,strawberry yogurt,50,60,10,1,00393,India
903686,2023-06-10,210,mountain dew,75,100,25,1,00393,India
903686,2023-06-10,206,yakult,360,400,40,1,00393,India
903686,2023-06-10,203,mango yogurt,50,60,10,1,00393,India
994994,2023-06-10,202,milk,12,27,15,1,00002,India
994994,2023-06-10,204,strawberry yogurt,50,60,10,1,00002,India
994994,2023-06-10,212,amul cheese,250,315,65,1,00002,India
994994,2023-06-10,207,coca cola,75,100,25,1,00002,India
471872,2023-06-10,209,pepsi,75,100,25,1,00285,India
471872,2023-06-10,211,red bull,90,125,35,1,00285,India
471872,2023-06-10,201,paneer,210,340,130,1,00285,India
471872,2023-06-10,205,classic yogurt,45,60,15,1,00285,India
466457,2023-06-10,210,mountain dew,75,100,25,1,00088,India
466457,2023-06-10,203,mango yogurt,50,60,10,1,00088,India
438228,2023-06-10,211,red bull,90,125,35,1,00465,India
891231,2023-06-10,204,strawberry yogurt,50,60,10,1,00032,India
891231,2023-06-10,209,pepsi,75,100,25,1,00032,India
891231,2023-06-10,213,bisleri,6,15,9,1,00032,India
891231,2023-06-10,208,sprite,75,100,25,1,00032,India
932883,2023-06-10,203,mango yogurt,50,60,10,1,00071,India
932883,2023-06-10,211,red bull,90,125,35,1,00071,India
932883,2023-06-10,205,classic yogurt,45,60,15,1,00071,India
750032,2023-06-10,211,red bull,90,125,35,1,00058,India
477800,2023-06-10,211,red bull,90,125,35,1,00172,India
477800,2023-06-10,212,amul cheese,250,315,65,1,00172,India
477800,2023-06-10,207,coca cola,75,100,25,1,00172,India
855269,2023-06-10,204,strawberry yogurt,50,60,10,1,00049,India
576335,2023-06-10,213,bisleri,6,15,9,1,00047,India
576335,2023-06-10,201,paneer,210,340,130,1,00047,India
859882,2023-06-10,206,yakult,360,400,40,1,00400,India
859882,2023-06-10,204,strawberry yogurt,50,60,10,1,00400,India
859882,2023-06-10,203,mango yogurt,50,60,10,1,00400,India
859882,2023-06-10,205,classic yogurt,45,60,15,1,00400,India
859882,2023-06-10,213,bisleri,6,15,9,1,00400,India
838197,2023-06-10,212,amul cheese,250,315,65,1,00268,India
838197,2023-06-10,201,paneer,210,340,130,1,00268,India
838197,2023-06-10,210,mountain dew,75,100,25,1,00268,India
432081,2023-06-10,211,red bull,90,125,35,1,00366,India
744107,2023-06-10,203,mango yogurt,50,60,10,1,00282,India
744107,2023-06-10,205,classic yogurt,45,60,15,1,00282,India
438318,2023-06-10,205,classic yogurt,45,60,15,1,00310,India
438318,2023-06-10,206,yakult,360,400,40,1,00310,India
438318,2023-06-10,209,pepsi,75,100,25,1,00310,India
438318,2023-06-10,211,red bull,90,125,35,1,00310,India
508921,2023-06-10,209,pepsi,75,100,25,1,00243,India
508921,2023-06-10,202,milk,12,27,15,1,00243,India
508921,2023-06-10,207,coca cola,75,100,25,1,00243,India
508921,2023-06-10,206,yakult,360,400,40,1,00243,India
915836,2023-06-10,209,pepsi,75,100,25,1,00209,India
915836,2023-06-10,205,classic yogurt,45,60,15,1,00209,India
253226,2023-06-10,205,classic yogurt,45,60,15,1,00174,India
253226,2023-06-10,207,coca cola,75,100,25,1,00174,India
253226,2023-06-10,202,milk,12,27,15,1,00174,India
218680,2023-06-10,204,strawberry yogurt,50,60,10,1,00329,India
954501,2023-06-10,209,pepsi,75,100,25,1,00053,India
954501,2023-06-10,205,classic yogurt,45,60,15,1,00053,India
954501,2023-06-10,207,coca cola,75,100,25,1,00053,India
954501,2023-06-10,201,paneer,210,340,130,1,00053,India
229569,2023-06-10,209,pepsi,75,100,25,1,00155,India
229569,2023-06-10,208,sprite,75,100,25,1,00155,India
229569,2023-06-10,203,mango yogurt,50,60,10,1,00155,India
540275,2023-06-10,205,classic yogurt,45,60,15,1,00416,India
540275,2023-06-10,209,pepsi,75,100,25,1,00416,India
540275,2023-06-10,204,strawberry yogurt,50,60,10,1,00416,India
540275,2023-06-10,206,yakult,360,400,40,1,00416,India
529448,2023-06-10,203,mango yogurt,50,60,10,1,00408,India
529448,2023-06-10,209,pepsi,75,100,25,1,00408,India
529448,2023-06-10,210,mountain dew,75,100,25,1,00408,India
529448,2023-06-10,205,classic yogurt,45,60,15,1,00408,India
207494,2023-06-10,213,bisleri,6,15,9,1,00012,India
207494,2023-06-10,210,mountain dew,75,100,25,1,00012,India
149549,2023-06-10,205,classic yogurt,45,60,15,1,00350,India
149549,2023-06-10,204,strawberry yogurt,50,60,10,1,00350,India
149549,2023-06-10,211,red bull,90,125,35,1,00350,India
713543,2023-06-10,201,paneer,210,340,130,1,00264,India
713543,2023-06-10,204,strawberry yogurt,50,60,10,1,00264,India
713543,2023-06-10,212,amul cheese,250,315,65,1,00264,India
833480,2023-06-10,211,red bull,90,125,35,1,00205,India
673221,2023-06-10,204,strawberry yogurt,50,60,10,1,00244,India
673221,2023-06-10,202,milk,12,27,15,1,00244,India
673221,2023-06-10,203,mango yogurt,50,60,10,1,00244,India
673221,2023-06-10,209,pepsi,75,100,25,1,00244,India
673221,2023-06-10,207,coca cola,75,100,25,1,00244,India
999705,2023-06-10,208,sprite,75,100,25,1,00125,India
999705,2023-06-10,207,coca cola,75,100,25,1,00125,India
999705,2023-06-10,205,classic yogurt,45,60,15,1,00125,India
999705,2023-06-10,202,milk,12,27,15,1,00125,India
609681,2023-06-10,207,coca cola,75,100,25,1,00206,India
609681,2023-06-10,213,bisleri,6,15,9,1,00206,India
609681,2023-06-10,201,paneer,210,340,130,1,00206,India
201067,2023-06-10,210,mountain dew,75,100,25,1,00291,India
201067,2023-06-10,213,bisleri,6,15,9,1,00291,India
201067,2023-06-10,207,coca cola,75,100,25,1,00291,India
187845,2023-06-10,204,strawberry yogurt,50,60,10,1,00481,India
187845,2023-06-10,206,yakult,360,400,40,1,00481,India
187845,2023-06-10,211,red bull,90,125,35,1,00481,India
187845,2023-06-10,208,sprite,75,100,25,1,00481,India
187845,2023-06-10,205,classic yogurt,45,60,15,1,00481,India
765787,2023-06-10,202,milk,12,27,15,1,00483,India
765787,2023-06-10,208,sprite,75,100,25,1,00483,India
765787,2023-06-10,213,bisleri,6,15,9,1,00483,India
267562,2023-06-10,207,coca cola,75,100,25,1,00053,India
267562,2023-06-10,213,bisleri,6,15,9,1,00053,India
861158,2023-06-10,208,sprite,75,100,25,1,00166,India
547072,2023-06-10,205,classic yogurt,45,60,15,1,00216,India
703160,2023-06-10,213,bisleri,6,15,9,1,00326,India
801237,2023-06-10,202,milk,12,27,15,1,00238,India
801237,2023-06-10,207,coca cola,75,100,25,1,00238,India
801237,2023-06-10,208,sprite,75,100,25,1,00238,India
801237,2023-06-10,206,yakult,360,400,40,1,00238,India
972948,2023-06-10,207,coca cola,75,100,25,1,00233,India
972948,2023-06-10,208,sprite,75,100,25,1,00233,India
972948,2023-06-10,213,bisleri,6,15,9,1,00233,India
915848,2023-06-10,213,bisleri,6,15,9,1,00128,India
915848,2023-06-10,205,classic yogurt,45,60,15,1,00128,India
915848,2023-06-10,209,pepsi,75,100,25,1,00128,India
811653,2023-06-10,202,milk,12,27,15,1,00326,India
811653,2023-06-10,207,coca cola,75,100,25,1,00326,India
811653,2023-06-10,201,paneer,210,340,130,1,00326,India
358973,2023-06-10,211,red bull,90,125,35,1,00059,India
592914,2023-06-10,202,milk,12,27,15,1,00416,India
592914,2023-06-10,201,paneer,210,340,130,1,00416,India
592914,2023-06-10,204,strawberry yogurt,50,60,10,1,00416,India
444243,2023-06-10,213,bisleri,6,15,9,1,00092,India
444243,2023-06-10,204,strawberry yogurt,50,60,10,1,00092,India
444243,2023-06-10,206,yakult,360,400,40,1,00092,India
207768,2023-06-10,202,milk,12,27,15,1,00481,India
207768,2023-06-10,203,mango yogurt,50,60,10,1,00481,India
207768,2023-06-10,204,strawberry yogurt,50,60,10,1,00481,India
207768,2023-06-10,213,bisleri,6,15,9,1,00481,India
207768,2023-06-10,207,coca cola,75,100,25,1,00481,India
126999,2023-06-10,207,coca cola,75,100,25,1,00232,India
804682,2023-06-10,213,bisleri,6,15,9,1,00159,India
804682,2023-06-10,210,mountain dew,75,100,25,1,00159,India
804682,2023-06-10,212,amul cheese,250,315,65,1,00159,India
658397,2023-06-10,212,amul cheese,250,315,65,1,00443,India
658397,2023-06-10,211,red bull,90,125,35,1,00443,India
838117,2023-06-10,205,classic yogurt,45,60,15,1,00296,India
838117,2023-06-10,213,bisleri,6,15,9,1,00296,India
838117,2023-06-10,201,paneer,210,340,130,1,00296,India
838117,2023-06-10,202,milk,12,27,15,1,00296,India
838117,2023-06-10,204,strawberry yogurt,50,60,10,1,00296,India
460291,2023-06-10,201,paneer,210,340,130,1,00369,India
460291,2023-06-10,202,milk,12,27,15,1,00369,India
460291,2023-06-10,211,red bull,90,125,35,1,00369,India
460291,2023-06-10,208,sprite,75,100,25,1,00369,India
610485,2023-06-10,208,sprite,75,100,25,1,00456,India
610485,2023-06-10,207,coca cola,75,100,25,1,00456,India
525500,2023-06-10,207,coca cola,75,100,25,1,00352,India
525500,2023-06-10,206,yakult,360,400,40,1,00352,India
525500,2023-06-10,202,milk,12,27,15,1,00352,India
327409,2023-06-10,208,sprite,75,100,25,1,00271,India
327409,2023-06-10,209,pepsi,75,100,25,1,00271,India
327409,2023-06-10,213,bisleri,6,15,9,1,00271,India
327409,2023-06-10,210,mountain dew,75,100,25,1,00271,India
221900,2023-06-10,211,red bull,90,125,35,1,00343,India
221900,2023-06-10,208,sprite,75,100,25,1,00343,India
221900,2023-06-10,213,bisleri,6,15,9,1,00343,India
698313,2023-06-10,208,sprite,75,100,25,1,00466,India
698313,2023-06-10,201,paneer,210,340,130,1,00466,India
698313,2023-06-10,203,mango yogurt,50,60,10,1,00466,India
698313,2023-06-10,211,red bull,90,125,35,1,00466,India
609454,2023-06-10,207,coca cola,75,100,25,1,00131,India
609454,2023-06-10,213,bisleri,6,15,9,1,00131,India
609454,2023-06-10,209,pepsi,75,100,25,1,00131,India
388182,2023-06-10,213,bisleri,6,15,9,1,00136,India
715035,2023-06-10,212,amul cheese,250,315,65,1,00104,India
715035,2023-06-10,205,classic yogurt,45,60,15,1,00104,India
359566,2023-06-11,205,classic yogurt,45,60,15,1,00160,India
359566,2023-06-11,211,red bull,90,125,35,1,00160,India
359566,2023-06-11,213,bisleri,6,15,9,1,00160,India
989777,2023-06-11,211,red bull,90,125,35,1,00081,India
376149,2023-06-11,201,paneer,210,340,130,1,00274,India
376149,2023-06-11,203,mango yogurt,50,60,10,1,00274,India
606446,2023-06-11,212,amul cheese,250,315,65,1,00150,India
606446,2023-06-11,203,mango yogurt,50,60,10,1,00150,India
916347,2023-06-11,213,bisleri,6,15,9,1,00390,India
792857,2023-06-11,213,bisleri,6,15,9,1,00381,India
792857,2023-06-11,206,yakult,360,400,40,1,00381,India
102727,2023-06-11,208,sprite,75,100,25,1,00149,India
102727,2023-06-11,209,pepsi,75,100,25,1,00149,India
727151,2023-06-11,211,red bull,90,125,35,1,00240,India
727151,2023-06-11,206,yakult,360,400,40,1,00240,India
727151,2023-06-11,202,milk,12,27,15,1,00240,India
727151,2023-06-11,208,sprite,75,100,25,1,00240,India
936022,2023-06-11,201,paneer,210,340,130,1,00236,India
936022,2023-06-11,211,red bull,90,125,35,1,00236,India
936022,2023-06-11,208,sprite,75,100,25,1,00236,India
972255,2023-06-11,213,bisleri,6,15,9,1,00037,India
972255,2023-06-11,203,mango yogurt,50,60,10,1,00037,India
972255,2023-06-11,205,classic yogurt,45,60,15,1,00037,India
972255,2023-06-11,212,amul cheese,250,315,65,1,00037,India
721899,2023-06-11,206,yakult,360,400,40,1,00262,India
721899,2023-06-11,205,classic yogurt,45,60,15,1,00262,India
721899,2023-06-11,211,red bull,90,125,35,1,00262,India
362338,2023-06-11,210,mountain dew,75,100,25,1,00092,India
362338,2023-06-11,207,coca cola,75,100,25,1,00092,India
362338,2023-06-11,208,sprite,75,100,25,1,00092,India
362338,2023-06-11,213,bisleri,6,15,9,1,00092,India
953247,2023-06-11,211,red bull,90,125,35,1,00231,India
953247,2023-06-11,206,yakult,360,400,40,1,00231,India
367408,2023-06-11,202,milk,12,27,15,1,00085,India
367408,2023-06-11,211,red bull,90,125,35,1,00085,India
544519,2023-06-11,207,coca cola,75,100,25,1,00252,India
544519,2023-06-11,201,paneer,210,340,130,1,00252,India
544519,2023-06-11,204,strawberry yogurt,50,60,10,1,00252,India
544519,2023-06-11,209,pepsi,75,100,25,1,00252,India
544519,2023-06-11,211,red bull,90,125,35,1,00252,India
887115,2023-06-11,206,yakult,360,400,40,1,00072,India
887115,2023-06-11,204,strawberry yogurt,50,60,10,1,00072,India
786177,2023-06-11,202,milk,12,27,15,1,00472,India
786177,2023-06-11,207,coca cola,75,100,25,1,00472,India
786177,2023-06-11,212,amul cheese,250,315,65,1,00472,India
721493,2023-06-11,203,mango yogurt,50,60,10,1,00129,India
721493,2023-06-11,201,paneer,210,340,130,1,00129,India
721493,2023-06-11,208,sprite,75,100,25,1,00129,India
721493,2023-06-11,213,bisleri,6,15,9,1,00129,India
721493,2023-06-11,211,red bull,90,125,35,1,00129,India
962133,2023-06-11,202,milk,12,27,15,1,00471,India
523553,2023-06-11,213,bisleri,6,15,9,1,00191,India
523553,2023-06-11,210,mountain dew,75,100,25,1,00191,India
523553,2023-06-11,203,mango yogurt,50,60,10,1,00191,India
523553,2023-06-11,209,pepsi,75,100,25,1,00191,India
523553,2023-06-11,202,milk,12,27,15,1,00191,India
603011,2023-06-11,211,red bull,90,125,35,1,00097,India
603011,2023-06-11,213,bisleri,6,15,9,1,00097,India
877529,2023-06-11,212,amul cheese,250,315,65,1,00114,India
839152,2023-06-11,202,milk,12,27,15,1,00330,India
839152,2023-06-11,209,pepsi,75,100,25,1,00330,India
839152,2023-06-11,203,mango yogurt,50,60,10,1,00330,India
613445,2023-06-11,207,coca cola,75,100,25,1,00165,India
613445,2023-06-11,209,pepsi,75,100,25,1,00165,India
613445,2023-06-11,210,mountain dew,75,100,25,1,00165,India
613445,2023-06-11,202,milk,12,27,15,1,00165,India
146473,2023-06-11,205,classic yogurt,45,60,15,1,00194,India
146473,2023-06-11,213,bisleri,6,15,9,1,00194,India
146473,2023-06-11,208,sprite,75,100,25,1,00194,India
168115,2023-06-11,210,mountain dew,75,100,25,1,00443,India
168115,2023-06-11,211,red bull,90,125,35,1,00443,India
168115,2023-06-11,202,milk,12,27,15,1,00443,India
168115,2023-06-11,203,mango yogurt,50,60,10,1,00443,India
238591,2023-06-11,201,paneer,210,340,130,1,00482,India
414237,2023-06-11,207,coca cola,75,100,25,1,00118,India
414237,2023-06-11,205,classic yogurt,45,60,15,1,00118,India
414237,2023-06-11,212,amul cheese,250,315,65,1,00118,India
101792,2023-06-11,211,red bull,90,125,35,1,00185,India
101792,2023-06-11,207,coca cola,75,100,25,1,00185,India
637565,2023-06-11,204,strawberry yogurt,50,60,10,1,00487,India
240330,2023-06-11,201,paneer,210,340,130,1,00214,India
411814,2023-06-11,213,bisleri,6,15,9,1,00056,India
411814,2023-06-11,210,mountain dew,75,100,25,1,00056,India
411814,2023-06-11,206,yakult,360,400,40,1,00056,India
411814,2023-06-11,203,mango yogurt,50,60,10,1,00056,India
411814,2023-06-11,208,sprite,75,100,25,1,00056,India
943775,2023-06-11,213,bisleri,6,15,9,1,00449,India
943775,2023-06-11,202,milk,12,27,15,1,00449,India
943775,2023-06-11,204,strawberry yogurt,50,60,10,1,00449,India
943775,2023-06-11,206,yakult,360,400,40,1,00449,India
201517,2023-06-11,213,bisleri,6,15,9,1,00385,India
146435,2023-06-11,207,coca cola,75,100,25,1,00266,India
146435,2023-06-11,205,classic yogurt,45,60,15,1,00266,India
438549,2023-06-11,213,bisleri,6,15,9,1,00278,India
438549,2023-06-11,203,mango yogurt,50,60,10,1,00278,India
669286,2023-06-11,203,mango yogurt,50,60,10,1,00492,India
669286,2023-06-11,201,paneer,210,340,130,1,00492,India
669286,2023-06-11,210,mountain dew,75,100,25,1,00492,India
518509,2023-06-11,203,mango yogurt,50,60,10,1,00190,India
380510,2023-06-11,204,strawberry yogurt,50,60,10,1,00081,India
380510,2023-06-11,211,red bull,90,125,35,1,00081,India
380510,2023-06-11,207,coca cola,75,100,25,1,00081,India
380510,2023-06-11,202,milk,12,27,15,1,00081,India
380510,2023-06-11,209,pepsi,75,100,25,1,00081,India
448024,2023-06-11,205,classic yogurt,45,60,15,1,00097,India
448024,2023-06-11,211,red bull,90,125,35,1,00097,India
508369,2023-06-11,204,strawberry yogurt,50,60,10,1,00181,India
508369,2023-06-11,209,pepsi,75,100,25,1,00181,India
436727,2023-06-11,205,classic yogurt,45,60,15,1,00267,India
436727,2023-06-11,210,mountain dew,75,100,25,1,00267,India
270438,2023-06-11,213,bisleri,6,15,9,1,00464,India
270438,2023-06-11,201,paneer,210,340,130,1,00464,India
270438,2023-06-11,202,milk,12,27,15,1,00464,India
270438,2023-06-11,210,mountain dew,75,100,25,1,00464,India
173912,2023-06-11,202,milk,12,27,15,1,00050,India
173912,2023-06-11,208,sprite,75,100,25,1,00050,India
173912,2023-06-11,210,mountain dew,75,100,25,1,00050,India
173912,2023-06-11,213,bisleri,6,15,9,1,00050,India
173912,2023-06-11,203,mango yogurt,50,60,10,1,00050,India
166876,2023-06-11,213,bisleri,6,15,9,1,00257,India
180882,2023-06-11,202,milk,12,27,15,1,00166,India
616754,2023-06-11,206,yakult,360,400,40,1,00102,India
616754,2023-06-11,212,amul cheese,250,315,65,1,00102,India
616754,2023-06-11,208,sprite,75,100,25,1,00102,India
616754,2023-06-11,205,classic yogurt,45,60,15,1,00102,India
877873,2023-06-11,203,mango yogurt,50,60,10,1,00207,India
877873,2023-06-11,202,milk,12,27,15,1,00207,India
877873,2023-06-11,212,amul cheese,250,315,65,1,00207,India
877873,2023-06-11,204,strawberry yogurt,50,60,10,1,00207,India
338273,2023-06-11,202,milk,12,27,15,1,00377,India
338273,2023-06-11,213,bisleri,6,15,9,1,00377,India
338273,2023-06-11,201,paneer,210,340,130,1,00377,India
338273,2023-06-11,208,sprite,75,100,25,1,00377,India
338273,2023-06-11,211,red bull,90,125,35,1,00377,India
780242,2023-06-11,202,milk,12,27,15,1,00334,India
780242,2023-06-11,207,coca cola,75,100,25,1,00334,India
780242,2023-06-11,210,mountain dew,75,100,25,1,00334,India
780242,2023-06-11,208,sprite,75,100,25,1,00334,India
670658,2023-06-11,205,classic yogurt,45,60,15,1,00258,India
670658,2023-06-11,201,paneer,210,340,130,1,00258,India
670658,2023-06-11,203,mango yogurt,50,60,10,1,00258,India
670658,2023-06-11,213,bisleri,6,15,9,1,00258,India
670658,2023-06-11,210,mountain dew,75,100,25,1,00258,India
458823,2023-06-11,213,bisleri,6,15,9,1,00409,India
458823,2023-06-11,211,red bull,90,125,35,1,00409,India
458823,2023-06-11,205,classic yogurt,45,60,15,1,00409,India
458823,2023-06-11,212,amul cheese,250,315,65,1,00409,India
458823,2023-06-11,203,mango yogurt,50,60,10,1,00409,India
891108,2023-06-11,204,strawberry yogurt,50,60,10,1,00259,India
891108,2023-06-11,208,sprite,75,100,25,1,00259,India
891108,2023-06-11,206,yakult,360,400,40,1,00259,India
729784,2023-06-11,211,red bull,90,125,35,1,00075,India
729784,2023-06-11,209,pepsi,75,100,25,1,00075,India
248511,2023-06-11,203,mango yogurt,50,60,10,1,00108,India
174256,2023-06-11,210,mountain dew,75,100,25,1,00453,India
174256,2023-06-11,208,sprite,75,100,25,1,00453,India
105771,2023-06-11,201,paneer,210,340,130,1,00372,India
105771,2023-06-11,202,milk,12,27,15,1,00372,India
105771,2023-06-11,212,amul cheese,250,315,65,1,00372,India
105771,2023-06-11,208,sprite,75,100,25,1,00372,India
733407,2023-06-11,208,sprite,75,100,25,1,00193,India
733407,2023-06-11,210,mountain dew,75,100,25,1,00193,India
733407,2023-06-11,213,bisleri,6,15,9,1,00193,India
190844,2023-06-11,201,paneer,210,340,130,1,00213,India
190844,2023-06-11,212,amul cheese,250,315,65,1,00213,India
389483,2023-06-11,205,classic yogurt,45,60,15,1,00217,India
389483,2023-06-11,201,paneer,210,340,130,1,00217,India
389483,2023-06-11,202,milk,12,27,15,1,00217,India
389483,2023-06-11,204,strawberry yogurt,50,60,10,1,00217,India
568903,2023-06-11,211,red bull,90,125,35,1,00045,India
420243,2023-06-11,204,strawberry yogurt,50,60,10,1,00076,India
420243,2023-06-11,208,sprite,75,100,25,1,00076,India
420243,2023-06-11,205,classic yogurt,45,60,15,1,00076,India
420243,2023-06-11,213,bisleri,6,15,9,1,00076,India
848707,2023-06-11,211,red bull,90,125,35,1,00467,India
649922,2023-06-11,204,strawberry yogurt,50,60,10,1,00423,India
649922,2023-06-11,202,milk,12,27,15,1,00423,India
755915,2023-06-11,208,sprite,75,100,25,1,00054,India
755915,2023-06-11,209,pepsi,75,100,25,1,00054,India
755915,2023-06-11,206,yakult,360,400,40,1,00054,India
390543,2023-06-11,206,yakult,360,400,40,1,00003,India
390543,2023-06-11,205,classic yogurt,45,60,15,1,00003,India
390543,2023-06-11,203,mango yogurt,50,60,10,1,00003,India
231910,2023-06-11,209,pepsi,75,100,25,1,00047,India
231910,2023-06-11,202,milk,12,27,15,1,00047,India
576809,2023-06-11,205,classic yogurt,45,60,15,1,00144,India
576809,2023-06-11,206,yakult,360,400,40,1,00144,India
576809,2023-06-11,208,sprite,75,100,25,1,00144,India
576809,2023-06-11,207,coca cola,75,100,25,1,00144,India
800300,2023-06-11,202,milk,12,27,15,1,00188,India
800300,2023-06-11,208,sprite,75,100,25,1,00188,India
302728,2023-06-11,208,sprite,75,100,25,1,00309,India
302728,2023-06-11,206,yakult,360,400,40,1,00309,India
302728,2023-06-11,204,strawberry yogurt,50,60,10,1,00309,India
254272,2023-06-11,213,bisleri,6,15,9,1,00301,India
385494,2023-06-11,208,sprite,75,100,25,1,00274,India
382718,2023-06-11,213,bisleri,6,15,9,1,00300,India
382718,2023-06-11,209,pepsi,75,100,25,1,00300,India
382718,2023-06-11,205,classic yogurt,45,60,15,1,00300,India
660187,2023-06-11,208,sprite,75,100,25,1,00328,India
660187,2023-06-11,211,red bull,90,125,35,1,00328,India
771821,2023-06-11,213,bisleri,6,15,9,1,00307,India
623362,2023-06-11,206,yakult,360,400,40,1,00266,India
623362,2023-06-11,203,mango yogurt,50,60,10,1,00266,India
176077,2023-06-11,211,red bull,90,125,35,1,00169,India
176077,2023-06-11,202,milk,12,27,15,1,00169,India
176077,2023-06-11,203,mango yogurt,50,60,10,1,00169,India
566639,2023-06-11,203,mango yogurt,50,60,10,1,00379,India
566639,2023-06-11,205,classic yogurt,45,60,15,1,00379,India
566639,2023-06-11,202,milk,12,27,15,1,00379,India
566639,2023-06-11,206,yakult,360,400,40,1,00379,India
566639,2023-06-11,204,strawberry yogurt,50,60,10,1,00379,India
783411,2023-06-11,207,coca cola,75,100,25,1,00116,India
783411,2023-06-11,203,mango yogurt,50,60,10,1,00116,India
384546,2023-06-11,205,classic yogurt,45,60,15,1,00233,India
384546,2023-06-11,211,red bull,90,125,35,1,00233,India
384546,2023-06-11,203,mango yogurt,50,60,10,1,00233,India
345142,2023-06-11,204,strawberry yogurt,50,60,10,1,00180,India
345142,2023-06-11,202,milk,12,27,15,1,00180,India
251970,2023-06-12,202,milk,12,27,15,1,00102,India
272474,2023-06-12,204,strawberry yogurt,50,60,10,1,00097,India
272474,2023-06-12,203,mango yogurt,50,60,10,1,00097,India
272474,2023-06-12,201,paneer,210,340,130,1,00097,India
875645,2023-06-12,204,strawberry yogurt,50,60,10,1,00161,India
875645,2023-06-12,211,red bull,90,125,35,1,00161,India
875645,2023-06-12,210,mountain dew,75,100,25,1,00161,India
875645,2023-06-12,203,mango yogurt,50,60,10,1,00161,India
958636,2023-06-12,210,mountain dew,75,100,25,1,00482,India
177987,2023-06-12,203,mango yogurt,50,60,10,1,00099,India
177987,2023-06-12,202,milk,12,27,15,1,00099,India
177987,2023-06-12,209,pepsi,75,100,25,1,00099,India
680537,2023-06-12,210,mountain dew,75,100,25,1,00112,India
830053,2023-06-12,213,bisleri,6,15,9,1,00197,India
830053,2023-06-12,212,amul cheese,250,315,65,1,00197,India
830053,2023-06-12,204,strawberry yogurt,50,60,10,1,00197,India
830053,2023-06-12,207,coca cola,75,100,25,1,00197,India
893068,2023-06-12,209,pepsi,75,100,25,1,00468,India
893068,2023-06-12,211,red bull,90,125,35,1,00468,India
745754,2023-06-12,209,pepsi,75,100,25,1,00228,India
745754,2023-06-12,208,sprite,75,100,25,1,00228,India
745754,2023-06-12,207,coca cola,75,100,25,1,00228,India
745754,2023-06-12,201,paneer,210,340,130,1,00228,India
745754,2023-06-12,203,mango yogurt,50,60,10,1,00228,India
706831,2023-06-12,204,strawberry yogurt,50,60,10,1,00336,India
706831,2023-06-12,208,sprite,75,100,25,1,00336,India
706831,2023-06-12,210,mountain dew,75,100,25,1,00336,India
706831,2023-06-12,213,bisleri,6,15,9,1,00336,India
746950,2023-06-12,210,mountain dew,75,100,25,1,00353,India
746950,2023-06-12,213,bisleri,6,15,9,1,00353,India
746950,2023-06-12,205,classic yogurt,45,60,15,1,00353,India
591816,2023-06-12,210,mountain dew,75,100,25,1,00419,India
591816,2023-06-12,208,sprite,75,100,25,1,00419,India
591816,2023-06-12,205,classic yogurt,45,60,15,1,00419,India
591816,2023-06-12,202,milk,12,27,15,1,00419,India
591816,2023-06-12,212,amul cheese,250,315,65,1,00419,India
278170,2023-06-12,205,classic yogurt,45,60,15,1,00025,India
278170,2023-06-12,201,paneer,210,340,130,1,00025,India
278170,2023-06-12,213,bisleri,6,15,9,1,00025,India
278170,2023-06-12,203,mango yogurt,50,60,10,1,00025,India
278170,2023-06-12,204,strawberry yogurt,50,60,10,1,00025,India
150028,2023-06-12,213,bisleri,6,15,9,1,00462,India
150028,2023-06-12,201,paneer,210,340,130,1,00462,India
236616,2023-06-12,207,coca cola,75,100,25,1,00228,India
236616,2023-06-12,202,milk,12,27,15,1,00228,India
944372,2023-06-12,210,mountain dew,75,100,25,1,00042,India
728085,2023-06-12,213,bisleri,6,15,9,1,00261,India
728085,2023-06-12,207,coca cola,75,100,25,1,00261,India
225465,2023-06-12,203,mango yogurt,50,60,10,1,00191,India
225465,2023-06-12,201,paneer,210,340,130,1,00191,India
225465,2023-06-12,209,pepsi,75,100,25,1,00191,India
225465,2023-06-12,204,strawberry yogurt,50,60,10,1,00191,India
142052,2023-06-12,210,mountain dew,75,100,25,1,00307,India
958055,2023-06-12,206,yakult,360,400,40,1,00343,India
958055,2023-06-12,213,bisleri,6,15,9,1,00343,India
958055,2023-06-12,205,classic yogurt,45,60,15,1,00343,India
837096,2023-06-12,204,strawberry yogurt,50,60,10,1,00452,India
837096,2023-06-12,212,amul cheese,250,315,65,1,00452,India
837096,2023-06-12,213,bisleri,6,15,9,1,00452,India
837096,2023-06-12,208,sprite,75,100,25,1,00452,India
329478,2023-06-12,209,pepsi,75,100,25,1,00026,India
909379,2023-06-12,204,strawberry yogurt,50,60,10,1,00285,India
909379,2023-06-12,203,mango yogurt,50,60,10,1,00285,India
909379,2023-06-12,206,yakult,360,400,40,1,00285,India
530781,2023-06-12,203,mango yogurt,50,60,10,1,00358,India
530781,2023-06-12,211,red bull,90,125,35,1,00358,India
530781,2023-06-12,209,pepsi,75,100,25,1,00358,India
530781,2023-06-12,206,yakult,360,400,40,1,00358,India
530781,2023-06-12,205,classic yogurt,45,60,15,1,00358,India
478276,2023-06-12,205,classic yogurt,45,60,15,1,00455,India
180563,2023-06-12,202,milk,12,27,15,1,00266,India
180563,2023-06-12,207,coca cola,75,100,25,1,00266,India
180563,2023-06-12,204,strawberry yogurt,50,60,10,1,00266,India
345089,2023-06-12,205,classic yogurt,45,60,15,1,00239,India
345089,2023-06-12,207,coca cola,75,100,25,1,00239,India
345089,2023-06-12,206,yakult,360,400,40,1,00239,India
345089,2023-06-12,208,sprite,75,100,25,1,00239,India
310120,2023-06-12,204,strawberry yogurt,50,60,10,1,00467,India
310120,2023-06-12,208,sprite,75,100,25,1,00467,India
310120,2023-06-12,203,mango yogurt,50,60,10,1,00467,India
715136,2023-06-12,203,mango yogurt,50,60,10,1,00150,India
715136,2023-06-12,206,yakult,360,400,40,1,00150,India
715136,2023-06-12,207,coca cola,75,100,25,1,00150,India
715136,2023-06-12,201,paneer,210,340,130,1,00150,India
486797,2023-06-12,207,coca cola,75,100,25,1,00174,India
486797,2023-06-12,204,strawberry yogurt,50,60,10,1,00174,India
486797,2023-06-12,213,bisleri,6,15,9,1,00174,India
578810,2023-06-12,204,strawberry yogurt,50,60,10,1,00256,India
578810,2023-06-12,209,pepsi,75,100,25,1,00256,India
578810,2023-06-12,202,milk,12,27,15,1,00256,India
327934,2023-06-12,213,bisleri,6,15,9,1,00383,India
509130,2023-06-12,205,classic yogurt,45,60,15,1,00048,India
753718,2023-06-12,211,red bull,90,125,35,1,00018,India
751799,2023-06-12,201,paneer,210,340,130,1,00388,India
751799,2023-06-12,202,milk,12,27,15,1,00388,India
751799,2023-06-12,208,sprite,75,100,25,1,00388,India
121721,2023-06-12,212,amul cheese,250,315,65,1,00435,India
121721,2023-06-12,201,paneer,210,340,130,1,00435,India
989090,2023-06-12,207,coca cola,75,100,25,1,00224,India
989090,2023-06-12,208,sprite,75,100,25,1,00224,India
989090,2023-06-12,212,amul cheese,250,315,65,1,00224,India
306911,2023-06-12,208,sprite,75,100,25,1,00011,India
306911,2023-06-12,201,paneer,210,340,130,1,00011,India
306911,2023-06-12,209,pepsi,75,100,25,1,00011,India
151798,2023-06-12,208,sprite,75,100,25,1,00401,India
151798,2023-06-12,202,milk,12,27,15,1,00401,India
151798,2023-06-12,203,mango yogurt,50,60,10,1,00401,India
235052,2023-06-12,202,milk,12,27,15,1,00487,India
235052,2023-06-12,208,sprite,75,100,25,1,00487,India
767402,2023-06-12,213,bisleri,6,15,9,1,00132,India
413291,2023-06-12,206,yakult,360,400,40,1,00328,India
957804,2023-06-12,213,bisleri,6,15,9,1,00435,India
957804,2023-06-12,204,strawberry yogurt,50,60,10,1,00435,India
985234,2023-06-12,201,paneer,210,340,130,1,00277,India
985234,2023-06-12,204,strawberry yogurt,50,60,10,1,00277,India
985234,2023-06-12,211,red bull,90,125,35,1,00277,India
985234,2023-06-12,210,mountain dew,75,100,25,1,00277,India
909363,2023-06-12,203,mango yogurt,50,60,10,1,00354,India
909363,2023-06-12,208,sprite,75,100,25,1,00354,India
909363,2023-06-12,212,amul cheese,250,315,65,1,00354,India
909363,2023-06-12,213,bisleri,6,15,9,1,00354,India
519505,2023-06-12,207,coca cola,75,100,25,1,00478,India
519505,2023-06-12,211,red bull,90,125,35,1,00478,India
519505,2023-06-12,213,bisleri,6,15,9,1,00478,India
519505,2023-06-12,210,mountain dew,75,100,25,1,00478,India
269214,2023-06-12,211,red bull,90,125,35,1,00342,India
269214,2023-06-12,210,mountain dew,75,100,25,1,00342,India
269214,2023-06-12,212,amul cheese,250,315,65,1,00342,India
627576,2023-06-12,209,pepsi,75,100,25,1,00164,India
627576,2023-06-12,205,classic yogurt,45,60,15,1,00164,India
627576,2023-06-12,210,mountain dew,75,100,25,1,00164,India
627576,2023-06-12,202,milk,12,27,15,1,00164,India
699597,2023-06-12,209,pepsi,75,100,25,1,00440,India
699597,2023-06-12,213,bisleri,6,15,9,1,00440,India
699597,2023-06-12,202,milk,12,27,15,1,00440,India
699597,2023-06-12,205,classic yogurt,45,60,15,1,00440,India
699597,2023-06-12,210,mountain dew,75,100,25,1,00440,India
190161,2023-06-12,212,amul cheese,250,315,65,1,00048,India
190161,2023-06-12,210,mountain dew,75,100,25,1,00048,India
322052,2023-06-12,211,red bull,90,125,35,1,00104,India
322052,2023-06-12,212,amul cheese,250,315,65,1,00104,India
322052,2023-06-12,210,mountain dew,75,100,25,1,00104,India
322052,2023-06-12,208,sprite,75,100,25,1,00104,India
461878,2023-06-12,207,coca cola,75,100,25,1,00029,India
461878,2023-06-12,209,pepsi,75,100,25,1,00029,India
461878,2023-06-12,211,red bull,90,125,35,1,00029,India
556603,2023-06-12,202,milk,12,27,15,1,00293,India
556603,2023-06-12,204,strawberry yogurt,50,60,10,1,00293,India
556603,2023-06-12,210,mountain dew,75,100,25,1,00293,India
463295,2023-06-12,204,strawberry yogurt,50,60,10,1,00452,India
463295,2023-06-12,203,mango yogurt,50,60,10,1,00452,India
463295,2023-06-12,209,pepsi,75,100,25,1,00452,India
212294,2023-06-12,205,classic yogurt,45,60,15,1,00406,India
212294,2023-06-12,201,paneer,210,340,130,1,00406,India
212294,2023-06-12,203,mango yogurt,50,60,10,1,00406,India
212294,2023-06-12,209,pepsi,75,100,25,1,00406,India
348015,2023-06-12,201,paneer,210,340,130,1,00453,India
348015,2023-06-12,208,sprite,75,100,25,1,00453,India
520021,2023-06-12,207,coca cola,75,100,25,1,00335,India
520021,2023-06-12,212,amul cheese,250,315,65,1,00335,India
751604,2023-06-12,207,coca cola,75,100,25,1,00004,India
751604,2023-06-12,213,bisleri,6,15,9,1,00004,India
751604,2023-06-12,208,sprite,75,100,25,1,00004,India
274936,2023-06-12,205,classic yogurt,45,60,15,1,00101,India
274936,2023-06-12,212,amul cheese,250,315,65,1,00101,India
274936,2023-06-12,207,coca cola,75,100,25,1,00101,India
274936,2023-06-12,211,red bull,90,125,35,1,00101,India
274936,2023-06-12,204,strawberry yogurt,50,60,10,1,00101,India
987092,2023-06-12,207,coca cola,75,100,25,1,00208,India
987092,2023-06-12,209,pepsi,75,100,25,1,00208,India
987092,2023-06-12,202,milk,12,27,15,1,00208,India
987092,2023-06-12,205,classic yogurt,45,60,15,1,00208,India
987092,2023-06-12,203,mango yogurt,50,60,10,1,00208,India
812755,2023-06-12,208,sprite,75,100,25,1,00258,India
812755,2023-06-12,204,strawberry yogurt,50,60,10,1,00258,India
293886,2023-06-12,203,mango yogurt,50,60,10,1,00189,India
882323,2023-06-12,204,strawberry yogurt,50,60,10,1,00457,India
882323,2023-06-12,202,milk,12,27,15,1,00457,India
882323,2023-06-12,210,mountain dew,75,100,25,1,00457,India
882323,2023-06-12,206,yakult,360,400,40,1,00457,India
258374,2023-06-12,212,amul cheese,250,315,65,1,00444,India
122661,2023-06-12,213,bisleri,6,15,9,1,00151,India
838985,2023-06-12,208,sprite,75,100,25,1,00336,India
838985,2023-06-12,204,strawberry yogurt,50,60,10,1,00336,India
838985,2023-06-12,205,classic yogurt,45,60,15,1,00336,India
838985,2023-06-12,210,mountain dew,75,100,25,1,00336,India
278297,2023-06-12,201,paneer,210,340,130,1,00421,India
278297,2023-06-12,213,bisleri,6,15,9,1,00421,India
278297,2023-06-12,205,classic yogurt,45,60,15,1,00421,India
990434,2023-06-12,212,amul cheese,250,315,65,1,00471,India
990434,2023-06-12,203,mango yogurt,50,60,10,1,00471,India
638044,2023-06-12,207,coca cola,75,100,25,1,00499,India
638044,2023-06-12,212,amul cheese,250,315,65,1,00499,India
638044,2023-06-12,209,pepsi,75,100,25,1,00499,India
855226,2023-06-12,203,mango yogurt,50,60,10,1,00427,India
855226,2023-06-12,207,coca cola,75,100,25,1,00427,India
855226,2023-06-12,213,bisleri,6,15,9,1,00427,India
710530,2023-06-12,208,sprite,75,100,25,1,00396,India
710530,2023-06-12,204,strawberry yogurt,50,60,10,1,00396,India
994233,2023-06-12,209,pepsi,75,100,25,1,00243,India
994233,2023-06-12,207,coca cola,75,100,25,1,00243,India
994233,2023-06-12,205,classic yogurt,45,60,15,1,00243,India
970843,2023-06-12,207,coca cola,75,100,25,1,00347,India
970843,2023-06-12,210,mountain dew,75,100,25,1,00347,India
970843,2023-06-12,203,mango yogurt,50,60,10,1,00347,India
522163,2023-06-12,201,paneer,210,340,130,1,00185,India
522163,2023-06-12,213,bisleri,6,15,9,1,00185,India
522163,2023-06-12,205,classic yogurt,45,60,15,1,00185,India
908792,2023-06-12,208,sprite,75,100,25,1,00230,India
908792,2023-06-12,211,red bull,90,125,35,1,00230,India
908792,2023-06-12,206,yakult,360,400,40,1,00230,India
304298,2023-06-13,203,mango yogurt,50,60,10,1,00172,India
304298,2023-06-13,210,mountain dew,75,100,25,1,00172,India
304298,2023-06-13,202,milk,12,27,15,1,00172,India
197726,2023-06-13,211,red bull,90,125,35,1,00482,India
890448,2023-06-13,205,classic yogurt,45,60,15,1,00051,India
890448,2023-06-13,213,bisleri,6,15,9,1,00051,India
239450,2023-06-13,209,pepsi,75,100,25,1,00253,India
906471,2023-06-13,203,mango yogurt,50,60,10,1,00230,India
886572,2023-06-13,211,red bull,90,125,35,1,00419,India
886572,2023-06-13,202,milk,12,27,15,1,00419,India
886572,2023-06-13,201,paneer,210,340,130,1,00419,India
886572,2023-06-13,210,mountain dew,75,100,25,1,00419,India
888222,2023-06-13,208,sprite,75,100,25,1,00500,India
102335,2023-06-13,213,bisleri,6,15,9,1,00431,India
102335,2023-06-13,202,milk,12,27,15,1,00431,India
102335,2023-06-13,204,strawberry yogurt,50,60,10,1,00431,India
102335,2023-06-13,211,red bull,90,125,35,1,00431,India
297748,2023-06-13,213,bisleri,6,15,9,1,00235,India
297748,2023-06-13,212,amul cheese,250,315,65,1,00235,India
297748,2023-06-13,209,pepsi,75,100,25,1,00235,India
229306,2023-06-13,211,red bull,90,125,35,1,00347,India
229306,2023-06-13,210,mountain dew,75,100,25,1,00347,India
229306,2023-06-13,207,coca cola,75,100,25,1,00347,India
229306,2023-06-13,206,yakult,360,400,40,1,00347,India
229306,2023-06-13,203,mango yogurt,50,60,10,1,00347,India
230746,2023-06-13,212,amul cheese,250,315,65,1,00010,India
230746,2023-06-13,202,milk,12,27,15,1,00010,India
230746,2023-06-13,208,sprite,75,100,25,1,00010,India
458032,2023-06-13,206,yakult,360,400,40,1,00330,India
458032,2023-06-13,202,milk,12,27,15,1,00330,India
458032,2023-06-13,208,sprite,75,100,25,1,00330,India
458032,2023-06-13,204,strawberry yogurt,50,60,10,1,00330,India
855358,2023-06-13,210,mountain dew,75,100,25,1,00277,India
855358,2023-06-13,209,pepsi,75,100,25,1,00277,India
914654,2023-06-13,201,paneer,210,340,130,1,00262,India
914654,2023-06-13,203,mango yogurt,50,60,10,1,00262,India
914654,2023-06-13,204,strawberry yogurt,50,60,10,1,00262,India
914654,2023-06-13,205,classic yogurt,45,60,15,1,00262,India
914654,2023-06-13,206,yakult,360,400,40,1,00262,India
399844,2023-06-13,208,sprite,75,100,25,1,00374,India
399844,2023-06-13,206,yakult,360,400,40,1,00374,India
756099,2023-06-13,205,classic yogurt,45,60,15,1,00265,India
756099,2023-06-13,207,coca cola,75,100,25,1,00265,India
756099,2023-06-13,208,sprite,75,100,25,1,00265,India
756099,2023-06-13,204,strawberry yogurt,50,60,10,1,00265,India
136404,2023-06-13,201,paneer,210,340,130,1,00486,India
730827,2023-06-13,210,mountain dew,75,100,25,1,00485,India
730827,2023-06-13,207,coca cola,75,100,25,1,00485,India
730827,2023-06-13,212,amul cheese,250,315,65,1,00485,India
570048,2023-06-13,207,coca cola,75,100,25,1,00484,India
570048,2023-06-13,203,mango yogurt,50,60,10,1,00484,India
570048,2023-06-13,201,paneer,210,340,130,1,00484,India
570048,2023-06-13,209,pepsi,75,100,25,1,00484,India
570048,2023-06-13,208,sprite,75,100,25,1,00484,India
414080,2023-06-13,203,mango yogurt,50,60,10,1,00438,India
414080,2023-06-13,208,sprite,75,100,25,1,00438,India
414080,2023-06-13,213,bisleri,6,15,9,1,00438,India
414080,2023-06-13,209,pepsi,75,100,25,1,00438,India
414080,2023-06-13,201,paneer,210,340,130,1,00438,India
230177,2023-06-13,207,coca cola,75,100,25,1,00002,India
995590,2023-06-13,204,strawberry yogurt,50,60,10,1,00312,India
239648,2023-06-13,204,strawberry yogurt,50,60,10,1,00230,India
239648,2023-06-13,210,mountain dew,75,100,25,1,00230,India
239648,2023-06-13,209,pepsi,75,100,25,1,00230,India
937122,2023-06-13,201,paneer,210,340,130,1,00478,India
937122,2023-06-13,213,bisleri,6,15,9,1,00478,India
937122,2023-06-13,206,yakult,360,400,40,1,00478,India
937122,2023-06-13,207,coca cola,75,100,25,1,00478,India
937122,2023-06-13,203,mango yogurt,50,60,10,1,00478,India
213577,2023-06-13,205,classic yogurt,45,60,15,1,00234,India
213577,2023-06-13,202,milk,12,27,15,1,00234,India
491643,2023-06-13,205,classic yogurt,45,60,15,1,00077,India
491643,2023-06-13,212,amul cheese,250,315,65,1,00077,India
491643,2023-06-13,209,pepsi,75,100,25,1,00077,India
491643,2023-06-13,204,strawberry yogurt,50,60,10,1,00077,India
103762,2023-06-13,212,amul cheese,250,315,65,1,00362,India
103762,2023-06-13,203,mango yogurt,50,60,10,1,00362,India
103762,2023-06-13,210,mountain dew,75,100,25,1,00362,India
103762,2023-06-13,201,paneer,210,340,130,1,00362,India
843035,2023-06-13,211,red bull,90,125,35,1,00040,India
843035,2023-06-13,208,sprite,75,100,25,1,00040,India
843035,2023-06-13,203,mango yogurt,50,60,10,1,00040,India
859605,2023-06-13,213,bisleri,6,15,9,1,00083,India
859605,2023-06-13,211,red bull,90,125,35,1,00083,India
859605,2023-06-13,206,yakult,360,400,40,1,00083,India
859605,2023-06-13,212,amul cheese,250,315,65,1,00083,India
138027,2023-06-13,207,coca cola,75,100,25,1,00018,India
138027,2023-06-13,206,yakult,360,400,40,1,00018,India
973775,2023-06-13,201,paneer,210,340,130,1,00086,India
973775,2023-06-13,213,bisleri,6,15,9,1,00086,India
735107,2023-06-13,213,bisleri,6,15,9,1,00311,India
881751,2023-06-13,204,strawberry yogurt,50,60,10,1,00281,India
549484,2023-06-13,203,mango yogurt,50,60,10,1,00398,India
549484,2023-06-13,208,sprite,75,100,25,1,00398,India
756285,2023-06-13,202,milk,12,27,15,1,00408,India
756285,2023-06-13,208,sprite,75,100,25,1,00408,India
756285,2023-06-13,205,classic yogurt,45,60,15,1,00408,India
756285,2023-06-13,209,pepsi,75,100,25,1,00408,India
756285,2023-06-13,213,bisleri,6,15,9,1,00408,India
737651,2023-06-13,212,amul cheese,250,315,65,1,00254,India
737651,2023-06-13,209,pepsi,75,100,25,1,00254,India
737651,2023-06-13,201,paneer,210,340,130,1,00254,India
737651,2023-06-13,206,yakult,360,400,40,1,00254,India
737651,2023-06-13,207,coca cola,75,100,25,1,00254,India
252615,2023-06-13,202,milk,12,27,15,1,00392,India
252615,2023-06-13,209,pepsi,75,100,25,1,00392,India
252615,2023-06-13,207,coca cola,75,100,25,1,00392,India
252615,2023-06-13,203,mango yogurt,50,60,10,1,00392,India
907795,2023-06-13,211,red bull,90,125,35,1,00048,India
496847,2023-06-13,212,amul cheese,250,315,65,1,00231,India
496847,2023-06-13,207,coca cola,75,100,25,1,00231,India
496847,2023-06-13,213,bisleri,6,15,9,1,00231,India
496847,2023-06-13,208,sprite,75,100,25,1,00231,India
496847,2023-06-13,204,strawberry yogurt,50,60,10,1,00231,India
563718,2023-06-13,211,red bull,90,125,35,1,00258,India
563718,2023-06-13,209,pepsi,75,100,25,1,00258,India
563718,2023-06-13,203,mango yogurt,50,60,10,1,00258,India
563718,2023-06-13,204,strawberry yogurt,50,60,10,1,00258,India
563718,2023-06-13,208,sprite,75,100,25,1,00258,India
161691,2023-06-13,202,milk,12,27,15,1,00231,India
161691,2023-06-13,205,classic yogurt,45,60,15,1,00231,India
169790,2023-06-13,201,paneer,210,340,130,1,00447,India
169790,2023-06-13,212,amul cheese,250,315,65,1,00447,India
169790,2023-06-13,210,mountain dew,75,100,25,1,00447,India
169790,2023-06-13,204,strawberry yogurt,50,60,10,1,00447,India
169790,2023-06-13,206,yakult,360,400,40,1,00447,India
839445,2023-06-13,213,bisleri,6,15,9,1,00281,India
354552,2023-06-13,212,amul cheese,250,315,65,1,00282,India
354552,2023-06-13,213,bisleri,6,15,9,1,00282,India
354552,2023-06-13,204,strawberry yogurt,50,60,10,1,00282,India
865849,2023-06-13,211,red bull,90,125,35,1,00118,India
865849,2023-06-13,201,paneer,210,340,130,1,00118,India
865849,2023-06-13,205,classic yogurt,45,60,15,1,00118,India
865849,2023-06-13,206,yakult,360,400,40,1,00118,India
364305,2023-06-13,211,red bull,90,125,35,1,00199,India
364305,2023-06-13,206,yakult,360,400,40,1,00199,India
673672,2023-06-13,213,bisleri,6,15,9,1,00338,India
673672,2023-06-13,206,yakult,360,400,40,1,00338,India
673672,2023-06-13,204,strawberry yogurt,50,60,10,1,00338,India
673672,2023-06-13,208,sprite,75,100,25,1,00338,India
741390,2023-06-13,211,red bull,90,125,35,1,00326,India
741390,2023-06-13,201,paneer,210,340,130,1,00326,India
210674,2023-06-13,202,milk,12,27,15,1,00055,India
705439,2023-06-13,202,milk,12,27,15,1,00035,India
705439,2023-06-13,207,coca cola,75,100,25,1,00035,India
875434,2023-06-13,210,mountain dew,75,100,25,1,00420,India
875434,2023-06-13,207,coca cola,75,100,25,1,00420,India
542238,2023-06-13,206,yakult,360,400,40,1,00294,India
542238,2023-06-13,202,milk,12,27,15,1,00294,India
542238,2023-06-13,205,classic yogurt,45,60,15,1,00294,India
337483,2023-06-13,208,sprite,75,100,25,1,00169,India
337483,2023-06-13,213,bisleri,6,15,9,1,00169,India
337483,2023-06-13,212,amul cheese,250,315,65,1,00169,India
731202,2023-06-13,208,sprite,75,100,25,1,00353,India
731202,2023-06-13,210,mountain dew,75,100,25,1,00353,India
731202,2023-06-13,212,amul cheese,250,315,65,1,00353,India
500546,2023-06-13,201,paneer,210,340,130,1,00136,India
500546,2023-06-13,203,mango yogurt,50,60,10,1,00136,India
500546,2023-06-13,205,classic yogurt,45,60,15,1,00136,India
414003,2023-06-13,201,paneer,210,340,130,1,00195,India
414003,2023-06-13,209,pepsi,75,100,25,1,00195,India
282734,2023-06-13,203,mango yogurt,50,60,10,1,00412,India
282734,2023-06-13,204,strawberry yogurt,50,60,10,1,00412,India
282734,2023-06-13,210,mountain dew,75,100,25,1,00412,India
159131,2023-06-13,205,classic yogurt,45,60,15,1,00221,India
159131,2023-06-13,201,paneer,210,340,130,1,00221,India
159131,2023-06-13,211,red bull,90,125,35,1,00221,India
159131,2023-06-13,210,mountain dew,75,100,25,1,00221,India
768117,2023-06-13,213,bisleri,6,15,9,1,00041,India
768117,2023-06-13,211,red bull,90,125,35,1,00041,India
768117,2023-06-13,210,mountain dew,75,100,25,1,00041,India
768117,2023-06-13,208,sprite,75,100,25,1,00041,India
768117,2023-06-13,204,strawberry yogurt,50,60,10,1,00041,India
587641,2023-06-13,204,strawberry yogurt,50,60,10,1,00155,India
303070,2023-06-13,205,classic yogurt,45,60,15,1,00142,India
303070,2023-06-13,211,red bull,90,125,35,1,00142,India
185755,2023-06-13,207,coca cola,75,100,25,1,00008,India
185755,2023-06-13,205,classic yogurt,45,60,15,1,00008,India
185755,2023-06-13,208,sprite,75,100,25,1,00008,India
185755,2023-06-13,212,amul cheese,250,315,65,1,00008,India
768929,2023-06-13,207,coca cola,75,100,25,1,00480,India
768929,2023-06-13,206,yakult,360,400,40,1,00480,India
768929,2023-06-13,208,sprite,75,100,25,1,00480,India
423740,2023-06-13,204,strawberry yogurt,50,60,10,1,00091,India
696849,2023-06-13,213,bisleri,6,15,9,1,00209,India
847771,2023-06-13,201,paneer,210,340,130,1,00077,India
921163,2023-06-13,212,amul cheese,250,315,65,1,00283,India
560413,2023-06-13,201,paneer,210,340,130,1,00269,India
388322,2023-06-13,211,red bull,90,125,35,1,00387,India
460855,2023-06-13,205,classic yogurt,45,60,15,1,00191,India
460855,2023-06-13,209,pepsi,75,100,25,1,00191,India
460855,2023-06-13,213,bisleri,6,15,9,1,00191,India
460855,2023-06-13,201,paneer,210,340,130,1,00191,India
398601,2023-06-13,213,bisleri,6,15,9,1,00421,India
398601,2023-06-13,203,mango yogurt,50,60,10,1,00421,India
398601,2023-06-13,211,red bull,90,125,35,1,00421,India
398601,2023-06-13,202,milk,12,27,15,1,00421,India
321829,2023-06-13,206,yakult,360,400,40,1,00335,India
321829,2023-06-13,210,mountain dew,75,100,25,1,00335,India
321829,2023-06-13,211,red bull,90,125,35,1,00335,India
206501,2023-06-13,211,red bull,90,125,35,1,00140,India
206501,2023-06-13,212,amul cheese,250,315,65,1,00140,India
207429,2023-06-13,211,red bull,90,125,35,1,00206,India
207429,2023-06-13,204,strawberry yogurt,50,60,10,1,00206,India
207429,2023-06-13,207,coca cola,75,100,25,1,00206,India
207429,2023-06-13,213,bisleri,6,15,9,1,00206,India
207429,2023-06-13,210,mountain dew,75,100,25,1,00206,India
579691,2023-06-13,211,red bull,90,125,35,1,00098,India
579691,2023-06-13,206,yakult,360,400,40,1,00098,India
579691,2023-06-13,212,amul cheese,250,315,65,1,00098,India
535379,2023-06-13,203,mango yogurt,50,60,10,1,00176,India
535379,2023-06-13,205,classic yogurt,45,60,15,1,00176,India
535379,2023-06-13,209,pepsi,75,100,25,1,00176,India
386612,2023-06-13,201,paneer,210,340,130,1,00219,India
386612,2023-06-13,202,milk,12,27,15,1,00219,India
386612,2023-06-13,210,mountain dew,75,100,25,1,00219,India
440116,2023-06-13,206,yakult,360,400,40,1,00330,India
440116,2023-06-13,210,mountain dew,75,100,25,1,00330,India
440116,2023-06-13,209,pepsi,75,100,25,1,00330,India
440116,2023-06-13,211,red bull,90,125,35,1,00330,India
222069,2023-06-13,204,strawberry yogurt,50,60,10,1,00449,India
222069,2023-06-13,208,sprite,75,100,25,1,00449,India
139481,2023-06-13,210,mountain dew,75,100,25,1,00356,India
139481,2023-06-13,202,milk,12,27,15,1,00356,India
139481,2023-06-13,211,red bull,90,125,35,1,00356,India
139481,2023-06-13,212,amul cheese,250,315,65,1,00356,India
788425,2023-06-13,209,pepsi,75,100,25,1,00243,India
788425,2023-06-13,207,coca cola,75,100,25,1,00243,India
788425,2023-06-13,211,red bull,90,125,35,1,00243,India
856955,2023-06-13,207,coca cola,75,100,25,1,00240,India
856955,2023-06-13,208,sprite,75,100,25,1,00240,India
221749,2023-06-13,210,mountain dew,75,100,25,1,00487,India
221749,2023-06-13,206,yakult,360,400,40,1,00487,India
578789,2023-06-13,201,paneer,210,340,130,1,00351,India
578789,2023-06-13,203,mango yogurt,50,60,10,1,00351,India
578789,2023-06-13,208,sprite,75,100,25,1,00351,India
741121,2023-06-13,213,bisleri,6,15,9,1,00274,India
741121,2023-06-13,201,paneer,210,340,130,1,00274,India
774693,2023-06-13,213,bisleri,6,15,9,1,00288,India
774693,2023-06-13,201,paneer,210,340,130,1,00288,India
740333,2023-06-13,204,strawberry yogurt,50,60,10,1,00247,India
740333,2023-06-13,201,paneer,210,340,130,1,00247,India
740333,2023-06-13,210,mountain dew,75,100,25,1,00247,India
740333,2023-06-13,202,milk,12,27,15,1,00247,India
740333,2023-06-13,207,coca cola,75,100,25,1,00247,India
168386,2023-06-13,202,milk,12,27,15,1,00368,India
168386,2023-06-13,211,red bull,90,125,35,1,00368,India
168386,2023-06-13,208,sprite,75,100,25,1,00368,India
900724,2023-06-13,204,strawberry yogurt,50,60,10,1,00324,India
209351,2023-06-13,209,pepsi,75,100,25,1,00262,India
209351,2023-06-13,213,bisleri,6,15,9,1,00262,India
209351,2023-06-13,210,mountain dew,75,100,25,1,00262,India
474214,2023-06-14,212,amul cheese,250,315,65,1,00350,India
474214,2023-06-14,202,milk,12,27,15,1,00350,India
474214,2023-06-14,201,paneer,210,340,130,1,00350,India
474214,2023-06-14,203,mango yogurt,50,60,10,1,00350,India
448689,2023-06-14,203,mango yogurt,50,60,10,1,00071,India
595126,2023-06-14,207,coca cola,75,100,25,1,00090,India
595126,2023-06-14,203,mango yogurt,50,60,10,1,00090,India
608895,2023-06-14,204,strawberry yogurt,50,60,10,1,00352,India
608895,2023-06-14,203,mango yogurt,50,60,10,1,00352,India
608895,2023-06-14,202,milk,12,27,15,1,00352,India
608895,2023-06-14,213,bisleri,6,15,9,1,00352,India
831252,2023-06-14,207,coca cola,75,100,25,1,00225,India
300516,2023-06-14,203,mango yogurt,50,60,10,1,00110,India
300516,2023-06-14,204,strawberry yogurt,50,60,10,1,00110,India
286684,2023-06-14,208,sprite,75,100,25,1,00209,India
286684,2023-06-14,202,milk,12,27,15,1,00209,India
319772,2023-06-14,212,amul cheese,250,315,65,1,00183,India
319772,2023-06-14,206,yakult,360,400,40,1,00183,India
319772,2023-06-14,209,pepsi,75,100,25,1,00183,India
800882,2023-06-14,213,bisleri,6,15,9,1,00210,India
122403,2023-06-14,210,mountain dew,75,100,25,1,00278,India
122403,2023-06-14,205,classic yogurt,45,60,15,1,00278,India
122403,2023-06-14,207,coca cola,75,100,25,1,00278,India
122403,2023-06-14,213,bisleri,6,15,9,1,00278,India
983786,2023-06-14,212,amul cheese,250,315,65,1,00300,India
983786,2023-06-14,204,strawberry yogurt,50,60,10,1,00300,India
983786,2023-06-14,211,red bull,90,125,35,1,00300,India
880505,2023-06-14,203,mango yogurt,50,60,10,1,00425,India
880505,2023-06-14,211,red bull,90,125,35,1,00425,India
880505,2023-06-14,212,amul cheese,250,315,65,1,00425,India
880505,2023-06-14,209,pepsi,75,100,25,1,00425,India
565301,2023-06-14,206,yakult,360,400,40,1,00235,India
565301,2023-06-14,212,amul cheese,250,315,65,1,00235,India
689654,2023-06-14,211,red bull,90,125,35,1,00466,India
689654,2023-06-14,201,paneer,210,340,130,1,00466,India
689654,2023-06-14,202,milk,12,27,15,1,00466,India
689654,2023-06-14,204,strawberry yogurt,50,60,10,1,00466,India
689654,2023-06-14,212,amul cheese,250,315,65,1,00466,India
662564,2023-06-14,206,yakult,360,400,40,1,00124,India
378272,2023-06-14,208,sprite,75,100,25,1,00339,India
378272,2023-06-14,201,paneer,210,340,130,1,00339,India
378272,2023-06-14,209,pepsi,75,100,25,1,00339,India
378272,2023-06-14,212,amul cheese,250,315,65,1,00339,India
521321,2023-06-14,212,amul cheese,250,315,65,1,00097,India
521321,2023-06-14,208,sprite,75,100,25,1,00097,India
521321,2023-06-14,206,yakult,360,400,40,1,00097,India
521321,2023-06-14,209,pepsi,75,100,25,1,00097,India
185547,2023-06-14,210,mountain dew,75,100,25,1,00398,India
185547,2023-06-14,207,coca cola,75,100,25,1,00398,India
185547,2023-06-14,204,strawberry yogurt,50,60,10,1,00398,India
508524,2023-06-14,203,mango yogurt,50,60,10,1,00054,India
508524,2023-06-14,208,sprite,75,100,25,1,00054,India
508524,2023-06-14,205,classic yogurt,45,60,15,1,00054,India
508524,2023-06-14,209,pepsi,75,100,25,1,00054,India
942568,2023-06-14,212,amul cheese,250,315,65,1,00325,India
942568,2023-06-14,213,bisleri,6,15,9,1,00325,India
371553,2023-06-14,203,mango yogurt,50,60,10,1,00198,India
431297,2023-06-14,211,red bull,90,125,35,1,00015,India
431297,2023-06-14,204,strawberry yogurt,50,60,10,1,00015,India
854107,2023-06-14,206,yakult,360,400,40,1,00410,India
854107,2023-06-14,205,classic yogurt,45,60,15,1,00410,India
322370,2023-06-14,201,paneer,210,340,130,1,00412,India
322370,2023-06-14,208,sprite,75,100,25,1,00412,India
322370,2023-06-14,204,strawberry yogurt,50,60,10,1,00412,India
601170,2023-06-14,210,mountain dew,75,100,25,1,00392,India
601170,2023-06-14,206,yakult,360,400,40,1,00392,India
425960,2023-06-14,211,red bull,90,125,35,1,00310,India
425960,2023-06-14,209,pepsi,75,100,25,1,00310,India
425960,2023-06-14,201,paneer,210,340,130,1,00310,India
882939,2023-06-14,210,mountain dew,75,100,25,1,00328,India
882939,2023-06-14,206,yakult,360,400,40,1,00328,India
882939,2023-06-14,212,amul cheese,250,315,65,1,00328,India
882939,2023-06-14,205,classic yogurt,45,60,15,1,00328,India
882939,2023-06-14,201,paneer,210,340,130,1,00328,India
792298,2023-06-14,212,amul cheese,250,315,65,1,00052,India
199935,2023-06-14,213,bisleri,6,15,9,1,00061,India
199935,2023-06-14,205,classic yogurt,45,60,15,1,00061,India
905154,2023-06-14,211,red bull,90,125,35,1,00451,India
905154,2023-06-14,203,mango yogurt,50,60,10,1,00451,India
905154,2023-06-14,213,bisleri,6,15,9,1,00451,India
437521,2023-06-14,201,paneer,210,340,130,1,00010,India
437521,2023-06-14,213,bisleri,6,15,9,1,00010,India
437521,2023-06-14,203,mango yogurt,50,60,10,1,00010,India
437521,2023-06-14,211,red bull,90,125,35,1,00010,India
514486,2023-06-14,209,pepsi,75,100,25,1,00489,India
822401,2023-06-14,207,coca cola,75,100,25,1,00378,India
822401,2023-06-14,203,mango yogurt,50,60,10,1,00378,India
615143,2023-06-14,212,amul cheese,250,315,65,1,00401,India
181096,2023-06-14,207,coca cola,75,100,25,1,00280,India
181096,2023-06-14,212,amul cheese,250,315,65,1,00280,India
181096,2023-06-14,213,bisleri,6,15,9,1,00280,India
181096,2023-06-14,211,red bull,90,125,35,1,00280,India
181096,2023-06-14,202,milk,12,27,15,1,00280,India
663470,2023-06-14,212,amul cheese,250,315,65,1,00500,India
663470,2023-06-14,208,sprite,75,100,25,1,00500,India
663470,2023-06-14,210,mountain dew,75,100,25,1,00500,India
217686,2023-06-14,206,yakult,360,400,40,1,00410,India
217686,2023-06-14,213,bisleri,6,15,9,1,00410,India
217686,2023-06-14,209,pepsi,75,100,25,1,00410,India
217686,2023-06-14,212,amul cheese,250,315,65,1,00410,India
217686,2023-06-14,201,paneer,210,340,130,1,00410,India
786865,2023-06-14,209,pepsi,75,100,25,1,00485,India
786865,2023-06-14,213,bisleri,6,15,9,1,00485,India
786865,2023-06-14,208,sprite,75,100,25,1,00485,India
786865,2023-06-14,204,strawberry yogurt,50,60,10,1,00485,India
627197,2023-06-14,201,paneer,210,340,130,1,00072,India
420388,2023-06-14,212,amul cheese,250,315,65,1,00012,India
420388,2023-06-14,205,classic yogurt,45,60,15,1,00012,India
979834,2023-06-14,205,classic yogurt,45,60,15,1,00398,India
979834,2023-06-14,213,bisleri,6,15,9,1,00398,India
656698,2023-06-14,207,coca cola,75,100,25,1,00238,India
656698,2023-06-14,201,paneer,210,340,130,1,00238,India
656698,2023-06-14,205,classic yogurt,45,60,15,1,00238,India
542143,2023-06-14,212,amul cheese,250,315,65,1,00342,India
542143,2023-06-14,204,strawberry yogurt,50,60,10,1,00342,India
205126,2023-06-14,202,milk,12,27,15,1,00162,India
205126,2023-06-14,212,amul cheese,250,315,65,1,00162,India
205126,2023-06-14,207,coca cola,75,100,25,1,00162,India
205126,2023-06-14,204,strawberry yogurt,50,60,10,1,00162,India
205126,2023-06-14,210,mountain dew,75,100,25,1,00162,India
959073,2023-06-14,205,classic yogurt,45,60,15,1,00390,India
971390,2023-06-14,204,strawberry yogurt,50,60,10,1,00244,India
971390,2023-06-14,210,mountain dew,75,100,25,1,00244,India
971390,2023-06-14,213,bisleri,6,15,9,1,00244,India
971390,2023-06-14,202,milk,12,27,15,1,00244,India
971390,2023-06-14,212,amul cheese,250,315,65,1,00244,India
888663,2023-06-14,207,coca cola,75,100,25,1,00172,India
888663,2023-06-14,203,mango yogurt,50,60,10,1,00172,India
888663,2023-06-14,201,paneer,210,340,130,1,00172,India
985737,2023-06-14,201,paneer,210,340,130,1,00168,India
224612,2023-06-14,209,pepsi,75,100,25,1,00162,India
224612,2023-06-14,205,classic yogurt,45,60,15,1,00162,India
224612,2023-06-14,203,mango yogurt,50,60,10,1,00162,India
920665,2023-06-14,205,classic yogurt,45,60,15,1,00133,India
999938,2023-06-14,210,mountain dew,75,100,25,1,00069,India
999938,2023-06-14,204,strawberry yogurt,50,60,10,1,00069,India
999938,2023-06-14,203,mango yogurt,50,60,10,1,00069,India
934232,2023-06-14,205,classic yogurt,45,60,15,1,00197,India
934232,2023-06-14,203,mango yogurt,50,60,10,1,00197,India
934232,2023-06-14,209,pepsi,75,100,25,1,00197,India
934232,2023-06-14,210,mountain dew,75,100,25,1,00197,India
307096,2023-06-14,208,sprite,75,100,25,1,00055,India
307096,2023-06-14,212,amul cheese,250,315,65,1,00055,India
307096,2023-06-14,203,mango yogurt,50,60,10,1,00055,India
307096,2023-06-14,205,classic yogurt,45,60,15,1,00055,India
260020,2023-06-14,207,coca cola,75,100,25,1,00032,India
260020,2023-06-14,211,red bull,90,125,35,1,00032,India
861941,2023-06-14,204,strawberry yogurt,50,60,10,1,00131,India
861941,2023-06-14,201,paneer,210,340,130,1,00131,India
861941,2023-06-14,212,amul cheese,250,315,65,1,00131,India
861941,2023-06-14,210,mountain dew,75,100,25,1,00131,India
821296,2023-06-14,213,bisleri,6,15,9,1,00345,India
821296,2023-06-14,202,milk,12,27,15,1,00345,India
208336,2023-06-14,201,paneer,210,340,130,1,00091,India
215179,2023-06-14,206,yakult,360,400,40,1,00411,India
831077,2023-06-14,208,sprite,75,100,25,1,00219,India
831077,2023-06-14,205,classic yogurt,45,60,15,1,00219,India
831077,2023-06-14,209,pepsi,75,100,25,1,00219,India
831077,2023-06-14,202,milk,12,27,15,1,00219,India
831077,2023-06-14,210,mountain dew,75,100,25,1,00219,India
549555,2023-06-14,203,mango yogurt,50,60,10,1,00409,India
549555,2023-06-14,206,yakult,360,400,40,1,00409,India
549555,2023-06-14,213,bisleri,6,15,9,1,00409,India
549555,2023-06-14,202,milk,12,27,15,1,00409,India
628836,2023-06-14,203,mango yogurt,50,60,10,1,00023,India
628836,2023-06-14,213,bisleri,6,15,9,1,00023,India
155356,2023-06-14,213,bisleri,6,15,9,1,00334,India
155356,2023-06-14,209,pepsi,75,100,25,1,00334,India
155356,2023-06-14,202,milk,12,27,15,1,00334,India
155356,2023-06-14,201,paneer,210,340,130,1,00334,India
155356,2023-06-14,208,sprite,75,100,25,1,00334,India
565903,2023-06-14,207,coca cola,75,100,25,1,00075,India
565903,2023-06-14,212,amul cheese,250,315,65,1,00075,India
565903,2023-06-14,210,mountain dew,75,100,25,1,00075,India
874747,2023-06-14,209,pepsi,75,100,25,1,00347,India
874747,2023-06-14,212,amul cheese,250,315,65,1,00347,India
613276,2023-06-14,206,yakult,360,400,40,1,00042,India
613276,2023-06-14,201,paneer,210,340,130,1,00042,India
850795,2023-06-14,212,amul cheese,250,315,65,1,00126,India
850795,2023-06-14,203,mango yogurt,50,60,10,1,00126,India
850795,2023-06-14,207,coca cola,75,100,25,1,00126,India
850795,2023-06-14,206,yakult,360,400,40,1,00126,India
531113,2023-06-14,204,strawberry yogurt,50,60,10,1,00379,India
531113,2023-06-14,211,red bull,90,125,35,1,00379,India
607360,2023-06-14,210,mountain dew,75,100,25,1,00372,India
607360,2023-06-14,203,mango yogurt,50,60,10,1,00372,India
607360,2023-06-14,204,strawberry yogurt,50,60,10,1,00372,India
607360,2023-06-14,212,amul cheese,250,315,65,1,00372,India
607360,2023-06-14,209,pepsi,75,100,25,1,00372,India
707838,2023-06-14,206,yakult,360,400,40,1,00003,India
707838,2023-06-14,212,amul cheese,250,315,65,1,00003,India
858165,2023-06-14,213,bisleri,6,15,9,1,00271,India
858165,2023-06-14,206,yakult,360,400,40,1,00271,India
858165,2023-06-14,201,paneer,210,340,130,1,00271,India
448862,2023-06-14,206,yakult,360,400,40,1,00313,India
448862,2023-06-14,210,mountain dew,75,100,25,1,00313,India
448862,2023-06-14,205,classic yogurt,45,60,15,1,00313,India
871043,2023-06-14,202,milk,12,27,15,1,00191,India
871043,2023-06-14,208,sprite,75,100,25,1,00191,India
871043,2023-06-14,209,pepsi,75,100,25,1,00191,India
871043,2023-06-14,206,yakult,360,400,40,1,00191,India
810892,2023-06-14,209,pepsi,75,100,25,1,00023,India
810892,2023-06-14,210,mountain dew,75,100,25,1,00023,India
810892,2023-06-14,202,milk,12,27,15,1,00023,India
450340,2023-06-14,204,strawberry yogurt,50,60,10,1,00015,India
450340,2023-06-14,207,coca cola,75,100,25,1,00015,India
450340,2023-06-14,208,sprite,75,100,25,1,00015,India
450340,2023-06-14,212,amul cheese,250,315,65,1,00015,India
450340,2023-06-14,211,red bull,90,125,35,1,00015,India
721720,2023-06-14,208,sprite,75,100,25,1,00330,India
317953,2023-06-15,206,yakult,360,400,40,1,00106,India
317953,2023-06-15,211,red bull,90,125,35,1,00106,India
317953,2023-06-15,203,mango yogurt,50,60,10,1,00106,India
428806,2023-06-15,211,red bull,90,125,35,1,00341,India
428806,2023-06-15,213,bisleri,6,15,9,1,00341,India
286640,2023-06-15,206,yakult,360,400,40,1,00408,India
130378,2023-06-15,211,red bull,90,125,35,1,00158,India
130378,2023-06-15,204,strawberry yogurt,50,60,10,1,00158,India
802036,2023-06-15,213,bisleri,6,15,9,1,00153,India
802036,2023-06-15,201,paneer,210,340,130,1,00153,India
802036,2023-06-15,205,classic yogurt,45,60,15,1,00153,India
884058,2023-06-15,203,mango yogurt,50,60,10,1,00011,India
884058,2023-06-15,212,amul cheese,250,315,65,1,00011,India
116677,2023-06-15,210,mountain dew,75,100,25,1,00181,India
116677,2023-06-15,201,paneer,210,340,130,1,00181,India
116677,2023-06-15,213,bisleri,6,15,9,1,00181,India
879057,2023-06-15,207,coca cola,75,100,25,1,00452,India
879057,2023-06-15,208,sprite,75,100,25,1,00452,India
376753,2023-06-15,206,yakult,360,400,40,1,00304,India
376753,2023-06-15,203,mango yogurt,50,60,10,1,00304,India
376753,2023-06-15,207,coca cola,75,100,25,1,00304,India
376753,2023-06-15,208,sprite,75,100,25,1,00304,India
762896,2023-06-15,201,paneer,210,340,130,1,00310,India
710543,2023-06-15,202,milk,12,27,15,1,00168,India
710543,2023-06-15,213,bisleri,6,15,9,1,00168,India
710543,2023-06-15,203,mango yogurt,50,60,10,1,00168,India
710543,2023-06-15,205,classic yogurt,45,60,15,1,00168,India
272983,2023-06-15,213,bisleri,6,15,9,1,00260,India
272983,2023-06-15,202,milk,12,27,15,1,00260,India
944629,2023-06-15,205,classic yogurt,45,60,15,1,00037,India
944629,2023-06-15,207,coca cola,75,100,25,1,00037,India
555026,2023-06-15,212,amul cheese,250,315,65,1,00283,India
555026,2023-06-15,203,mango yogurt,50,60,10,1,00283,India
201119,2023-06-15,213,bisleri,6,15,9,1,00013,India
201119,2023-06-15,206,yakult,360,400,40,1,00013,India
480062,2023-06-15,201,paneer,210,340,130,1,00441,India
480062,2023-06-15,206,yakult,360,400,40,1,00441,India
793039,2023-06-15,212,amul cheese,250,315,65,1,00147,India
255355,2023-06-15,211,red bull,90,125,35,1,00173,India
255355,2023-06-15,201,paneer,210,340,130,1,00173,India
255355,2023-06-15,203,mango yogurt,50,60,10,1,00173,India
255355,2023-06-15,210,mountain dew,75,100,25,1,00173,India
334980,2023-06-15,212,amul cheese,250,315,65,1,00273,India
334980,2023-06-15,202,milk,12,27,15,1,00273,India
334980,2023-06-15,213,bisleri,6,15,9,1,00273,India
558919,2023-06-15,212,amul cheese,250,315,65,1,00384,India
558919,2023-06-15,206,yakult,360,400,40,1,00384,India
558919,2023-06-15,208,sprite,75,100,25,1,00384,India
558919,2023-06-15,213,bisleri,6,15,9,1,00384,India
882694,2023-06-15,208,sprite,75,100,25,1,00193,India
893257,2023-06-15,205,classic yogurt,45,60,15,1,00269,India
893257,2023-06-15,203,mango yogurt,50,60,10,1,00269,India
893257,2023-06-15,202,milk,12,27,15,1,00269,India
619773,2023-06-15,201,paneer,210,340,130,1,00183,India
619773,2023-06-15,208,sprite,75,100,25,1,00183,India
743369,2023-06-15,206,yakult,360,400,40,1,00222,India
743369,2023-06-15,211,red bull,90,125,35,1,00222,India
743369,2023-06-15,207,coca cola,75,100,25,1,00222,India
743369,2023-06-15,201,paneer,210,340,130,1,00222,India
311229,2023-06-15,204,strawberry yogurt,50,60,10,1,00086,India
311229,2023-06-15,209,pepsi,75,100,25,1,00086,India
311229,2023-06-15,208,sprite,75,100,25,1,00086,India
311229,2023-06-15,207,coca cola,75,100,25,1,00086,India
202680,2023-06-15,201,paneer,210,340,130,1,00450,India
751895,2023-06-15,204,strawberry yogurt,50,60,10,1,00391,India
751895,2023-06-15,212,amul cheese,250,315,65,1,00391,India
751895,2023-06-15,208,sprite,75,100,25,1,00391,India
109248,2023-06-15,206,yakult,360,400,40,1,00237,India
109248,2023-06-15,205,classic yogurt,45,60,15,1,00237,India
601387,2023-06-15,212,amul cheese,250,315,65,1,00466,India
601387,2023-06-15,210,mountain dew,75,100,25,1,00466,India
601387,2023-06-15,208,sprite,75,100,25,1,00466,India
592863,2023-06-15,211,red bull,90,125,35,1,00295,India
592863,2023-06-15,204,strawberry yogurt,50,60,10,1,00295,India
592863,2023-06-15,206,yakult,360,400,40,1,00295,India
601201,2023-06-15,201,paneer,210,340,130,1,00211,India
740963,2023-06-15,203,mango yogurt,50,60,10,1,00367,India
740963,2023-06-15,212,amul cheese,250,315,65,1,00367,India
740963,2023-06-15,204,strawberry yogurt,50,60,10,1,00367,India
740963,2023-06-15,206,yakult,360,400,40,1,00367,India
690709,2023-06-15,204,strawberry yogurt,50,60,10,1,00231,India
690709,2023-06-15,206,yakult,360,400,40,1,00231,India
690709,2023-06-15,212,amul cheese,250,315,65,1,00231,India
690709,2023-06-15,201,paneer,210,340,130,1,00231,India
690709,2023-06-15,207,coca cola,75,100,25,1,00231,India
582180,2023-06-15,209,pepsi,75,100,25,1,00380,India
234930,2023-06-15,204,strawberry yogurt,50,60,10,1,00392,India
184228,2023-06-15,201,paneer,210,340,130,1,00187,India
184228,2023-06-15,208,sprite,75,100,25,1,00187,India
184228,2023-06-15,205,classic yogurt,45,60,15,1,00187,India
184228,2023-06-15,210,mountain dew,75,100,25,1,00187,India
226188,2023-06-15,213,bisleri,6,15,9,1,00104,India
611750,2023-06-15,207,coca cola,75,100,25,1,00292,India
611750,2023-06-15,205,classic yogurt,45,60,15,1,00292,India
611750,2023-06-15,201,paneer,210,340,130,1,00292,India
497058,2023-06-15,208,sprite,75,100,25,1,00079,India
497058,2023-06-15,207,coca cola,75,100,25,1,00079,India
882505,2023-06-15,202,milk,12,27,15,1,00114,India
882505,2023-06-15,203,mango yogurt,50,60,10,1,00114,India
137893,2023-06-15,211,red bull,90,125,35,1,00303,India
188557,2023-06-15,212,amul cheese,250,315,65,1,00436,India
115347,2023-06-15,208,sprite,75,100,25,1,00416,India
583926,2023-06-15,202,milk,12,27,15,1,00349,India
583926,2023-06-15,210,mountain dew,75,100,25,1,00349,India
832085,2023-06-15,207,coca cola,75,100,25,1,00426,India
832085,2023-06-15,206,yakult,360,400,40,1,00426,India
832085,2023-06-15,210,mountain dew,75,100,25,1,00426,India
550400,2023-06-15,205,classic yogurt,45,60,15,1,00328,India
550400,2023-06-15,203,mango yogurt,50,60,10,1,00328,India
507268,2023-06-15,206,yakult,360,400,40,1,00145,India
759918,2023-06-15,206,yakult,360,400,40,1,00412,India
759918,2023-06-15,212,amul cheese,250,315,65,1,00412,India
759918,2023-06-15,209,pepsi,75,100,25,1,00412,India
959970,2023-06-15,210,mountain dew,75,100,25,1,00153,India
959970,2023-06-15,205,classic yogurt,45,60,15,1,00153,India
959970,2023-06-15,212,amul cheese,250,315,65,1,00153,India
959970,2023-06-15,208,sprite,75,100,25,1,00153,India
764276,2023-06-15,211,red bull,90,125,35,1,00220,India
290150,2023-06-15,209,pepsi,75,100,25,1,00336,India
290150,2023-06-15,211,red bull,90,125,35,1,00336,India
290150,2023-06-15,207,coca cola,75,100,25,1,00336,India
579236,2023-06-15,206,yakult,360,400,40,1,00328,India
579236,2023-06-15,208,sprite,75,100,25,1,00328,India
579236,2023-06-15,211,red bull,90,125,35,1,00328,India
170169,2023-06-15,211,red bull,90,125,35,1,00254,India
170169,2023-06-15,206,yakult,360,400,40,1,00254,India
912143,2023-06-15,207,coca cola,75,100,25,1,00334,India
912143,2023-06-15,203,mango yogurt,50,60,10,1,00334,India
912143,2023-06-15,208,sprite,75,100,25,1,00334,India
562110,2023-06-15,213,bisleri,6,15,9,1,00392,India
562110,2023-06-15,211,red bull,90,125,35,1,00392,India
562110,2023-06-15,205,classic yogurt,45,60,15,1,00392,India
562110,2023-06-15,202,milk,12,27,15,1,00392,India
180333,2023-06-15,210,mountain dew,75,100,25,1,00036,India
180333,2023-06-15,213,bisleri,6,15,9,1,00036,India
919191,2023-06-15,209,pepsi,75,100,25,1,00433,India
919191,2023-06-15,207,coca cola,75,100,25,1,00433,India
919191,2023-06-15,205,classic yogurt,45,60,15,1,00433,India
564252,2023-06-16,211,red bull,90,125,35,1,00269,India
564252,2023-06-16,207,coca cola,75,100,25,1,00269,India
620249,2023-06-16,201,paneer,210,340,130,1,00364,India
620249,2023-06-16,204,strawberry yogurt,50,60,10,1,00364,India
620249,2023-06-16,211,red bull,90,125,35,1,00364,India
368624,2023-06-16,205,classic yogurt,45,60,15,1,00328,India
368624,2023-06-16,206,yakult,360,400,40,1,00328,India
658871,2023-06-16,203,mango yogurt,50,60,10,1,00085,India
658871,2023-06-16,206,yakult,360,400,40,1,00085,India
658871,2023-06-16,204,strawberry yogurt,50,60,10,1,00085,India
658871,2023-06-16,211,red bull,90,125,35,1,00085,India
658871,2023-06-16,212,amul cheese,250,315,65,1,00085,India
406249,2023-06-16,206,yakult,360,400,40,1,00165,India
406249,2023-06-16,204,strawberry yogurt,50,60,10,1,00165,India
282889,2023-06-16,201,paneer,210,340,130,1,00091,India
282889,2023-06-16,211,red bull,90,125,35,1,00091,India
282889,2023-06-16,205,classic yogurt,45,60,15,1,00091,India
338635,2023-06-16,209,pepsi,75,100,25,1,00172,India
865944,2023-06-16,213,bisleri,6,15,9,1,00190,India
865944,2023-06-16,201,paneer,210,340,130,1,00190,India
449196,2023-06-16,209,pepsi,75,100,25,1,00442,India
449196,2023-06-16,204,strawberry yogurt,50,60,10,1,00442,India
449196,2023-06-16,207,coca cola,75,100,25,1,00442,India
468477,2023-06-16,207,coca cola,75,100,25,1,00367,India
468477,2023-06-16,212,amul cheese,250,315,65,1,00367,India
468477,2023-06-16,211,red bull,90,125,35,1,00367,India
468477,2023-06-16,213,bisleri,6,15,9,1,00367,India
759158,2023-06-16,212,amul cheese,250,315,65,1,00007,India
759158,2023-06-16,206,yakult,360,400,40,1,00007,India
874766,2023-06-16,204,strawberry yogurt,50,60,10,1,00126,India
362708,2023-06-16,212,amul cheese,250,315,65,1,00327,India
362708,2023-06-16,209,pepsi,75,100,25,1,00327,India
362708,2023-06-16,208,sprite,75,100,25,1,00327,India
362708,2023-06-16,210,mountain dew,75,100,25,1,00327,India
597971,2023-06-16,201,paneer,210,340,130,1,00102,India
597971,2023-06-16,207,coca cola,75,100,25,1,00102,India
597971,2023-06-16,204,strawberry yogurt,50,60,10,1,00102,India
145604,2023-06-16,206,yakult,360,400,40,1,00355,India
145604,2023-06-16,211,red bull,90,125,35,1,00355,India
780446,2023-06-16,209,pepsi,75,100,25,1,00255,India
780446,2023-06-16,213,bisleri,6,15,9,1,00255,India
780446,2023-06-16,211,red bull,90,125,35,1,00255,India
155434,2023-06-16,212,amul cheese,250,315,65,1,00370,India
958860,2023-06-16,201,paneer,210,340,130,1,00094,India
958860,2023-06-16,213,bisleri,6,15,9,1,00094,India
958860,2023-06-16,205,classic yogurt,45,60,15,1,00094,India
958860,2023-06-16,204,strawberry yogurt,50,60,10,1,00094,India
829933,2023-06-16,211,red bull,90,125,35,1,00142,India
829933,2023-06-16,202,milk,12,27,15,1,00142,India
829933,2023-06-16,206,yakult,360,400,40,1,00142,India
965270,2023-06-16,213,bisleri,6,15,9,1,00224,India
965270,2023-06-16,208,sprite,75,100,25,1,00224,India
152409,2023-06-16,206,yakult,360,400,40,1,00293,India
152409,2023-06-16,205,classic yogurt,45,60,15,1,00293,India
152409,2023-06-16,211,red bull,90,125,35,1,00293,India
603384,2023-06-16,205,classic yogurt,45,60,15,1,00310,India
603384,2023-06-16,206,yakult,360,400,40,1,00310,India
748934,2023-06-16,206,yakult,360,400,40,1,00436,India
748934,2023-06-16,204,strawberry yogurt,50,60,10,1,00436,India
748934,2023-06-16,201,paneer,210,340,130,1,00436,India
529116,2023-06-16,210,mountain dew,75,100,25,1,00377,India
529116,2023-06-16,209,pepsi,75,100,25,1,00377,India
529116,2023-06-16,206,yakult,360,400,40,1,00377,India
153808,2023-06-16,201,paneer,210,340,130,1,00240,India
153808,2023-06-16,211,red bull,90,125,35,1,00240,India
153808,2023-06-16,207,coca cola,75,100,25,1,00240,India
153808,2023-06-16,213,bisleri,6,15,9,1,00240,India
141233,2023-06-16,201,paneer,210,340,130,1,00047,India
141233,2023-06-16,202,milk,12,27,15,1,00047,India
141233,2023-06-16,210,mountain dew,75,100,25,1,00047,India
141233,2023-06-16,209,pepsi,75,100,25,1,00047,India
610568,2023-06-16,213,bisleri,6,15,9,1,00484,India
610568,2023-06-16,208,sprite,75,100,25,1,00484,India
610568,2023-06-16,209,pepsi,75,100,25,1,00484,India
610568,2023-06-16,212,amul cheese,250,315,65,1,00484,India
610568,2023-06-16,206,yakult,360,400,40,1,00484,India
359275,2023-06-16,205,classic yogurt,45,60,15,1,00165,India
547949,2023-06-16,210,mountain dew,75,100,25,1,00484,India
112196,2023-06-16,210,mountain dew,75,100,25,1,00381,India
112196,2023-06-16,211,red bull,90,125,35,1,00381,India
112196,2023-06-16,208,sprite,75,100,25,1,00381,India
343907,2023-06-16,203,mango yogurt,50,60,10,1,00167,India
343907,2023-06-16,213,bisleri,6,15,9,1,00167,India
343907,2023-06-16,205,classic yogurt,45,60,15,1,00167,India
468671,2023-06-16,210,mountain dew,75,100,25,1,00025,India
468671,2023-06-16,209,pepsi,75,100,25,1,00025,India
468671,2023-06-16,206,yakult,360,400,40,1,00025,India
468671,2023-06-16,211,red bull,90,125,35,1,00025,India
433368,2023-06-16,205,classic yogurt,45,60,15,1,00208,India
433368,2023-06-16,204,strawberry yogurt,50,60,10,1,00208,India
433368,2023-06-16,203,mango yogurt,50,60,10,1,00208,India
433368,2023-06-16,207,coca cola,75,100,25,1,00208,India
861138,2023-06-16,213,bisleri,6,15,9,1,00022,India
861138,2023-06-16,207,coca cola,75,100,25,1,00022,India
787492,2023-06-16,204,strawberry yogurt,50,60,10,1,00141,India
787492,2023-06-16,212,amul cheese,250,315,65,1,00141,India
787492,2023-06-16,205,classic yogurt,45,60,15,1,00141,India
292884,2023-06-16,209,pepsi,75,100,25,1,00431,India
477468,2023-06-16,212,amul cheese,250,315,65,1,00004,India
972234,2023-06-16,210,mountain dew,75,100,25,1,00437,India
972234,2023-06-16,208,sprite,75,100,25,1,00437,India
972234,2023-06-16,201,paneer,210,340,130,1,00437,India
972234,2023-06-16,205,classic yogurt,45,60,15,1,00437,India
972234,2023-06-16,202,milk,12,27,15,1,00437,India
629895,2023-06-16,203,mango yogurt,50,60,10,1,00287,India
629895,2023-06-16,206,yakult,360,400,40,1,00287,India
629895,2023-06-16,213,bisleri,6,15,9,1,00287,India
468598,2023-06-16,205,classic yogurt,45,60,15,1,00092,India
493485,2023-06-16,209,pepsi,75,100,25,1,00203,India
493485,2023-06-16,207,coca cola,75,100,25,1,00203,India
493485,2023-06-16,212,amul cheese,250,315,65,1,00203,India
666240,2023-06-16,211,red bull,90,125,35,1,00261,India
613663,2023-06-16,201,paneer,210,340,130,1,00339,India
613663,2023-06-16,208,sprite,75,100,25,1,00339,India
613663,2023-06-16,213,bisleri,6,15,9,1,00339,India
570903,2023-06-16,212,amul cheese,250,315,65,1,00389,India
570903,2023-06-16,209,pepsi,75,100,25,1,00389,India
570903,2023-06-16,211,red bull,90,125,35,1,00389,India
375344,2023-06-16,205,classic yogurt,45,60,15,1,00235,India
375344,2023-06-16,206,yakult,360,400,40,1,00235,India
375344,2023-06-16,208,sprite,75,100,25,1,00235,India
375344,2023-06-16,203,mango yogurt,50,60,10,1,00235,India
489628,2023-06-16,204,strawberry yogurt,50,60,10,1,00199,India
489628,2023-06-16,203,mango yogurt,50,60,10,1,00199,India
489628,2023-06-16,207,coca cola,75,100,25,1,00199,India
489628,2023-06-16,206,yakult,360,400,40,1,00199,India
167845,2023-06-16,206,yakult,360,400,40,1,00237,India
329605,2023-06-16,203,mango yogurt,50,60,10,1,00067,India
329605,2023-06-16,207,coca cola,75,100,25,1,00067,India
678544,2023-06-16,212,amul cheese,250,315,65,1,00159,India
523940,2023-06-16,202,milk,12,27,15,1,00391,India
523940,2023-06-16,205,classic yogurt,45,60,15,1,00391,India
523940,2023-06-16,208,sprite,75,100,25,1,00391,India
634712,2023-06-16,210,mountain dew,75,100,25,1,00377,India
634712,2023-06-16,201,paneer,210,340,130,1,00377,India
634712,2023-06-16,208,sprite,75,100,25,1,00377,India
613419,2023-06-16,212,amul cheese,250,315,65,1,00325,India
613419,2023-06-16,203,mango yogurt,50,60,10,1,00325,India
613419,2023-06-16,205,classic yogurt,45,60,15,1,00325,India
898622,2023-06-17,212,amul cheese,250,315,65,1,00099,India
898622,2023-06-17,204,strawberry yogurt,50,60,10,1,00099,India
898622,2023-06-17,201,paneer,210,340,130,1,00099,India
898622,2023-06-17,209,pepsi,75,100,25,1,00099,India
691553,2023-06-17,212,amul cheese,250,315,65,1,00260,India
691553,2023-06-17,211,red bull,90,125,35,1,00260,India
279998,2023-06-17,206,yakult,360,400,40,1,00084,India
279998,2023-06-17,204,strawberry yogurt,50,60,10,1,00084,India
478365,2023-06-17,209,pepsi,75,100,25,1,00406,India
478365,2023-06-17,211,red bull,90,125,35,1,00406,India
478365,2023-06-17,205,classic yogurt,45,60,15,1,00406,India
589626,2023-06-17,204,strawberry yogurt,50,60,10,1,00175,India
589626,2023-06-17,201,paneer,210,340,130,1,00175,India
589626,2023-06-17,211,red bull,90,125,35,1,00175,India
589626,2023-06-17,209,pepsi,75,100,25,1,00175,India
589626,2023-06-17,210,mountain dew,75,100,25,1,00175,India
395827,2023-06-17,204,strawberry yogurt,50,60,10,1,00217,India
395827,2023-06-17,206,yakult,360,400,40,1,00217,India
395827,2023-06-17,213,bisleri,6,15,9,1,00217,India
395827,2023-06-17,208,sprite,75,100,25,1,00217,India
327700,2023-06-17,204,strawberry yogurt,50,60,10,1,00209,India
327700,2023-06-17,202,milk,12,27,15,1,00209,India
446938,2023-06-17,206,yakult,360,400,40,1,00042,India
656892,2023-06-17,213,bisleri,6,15,9,1,00119,India
656892,2023-06-17,202,milk,12,27,15,1,00119,India
656892,2023-06-17,204,strawberry yogurt,50,60,10,1,00119,India
600956,2023-06-17,203,mango yogurt,50,60,10,1,00019,India
600956,2023-06-17,205,classic yogurt,45,60,15,1,00019,India
154363,2023-06-17,207,coca cola,75,100,25,1,00251,India
154363,2023-06-17,210,mountain dew,75,100,25,1,00251,India
154363,2023-06-17,203,mango yogurt,50,60,10,1,00251,India
154363,2023-06-17,209,pepsi,75,100,25,1,00251,India
381883,2023-06-17,211,red bull,90,125,35,1,00350,India
381883,2023-06-17,213,bisleri,6,15,9,1,00350,India
381883,2023-06-17,205,classic yogurt,45,60,15,1,00350,India
381883,2023-06-17,210,mountain dew,75,100,25,1,00350,India
381883,2023-06-17,201,paneer,210,340,130,1,00350,India
748508,2023-06-17,206,yakult,360,400,40,1,00325,India
748508,2023-06-17,209,pepsi,75,100,25,1,00325,India
748508,2023-06-17,212,amul cheese,250,315,65,1,00325,India
748508,2023-06-17,203,mango yogurt,50,60,10,1,00325,India
295858,2023-06-17,210,mountain dew,75,100,25,1,00315,India
295858,2023-06-17,212,amul cheese,250,315,65,1,00315,India
295858,2023-06-17,207,coca cola,75,100,25,1,00315,India
295858,2023-06-17,202,milk,12,27,15,1,00315,India
197000,2023-06-17,204,strawberry yogurt,50,60,10,1,00029,India
197000,2023-06-17,209,pepsi,75,100,25,1,00029,India
197000,2023-06-17,213,bisleri,6,15,9,1,00029,India
820916,2023-06-17,204,strawberry yogurt,50,60,10,1,00313,India
820916,2023-06-17,208,sprite,75,100,25,1,00313,India
779116,2023-06-17,202,milk,12,27,15,1,00133,India
779116,2023-06-17,203,mango yogurt,50,60,10,1,00133,India
779116,2023-06-17,201,paneer,210,340,130,1,00133,India
764679,2023-06-17,205,classic yogurt,45,60,15,1,00261,India
764679,2023-06-17,204,strawberry yogurt,50,60,10,1,00261,India
764679,2023-06-17,210,mountain dew,75,100,25,1,00261,India
889783,2023-06-17,210,mountain dew,75,100,25,1,00016,India
889783,2023-06-17,203,mango yogurt,50,60,10,1,00016,India
889783,2023-06-17,204,strawberry yogurt,50,60,10,1,00016,India
889783,2023-06-17,206,yakult,360,400,40,1,00016,India
130013,2023-06-17,207,coca cola,75,100,25,1,00124,India
130013,2023-06-17,212,amul cheese,250,315,65,1,00124,India
582375,2023-06-17,207,coca cola,75,100,25,1,00375,India
582375,2023-06-17,212,amul cheese,250,315,65,1,00375,India
582375,2023-06-17,209,pepsi,75,100,25,1,00375,India
679427,2023-06-17,201,paneer,210,340,130,1,00449,India
679427,2023-06-17,202,milk,12,27,15,1,00449,India
679427,2023-06-17,204,strawberry yogurt,50,60,10,1,00449,India
679427,2023-06-17,206,yakult,360,400,40,1,00449,India
917197,2023-06-17,202,milk,12,27,15,1,00109,India
917197,2023-06-17,211,red bull,90,125,35,1,00109,India
917197,2023-06-17,213,bisleri,6,15,9,1,00109,India
917197,2023-06-17,205,classic yogurt,45,60,15,1,00109,India
917197,2023-06-17,212,amul cheese,250,315,65,1,00109,India
741902,2023-06-17,205,classic yogurt,45,60,15,1,00221,India
920234,2023-06-17,204,strawberry yogurt,50,60,10,1,00062,India
920234,2023-06-17,213,bisleri,6,15,9,1,00062,India
920234,2023-06-17,207,coca cola,75,100,25,1,00062,India
393749,2023-06-17,208,sprite,75,100,25,1,00032,India
393749,2023-06-17,210,mountain dew,75,100,25,1,00032,India
393749,2023-06-17,206,yakult,360,400,40,1,00032,India
280234,2023-06-17,211,red bull,90,125,35,1,00277,India
280234,2023-06-17,201,paneer,210,340,130,1,00277,India
254739,2023-06-17,212,amul cheese,250,315,65,1,00444,India
254739,2023-06-17,203,mango yogurt,50,60,10,1,00444,India
969329,2023-06-17,202,milk,12,27,15,1,00300,India
969329,2023-06-17,204,strawberry yogurt,50,60,10,1,00300,India
969329,2023-06-17,210,mountain dew,75,100,25,1,00300,India
219645,2023-06-17,206,yakult,360,400,40,1,00091,India
256093,2023-06-17,202,milk,12,27,15,1,00104,India
256093,2023-06-17,207,coca cola,75,100,25,1,00104,India
304367,2023-06-17,213,bisleri,6,15,9,1,00143,India
304367,2023-06-17,202,milk,12,27,15,1,00143,India
304367,2023-06-17,208,sprite,75,100,25,1,00143,India
505103,2023-06-17,207,coca cola,75,100,25,1,00097,India
505103,2023-06-17,210,mountain dew,75,100,25,1,00097,India
505103,2023-06-17,212,amul cheese,250,315,65,1,00097,India
505103,2023-06-17,213,bisleri,6,15,9,1,00097,India
534414,2023-06-17,212,amul cheese,250,315,65,1,00368,India
534414,2023-06-17,201,paneer,210,340,130,1,00368,India
534414,2023-06-17,203,mango yogurt,50,60,10,1,00368,India
534414,2023-06-17,208,sprite,75,100,25,1,00368,India
534414,2023-06-17,209,pepsi,75,100,25,1,00368,India
999551,2023-06-17,203,mango yogurt,50,60,10,1,00159,India
822983,2023-06-17,209,pepsi,75,100,25,1,00238,India
822983,2023-06-17,203,mango yogurt,50,60,10,1,00238,India
951415,2023-06-17,205,classic yogurt,45,60,15,1,00238,India
192095,2023-06-17,206,yakult,360,400,40,1,00028,India
520112,2023-06-17,211,red bull,90,125,35,1,00119,India
520112,2023-06-17,202,milk,12,27,15,1,00119,India
520112,2023-06-17,204,strawberry yogurt,50,60,10,1,00119,India
520112,2023-06-17,213,bisleri,6,15,9,1,00119,India
765368,2023-06-17,210,mountain dew,75,100,25,1,00347,India
765368,2023-06-17,207,coca cola,75,100,25,1,00347,India
765368,2023-06-17,208,sprite,75,100,25,1,00347,India
765368,2023-06-17,213,bisleri,6,15,9,1,00347,India
765368,2023-06-17,212,amul cheese,250,315,65,1,00347,India
251947,2023-06-17,212,amul cheese,250,315,65,1,00147,India
378747,2023-06-17,201,paneer,210,340,130,1,00292,India
378747,2023-06-17,202,milk,12,27,15,1,00292,India
475001,2023-06-17,212,amul cheese,250,315,65,1,00255,India
475001,2023-06-17,213,bisleri,6,15,9,1,00255,India
589623,2023-06-17,206,yakult,360,400,40,1,00375,India
589623,2023-06-17,201,paneer,210,340,130,1,00375,India
589623,2023-06-17,212,amul cheese,250,315,65,1,00375,India
589623,2023-06-17,211,red bull,90,125,35,1,00375,India
730143,2023-06-17,204,strawberry yogurt,50,60,10,1,00296,India
730143,2023-06-17,213,bisleri,6,15,9,1,00296,India
730143,2023-06-17,203,mango yogurt,50,60,10,1,00296,India
264580,2023-06-17,208,sprite,75,100,25,1,00117,India
264580,2023-06-17,212,amul cheese,250,315,65,1,00117,India
264580,2023-06-17,205,classic yogurt,45,60,15,1,00117,India
400897,2023-06-17,202,milk,12,27,15,1,00363,India
400897,2023-06-17,207,coca cola,75,100,25,1,00363,India
170507,2023-06-17,209,pepsi,75,100,25,1,00326,India
170507,2023-06-17,211,red bull,90,125,35,1,00326,India
170507,2023-06-17,205,classic yogurt,45,60,15,1,00326,India
170507,2023-06-17,212,amul cheese,250,315,65,1,00326,India
170507,2023-06-17,207,coca cola,75,100,25,1,00326,India
152723,2023-06-17,204,strawberry yogurt,50,60,10,1,00094,India
684652,2023-06-17,210,mountain dew,75,100,25,1,00103,India
684652,2023-06-17,209,pepsi,75,100,25,1,00103,India
684652,2023-06-17,202,milk,12,27,15,1,00103,India
684652,2023-06-17,205,classic yogurt,45,60,15,1,00103,India
684652,2023-06-17,204,strawberry yogurt,50,60,10,1,00103,India
670806,2023-06-17,210,mountain dew,75,100,25,1,00091,India
670806,2023-06-17,211,red bull,90,125,35,1,00091,India
670806,2023-06-17,203,mango yogurt,50,60,10,1,00091,India
564074,2023-06-17,207,coca cola,75,100,25,1,00400,India
564074,2023-06-17,210,mountain dew,75,100,25,1,00400,India
107418,2023-06-17,209,pepsi,75,100,25,1,00284,India
107418,2023-06-17,203,mango yogurt,50,60,10,1,00284,India
107418,2023-06-17,208,sprite,75,100,25,1,00284,India
107418,2023-06-17,207,coca cola,75,100,25,1,00284,India
107418,2023-06-17,204,strawberry yogurt,50,60,10,1,00284,India
472646,2023-06-17,206,yakult,360,400,40,1,00353,India
472646,2023-06-17,202,milk,12,27,15,1,00353,India
838702,2023-06-17,202,milk,12,27,15,1,00275,India
838702,2023-06-17,211,red bull,90,125,35,1,00275,India
838702,2023-06-17,213,bisleri,6,15,9,1,00275,India
923989,2023-06-17,203,mango yogurt,50,60,10,1,00264,India
923989,2023-06-17,204,strawberry yogurt,50,60,10,1,00264,India
923989,2023-06-17,208,sprite,75,100,25,1,00264,India
194264,2023-06-17,209,pepsi,75,100,25,1,00146,India
652136,2023-06-17,208,sprite,75,100,25,1,00202,India
652136,2023-06-17,201,paneer,210,340,130,1,00202,India
652136,2023-06-17,205,classic yogurt,45,60,15,1,00202,India
652136,2023-06-17,202,milk,12,27,15,1,00202,India
911629,2023-06-17,210,mountain dew,75,100,25,1,00027,India
911629,2023-06-17,211,red bull,90,125,35,1,00027,India
647507,2023-06-17,204,strawberry yogurt,50,60,10,1,00491,India
647507,2023-06-17,205,classic yogurt,45,60,15,1,00491,India
647507,2023-06-17,206,yakult,360,400,40,1,00491,India
995742,2023-06-17,203,mango yogurt,50,60,10,1,00436,India
995742,2023-06-17,213,bisleri,6,15,9,1,00436,India
995742,2023-06-17,209,pepsi,75,100,25,1,00436,India
599961,2023-06-17,213,bisleri,6,15,9,1,00339,India
599961,2023-06-17,208,sprite,75,100,25,1,00339,India
599961,2023-06-17,209,pepsi,75,100,25,1,00339,India
599961,2023-06-17,207,coca cola,75,100,25,1,00339,India
914146,2023-06-17,207,coca cola,75,100,25,1,00256,India
255386,2023-06-17,210,mountain dew,75,100,25,1,00203,India
255386,2023-06-17,207,coca cola,75,100,25,1,00203,India
243333,2023-06-17,210,mountain dew,75,100,25,1,00363,India
243333,2023-06-17,204,strawberry yogurt,50,60,10,1,00363,India
749882,2023-06-17,202,milk,12,27,15,1,00195,India
749882,2023-06-17,201,paneer,210,340,130,1,00195,India
749882,2023-06-17,213,bisleri,6,15,9,1,00195,India
749882,2023-06-17,204,strawberry yogurt,50,60,10,1,00195,India
749882,2023-06-17,210,mountain dew,75,100,25,1,00195,India
770651,2023-06-17,202,milk,12,27,15,1,00337,India
104254,2023-06-17,207,coca cola,75,100,25,1,00220,India
104254,2023-06-17,205,classic yogurt,45,60,15,1,00220,India
436244,2023-06-17,208,sprite,75,100,25,1,00480,India
436244,2023-06-17,210,mountain dew,75,100,25,1,00480,India
283884,2023-06-17,203,mango yogurt,50,60,10,1,00498,India
283884,2023-06-17,212,amul cheese,250,315,65,1,00498,India
720038,2023-06-17,201,paneer,210,340,130,1,00064,India
149871,2023-06-17,212,amul cheese,250,315,65,1,00343,India
149871,2023-06-17,203,mango yogurt,50,60,10,1,00343,India
926499,2023-06-17,205,classic yogurt,45,60,15,1,00286,India
926499,2023-06-17,207,coca cola,75,100,25,1,00286,India
926499,2023-06-17,211,red bull,90,125,35,1,00286,India
148364,2023-06-17,207,coca cola,75,100,25,1,00190,India
148364,2023-06-17,210,mountain dew,75,100,25,1,00190,India
148364,2023-06-17,213,bisleri,6,15,9,1,00190,India
859204,2023-06-17,208,sprite,75,100,25,1,00367,India
859204,2023-06-17,207,coca cola,75,100,25,1,00367,India
859204,2023-06-17,206,yakult,360,400,40,1,00367,India
859204,2023-06-17,213,bisleri,6,15,9,1,00367,India
485002,2023-06-17,213,bisleri,6,15,9,1,00126,India
485002,2023-06-17,208,sprite,75,100,25,1,00126,India
532899,2023-06-17,207,coca cola,75,100,25,1,00025,India
716168,2023-06-17,208,sprite,75,100,25,1,00373,India
716168,2023-06-17,206,yakult,360,400,40,1,00373,India
716168,2023-06-17,203,mango yogurt,50,60,10,1,00373,India
716168,2023-06-17,209,pepsi,75,100,25,1,00373,India
347072,2023-06-17,209,pepsi,75,100,25,1,00293,India
638978,2023-06-17,210,mountain dew,75,100,25,1,00134,India
152705,2023-06-17,206,yakult,360,400,40,1,00165,India
198244,2023-06-17,213,bisleri,6,15,9,1,00071,India
198244,2023-06-17,205,classic yogurt,45,60,15,1,00071,India
198244,2023-06-17,204,strawberry yogurt,50,60,10,1,00071,India
198244,2023-06-17,201,paneer,210,340,130,1,00071,India
652706,2023-06-17,212,amul cheese,250,315,65,1,00068,India
652706,2023-06-17,211,red bull,90,125,35,1,00068,India
652706,2023-06-17,209,pepsi,75,100,25,1,00068,India
900578,2023-06-17,203,mango yogurt,50,60,10,1,00378,India
900578,2023-06-17,205,classic yogurt,45,60,15,1,00378,India
900578,2023-06-17,206,yakult,360,400,40,1,00378,India
900578,2023-06-17,202,milk,12,27,15,1,00378,India
900578,2023-06-17,207,coca cola,75,100,25,1,00378,India
548913,2023-06-17,210,mountain dew,75,100,25,1,00283,India
548913,2023-06-17,206,yakult,360,400,40,1,00283,India
227916,2023-06-17,212,amul cheese,250,315,65,1,00358,India
611474,2023-06-17,206,yakult,360,400,40,1,00151,India
611474,2023-06-17,208,sprite,75,100,25,1,00151,India
611474,2023-06-17,212,amul cheese,250,315,65,1,00151,India
611474,2023-06-17,209,pepsi,75,100,25,1,00151,India
611474,2023-06-17,207,coca cola,75,100,25,1,00151,India
891981,2023-06-17,204,strawberry yogurt,50,60,10,1,00105,India
891981,2023-06-17,209,pepsi,75,100,25,1,00105,India
891981,2023-06-17,210,mountain dew,75,100,25,1,00105,India
891981,2023-06-17,206,yakult,360,400,40,1,00105,India
939014,2023-06-17,203,mango yogurt,50,60,10,1,00481,India
939014,2023-06-17,206,yakult,360,400,40,1,00481,India
939014,2023-06-17,208,sprite,75,100,25,1,00481,India
488481,2023-06-17,201,paneer,210,340,130,1,00302,India
488481,2023-06-17,207,coca cola,75,100,25,1,00302,India
488481,2023-06-17,211,red bull,90,125,35,1,00302,India
989039,2023-06-17,208,sprite,75,100,25,1,00376,India
989039,2023-06-17,207,coca cola,75,100,25,1,00376,India
989039,2023-06-17,201,paneer,210,340,130,1,00376,India
989039,2023-06-17,206,yakult,360,400,40,1,00376,India
302141,2023-06-17,212,amul cheese,250,315,65,1,00262,India
302141,2023-06-17,206,yakult,360,400,40,1,00262,India
302141,2023-06-17,202,milk,12,27,15,1,00262,India
302141,2023-06-17,211,red bull,90,125,35,1,00262,India
302141,2023-06-17,205,classic yogurt,45,60,15,1,00262,India
293875,2023-06-17,206,yakult,360,400,40,1,00205,India
293875,2023-06-17,211,red bull,90,125,35,1,00205,India
349161,2023-06-17,202,milk,12,27,15,1,00028,India
282219,2023-06-17,205,classic yogurt,45,60,15,1,00068,India
282219,2023-06-17,209,pepsi,75,100,25,1,00068,India
282219,2023-06-17,210,mountain dew,75,100,25,1,00068,India
282219,2023-06-17,213,bisleri,6,15,9,1,00068,India
663773,2023-06-17,201,paneer,210,340,130,1,00053,India
796748,2023-06-17,210,mountain dew,75,100,25,1,00322,India
796748,2023-06-17,212,amul cheese,250,315,65,1,00322,India
796748,2023-06-17,213,bisleri,6,15,9,1,00322,India
796748,2023-06-17,204,strawberry yogurt,50,60,10,1,00322,India
796748,2023-06-17,202,milk,12,27,15,1,00322,India
312278,2023-06-17,207,coca cola,75,100,25,1,00263,India
312278,2023-06-17,205,classic yogurt,45,60,15,1,00263,India
312278,2023-06-17,213,bisleri,6,15,9,1,00263,India
312278,2023-06-17,203,mango yogurt,50,60,10,1,00263,India
610084,2023-06-17,213,bisleri,6,15,9,1,00324,India
536373,2023-06-17,205,classic yogurt,45,60,15,1,00075,India
536373,2023-06-17,207,coca cola,75,100,25,1,00075,India
536373,2023-06-17,210,mountain dew,75,100,25,1,00075,India
536373,2023-06-17,206,yakult,360,400,40,1,00075,India
704659,2023-06-18,202,milk,12,27,15,1,00366,India
704659,2023-06-18,205,classic yogurt,45,60,15,1,00366,India
670707,2023-06-18,201,paneer,210,340,130,1,00332,India
670707,2023-06-18,212,amul cheese,250,315,65,1,00332,India
670707,2023-06-18,213,bisleri,6,15,9,1,00332,India
670707,2023-06-18,209,pepsi,75,100,25,1,00332,India
432452,2023-06-18,207,coca cola,75,100,25,1,00064,India
432452,2023-06-18,209,pepsi,75,100,25,1,00064,India
432452,2023-06-18,204,strawberry yogurt,50,60,10,1,00064,India
875412,2023-06-18,202,milk,12,27,15,1,00002,India
819122,2023-06-18,203,mango yogurt,50,60,10,1,00330,India
819122,2023-06-18,204,strawberry yogurt,50,60,10,1,00330,India
819122,2023-06-18,206,yakult,360,400,40,1,00330,India
819122,2023-06-18,212,amul cheese,250,315,65,1,00330,India
193027,2023-06-18,206,yakult,360,400,40,1,00431,India
193027,2023-06-18,201,paneer,210,340,130,1,00431,India
193027,2023-06-18,207,coca cola,75,100,25,1,00431,India
717829,2023-06-18,209,pepsi,75,100,25,1,00470,India
814860,2023-06-18,210,mountain dew,75,100,25,1,00232,India
814860,2023-06-18,206,yakult,360,400,40,1,00232,India
999104,2023-06-18,209,pepsi,75,100,25,1,00251,India
999104,2023-06-18,204,strawberry yogurt,50,60,10,1,00251,India
999104,2023-06-18,211,red bull,90,125,35,1,00251,India
999104,2023-06-18,201,paneer,210,340,130,1,00251,India
999104,2023-06-18,206,yakult,360,400,40,1,00251,India
805128,2023-06-18,208,sprite,75,100,25,1,00427,India
805128,2023-06-18,206,yakult,360,400,40,1,00427,India
462874,2023-06-18,206,yakult,360,400,40,1,00205,India
462874,2023-06-18,203,mango yogurt,50,60,10,1,00205,India
462874,2023-06-18,209,pepsi,75,100,25,1,00205,India
388512,2023-06-18,204,strawberry yogurt,50,60,10,1,00274,India
191050,2023-06-18,209,pepsi,75,100,25,1,00183,India
191050,2023-06-18,210,mountain dew,75,100,25,1,00183,India
327939,2023-06-18,209,pepsi,75,100,25,1,00246,India
327939,2023-06-18,207,coca cola,75,100,25,1,00246,India
570318,2023-06-18,212,amul cheese,250,315,65,1,00446,India
227832,2023-06-18,207,coca cola,75,100,25,1,00005,India
227832,2023-06-18,202,milk,12,27,15,1,00005,India
470721,2023-06-18,202,milk,12,27,15,1,00204,India
679137,2023-06-18,202,milk,12,27,15,1,00281,India
690246,2023-06-18,209,pepsi,75,100,25,1,00450,India
690246,2023-06-18,204,strawberry yogurt,50,60,10,1,00450,India
690246,2023-06-18,210,mountain dew,75,100,25,1,00450,India
690246,2023-06-18,202,milk,12,27,15,1,00450,India
210763,2023-06-18,204,strawberry yogurt,50,60,10,1,00002,India
210763,2023-06-18,205,classic yogurt,45,60,15,1,00002,India
210763,2023-06-18,210,mountain dew,75,100,25,1,00002,India
416853,2023-06-18,202,milk,12,27,15,1,00393,India
846988,2023-06-18,213,bisleri,6,15,9,1,00132,India
815288,2023-06-18,209,pepsi,75,100,25,1,00139,India
819068,2023-06-18,202,milk,12,27,15,1,00327,India
819068,2023-06-18,211,red bull,90,125,35,1,00327,India
819068,2023-06-18,205,classic yogurt,45,60,15,1,00327,India
681862,2023-06-18,206,yakult,360,400,40,1,00441,India
681862,2023-06-18,202,milk,12,27,15,1,00441,India
681862,2023-06-18,201,paneer,210,340,130,1,00441,India
681862,2023-06-18,212,amul cheese,250,315,65,1,00441,India
681862,2023-06-18,203,mango yogurt,50,60,10,1,00441,India
115150,2023-06-18,202,milk,12,27,15,1,00256,India
921515,2023-06-18,201,paneer,210,340,130,1,00297,India
921515,2023-06-18,203,mango yogurt,50,60,10,1,00297,India
921515,2023-06-18,202,milk,12,27,15,1,00297,India
921515,2023-06-18,209,pepsi,75,100,25,1,00297,India
921515,2023-06-18,206,yakult,360,400,40,1,00297,India
667692,2023-06-18,204,strawberry yogurt,50,60,10,1,00106,India
667692,2023-06-18,210,mountain dew,75,100,25,1,00106,India
758445,2023-06-18,208,sprite,75,100,25,1,00104,India
758445,2023-06-18,202,milk,12,27,15,1,00104,India
269719,2023-06-18,210,mountain dew,75,100,25,1,00065,India
269719,2023-06-18,208,sprite,75,100,25,1,00065,India
173238,2023-06-18,209,pepsi,75,100,25,1,00446,India
173238,2023-06-18,201,paneer,210,340,130,1,00446,India
173238,2023-06-18,207,coca cola,75,100,25,1,00446,India
173238,2023-06-18,206,yakult,360,400,40,1,00446,India
510380,2023-06-18,202,milk,12,27,15,1,00227,India
510380,2023-06-18,203,mango yogurt,50,60,10,1,00227,India
510380,2023-06-18,206,yakult,360,400,40,1,00227,India
510380,2023-06-18,212,amul cheese,250,315,65,1,00227,India
124940,2023-06-18,213,bisleri,6,15,9,1,00067,India
124940,2023-06-18,207,coca cola,75,100,25,1,00067,India
124940,2023-06-18,201,paneer,210,340,130,1,00067,India
124940,2023-06-18,205,classic yogurt,45,60,15,1,00067,India
124940,2023-06-18,210,mountain dew,75,100,25,1,00067,India
867776,2023-06-18,205,classic yogurt,45,60,15,1,00033,India
867776,2023-06-18,211,red bull,90,125,35,1,00033,India
867776,2023-06-18,213,bisleri,6,15,9,1,00033,India
612190,2023-06-18,201,paneer,210,340,130,1,00087,India
106421,2023-06-18,205,classic yogurt,45,60,15,1,00133,India
811573,2023-06-18,208,sprite,75,100,25,1,00382,India
811573,2023-06-18,207,coca cola,75,100,25,1,00382,India
811573,2023-06-18,201,paneer,210,340,130,1,00382,India
981992,2023-06-18,202,milk,12,27,15,1,00341,India
981992,2023-06-18,205,classic yogurt,45,60,15,1,00341,India
981992,2023-06-18,210,mountain dew,75,100,25,1,00341,India
981992,2023-06-18,201,paneer,210,340,130,1,00341,India
824100,2023-06-18,208,sprite,75,100,25,1,00450,India
824100,2023-06-18,207,coca cola,75,100,25,1,00450,India
824100,2023-06-18,206,yakult,360,400,40,1,00450,India
824100,2023-06-18,202,milk,12,27,15,1,00450,India
930503,2023-06-18,209,pepsi,75,100,25,1,00325,India
930503,2023-06-18,201,paneer,210,340,130,1,00325,India
930503,2023-06-18,213,bisleri,6,15,9,1,00325,India
930503,2023-06-18,203,mango yogurt,50,60,10,1,00325,India
650438,2023-06-18,206,yakult,360,400,40,1,00206,India
519433,2023-06-18,204,strawberry yogurt,50,60,10,1,00494,India
519433,2023-06-18,210,mountain dew,75,100,25,1,00494,India
519433,2023-06-18,201,paneer,210,340,130,1,00494,India
519433,2023-06-18,209,pepsi,75,100,25,1,00494,India
121659,2023-06-18,205,classic yogurt,45,60,15,1,00103,India
645770,2023-06-18,207,coca cola,75,100,25,1,00180,India
645770,2023-06-18,213,bisleri,6,15,9,1,00180,India
250146,2023-06-18,201,paneer,210,340,130,1,00199,India
250146,2023-06-18,210,mountain dew,75,100,25,1,00199,India
250146,2023-06-18,205,classic yogurt,45,60,15,1,00199,India
250146,2023-06-18,208,sprite,75,100,25,1,00199,India
111426,2023-06-18,211,red bull,90,125,35,1,00470,India
111426,2023-06-18,209,pepsi,75,100,25,1,00470,India
111426,2023-06-18,202,milk,12,27,15,1,00470,India
111426,2023-06-18,207,coca cola,75,100,25,1,00470,India
995222,2023-06-18,210,mountain dew,75,100,25,1,00150,India
995222,2023-06-18,203,mango yogurt,50,60,10,1,00150,India
995222,2023-06-18,211,red bull,90,125,35,1,00150,India
815771,2023-06-18,209,pepsi,75,100,25,1,00474,India
815771,2023-06-18,212,amul cheese,250,315,65,1,00474,India
815771,2023-06-18,206,yakult,360,400,40,1,00474,India
400722,2023-06-18,202,milk,12,27,15,1,00260,India
268861,2023-06-18,204,strawberry yogurt,50,60,10,1,00323,India
268861,2023-06-18,201,paneer,210,340,130,1,00323,India
268861,2023-06-18,213,bisleri,6,15,9,1,00323,India
268861,2023-06-18,209,pepsi,75,100,25,1,00323,India
207188,2023-06-18,207,coca cola,75,100,25,1,00141,India
805421,2023-06-18,212,amul cheese,250,315,65,1,00360,India
805421,2023-06-18,213,bisleri,6,15,9,1,00360,India
805421,2023-06-18,203,mango yogurt,50,60,10,1,00360,India
805421,2023-06-18,210,mountain dew,75,100,25,1,00360,India
168558,2023-06-18,201,paneer,210,340,130,1,00237,India
585724,2023-06-18,204,strawberry yogurt,50,60,10,1,00220,India
585724,2023-06-18,209,pepsi,75,100,25,1,00220,India
585724,2023-06-18,203,mango yogurt,50,60,10,1,00220,India
351552,2023-06-18,205,classic yogurt,45,60,15,1,00486,India
351552,2023-06-18,209,pepsi,75,100,25,1,00486,India
351552,2023-06-18,211,red bull,90,125,35,1,00486,India
351552,2023-06-18,213,bisleri,6,15,9,1,00486,India
404233,2023-06-18,205,classic yogurt,45,60,15,1,00279,India
410112,2023-06-18,209,pepsi,75,100,25,1,00292,India
410112,2023-06-18,212,amul cheese,250,315,65,1,00292,India
298520,2023-06-18,209,pepsi,75,100,25,1,00253,India
298520,2023-06-18,212,amul cheese,250,315,65,1,00253,India
913114,2023-06-18,205,classic yogurt,45,60,15,1,00147,India
351566,2023-06-18,203,mango yogurt,50,60,10,1,00407,India
351566,2023-06-18,210,mountain dew,75,100,25,1,00407,India
351566,2023-06-18,211,red bull,90,125,35,1,00407,India
351566,2023-06-18,213,bisleri,6,15,9,1,00407,India
378040,2023-06-18,208,sprite,75,100,25,1,00031,India
263391,2023-06-18,209,pepsi,75,100,25,1,00368,India
263391,2023-06-18,204,strawberry yogurt,50,60,10,1,00368,India
263391,2023-06-18,210,mountain dew,75,100,25,1,00368,India
543938,2023-06-18,212,amul cheese,250,315,65,1,00429,India
543938,2023-06-18,204,strawberry yogurt,50,60,10,1,00429,India
601012,2023-06-18,209,pepsi,75,100,25,1,00490,India
601012,2023-06-18,207,coca cola,75,100,25,1,00490,India
601012,2023-06-18,202,milk,12,27,15,1,00490,India
479645,2023-06-18,206,yakult,360,400,40,1,00237,India
479645,2023-06-18,202,milk,12,27,15,1,00237,India
479645,2023-06-18,207,coca cola,75,100,25,1,00237,India
299265,2023-06-18,201,paneer,210,340,130,1,00037,India
372947,2023-06-18,213,bisleri,6,15,9,1,00112,India
372947,2023-06-18,201,paneer,210,340,130,1,00112,India
372947,2023-06-18,208,sprite,75,100,25,1,00112,India
370790,2023-06-18,207,coca cola,75,100,25,1,00208,India
370790,2023-06-18,205,classic yogurt,45,60,15,1,00208,India
980517,2023-06-18,210,mountain dew,75,100,25,1,00449,India
980517,2023-06-18,212,amul cheese,250,315,65,1,00449,India
424197,2023-06-18,204,strawberry yogurt,50,60,10,1,00310,India
424197,2023-06-18,206,yakult,360,400,40,1,00310,India
867373,2023-06-18,211,red bull,90,125,35,1,00319,India
867373,2023-06-18,209,pepsi,75,100,25,1,00319,India
867373,2023-06-18,205,classic yogurt,45,60,15,1,00319,India
867373,2023-06-18,203,mango yogurt,50,60,10,1,00319,India
910315,2023-06-18,210,mountain dew,75,100,25,1,00390,India
910315,2023-06-18,212,amul cheese,250,315,65,1,00390,India
910315,2023-06-18,207,coca cola,75,100,25,1,00390,India
574757,2023-06-19,208,sprite,75,100,25,1,00411,India
574757,2023-06-19,206,yakult,360,400,40,1,00411,India
660777,2023-06-19,202,milk,12,27,15,1,00334,India
869634,2023-06-19,212,amul cheese,250,315,65,1,00374,India
869634,2023-06-19,207,coca cola,75,100,25,1,00374,India
705114,2023-06-19,205,classic yogurt,45,60,15,1,00140,India
705114,2023-06-19,201,paneer,210,340,130,1,00140,India
561690,2023-06-19,207,coca cola,75,100,25,1,00193,India
561690,2023-06-19,204,strawberry yogurt,50,60,10,1,00193,India
316363,2023-06-19,204,strawberry yogurt,50,60,10,1,00178,India
316363,2023-06-19,202,milk,12,27,15,1,00178,India
316363,2023-06-19,207,coca cola,75,100,25,1,00178,India
316363,2023-06-19,213,bisleri,6,15,9,1,00178,India
316363,2023-06-19,212,amul cheese,250,315,65,1,00178,India
425103,2023-06-19,202,milk,12,27,15,1,00058,India
228731,2023-06-19,212,amul cheese,250,315,65,1,00078,India
228731,2023-06-19,209,pepsi,75,100,25,1,00078,India
228731,2023-06-19,201,paneer,210,340,130,1,00078,India
228731,2023-06-19,207,coca cola,75,100,25,1,00078,India
228731,2023-06-19,205,classic yogurt,45,60,15,1,00078,India
204383,2023-06-19,211,red bull,90,125,35,1,00363,India
204383,2023-06-19,202,milk,12,27,15,1,00363,India
204383,2023-06-19,212,amul cheese,250,315,65,1,00363,India
204383,2023-06-19,209,pepsi,75,100,25,1,00363,India
650532,2023-06-19,206,yakult,360,400,40,1,00125,India
650532,2023-06-19,209,pepsi,75,100,25,1,00125,India
650532,2023-06-19,208,sprite,75,100,25,1,00125,India
650532,2023-06-19,211,red bull,90,125,35,1,00125,India
650532,2023-06-19,203,mango yogurt,50,60,10,1,00125,India
581585,2023-06-19,212,amul cheese,250,315,65,1,00455,India
581585,2023-06-19,201,paneer,210,340,130,1,00455,India
581585,2023-06-19,203,mango yogurt,50,60,10,1,00455,India
239368,2023-06-19,204,strawberry yogurt,50,60,10,1,00313,India
239368,2023-06-19,206,yakult,360,400,40,1,00313,India
239368,2023-06-19,208,sprite,75,100,25,1,00313,India
239368,2023-06-19,213,bisleri,6,15,9,1,00313,India
239368,2023-06-19,201,paneer,210,340,130,1,00313,India
576385,2023-06-19,211,red bull,90,125,35,1,00323,India
576385,2023-06-19,201,paneer,210,340,130,1,00323,India
576385,2023-06-19,213,bisleri,6,15,9,1,00323,India
576385,2023-06-19,205,classic yogurt,45,60,15,1,00323,India
832308,2023-06-19,208,sprite,75,100,25,1,00429,India
832308,2023-06-19,205,classic yogurt,45,60,15,1,00429,India
276927,2023-06-19,209,pepsi,75,100,25,1,00253,India
276927,2023-06-19,205,classic yogurt,45,60,15,1,00253,India
276927,2023-06-19,210,mountain dew,75,100,25,1,00253,India
959182,2023-06-19,201,paneer,210,340,130,1,00034,India
959182,2023-06-19,213,bisleri,6,15,9,1,00034,India
959182,2023-06-19,202,milk,12,27,15,1,00034,India
265847,2023-06-19,211,red bull,90,125,35,1,00376,India
265847,2023-06-19,205,classic yogurt,45,60,15,1,00376,India
265847,2023-06-19,209,pepsi,75,100,25,1,00376,India
265847,2023-06-19,202,milk,12,27,15,1,00376,India
156853,2023-06-19,202,milk,12,27,15,1,00281,India
156853,2023-06-19,211,red bull,90,125,35,1,00281,India
841859,2023-06-19,209,pepsi,75,100,25,1,00172,India
737451,2023-06-19,207,coca cola,75,100,25,1,00356,India
737451,2023-06-19,212,amul cheese,250,315,65,1,00356,India
737451,2023-06-19,206,yakult,360,400,40,1,00356,India
737451,2023-06-19,201,paneer,210,340,130,1,00356,India
970792,2023-06-19,204,strawberry yogurt,50,60,10,1,00401,India
970792,2023-06-19,213,bisleri,6,15,9,1,00401,India
970792,2023-06-19,205,classic yogurt,45,60,15,1,00401,India
379876,2023-06-19,205,classic yogurt,45,60,15,1,00135,India
379876,2023-06-19,203,mango yogurt,50,60,10,1,00135,India
379876,2023-06-19,201,paneer,210,340,130,1,00135,India
379876,2023-06-19,202,milk,12,27,15,1,00135,India
107915,2023-06-19,211,red bull,90,125,35,1,00355,India
107915,2023-06-19,205,classic yogurt,45,60,15,1,00355,India
107915,2023-06-19,213,bisleri,6,15,9,1,00355,India
563556,2023-06-19,202,milk,12,27,15,1,00411,India
515211,2023-06-19,204,strawberry yogurt,50,60,10,1,00470,India
515211,2023-06-19,208,sprite,75,100,25,1,00470,India
515211,2023-06-19,203,mango yogurt,50,60,10,1,00470,India
254148,2023-06-19,209,pepsi,75,100,25,1,00259,India
979415,2023-06-19,209,pepsi,75,100,25,1,00307,India
979415,2023-06-19,213,bisleri,6,15,9,1,00307,India
979415,2023-06-19,210,mountain dew,75,100,25,1,00307,India
964458,2023-06-19,201,paneer,210,340,130,1,00489,India
964458,2023-06-19,206,yakult,360,400,40,1,00489,India
592798,2023-06-19,212,amul cheese,250,315,65,1,00195,India
592798,2023-06-19,204,strawberry yogurt,50,60,10,1,00195,India
214545,2023-06-19,209,pepsi,75,100,25,1,00245,India
214545,2023-06-19,205,classic yogurt,45,60,15,1,00245,India
353274,2023-06-19,213,bisleri,6,15,9,1,00489,India
353274,2023-06-19,203,mango yogurt,50,60,10,1,00489,India
353274,2023-06-19,211,red bull,90,125,35,1,00489,India
971702,2023-06-19,209,pepsi,75,100,25,1,00198,India
971702,2023-06-19,206,yakult,360,400,40,1,00198,India
751544,2023-06-19,207,coca cola,75,100,25,1,00409,India
751544,2023-06-19,204,strawberry yogurt,50,60,10,1,00409,India
874237,2023-06-19,212,amul cheese,250,315,65,1,00261,India
874237,2023-06-19,202,milk,12,27,15,1,00261,India
874237,2023-06-19,205,classic yogurt,45,60,15,1,00261,India
874237,2023-06-19,203,mango yogurt,50,60,10,1,00261,India
874237,2023-06-19,213,bisleri,6,15,9,1,00261,India
663992,2023-06-19,204,strawberry yogurt,50,60,10,1,00483,India
663992,2023-06-19,209,pepsi,75,100,25,1,00483,India
663992,2023-06-19,212,amul cheese,250,315,65,1,00483,India
958220,2023-06-19,209,pepsi,75,100,25,1,00318,India
958220,2023-06-19,201,paneer,210,340,130,1,00318,India
707945,2023-06-19,205,classic yogurt,45,60,15,1,00452,India
707945,2023-06-19,210,mountain dew,75,100,25,1,00452,India
707945,2023-06-19,208,sprite,75,100,25,1,00452,India
707945,2023-06-19,213,bisleri,6,15,9,1,00452,India
371327,2023-06-19,203,mango yogurt,50,60,10,1,00123,India
371327,2023-06-19,211,red bull,90,125,35,1,00123,India
268893,2023-06-19,204,strawberry yogurt,50,60,10,1,00156,India
268893,2023-06-19,205,classic yogurt,45,60,15,1,00156,India
268893,2023-06-19,206,yakult,360,400,40,1,00156,India
450069,2023-06-19,205,classic yogurt,45,60,15,1,00292,India
497774,2023-06-19,207,coca cola,75,100,25,1,00417,India
497774,2023-06-19,210,mountain dew,75,100,25,1,00417,India
497774,2023-06-19,202,milk,12,27,15,1,00417,India
497774,2023-06-19,203,mango yogurt,50,60,10,1,00417,India
932248,2023-06-19,210,mountain dew,75,100,25,1,00054,India
932248,2023-06-19,205,classic yogurt,45,60,15,1,00054,India
909538,2023-06-19,206,yakult,360,400,40,1,00047,India
322162,2023-06-19,205,classic yogurt,45,60,15,1,00285,India
322162,2023-06-19,208,sprite,75,100,25,1,00285,India
656847,2023-06-19,210,mountain dew,75,100,25,1,00265,India
656847,2023-06-19,211,red bull,90,125,35,1,00265,India
656847,2023-06-19,207,coca cola,75,100,25,1,00265,India
125423,2023-06-19,201,paneer,210,340,130,1,00249,India
125423,2023-06-19,204,strawberry yogurt,50,60,10,1,00249,India
125423,2023-06-19,209,pepsi,75,100,25,1,00249,India
125423,2023-06-19,206,yakult,360,400,40,1,00249,India
149968,2023-06-19,201,paneer,210,340,130,1,00305,India
149968,2023-06-19,204,strawberry yogurt,50,60,10,1,00305,India
149968,2023-06-19,209,pepsi,75,100,25,1,00305,India
628603,2023-06-19,209,pepsi,75,100,25,1,00201,India
481154,2023-06-19,213,bisleri,6,15,9,1,00365,India
481154,2023-06-19,207,coca cola,75,100,25,1,00365,India
481154,2023-06-19,211,red bull,90,125,35,1,00365,India
481154,2023-06-19,203,mango yogurt,50,60,10,1,00365,India
794082,2023-06-19,213,bisleri,6,15,9,1,00024,India
794082,2023-06-19,212,amul cheese,250,315,65,1,00024,India
948651,2023-06-19,207,coca cola,75,100,25,1,00405,India
948651,2023-06-19,204,strawberry yogurt,50,60,10,1,00405,India
948651,2023-06-19,205,classic yogurt,45,60,15,1,00405,India
877491,2023-06-19,207,coca cola,75,100,25,1,00151,India
806619,2023-06-19,203,mango yogurt,50,60,10,1,00258,India
806619,2023-06-19,206,yakult,360,400,40,1,00258,India
806619,2023-06-19,204,strawberry yogurt,50,60,10,1,00258,India
806619,2023-06-19,211,red bull,90,125,35,1,00258,India
733042,2023-06-19,213,bisleri,6,15,9,1,00397,India
934027,2023-06-19,205,classic yogurt,45,60,15,1,00427,India
934027,2023-06-19,202,milk,12,27,15,1,00427,India
934027,2023-06-19,211,red bull,90,125,35,1,00427,India
676737,2023-06-19,203,mango yogurt,50,60,10,1,00293,India
676737,2023-06-19,208,sprite,75,100,25,1,00293,India
676737,2023-06-19,213,bisleri,6,15,9,1,00293,India
676737,2023-06-19,206,yakult,360,400,40,1,00293,India
462240,2023-06-19,204,strawberry yogurt,50,60,10,1,00093,India
219487,2023-06-19,207,coca cola,75,100,25,1,00492,India
219487,2023-06-19,213,bisleri,6,15,9,1,00492,India
219487,2023-06-19,212,amul cheese,250,315,65,1,00492,India
219487,2023-06-19,210,mountain dew,75,100,25,1,00492,India
681331,2023-06-19,204,strawberry yogurt,50,60,10,1,00215,India
681331,2023-06-19,210,mountain dew,75,100,25,1,00215,India
963824,2023-06-19,210,mountain dew,75,100,25,1,00137,India
963824,2023-06-19,204,strawberry yogurt,50,60,10,1,00137,India
963824,2023-06-19,205,classic yogurt,45,60,15,1,00137,India
963824,2023-06-19,208,sprite,75,100,25,1,00137,India
233917,2023-06-19,211,red bull,90,125,35,1,00192,India
233917,2023-06-19,203,mango yogurt,50,60,10,1,00192,India
233917,2023-06-19,206,yakult,360,400,40,1,00192,India
233917,2023-06-19,212,amul cheese,250,315,65,1,00192,India
429692,2023-06-19,211,red bull,90,125,35,1,00022,India
429692,2023-06-19,210,mountain dew,75,100,25,1,00022,India
886125,2023-06-19,202,milk,12,27,15,1,00127,India
886125,2023-06-19,210,mountain dew,75,100,25,1,00127,India
886125,2023-06-19,207,coca cola,75,100,25,1,00127,India
152221,2023-06-20,203,mango yogurt,50,60,10,1,00154,India
152221,2023-06-20,205,classic yogurt,45,60,15,1,00154,India
152221,2023-06-20,209,pepsi,75,100,25,1,00154,India
152221,2023-06-20,207,coca cola,75,100,25,1,00154,India
452663,2023-06-20,205,classic yogurt,45,60,15,1,00477,India
222812,2023-06-20,201,paneer,210,340,130,1,00104,India
222812,2023-06-20,206,yakult,360,400,40,1,00104,India
222812,2023-06-20,207,coca cola,75,100,25,1,00104,India
222812,2023-06-20,210,mountain dew,75,100,25,1,00104,India
714051,2023-06-20,201,paneer,210,340,130,1,00134,India
900535,2023-06-20,204,strawberry yogurt,50,60,10,1,00042,India
900535,2023-06-20,201,paneer,210,340,130,1,00042,India
953327,2023-06-20,204,strawberry yogurt,50,60,10,1,00283,India
953327,2023-06-20,212,amul cheese,250,315,65,1,00283,India
968855,2023-06-20,206,yakult,360,400,40,1,00348,India
968855,2023-06-20,207,coca cola,75,100,25,1,00348,India
968855,2023-06-20,208,sprite,75,100,25,1,00348,India
968855,2023-06-20,209,pepsi,75,100,25,1,00348,India
340586,2023-06-20,204,strawberry yogurt,50,60,10,1,00270,India
812988,2023-06-20,211,red bull,90,125,35,1,00471,India
812988,2023-06-20,210,mountain dew,75,100,25,1,00471,India
812988,2023-06-20,206,yakult,360,400,40,1,00471,India
812988,2023-06-20,205,classic yogurt,45,60,15,1,00471,India
291601,2023-06-20,211,red bull,90,125,35,1,00400,India
291601,2023-06-20,204,strawberry yogurt,50,60,10,1,00400,India
291601,2023-06-20,210,mountain dew,75,100,25,1,00400,India
291601,2023-06-20,213,bisleri,6,15,9,1,00400,India
659672,2023-06-20,212,amul cheese,250,315,65,1,00499,India
659672,2023-06-20,205,classic yogurt,45,60,15,1,00499,India
315363,2023-06-20,205,classic yogurt,45,60,15,1,00297,India
315363,2023-06-20,201,paneer,210,340,130,1,00297,India
315363,2023-06-20,207,coca cola,75,100,25,1,00297,India
431905,2023-06-20,212,amul cheese,250,315,65,1,00497,India
431905,2023-06-20,213,bisleri,6,15,9,1,00497,India
618357,2023-06-20,213,bisleri,6,15,9,1,00495,India
618357,2023-06-20,207,coca cola,75,100,25,1,00495,India
618357,2023-06-20,210,mountain dew,75,100,25,1,00495,India
618357,2023-06-20,209,pepsi,75,100,25,1,00495,India
783655,2023-06-20,206,yakult,360,400,40,1,00494,India
783655,2023-06-20,201,paneer,210,340,130,1,00494,India
783655,2023-06-20,212,amul cheese,250,315,65,1,00494,India
955086,2023-06-20,207,coca cola,75,100,25,1,00245,India
955086,2023-06-20,206,yakult,360,400,40,1,00245,India
955086,2023-06-20,209,pepsi,75,100,25,1,00245,India
312791,2023-06-20,205,classic yogurt,45,60,15,1,00086,India
312791,2023-06-20,208,sprite,75,100,25,1,00086,India
312791,2023-06-20,206,yakult,360,400,40,1,00086,India
312791,2023-06-20,211,red bull,90,125,35,1,00086,India
815776,2023-06-20,206,yakult,360,400,40,1,00490,India
815776,2023-06-20,210,mountain dew,75,100,25,1,00490,India
815776,2023-06-20,213,bisleri,6,15,9,1,00490,India
815776,2023-06-20,201,paneer,210,340,130,1,00490,India
815776,2023-06-20,203,mango yogurt,50,60,10,1,00490,India
668422,2023-06-20,208,sprite,75,100,25,1,00434,India
668422,2023-06-20,207,coca cola,75,100,25,1,00434,India
668422,2023-06-20,201,paneer,210,340,130,1,00434,India
679915,2023-06-20,208,sprite,75,100,25,1,00404,India
679915,2023-06-20,211,red bull,90,125,35,1,00404,India
679915,2023-06-20,210,mountain dew,75,100,25,1,00404,India
679915,2023-06-20,207,coca cola,75,100,25,1,00404,India
883227,2023-06-20,206,yakult,360,400,40,1,00494,India
883227,2023-06-20,211,red bull,90,125,35,1,00494,India
963590,2023-06-20,209,pepsi,75,100,25,1,00014,India
963590,2023-06-20,205,classic yogurt,45,60,15,1,00014,India
963590,2023-06-20,201,paneer,210,340,130,1,00014,India
963590,2023-06-20,208,sprite,75,100,25,1,00014,India
359080,2023-06-20,204,strawberry yogurt,50,60,10,1,00295,India
367115,2023-06-20,206,yakult,360,400,40,1,00055,India
367115,2023-06-20,209,pepsi,75,100,25,1,00055,India
367115,2023-06-20,211,red bull,90,125,35,1,00055,India
367115,2023-06-20,207,coca cola,75,100,25,1,00055,India
367115,2023-06-20,212,amul cheese,250,315,65,1,00055,India
806769,2023-06-20,212,amul cheese,250,315,65,1,00181,India
806769,2023-06-20,202,milk,12,27,15,1,00181,India
806769,2023-06-20,209,pepsi,75,100,25,1,00181,India
806769,2023-06-20,204,strawberry yogurt,50,60,10,1,00181,India
301077,2023-06-20,208,sprite,75,100,25,1,00135,India
301077,2023-06-20,201,paneer,210,340,130,1,00135,India
408993,2023-06-20,206,yakult,360,400,40,1,00218,India
408993,2023-06-20,209,pepsi,75,100,25,1,00218,India
408993,2023-06-20,205,classic yogurt,45,60,15,1,00218,India
408993,2023-06-20,210,mountain dew,75,100,25,1,00218,India
408993,2023-06-20,202,milk,12,27,15,1,00218,India
828095,2023-06-20,201,paneer,210,340,130,1,00338,India
828095,2023-06-20,210,mountain dew,75,100,25,1,00338,India
828095,2023-06-20,212,amul cheese,250,315,65,1,00338,India
897016,2023-06-20,213,bisleri,6,15,9,1,00449,India
897016,2023-06-20,210,mountain dew,75,100,25,1,00449,India
897016,2023-06-20,212,amul cheese,250,315,65,1,00449,India
897016,2023-06-20,211,red bull,90,125,35,1,00449,India
189710,2023-06-20,202,milk,12,27,15,1,00085,India
275272,2023-06-20,211,red bull,90,125,35,1,00398,India
275272,2023-06-20,213,bisleri,6,15,9,1,00398,India
275272,2023-06-20,209,pepsi,75,100,25,1,00398,India
810553,2023-06-20,213,bisleri,6,15,9,1,00263,India
839999,2023-06-20,201,paneer,210,340,130,1,00474,India
839999,2023-06-20,202,milk,12,27,15,1,00474,India
839999,2023-06-20,205,classic yogurt,45,60,15,1,00474,India
839999,2023-06-20,207,coca cola,75,100,25,1,00474,India
839999,2023-06-20,212,amul cheese,250,315,65,1,00474,India
291234,2023-06-20,206,yakult,360,400,40,1,00222,India
291234,2023-06-20,202,milk,12,27,15,1,00222,India
291234,2023-06-20,209,pepsi,75,100,25,1,00222,India
436534,2023-06-20,206,yakult,360,400,40,1,00301,India
436534,2023-06-20,201,paneer,210,340,130,1,00301,India
436534,2023-06-20,207,coca cola,75,100,25,1,00301,India
315703,2023-06-20,210,mountain dew,75,100,25,1,00289,India
707028,2023-06-20,203,mango yogurt,50,60,10,1,00298,India
707028,2023-06-20,204,strawberry yogurt,50,60,10,1,00298,India
707028,2023-06-20,202,milk,12,27,15,1,00298,India
707028,2023-06-20,213,bisleri,6,15,9,1,00298,India
707028,2023-06-20,211,red bull,90,125,35,1,00298,India
746788,2023-06-20,201,paneer,210,340,130,1,00167,India
214238,2023-06-20,208,sprite,75,100,25,1,00442,India
723581,2023-06-20,208,sprite,75,100,25,1,00140,India
723581,2023-06-20,207,coca cola,75,100,25,1,00140,India
723581,2023-06-20,212,amul cheese,250,315,65,1,00140,India
869865,2023-06-20,204,strawberry yogurt,50,60,10,1,00325,India
869865,2023-06-20,203,mango yogurt,50,60,10,1,00325,India
334417,2023-06-20,209,pepsi,75,100,25,1,00409,India
334417,2023-06-20,210,mountain dew,75,100,25,1,00409,India
334417,2023-06-20,211,red bull,90,125,35,1,00409,India
334417,2023-06-20,204,strawberry yogurt,50,60,10,1,00409,India
334417,2023-06-20,208,sprite,75,100,25,1,00409,India
700617,2023-06-20,210,mountain dew,75,100,25,1,00303,India
700617,2023-06-20,201,paneer,210,340,130,1,00303,India
648657,2023-06-20,206,yakult,360,400,40,1,00154,India
648657,2023-06-20,207,coca cola,75,100,25,1,00154,India
648657,2023-06-20,210,mountain dew,75,100,25,1,00154,India
648657,2023-06-20,212,amul cheese,250,315,65,1,00154,India
837353,2023-06-20,208,sprite,75,100,25,1,00422,India
633746,2023-06-20,205,classic yogurt,45,60,15,1,00285,India
963954,2023-06-20,210,mountain dew,75,100,25,1,00408,India
620330,2023-06-20,211,red bull,90,125,35,1,00489,India
620330,2023-06-20,207,coca cola,75,100,25,1,00489,India
620330,2023-06-20,209,pepsi,75,100,25,1,00489,India
234820,2023-06-20,205,classic yogurt,45,60,15,1,00175,India
234820,2023-06-20,204,strawberry yogurt,50,60,10,1,00175,India
234820,2023-06-20,203,mango yogurt,50,60,10,1,00175,India
956437,2023-06-20,209,pepsi,75,100,25,1,00040,India
956437,2023-06-20,206,yakult,360,400,40,1,00040,India
956437,2023-06-20,210,mountain dew,75,100,25,1,00040,India
956437,2023-06-20,203,mango yogurt,50,60,10,1,00040,India
762640,2023-06-20,205,classic yogurt,45,60,15,1,00039,India
762640,2023-06-20,204,strawberry yogurt,50,60,10,1,00039,India
762640,2023-06-20,206,yakult,360,400,40,1,00039,India
762640,2023-06-20,211,red bull,90,125,35,1,00039,India
666896,2023-06-21,211,red bull,90,125,35,1,00450,India
666896,2023-06-21,201,paneer,210,340,130,1,00450,India
666896,2023-06-21,202,milk,12,27,15,1,00450,India
666896,2023-06-21,204,strawberry yogurt,50,60,10,1,00450,India
666896,2023-06-21,205,classic yogurt,45,60,15,1,00450,India
741087,2023-06-21,212,amul cheese,250,315,65,1,00459,India
741087,2023-06-21,213,bisleri,6,15,9,1,00459,India
741087,2023-06-21,208,sprite,75,100,25,1,00459,India
741087,2023-06-21,201,paneer,210,340,130,1,00459,India
932191,2023-06-21,212,amul cheese,250,315,65,1,00039,India
185340,2023-06-21,205,classic yogurt,45,60,15,1,00044,India
185340,2023-06-21,201,paneer,210,340,130,1,00044,India
121201,2023-06-21,206,yakult,360,400,40,1,00170,India
216517,2023-06-21,213,bisleri,6,15,9,1,00346,India
216517,2023-06-21,211,red bull,90,125,35,1,00346,India
216517,2023-06-21,202,milk,12,27,15,1,00346,India
216517,2023-06-21,201,paneer,210,340,130,1,00346,India
958488,2023-06-21,211,red bull,90,125,35,1,00088,India
958488,2023-06-21,202,milk,12,27,15,1,00088,India
958488,2023-06-21,209,pepsi,75,100,25,1,00088,India
958488,2023-06-21,207,coca cola,75,100,25,1,00088,India
292804,2023-06-21,203,mango yogurt,50,60,10,1,00142,India
292804,2023-06-21,213,bisleri,6,15,9,1,00142,India
934403,2023-06-21,211,red bull,90,125,35,1,00281,India
934403,2023-06-21,202,milk,12,27,15,1,00281,India
934403,2023-06-21,207,coca cola,75,100,25,1,00281,India
937087,2023-06-21,206,yakult,360,400,40,1,00326,India
937087,2023-06-21,202,milk,12,27,15,1,00326,India
425917,2023-06-21,213,bisleri,6,15,9,1,00363,India
425917,2023-06-21,206,yakult,360,400,40,1,00363,India
425917,2023-06-21,202,milk,12,27,15,1,00363,India
988162,2023-06-21,202,milk,12,27,15,1,00213,India
988162,2023-06-21,208,sprite,75,100,25,1,00213,India
988162,2023-06-21,201,paneer,210,340,130,1,00213,India
236333,2023-06-21,204,strawberry yogurt,50,60,10,1,00270,India
236333,2023-06-21,202,milk,12,27,15,1,00270,India
236333,2023-06-21,205,classic yogurt,45,60,15,1,00270,India
138816,2023-06-21,205,classic yogurt,45,60,15,1,00174,India
138816,2023-06-21,203,mango yogurt,50,60,10,1,00174,India
138816,2023-06-21,206,yakult,360,400,40,1,00174,India
138816,2023-06-21,213,bisleri,6,15,9,1,00174,India
138816,2023-06-21,201,paneer,210,340,130,1,00174,India
488196,2023-06-21,208,sprite,75,100,25,1,00373,India
488196,2023-06-21,210,mountain dew,75,100,25,1,00373,India
488196,2023-06-21,207,coca cola,75,100,25,1,00373,India
488196,2023-06-21,213,bisleri,6,15,9,1,00373,India
708537,2023-06-21,205,classic yogurt,45,60,15,1,00057,India
708537,2023-06-21,212,amul cheese,250,315,65,1,00057,India
708537,2023-06-21,203,mango yogurt,50,60,10,1,00057,India
499290,2023-06-21,202,milk,12,27,15,1,00437,India
580922,2023-06-21,202,milk,12,27,15,1,00114,India
580922,2023-06-21,204,strawberry yogurt,50,60,10,1,00114,India
580922,2023-06-21,213,bisleri,6,15,9,1,00114,India
580922,2023-06-21,208,sprite,75,100,25,1,00114,India
936235,2023-06-21,201,paneer,210,340,130,1,00051,India
936235,2023-06-21,213,bisleri,6,15,9,1,00051,India
145235,2023-06-21,209,pepsi,75,100,25,1,00480,India
145235,2023-06-21,203,mango yogurt,50,60,10,1,00480,India
145235,2023-06-21,210,mountain dew,75,100,25,1,00480,India
323317,2023-06-21,210,mountain dew,75,100,25,1,00186,India
323317,2023-06-21,201,paneer,210,340,130,1,00186,India
279688,2023-06-21,202,milk,12,27,15,1,00247,India
279688,2023-06-21,212,amul cheese,250,315,65,1,00247,India
300597,2023-06-21,212,amul cheese,250,315,65,1,00318,India
300597,2023-06-21,205,classic yogurt,45,60,15,1,00318,India
300597,2023-06-21,209,pepsi,75,100,25,1,00318,India
300597,2023-06-21,202,milk,12,27,15,1,00318,India
271860,2023-06-21,210,mountain dew,75,100,25,1,00454,India
807705,2023-06-21,210,mountain dew,75,100,25,1,00442,India
648013,2023-06-21,213,bisleri,6,15,9,1,00132,India
648013,2023-06-21,204,strawberry yogurt,50,60,10,1,00132,India
648013,2023-06-21,208,sprite,75,100,25,1,00132,India
595275,2023-06-21,201,paneer,210,340,130,1,00417,India
595275,2023-06-21,213,bisleri,6,15,9,1,00417,India
595275,2023-06-21,206,yakult,360,400,40,1,00417,India
717061,2023-06-21,204,strawberry yogurt,50,60,10,1,00260,India
977851,2023-06-21,206,yakult,360,400,40,1,00462,India
977851,2023-06-21,205,classic yogurt,45,60,15,1,00462,India
977851,2023-06-21,202,milk,12,27,15,1,00462,India
977851,2023-06-21,212,amul cheese,250,315,65,1,00462,India
718062,2023-06-21,204,strawberry yogurt,50,60,10,1,00454,India
718062,2023-06-21,213,bisleri,6,15,9,1,00454,India
718062,2023-06-21,203,mango yogurt,50,60,10,1,00454,India
766699,2023-06-21,206,yakult,360,400,40,1,00465,India
766699,2023-06-21,211,red bull,90,125,35,1,00465,India
766699,2023-06-21,204,strawberry yogurt,50,60,10,1,00465,India
814526,2023-06-21,201,paneer,210,340,130,1,00069,India
977556,2023-06-21,207,coca cola,75,100,25,1,00132,India
977556,2023-06-21,209,pepsi,75,100,25,1,00132,India
977556,2023-06-21,208,sprite,75,100,25,1,00132,India
977556,2023-06-21,203,mango yogurt,50,60,10,1,00132,India
977556,2023-06-21,204,strawberry yogurt,50,60,10,1,00132,India
355207,2023-06-21,202,milk,12,27,15,1,00228,India
355207,2023-06-21,204,strawberry yogurt,50,60,10,1,00228,India
355207,2023-06-21,210,mountain dew,75,100,25,1,00228,India
824152,2023-06-21,204,strawberry yogurt,50,60,10,1,00219,India
904048,2023-06-21,202,milk,12,27,15,1,00307,India
904048,2023-06-21,205,classic yogurt,45,60,15,1,00307,India
904048,2023-06-21,210,mountain dew,75,100,25,1,00307,India
904048,2023-06-21,211,red bull,90,125,35,1,00307,India
461779,2023-06-21,205,classic yogurt,45,60,15,1,00240,India
461779,2023-06-21,212,amul cheese,250,315,65,1,00240,India
461779,2023-06-21,202,milk,12,27,15,1,00240,India
357100,2023-06-21,205,classic yogurt,45,60,15,1,00440,India
357100,2023-06-21,201,paneer,210,340,130,1,00440,India
314980,2023-06-21,209,pepsi,75,100,25,1,00037,India
731438,2023-06-21,206,yakult,360,400,40,1,00273,India
323044,2023-06-21,207,coca cola,75,100,25,1,00337,India
295417,2023-06-21,208,sprite,75,100,25,1,00369,India
295417,2023-06-21,209,pepsi,75,100,25,1,00369,India
295417,2023-06-21,203,mango yogurt,50,60,10,1,00369,India
295417,2023-06-21,201,paneer,210,340,130,1,00369,India
998206,2023-06-21,213,bisleri,6,15,9,1,00397,India
998206,2023-06-21,207,coca cola,75,100,25,1,00397,India
998206,2023-06-21,210,mountain dew,75,100,25,1,00397,India
998206,2023-06-21,201,paneer,210,340,130,1,00397,India
477168,2023-06-21,212,amul cheese,250,315,65,1,00075,India
477168,2023-06-21,205,classic yogurt,45,60,15,1,00075,India
477168,2023-06-21,202,milk,12,27,15,1,00075,India
477168,2023-06-21,206,yakult,360,400,40,1,00075,India
873753,2023-06-21,201,paneer,210,340,130,1,00109,India
694805,2023-06-21,209,pepsi,75,100,25,1,00156,India
538113,2023-06-21,210,mountain dew,75,100,25,1,00015,India
538113,2023-06-21,205,classic yogurt,45,60,15,1,00015,India
538113,2023-06-21,209,pepsi,75,100,25,1,00015,India
188592,2023-06-21,213,bisleri,6,15,9,1,00282,India
188592,2023-06-21,211,red bull,90,125,35,1,00282,India
188592,2023-06-21,206,yakult,360,400,40,1,00282,India
858305,2023-06-21,212,amul cheese,250,315,65,1,00108,India
858305,2023-06-21,213,bisleri,6,15,9,1,00108,India
858305,2023-06-21,202,milk,12,27,15,1,00108,India
858305,2023-06-21,207,coca cola,75,100,25,1,00108,India
858305,2023-06-21,211,red bull,90,125,35,1,00108,India
772708,2023-06-21,211,red bull,90,125,35,1,00185,India
772708,2023-06-21,210,mountain dew,75,100,25,1,00185,India
759889,2023-06-21,211,red bull,90,125,35,1,00231,India
759889,2023-06-21,203,mango yogurt,50,60,10,1,00231,India
109772,2023-06-22,211,red bull,90,125,35,1,00422,India
109772,2023-06-22,212,amul cheese,250,315,65,1,00422,India
109772,2023-06-22,206,yakult,360,400,40,1,00422,India
657480,2023-06-22,202,milk,12,27,15,1,00428,India
910974,2023-06-22,208,sprite,75,100,25,1,00334,India
977659,2023-06-22,213,bisleri,6,15,9,1,00273,India
977659,2023-06-22,205,classic yogurt,45,60,15,1,00273,India
977659,2023-06-22,206,yakult,360,400,40,1,00273,India
977659,2023-06-22,204,strawberry yogurt,50,60,10,1,00273,India
689460,2023-06-22,207,coca cola,75,100,25,1,00384,India
689460,2023-06-22,208,sprite,75,100,25,1,00384,India
689460,2023-06-22,211,red bull,90,125,35,1,00384,India
581825,2023-06-22,213,bisleri,6,15,9,1,00179,India
581825,2023-06-22,211,red bull,90,125,35,1,00179,India
581825,2023-06-22,202,milk,12,27,15,1,00179,India
498788,2023-06-22,209,pepsi,75,100,25,1,00060,India
498788,2023-06-22,203,mango yogurt,50,60,10,1,00060,India
498788,2023-06-22,205,classic yogurt,45,60,15,1,00060,India
498788,2023-06-22,201,paneer,210,340,130,1,00060,India
498788,2023-06-22,204,strawberry yogurt,50,60,10,1,00060,India
255459,2023-06-22,207,coca cola,75,100,25,1,00488,India
255459,2023-06-22,212,amul cheese,250,315,65,1,00488,India
401974,2023-06-22,205,classic yogurt,45,60,15,1,00230,India
401974,2023-06-22,203,mango yogurt,50,60,10,1,00230,India
401974,2023-06-22,210,mountain dew,75,100,25,1,00230,India
963982,2023-06-22,210,mountain dew,75,100,25,1,00320,India
963982,2023-06-22,212,amul cheese,250,315,65,1,00320,India
963982,2023-06-22,203,mango yogurt,50,60,10,1,00320,India
274424,2023-06-22,210,mountain dew,75,100,25,1,00444,India
274424,2023-06-22,213,bisleri,6,15,9,1,00444,India
820739,2023-06-22,209,pepsi,75,100,25,1,00160,India
820739,2023-06-22,205,classic yogurt,45,60,15,1,00160,India
820739,2023-06-22,208,sprite,75,100,25,1,00160,India
307148,2023-06-22,211,red bull,90,125,35,1,00084,India
307148,2023-06-22,213,bisleri,6,15,9,1,00084,India
307148,2023-06-22,208,sprite,75,100,25,1,00084,India
601829,2023-06-22,203,mango yogurt,50,60,10,1,00146,India
601829,2023-06-22,210,mountain dew,75,100,25,1,00146,India
128852,2023-06-22,209,pepsi,75,100,25,1,00071,India
214127,2023-06-22,212,amul cheese,250,315,65,1,00103,India
214127,2023-06-22,201,paneer,210,340,130,1,00103,India
214127,2023-06-22,202,milk,12,27,15,1,00103,India
766000,2023-06-22,207,coca cola,75,100,25,1,00178,India
766000,2023-06-22,204,strawberry yogurt,50,60,10,1,00178,India
766000,2023-06-22,208,sprite,75,100,25,1,00178,India
766000,2023-06-22,202,milk,12,27,15,1,00178,India
115357,2023-06-22,204,strawberry yogurt,50,60,10,1,00052,India
518781,2023-06-22,203,mango yogurt,50,60,10,1,00420,India
518781,2023-06-22,206,yakult,360,400,40,1,00420,India
518781,2023-06-22,213,bisleri,6,15,9,1,00420,India
768728,2023-06-22,203,mango yogurt,50,60,10,1,00101,India
768728,2023-06-22,211,red bull,90,125,35,1,00101,India
768728,2023-06-22,202,milk,12,27,15,1,00101,India
768728,2023-06-22,212,amul cheese,250,315,65,1,00101,India
768728,2023-06-22,207,coca cola,75,100,25,1,00101,India
257352,2023-06-22,206,yakult,360,400,40,1,00241,India
257352,2023-06-22,211,red bull,90,125,35,1,00241,India
257352,2023-06-22,209,pepsi,75,100,25,1,00241,India
257352,2023-06-22,210,mountain dew,75,100,25,1,00241,India
257352,2023-06-22,202,milk,12,27,15,1,00241,India
582740,2023-06-22,201,paneer,210,340,130,1,00216,India
582740,2023-06-22,202,milk,12,27,15,1,00216,India
582740,2023-06-22,204,strawberry yogurt,50,60,10,1,00216,India
491224,2023-06-22,205,classic yogurt,45,60,15,1,00423,India
491224,2023-06-22,206,yakult,360,400,40,1,00423,India
491224,2023-06-22,208,sprite,75,100,25,1,00423,India
491224,2023-06-22,209,pepsi,75,100,25,1,00423,India
221439,2023-06-22,203,mango yogurt,50,60,10,1,00458,India
221439,2023-06-22,210,mountain dew,75,100,25,1,00458,India
221439,2023-06-22,206,yakult,360,400,40,1,00458,India
221439,2023-06-22,207,coca cola,75,100,25,1,00458,India
848560,2023-06-22,208,sprite,75,100,25,1,00044,India
848560,2023-06-22,204,strawberry yogurt,50,60,10,1,00044,India
160279,2023-06-22,203,mango yogurt,50,60,10,1,00336,India
160279,2023-06-22,210,mountain dew,75,100,25,1,00336,India
160279,2023-06-22,212,amul cheese,250,315,65,1,00336,India
160279,2023-06-22,201,paneer,210,340,130,1,00336,India
160279,2023-06-22,208,sprite,75,100,25,1,00336,India
823811,2023-06-22,207,coca cola,75,100,25,1,00342,India
823811,2023-06-22,201,paneer,210,340,130,1,00342,India
823811,2023-06-22,209,pepsi,75,100,25,1,00342,India
823811,2023-06-22,212,amul cheese,250,315,65,1,00342,India
338150,2023-06-22,209,pepsi,75,100,25,1,00274,India
338150,2023-06-22,206,yakult,360,400,40,1,00274,India
856507,2023-06-22,213,bisleri,6,15,9,1,00199,India
856507,2023-06-22,205,classic yogurt,45,60,15,1,00199,India
856507,2023-06-22,211,red bull,90,125,35,1,00199,India
856507,2023-06-22,207,coca cola,75,100,25,1,00199,India
154071,2023-06-22,201,paneer,210,340,130,1,00446,India
154071,2023-06-22,213,bisleri,6,15,9,1,00446,India
154071,2023-06-22,207,coca cola,75,100,25,1,00446,India
992333,2023-06-22,202,milk,12,27,15,1,00181,India
667970,2023-06-22,208,sprite,75,100,25,1,00269,India
576423,2023-06-22,206,yakult,360,400,40,1,00127,India
576423,2023-06-22,210,mountain dew,75,100,25,1,00127,India
918250,2023-06-22,211,red bull,90,125,35,1,00225,India
674841,2023-06-22,208,sprite,75,100,25,1,00005,India
674841,2023-06-22,201,paneer,210,340,130,1,00005,India
674841,2023-06-22,212,amul cheese,250,315,65,1,00005,India
674841,2023-06-22,202,milk,12,27,15,1,00005,India
459392,2023-06-22,207,coca cola,75,100,25,1,00284,India
459392,2023-06-22,210,mountain dew,75,100,25,1,00284,India
459392,2023-06-22,201,paneer,210,340,130,1,00284,India
984966,2023-06-22,206,yakult,360,400,40,1,00248,India
984966,2023-06-22,210,mountain dew,75,100,25,1,00248,India
984966,2023-06-22,208,sprite,75,100,25,1,00248,India
984966,2023-06-22,202,milk,12,27,15,1,00248,India
975594,2023-06-22,213,bisleri,6,15,9,1,00193,India
975594,2023-06-22,207,coca cola,75,100,25,1,00193,India
479988,2023-06-22,208,sprite,75,100,25,1,00071,India
721032,2023-06-22,201,paneer,210,340,130,1,00045,India
721032,2023-06-22,213,bisleri,6,15,9,1,00045,India
721032,2023-06-22,202,milk,12,27,15,1,00045,India
721032,2023-06-22,203,mango yogurt,50,60,10,1,00045,India
865285,2023-06-22,209,pepsi,75,100,25,1,00311,India
865285,2023-06-22,204,strawberry yogurt,50,60,10,1,00311,India
865285,2023-06-22,202,milk,12,27,15,1,00311,India
691274,2023-06-22,208,sprite,75,100,25,1,00329,India
691274,2023-06-22,206,yakult,360,400,40,1,00329,India
935456,2023-06-22,208,sprite,75,100,25,1,00075,India
987406,2023-06-22,204,strawberry yogurt,50,60,10,1,00198,India
987406,2023-06-22,202,milk,12,27,15,1,00198,India
987406,2023-06-22,207,coca cola,75,100,25,1,00198,India
987406,2023-06-22,203,mango yogurt,50,60,10,1,00198,India
987406,2023-06-22,211,red bull,90,125,35,1,00198,India
435630,2023-06-22,203,mango yogurt,50,60,10,1,00112,India
435630,2023-06-22,207,coca cola,75,100,25,1,00112,India
435630,2023-06-22,213,bisleri,6,15,9,1,00112,India
435630,2023-06-22,212,amul cheese,250,315,65,1,00112,India
513244,2023-06-22,208,sprite,75,100,25,1,00397,India
513244,2023-06-22,207,coca cola,75,100,25,1,00397,India
148913,2023-06-22,206,yakult,360,400,40,1,00226,India
148913,2023-06-22,210,mountain dew,75,100,25,1,00226,India
148913,2023-06-22,204,strawberry yogurt,50,60,10,1,00226,India
148913,2023-06-22,202,milk,12,27,15,1,00226,India
193011,2023-06-22,213,bisleri,6,15,9,1,00464,India
193011,2023-06-22,207,coca cola,75,100,25,1,00464,India
193011,2023-06-22,211,red bull,90,125,35,1,00464,India
622542,2023-06-22,209,pepsi,75,100,25,1,00147,India
622542,2023-06-22,204,strawberry yogurt,50,60,10,1,00147,India
622542,2023-06-22,207,coca cola,75,100,25,1,00147,India
107672,2023-06-22,210,mountain dew,75,100,25,1,00466,India
107672,2023-06-22,202,milk,12,27,15,1,00466,India
107672,2023-06-22,209,pepsi,75,100,25,1,00466,India
107672,2023-06-22,211,red bull,90,125,35,1,00466,India
107672,2023-06-22,201,paneer,210,340,130,1,00466,India
852409,2023-06-22,201,paneer,210,340,130,1,00384,India
366678,2023-06-22,213,bisleri,6,15,9,1,00267,India
366678,2023-06-22,211,red bull,90,125,35,1,00267,India
366678,2023-06-22,202,milk,12,27,15,1,00267,India
366678,2023-06-22,212,amul cheese,250,315,65,1,00267,India
139429,2023-06-22,211,red bull,90,125,35,1,00142,India
139429,2023-06-22,210,mountain dew,75,100,25,1,00142,India
240508,2023-06-22,211,red bull,90,125,35,1,00474,India
248335,2023-06-22,203,mango yogurt,50,60,10,1,00385,India
248335,2023-06-22,211,red bull,90,125,35,1,00385,India
248335,2023-06-22,206,yakult,360,400,40,1,00385,India
248335,2023-06-22,205,classic yogurt,45,60,15,1,00385,India
488885,2023-06-22,201,paneer,210,340,130,1,00386,India
488885,2023-06-22,203,mango yogurt,50,60,10,1,00386,India
787926,2023-06-22,204,strawberry yogurt,50,60,10,1,00223,India
787926,2023-06-22,202,milk,12,27,15,1,00223,India
442403,2023-06-22,207,coca cola,75,100,25,1,00163,India
259890,2023-06-22,212,amul cheese,250,315,65,1,00127,India
376351,2023-06-22,202,milk,12,27,15,1,00117,India
376351,2023-06-22,201,paneer,210,340,130,1,00117,India
553091,2023-06-22,205,classic yogurt,45,60,15,1,00184,India
553091,2023-06-22,209,pepsi,75,100,25,1,00184,India
812333,2023-06-22,209,pepsi,75,100,25,1,00264,India
911553,2023-06-22,208,sprite,75,100,25,1,00243,India
911553,2023-06-22,206,yakult,360,400,40,1,00243,India
911553,2023-06-22,205,classic yogurt,45,60,15,1,00243,India
911553,2023-06-22,213,bisleri,6,15,9,1,00243,India
473600,2023-06-22,207,coca cola,75,100,25,1,00008,India
473600,2023-06-22,201,paneer,210,340,130,1,00008,India
473600,2023-06-22,209,pepsi,75,100,25,1,00008,India
473600,2023-06-22,212,amul cheese,250,315,65,1,00008,India
101463,2023-06-22,213,bisleri,6,15,9,1,00470,India
101463,2023-06-22,208,sprite,75,100,25,1,00470,India
101463,2023-06-22,205,classic yogurt,45,60,15,1,00470,India
101463,2023-06-22,206,yakult,360,400,40,1,00470,India
800491,2023-06-22,202,milk,12,27,15,1,00204,India
800491,2023-06-22,207,coca cola,75,100,25,1,00204,India
800491,2023-06-22,208,sprite,75,100,25,1,00204,India
800491,2023-06-22,205,classic yogurt,45,60,15,1,00204,India
800491,2023-06-22,203,mango yogurt,50,60,10,1,00204,India
959216,2023-06-22,201,paneer,210,340,130,1,00146,India
959216,2023-06-22,206,yakult,360,400,40,1,00146,India
959216,2023-06-22,210,mountain dew,75,100,25,1,00146,India
213778,2023-06-22,207,coca cola,75,100,25,1,00162,India
213778,2023-06-22,202,milk,12,27,15,1,00162,India
270109,2023-06-22,204,strawberry yogurt,50,60,10,1,00256,India
270109,2023-06-22,207,coca cola,75,100,25,1,00256,India
270109,2023-06-22,202,milk,12,27,15,1,00256,India
270109,2023-06-22,209,pepsi,75,100,25,1,00256,India
203048,2023-06-22,210,mountain dew,75,100,25,1,00128,India
203048,2023-06-22,213,bisleri,6,15,9,1,00128,India
203048,2023-06-22,202,milk,12,27,15,1,00128,India
203048,2023-06-22,204,strawberry yogurt,50,60,10,1,00128,India
203048,2023-06-22,205,classic yogurt,45,60,15,1,00128,India
490381,2023-06-22,207,coca cola,75,100,25,1,00166,India
490381,2023-06-22,209,pepsi,75,100,25,1,00166,India
490381,2023-06-22,210,mountain dew,75,100,25,1,00166,India
490381,2023-06-22,213,bisleri,6,15,9,1,00166,India
490381,2023-06-22,205,classic yogurt,45,60,15,1,00166,India
527900,2023-06-22,207,coca cola,75,100,25,1,00485,India
527900,2023-06-22,205,classic yogurt,45,60,15,1,00485,India
527900,2023-06-22,203,mango yogurt,50,60,10,1,00485,India
527900,2023-06-22,209,pepsi,75,100,25,1,00485,India
529204,2023-06-22,208,sprite,75,100,25,1,00076,India
529204,2023-06-22,205,classic yogurt,45,60,15,1,00076,India
529204,2023-06-22,211,red bull,90,125,35,1,00076,India
397802,2023-06-22,213,bisleri,6,15,9,1,00407,India
397802,2023-06-22,201,paneer,210,340,130,1,00407,India
397802,2023-06-22,203,mango yogurt,50,60,10,1,00407,India
775639,2023-06-22,213,bisleri,6,15,9,1,00030,India
775639,2023-06-22,210,mountain dew,75,100,25,1,00030,India
775639,2023-06-22,209,pepsi,75,100,25,1,00030,India
775639,2023-06-22,207,coca cola,75,100,25,1,00030,India
770754,2023-06-22,202,milk,12,27,15,1,00333,India
770754,2023-06-22,206,yakult,360,400,40,1,00333,India
770754,2023-06-22,208,sprite,75,100,25,1,00333,India
770754,2023-06-22,212,amul cheese,250,315,65,1,00333,India
148481,2023-06-22,207,coca cola,75,100,25,1,00028,India
991289,2023-06-22,210,mountain dew,75,100,25,1,00181,India
991289,2023-06-22,201,paneer,210,340,130,1,00181,India
991289,2023-06-22,204,strawberry yogurt,50,60,10,1,00181,India
991289,2023-06-22,212,amul cheese,250,315,65,1,00181,India
325216,2023-06-22,210,mountain dew,75,100,25,1,00084,India
325216,2023-06-22,213,bisleri,6,15,9,1,00084,India
325216,2023-06-22,202,milk,12,27,15,1,00084,India
325216,2023-06-22,208,sprite,75,100,25,1,00084,India
992341,2023-06-23,210,mountain dew,75,100,25,1,00109,India
992341,2023-06-23,211,red bull,90,125,35,1,00109,India
992341,2023-06-23,206,yakult,360,400,40,1,00109,India
992341,2023-06-23,207,coca cola,75,100,25,1,00109,India
455602,2023-06-23,207,coca cola,75,100,25,1,00208,India
455602,2023-06-23,201,paneer,210,340,130,1,00208,India
615239,2023-06-23,204,strawberry yogurt,50,60,10,1,00302,India
438929,2023-06-23,210,mountain dew,75,100,25,1,00225,India
476268,2023-06-23,206,yakult,360,400,40,1,00148,India
476268,2023-06-23,211,red bull,90,125,35,1,00148,India
476268,2023-06-23,210,mountain dew,75,100,25,1,00148,India
389078,2023-06-23,208,sprite,75,100,25,1,00430,India
389078,2023-06-23,209,pepsi,75,100,25,1,00430,India
389078,2023-06-23,206,yakult,360,400,40,1,00430,India
389078,2023-06-23,213,bisleri,6,15,9,1,00430,India
932493,2023-06-23,209,pepsi,75,100,25,1,00157,India
136881,2023-06-23,213,bisleri,6,15,9,1,00265,India
136881,2023-06-23,201,paneer,210,340,130,1,00265,India
136881,2023-06-23,207,coca cola,75,100,25,1,00265,India
831796,2023-06-23,210,mountain dew,75,100,25,1,00083,India
831796,2023-06-23,203,mango yogurt,50,60,10,1,00083,India
831796,2023-06-23,207,coca cola,75,100,25,1,00083,India
679449,2023-06-23,209,pepsi,75,100,25,1,00328,India
679449,2023-06-23,212,amul cheese,250,315,65,1,00328,India
222432,2023-06-23,212,amul cheese,250,315,65,1,00222,India
222432,2023-06-23,213,bisleri,6,15,9,1,00222,India
222432,2023-06-23,201,paneer,210,340,130,1,00222,India
222432,2023-06-23,202,milk,12,27,15,1,00222,India
356621,2023-06-23,203,mango yogurt,50,60,10,1,00287,India
356621,2023-06-23,205,classic yogurt,45,60,15,1,00287,India
356621,2023-06-23,207,coca cola,75,100,25,1,00287,India
559324,2023-06-23,213,bisleri,6,15,9,1,00159,India
559324,2023-06-23,203,mango yogurt,50,60,10,1,00159,India
559324,2023-06-23,209,pepsi,75,100,25,1,00159,India
559324,2023-06-23,202,milk,12,27,15,1,00159,India
387273,2023-06-23,202,milk,12,27,15,1,00453,India
387273,2023-06-23,206,yakult,360,400,40,1,00453,India
387273,2023-06-23,210,mountain dew,75,100,25,1,00453,India
863153,2023-06-23,208,sprite,75,100,25,1,00290,India
863153,2023-06-23,212,amul cheese,250,315,65,1,00290,India
863153,2023-06-23,213,bisleri,6,15,9,1,00290,India
863153,2023-06-23,201,paneer,210,340,130,1,00290,India
610063,2023-06-23,207,coca cola,75,100,25,1,00456,India
610063,2023-06-23,208,sprite,75,100,25,1,00456,India
559637,2023-06-23,212,amul cheese,250,315,65,1,00363,India
559637,2023-06-23,207,coca cola,75,100,25,1,00363,India
559637,2023-06-23,209,pepsi,75,100,25,1,00363,India
559637,2023-06-23,213,bisleri,6,15,9,1,00363,India
559637,2023-06-23,210,mountain dew,75,100,25,1,00363,India
124832,2023-06-23,210,mountain dew,75,100,25,1,00357,India
124832,2023-06-23,208,sprite,75,100,25,1,00357,India
124832,2023-06-23,206,yakult,360,400,40,1,00357,India
124832,2023-06-23,204,strawberry yogurt,50,60,10,1,00357,India
738690,2023-06-23,204,strawberry yogurt,50,60,10,1,00031,India
738690,2023-06-23,203,mango yogurt,50,60,10,1,00031,India
738690,2023-06-23,208,sprite,75,100,25,1,00031,India
905281,2023-06-23,209,pepsi,75,100,25,1,00480,India
905281,2023-06-23,202,milk,12,27,15,1,00480,India
905281,2023-06-23,205,classic yogurt,45,60,15,1,00480,India
905281,2023-06-23,203,mango yogurt,50,60,10,1,00480,India
742098,2023-06-23,206,yakult,360,400,40,1,00218,India
742098,2023-06-23,211,red bull,90,125,35,1,00218,India
742098,2023-06-23,212,amul cheese,250,315,65,1,00218,India
389885,2023-06-23,201,paneer,210,340,130,1,00211,India
389885,2023-06-23,208,sprite,75,100,25,1,00211,India
389885,2023-06-23,213,bisleri,6,15,9,1,00211,India
389885,2023-06-23,205,classic yogurt,45,60,15,1,00211,India
812672,2023-06-23,211,red bull,90,125,35,1,00158,India
812672,2023-06-23,206,yakult,360,400,40,1,00158,India
812672,2023-06-23,204,strawberry yogurt,50,60,10,1,00158,India
812672,2023-06-23,209,pepsi,75,100,25,1,00158,India
777498,2023-06-23,201,paneer,210,340,130,1,00036,India
777498,2023-06-23,206,yakult,360,400,40,1,00036,India
778391,2023-06-23,213,bisleri,6,15,9,1,00443,India
778391,2023-06-23,211,red bull,90,125,35,1,00443,India
372827,2023-06-23,207,coca cola,75,100,25,1,00108,India
372827,2023-06-23,209,pepsi,75,100,25,1,00108,India
372827,2023-06-23,205,classic yogurt,45,60,15,1,00108,India
191093,2023-06-23,207,coca cola,75,100,25,1,00417,India
599419,2023-06-23,213,bisleri,6,15,9,1,00210,India
599419,2023-06-23,209,pepsi,75,100,25,1,00210,India
599419,2023-06-23,205,classic yogurt,45,60,15,1,00210,India
599419,2023-06-23,210,mountain dew,75,100,25,1,00210,India
834325,2023-06-23,207,coca cola,75,100,25,1,00180,India
834325,2023-06-23,213,bisleri,6,15,9,1,00180,India
834325,2023-06-23,206,yakult,360,400,40,1,00180,India
441904,2023-06-23,210,mountain dew,75,100,25,1,00007,India
441904,2023-06-23,208,sprite,75,100,25,1,00007,India
441904,2023-06-23,213,bisleri,6,15,9,1,00007,India
441904,2023-06-23,209,pepsi,75,100,25,1,00007,India
764993,2023-06-23,205,classic yogurt,45,60,15,1,00184,India
764993,2023-06-23,202,milk,12,27,15,1,00184,India
764993,2023-06-23,201,paneer,210,340,130,1,00184,India
764993,2023-06-23,211,red bull,90,125,35,1,00184,India
764993,2023-06-23,213,bisleri,6,15,9,1,00184,India
229310,2023-06-23,212,amul cheese,250,315,65,1,00239,India
229310,2023-06-23,210,mountain dew,75,100,25,1,00239,India
229310,2023-06-23,208,sprite,75,100,25,1,00239,India
193520,2023-06-23,204,strawberry yogurt,50,60,10,1,00150,India
441395,2023-06-23,213,bisleri,6,15,9,1,00324,India
441395,2023-06-23,201,paneer,210,340,130,1,00324,India
441395,2023-06-23,205,classic yogurt,45,60,15,1,00324,India
441395,2023-06-23,212,amul cheese,250,315,65,1,00324,India
132126,2023-06-23,212,amul cheese,250,315,65,1,00407,India
862591,2023-06-23,202,milk,12,27,15,1,00467,India
862591,2023-06-23,206,yakult,360,400,40,1,00467,India
525928,2023-06-23,209,pepsi,75,100,25,1,00106,India
525928,2023-06-23,213,bisleri,6,15,9,1,00106,India
525928,2023-06-23,201,paneer,210,340,130,1,00106,India
525928,2023-06-23,203,mango yogurt,50,60,10,1,00106,India
690156,2023-06-23,206,yakult,360,400,40,1,00248,India
690156,2023-06-23,204,strawberry yogurt,50,60,10,1,00248,India
690156,2023-06-23,202,milk,12,27,15,1,00248,India
690156,2023-06-23,203,mango yogurt,50,60,10,1,00248,India
986784,2023-06-23,204,strawberry yogurt,50,60,10,1,00112,India
986784,2023-06-23,206,yakult,360,400,40,1,00112,India
986784,2023-06-23,208,sprite,75,100,25,1,00112,India
986784,2023-06-23,202,milk,12,27,15,1,00112,India
986784,2023-06-23,203,mango yogurt,50,60,10,1,00112,India
702306,2023-06-23,212,amul cheese,250,315,65,1,00076,India
702306,2023-06-23,209,pepsi,75,100,25,1,00076,India
702306,2023-06-23,207,coca cola,75,100,25,1,00076,India
182952,2023-06-23,210,mountain dew,75,100,25,1,00420,India
370629,2023-06-23,203,mango yogurt,50,60,10,1,00167,India
920830,2023-06-23,206,yakult,360,400,40,1,00329,India
920830,2023-06-23,208,sprite,75,100,25,1,00329,India
920830,2023-06-23,210,mountain dew,75,100,25,1,00329,India
276550,2023-06-23,207,coca cola,75,100,25,1,00237,India
276550,2023-06-23,203,mango yogurt,50,60,10,1,00237,India
276550,2023-06-23,209,pepsi,75,100,25,1,00237,India
276550,2023-06-23,206,yakult,360,400,40,1,00237,India
856669,2023-06-23,208,sprite,75,100,25,1,00236,India
856669,2023-06-23,207,coca cola,75,100,25,1,00236,India
481552,2023-06-23,206,yakult,360,400,40,1,00093,India
481552,2023-06-23,205,classic yogurt,45,60,15,1,00093,India
481552,2023-06-23,202,milk,12,27,15,1,00093,India
381233,2023-06-23,203,mango yogurt,50,60,10,1,00481,India
381233,2023-06-23,213,bisleri,6,15,9,1,00481,India
381233,2023-06-23,202,milk,12,27,15,1,00481,India
381233,2023-06-23,211,red bull,90,125,35,1,00481,India
381233,2023-06-23,208,sprite,75,100,25,1,00481,India
900777,2023-06-23,203,mango yogurt,50,60,10,1,00112,India
900777,2023-06-23,213,bisleri,6,15,9,1,00112,India
900777,2023-06-23,211,red bull,90,125,35,1,00112,India
900777,2023-06-23,212,amul cheese,250,315,65,1,00112,India
571635,2023-06-23,207,coca cola,75,100,25,1,00292,India
571635,2023-06-23,210,mountain dew,75,100,25,1,00292,India
571635,2023-06-23,202,milk,12,27,15,1,00292,India
571635,2023-06-23,213,bisleri,6,15,9,1,00292,India
791862,2023-06-23,210,mountain dew,75,100,25,1,00028,India
791862,2023-06-23,211,red bull,90,125,35,1,00028,India
952913,2023-06-23,211,red bull,90,125,35,1,00463,India
952913,2023-06-23,205,classic yogurt,45,60,15,1,00463,India
532997,2023-06-23,213,bisleri,6,15,9,1,00154,India
198190,2023-06-23,205,classic yogurt,45,60,15,1,00443,India
198190,2023-06-23,207,coca cola,75,100,25,1,00443,India
198190,2023-06-23,212,amul cheese,250,315,65,1,00443,India
198190,2023-06-23,211,red bull,90,125,35,1,00443,India
268539,2023-06-23,208,sprite,75,100,25,1,00334,India
268539,2023-06-23,211,red bull,90,125,35,1,00334,India
268539,2023-06-23,203,mango yogurt,50,60,10,1,00334,India
268539,2023-06-23,202,milk,12,27,15,1,00334,India
684278,2023-06-23,207,coca cola,75,100,25,1,00296,India
684278,2023-06-23,211,red bull,90,125,35,1,00296,India
684278,2023-06-23,201,paneer,210,340,130,1,00296,India
775707,2023-06-23,205,classic yogurt,45,60,15,1,00487,India
775707,2023-06-23,206,yakult,360,400,40,1,00487,India
775707,2023-06-23,211,red bull,90,125,35,1,00487,India
305990,2023-06-23,204,strawberry yogurt,50,60,10,1,00076,India
305990,2023-06-23,203,mango yogurt,50,60,10,1,00076,India
305990,2023-06-23,202,milk,12,27,15,1,00076,India
305990,2023-06-23,205,classic yogurt,45,60,15,1,00076,India
676859,2023-06-23,203,mango yogurt,50,60,10,1,00457,India
676859,2023-06-23,207,coca cola,75,100,25,1,00457,India
676859,2023-06-23,212,amul cheese,250,315,65,1,00457,India
676859,2023-06-23,205,classic yogurt,45,60,15,1,00457,India
682045,2023-06-23,203,mango yogurt,50,60,10,1,00422,India
682045,2023-06-23,205,classic yogurt,45,60,15,1,00422,India
682045,2023-06-23,207,coca cola,75,100,25,1,00422,India
195088,2023-06-23,204,strawberry yogurt,50,60,10,1,00325,India
195088,2023-06-23,202,milk,12,27,15,1,00325,India
460192,2023-06-23,207,coca cola,75,100,25,1,00013,India
460192,2023-06-23,212,amul cheese,250,315,65,1,00013,India
834179,2023-06-23,213,bisleri,6,15,9,1,00141,India
834179,2023-06-23,209,pepsi,75,100,25,1,00141,India
668152,2023-06-23,202,milk,12,27,15,1,00141,India
668152,2023-06-23,207,coca cola,75,100,25,1,00141,India
668152,2023-06-23,212,amul cheese,250,315,65,1,00141,India
705431,2023-06-23,208,sprite,75,100,25,1,00333,India
705431,2023-06-23,212,amul cheese,250,315,65,1,00333,India
705431,2023-06-23,213,bisleri,6,15,9,1,00333,India
705431,2023-06-23,206,yakult,360,400,40,1,00333,India
983510,2023-06-23,205,classic yogurt,45,60,15,1,00374,India
266463,2023-06-23,202,milk,12,27,15,1,00266,India
266463,2023-06-23,204,strawberry yogurt,50,60,10,1,00266,India
266463,2023-06-23,211,red bull,90,125,35,1,00266,India
469768,2023-06-23,205,classic yogurt,45,60,15,1,00245,India
469768,2023-06-23,210,mountain dew,75,100,25,1,00245,India
469768,2023-06-23,208,sprite,75,100,25,1,00245,India
469768,2023-06-23,201,paneer,210,340,130,1,00245,India
247912,2023-06-23,205,classic yogurt,45,60,15,1,00498,India
995848,2023-06-23,210,mountain dew,75,100,25,1,00150,India
995848,2023-06-23,209,pepsi,75,100,25,1,00150,India
995848,2023-06-23,212,amul cheese,250,315,65,1,00150,India
166205,2023-06-23,211,red bull,90,125,35,1,00118,India
166205,2023-06-23,201,paneer,210,340,130,1,00118,India
166205,2023-06-23,202,milk,12,27,15,1,00118,India
166205,2023-06-23,203,mango yogurt,50,60,10,1,00118,India
120657,2023-06-23,211,red bull,90,125,35,1,00043,India
120657,2023-06-23,202,milk,12,27,15,1,00043,India
120657,2023-06-23,210,mountain dew,75,100,25,1,00043,India
924317,2023-06-23,204,strawberry yogurt,50,60,10,1,00029,India
924317,2023-06-23,206,yakult,360,400,40,1,00029,India
902208,2023-06-23,206,yakult,360,400,40,1,00212,India
902208,2023-06-23,211,red bull,90,125,35,1,00212,India
902208,2023-06-23,205,classic yogurt,45,60,15,1,00212,India
941466,2023-06-23,213,bisleri,6,15,9,1,00365,India
687091,2023-06-23,208,sprite,75,100,25,1,00118,India
477612,2023-06-23,213,bisleri,6,15,9,1,00144,India
477612,2023-06-23,203,mango yogurt,50,60,10,1,00144,India
477612,2023-06-23,201,paneer,210,340,130,1,00144,India
369445,2023-06-23,205,classic yogurt,45,60,15,1,00444,India
369445,2023-06-23,208,sprite,75,100,25,1,00444,India
369445,2023-06-23,202,milk,12,27,15,1,00444,India
860799,2023-06-23,210,mountain dew,75,100,25,1,00110,India
860799,2023-06-23,202,milk,12,27,15,1,00110,India
624463,2023-06-23,206,yakult,360,400,40,1,00212,India
624463,2023-06-23,202,milk,12,27,15,1,00212,India
624463,2023-06-23,211,red bull,90,125,35,1,00212,India
624463,2023-06-23,205,classic yogurt,45,60,15,1,00212,India
624463,2023-06-23,209,pepsi,75,100,25,1,00212,India
436515,2023-06-23,212,amul cheese,250,315,65,1,00086,India
436515,2023-06-23,209,pepsi,75,100,25,1,00086,India
436515,2023-06-23,208,sprite,75,100,25,1,00086,India
436515,2023-06-23,205,classic yogurt,45,60,15,1,00086,India
862457,2023-06-23,205,classic yogurt,45,60,15,1,00148,India
361266,2023-06-23,209,pepsi,75,100,25,1,00094,India
361266,2023-06-23,205,classic yogurt,45,60,15,1,00094,India
361266,2023-06-23,203,mango yogurt,50,60,10,1,00094,India
361266,2023-06-23,208,sprite,75,100,25,1,00094,India
202590,2023-06-23,209,pepsi,75,100,25,1,00364,India
202590,2023-06-23,204,strawberry yogurt,50,60,10,1,00364,India
202590,2023-06-23,202,milk,12,27,15,1,00364,India
202590,2023-06-23,210,mountain dew,75,100,25,1,00364,India
594590,2023-06-23,204,strawberry yogurt,50,60,10,1,00307,India
594590,2023-06-23,207,coca cola,75,100,25,1,00307,India
594590,2023-06-23,201,paneer,210,340,130,1,00307,India
123309,2023-06-24,213,bisleri,6,15,9,1,00099,India
123309,2023-06-24,207,coca cola,75,100,25,1,00099,India
123309,2023-06-24,203,mango yogurt,50,60,10,1,00099,India
180188,2023-06-24,203,mango yogurt,50,60,10,1,00377,India
702087,2023-06-24,209,pepsi,75,100,25,1,00156,India
702087,2023-06-24,211,red bull,90,125,35,1,00156,India
702087,2023-06-24,201,paneer,210,340,130,1,00156,India
893753,2023-06-24,204,strawberry yogurt,50,60,10,1,00390,India
747586,2023-06-24,208,sprite,75,100,25,1,00418,India
747586,2023-06-24,204,strawberry yogurt,50,60,10,1,00418,India
747586,2023-06-24,211,red bull,90,125,35,1,00418,India
747586,2023-06-24,203,mango yogurt,50,60,10,1,00418,India
747586,2023-06-24,205,classic yogurt,45,60,15,1,00418,India
361038,2023-06-24,209,pepsi,75,100,25,1,00003,India
361038,2023-06-24,211,red bull,90,125,35,1,00003,India
586971,2023-06-24,208,sprite,75,100,25,1,00381,India
586971,2023-06-24,204,strawberry yogurt,50,60,10,1,00381,India
586971,2023-06-24,210,mountain dew,75,100,25,1,00381,India
689637,2023-06-24,206,yakult,360,400,40,1,00149,India
689637,2023-06-24,211,red bull,90,125,35,1,00149,India
689637,2023-06-24,209,pepsi,75,100,25,1,00149,India
852567,2023-06-24,203,mango yogurt,50,60,10,1,00365,India
852567,2023-06-24,213,bisleri,6,15,9,1,00365,India
852567,2023-06-24,205,classic yogurt,45,60,15,1,00365,India
852567,2023-06-24,207,coca cola,75,100,25,1,00365,India
487105,2023-06-24,201,paneer,210,340,130,1,00076,India
487105,2023-06-24,208,sprite,75,100,25,1,00076,India
487105,2023-06-24,212,amul cheese,250,315,65,1,00076,India
487105,2023-06-24,206,yakult,360,400,40,1,00076,India
487105,2023-06-24,210,mountain dew,75,100,25,1,00076,India
170854,2023-06-24,209,pepsi,75,100,25,1,00166,India
170854,2023-06-24,211,red bull,90,125,35,1,00166,India
170854,2023-06-24,204,strawberry yogurt,50,60,10,1,00166,India
170854,2023-06-24,205,classic yogurt,45,60,15,1,00166,India
518594,2023-06-24,201,paneer,210,340,130,1,00154,India
518594,2023-06-24,206,yakult,360,400,40,1,00154,India
383524,2023-06-24,203,mango yogurt,50,60,10,1,00386,India
383524,2023-06-24,208,sprite,75,100,25,1,00386,India
383524,2023-06-24,211,red bull,90,125,35,1,00386,India
383524,2023-06-24,207,coca cola,75,100,25,1,00386,India
477421,2023-06-24,213,bisleri,6,15,9,1,00177,India
477421,2023-06-24,207,coca cola,75,100,25,1,00177,India
477421,2023-06-24,211,red bull,90,125,35,1,00177,India
477421,2023-06-24,206,yakult,360,400,40,1,00177,India
798500,2023-06-24,204,strawberry yogurt,50,60,10,1,00302,India
798500,2023-06-24,212,amul cheese,250,315,65,1,00302,India
107578,2023-06-24,211,red bull,90,125,35,1,00498,India
972618,2023-06-24,213,bisleri,6,15,9,1,00033,India
972618,2023-06-24,208,sprite,75,100,25,1,00033,India
341163,2023-06-24,205,classic yogurt,45,60,15,1,00050,India
341163,2023-06-24,202,milk,12,27,15,1,00050,India
341163,2023-06-24,208,sprite,75,100,25,1,00050,India
341163,2023-06-24,212,amul cheese,250,315,65,1,00050,India
845573,2023-06-24,201,paneer,210,340,130,1,00239,India
845573,2023-06-24,203,mango yogurt,50,60,10,1,00239,India
845573,2023-06-24,205,classic yogurt,45,60,15,1,00239,India
845573,2023-06-24,213,bisleri,6,15,9,1,00239,India
147766,2023-06-24,202,milk,12,27,15,1,00054,India
206731,2023-06-24,213,bisleri,6,15,9,1,00409,India
206731,2023-06-24,203,mango yogurt,50,60,10,1,00409,India
144473,2023-06-24,202,milk,12,27,15,1,00074,India
144473,2023-06-24,210,mountain dew,75,100,25,1,00074,India
144473,2023-06-24,209,pepsi,75,100,25,1,00074,India
144473,2023-06-24,206,yakult,360,400,40,1,00074,India
878014,2023-06-24,206,yakult,360,400,40,1,00276,India
878014,2023-06-24,208,sprite,75,100,25,1,00276,India
878014,2023-06-24,212,amul cheese,250,315,65,1,00276,India
911031,2023-06-24,206,yakult,360,400,40,1,00332,India
911031,2023-06-24,207,coca cola,75,100,25,1,00332,India
911031,2023-06-24,201,paneer,210,340,130,1,00332,India
461024,2023-06-24,211,red bull,90,125,35,1,00278,India
461024,2023-06-24,212,amul cheese,250,315,65,1,00278,India
461024,2023-06-24,202,milk,12,27,15,1,00278,India
461024,2023-06-24,213,bisleri,6,15,9,1,00278,India
461024,2023-06-24,207,coca cola,75,100,25,1,00278,India
944678,2023-06-24,203,mango yogurt,50,60,10,1,00442,India
944678,2023-06-24,211,red bull,90,125,35,1,00442,India
944678,2023-06-24,208,sprite,75,100,25,1,00442,India
944678,2023-06-24,210,mountain dew,75,100,25,1,00442,India
453554,2023-06-24,208,sprite,75,100,25,1,00446,India
453554,2023-06-24,201,paneer,210,340,130,1,00446,India
330191,2023-06-24,213,bisleri,6,15,9,1,00430,India
330191,2023-06-24,209,pepsi,75,100,25,1,00430,India
330191,2023-06-24,208,sprite,75,100,25,1,00430,India
330191,2023-06-24,201,paneer,210,340,130,1,00430,India
958898,2023-06-24,203,mango yogurt,50,60,10,1,00181,India
958898,2023-06-24,205,classic yogurt,45,60,15,1,00181,India
958898,2023-06-24,210,mountain dew,75,100,25,1,00181,India
958898,2023-06-24,209,pepsi,75,100,25,1,00181,India
958898,2023-06-24,211,red bull,90,125,35,1,00181,India
361688,2023-06-24,206,yakult,360,400,40,1,00242,India
361688,2023-06-24,207,coca cola,75,100,25,1,00242,India
361688,2023-06-24,212,amul cheese,250,315,65,1,00242,India
361688,2023-06-24,213,bisleri,6,15,9,1,00242,India
539951,2023-06-24,207,coca cola,75,100,25,1,00371,India
539951,2023-06-24,212,amul cheese,250,315,65,1,00371,India
539951,2023-06-24,205,classic yogurt,45,60,15,1,00371,India
932238,2023-06-24,207,coca cola,75,100,25,1,00464,India
932238,2023-06-24,201,paneer,210,340,130,1,00464,India
932238,2023-06-24,211,red bull,90,125,35,1,00464,India
932238,2023-06-24,212,amul cheese,250,315,65,1,00464,India
736226,2023-06-24,210,mountain dew,75,100,25,1,00098,India
736226,2023-06-24,207,coca cola,75,100,25,1,00098,India
736226,2023-06-24,213,bisleri,6,15,9,1,00098,India
736226,2023-06-24,202,milk,12,27,15,1,00098,India
736226,2023-06-24,203,mango yogurt,50,60,10,1,00098,India
705350,2023-06-24,209,pepsi,75,100,25,1,00287,India
705350,2023-06-24,204,strawberry yogurt,50,60,10,1,00287,India
705350,2023-06-24,203,mango yogurt,50,60,10,1,00287,India
705350,2023-06-24,210,mountain dew,75,100,25,1,00287,India
184556,2023-06-24,209,pepsi,75,100,25,1,00131,India
184556,2023-06-24,205,classic yogurt,45,60,15,1,00131,India
184556,2023-06-24,212,amul cheese,250,315,65,1,00131,India
980731,2023-06-24,207,coca cola,75,100,25,1,00259,India
980731,2023-06-24,206,yakult,360,400,40,1,00259,India
980731,2023-06-24,212,amul cheese,250,315,65,1,00259,India
789621,2023-06-24,203,mango yogurt,50,60,10,1,00250,India
789621,2023-06-24,205,classic yogurt,45,60,15,1,00250,India
528896,2023-06-24,202,milk,12,27,15,1,00085,India
528896,2023-06-24,204,strawberry yogurt,50,60,10,1,00085,India
395412,2023-06-24,203,mango yogurt,50,60,10,1,00455,India
395412,2023-06-24,206,yakult,360,400,40,1,00455,India
395412,2023-06-24,210,mountain dew,75,100,25,1,00455,India
617141,2023-06-24,211,red bull,90,125,35,1,00394,India
617141,2023-06-24,210,mountain dew,75,100,25,1,00394,India
617141,2023-06-24,208,sprite,75,100,25,1,00394,India
299735,2023-06-24,204,strawberry yogurt,50,60,10,1,00243,India
299735,2023-06-24,202,milk,12,27,15,1,00243,India
823881,2023-06-24,213,bisleri,6,15,9,1,00098,India
823881,2023-06-24,208,sprite,75,100,25,1,00098,India
823881,2023-06-24,203,mango yogurt,50,60,10,1,00098,India
823881,2023-06-24,202,milk,12,27,15,1,00098,India
823881,2023-06-24,211,red bull,90,125,35,1,00098,India
174114,2023-06-24,202,milk,12,27,15,1,00364,India
174114,2023-06-24,201,paneer,210,340,130,1,00364,India
174114,2023-06-24,203,mango yogurt,50,60,10,1,00364,India
174114,2023-06-24,212,amul cheese,250,315,65,1,00364,India
174114,2023-06-24,208,sprite,75,100,25,1,00364,India
764190,2023-06-24,201,paneer,210,340,130,1,00355,India
764190,2023-06-24,202,milk,12,27,15,1,00355,India
764190,2023-06-24,211,red bull,90,125,35,1,00355,India
350076,2023-06-24,208,sprite,75,100,25,1,00400,India
350076,2023-06-24,201,paneer,210,340,130,1,00400,India
317674,2023-06-24,202,milk,12,27,15,1,00262,India
317674,2023-06-24,203,mango yogurt,50,60,10,1,00262,India
317674,2023-06-24,211,red bull,90,125,35,1,00262,India
317674,2023-06-24,205,classic yogurt,45,60,15,1,00262,India
317674,2023-06-24,210,mountain dew,75,100,25,1,00262,India
889511,2023-06-24,211,red bull,90,125,35,1,00332,India
809838,2023-06-24,213,bisleri,6,15,9,1,00041,India
809838,2023-06-24,201,paneer,210,340,130,1,00041,India
809838,2023-06-24,203,mango yogurt,50,60,10,1,00041,India
901102,2023-06-24,209,pepsi,75,100,25,1,00054,India
901102,2023-06-24,211,red bull,90,125,35,1,00054,India
791880,2023-06-24,206,yakult,360,400,40,1,00129,India
791880,2023-06-24,207,coca cola,75,100,25,1,00129,India
791880,2023-06-24,208,sprite,75,100,25,1,00129,India
403253,2023-06-24,202,milk,12,27,15,1,00309,India
328177,2023-06-24,210,mountain dew,75,100,25,1,00398,India
213251,2023-06-24,206,yakult,360,400,40,1,00148,India
213251,2023-06-24,201,paneer,210,340,130,1,00148,India
213251,2023-06-24,202,milk,12,27,15,1,00148,India
213251,2023-06-24,210,mountain dew,75,100,25,1,00148,India
643479,2023-06-24,209,pepsi,75,100,25,1,00010,India
206976,2023-06-24,205,classic yogurt,45,60,15,1,00377,India
206976,2023-06-24,203,mango yogurt,50,60,10,1,00377,India
206976,2023-06-24,202,milk,12,27,15,1,00377,India
621582,2023-06-24,209,pepsi,75,100,25,1,00179,India
621582,2023-06-24,201,paneer,210,340,130,1,00179,India
621582,2023-06-24,212,amul cheese,250,315,65,1,00179,India
621582,2023-06-24,204,strawberry yogurt,50,60,10,1,00179,India
896281,2023-06-24,211,red bull,90,125,35,1,00263,India
896281,2023-06-24,209,pepsi,75,100,25,1,00263,India
896281,2023-06-24,203,mango yogurt,50,60,10,1,00263,India
896281,2023-06-24,207,coca cola,75,100,25,1,00263,India
321065,2023-06-24,209,pepsi,75,100,25,1,00245,India
321065,2023-06-24,212,amul cheese,250,315,65,1,00245,India
473690,2023-06-24,207,coca cola,75,100,25,1,00076,India
703359,2023-06-24,203,mango yogurt,50,60,10,1,00121,India
703359,2023-06-24,211,red bull,90,125,35,1,00121,India
703359,2023-06-24,209,pepsi,75,100,25,1,00121,India
703359,2023-06-24,201,paneer,210,340,130,1,00121,India
703359,2023-06-24,208,sprite,75,100,25,1,00121,India
249704,2023-06-24,204,strawberry yogurt,50,60,10,1,00335,India
249704,2023-06-24,206,yakult,360,400,40,1,00335,India
249704,2023-06-24,207,coca cola,75,100,25,1,00335,India
249704,2023-06-24,205,classic yogurt,45,60,15,1,00335,India
468114,2023-06-24,209,pepsi,75,100,25,1,00335,India
468114,2023-06-24,202,milk,12,27,15,1,00335,India
468114,2023-06-24,211,red bull,90,125,35,1,00335,India
651524,2023-06-24,213,bisleri,6,15,9,1,00474,India
651524,2023-06-24,211,red bull,90,125,35,1,00474,India
651524,2023-06-24,207,coca cola,75,100,25,1,00474,India
651524,2023-06-24,202,milk,12,27,15,1,00474,India
531822,2023-06-24,209,pepsi,75,100,25,1,00273,India
531822,2023-06-24,213,bisleri,6,15,9,1,00273,India
531822,2023-06-24,207,coca cola,75,100,25,1,00273,India
531822,2023-06-24,208,sprite,75,100,25,1,00273,India
482908,2023-06-24,201,paneer,210,340,130,1,00074,India
482908,2023-06-24,209,pepsi,75,100,25,1,00074,India
645156,2023-06-24,209,pepsi,75,100,25,1,00409,India
645156,2023-06-24,202,milk,12,27,15,1,00409,India
764461,2023-06-24,206,yakult,360,400,40,1,00472,India
764461,2023-06-24,204,strawberry yogurt,50,60,10,1,00472,India
143544,2023-06-24,205,classic yogurt,45,60,15,1,00146,India
143544,2023-06-24,210,mountain dew,75,100,25,1,00146,India
143544,2023-06-24,211,red bull,90,125,35,1,00146,India
143544,2023-06-24,201,paneer,210,340,130,1,00146,India
406266,2023-06-24,208,sprite,75,100,25,1,00325,India
406266,2023-06-24,209,pepsi,75,100,25,1,00325,India
524248,2023-06-25,207,coca cola,75,100,25,1,00439,India
524248,2023-06-25,213,bisleri,6,15,9,1,00439,India
126724,2023-06-25,213,bisleri,6,15,9,1,00319,India
126724,2023-06-25,205,classic yogurt,45,60,15,1,00319,India
126724,2023-06-25,211,red bull,90,125,35,1,00319,India
126724,2023-06-25,202,milk,12,27,15,1,00319,India
779445,2023-06-25,206,yakult,360,400,40,1,00205,India
724300,2023-06-25,213,bisleri,6,15,9,1,00097,India
724300,2023-06-25,211,red bull,90,125,35,1,00097,India
724300,2023-06-25,201,paneer,210,340,130,1,00097,India
724300,2023-06-25,206,yakult,360,400,40,1,00097,India
297845,2023-06-25,203,mango yogurt,50,60,10,1,00383,India
241845,2023-06-25,202,milk,12,27,15,1,00291,India
785583,2023-06-25,201,paneer,210,340,130,1,00073,India
785583,2023-06-25,205,classic yogurt,45,60,15,1,00073,India
785583,2023-06-25,208,sprite,75,100,25,1,00073,India
729396,2023-06-25,201,paneer,210,340,130,1,00348,India
729396,2023-06-25,205,classic yogurt,45,60,15,1,00348,India
729396,2023-06-25,212,amul cheese,250,315,65,1,00348,India
460653,2023-06-25,209,pepsi,75,100,25,1,00249,India
460653,2023-06-25,207,coca cola,75,100,25,1,00249,India
460653,2023-06-25,206,yakult,360,400,40,1,00249,India
773293,2023-06-25,206,yakult,360,400,40,1,00030,India
773293,2023-06-25,212,amul cheese,250,315,65,1,00030,India
773293,2023-06-25,203,mango yogurt,50,60,10,1,00030,India
773293,2023-06-25,209,pepsi,75,100,25,1,00030,India
953155,2023-06-25,213,bisleri,6,15,9,1,00154,India
953155,2023-06-25,203,mango yogurt,50,60,10,1,00154,India
490375,2023-06-25,210,mountain dew,75,100,25,1,00277,India
490375,2023-06-25,203,mango yogurt,50,60,10,1,00277,India
490375,2023-06-25,213,bisleri,6,15,9,1,00277,India
550103,2023-06-25,213,bisleri,6,15,9,1,00198,India
277714,2023-06-25,205,classic yogurt,45,60,15,1,00387,India
277714,2023-06-25,213,bisleri,6,15,9,1,00387,India
277714,2023-06-25,203,mango yogurt,50,60,10,1,00387,India
833610,2023-06-25,213,bisleri,6,15,9,1,00283,India
833610,2023-06-25,209,pepsi,75,100,25,1,00283,India
395403,2023-06-25,203,mango yogurt,50,60,10,1,00128,India
395403,2023-06-25,207,coca cola,75,100,25,1,00128,India
511418,2023-06-25,205,classic yogurt,45,60,15,1,00322,India
511418,2023-06-25,203,mango yogurt,50,60,10,1,00322,India
511418,2023-06-25,204,strawberry yogurt,50,60,10,1,00322,India
511418,2023-06-25,207,coca cola,75,100,25,1,00322,India
708624,2023-06-25,203,mango yogurt,50,60,10,1,00264,India
708624,2023-06-25,212,amul cheese,250,315,65,1,00264,India
708624,2023-06-25,205,classic yogurt,45,60,15,1,00264,India
829469,2023-06-25,210,mountain dew,75,100,25,1,00074,India
829469,2023-06-25,209,pepsi,75,100,25,1,00074,India
829469,2023-06-25,213,bisleri,6,15,9,1,00074,India
829469,2023-06-25,211,red bull,90,125,35,1,00074,India
865798,2023-06-25,210,mountain dew,75,100,25,1,00075,India
655685,2023-06-25,209,pepsi,75,100,25,1,00181,India
655685,2023-06-25,212,amul cheese,250,315,65,1,00181,India
183930,2023-06-25,207,coca cola,75,100,25,1,00041,India
183930,2023-06-25,206,yakult,360,400,40,1,00041,India
183930,2023-06-25,212,amul cheese,250,315,65,1,00041,India
183930,2023-06-25,213,bisleri,6,15,9,1,00041,India
749442,2023-06-25,201,paneer,210,340,130,1,00215,India
749442,2023-06-25,209,pepsi,75,100,25,1,00215,India
749442,2023-06-25,213,bisleri,6,15,9,1,00215,India
380834,2023-06-25,207,coca cola,75,100,25,1,00194,India
847464,2023-06-25,202,milk,12,27,15,1,00387,India
988428,2023-06-25,202,milk,12,27,15,1,00280,India
305514,2023-06-25,206,yakult,360,400,40,1,00069,India
305514,2023-06-25,207,coca cola,75,100,25,1,00069,India
305514,2023-06-25,203,mango yogurt,50,60,10,1,00069,India
305514,2023-06-25,204,strawberry yogurt,50,60,10,1,00069,India
125748,2023-06-25,201,paneer,210,340,130,1,00426,India
125748,2023-06-25,209,pepsi,75,100,25,1,00426,India
125748,2023-06-25,208,sprite,75,100,25,1,00426,India
181305,2023-06-25,205,classic yogurt,45,60,15,1,00417,India
181305,2023-06-25,213,bisleri,6,15,9,1,00417,India
190600,2023-06-25,213,bisleri,6,15,9,1,00482,India
166001,2023-06-25,206,yakult,360,400,40,1,00098,India
832932,2023-06-25,212,amul cheese,250,315,65,1,00248,India
832932,2023-06-25,201,paneer,210,340,130,1,00248,India
832932,2023-06-25,206,yakult,360,400,40,1,00248,India
832932,2023-06-25,209,pepsi,75,100,25,1,00248,India
197518,2023-06-25,209,pepsi,75,100,25,1,00251,India
197518,2023-06-25,202,milk,12,27,15,1,00251,India
197518,2023-06-25,205,classic yogurt,45,60,15,1,00251,India
983073,2023-06-25,211,red bull,90,125,35,1,00172,India
119209,2023-06-25,205,classic yogurt,45,60,15,1,00141,India
119209,2023-06-25,212,amul cheese,250,315,65,1,00141,India
119209,2023-06-25,203,mango yogurt,50,60,10,1,00141,India
770069,2023-06-25,209,pepsi,75,100,25,1,00170,India
770069,2023-06-25,211,red bull,90,125,35,1,00170,India
770069,2023-06-25,213,bisleri,6,15,9,1,00170,India
932318,2023-06-25,201,paneer,210,340,130,1,00400,India
499154,2023-06-25,210,mountain dew,75,100,25,1,00328,India
499154,2023-06-25,202,milk,12,27,15,1,00328,India
671594,2023-06-25,213,bisleri,6,15,9,1,00240,India
671594,2023-06-25,206,yakult,360,400,40,1,00240,India
671594,2023-06-25,208,sprite,75,100,25,1,00240,India
972965,2023-06-25,210,mountain dew,75,100,25,1,00409,India
972965,2023-06-25,211,red bull,90,125,35,1,00409,India
279488,2023-06-25,210,mountain dew,75,100,25,1,00129,India
279488,2023-06-25,209,pepsi,75,100,25,1,00129,India
279488,2023-06-25,212,amul cheese,250,315,65,1,00129,India
279488,2023-06-25,206,yakult,360,400,40,1,00129,India
587401,2023-06-25,205,classic yogurt,45,60,15,1,00405,India
587401,2023-06-25,210,mountain dew,75,100,25,1,00405,India
721437,2023-06-25,205,classic yogurt,45,60,15,1,00173,India
721437,2023-06-25,207,coca cola,75,100,25,1,00173,India
607580,2023-06-25,207,coca cola,75,100,25,1,00038,India
607580,2023-06-25,212,amul cheese,250,315,65,1,00038,India
607580,2023-06-25,213,bisleri,6,15,9,1,00038,India
607580,2023-06-25,206,yakult,360,400,40,1,00038,India
436125,2023-06-25,202,milk,12,27,15,1,00196,India
436125,2023-06-25,210,mountain dew,75,100,25,1,00196,India
116944,2023-06-25,208,sprite,75,100,25,1,00004,India
116944,2023-06-25,206,yakult,360,400,40,1,00004,India
116944,2023-06-25,212,amul cheese,250,315,65,1,00004,India
116944,2023-06-25,205,classic yogurt,45,60,15,1,00004,India
348381,2023-06-25,209,pepsi,75,100,25,1,00485,India
348381,2023-06-25,202,milk,12,27,15,1,00485,India
348381,2023-06-25,212,amul cheese,250,315,65,1,00485,India
348381,2023-06-25,213,bisleri,6,15,9,1,00485,India
348381,2023-06-25,206,yakult,360,400,40,1,00485,India
669179,2023-06-25,209,pepsi,75,100,25,1,00463,India
669179,2023-06-25,206,yakult,360,400,40,1,00463,India
669179,2023-06-25,211,red bull,90,125,35,1,00463,India
669179,2023-06-25,210,mountain dew,75,100,25,1,00463,India
368183,2023-06-25,209,pepsi,75,100,25,1,00417,India
869930,2023-06-25,203,mango yogurt,50,60,10,1,00195,India
869930,2023-06-25,207,coca cola,75,100,25,1,00195,India
572085,2023-06-25,212,amul cheese,250,315,65,1,00171,India
572085,2023-06-25,202,milk,12,27,15,1,00171,India
199236,2023-06-25,210,mountain dew,75,100,25,1,00363,India
199236,2023-06-25,204,strawberry yogurt,50,60,10,1,00363,India
199236,2023-06-25,207,coca cola,75,100,25,1,00363,India
781898,2023-06-25,205,classic yogurt,45,60,15,1,00465,India
781898,2023-06-25,202,milk,12,27,15,1,00465,India
781898,2023-06-25,210,mountain dew,75,100,25,1,00465,India
781898,2023-06-25,213,bisleri,6,15,9,1,00465,India
781898,2023-06-25,207,coca cola,75,100,25,1,00465,India
421139,2023-06-25,212,amul cheese,250,315,65,1,00200,India
886637,2023-06-25,209,pepsi,75,100,25,1,00382,India
886637,2023-06-25,204,strawberry yogurt,50,60,10,1,00382,India
886637,2023-06-25,206,yakult,360,400,40,1,00382,India
513665,2023-06-25,208,sprite,75,100,25,1,00431,India
513665,2023-06-25,212,amul cheese,250,315,65,1,00431,India
513665,2023-06-25,202,milk,12,27,15,1,00431,India
422981,2023-06-25,210,mountain dew,75,100,25,1,00349,India
422981,2023-06-25,206,yakult,360,400,40,1,00349,India
422981,2023-06-25,209,pepsi,75,100,25,1,00349,India
422981,2023-06-25,213,bisleri,6,15,9,1,00349,India
422981,2023-06-25,204,strawberry yogurt,50,60,10,1,00349,India
537107,2023-06-25,206,yakult,360,400,40,1,00174,India
222195,2023-06-25,206,yakult,360,400,40,1,00324,India
418620,2023-06-25,206,yakult,360,400,40,1,00408,India
418620,2023-06-25,205,classic yogurt,45,60,15,1,00408,India
227244,2023-06-25,209,pepsi,75,100,25,1,00032,India
749656,2023-06-25,202,milk,12,27,15,1,00412,India
749656,2023-06-25,208,sprite,75,100,25,1,00412,India
357472,2023-06-25,201,paneer,210,340,130,1,00334,India
357472,2023-06-25,206,yakult,360,400,40,1,00334,India
357472,2023-06-25,210,mountain dew,75,100,25,1,00334,India
357472,2023-06-25,209,pepsi,75,100,25,1,00334,India
357472,2023-06-25,204,strawberry yogurt,50,60,10,1,00334,India
396132,2023-06-25,202,milk,12,27,15,1,00084,India
396132,2023-06-25,203,mango yogurt,50,60,10,1,00084,India
396132,2023-06-25,210,mountain dew,75,100,25,1,00084,India
396132,2023-06-25,205,classic yogurt,45,60,15,1,00084,India
396132,2023-06-25,201,paneer,210,340,130,1,00084,India
485949,2023-06-25,206,yakult,360,400,40,1,00468,India
485949,2023-06-25,210,mountain dew,75,100,25,1,00468,India
408893,2023-06-25,211,red bull,90,125,35,1,00024,India
408893,2023-06-25,212,amul cheese,250,315,65,1,00024,India
408893,2023-06-25,213,bisleri,6,15,9,1,00024,India
282143,2023-06-25,208,sprite,75,100,25,1,00262,India
588968,2023-06-25,202,milk,12,27,15,1,00100,India
588968,2023-06-25,211,red bull,90,125,35,1,00100,India
588968,2023-06-25,204,strawberry yogurt,50,60,10,1,00100,India
392359,2023-06-25,209,pepsi,75,100,25,1,00058,India
392359,2023-06-25,211,red bull,90,125,35,1,00058,India
538042,2023-06-25,210,mountain dew,75,100,25,1,00258,India
538042,2023-06-25,207,coca cola,75,100,25,1,00258,India
538042,2023-06-25,204,strawberry yogurt,50,60,10,1,00258,India
573978,2023-06-25,213,bisleri,6,15,9,1,00088,India
573978,2023-06-25,208,sprite,75,100,25,1,00088,India
454667,2023-06-25,205,classic yogurt,45,60,15,1,00222,India
454667,2023-06-25,210,mountain dew,75,100,25,1,00222,India
454667,2023-06-25,206,yakult,360,400,40,1,00222,India
188469,2023-06-25,212,amul cheese,250,315,65,1,00275,India
188469,2023-06-25,213,bisleri,6,15,9,1,00275,India
188469,2023-06-25,206,yakult,360,400,40,1,00275,India
188469,2023-06-25,204,strawberry yogurt,50,60,10,1,00275,India
315303,2023-06-25,208,sprite,75,100,25,1,00233,India
315303,2023-06-25,210,mountain dew,75,100,25,1,00233,India
315303,2023-06-25,205,classic yogurt,45,60,15,1,00233,India
983922,2023-06-25,210,mountain dew,75,100,25,1,00036,India
983922,2023-06-25,213,bisleri,6,15,9,1,00036,India
320547,2023-06-25,202,milk,12,27,15,1,00446,India
320547,2023-06-25,213,bisleri,6,15,9,1,00446,India
320547,2023-06-25,203,mango yogurt,50,60,10,1,00446,India
320547,2023-06-25,212,amul cheese,250,315,65,1,00446,India
582405,2023-06-25,211,red bull,90,125,35,1,00312,India
395884,2023-06-25,212,amul cheese,250,315,65,1,00004,India
200643,2023-06-25,209,pepsi,75,100,25,1,00022,India
200643,2023-06-25,211,red bull,90,125,35,1,00022,India
200643,2023-06-25,204,strawberry yogurt,50,60,10,1,00022,India
200643,2023-06-25,206,yakult,360,400,40,1,00022,India
225169,2023-06-25,210,mountain dew,75,100,25,1,00201,India
225169,2023-06-25,205,classic yogurt,45,60,15,1,00201,India
788701,2023-06-25,211,red bull,90,125,35,1,00036,India
788701,2023-06-25,209,pepsi,75,100,25,1,00036,India
921543,2023-06-25,202,milk,12,27,15,1,00097,India
921543,2023-06-25,212,amul cheese,250,315,65,1,00097,India
731948,2023-06-25,208,sprite,75,100,25,1,00001,India
270120,2023-06-25,202,milk,12,27,15,1,00120,India
123396,2023-06-25,207,coca cola,75,100,25,1,00057,India
123396,2023-06-25,206,yakult,360,400,40,1,00057,India
123396,2023-06-25,201,paneer,210,340,130,1,00057,India
561709,2023-06-25,210,mountain dew,75,100,25,1,00142,India
360960,2023-06-25,202,milk,12,27,15,1,00407,India
360960,2023-06-25,205,classic yogurt,45,60,15,1,00407,India
360960,2023-06-25,208,sprite,75,100,25,1,00407,India
360960,2023-06-25,206,yakult,360,400,40,1,00407,India
888567,2023-06-25,202,milk,12,27,15,1,00465,India
888567,2023-06-25,208,sprite,75,100,25,1,00465,India
355348,2023-06-25,212,amul cheese,250,315,65,1,00070,India
355348,2023-06-25,207,coca cola,75,100,25,1,00070,India
355348,2023-06-25,203,mango yogurt,50,60,10,1,00070,India
729634,2023-06-25,202,milk,12,27,15,1,00251,India
729634,2023-06-25,201,paneer,210,340,130,1,00251,India
368574,2023-06-26,209,pepsi,75,100,25,1,00026,India
368574,2023-06-26,211,red bull,90,125,35,1,00026,India
368574,2023-06-26,204,strawberry yogurt,50,60,10,1,00026,India
368574,2023-06-26,201,paneer,210,340,130,1,00026,India
775301,2023-06-26,207,coca cola,75,100,25,1,00372,India
775301,2023-06-26,206,yakult,360,400,40,1,00372,India
764058,2023-06-26,207,coca cola,75,100,25,1,00076,India
764058,2023-06-26,210,mountain dew,75,100,25,1,00076,India
764058,2023-06-26,212,amul cheese,250,315,65,1,00076,India
483858,2023-06-26,206,yakult,360,400,40,1,00435,India
483858,2023-06-26,202,milk,12,27,15,1,00435,India
728275,2023-06-26,204,strawberry yogurt,50,60,10,1,00166,India
185700,2023-06-26,204,strawberry yogurt,50,60,10,1,00064,India
185700,2023-06-26,202,milk,12,27,15,1,00064,India
185700,2023-06-26,201,paneer,210,340,130,1,00064,India
185700,2023-06-26,205,classic yogurt,45,60,15,1,00064,India
765236,2023-06-26,213,bisleri,6,15,9,1,00342,India
765236,2023-06-26,201,paneer,210,340,130,1,00342,India
765236,2023-06-26,206,yakult,360,400,40,1,00342,India
765236,2023-06-26,204,strawberry yogurt,50,60,10,1,00342,India
900745,2023-06-26,208,sprite,75,100,25,1,00160,India
900745,2023-06-26,202,milk,12,27,15,1,00160,India
709662,2023-06-26,208,sprite,75,100,25,1,00205,India
974419,2023-06-26,213,bisleri,6,15,9,1,00159,India
974419,2023-06-26,209,pepsi,75,100,25,1,00159,India
688928,2023-06-26,202,milk,12,27,15,1,00055,India
423580,2023-06-26,212,amul cheese,250,315,65,1,00106,India
478923,2023-06-26,203,mango yogurt,50,60,10,1,00128,India
190801,2023-06-26,206,yakult,360,400,40,1,00021,India
190801,2023-06-26,201,paneer,210,340,130,1,00021,India
190801,2023-06-26,202,milk,12,27,15,1,00021,India
190801,2023-06-26,211,red bull,90,125,35,1,00021,India
351430,2023-06-26,207,coca cola,75,100,25,1,00467,India
351430,2023-06-26,203,mango yogurt,50,60,10,1,00467,India
351430,2023-06-26,201,paneer,210,340,130,1,00467,India
351430,2023-06-26,212,amul cheese,250,315,65,1,00467,India
351430,2023-06-26,209,pepsi,75,100,25,1,00467,India
789753,2023-06-26,202,milk,12,27,15,1,00330,India
789753,2023-06-26,203,mango yogurt,50,60,10,1,00330,India
789753,2023-06-26,208,sprite,75,100,25,1,00330,India
789753,2023-06-26,209,pepsi,75,100,25,1,00330,India
492203,2023-06-26,208,sprite,75,100,25,1,00118,India
492203,2023-06-26,206,yakult,360,400,40,1,00118,India
492203,2023-06-26,207,coca cola,75,100,25,1,00118,India
492203,2023-06-26,201,paneer,210,340,130,1,00118,India
489951,2023-06-26,208,sprite,75,100,25,1,00244,India
489951,2023-06-26,201,paneer,210,340,130,1,00244,India
677264,2023-06-26,211,red bull,90,125,35,1,00004,India
677264,2023-06-26,210,mountain dew,75,100,25,1,00004,India
677264,2023-06-26,201,paneer,210,340,130,1,00004,India
677264,2023-06-26,203,mango yogurt,50,60,10,1,00004,India
677264,2023-06-26,205,classic yogurt,45,60,15,1,00004,India
484108,2023-06-26,202,milk,12,27,15,1,00114,India
484108,2023-06-26,213,bisleri,6,15,9,1,00114,India
484108,2023-06-26,205,classic yogurt,45,60,15,1,00114,India
484108,2023-06-26,204,strawberry yogurt,50,60,10,1,00114,India
638800,2023-06-26,213,bisleri,6,15,9,1,00167,India
638800,2023-06-26,209,pepsi,75,100,25,1,00167,India
638800,2023-06-26,207,coca cola,75,100,25,1,00167,India
638800,2023-06-26,212,amul cheese,250,315,65,1,00167,India
152002,2023-06-26,204,strawberry yogurt,50,60,10,1,00056,India
434332,2023-06-26,208,sprite,75,100,25,1,00077,India
778076,2023-06-26,211,red bull,90,125,35,1,00418,India
778076,2023-06-26,209,pepsi,75,100,25,1,00418,India
778076,2023-06-26,201,paneer,210,340,130,1,00418,India
268521,2023-06-26,205,classic yogurt,45,60,15,1,00464,India
268521,2023-06-26,204,strawberry yogurt,50,60,10,1,00464,India
268521,2023-06-26,201,paneer,210,340,130,1,00464,India
268521,2023-06-26,202,milk,12,27,15,1,00464,India
798124,2023-06-26,206,yakult,360,400,40,1,00107,India
798124,2023-06-26,204,strawberry yogurt,50,60,10,1,00107,India
798124,2023-06-26,211,red bull,90,125,35,1,00107,India
456173,2023-06-26,202,milk,12,27,15,1,00460,India
683717,2023-06-26,201,paneer,210,340,130,1,00115,India
181102,2023-06-26,211,red bull,90,125,35,1,00443,India
181102,2023-06-26,201,paneer,210,340,130,1,00443,India
181102,2023-06-26,212,amul cheese,250,315,65,1,00443,India
181102,2023-06-26,204,strawberry yogurt,50,60,10,1,00443,India
181102,2023-06-26,205,classic yogurt,45,60,15,1,00443,India
230871,2023-06-26,207,coca cola,75,100,25,1,00024,India
230871,2023-06-26,213,bisleri,6,15,9,1,00024,India
230871,2023-06-26,205,classic yogurt,45,60,15,1,00024,India
230871,2023-06-26,210,mountain dew,75,100,25,1,00024,India
932670,2023-06-26,210,mountain dew,75,100,25,1,00425,India
177284,2023-06-26,204,strawberry yogurt,50,60,10,1,00209,India
177284,2023-06-26,212,amul cheese,250,315,65,1,00209,India
177284,2023-06-26,208,sprite,75,100,25,1,00209,India
813015,2023-06-26,212,amul cheese,250,315,65,1,00479,India
813015,2023-06-26,210,mountain dew,75,100,25,1,00479,India
813015,2023-06-26,209,pepsi,75,100,25,1,00479,India
624868,2023-06-26,210,mountain dew,75,100,25,1,00115,India
624868,2023-06-26,204,strawberry yogurt,50,60,10,1,00115,India
624868,2023-06-26,212,amul cheese,250,315,65,1,00115,India
624868,2023-06-26,201,paneer,210,340,130,1,00115,India
624868,2023-06-26,211,red bull,90,125,35,1,00115,India
736064,2023-06-26,201,paneer,210,340,130,1,00295,India
736064,2023-06-26,213,bisleri,6,15,9,1,00295,India
110991,2023-06-26,202,milk,12,27,15,1,00067,India
110991,2023-06-26,210,mountain dew,75,100,25,1,00067,India
110991,2023-06-26,201,paneer,210,340,130,1,00067,India
110991,2023-06-26,205,classic yogurt,45,60,15,1,00067,India
110991,2023-06-26,207,coca cola,75,100,25,1,00067,India
133933,2023-06-26,211,red bull,90,125,35,1,00287,India
819399,2023-06-26,201,paneer,210,340,130,1,00289,India
819399,2023-06-26,209,pepsi,75,100,25,1,00289,India
819399,2023-06-26,207,coca cola,75,100,25,1,00289,India
819399,2023-06-26,212,amul cheese,250,315,65,1,00289,India
819399,2023-06-26,204,strawberry yogurt,50,60,10,1,00289,India
782054,2023-06-26,206,yakult,360,400,40,1,00422,India
116434,2023-06-26,207,coca cola,75,100,25,1,00255,India
138352,2023-06-26,213,bisleri,6,15,9,1,00205,India
138352,2023-06-26,204,strawberry yogurt,50,60,10,1,00205,India
877032,2023-06-26,210,mountain dew,75,100,25,1,00454,India
877032,2023-06-26,207,coca cola,75,100,25,1,00454,India
863140,2023-06-26,210,mountain dew,75,100,25,1,00433,India
863140,2023-06-26,203,mango yogurt,50,60,10,1,00433,India
863140,2023-06-26,201,paneer,210,340,130,1,00433,India
918656,2023-06-26,206,yakult,360,400,40,1,00156,India
918656,2023-06-26,212,amul cheese,250,315,65,1,00156,India
918656,2023-06-26,213,bisleri,6,15,9,1,00156,India
977258,2023-06-26,207,coca cola,75,100,25,1,00303,India
977258,2023-06-26,208,sprite,75,100,25,1,00303,India
977258,2023-06-26,201,paneer,210,340,130,1,00303,India
977258,2023-06-26,212,amul cheese,250,315,65,1,00303,India
528343,2023-06-26,207,coca cola,75,100,25,1,00149,India
334886,2023-06-26,201,paneer,210,340,130,1,00495,India
334886,2023-06-26,213,bisleri,6,15,9,1,00495,India
334886,2023-06-26,204,strawberry yogurt,50,60,10,1,00495,India
334886,2023-06-26,203,mango yogurt,50,60,10,1,00495,India
334886,2023-06-26,205,classic yogurt,45,60,15,1,00495,India
625607,2023-06-26,203,mango yogurt,50,60,10,1,00168,India
625607,2023-06-26,209,pepsi,75,100,25,1,00168,India
625607,2023-06-26,206,yakult,360,400,40,1,00168,India
107920,2023-06-26,201,paneer,210,340,130,1,00239,India
107920,2023-06-26,213,bisleri,6,15,9,1,00239,India
107920,2023-06-26,210,mountain dew,75,100,25,1,00239,India
107920,2023-06-26,211,red bull,90,125,35,1,00239,India
107920,2023-06-26,205,classic yogurt,45,60,15,1,00239,India
146663,2023-06-26,211,red bull,90,125,35,1,00197,India
146663,2023-06-26,203,mango yogurt,50,60,10,1,00197,India
146663,2023-06-26,201,paneer,210,340,130,1,00197,India
146663,2023-06-26,209,pepsi,75,100,25,1,00197,India
699684,2023-06-26,205,classic yogurt,45,60,15,1,00408,India
719983,2023-06-26,209,pepsi,75,100,25,1,00004,India
327259,2023-06-26,205,classic yogurt,45,60,15,1,00216,India
327259,2023-06-26,208,sprite,75,100,25,1,00216,India
327259,2023-06-26,211,red bull,90,125,35,1,00216,India
327259,2023-06-26,202,milk,12,27,15,1,00216,India
327259,2023-06-26,207,coca cola,75,100,25,1,00216,India
818600,2023-06-26,211,red bull,90,125,35,1,00475,India
818600,2023-06-26,202,milk,12,27,15,1,00475,India
818600,2023-06-26,210,mountain dew,75,100,25,1,00475,India
859978,2023-06-26,203,mango yogurt,50,60,10,1,00157,India
859978,2023-06-26,206,yakult,360,400,40,1,00157,India
820865,2023-06-26,207,coca cola,75,100,25,1,00003,India
820865,2023-06-26,211,red bull,90,125,35,1,00003,India
820865,2023-06-26,201,paneer,210,340,130,1,00003,India
820865,2023-06-26,206,yakult,360,400,40,1,00003,India
761318,2023-06-26,208,sprite,75,100,25,1,00470,India
621332,2023-06-26,210,mountain dew,75,100,25,1,00428,India
726180,2023-06-26,210,mountain dew,75,100,25,1,00262,India
726180,2023-06-26,211,red bull,90,125,35,1,00262,India
726180,2023-06-26,206,yakult,360,400,40,1,00262,India
565890,2023-06-26,212,amul cheese,250,315,65,1,00468,India
565890,2023-06-26,202,milk,12,27,15,1,00468,India
565890,2023-06-26,210,mountain dew,75,100,25,1,00468,India
565890,2023-06-26,208,sprite,75,100,25,1,00468,India
958703,2023-06-26,201,paneer,210,340,130,1,00492,India
958703,2023-06-26,203,mango yogurt,50,60,10,1,00492,India
219182,2023-06-26,203,mango yogurt,50,60,10,1,00274,India
219182,2023-06-26,209,pepsi,75,100,25,1,00274,India
796699,2023-06-26,204,strawberry yogurt,50,60,10,1,00179,India
135125,2023-06-26,207,coca cola,75,100,25,1,00305,India
654853,2023-06-26,210,mountain dew,75,100,25,1,00055,India
654853,2023-06-26,203,mango yogurt,50,60,10,1,00055,India
654853,2023-06-26,207,coca cola,75,100,25,1,00055,India
172869,2023-06-26,206,yakult,360,400,40,1,00410,India
172869,2023-06-26,211,red bull,90,125,35,1,00410,India
163005,2023-06-26,205,classic yogurt,45,60,15,1,00197,India
430501,2023-06-26,212,amul cheese,250,315,65,1,00099,India
430501,2023-06-26,208,sprite,75,100,25,1,00099,India
656950,2023-06-26,208,sprite,75,100,25,1,00366,India
656950,2023-06-26,211,red bull,90,125,35,1,00366,India
656950,2023-06-26,207,coca cola,75,100,25,1,00366,India
656950,2023-06-26,205,classic yogurt,45,60,15,1,00366,India
849957,2023-06-26,209,pepsi,75,100,25,1,00419,India
849957,2023-06-26,213,bisleri,6,15,9,1,00419,India
849957,2023-06-26,207,coca cola,75,100,25,1,00419,India
474406,2023-06-26,203,mango yogurt,50,60,10,1,00253,India
597324,2023-06-26,204,strawberry yogurt,50,60,10,1,00088,India
597324,2023-06-26,201,paneer,210,340,130,1,00088,India
597324,2023-06-26,209,pepsi,75,100,25,1,00088,India
597324,2023-06-26,213,bisleri,6,15,9,1,00088,India
470498,2023-06-26,205,classic yogurt,45,60,15,1,00304,India
470498,2023-06-26,202,milk,12,27,15,1,00304,India
470498,2023-06-26,203,mango yogurt,50,60,10,1,00304,India
470498,2023-06-26,210,mountain dew,75,100,25,1,00304,India
273811,2023-06-26,207,coca cola,75,100,25,1,00109,India
273811,2023-06-26,212,amul cheese,250,315,65,1,00109,India
859281,2023-06-26,206,yakult,360,400,40,1,00377,India
859281,2023-06-26,204,strawberry yogurt,50,60,10,1,00377,India
859281,2023-06-26,212,amul cheese,250,315,65,1,00377,India
134004,2023-06-26,208,sprite,75,100,25,1,00449,India
562780,2023-06-26,203,mango yogurt,50,60,10,1,00261,India
253919,2023-06-26,203,mango yogurt,50,60,10,1,00158,India
253919,2023-06-26,206,yakult,360,400,40,1,00158,India
253919,2023-06-26,212,amul cheese,250,315,65,1,00158,India
236523,2023-06-26,208,sprite,75,100,25,1,00187,India
236523,2023-06-26,212,amul cheese,250,315,65,1,00187,India
236523,2023-06-26,205,classic yogurt,45,60,15,1,00187,India
144622,2023-06-26,209,pepsi,75,100,25,1,00269,India
144622,2023-06-26,202,milk,12,27,15,1,00269,India
144622,2023-06-26,210,mountain dew,75,100,25,1,00269,India
447422,2023-06-26,206,yakult,360,400,40,1,00345,India
472381,2023-06-26,213,bisleri,6,15,9,1,00209,India
106193,2023-06-26,211,red bull,90,125,35,1,00258,India
106193,2023-06-26,205,classic yogurt,45,60,15,1,00258,India
106193,2023-06-26,204,strawberry yogurt,50,60,10,1,00258,India
855528,2023-06-26,202,milk,12,27,15,1,00105,India
855528,2023-06-26,203,mango yogurt,50,60,10,1,00105,India
374757,2023-06-26,209,pepsi,75,100,25,1,00027,India
374757,2023-06-26,210,mountain dew,75,100,25,1,00027,India
374757,2023-06-26,213,bisleri,6,15,9,1,00027,India
374757,2023-06-26,203,mango yogurt,50,60,10,1,00027,India
763614,2023-06-26,213,bisleri,6,15,9,1,00071,India
296386,2023-06-26,206,yakult,360,400,40,1,00432,India
142058,2023-06-26,209,pepsi,75,100,25,1,00233,India
142058,2023-06-26,202,milk,12,27,15,1,00233,India
142058,2023-06-26,213,bisleri,6,15,9,1,00233,India
142058,2023-06-26,211,red bull,90,125,35,1,00233,India
142058,2023-06-26,208,sprite,75,100,25,1,00233,India
350040,2023-06-27,208,sprite,75,100,25,1,00273,India
350040,2023-06-27,202,milk,12,27,15,1,00273,India
350040,2023-06-27,204,strawberry yogurt,50,60,10,1,00273,India
717373,2023-06-27,203,mango yogurt,50,60,10,1,00082,India
717373,2023-06-27,206,yakult,360,400,40,1,00082,India
717373,2023-06-27,204,strawberry yogurt,50,60,10,1,00082,India
946235,2023-06-27,213,bisleri,6,15,9,1,00353,India
353670,2023-06-27,207,coca cola,75,100,25,1,00069,India
353670,2023-06-27,211,red bull,90,125,35,1,00069,India
353670,2023-06-27,213,bisleri,6,15,9,1,00069,India
353670,2023-06-27,203,mango yogurt,50,60,10,1,00069,India
353670,2023-06-27,205,classic yogurt,45,60,15,1,00069,India
654676,2023-06-27,205,classic yogurt,45,60,15,1,00470,India
920933,2023-06-27,211,red bull,90,125,35,1,00259,India
541050,2023-06-27,212,amul cheese,250,315,65,1,00045,India
541050,2023-06-27,207,coca cola,75,100,25,1,00045,India
541050,2023-06-27,210,mountain dew,75,100,25,1,00045,India
541050,2023-06-27,201,paneer,210,340,130,1,00045,India
747944,2023-06-27,209,pepsi,75,100,25,1,00375,India
747944,2023-06-27,204,strawberry yogurt,50,60,10,1,00375,India
747944,2023-06-27,205,classic yogurt,45,60,15,1,00375,India
747944,2023-06-27,213,bisleri,6,15,9,1,00375,India
747944,2023-06-27,201,paneer,210,340,130,1,00375,India
820924,2023-06-27,213,bisleri,6,15,9,1,00378,India
820924,2023-06-27,209,pepsi,75,100,25,1,00378,India
820924,2023-06-27,212,amul cheese,250,315,65,1,00378,India
820924,2023-06-27,208,sprite,75,100,25,1,00378,India
747044,2023-06-27,203,mango yogurt,50,60,10,1,00043,India
747044,2023-06-27,204,strawberry yogurt,50,60,10,1,00043,India
747044,2023-06-27,206,yakult,360,400,40,1,00043,India
314491,2023-06-27,209,pepsi,75,100,25,1,00356,India
314491,2023-06-27,208,sprite,75,100,25,1,00356,India
609101,2023-06-27,206,yakult,360,400,40,1,00116,India
609101,2023-06-27,201,paneer,210,340,130,1,00116,India
609101,2023-06-27,208,sprite,75,100,25,1,00116,India
392866,2023-06-27,213,bisleri,6,15,9,1,00019,India
754709,2023-06-27,208,sprite,75,100,25,1,00309,India
754709,2023-06-27,211,red bull,90,125,35,1,00309,India
502917,2023-06-27,208,sprite,75,100,25,1,00447,India
502917,2023-06-27,212,amul cheese,250,315,65,1,00447,India
502917,2023-06-27,210,mountain dew,75,100,25,1,00447,India
521990,2023-06-27,202,milk,12,27,15,1,00355,India
521990,2023-06-27,211,red bull,90,125,35,1,00355,India
521990,2023-06-27,203,mango yogurt,50,60,10,1,00355,India
492030,2023-06-27,212,amul cheese,250,315,65,1,00300,India
492030,2023-06-27,213,bisleri,6,15,9,1,00300,India
492030,2023-06-27,210,mountain dew,75,100,25,1,00300,India
492030,2023-06-27,209,pepsi,75,100,25,1,00300,India
958778,2023-06-27,201,paneer,210,340,130,1,00103,India
958778,2023-06-27,210,mountain dew,75,100,25,1,00103,India
958778,2023-06-27,205,classic yogurt,45,60,15,1,00103,India
931781,2023-06-27,213,bisleri,6,15,9,1,00340,India
931781,2023-06-27,207,coca cola,75,100,25,1,00340,India
931781,2023-06-27,211,red bull,90,125,35,1,00340,India
931781,2023-06-27,202,milk,12,27,15,1,00340,India
308546,2023-06-27,209,pepsi,75,100,25,1,00442,India
308546,2023-06-27,206,yakult,360,400,40,1,00442,India
174414,2023-06-27,201,paneer,210,340,130,1,00324,India
174414,2023-06-27,211,red bull,90,125,35,1,00324,India
174414,2023-06-27,202,milk,12,27,15,1,00324,India
381788,2023-06-27,209,pepsi,75,100,25,1,00173,India
381788,2023-06-27,204,strawberry yogurt,50,60,10,1,00173,India
381788,2023-06-27,212,amul cheese,250,315,65,1,00173,India
381788,2023-06-27,201,paneer,210,340,130,1,00173,India
381788,2023-06-27,205,classic yogurt,45,60,15,1,00173,India
741430,2023-06-27,203,mango yogurt,50,60,10,1,00496,India
853911,2023-06-27,205,classic yogurt,45,60,15,1,00339,India
853911,2023-06-27,207,coca cola,75,100,25,1,00339,India
853911,2023-06-27,203,mango yogurt,50,60,10,1,00339,India
750017,2023-06-27,212,amul cheese,250,315,65,1,00040,India
672926,2023-06-27,206,yakult,360,400,40,1,00264,India
672926,2023-06-27,211,red bull,90,125,35,1,00264,India
672926,2023-06-27,213,bisleri,6,15,9,1,00264,India
928415,2023-06-27,206,yakult,360,400,40,1,00277,India
928415,2023-06-27,202,milk,12,27,15,1,00277,India
928415,2023-06-27,213,bisleri,6,15,9,1,00277,India
710492,2023-06-27,211,red bull,90,125,35,1,00412,India
710492,2023-06-27,213,bisleri,6,15,9,1,00412,India
710492,2023-06-27,208,sprite,75,100,25,1,00412,India
745357,2023-06-27,203,mango yogurt,50,60,10,1,00366,India
172007,2023-06-27,206,yakult,360,400,40,1,00077,India
206953,2023-06-27,207,coca cola,75,100,25,1,00384,India
206953,2023-06-27,206,yakult,360,400,40,1,00384,India
206953,2023-06-27,210,mountain dew,75,100,25,1,00384,India
206953,2023-06-27,211,red bull,90,125,35,1,00384,India
646925,2023-06-27,211,red bull,90,125,35,1,00176,India
646925,2023-06-27,201,paneer,210,340,130,1,00176,India
646925,2023-06-27,210,mountain dew,75,100,25,1,00176,India
646925,2023-06-27,202,milk,12,27,15,1,00176,India
550944,2023-06-27,201,paneer,210,340,130,1,00490,India
550944,2023-06-27,207,coca cola,75,100,25,1,00490,India
550944,2023-06-27,209,pepsi,75,100,25,1,00490,India
550944,2023-06-27,203,mango yogurt,50,60,10,1,00490,India
550944,2023-06-27,210,mountain dew,75,100,25,1,00490,India
118598,2023-06-27,201,paneer,210,340,130,1,00115,India
118598,2023-06-27,213,bisleri,6,15,9,1,00115,India
429781,2023-06-27,201,paneer,210,340,130,1,00160,India
731537,2023-06-27,205,classic yogurt,45,60,15,1,00332,India
731537,2023-06-27,207,coca cola,75,100,25,1,00332,India
115481,2023-06-27,207,coca cola,75,100,25,1,00041,India
115481,2023-06-27,205,classic yogurt,45,60,15,1,00041,India
115481,2023-06-27,203,mango yogurt,50,60,10,1,00041,India
115481,2023-06-27,206,yakult,360,400,40,1,00041,India
295962,2023-06-27,205,classic yogurt,45,60,15,1,00462,India
295962,2023-06-27,206,yakult,360,400,40,1,00462,India
295962,2023-06-27,212,amul cheese,250,315,65,1,00462,India
295962,2023-06-27,210,mountain dew,75,100,25,1,00462,India
669266,2023-06-27,213,bisleri,6,15,9,1,00118,India
669266,2023-06-27,212,amul cheese,250,315,65,1,00118,India
669266,2023-06-27,204,strawberry yogurt,50,60,10,1,00118,India
138998,2023-06-27,212,amul cheese,250,315,65,1,00326,India
138998,2023-06-27,202,milk,12,27,15,1,00326,India
138998,2023-06-27,205,classic yogurt,45,60,15,1,00326,India
138998,2023-06-27,207,coca cola,75,100,25,1,00326,India
471021,2023-06-27,202,milk,12,27,15,1,00051,India
471021,2023-06-27,207,coca cola,75,100,25,1,00051,India
322592,2023-06-27,206,yakult,360,400,40,1,00186,India
322592,2023-06-27,207,coca cola,75,100,25,1,00186,India
895048,2023-06-27,205,classic yogurt,45,60,15,1,00134,India
895048,2023-06-27,213,bisleri,6,15,9,1,00134,India
895048,2023-06-27,203,mango yogurt,50,60,10,1,00134,India
895048,2023-06-27,206,yakult,360,400,40,1,00134,India
984042,2023-06-27,201,paneer,210,340,130,1,00197,India
984042,2023-06-27,210,mountain dew,75,100,25,1,00197,India
984042,2023-06-27,203,mango yogurt,50,60,10,1,00197,India
984042,2023-06-27,211,red bull,90,125,35,1,00197,India
367602,2023-06-27,202,milk,12,27,15,1,00276,India
367602,2023-06-27,201,paneer,210,340,130,1,00276,India
322286,2023-06-27,204,strawberry yogurt,50,60,10,1,00249,India
322286,2023-06-27,209,pepsi,75,100,25,1,00249,India
935078,2023-06-27,202,milk,12,27,15,1,00079,India
935078,2023-06-27,201,paneer,210,340,130,1,00079,India
935078,2023-06-27,212,amul cheese,250,315,65,1,00079,India
935078,2023-06-27,203,mango yogurt,50,60,10,1,00079,India
813703,2023-06-27,204,strawberry yogurt,50,60,10,1,00339,India
813703,2023-06-27,208,sprite,75,100,25,1,00339,India
813703,2023-06-27,205,classic yogurt,45,60,15,1,00339,India
813703,2023-06-27,211,red bull,90,125,35,1,00339,India
455026,2023-06-27,213,bisleri,6,15,9,1,00414,India
455026,2023-06-27,202,milk,12,27,15,1,00414,India
930436,2023-06-27,205,classic yogurt,45,60,15,1,00175,India
254814,2023-06-27,203,mango yogurt,50,60,10,1,00292,India
254814,2023-06-27,202,milk,12,27,15,1,00292,India
324035,2023-06-27,204,strawberry yogurt,50,60,10,1,00205,India
776337,2023-06-27,212,amul cheese,250,315,65,1,00390,India
776337,2023-06-27,203,mango yogurt,50,60,10,1,00390,India
776337,2023-06-27,210,mountain dew,75,100,25,1,00390,India
857956,2023-06-27,209,pepsi,75,100,25,1,00287,India
857956,2023-06-27,203,mango yogurt,50,60,10,1,00287,India
388675,2023-06-27,201,paneer,210,340,130,1,00091,India
100087,2023-06-27,206,yakult,360,400,40,1,00159,India
100087,2023-06-27,204,strawberry yogurt,50,60,10,1,00159,India
100087,2023-06-27,203,mango yogurt,50,60,10,1,00159,India
100087,2023-06-27,202,milk,12,27,15,1,00159,India
305882,2023-06-27,208,sprite,75,100,25,1,00217,India
305882,2023-06-27,202,milk,12,27,15,1,00217,India
305882,2023-06-27,207,coca cola,75,100,25,1,00217,India
305882,2023-06-27,209,pepsi,75,100,25,1,00217,India
692654,2023-06-27,212,amul cheese,250,315,65,1,00274,India
691713,2023-06-27,208,sprite,75,100,25,1,00029,India
691713,2023-06-27,207,coca cola,75,100,25,1,00029,India
691713,2023-06-27,210,mountain dew,75,100,25,1,00029,India
843940,2023-06-27,205,classic yogurt,45,60,15,1,00097,India
843940,2023-06-27,212,amul cheese,250,315,65,1,00097,India
843940,2023-06-27,213,bisleri,6,15,9,1,00097,India
843940,2023-06-27,202,milk,12,27,15,1,00097,India
129633,2023-06-27,203,mango yogurt,50,60,10,1,00062,India
129633,2023-06-27,210,mountain dew,75,100,25,1,00062,India
129633,2023-06-27,201,paneer,210,340,130,1,00062,India
441827,2023-06-27,206,yakult,360,400,40,1,00162,India
441827,2023-06-27,207,coca cola,75,100,25,1,00162,India
176822,2023-06-27,201,paneer,210,340,130,1,00454,India
176822,2023-06-27,207,coca cola,75,100,25,1,00454,India
176822,2023-06-27,208,sprite,75,100,25,1,00454,India
176822,2023-06-27,212,amul cheese,250,315,65,1,00454,India
964632,2023-06-27,203,mango yogurt,50,60,10,1,00282,India
964632,2023-06-27,212,amul cheese,250,315,65,1,00282,India
377431,2023-06-27,208,sprite,75,100,25,1,00361,India
377431,2023-06-27,201,paneer,210,340,130,1,00361,India
377431,2023-06-27,207,coca cola,75,100,25,1,00361,India
907800,2023-06-27,210,mountain dew,75,100,25,1,00111,India
737530,2023-06-27,213,bisleri,6,15,9,1,00432,India
737530,2023-06-27,203,mango yogurt,50,60,10,1,00432,India
737530,2023-06-27,207,coca cola,75,100,25,1,00432,India
656337,2023-06-27,201,paneer,210,340,130,1,00407,India
656337,2023-06-27,208,sprite,75,100,25,1,00407,India
920890,2023-06-27,202,milk,12,27,15,1,00417,India
691815,2023-06-27,201,paneer,210,340,130,1,00182,India
691815,2023-06-27,204,strawberry yogurt,50,60,10,1,00182,India
994240,2023-06-27,202,milk,12,27,15,1,00210,India
994240,2023-06-27,201,paneer,210,340,130,1,00210,India
994240,2023-06-27,206,yakult,360,400,40,1,00210,India
167805,2023-06-27,203,mango yogurt,50,60,10,1,00056,India
167805,2023-06-27,208,sprite,75,100,25,1,00056,India
167805,2023-06-27,201,paneer,210,340,130,1,00056,India
167805,2023-06-27,207,coca cola,75,100,25,1,00056,India
167805,2023-06-27,204,strawberry yogurt,50,60,10,1,00056,India
475095,2023-06-27,201,paneer,210,340,130,1,00463,India
475095,2023-06-27,211,red bull,90,125,35,1,00463,India
475095,2023-06-27,212,amul cheese,250,315,65,1,00463,India
443323,2023-06-27,213,bisleri,6,15,9,1,00393,India
443323,2023-06-27,209,pepsi,75,100,25,1,00393,India
661130,2023-06-27,206,yakult,360,400,40,1,00492,India
401334,2023-06-27,207,coca cola,75,100,25,1,00378,India
401334,2023-06-27,201,paneer,210,340,130,1,00378,India
401334,2023-06-27,205,classic yogurt,45,60,15,1,00378,India
339400,2023-06-27,202,milk,12,27,15,1,00134,India
339400,2023-06-27,210,mountain dew,75,100,25,1,00134,India
339400,2023-06-27,201,paneer,210,340,130,1,00134,India
235660,2023-06-27,210,mountain dew,75,100,25,1,00083,India
235660,2023-06-27,206,yakult,360,400,40,1,00083,India
859044,2023-06-27,209,pepsi,75,100,25,1,00304,India
859044,2023-06-27,208,sprite,75,100,25,1,00304,India
859044,2023-06-27,204,strawberry yogurt,50,60,10,1,00304,India
619295,2023-06-27,211,red bull,90,125,35,1,00486,India
619295,2023-06-27,212,amul cheese,250,315,65,1,00486,India
619295,2023-06-27,201,paneer,210,340,130,1,00486,India
265686,2023-06-27,205,classic yogurt,45,60,15,1,00077,India
265686,2023-06-27,209,pepsi,75,100,25,1,00077,India
265686,2023-06-27,204,strawberry yogurt,50,60,10,1,00077,India
727078,2023-06-27,211,red bull,90,125,35,1,00352,India
727078,2023-06-27,202,milk,12,27,15,1,00352,India
727078,2023-06-27,204,strawberry yogurt,50,60,10,1,00352,India
727078,2023-06-27,212,amul cheese,250,315,65,1,00352,India
218508,2023-06-27,210,mountain dew,75,100,25,1,00143,India
218508,2023-06-27,213,bisleri,6,15,9,1,00143,India
305407,2023-06-27,210,mountain dew,75,100,25,1,00033,India
922400,2023-06-27,204,strawberry yogurt,50,60,10,1,00396,India
381729,2023-06-27,211,red bull,90,125,35,1,00390,India
195125,2023-06-27,212,amul cheese,250,315,65,1,00009,India
195125,2023-06-27,204,strawberry yogurt,50,60,10,1,00009,India
239881,2023-06-27,210,mountain dew,75,100,25,1,00103,India
239881,2023-06-27,203,mango yogurt,50,60,10,1,00103,India
239881,2023-06-27,212,amul cheese,250,315,65,1,00103,India
239881,2023-06-27,201,paneer,210,340,130,1,00103,India
794743,2023-06-27,201,paneer,210,340,130,1,00353,India
231141,2023-06-27,208,sprite,75,100,25,1,00061,India
231141,2023-06-27,211,red bull,90,125,35,1,00061,India
202430,2023-06-27,206,yakult,360,400,40,1,00480,India
202430,2023-06-27,208,sprite,75,100,25,1,00480,India
202430,2023-06-27,205,classic yogurt,45,60,15,1,00480,India
202430,2023-06-27,210,mountain dew,75,100,25,1,00480,India
202430,2023-06-27,201,paneer,210,340,130,1,00480,India
711202,2023-06-27,207,coca cola,75,100,25,1,00085,India
711202,2023-06-27,201,paneer,210,340,130,1,00085,India
711202,2023-06-27,203,mango yogurt,50,60,10,1,00085,India
152616,2023-06-27,210,mountain dew,75,100,25,1,00084,India
152616,2023-06-27,212,amul cheese,250,315,65,1,00084,India
550579,2023-06-27,211,red bull,90,125,35,1,00328,India
139907,2023-06-28,207,coca cola,75,100,25,1,00470,India
139907,2023-06-28,208,sprite,75,100,25,1,00470,India
139907,2023-06-28,212,amul cheese,250,315,65,1,00470,India
199125,2023-06-28,210,mountain dew,75,100,25,1,00475,India
199125,2023-06-28,205,classic yogurt,45,60,15,1,00475,India
199125,2023-06-28,201,paneer,210,340,130,1,00475,India
863452,2023-06-28,211,red bull,90,125,35,1,00038,India
863452,2023-06-28,212,amul cheese,250,315,65,1,00038,India
863452,2023-06-28,208,sprite,75,100,25,1,00038,India
863452,2023-06-28,210,mountain dew,75,100,25,1,00038,India
681707,2023-06-28,209,pepsi,75,100,25,1,00389,India
681707,2023-06-28,207,coca cola,75,100,25,1,00389,India
681707,2023-06-28,204,strawberry yogurt,50,60,10,1,00389,India
302585,2023-06-28,205,classic yogurt,45,60,15,1,00462,India
302585,2023-06-28,201,paneer,210,340,130,1,00462,India
598592,2023-06-28,205,classic yogurt,45,60,15,1,00167,India
709231,2023-06-28,202,milk,12,27,15,1,00022,India
709231,2023-06-28,212,amul cheese,250,315,65,1,00022,India
709231,2023-06-28,204,strawberry yogurt,50,60,10,1,00022,India
669500,2023-06-28,202,milk,12,27,15,1,00140,India
509791,2023-06-28,210,mountain dew,75,100,25,1,00255,India
509791,2023-06-28,205,classic yogurt,45,60,15,1,00255,India
528551,2023-06-28,206,yakult,360,400,40,1,00053,India
528551,2023-06-28,209,pepsi,75,100,25,1,00053,India
528551,2023-06-28,207,coca cola,75,100,25,1,00053,India
147288,2023-06-28,205,classic yogurt,45,60,15,1,00292,India
147288,2023-06-28,202,milk,12,27,15,1,00292,India
878663,2023-06-28,208,sprite,75,100,25,1,00226,India
878663,2023-06-28,210,mountain dew,75,100,25,1,00226,India
878663,2023-06-28,204,strawberry yogurt,50,60,10,1,00226,India
878663,2023-06-28,211,red bull,90,125,35,1,00226,India
146185,2023-06-28,203,mango yogurt,50,60,10,1,00498,India
146185,2023-06-28,213,bisleri,6,15,9,1,00498,India
117124,2023-06-28,207,coca cola,75,100,25,1,00120,India
117124,2023-06-28,201,paneer,210,340,130,1,00120,India
117124,2023-06-28,204,strawberry yogurt,50,60,10,1,00120,India
117124,2023-06-28,209,pepsi,75,100,25,1,00120,India
117124,2023-06-28,213,bisleri,6,15,9,1,00120,India
618061,2023-06-28,202,milk,12,27,15,1,00272,India
618061,2023-06-28,204,strawberry yogurt,50,60,10,1,00272,India
618061,2023-06-28,205,classic yogurt,45,60,15,1,00272,India
618061,2023-06-28,207,coca cola,75,100,25,1,00272,India
618061,2023-06-28,208,sprite,75,100,25,1,00272,India
550884,2023-06-28,211,red bull,90,125,35,1,00499,India
550884,2023-06-28,206,yakult,360,400,40,1,00499,India
338008,2023-06-28,204,strawberry yogurt,50,60,10,1,00157,India
338008,2023-06-28,206,yakult,360,400,40,1,00157,India
338008,2023-06-28,211,red bull,90,125,35,1,00157,India
338008,2023-06-28,207,coca cola,75,100,25,1,00157,India
338008,2023-06-28,201,paneer,210,340,130,1,00157,India
118462,2023-06-28,212,amul cheese,250,315,65,1,00153,India
118462,2023-06-28,208,sprite,75,100,25,1,00153,India
118462,2023-06-28,210,mountain dew,75,100,25,1,00153,India
715836,2023-06-28,209,pepsi,75,100,25,1,00493,India
715836,2023-06-28,201,paneer,210,340,130,1,00493,India
715836,2023-06-28,213,bisleri,6,15,9,1,00493,India
715836,2023-06-28,202,milk,12,27,15,1,00493,India
949177,2023-06-28,203,mango yogurt,50,60,10,1,00418,India
949177,2023-06-28,212,amul cheese,250,315,65,1,00418,India
949177,2023-06-28,209,pepsi,75,100,25,1,00418,India
949177,2023-06-28,201,paneer,210,340,130,1,00418,India
571988,2023-06-28,212,amul cheese,250,315,65,1,00135,India
571988,2023-06-28,211,red bull,90,125,35,1,00135,India
571988,2023-06-28,205,classic yogurt,45,60,15,1,00135,India
571988,2023-06-28,204,strawberry yogurt,50,60,10,1,00135,India
571988,2023-06-28,208,sprite,75,100,25,1,00135,India
332479,2023-06-28,212,amul cheese,250,315,65,1,00430,India
955372,2023-06-28,210,mountain dew,75,100,25,1,00327,India
391682,2023-06-28,212,amul cheese,250,315,65,1,00140,India
391682,2023-06-28,204,strawberry yogurt,50,60,10,1,00140,India
391682,2023-06-28,208,sprite,75,100,25,1,00140,India
938358,2023-06-28,204,strawberry yogurt,50,60,10,1,00133,India
938358,2023-06-28,211,red bull,90,125,35,1,00133,India
573257,2023-06-28,210,mountain dew,75,100,25,1,00262,India
573257,2023-06-28,212,amul cheese,250,315,65,1,00262,India
921438,2023-06-28,207,coca cola,75,100,25,1,00420,India
538907,2023-06-28,203,mango yogurt,50,60,10,1,00082,India
538907,2023-06-28,210,mountain dew,75,100,25,1,00082,India
837756,2023-06-28,207,coca cola,75,100,25,1,00187,India
837756,2023-06-28,209,pepsi,75,100,25,1,00187,India
837756,2023-06-28,203,mango yogurt,50,60,10,1,00187,India
146576,2023-06-28,204,strawberry yogurt,50,60,10,1,00234,India
146576,2023-06-28,208,sprite,75,100,25,1,00234,India
146576,2023-06-28,201,paneer,210,340,130,1,00234,India
146576,2023-06-28,212,amul cheese,250,315,65,1,00234,India
146576,2023-06-28,205,classic yogurt,45,60,15,1,00234,India
840657,2023-06-28,211,red bull,90,125,35,1,00445,India
840657,2023-06-28,202,milk,12,27,15,1,00445,India
840657,2023-06-28,213,bisleri,6,15,9,1,00445,India
934702,2023-06-28,210,mountain dew,75,100,25,1,00015,India
934702,2023-06-28,209,pepsi,75,100,25,1,00015,India
934702,2023-06-28,203,mango yogurt,50,60,10,1,00015,India
934702,2023-06-28,213,bisleri,6,15,9,1,00015,India
702562,2023-06-28,205,classic yogurt,45,60,15,1,00045,India
702562,2023-06-28,212,amul cheese,250,315,65,1,00045,India
702562,2023-06-28,213,bisleri,6,15,9,1,00045,India
702562,2023-06-28,204,strawberry yogurt,50,60,10,1,00045,India
737840,2023-06-28,211,red bull,90,125,35,1,00296,India
737840,2023-06-28,208,sprite,75,100,25,1,00296,India
737840,2023-06-28,212,amul cheese,250,315,65,1,00296,India
970359,2023-06-28,213,bisleri,6,15,9,1,00137,India
970359,2023-06-28,201,paneer,210,340,130,1,00137,India
970359,2023-06-28,211,red bull,90,125,35,1,00137,India
970359,2023-06-28,203,mango yogurt,50,60,10,1,00137,India
647374,2023-06-28,204,strawberry yogurt,50,60,10,1,00494,India
734843,2023-06-28,210,mountain dew,75,100,25,1,00428,India
734843,2023-06-28,207,coca cola,75,100,25,1,00428,India
734843,2023-06-28,205,classic yogurt,45,60,15,1,00428,India
151135,2023-06-28,212,amul cheese,250,315,65,1,00163,India
151135,2023-06-28,209,pepsi,75,100,25,1,00163,India
151135,2023-06-28,201,paneer,210,340,130,1,00163,India
151135,2023-06-28,203,mango yogurt,50,60,10,1,00163,India
140009,2023-06-28,209,pepsi,75,100,25,1,00216,India
140009,2023-06-28,213,bisleri,6,15,9,1,00216,India
898548,2023-06-28,202,milk,12,27,15,1,00364,India
898548,2023-06-28,209,pepsi,75,100,25,1,00364,India
898548,2023-06-28,212,amul cheese,250,315,65,1,00364,India
958696,2023-06-28,213,bisleri,6,15,9,1,00313,India
958696,2023-06-28,208,sprite,75,100,25,1,00313,India
958696,2023-06-28,211,red bull,90,125,35,1,00313,India
958696,2023-06-28,203,mango yogurt,50,60,10,1,00313,India
958696,2023-06-28,209,pepsi,75,100,25,1,00313,India
698939,2023-06-28,206,yakult,360,400,40,1,00459,India
746167,2023-06-28,206,yakult,360,400,40,1,00197,India
746167,2023-06-28,204,strawberry yogurt,50,60,10,1,00197,India
746167,2023-06-28,213,bisleri,6,15,9,1,00197,India
495602,2023-06-28,205,classic yogurt,45,60,15,1,00490,India
495602,2023-06-28,208,sprite,75,100,25,1,00490,India
495602,2023-06-28,204,strawberry yogurt,50,60,10,1,00490,India
700847,2023-06-28,203,mango yogurt,50,60,10,1,00295,India
140637,2023-06-28,210,mountain dew,75,100,25,1,00121,India
609501,2023-06-28,209,pepsi,75,100,25,1,00013,India
609501,2023-06-28,203,mango yogurt,50,60,10,1,00013,India
609501,2023-06-28,210,mountain dew,75,100,25,1,00013,India
840457,2023-06-28,209,pepsi,75,100,25,1,00158,India
840457,2023-06-28,213,bisleri,6,15,9,1,00158,India
840457,2023-06-28,206,yakult,360,400,40,1,00158,India
825143,2023-06-28,205,classic yogurt,45,60,15,1,00391,India
825143,2023-06-28,209,pepsi,75,100,25,1,00391,India
825143,2023-06-28,207,coca cola,75,100,25,1,00391,India
825143,2023-06-28,203,mango yogurt,50,60,10,1,00391,India
790018,2023-06-28,213,bisleri,6,15,9,1,00499,India
790018,2023-06-28,208,sprite,75,100,25,1,00499,India
302987,2023-06-28,202,milk,12,27,15,1,00177,India
228665,2023-06-28,201,paneer,210,340,130,1,00417,India
228665,2023-06-28,210,mountain dew,75,100,25,1,00417,India
228665,2023-06-28,204,strawberry yogurt,50,60,10,1,00417,India
228665,2023-06-28,202,milk,12,27,15,1,00417,India
433252,2023-06-28,206,yakult,360,400,40,1,00191,India
433252,2023-06-28,209,pepsi,75,100,25,1,00191,India
494016,2023-06-28,207,coca cola,75,100,25,1,00151,India
571971,2023-06-28,205,classic yogurt,45,60,15,1,00371,India
571971,2023-06-28,208,sprite,75,100,25,1,00371,India
571971,2023-06-28,210,mountain dew,75,100,25,1,00371,India
571971,2023-06-28,202,milk,12,27,15,1,00371,India
498047,2023-06-28,208,sprite,75,100,25,1,00322,India
597040,2023-06-28,209,pepsi,75,100,25,1,00305,India
274316,2023-06-28,212,amul cheese,250,315,65,1,00069,India
274316,2023-06-28,207,coca cola,75,100,25,1,00069,India
294411,2023-06-28,202,milk,12,27,15,1,00304,India
294411,2023-06-28,204,strawberry yogurt,50,60,10,1,00304,India
294411,2023-06-28,211,red bull,90,125,35,1,00304,India
620380,2023-06-28,211,red bull,90,125,35,1,00273,India
620380,2023-06-28,202,milk,12,27,15,1,00273,India
620380,2023-06-28,205,classic yogurt,45,60,15,1,00273,India
713822,2023-06-28,204,strawberry yogurt,50,60,10,1,00151,India
713822,2023-06-28,207,coca cola,75,100,25,1,00151,India
713822,2023-06-28,209,pepsi,75,100,25,1,00151,India
873419,2023-06-28,205,classic yogurt,45,60,15,1,00178,India
873419,2023-06-28,209,pepsi,75,100,25,1,00178,India
873419,2023-06-28,211,red bull,90,125,35,1,00178,India
873419,2023-06-28,204,strawberry yogurt,50,60,10,1,00178,India
245706,2023-06-28,208,sprite,75,100,25,1,00243,India
245706,2023-06-28,204,strawberry yogurt,50,60,10,1,00243,India
245706,2023-06-28,213,bisleri,6,15,9,1,00243,India
113852,2023-06-28,212,amul cheese,250,315,65,1,00043,India
113852,2023-06-28,209,pepsi,75,100,25,1,00043,India
113852,2023-06-28,213,bisleri,6,15,9,1,00043,India
113852,2023-06-28,202,milk,12,27,15,1,00043,India
724003,2023-06-28,212,amul cheese,250,315,65,1,00003,India
423492,2023-06-28,204,strawberry yogurt,50,60,10,1,00200,India
423492,2023-06-28,209,pepsi,75,100,25,1,00200,India
423492,2023-06-28,205,classic yogurt,45,60,15,1,00200,India
423492,2023-06-28,213,bisleri,6,15,9,1,00200,India
423492,2023-06-28,206,yakult,360,400,40,1,00200,India
753588,2023-06-28,208,sprite,75,100,25,1,00228,India
753588,2023-06-28,205,classic yogurt,45,60,15,1,00228,India
753588,2023-06-28,213,bisleri,6,15,9,1,00228,India
753588,2023-06-28,201,paneer,210,340,130,1,00228,India
620269,2023-06-28,204,strawberry yogurt,50,60,10,1,00290,India
620269,2023-06-28,213,bisleri,6,15,9,1,00290,India
620269,2023-06-28,205,classic yogurt,45,60,15,1,00290,India
620269,2023-06-28,202,milk,12,27,15,1,00290,India
571093,2023-06-28,207,coca cola,75,100,25,1,00151,India
571093,2023-06-28,213,bisleri,6,15,9,1,00151,India
571093,2023-06-28,209,pepsi,75,100,25,1,00151,India
571093,2023-06-28,204,strawberry yogurt,50,60,10,1,00151,India
596875,2023-06-28,211,red bull,90,125,35,1,00155,India
596875,2023-06-28,208,sprite,75,100,25,1,00155,India
596875,2023-06-28,207,coca cola,75,100,25,1,00155,India
596875,2023-06-28,212,amul cheese,250,315,65,1,00155,India
521034,2023-06-28,213,bisleri,6,15,9,1,00063,India
521034,2023-06-28,206,yakult,360,400,40,1,00063,India
458046,2023-06-28,212,amul cheese,250,315,65,1,00429,India
458046,2023-06-28,206,yakult,360,400,40,1,00429,India
458046,2023-06-28,204,strawberry yogurt,50,60,10,1,00429,India
458046,2023-06-28,210,mountain dew,75,100,25,1,00429,India
458046,2023-06-28,202,milk,12,27,15,1,00429,India
284344,2023-06-28,208,sprite,75,100,25,1,00083,India
284344,2023-06-28,207,coca cola,75,100,25,1,00083,India
442865,2023-06-28,206,yakult,360,400,40,1,00490,India
442865,2023-06-28,208,sprite,75,100,25,1,00490,India
442865,2023-06-28,207,coca cola,75,100,25,1,00490,India
108538,2023-06-28,205,classic yogurt,45,60,15,1,00336,India
108538,2023-06-28,202,milk,12,27,15,1,00336,India
933205,2023-06-28,201,paneer,210,340,130,1,00134,India
933205,2023-06-28,213,bisleri,6,15,9,1,00134,India
933205,2023-06-28,212,amul cheese,250,315,65,1,00134,India
933205,2023-06-28,211,red bull,90,125,35,1,00134,India
993833,2023-06-28,207,coca cola,75,100,25,1,00445,India
993833,2023-06-28,204,strawberry yogurt,50,60,10,1,00445,India
993833,2023-06-28,209,pepsi,75,100,25,1,00445,India
497211,2023-06-28,204,strawberry yogurt,50,60,10,1,00150,India
497211,2023-06-28,205,classic yogurt,45,60,15,1,00150,India
386415,2023-06-28,208,sprite,75,100,25,1,00191,India
400481,2023-06-28,201,paneer,210,340,130,1,00018,India
400481,2023-06-28,205,classic yogurt,45,60,15,1,00018,India
400481,2023-06-28,206,yakult,360,400,40,1,00018,India
598863,2023-06-28,204,strawberry yogurt,50,60,10,1,00321,India
598863,2023-06-28,209,pepsi,75,100,25,1,00321,India
598863,2023-06-28,205,classic yogurt,45,60,15,1,00321,India
598863,2023-06-28,211,red bull,90,125,35,1,00321,India
575775,2023-06-28,207,coca cola,75,100,25,1,00049,India
716447,2023-06-28,202,milk,12,27,15,1,00128,India
716447,2023-06-28,205,classic yogurt,45,60,15,1,00128,India
716447,2023-06-28,206,yakult,360,400,40,1,00128,India
716447,2023-06-28,201,paneer,210,340,130,1,00128,India
405245,2023-06-28,208,sprite,75,100,25,1,00459,India
569819,2023-06-28,213,bisleri,6,15,9,1,00428,India
569819,2023-06-28,202,milk,12,27,15,1,00428,India
233642,2023-06-28,203,mango yogurt,50,60,10,1,00387,India
609430,2023-06-28,201,paneer,210,340,130,1,00095,India
609430,2023-06-28,208,sprite,75,100,25,1,00095,India
213078,2023-06-28,201,paneer,210,340,130,1,00149,India
716447,2023-06-29,202,milk,12,27,15,1,00128,India
716447,2023-06-29,211,red bull,90,125,35,1,00128,India
716447,2023-06-29,206,yakult,360,400,40,1,00128,India
221448,2023-06-29,203,mango yogurt,50,60,10,1,00091,India
221448,2023-06-29,202,milk,12,27,15,1,00091,India
221448,2023-06-29,211,red bull,90,125,35,1,00091,India
221448,2023-06-29,205,classic yogurt,45,60,15,1,00091,India
682796,2023-06-29,204,strawberry yogurt,50,60,10,1,00453,India
682796,2023-06-29,209,pepsi,75,100,25,1,00453,India
304821,2023-06-29,209,pepsi,75,100,25,1,00166,India
631284,2023-06-29,204,strawberry yogurt,50,60,10,1,00434,India
404623,2023-06-29,211,red bull,90,125,35,1,00113,India
404623,2023-06-29,204,strawberry yogurt,50,60,10,1,00113,India
404623,2023-06-29,212,amul cheese,250,315,65,1,00113,India
404623,2023-06-29,205,classic yogurt,45,60,15,1,00113,India
607868,2023-06-29,205,classic yogurt,45,60,15,1,00452,India
607868,2023-06-29,208,sprite,75,100,25,1,00452,India
607868,2023-06-29,212,amul cheese,250,315,65,1,00452,India
250057,2023-06-29,201,paneer,210,340,130,1,00410,India
250057,2023-06-29,212,amul cheese,250,315,65,1,00410,India
250057,2023-06-29,206,yakult,360,400,40,1,00410,India
250057,2023-06-29,209,pepsi,75,100,25,1,00410,India
314296,2023-06-29,211,red bull,90,125,35,1,00078,India
314296,2023-06-29,201,paneer,210,340,130,1,00078,India
314296,2023-06-29,202,milk,12,27,15,1,00078,India
314296,2023-06-29,208,sprite,75,100,25,1,00078,India
314296,2023-06-29,205,classic yogurt,45,60,15,1,00078,India
907361,2023-06-29,210,mountain dew,75,100,25,1,00350,India
907361,2023-06-29,203,mango yogurt,50,60,10,1,00350,India
907361,2023-06-29,202,milk,12,27,15,1,00350,India
367986,2023-06-29,211,red bull,90,125,35,1,00239,India
367986,2023-06-29,212,amul cheese,250,315,65,1,00239,India
367986,2023-06-29,205,classic yogurt,45,60,15,1,00239,India
367986,2023-06-29,213,bisleri,6,15,9,1,00239,India
314243,2023-06-29,209,pepsi,75,100,25,1,00381,India
314243,2023-06-29,207,coca cola,75,100,25,1,00381,India
314243,2023-06-29,201,paneer,210,340,130,1,00381,India
314243,2023-06-29,208,sprite,75,100,25,1,00381,India
314243,2023-06-29,212,amul cheese,250,315,65,1,00381,India
405642,2023-06-29,206,yakult,360,400,40,1,00471,India
405642,2023-06-29,204,strawberry yogurt,50,60,10,1,00471,India
405642,2023-06-29,213,bisleri,6,15,9,1,00471,India
405642,2023-06-29,202,milk,12,27,15,1,00471,India
562717,2023-06-29,206,yakult,360,400,40,1,00471,India
601741,2023-06-29,210,mountain dew,75,100,25,1,00342,India
601741,2023-06-29,203,mango yogurt,50,60,10,1,00342,India
601741,2023-06-29,213,bisleri,6,15,9,1,00342,India
601741,2023-06-29,206,yakult,360,400,40,1,00342,India
110892,2023-06-29,210,mountain dew,75,100,25,1,00056,India
553444,2023-06-29,213,bisleri,6,15,9,1,00287,India
553444,2023-06-29,211,red bull,90,125,35,1,00287,India
553444,2023-06-29,208,sprite,75,100,25,1,00287,India
553444,2023-06-29,212,amul cheese,250,315,65,1,00287,India
740551,2023-06-29,206,yakult,360,400,40,1,00292,India
740551,2023-06-29,201,paneer,210,340,130,1,00292,India
182181,2023-06-29,212,amul cheese,250,315,65,1,00160,India
182181,2023-06-29,202,milk,12,27,15,1,00160,India
182181,2023-06-29,209,pepsi,75,100,25,1,00160,India
182181,2023-06-29,205,classic yogurt,45,60,15,1,00160,India
465012,2023-06-29,202,milk,12,27,15,1,00454,India
161227,2023-06-29,202,milk,12,27,15,1,00028,India
928220,2023-06-29,211,red bull,90,125,35,1,00114,India
928220,2023-06-29,213,bisleri,6,15,9,1,00114,India
928220,2023-06-29,207,coca cola,75,100,25,1,00114,India
155033,2023-06-29,201,paneer,210,340,130,1,00005,India
155033,2023-06-29,205,classic yogurt,45,60,15,1,00005,India
155033,2023-06-29,210,mountain dew,75,100,25,1,00005,India
191889,2023-06-29,209,pepsi,75,100,25,1,00391,India
191889,2023-06-29,204,strawberry yogurt,50,60,10,1,00391,India
475414,2023-06-29,206,yakult,360,400,40,1,00235,India
475414,2023-06-29,208,sprite,75,100,25,1,00235,India
475414,2023-06-29,203,mango yogurt,50,60,10,1,00235,India
475414,2023-06-29,210,mountain dew,75,100,25,1,00235,India
291631,2023-06-29,202,milk,12,27,15,1,00200,India
362253,2023-06-29,204,strawberry yogurt,50,60,10,1,00362,India
362253,2023-06-29,205,classic yogurt,45,60,15,1,00362,India
931829,2023-06-29,210,mountain dew,75,100,25,1,00209,India
931829,2023-06-29,201,paneer,210,340,130,1,00209,India
931829,2023-06-29,211,red bull,90,125,35,1,00209,India
931829,2023-06-29,205,classic yogurt,45,60,15,1,00209,India
931829,2023-06-29,204,strawberry yogurt,50,60,10,1,00209,India
724166,2023-06-29,204,strawberry yogurt,50,60,10,1,00122,India
724166,2023-06-29,203,mango yogurt,50,60,10,1,00122,India
724166,2023-06-29,210,mountain dew,75,100,25,1,00122,India
860298,2023-06-29,212,amul cheese,250,315,65,1,00427,India
860298,2023-06-29,202,milk,12,27,15,1,00427,India
995846,2023-06-29,203,mango yogurt,50,60,10,1,00277,India
862986,2023-06-29,210,mountain dew,75,100,25,1,00424,India
862986,2023-06-29,207,coca cola,75,100,25,1,00424,India
862986,2023-06-29,202,milk,12,27,15,1,00424,India
257083,2023-06-29,207,coca cola,75,100,25,1,00005,India
447426,2023-06-29,206,yakult,360,400,40,1,00448,India
447426,2023-06-29,210,mountain dew,75,100,25,1,00448,India
447426,2023-06-29,213,bisleri,6,15,9,1,00448,India
447426,2023-06-29,212,amul cheese,250,315,65,1,00448,India
447426,2023-06-29,204,strawberry yogurt,50,60,10,1,00448,India
878907,2023-06-29,210,mountain dew,75,100,25,1,00459,India
878907,2023-06-29,209,pepsi,75,100,25,1,00459,India
241045,2023-06-29,204,strawberry yogurt,50,60,10,1,00081,India
241045,2023-06-29,210,mountain dew,75,100,25,1,00081,India
241045,2023-06-29,202,milk,12,27,15,1,00081,India
631670,2023-06-29,207,coca cola,75,100,25,1,00247,India
288109,2023-06-29,211,red bull,90,125,35,1,00043,India
288109,2023-06-29,205,classic yogurt,45,60,15,1,00043,India
672048,2023-06-29,210,mountain dew,75,100,25,1,00084,India
672048,2023-06-29,209,pepsi,75,100,25,1,00084,India
672048,2023-06-29,203,mango yogurt,50,60,10,1,00084,India
672048,2023-06-29,206,yakult,360,400,40,1,00084,India
954376,2023-06-29,207,coca cola,75,100,25,1,00149,India
954376,2023-06-29,208,sprite,75,100,25,1,00149,India
954376,2023-06-29,202,milk,12,27,15,1,00149,India
714746,2023-06-29,208,sprite,75,100,25,1,00027,India
416059,2023-06-29,210,mountain dew,75,100,25,1,00216,India
416059,2023-06-29,209,pepsi,75,100,25,1,00216,India
416059,2023-06-29,207,coca cola,75,100,25,1,00216,India
638243,2023-06-29,210,mountain dew,75,100,25,1,00453,India
638243,2023-06-29,209,pepsi,75,100,25,1,00453,India
638243,2023-06-29,203,mango yogurt,50,60,10,1,00453,India
373009,2023-06-29,205,classic yogurt,45,60,15,1,00150,India
373009,2023-06-29,211,red bull,90,125,35,1,00150,India
545729,2023-06-29,203,mango yogurt,50,60,10,1,00492,India
545729,2023-06-29,212,amul cheese,250,315,65,1,00492,India
517292,2023-06-29,203,mango yogurt,50,60,10,1,00263,India
517292,2023-06-29,206,yakult,360,400,40,1,00263,India
970007,2023-06-29,209,pepsi,75,100,25,1,00250,India
396398,2023-06-29,211,red bull,90,125,35,1,00173,India
396398,2023-06-29,202,milk,12,27,15,1,00173,India
396398,2023-06-29,207,coca cola,75,100,25,1,00173,India
396398,2023-06-29,203,mango yogurt,50,60,10,1,00173,India
834718,2023-06-29,210,mountain dew,75,100,25,1,00156,India
834718,2023-06-29,202,milk,12,27,15,1,00156,India
834718,2023-06-29,208,sprite,75,100,25,1,00156,India
979080,2023-06-29,206,yakult,360,400,40,1,00293,India
461428,2023-06-29,206,yakult,360,400,40,1,00308,India
658718,2023-06-29,212,amul cheese,250,315,65,1,00423,India
658718,2023-06-29,203,mango yogurt,50,60,10,1,00423,India
658718,2023-06-29,210,mountain dew,75,100,25,1,00423,India
658718,2023-06-29,205,classic yogurt,45,60,15,1,00423,India
279826,2023-06-29,212,amul cheese,250,315,65,1,00264,India
712649,2023-06-30,206,yakult,360,400,40,1,00444,India
712649,2023-06-30,210,mountain dew,75,100,25,1,00444,India
712649,2023-06-30,202,milk,12,27,15,1,00444,India
712649,2023-06-30,203,mango yogurt,50,60,10,1,00444,India
682443,2023-06-30,203,mango yogurt,50,60,10,1,00302,India
682443,2023-06-30,202,milk,12,27,15,1,00302,India
682443,2023-06-30,212,amul cheese,250,315,65,1,00302,India
281394,2023-06-30,213,bisleri,6,15,9,1,00054,India
281394,2023-06-30,207,coca cola,75,100,25,1,00054,India
281394,2023-06-30,206,yakult,360,400,40,1,00054,India
417833,2023-06-30,203,mango yogurt,50,60,10,1,00318,India
417833,2023-06-30,210,mountain dew,75,100,25,1,00318,India
417833,2023-06-30,211,red bull,90,125,35,1,00318,India
585466,2023-06-30,211,red bull,90,125,35,1,00363,India
585466,2023-06-30,201,paneer,210,340,130,1,00363,India
585466,2023-06-30,205,classic yogurt,45,60,15,1,00363,India
585466,2023-06-30,210,mountain dew,75,100,25,1,00363,India
949169,2023-06-30,201,paneer,210,340,130,1,00416,India
949169,2023-06-30,206,yakult,360,400,40,1,00416,India
949169,2023-06-30,204,strawberry yogurt,50,60,10,1,00416,India
481485,2023-06-30,210,mountain dew,75,100,25,1,00393,India
481485,2023-06-30,207,coca cola,75,100,25,1,00393,India
481485,2023-06-30,205,classic yogurt,45,60,15,1,00393,India
786515,2023-06-30,206,yakult,360,400,40,1,00144,India
786515,2023-06-30,201,paneer,210,340,130,1,00144,India
337281,2023-06-30,209,pepsi,75,100,25,1,00182,India
337281,2023-06-30,213,bisleri,6,15,9,1,00182,India
337281,2023-06-30,203,mango yogurt,50,60,10,1,00182,India
563553,2023-06-30,207,coca cola,75,100,25,1,00112,India
563553,2023-06-30,205,classic yogurt,45,60,15,1,00112,India
563553,2023-06-30,210,mountain dew,75,100,25,1,00112,India
563553,2023-06-30,211,red bull,90,125,35,1,00112,India
563553,2023-06-30,212,amul cheese,250,315,65,1,00112,India
822478,2023-06-30,203,mango yogurt,50,60,10,1,00481,India
822478,2023-06-30,211,red bull,90,125,35,1,00481,India
822478,2023-06-30,207,coca cola,75,100,25,1,00481,India
822478,2023-06-30,201,paneer,210,340,130,1,00481,India
115685,2023-06-30,205,classic yogurt,45,60,15,1,00154,India
115685,2023-06-30,210,mountain dew,75,100,25,1,00154,India
593590,2023-06-30,207,coca cola,75,100,25,1,00046,India
197236,2023-06-30,201,paneer,210,340,130,1,00178,India
294485,2023-06-30,201,paneer,210,340,130,1,00279,India
294485,2023-06-30,211,red bull,90,125,35,1,00279,India
592548,2023-06-30,213,bisleri,6,15,9,1,00433,India
592548,2023-06-30,206,yakult,360,400,40,1,00433,India
592548,2023-06-30,207,coca cola,75,100,25,1,00433,India
817077,2023-06-30,207,coca cola,75,100,25,1,00294,India
817077,2023-06-30,201,paneer,210,340,130,1,00294,India
817077,2023-06-30,204,strawberry yogurt,50,60,10,1,00294,India
817077,2023-06-30,208,sprite,75,100,25,1,00294,India
504122,2023-06-30,204,strawberry yogurt,50,60,10,1,00350,India
657832,2023-06-30,205,classic yogurt,45,60,15,1,00412,India
721373,2023-06-30,213,bisleri,6,15,9,1,00487,India
721373,2023-06-30,210,mountain dew,75,100,25,1,00487,India
418736,2023-06-30,208,sprite,75,100,25,1,00200,India
131095,2023-06-30,204,strawberry yogurt,50,60,10,1,00115,India
545572,2023-06-30,207,coca cola,75,100,25,1,00126,India
279832,2023-06-30,210,mountain dew,75,100,25,1,00395,India
373534,2023-06-30,209,pepsi,75,100,25,1,00011,India
373534,2023-06-30,205,classic yogurt,45,60,15,1,00011,India
373534,2023-06-30,213,bisleri,6,15,9,1,00011,India
373534,2023-06-30,207,coca cola,75,100,25,1,00011,India
787964,2023-06-30,213,bisleri,6,15,9,1,00456,India
263814,2023-06-30,203,mango yogurt,50,60,10,1,00019,India
263814,2023-06-30,213,bisleri,6,15,9,1,00019,India
263814,2023-06-30,211,red bull,90,125,35,1,00019,India
316279,2023-06-30,207,coca cola,75,100,25,1,00329,India
316279,2023-06-30,201,paneer,210,340,130,1,00329,India
316279,2023-06-30,213,bisleri,6,15,9,1,00329,India
411393,2023-06-30,206,yakult,360,400,40,1,00392,India
411393,2023-06-30,211,red bull,90,125,35,1,00392,India
329803,2023-06-30,204,strawberry yogurt,50,60,10,1,00046,India
329803,2023-06-30,202,milk,12,27,15,1,00046,India
329803,2023-06-30,208,sprite,75,100,25,1,00046,India
329803,2023-06-30,209,pepsi,75,100,25,1,00046,India
222991,2023-06-30,201,paneer,210,340,130,1,00265,India
222991,2023-06-30,203,mango yogurt,50,60,10,1,00265,India
222991,2023-06-30,210,mountain dew,75,100,25,1,00265,India
222991,2023-06-30,206,yakult,360,400,40,1,00265,India
323272,2023-06-30,211,red bull,90,125,35,1,00262,India
323272,2023-06-30,209,pepsi,75,100,25,1,00262,India
323272,2023-06-30,205,classic yogurt,45,60,15,1,00262,India
323272,2023-06-30,208,sprite,75,100,25,1,00262,India
561626,2023-06-30,213,bisleri,6,15,9,1,00251,India
561626,2023-06-30,210,mountain dew,75,100,25,1,00251,India
589834,2023-06-30,211,red bull,90,125,35,1,00327,India
589834,2023-06-30,203,mango yogurt,50,60,10,1,00327,India
589834,2023-06-30,201,paneer,210,340,130,1,00327,India
757376,2023-06-30,210,mountain dew,75,100,25,1,00241,India
757376,2023-06-30,205,classic yogurt,45,60,15,1,00241,India
757376,2023-06-30,206,yakult,360,400,40,1,00241,India
652723,2023-06-30,208,sprite,75,100,25,1,00009,India
706914,2023-06-30,209,pepsi,75,100,25,1,00088,India
706914,2023-06-30,201,paneer,210,340,130,1,00088,India
706914,2023-06-30,210,mountain dew,75,100,25,1,00088,India
631431,2023-06-30,201,paneer,210,340,130,1,00295,India
631431,2023-06-30,211,red bull,90,125,35,1,00295,India
631431,2023-06-30,208,sprite,75,100,25,1,00295,India
672514,2023-06-30,211,red bull,90,125,35,1,00327,India
672514,2023-06-30,213,bisleri,6,15,9,1,00327,India
672514,2023-06-30,204,strawberry yogurt,50,60,10,1,00327,India
672514,2023-06-30,207,coca cola,75,100,25,1,00327,India
520195,2023-06-30,207,coca cola,75,100,25,1,00329,India
965475,2023-06-30,203,mango yogurt,50,60,10,1,00114,India
965475,2023-06-30,204,strawberry yogurt,50,60,10,1,00114,India
829763,2023-06-30,213,bisleri,6,15,9,1,00221,India
829763,2023-06-30,208,sprite,75,100,25,1,00221,India
881019,2023-06-30,201,paneer,210,340,130,1,00109,India
881019,2023-06-30,210,mountain dew,75,100,25,1,00109,India
488615,2023-06-30,211,red bull,90,125,35,1,00269,India
552452,2023-06-30,212,amul cheese,250,315,65,1,00468,India
552452,2023-06-30,210,mountain dew,75,100,25,1,00468,India
552452,2023-06-30,203,mango yogurt,50,60,10,1,00468,India
552452,2023-06-30,205,classic yogurt,45,60,15,1,00468,India
424308,2023-06-30,205,classic yogurt,45,60,15,1,00454,India
424308,2023-06-30,212,amul cheese,250,315,65,1,00454,India
424308,2023-06-30,209,pepsi,75,100,25,1,00454,India
424308,2023-06-30,203,mango yogurt,50,60,10,1,00454,India
279530,2023-06-30,212,amul cheese,250,315,65,1,00417,India
103239,2023-06-30,203,mango yogurt,50,60,10,1,00368,India
285128,2023-06-30,208,sprite,75,100,25,1,00426,India
285128,2023-06-30,204,strawberry yogurt,50,60,10,1,00426,India
285128,2023-06-30,201,paneer,210,340,130,1,00426,India
285128,2023-06-30,209,pepsi,75,100,25,1,00426,India
285128,2023-06-30,213,bisleri,6,15,9,1,00426,India
764805,2023-06-30,205,classic yogurt,45,60,15,1,00367,India
843082,2023-06-30,201,paneer,210,340,130,1,00100,India
843082,2023-06-30,210,mountain dew,75,100,25,1,00100,India
843082,2023-06-30,208,sprite,75,100,25,1,00100,India
843082,2023-06-30,211,red bull,90,125,35,1,00100,India
865854,2023-06-30,202,milk,12,27,15,1,00482,India
865854,2023-06-30,207,coca cola,75,100,25,1,00482,India
865854,2023-06-30,205,classic yogurt,45,60,15,1,00482,India
255901,2023-06-30,203,mango yogurt,50,60,10,1,00089,India
255901,2023-06-30,209,pepsi,75,100,25,1,00089,India
994423,2023-06-30,213,bisleri,6,15,9,1,00191,India
279234,2023-06-30,203,mango yogurt,50,60,10,1,00465,India
994363,2023-06-30,207,coca cola,75,100,25,1,00457,India
994363,2023-06-30,213,bisleri,6,15,9,1,00457,India
305743,2023-06-30,213,bisleri,6,15,9,1,00094,India
305743,2023-06-30,207,coca cola,75,100,25,1,00094,India
781177,2023-06-30,213,bisleri,6,15,9,1,00426,India
781177,2023-06-30,202,milk,12,27,15,1,00426,India
781177,2023-06-30,201,paneer,210,340,130,1,00426,India
633142,2023-06-30,203,mango yogurt,50,60,10,1,00172,India
633142,2023-06-30,202,milk,12,27,15,1,00172,India
633142,2023-06-30,213,bisleri,6,15,9,1,00172,India
220236,2023-06-30,211,red bull,90,125,35,1,00239,India
220236,2023-06-30,203,mango yogurt,50,60,10,1,00239,India
733552,2023-06-30,201,paneer,210,340,130,1,00236,India
733552,2023-06-30,204,strawberry yogurt,50,60,10,1,00236,India
733552,2023-06-30,209,pepsi,75,100,25,1,00236,India
579347,2023-06-30,213,bisleri,6,15,9,1,00295,India
447110,2023-06-30,208,sprite,75,100,25,1,00299,India
927221,2023-06-30,202,milk,12,27,15,1,00446,India
927221,2023-06-30,208,sprite,75,100,25,1,00446,India
927221,2023-06-30,205,classic yogurt,45,60,15,1,00446,India
927221,2023-06-30,204,strawberry yogurt,50,60,10,1,00446,India
927221,2023-06-30,209,pepsi,75,100,25,1,00446,India
818405,2023-06-30,207,coca cola,75,100,25,1,00169,India
818405,2023-06-30,206,yakult,360,400,40,1,00169,India
818405,2023-06-30,201,paneer,210,340,130,1,00169,India
818405,2023-06-30,212,amul cheese,250,315,65,1,00169,India
195235,2023-06-30,213,bisleri,6,15,9,1,00082,India
195235,2023-06-30,207,coca cola,75,100,25,1,00082,India
195235,2023-06-30,209,pepsi,75,100,25,1,00082,India
195235,2023-06-30,205,classic yogurt,45,60,15,1,00082,India
375362,2023-06-30,201,paneer,210,340,130,1,00500,India
375362,2023-06-30,203,mango yogurt,50,60,10,1,00500,India
375362,2023-06-30,205,classic yogurt,45,60,15,1,00500,India
387491,2023-06-30,208,sprite,75,100,25,1,00051,India
387491,2023-06-30,212,amul cheese,250,315,65,1,00051,India
387491,2023-06-30,209,pepsi,75,100,25,1,00051,India
344947,2023-06-30,207,coca cola,75,100,25,1,00196,India
919589,2023-06-30,211,red bull,90,125,35,1,00335,India
919589,2023-06-30,205,classic yogurt,45,60,15,1,00335,India
919589,2023-06-30,212,amul cheese,250,315,65,1,00335,India
919589,2023-06-30,204,strawberry yogurt,50,60,10,1,00335,India
289761,2023-06-30,206,yakult,360,400,40,1,00220,India
289761,2023-06-30,202,milk,12,27,15,1,00220,India
652718,2023-06-30,212,amul cheese,250,315,65,1,00432,India
652718,2023-06-30,204,strawberry yogurt,50,60,10,1,00432,India
652718,2023-06-30,203,mango yogurt,50,60,10,1,00432,India
652718,2023-06-30,211,red bull,90,125,35,1,00432,India
652718,2023-06-30,201,paneer,210,340,130,1,00432,India
119792,2023-06-30,206,yakult,360,400,40,1,00415,India
119792,2023-06-30,212,amul cheese,250,315,65,1,00415,India
119792,2023-06-30,201,paneer,210,340,130,1,00415,India
119792,2023-06-30,202,milk,12,27,15,1,00415,India
862960,2023-06-30,203,mango yogurt,50,60,10,1,00326,India
590656,2023-06-30,205,classic yogurt,45,60,15,1,00437,India
578676,2023-06-30,207,coca cola,75,100,25,1,00229,India
578676,2023-06-30,202,milk,12,27,15,1,00229,India
578676,2023-06-30,210,mountain dew,75,100,25,1,00229,India
663177,2023-06-30,213,bisleri,6,15,9,1,00219,India
809951,2023-06-30,210,mountain dew,75,100,25,1,00389,India
809951,2023-06-30,212,amul cheese,250,315,65,1,00389,India
531072,2023-06-30,207,coca cola,75,100,25,1,00080,India
531072,2023-06-30,211,red bull,90,125,35,1,00080,India
304391,2023-06-30,206,yakult,360,400,40,1,00007,India
304391,2023-06-30,213,bisleri,6,15,9,1,00007,India
304391,2023-06-30,209,pepsi,75,100,25,1,00007,India
304391,2023-06-30,203,mango yogurt,50,60,10,1,00007,India
597265,2023-06-30,208,sprite,75,100,25,1,00362,India
377602,2023-06-30,205,classic yogurt,45,60,15,1,00460,India
369398,2023-06-30,213,bisleri,6,15,9,1,00093,India
369398,2023-06-30,208,sprite,75,100,25,1,00093,India
369398,2023-06-30,211,red bull,90,125,35,1,00093,India
369398,2023-06-30,204,strawberry yogurt,50,60,10,1,00093,India
657389,2023-06-30,201,paneer,210,340,130,1,00448,India
657389,2023-06-30,213,bisleri,6,15,9,1,00448,India
657389,2023-06-30,206,yakult,360,400,40,1,00448,India
176067,2023-06-30,210,mountain dew,75,100,25,1,00412,India
176067,2023-06-30,203,mango yogurt,50,60,10,1,00412,India
176067,2023-06-30,201,paneer,210,340,130,1,00412,India
267472,2023-06-30,208,sprite,75,100,25,1,00015,India
267472,2023-06-30,201,paneer,210,340,130,1,00015,India
267472,2023-06-30,213,bisleri,6,15,9,1,00015,India
267472,2023-06-30,206,yakult,360,400,40,1,00015,India
765305,2023-06-30,207,coca cola,75,100,25,1,00128,India
765305,2023-06-30,201,paneer,210,340,130,1,00128,India
765305,2023-06-30,204,strawberry yogurt,50,60,10,1,00128,India
437362,2023-06-30,213,bisleri,6,15,9,1,00360,India
437362,2023-06-30,211,red bull,90,125,35,1,00360,India
437362,2023-06-30,209,pepsi,75,100,25,1,00360,India
767911,2023-06-30,207,coca cola,75,100,25,1,00476,India
767911,2023-06-30,211,red bull,90,125,35,1,00476,India
767911,2023-06-30,210,mountain dew,75,100,25,1,00476,India
881745,2023-06-30,208,sprite,75,100,25,1,00081,India
946193,2023-06-30,205,classic yogurt,45,60,15,1,00108,India
946193,2023-06-30,202,milk,12,27,15,1,00108,India
873013,2023-06-30,213,bisleri,6,15,9,1,00400,India
873013,2023-06-30,211,red bull,90,125,35,1,00400,India
873013,2023-06-30,207,coca cola,75,100,25,1,00400,India
789025,2023-06-30,202,milk,12,27,15,1,00269,India
789025,2023-06-30,201,paneer,210,340,130,1,00269,India
789025,2023-06-30,203,mango yogurt,50,60,10,1,00269,India
701096,2023-06-30,207,coca cola,75,100,25,1,00393,India
166809,2023-06-30,207,coca cola,75,100,25,1,00251,India
166809,2023-06-30,206,yakult,360,400,40,1,00251,India
854158,2023-06-30,205,classic yogurt,45,60,15,1,00239,India
854158,2023-06-30,204,strawberry yogurt,50,60,10,1,00239,India
962599,2023-07-01,204,strawberry yogurt,50,60,10,1,00267,India
962599,2023-07-01,210,mountain dew,75,100,25,1,00267,India
962599,2023-07-01,211,red bull,90,125,35,1,00267,India
962599,2023-07-01,203,mango yogurt,50,60,10,1,00267,India
395263,2023-07-01,212,amul cheese,250,315,65,1,00164,India
395263,2023-07-01,204,strawberry yogurt,50,60,10,1,00164,India
395263,2023-07-01,208,sprite,75,100,25,1,00164,India
474122,2023-07-01,206,yakult,360,400,40,1,00359,India
474122,2023-07-01,203,mango yogurt,50,60,10,1,00359,India
993749,2023-07-01,205,classic yogurt,45,60,15,1,00016,India
993749,2023-07-01,209,pepsi,75,100,25,1,00016,India
993749,2023-07-01,201,paneer,210,340,130,1,00016,India
969542,2023-07-01,213,bisleri,6,15,9,1,00313,India
969542,2023-07-01,209,pepsi,75,100,25,1,00313,India
335073,2023-07-01,201,paneer,210,340,130,1,00389,India
335073,2023-07-01,211,red bull,90,125,35,1,00389,India
335073,2023-07-01,206,yakult,360,400,40,1,00389,India
335073,2023-07-01,209,pepsi,75,100,25,1,00389,India
406353,2023-07-01,205,classic yogurt,45,60,15,1,00195,India
580468,2023-07-01,202,milk,12,27,15,1,00498,India
956479,2023-07-01,211,red bull,90,125,35,1,00166,India
956479,2023-07-01,208,sprite,75,100,25,1,00166,India
956479,2023-07-01,203,mango yogurt,50,60,10,1,00166,India
956479,2023-07-01,206,yakult,360,400,40,1,00166,India
492242,2023-07-01,213,bisleri,6,15,9,1,00234,India
492242,2023-07-01,211,red bull,90,125,35,1,00234,India
638432,2023-07-01,211,red bull,90,125,35,1,00060,India
193504,2023-07-01,203,mango yogurt,50,60,10,1,00283,India
193504,2023-07-01,208,sprite,75,100,25,1,00283,India
193504,2023-07-01,210,mountain dew,75,100,25,1,00283,India
193504,2023-07-01,211,red bull,90,125,35,1,00283,India
193504,2023-07-01,204,strawberry yogurt,50,60,10,1,00283,India
282136,2023-07-01,209,pepsi,75,100,25,1,00096,India
282136,2023-07-01,211,red bull,90,125,35,1,00096,India
282136,2023-07-01,203,mango yogurt,50,60,10,1,00096,India
282136,2023-07-01,204,strawberry yogurt,50,60,10,1,00096,India
822221,2023-07-01,208,sprite,75,100,25,1,00092,India
822221,2023-07-01,205,classic yogurt,45,60,15,1,00092,India
822221,2023-07-01,210,mountain dew,75,100,25,1,00092,India
924130,2023-07-01,206,yakult,360,400,40,1,00373,India
924130,2023-07-01,202,milk,12,27,15,1,00373,India
924130,2023-07-01,212,amul cheese,250,315,65,1,00373,India
924130,2023-07-01,207,coca cola,75,100,25,1,00373,India
175101,2023-07-01,202,milk,12,27,15,1,00377,India
175101,2023-07-01,201,paneer,210,340,130,1,00377,India
175101,2023-07-01,205,classic yogurt,45,60,15,1,00377,India
860445,2023-07-01,213,bisleri,6,15,9,1,00222,India
254168,2023-07-01,207,coca cola,75,100,25,1,00233,India
254168,2023-07-01,209,pepsi,75,100,25,1,00233,India
254168,2023-07-01,205,classic yogurt,45,60,15,1,00233,India
825699,2023-07-01,206,yakult,360,400,40,1,00469,India
825699,2023-07-01,208,sprite,75,100,25,1,00469,India
277870,2023-07-01,213,bisleri,6,15,9,1,00386,India
277870,2023-07-01,211,red bull,90,125,35,1,00386,India
277870,2023-07-01,206,yakult,360,400,40,1,00386,India
232237,2023-07-01,210,mountain dew,75,100,25,1,00471,India
232237,2023-07-01,202,milk,12,27,15,1,00471,India
232237,2023-07-01,208,sprite,75,100,25,1,00471,India
986086,2023-07-01,205,classic yogurt,45,60,15,1,00496,India
986086,2023-07-01,210,mountain dew,75,100,25,1,00496,India
986086,2023-07-01,212,amul cheese,250,315,65,1,00496,India
908684,2023-07-01,203,mango yogurt,50,60,10,1,00201,India
908684,2023-07-01,207,coca cola,75,100,25,1,00201,India
908684,2023-07-01,208,sprite,75,100,25,1,00201,India
908684,2023-07-01,210,mountain dew,75,100,25,1,00201,India
908684,2023-07-01,201,paneer,210,340,130,1,00201,India
158558,2023-07-01,210,mountain dew,75,100,25,1,00074,India
534021,2023-07-01,204,strawberry yogurt,50,60,10,1,00441,India
534021,2023-07-01,207,coca cola,75,100,25,1,00441,India
534021,2023-07-01,202,milk,12,27,15,1,00441,India
219471,2023-07-01,205,classic yogurt,45,60,15,1,00419,India
219471,2023-07-01,209,pepsi,75,100,25,1,00419,India
110218,2023-07-01,210,mountain dew,75,100,25,1,00372,India
110218,2023-07-01,211,red bull,90,125,35,1,00372,India
110218,2023-07-01,202,milk,12,27,15,1,00372,India
222468,2023-07-01,205,classic yogurt,45,60,15,1,00136,India
222468,2023-07-01,213,bisleri,6,15,9,1,00136,India
222468,2023-07-01,212,amul cheese,250,315,65,1,00136,India
737698,2023-07-01,204,strawberry yogurt,50,60,10,1,00066,India
737698,2023-07-01,201,paneer,210,340,130,1,00066,India
737698,2023-07-01,203,mango yogurt,50,60,10,1,00066,India
737698,2023-07-01,211,red bull,90,125,35,1,00066,India
479391,2023-07-01,201,paneer,210,340,130,1,00016,India
479391,2023-07-01,212,amul cheese,250,315,65,1,00016,India
479391,2023-07-01,213,bisleri,6,15,9,1,00016,India
479391,2023-07-01,207,coca cola,75,100,25,1,00016,India
238032,2023-07-01,210,mountain dew,75,100,25,1,00253,India
238032,2023-07-01,212,amul cheese,250,315,65,1,00253,India
238032,2023-07-01,202,milk,12,27,15,1,00253,India
238032,2023-07-01,203,mango yogurt,50,60,10,1,00253,India
254214,2023-07-01,203,mango yogurt,50,60,10,1,00353,India
254214,2023-07-01,204,strawberry yogurt,50,60,10,1,00353,India
254214,2023-07-01,210,mountain dew,75,100,25,1,00353,India
254214,2023-07-01,206,yakult,360,400,40,1,00353,India
846333,2023-07-01,202,milk,12,27,15,1,00121,India
846333,2023-07-01,205,classic yogurt,45,60,15,1,00121,India
846333,2023-07-01,206,yakult,360,400,40,1,00121,India
846333,2023-07-01,213,bisleri,6,15,9,1,00121,India
596228,2023-07-01,210,mountain dew,75,100,25,1,00327,India
596228,2023-07-01,213,bisleri,6,15,9,1,00327,India
596228,2023-07-01,207,coca cola,75,100,25,1,00327,India
596228,2023-07-01,201,paneer,210,340,130,1,00327,India
596228,2023-07-01,204,strawberry yogurt,50,60,10,1,00327,India
336647,2023-07-01,202,milk,12,27,15,1,00421,India
336647,2023-07-01,204,strawberry yogurt,50,60,10,1,00421,India
336647,2023-07-01,213,bisleri,6,15,9,1,00421,India
336647,2023-07-01,207,coca cola,75,100,25,1,00421,India
503036,2023-07-01,209,pepsi,75,100,25,1,00309,India
503036,2023-07-01,203,mango yogurt,50,60,10,1,00309,India
503036,2023-07-01,204,strawberry yogurt,50,60,10,1,00309,India
503036,2023-07-01,202,milk,12,27,15,1,00309,India
503036,2023-07-01,205,classic yogurt,45,60,15,1,00309,India
444516,2023-07-01,206,yakult,360,400,40,1,00211,India
444516,2023-07-01,207,coca cola,75,100,25,1,00211,India
444516,2023-07-01,210,mountain dew,75,100,25,1,00211,India
261673,2023-07-01,212,amul cheese,250,315,65,1,00383,India
261673,2023-07-01,207,coca cola,75,100,25,1,00383,India
261673,2023-07-01,203,mango yogurt,50,60,10,1,00383,India
261673,2023-07-01,201,paneer,210,340,130,1,00383,India
155220,2023-07-01,209,pepsi,75,100,25,1,00007,India
155220,2023-07-01,206,yakult,360,400,40,1,00007,India
155220,2023-07-01,202,milk,12,27,15,1,00007,India
155220,2023-07-01,204,strawberry yogurt,50,60,10,1,00007,India
472856,2023-07-01,203,mango yogurt,50,60,10,1,00375,India
384066,2023-07-01,202,milk,12,27,15,1,00388,India
384066,2023-07-01,201,paneer,210,340,130,1,00388,India
384066,2023-07-01,210,mountain dew,75,100,25,1,00388,India
360286,2023-07-01,213,bisleri,6,15,9,1,00002,India
360286,2023-07-01,205,classic yogurt,45,60,15,1,00002,India
360286,2023-07-01,210,mountain dew,75,100,25,1,00002,India
197425,2023-07-01,204,strawberry yogurt,50,60,10,1,00440,India
197425,2023-07-01,209,pepsi,75,100,25,1,00440,India
236355,2023-07-01,206,yakult,360,400,40,1,00072,India
236355,2023-07-01,207,coca cola,75,100,25,1,00072,India
187657,2023-07-01,206,yakult,360,400,40,1,00424,India
187657,2023-07-01,211,red bull,90,125,35,1,00424,India
377532,2023-07-01,205,classic yogurt,45,60,15,1,00242,India
377532,2023-07-01,202,milk,12,27,15,1,00242,India
377532,2023-07-01,206,yakult,360,400,40,1,00242,India
338684,2023-07-01,203,mango yogurt,50,60,10,1,00182,India
338684,2023-07-01,212,amul cheese,250,315,65,1,00182,India
774288,2023-07-01,210,mountain dew,75,100,25,1,00357,India
774288,2023-07-01,206,yakult,360,400,40,1,00357,India
774288,2023-07-01,205,classic yogurt,45,60,15,1,00357,India
400084,2023-07-01,211,red bull,90,125,35,1,00288,India
400084,2023-07-01,209,pepsi,75,100,25,1,00288,India
400084,2023-07-01,212,amul cheese,250,315,65,1,00288,India
400084,2023-07-01,205,classic yogurt,45,60,15,1,00288,India
462380,2023-07-01,213,bisleri,6,15,9,1,00074,India
462380,2023-07-01,209,pepsi,75,100,25,1,00074,India
462380,2023-07-01,202,milk,12,27,15,1,00074,India
250794,2023-07-01,206,yakult,360,400,40,1,00297,India
250794,2023-07-01,208,sprite,75,100,25,1,00297,India
250794,2023-07-01,209,pepsi,75,100,25,1,00297,India
250794,2023-07-01,210,mountain dew,75,100,25,1,00297,India
694787,2023-07-01,212,amul cheese,250,315,65,1,00336,India
694787,2023-07-01,213,bisleri,6,15,9,1,00336,India
552135,2023-07-01,201,paneer,210,340,130,1,00378,India
552135,2023-07-01,209,pepsi,75,100,25,1,00378,India
552135,2023-07-01,212,amul cheese,250,315,65,1,00378,India
895457,2023-07-01,210,mountain dew,75,100,25,1,00199,India
895457,2023-07-01,202,milk,12,27,15,1,00199,India
895457,2023-07-01,203,mango yogurt,50,60,10,1,00199,India
895457,2023-07-01,206,yakult,360,400,40,1,00199,India
783230,2023-07-01,207,coca cola,75,100,25,1,00318,India
783230,2023-07-01,205,classic yogurt,45,60,15,1,00318,India
387029,2023-07-01,209,pepsi,75,100,25,1,00043,India
387029,2023-07-01,208,sprite,75,100,25,1,00043,India
387029,2023-07-01,211,red bull,90,125,35,1,00043,India
490726,2023-07-01,208,sprite,75,100,25,1,00457,India
490726,2023-07-01,204,strawberry yogurt,50,60,10,1,00457,India
490726,2023-07-01,201,paneer,210,340,130,1,00457,India
814522,2023-07-01,208,sprite,75,100,25,1,00139,India
814522,2023-07-01,209,pepsi,75,100,25,1,00139,India
814522,2023-07-01,206,yakult,360,400,40,1,00139,India
206910,2023-07-01,205,classic yogurt,45,60,15,1,00411,India
206910,2023-07-01,207,coca cola,75,100,25,1,00411,India
433835,2023-07-01,212,amul cheese,250,315,65,1,00407,India
433835,2023-07-01,205,classic yogurt,45,60,15,1,00407,India
211669,2023-07-01,208,sprite,75,100,25,1,00314,India
211669,2023-07-01,203,mango yogurt,50,60,10,1,00314,India
907629,2023-07-01,203,mango yogurt,50,60,10,1,00164,India
907629,2023-07-01,206,yakult,360,400,40,1,00164,India
907629,2023-07-01,212,amul cheese,250,315,65,1,00164,India
886758,2023-07-01,202,milk,12,27,15,1,00125,India
886758,2023-07-01,203,mango yogurt,50,60,10,1,00125,India
886758,2023-07-01,201,paneer,210,340,130,1,00125,India
125312,2023-07-01,206,yakult,360,400,40,1,00198,India
125312,2023-07-01,205,classic yogurt,45,60,15,1,00198,India
125312,2023-07-01,208,sprite,75,100,25,1,00198,India
125312,2023-07-01,209,pepsi,75,100,25,1,00198,India
199206,2023-07-01,204,strawberry yogurt,50,60,10,1,00072,India
199206,2023-07-01,212,amul cheese,250,315,65,1,00072,India
199206,2023-07-01,205,classic yogurt,45,60,15,1,00072,India
199206,2023-07-01,201,paneer,210,340,130,1,00072,India
199206,2023-07-01,202,milk,12,27,15,1,00072,India
664862,2023-07-01,207,coca cola,75,100,25,1,00171,India
664862,2023-07-01,210,mountain dew,75,100,25,1,00171,India
664862,2023-07-01,201,paneer,210,340,130,1,00171,India
926339,2023-07-01,202,milk,12,27,15,1,00001,India
926339,2023-07-01,205,classic yogurt,45,60,15,1,00001,India
926339,2023-07-01,206,yakult,360,400,40,1,00001,India
926339,2023-07-01,211,red bull,90,125,35,1,00001,India
872647,2023-07-01,212,amul cheese,250,315,65,1,00130,India
872647,2023-07-01,208,sprite,75,100,25,1,00130,India
175107,2023-07-01,210,mountain dew,75,100,25,1,00093,India
175107,2023-07-01,201,paneer,210,340,130,1,00093,India
175107,2023-07-01,205,classic yogurt,45,60,15,1,00093,India
175107,2023-07-01,207,coca cola,75,100,25,1,00093,India
175107,2023-07-01,211,red bull,90,125,35,1,00093,India
504162,2023-07-01,209,pepsi,75,100,25,1,00420,India
504162,2023-07-01,205,classic yogurt,45,60,15,1,00420,India
584040,2023-07-01,212,amul cheese,250,315,65,1,00171,India
584040,2023-07-01,213,bisleri,6,15,9,1,00171,India
584040,2023-07-01,208,sprite,75,100,25,1,00171,India
706323,2023-07-01,204,strawberry yogurt,50,60,10,1,00074,India
706323,2023-07-01,201,paneer,210,340,130,1,00074,India
706323,2023-07-01,213,bisleri,6,15,9,1,00074,India
804619,2023-07-01,207,coca cola,75,100,25,1,00073,India
804619,2023-07-01,203,mango yogurt,50,60,10,1,00073,India
892668,2023-07-01,210,mountain dew,75,100,25,1,00439,India
892668,2023-07-01,209,pepsi,75,100,25,1,00439,India
892668,2023-07-01,211,red bull,90,125,35,1,00439,India
892668,2023-07-01,208,sprite,75,100,25,1,00439,India
892668,2023-07-01,205,classic yogurt,45,60,15,1,00439,India
201881,2023-07-01,207,coca cola,75,100,25,1,00093,India
201881,2023-07-01,209,pepsi,75,100,25,1,00093,India
201881,2023-07-01,212,amul cheese,250,315,65,1,00093,India
236987,2023-07-01,210,mountain dew,75,100,25,1,00023,India
236987,2023-07-01,204,strawberry yogurt,50,60,10,1,00023,India
236987,2023-07-01,211,red bull,90,125,35,1,00023,India
399257,2023-07-01,204,strawberry yogurt,50,60,10,1,00039,India
399257,2023-07-01,201,paneer,210,340,130,1,00039,India
399257,2023-07-01,211,red bull,90,125,35,1,00039,India
399257,2023-07-01,212,amul cheese,250,315,65,1,00039,India
399257,2023-07-01,210,mountain dew,75,100,25,1,00039,India
538687,2023-07-01,205,classic yogurt,45,60,15,1,00257,India
538687,2023-07-01,209,pepsi,75,100,25,1,00257,India
160358,2023-07-01,204,strawberry yogurt,50,60,10,1,00374,India
160358,2023-07-01,211,red bull,90,125,35,1,00374,India
160358,2023-07-01,212,amul cheese,250,315,65,1,00374,India
578439,2023-07-01,204,strawberry yogurt,50,60,10,1,00272,India
578439,2023-07-01,210,mountain dew,75,100,25,1,00272,India
578439,2023-07-01,208,sprite,75,100,25,1,00272,India
111310,2023-07-01,212,amul cheese,250,315,65,1,00017,India
111310,2023-07-01,204,strawberry yogurt,50,60,10,1,00017,India
108633,2023-07-01,204,strawberry yogurt,50,60,10,1,00353,India
108633,2023-07-01,206,yakult,360,400,40,1,00353,India
108633,2023-07-01,205,classic yogurt,45,60,15,1,00353,India
108633,2023-07-01,202,milk,12,27,15,1,00353,India
829861,2023-07-01,206,yakult,360,400,40,1,00031,India
829861,2023-07-01,203,mango yogurt,50,60,10,1,00031,India
829861,2023-07-01,205,classic yogurt,45,60,15,1,00031,India
921664,2023-07-01,213,bisleri,6,15,9,1,00488,India
921664,2023-07-01,204,strawberry yogurt,50,60,10,1,00488,India
921664,2023-07-01,202,milk,12,27,15,1,00488,India
921664,2023-07-01,206,yakult,360,400,40,1,00488,India
921664,2023-07-01,203,mango yogurt,50,60,10,1,00488,India
163700,2023-07-01,208,sprite,75,100,25,1,00109,India
163700,2023-07-01,202,milk,12,27,15,1,00109,India
163700,2023-07-01,204,strawberry yogurt,50,60,10,1,00109,India
388275,2023-07-01,204,strawberry yogurt,50,60,10,1,00184,India
388275,2023-07-01,205,classic yogurt,45,60,15,1,00184,India
388275,2023-07-01,209,pepsi,75,100,25,1,00184,India
695650,2023-07-01,212,amul cheese,250,315,65,1,00407,India
695650,2023-07-01,203,mango yogurt,50,60,10,1,00407,India
695650,2023-07-01,202,milk,12,27,15,1,00407,India
232701,2023-07-01,206,yakult,360,400,40,1,00426,India
232701,2023-07-01,212,amul cheese,250,315,65,1,00426,India
232701,2023-07-01,209,pepsi,75,100,25,1,00426,India
378540,2023-07-01,203,mango yogurt,50,60,10,1,00272,India
378540,2023-07-01,212,amul cheese,250,315,65,1,00272,India
378540,2023-07-01,207,coca cola,75,100,25,1,00272,India
378540,2023-07-01,202,milk,12,27,15,1,00272,India
378540,2023-07-01,206,yakult,360,400,40,1,00272,India
182357,2023-07-01,211,red bull,90,125,35,1,00469,India
182357,2023-07-01,203,mango yogurt,50,60,10,1,00469,India
641903,2023-07-01,204,strawberry yogurt,50,60,10,1,00484,India
641903,2023-07-01,213,bisleri,6,15,9,1,00484,India
641903,2023-07-01,209,pepsi,75,100,25,1,00484,India
776577,2023-07-01,203,mango yogurt,50,60,10,1,00148,India
776577,2023-07-01,201,paneer,210,340,130,1,00148,India
776577,2023-07-01,202,milk,12,27,15,1,00148,India
794449,2023-07-01,208,sprite,75,100,25,1,00057,India
794449,2023-07-01,204,strawberry yogurt,50,60,10,1,00057,India
794449,2023-07-01,205,classic yogurt,45,60,15,1,00057,India
794449,2023-07-01,202,milk,12,27,15,1,00057,India
199772,2023-07-01,209,pepsi,75,100,25,1,00141,India
191053,2023-07-01,205,classic yogurt,45,60,15,1,00268,India
191053,2023-07-01,201,paneer,210,340,130,1,00268,India
191053,2023-07-01,211,red bull,90,125,35,1,00268,India
191053,2023-07-01,209,pepsi,75,100,25,1,00268,India
934424,2023-07-01,209,pepsi,75,100,25,1,00081,India
934424,2023-07-01,202,milk,12,27,15,1,00081,India
934424,2023-07-01,210,mountain dew,75,100,25,1,00081,India
934424,2023-07-01,208,sprite,75,100,25,1,00081,India
976742,2023-07-02,208,sprite,75,100,25,1,00134,India
976742,2023-07-02,201,paneer,210,340,130,1,00134,India
976742,2023-07-02,209,pepsi,75,100,25,1,00134,India
752234,2023-07-02,212,amul cheese,250,315,65,1,00115,India
752234,2023-07-02,202,milk,12,27,15,1,00115,India
752234,2023-07-02,207,coca cola,75,100,25,1,00115,India
752234,2023-07-02,205,classic yogurt,45,60,15,1,00115,India
272668,2023-07-02,213,bisleri,6,15,9,1,00354,India
526419,2023-07-02,206,yakult,360,400,40,1,00070,India
526419,2023-07-02,213,bisleri,6,15,9,1,00070,India
708988,2023-07-02,204,strawberry yogurt,50,60,10,1,00086,India
708988,2023-07-02,208,sprite,75,100,25,1,00086,India
708988,2023-07-02,203,mango yogurt,50,60,10,1,00086,India
708988,2023-07-02,210,mountain dew,75,100,25,1,00086,India
649984,2023-07-02,208,sprite,75,100,25,1,00180,India
649984,2023-07-02,211,red bull,90,125,35,1,00180,India
649984,2023-07-02,205,classic yogurt,45,60,15,1,00180,India
649984,2023-07-02,202,milk,12,27,15,1,00180,India
757060,2023-07-02,205,classic yogurt,45,60,15,1,00261,India
359572,2023-07-02,210,mountain dew,75,100,25,1,00461,India
359572,2023-07-02,203,mango yogurt,50,60,10,1,00461,India
359572,2023-07-02,212,amul cheese,250,315,65,1,00461,India
324560,2023-07-02,204,strawberry yogurt,50,60,10,1,00376,India
324560,2023-07-02,212,amul cheese,250,315,65,1,00376,India
324560,2023-07-02,206,yakult,360,400,40,1,00376,India
324560,2023-07-02,209,pepsi,75,100,25,1,00376,India
330923,2023-07-02,207,coca cola,75,100,25,1,00251,India
330923,2023-07-02,204,strawberry yogurt,50,60,10,1,00251,India
330923,2023-07-02,209,pepsi,75,100,25,1,00251,India
870700,2023-07-02,209,pepsi,75,100,25,1,00010,India
564605,2023-07-02,211,red bull,90,125,35,1,00024,India
564605,2023-07-02,205,classic yogurt,45,60,15,1,00024,India
564605,2023-07-02,201,paneer,210,340,130,1,00024,India
194703,2023-07-02,211,red bull,90,125,35,1,00093,India
194703,2023-07-02,212,amul cheese,250,315,65,1,00093,India
194703,2023-07-02,206,yakult,360,400,40,1,00093,India
551183,2023-07-02,202,milk,12,27,15,1,00378,India
551183,2023-07-02,212,amul cheese,250,315,65,1,00378,India
728317,2023-07-02,211,red bull,90,125,35,1,00253,India
436593,2023-07-02,208,sprite,75,100,25,1,00475,India
436593,2023-07-02,203,mango yogurt,50,60,10,1,00475,India
436593,2023-07-02,205,classic yogurt,45,60,15,1,00475,India
780486,2023-07-02,211,red bull,90,125,35,1,00348,India
780486,2023-07-02,208,sprite,75,100,25,1,00348,India
780486,2023-07-02,210,mountain dew,75,100,25,1,00348,India
780486,2023-07-02,206,yakult,360,400,40,1,00348,India
780486,2023-07-02,203,mango yogurt,50,60,10,1,00348,India
457873,2023-07-02,211,red bull,90,125,35,1,00055,India
457873,2023-07-02,205,classic yogurt,45,60,15,1,00055,India
457873,2023-07-02,208,sprite,75,100,25,1,00055,India
308417,2023-07-02,205,classic yogurt,45,60,15,1,00447,India
308417,2023-07-02,207,coca cola,75,100,25,1,00447,India
308417,2023-07-02,203,mango yogurt,50,60,10,1,00447,India
567004,2023-07-02,207,coca cola,75,100,25,1,00317,India
567004,2023-07-02,210,mountain dew,75,100,25,1,00317,India
567004,2023-07-02,201,paneer,210,340,130,1,00317,India
567004,2023-07-02,206,yakult,360,400,40,1,00317,India
567004,2023-07-02,212,amul cheese,250,315,65,1,00317,India
722434,2023-07-02,201,paneer,210,340,130,1,00055,India
722434,2023-07-02,213,bisleri,6,15,9,1,00055,India
722434,2023-07-02,202,milk,12,27,15,1,00055,India
815721,2023-07-02,210,mountain dew,75,100,25,1,00011,India
678145,2023-07-02,213,bisleri,6,15,9,1,00350,India
678145,2023-07-02,209,pepsi,75,100,25,1,00350,India
678145,2023-07-02,206,yakult,360,400,40,1,00350,India
678145,2023-07-02,205,classic yogurt,45,60,15,1,00350,India
261638,2023-07-02,201,paneer,210,340,130,1,00407,India
930904,2023-07-02,210,mountain dew,75,100,25,1,00091,India
442448,2023-07-02,207,coca cola,75,100,25,1,00220,India
442448,2023-07-02,206,yakult,360,400,40,1,00220,India
921500,2023-07-02,204,strawberry yogurt,50,60,10,1,00355,India
653041,2023-07-02,201,paneer,210,340,130,1,00054,India
653041,2023-07-02,205,classic yogurt,45,60,15,1,00054,India
653041,2023-07-02,213,bisleri,6,15,9,1,00054,India
653041,2023-07-02,203,mango yogurt,50,60,10,1,00054,India
650414,2023-07-02,202,milk,12,27,15,1,00375,India
237382,2023-07-02,210,mountain dew,75,100,25,1,00135,India
237382,2023-07-02,206,yakult,360,400,40,1,00135,India
237382,2023-07-02,202,milk,12,27,15,1,00135,India
271874,2023-07-02,205,classic yogurt,45,60,15,1,00113,India
248994,2023-07-02,211,red bull,90,125,35,1,00171,India
903194,2023-07-02,211,red bull,90,125,35,1,00269,India
903194,2023-07-02,203,mango yogurt,50,60,10,1,00269,India
903194,2023-07-02,209,pepsi,75,100,25,1,00269,India
129135,2023-07-02,203,mango yogurt,50,60,10,1,00126,India
129135,2023-07-02,212,amul cheese,250,315,65,1,00126,India
129135,2023-07-02,210,mountain dew,75,100,25,1,00126,India
870851,2023-07-02,206,yakult,360,400,40,1,00104,India
870851,2023-07-02,204,strawberry yogurt,50,60,10,1,00104,India
258831,2023-07-02,208,sprite,75,100,25,1,00063,India
258831,2023-07-02,212,amul cheese,250,315,65,1,00063,India
258831,2023-07-02,209,pepsi,75,100,25,1,00063,India
258831,2023-07-02,210,mountain dew,75,100,25,1,00063,India
981995,2023-07-02,206,yakult,360,400,40,1,00367,India
981995,2023-07-02,210,mountain dew,75,100,25,1,00367,India
701903,2023-07-02,204,strawberry yogurt,50,60,10,1,00015,India
304676,2023-07-02,207,coca cola,75,100,25,1,00202,India
304676,2023-07-02,213,bisleri,6,15,9,1,00202,India
157953,2023-07-02,211,red bull,90,125,35,1,00479,India
157953,2023-07-02,203,mango yogurt,50,60,10,1,00479,India
978110,2023-07-02,209,pepsi,75,100,25,1,00140,India
296279,2023-07-02,212,amul cheese,250,315,65,1,00137,India
296279,2023-07-02,201,paneer,210,340,130,1,00137,India
296279,2023-07-02,213,bisleri,6,15,9,1,00137,India
781319,2023-07-02,212,amul cheese,250,315,65,1,00211,India
781319,2023-07-02,208,sprite,75,100,25,1,00211,India
781319,2023-07-02,213,bisleri,6,15,9,1,00211,India
118544,2023-07-02,212,amul cheese,250,315,65,1,00456,India
502919,2023-07-02,209,pepsi,75,100,25,1,00208,India
502919,2023-07-02,207,coca cola,75,100,25,1,00208,India
502919,2023-07-02,203,mango yogurt,50,60,10,1,00208,India
502919,2023-07-02,211,red bull,90,125,35,1,00208,India
987586,2023-07-02,203,mango yogurt,50,60,10,1,00375,India
619054,2023-07-02,207,coca cola,75,100,25,1,00283,India
619054,2023-07-02,203,mango yogurt,50,60,10,1,00283,India
619054,2023-07-02,209,pepsi,75,100,25,1,00283,India
692526,2023-07-02,206,yakult,360,400,40,1,00126,India
692526,2023-07-02,201,paneer,210,340,130,1,00126,India
227093,2023-07-02,211,red bull,90,125,35,1,00094,India
227093,2023-07-02,203,mango yogurt,50,60,10,1,00094,India
227093,2023-07-02,209,pepsi,75,100,25,1,00094,India
155070,2023-07-02,209,pepsi,75,100,25,1,00254,India
155070,2023-07-02,207,coca cola,75,100,25,1,00254,India
314694,2023-07-02,205,classic yogurt,45,60,15,1,00391,India
678816,2023-07-02,203,mango yogurt,50,60,10,1,00271,India
678816,2023-07-02,204,strawberry yogurt,50,60,10,1,00271,India
678816,2023-07-02,210,mountain dew,75,100,25,1,00271,India
203283,2023-07-02,203,mango yogurt,50,60,10,1,00379,India
203283,2023-07-02,211,red bull,90,125,35,1,00379,India
203283,2023-07-02,212,amul cheese,250,315,65,1,00379,India
203283,2023-07-02,213,bisleri,6,15,9,1,00379,India
213095,2023-07-02,206,yakult,360,400,40,1,00088,India
213095,2023-07-02,212,amul cheese,250,315,65,1,00088,India
585493,2023-07-02,203,mango yogurt,50,60,10,1,00328,India
585493,2023-07-02,201,paneer,210,340,130,1,00328,India
585493,2023-07-02,210,mountain dew,75,100,25,1,00328,India
324407,2023-07-02,210,mountain dew,75,100,25,1,00310,India
324407,2023-07-02,213,bisleri,6,15,9,1,00310,India
324407,2023-07-02,209,pepsi,75,100,25,1,00310,India
439377,2023-07-02,207,coca cola,75,100,25,1,00266,India
439377,2023-07-02,205,classic yogurt,45,60,15,1,00266,India
754625,2023-07-02,206,yakult,360,400,40,1,00109,India
754625,2023-07-02,204,strawberry yogurt,50,60,10,1,00109,India
754625,2023-07-02,210,mountain dew,75,100,25,1,00109,India
754625,2023-07-02,208,sprite,75,100,25,1,00109,India
795939,2023-07-02,201,paneer,210,340,130,1,00034,India
795939,2023-07-02,207,coca cola,75,100,25,1,00034,India
878258,2023-07-02,210,mountain dew,75,100,25,1,00435,India
878258,2023-07-02,203,mango yogurt,50,60,10,1,00435,India
878258,2023-07-02,211,red bull,90,125,35,1,00435,India
878258,2023-07-02,205,classic yogurt,45,60,15,1,00435,India
976255,2023-07-02,209,pepsi,75,100,25,1,00397,India
976255,2023-07-02,207,coca cola,75,100,25,1,00397,India
474418,2023-07-02,205,classic yogurt,45,60,15,1,00178,India
474418,2023-07-02,210,mountain dew,75,100,25,1,00178,India
474418,2023-07-02,207,coca cola,75,100,25,1,00178,India
474418,2023-07-02,204,strawberry yogurt,50,60,10,1,00178,India
967177,2023-07-02,204,strawberry yogurt,50,60,10,1,00098,India
967177,2023-07-02,208,sprite,75,100,25,1,00098,India
967177,2023-07-02,211,red bull,90,125,35,1,00098,India
967177,2023-07-02,207,coca cola,75,100,25,1,00098,India
967177,2023-07-02,213,bisleri,6,15,9,1,00098,India
903602,2023-07-02,211,red bull,90,125,35,1,00171,India
903602,2023-07-02,210,mountain dew,75,100,25,1,00171,India
903602,2023-07-02,204,strawberry yogurt,50,60,10,1,00171,India
723180,2023-07-03,211,red bull,90,125,35,1,00055,India
723180,2023-07-03,212,amul cheese,250,315,65,1,00055,India
342708,2023-07-03,212,amul cheese,250,315,65,1,00223,India
342708,2023-07-03,208,sprite,75,100,25,1,00223,India
342708,2023-07-03,213,bisleri,6,15,9,1,00223,India
342708,2023-07-03,210,mountain dew,75,100,25,1,00223,India
150063,2023-07-03,203,mango yogurt,50,60,10,1,00278,India
150063,2023-07-03,205,classic yogurt,45,60,15,1,00278,India
150063,2023-07-03,204,strawberry yogurt,50,60,10,1,00278,India
150063,2023-07-03,201,paneer,210,340,130,1,00278,India
150063,2023-07-03,210,mountain dew,75,100,25,1,00278,India
250842,2023-07-03,201,paneer,210,340,130,1,00156,India
250842,2023-07-03,209,pepsi,75,100,25,1,00156,India
250842,2023-07-03,208,sprite,75,100,25,1,00156,India
250842,2023-07-03,204,strawberry yogurt,50,60,10,1,00156,India
141348,2023-07-03,208,sprite,75,100,25,1,00194,India
141348,2023-07-03,210,mountain dew,75,100,25,1,00194,India
141348,2023-07-03,209,pepsi,75,100,25,1,00194,India
351484,2023-07-03,205,classic yogurt,45,60,15,1,00196,India
351484,2023-07-03,208,sprite,75,100,25,1,00196,India
351484,2023-07-03,209,pepsi,75,100,25,1,00196,India
351484,2023-07-03,201,paneer,210,340,130,1,00196,India
749912,2023-07-03,211,red bull,90,125,35,1,00324,India
219891,2023-07-03,203,mango yogurt,50,60,10,1,00243,India
219891,2023-07-03,206,yakult,360,400,40,1,00243,India
219891,2023-07-03,202,milk,12,27,15,1,00243,India
841432,2023-07-03,209,pepsi,75,100,25,1,00119,India
600674,2023-07-03,213,bisleri,6,15,9,1,00444,India
600674,2023-07-03,209,pepsi,75,100,25,1,00444,India
600674,2023-07-03,202,milk,12,27,15,1,00444,India
775618,2023-07-03,206,yakult,360,400,40,1,00171,India
958827,2023-07-03,204,strawberry yogurt,50,60,10,1,00491,India
958827,2023-07-03,206,yakult,360,400,40,1,00491,India
958827,2023-07-03,202,milk,12,27,15,1,00491,India
958827,2023-07-03,203,mango yogurt,50,60,10,1,00491,India
227251,2023-07-03,203,mango yogurt,50,60,10,1,00245,India
368290,2023-07-03,212,amul cheese,250,315,65,1,00202,India
368290,2023-07-03,213,bisleri,6,15,9,1,00202,India
368290,2023-07-03,205,classic yogurt,45,60,15,1,00202,India
368290,2023-07-03,201,paneer,210,340,130,1,00202,India
304279,2023-07-03,213,bisleri,6,15,9,1,00305,India
304279,2023-07-03,203,mango yogurt,50,60,10,1,00305,India
304279,2023-07-03,205,classic yogurt,45,60,15,1,00305,India
655486,2023-07-03,203,mango yogurt,50,60,10,1,00486,India
655486,2023-07-03,206,yakult,360,400,40,1,00486,India
655486,2023-07-03,205,classic yogurt,45,60,15,1,00486,India
655486,2023-07-03,201,paneer,210,340,130,1,00486,India
792200,2023-07-03,201,paneer,210,340,130,1,00093,India
792200,2023-07-03,202,milk,12,27,15,1,00093,India
792200,2023-07-03,206,yakult,360,400,40,1,00093,India
772546,2023-07-03,208,sprite,75,100,25,1,00447,India
772546,2023-07-03,201,paneer,210,340,130,1,00447,India
772546,2023-07-03,202,milk,12,27,15,1,00447,India
772546,2023-07-03,210,mountain dew,75,100,25,1,00447,India
161171,2023-07-03,210,mountain dew,75,100,25,1,00198,India
809528,2023-07-03,207,coca cola,75,100,25,1,00150,India
809528,2023-07-03,209,pepsi,75,100,25,1,00150,India
809528,2023-07-03,201,paneer,210,340,130,1,00150,India
912308,2023-07-03,204,strawberry yogurt,50,60,10,1,00448,India
912308,2023-07-03,203,mango yogurt,50,60,10,1,00448,India
912308,2023-07-03,206,yakult,360,400,40,1,00448,India
912308,2023-07-03,213,bisleri,6,15,9,1,00448,India
912308,2023-07-03,207,coca cola,75,100,25,1,00448,India
584148,2023-07-03,211,red bull,90,125,35,1,00044,India
584148,2023-07-03,202,milk,12,27,15,1,00044,India
343900,2023-07-03,206,yakult,360,400,40,1,00014,India
343900,2023-07-03,201,paneer,210,340,130,1,00014,India
343900,2023-07-03,209,pepsi,75,100,25,1,00014,India
563638,2023-07-03,206,yakult,360,400,40,1,00442,India
563638,2023-07-03,207,coca cola,75,100,25,1,00442,India
563638,2023-07-03,202,milk,12,27,15,1,00442,India
768866,2023-07-03,202,milk,12,27,15,1,00367,India
768866,2023-07-03,201,paneer,210,340,130,1,00367,India
768866,2023-07-03,207,coca cola,75,100,25,1,00367,India
768866,2023-07-03,209,pepsi,75,100,25,1,00367,India
500631,2023-07-03,204,strawberry yogurt,50,60,10,1,00176,India
913622,2023-07-03,203,mango yogurt,50,60,10,1,00134,India
913622,2023-07-03,213,bisleri,6,15,9,1,00134,India
913622,2023-07-03,211,red bull,90,125,35,1,00134,India
913622,2023-07-03,209,pepsi,75,100,25,1,00134,India
834047,2023-07-03,210,mountain dew,75,100,25,1,00172,India
834047,2023-07-03,202,milk,12,27,15,1,00172,India
834047,2023-07-03,209,pepsi,75,100,25,1,00172,India
507703,2023-07-03,207,coca cola,75,100,25,1,00107,India
507703,2023-07-03,210,mountain dew,75,100,25,1,00107,India
507703,2023-07-03,213,bisleri,6,15,9,1,00107,India
507703,2023-07-03,203,mango yogurt,50,60,10,1,00107,India
157816,2023-07-03,203,mango yogurt,50,60,10,1,00274,India
157816,2023-07-03,208,sprite,75,100,25,1,00274,India
157816,2023-07-03,201,paneer,210,340,130,1,00274,India
157816,2023-07-03,207,coca cola,75,100,25,1,00274,India
151804,2023-07-03,206,yakult,360,400,40,1,00163,India
538313,2023-07-03,212,amul cheese,250,315,65,1,00225,India
798752,2023-07-03,205,classic yogurt,45,60,15,1,00155,India
798752,2023-07-03,211,red bull,90,125,35,1,00155,India
437839,2023-07-03,201,paneer,210,340,130,1,00180,India
437839,2023-07-03,206,yakult,360,400,40,1,00180,India
437839,2023-07-03,207,coca cola,75,100,25,1,00180,India
418290,2023-07-03,210,mountain dew,75,100,25,1,00139,India
418290,2023-07-03,206,yakult,360,400,40,1,00139,India
418290,2023-07-03,201,paneer,210,340,130,1,00139,India
418290,2023-07-03,211,red bull,90,125,35,1,00139,India
394504,2023-07-03,209,pepsi,75,100,25,1,00084,India
394504,2023-07-03,203,mango yogurt,50,60,10,1,00084,India
242562,2023-07-03,210,mountain dew,75,100,25,1,00143,India
242562,2023-07-03,206,yakult,360,400,40,1,00143,India
242562,2023-07-03,213,bisleri,6,15,9,1,00143,India
242562,2023-07-03,212,amul cheese,250,315,65,1,00143,India
364980,2023-07-03,203,mango yogurt,50,60,10,1,00289,India
364980,2023-07-03,210,mountain dew,75,100,25,1,00289,India
364980,2023-07-03,204,strawberry yogurt,50,60,10,1,00289,India
364980,2023-07-03,213,bisleri,6,15,9,1,00289,India
364980,2023-07-03,209,pepsi,75,100,25,1,00289,India
922237,2023-07-03,209,pepsi,75,100,25,1,00290,India
922237,2023-07-03,205,classic yogurt,45,60,15,1,00290,India
922237,2023-07-03,206,yakult,360,400,40,1,00290,India
922237,2023-07-03,204,strawberry yogurt,50,60,10,1,00290,India
339175,2023-07-03,203,mango yogurt,50,60,10,1,00239,India
339175,2023-07-03,206,yakult,360,400,40,1,00239,India
339175,2023-07-03,207,coca cola,75,100,25,1,00239,India
339175,2023-07-03,213,bisleri,6,15,9,1,00239,India
435956,2023-07-03,201,paneer,210,340,130,1,00091,India
435956,2023-07-03,208,sprite,75,100,25,1,00091,India
435956,2023-07-03,212,amul cheese,250,315,65,1,00091,India
619873,2023-07-03,207,coca cola,75,100,25,1,00412,India
619873,2023-07-03,202,milk,12,27,15,1,00412,India
619873,2023-07-03,210,mountain dew,75,100,25,1,00412,India
416089,2023-07-03,207,coca cola,75,100,25,1,00253,India
416089,2023-07-03,210,mountain dew,75,100,25,1,00253,India
416089,2023-07-03,209,pepsi,75,100,25,1,00253,India
349286,2023-07-03,205,classic yogurt,45,60,15,1,00024,India
349286,2023-07-03,204,strawberry yogurt,50,60,10,1,00024,India
349286,2023-07-03,212,amul cheese,250,315,65,1,00024,India
960782,2023-07-03,203,mango yogurt,50,60,10,1,00380,India
960782,2023-07-03,212,amul cheese,250,315,65,1,00380,India
960782,2023-07-03,210,mountain dew,75,100,25,1,00380,India
960782,2023-07-03,204,strawberry yogurt,50,60,10,1,00380,India
335517,2023-07-03,202,milk,12,27,15,1,00141,India
335517,2023-07-03,203,mango yogurt,50,60,10,1,00141,India
562216,2023-07-03,206,yakult,360,400,40,1,00037,India
562216,2023-07-03,209,pepsi,75,100,25,1,00037,India
562216,2023-07-03,201,paneer,210,340,130,1,00037,India
562216,2023-07-03,213,bisleri,6,15,9,1,00037,India
562216,2023-07-03,203,mango yogurt,50,60,10,1,00037,India
814717,2023-07-03,209,pepsi,75,100,25,1,00177,India
814717,2023-07-03,206,yakult,360,400,40,1,00177,India
119661,2023-07-03,204,strawberry yogurt,50,60,10,1,00405,India
119661,2023-07-03,212,amul cheese,250,315,65,1,00405,India
516519,2023-07-03,205,classic yogurt,45,60,15,1,00113,India
516519,2023-07-03,210,mountain dew,75,100,25,1,00113,India
516519,2023-07-03,211,red bull,90,125,35,1,00113,India
516519,2023-07-03,207,coca cola,75,100,25,1,00113,India
632235,2023-07-03,211,red bull,90,125,35,1,00046,India
854225,2023-07-03,209,pepsi,75,100,25,1,00116,India
437522,2023-07-03,206,yakult,360,400,40,1,00304,India
437522,2023-07-03,203,mango yogurt,50,60,10,1,00304,India
437522,2023-07-03,213,bisleri,6,15,9,1,00304,India
437522,2023-07-03,201,paneer,210,340,130,1,00304,India
988771,2023-07-03,212,amul cheese,250,315,65,1,00021,India
988771,2023-07-03,201,paneer,210,340,130,1,00021,India
988771,2023-07-03,209,pepsi,75,100,25,1,00021,India
545263,2023-07-03,204,strawberry yogurt,50,60,10,1,00455,India
545263,2023-07-03,206,yakult,360,400,40,1,00455,India
545263,2023-07-03,211,red bull,90,125,35,1,00455,India
795406,2023-07-03,206,yakult,360,400,40,1,00169,India
795406,2023-07-03,211,red bull,90,125,35,1,00169,India
795406,2023-07-03,209,pepsi,75,100,25,1,00169,India
327327,2023-07-03,213,bisleri,6,15,9,1,00230,India
718344,2023-07-03,207,coca cola,75,100,25,1,00019,India
718344,2023-07-03,209,pepsi,75,100,25,1,00019,India
718344,2023-07-03,204,strawberry yogurt,50,60,10,1,00019,India
362390,2023-07-03,206,yakult,360,400,40,1,00254,India
362390,2023-07-03,210,mountain dew,75,100,25,1,00254,India
362390,2023-07-03,211,red bull,90,125,35,1,00254,India
362390,2023-07-03,208,sprite,75,100,25,1,00254,India
690650,2023-07-03,202,milk,12,27,15,1,00137,India
690650,2023-07-03,207,coca cola,75,100,25,1,00137,India
690650,2023-07-03,209,pepsi,75,100,25,1,00137,India
758686,2023-07-03,204,strawberry yogurt,50,60,10,1,00462,India
646410,2023-07-03,206,yakult,360,400,40,1,00333,India
646410,2023-07-03,209,pepsi,75,100,25,1,00333,India
103341,2023-07-04,212,amul cheese,250,315,65,1,00267,India
103341,2023-07-04,210,mountain dew,75,100,25,1,00267,India
103341,2023-07-04,208,sprite,75,100,25,1,00267,India
879827,2023-07-04,212,amul cheese,250,315,65,1,00028,India
879827,2023-07-04,206,yakult,360,400,40,1,00028,India
879827,2023-07-04,207,coca cola,75,100,25,1,00028,India
579619,2023-07-04,209,pepsi,75,100,25,1,00067,India
579619,2023-07-04,206,yakult,360,400,40,1,00067,India
579619,2023-07-04,211,red bull,90,125,35,1,00067,India
268397,2023-07-04,202,milk,12,27,15,1,00313,India
268397,2023-07-04,209,pepsi,75,100,25,1,00313,India
400663,2023-07-04,212,amul cheese,250,315,65,1,00358,India
400663,2023-07-04,203,mango yogurt,50,60,10,1,00358,India
400663,2023-07-04,201,paneer,210,340,130,1,00358,India
941671,2023-07-04,204,strawberry yogurt,50,60,10,1,00036,India
941671,2023-07-04,206,yakult,360,400,40,1,00036,India
800362,2023-07-04,213,bisleri,6,15,9,1,00103,India
800362,2023-07-04,211,red bull,90,125,35,1,00103,India
548862,2023-07-04,201,paneer,210,340,130,1,00148,India
548862,2023-07-04,206,yakult,360,400,40,1,00148,India
548862,2023-07-04,212,amul cheese,250,315,65,1,00148,India
548862,2023-07-04,208,sprite,75,100,25,1,00148,India
548862,2023-07-04,205,classic yogurt,45,60,15,1,00148,India
211080,2023-07-04,206,yakult,360,400,40,1,00381,India
211080,2023-07-04,209,pepsi,75,100,25,1,00381,India
211080,2023-07-04,201,paneer,210,340,130,1,00381,India
127092,2023-07-04,211,red bull,90,125,35,1,00431,India
127092,2023-07-04,207,coca cola,75,100,25,1,00431,India
127092,2023-07-04,209,pepsi,75,100,25,1,00431,India
848343,2023-07-04,209,pepsi,75,100,25,1,00044,India
539317,2023-07-04,210,mountain dew,75,100,25,1,00468,India
539317,2023-07-04,206,yakult,360,400,40,1,00468,India
539317,2023-07-04,213,bisleri,6,15,9,1,00468,India
100298,2023-07-04,204,strawberry yogurt,50,60,10,1,00161,India
100298,2023-07-04,210,mountain dew,75,100,25,1,00161,India
100298,2023-07-04,207,coca cola,75,100,25,1,00161,India
633549,2023-07-04,205,classic yogurt,45,60,15,1,00152,India
633549,2023-07-04,209,pepsi,75,100,25,1,00152,India
633549,2023-07-04,208,sprite,75,100,25,1,00152,India
633549,2023-07-04,210,mountain dew,75,100,25,1,00152,India
509726,2023-07-04,212,amul cheese,250,315,65,1,00139,India
509726,2023-07-04,213,bisleri,6,15,9,1,00139,India
884167,2023-07-04,211,red bull,90,125,35,1,00225,India
884167,2023-07-04,205,classic yogurt,45,60,15,1,00225,India
884167,2023-07-04,212,amul cheese,250,315,65,1,00225,India
835386,2023-07-04,209,pepsi,75,100,25,1,00322,India
835386,2023-07-04,201,paneer,210,340,130,1,00322,India
835386,2023-07-04,210,mountain dew,75,100,25,1,00322,India
906324,2023-07-04,210,mountain dew,75,100,25,1,00248,India
906324,2023-07-04,202,milk,12,27,15,1,00248,India
906324,2023-07-04,201,paneer,210,340,130,1,00248,India
906324,2023-07-04,207,coca cola,75,100,25,1,00248,India
813842,2023-07-04,206,yakult,360,400,40,1,00145,India
813842,2023-07-04,202,milk,12,27,15,1,00145,India
761048,2023-07-04,204,strawberry yogurt,50,60,10,1,00274,India
761048,2023-07-04,210,mountain dew,75,100,25,1,00274,India
761048,2023-07-04,207,coca cola,75,100,25,1,00274,India
761048,2023-07-04,203,mango yogurt,50,60,10,1,00274,India
761048,2023-07-04,208,sprite,75,100,25,1,00274,India
484507,2023-07-04,206,yakult,360,400,40,1,00237,India
484507,2023-07-04,203,mango yogurt,50,60,10,1,00237,India
880358,2023-07-04,212,amul cheese,250,315,65,1,00204,India
880358,2023-07-04,208,sprite,75,100,25,1,00204,India
880358,2023-07-04,203,mango yogurt,50,60,10,1,00204,India
880358,2023-07-04,211,red bull,90,125,35,1,00204,India
193917,2023-07-04,205,classic yogurt,45,60,15,1,00083,India
193917,2023-07-04,206,yakult,360,400,40,1,00083,India
193917,2023-07-04,201,paneer,210,340,130,1,00083,India
275762,2023-07-04,212,amul cheese,250,315,65,1,00189,India
275762,2023-07-04,207,coca cola,75,100,25,1,00189,India
275762,2023-07-04,213,bisleri,6,15,9,1,00189,India
275762,2023-07-04,211,red bull,90,125,35,1,00189,India
275762,2023-07-04,210,mountain dew,75,100,25,1,00189,India
130030,2023-07-04,208,sprite,75,100,25,1,00016,India
469394,2023-07-04,208,sprite,75,100,25,1,00368,India
469394,2023-07-04,203,mango yogurt,50,60,10,1,00368,India
469394,2023-07-04,205,classic yogurt,45,60,15,1,00368,India
469394,2023-07-04,202,milk,12,27,15,1,00368,India
674326,2023-07-04,203,mango yogurt,50,60,10,1,00041,India
674326,2023-07-04,202,milk,12,27,15,1,00041,India
674326,2023-07-04,213,bisleri,6,15,9,1,00041,India
897484,2023-07-04,211,red bull,90,125,35,1,00353,India
897484,2023-07-04,209,pepsi,75,100,25,1,00353,India
914477,2023-07-04,203,mango yogurt,50,60,10,1,00011,India
914477,2023-07-04,207,coca cola,75,100,25,1,00011,India
914477,2023-07-04,205,classic yogurt,45,60,15,1,00011,India
914477,2023-07-04,202,milk,12,27,15,1,00011,India
693085,2023-07-04,202,milk,12,27,15,1,00298,India
693085,2023-07-04,208,sprite,75,100,25,1,00298,India
693085,2023-07-04,210,mountain dew,75,100,25,1,00298,India
693085,2023-07-04,206,yakult,360,400,40,1,00298,India
781870,2023-07-04,209,pepsi,75,100,25,1,00268,India
781870,2023-07-04,213,bisleri,6,15,9,1,00268,India
230201,2023-07-04,205,classic yogurt,45,60,15,1,00286,India
230201,2023-07-04,203,mango yogurt,50,60,10,1,00286,India
230201,2023-07-04,204,strawberry yogurt,50,60,10,1,00286,India
230201,2023-07-04,213,bisleri,6,15,9,1,00286,India
974990,2023-07-04,206,yakult,360,400,40,1,00267,India
974990,2023-07-04,203,mango yogurt,50,60,10,1,00267,India
974990,2023-07-04,212,amul cheese,250,315,65,1,00267,India
994677,2023-07-04,207,coca cola,75,100,25,1,00299,India
994677,2023-07-04,210,mountain dew,75,100,25,1,00299,India
994677,2023-07-04,201,paneer,210,340,130,1,00299,India
331327,2023-07-04,206,yakult,360,400,40,1,00220,India
331327,2023-07-04,207,coca cola,75,100,25,1,00220,India
331327,2023-07-04,211,red bull,90,125,35,1,00220,India
169650,2023-07-04,202,milk,12,27,15,1,00396,India
169650,2023-07-04,201,paneer,210,340,130,1,00396,India
356297,2023-07-04,207,coca cola,75,100,25,1,00252,India
356297,2023-07-04,201,paneer,210,340,130,1,00252,India
541607,2023-07-04,210,mountain dew,75,100,25,1,00250,India
942668,2023-07-04,208,sprite,75,100,25,1,00203,India
208495,2023-07-04,207,coca cola,75,100,25,1,00324,India
208495,2023-07-04,211,red bull,90,125,35,1,00324,India
208495,2023-07-04,208,sprite,75,100,25,1,00324,India
208495,2023-07-04,210,mountain dew,75,100,25,1,00324,India
474804,2023-07-04,211,red bull,90,125,35,1,00289,India
474804,2023-07-04,207,coca cola,75,100,25,1,00289,India
474804,2023-07-04,212,amul cheese,250,315,65,1,00289,India
474804,2023-07-04,204,strawberry yogurt,50,60,10,1,00289,India
946243,2023-07-04,206,yakult,360,400,40,1,00138,India
946243,2023-07-04,207,coca cola,75,100,25,1,00138,India
946243,2023-07-04,202,milk,12,27,15,1,00138,India
946243,2023-07-04,201,paneer,210,340,130,1,00138,India
803293,2023-07-04,205,classic yogurt,45,60,15,1,00005,India
803293,2023-07-04,208,sprite,75,100,25,1,00005,India
803293,2023-07-04,211,red bull,90,125,35,1,00005,India
557630,2023-07-04,211,red bull,90,125,35,1,00381,India
557630,2023-07-04,213,bisleri,6,15,9,1,00381,India
557630,2023-07-04,203,mango yogurt,50,60,10,1,00381,India
557630,2023-07-04,212,amul cheese,250,315,65,1,00381,India
433581,2023-07-04,209,pepsi,75,100,25,1,00079,India
433581,2023-07-04,208,sprite,75,100,25,1,00079,India
433581,2023-07-04,207,coca cola,75,100,25,1,00079,India
433581,2023-07-04,213,bisleri,6,15,9,1,00079,India
306531,2023-07-04,202,milk,12,27,15,1,00450,India
306531,2023-07-04,201,paneer,210,340,130,1,00450,India
567828,2023-07-04,205,classic yogurt,45,60,15,1,00320,India
567828,2023-07-04,204,strawberry yogurt,50,60,10,1,00320,India
567828,2023-07-04,210,mountain dew,75,100,25,1,00320,India
641394,2023-07-04,212,amul cheese,250,315,65,1,00432,India
641394,2023-07-04,203,mango yogurt,50,60,10,1,00432,India
993736,2023-07-04,202,milk,12,27,15,1,00058,India
993736,2023-07-04,212,amul cheese,250,315,65,1,00058,India
993736,2023-07-04,203,mango yogurt,50,60,10,1,00058,India
240983,2023-07-04,203,mango yogurt,50,60,10,1,00090,India
572380,2023-07-04,201,paneer,210,340,130,1,00121,India
572380,2023-07-04,202,milk,12,27,15,1,00121,India
961611,2023-07-04,202,milk,12,27,15,1,00399,India
961611,2023-07-04,208,sprite,75,100,25,1,00399,India
478992,2023-07-05,206,yakult,360,400,40,1,00454,India
478992,2023-07-05,201,paneer,210,340,130,1,00454,India
478992,2023-07-05,212,amul cheese,250,315,65,1,00454,India
530758,2023-07-05,207,coca cola,75,100,25,1,00208,India
530758,2023-07-05,202,milk,12,27,15,1,00208,India
530758,2023-07-05,208,sprite,75,100,25,1,00208,India
206725,2023-07-05,208,sprite,75,100,25,1,00224,India
206725,2023-07-05,211,red bull,90,125,35,1,00224,India
689907,2023-07-05,213,bisleri,6,15,9,1,00310,India
689907,2023-07-05,210,mountain dew,75,100,25,1,00310,India
689907,2023-07-05,208,sprite,75,100,25,1,00310,India
689907,2023-07-05,205,classic yogurt,45,60,15,1,00310,India
689907,2023-07-05,201,paneer,210,340,130,1,00310,India
195171,2023-07-05,212,amul cheese,250,315,65,1,00434,India
195171,2023-07-05,209,pepsi,75,100,25,1,00434,India
932188,2023-07-05,202,milk,12,27,15,1,00056,India
932188,2023-07-05,207,coca cola,75,100,25,1,00056,India
932188,2023-07-05,212,amul cheese,250,315,65,1,00056,India
932188,2023-07-05,211,red bull,90,125,35,1,00056,India
294376,2023-07-05,207,coca cola,75,100,25,1,00086,India
294376,2023-07-05,210,mountain dew,75,100,25,1,00086,India
162605,2023-07-05,211,red bull,90,125,35,1,00097,India
162605,2023-07-05,206,yakult,360,400,40,1,00097,India
162605,2023-07-05,205,classic yogurt,45,60,15,1,00097,India
162605,2023-07-05,213,bisleri,6,15,9,1,00097,India
162605,2023-07-05,212,amul cheese,250,315,65,1,00097,India
117601,2023-07-05,205,classic yogurt,45,60,15,1,00390,India
117601,2023-07-05,204,strawberry yogurt,50,60,10,1,00390,India
221682,2023-07-05,201,paneer,210,340,130,1,00273,India
221682,2023-07-05,213,bisleri,6,15,9,1,00273,India
221682,2023-07-05,209,pepsi,75,100,25,1,00273,India
221682,2023-07-05,207,coca cola,75,100,25,1,00273,India
923964,2023-07-05,208,sprite,75,100,25,1,00264,India
923964,2023-07-05,203,mango yogurt,50,60,10,1,00264,India
463801,2023-07-05,210,mountain dew,75,100,25,1,00317,India
463801,2023-07-05,205,classic yogurt,45,60,15,1,00317,India
463801,2023-07-05,204,strawberry yogurt,50,60,10,1,00317,India
628746,2023-07-05,209,pepsi,75,100,25,1,00396,India
628746,2023-07-05,208,sprite,75,100,25,1,00396,India
628746,2023-07-05,203,mango yogurt,50,60,10,1,00396,India
628746,2023-07-05,212,amul cheese,250,315,65,1,00396,India
628746,2023-07-05,207,coca cola,75,100,25,1,00396,India
426422,2023-07-05,204,strawberry yogurt,50,60,10,1,00129,India
426422,2023-07-05,206,yakult,360,400,40,1,00129,India
426422,2023-07-05,202,milk,12,27,15,1,00129,India
853955,2023-07-05,208,sprite,75,100,25,1,00036,India
853955,2023-07-05,201,paneer,210,340,130,1,00036,India
853955,2023-07-05,207,coca cola,75,100,25,1,00036,India
853955,2023-07-05,202,milk,12,27,15,1,00036,India
853955,2023-07-05,204,strawberry yogurt,50,60,10,1,00036,India
501638,2023-07-05,211,red bull,90,125,35,1,00403,India
501638,2023-07-05,204,strawberry yogurt,50,60,10,1,00403,India
501638,2023-07-05,208,sprite,75,100,25,1,00403,India
613610,2023-07-05,212,amul cheese,250,315,65,1,00168,India
991710,2023-07-05,207,coca cola,75,100,25,1,00011,India
991710,2023-07-05,202,milk,12,27,15,1,00011,India
581257,2023-07-05,213,bisleri,6,15,9,1,00197,India
104275,2023-07-05,209,pepsi,75,100,25,1,00441,India
104275,2023-07-05,213,bisleri,6,15,9,1,00441,India
104275,2023-07-05,202,milk,12,27,15,1,00441,India
104275,2023-07-05,201,paneer,210,340,130,1,00441,India
104275,2023-07-05,211,red bull,90,125,35,1,00441,India
626565,2023-07-05,203,mango yogurt,50,60,10,1,00005,India
626565,2023-07-05,213,bisleri,6,15,9,1,00005,India
626565,2023-07-05,208,sprite,75,100,25,1,00005,India
626565,2023-07-05,206,yakult,360,400,40,1,00005,India
626565,2023-07-05,211,red bull,90,125,35,1,00005,India
732154,2023-07-05,208,sprite,75,100,25,1,00187,India
732154,2023-07-05,203,mango yogurt,50,60,10,1,00187,India
732154,2023-07-05,212,amul cheese,250,315,65,1,00187,India
317846,2023-07-05,206,yakult,360,400,40,1,00256,India
747500,2023-07-05,202,milk,12,27,15,1,00135,India
747500,2023-07-05,212,amul cheese,250,315,65,1,00135,India
747500,2023-07-05,203,mango yogurt,50,60,10,1,00135,India
747500,2023-07-05,205,classic yogurt,45,60,15,1,00135,India
880904,2023-07-05,209,pepsi,75,100,25,1,00229,India
880904,2023-07-05,207,coca cola,75,100,25,1,00229,India
880904,2023-07-05,210,mountain dew,75,100,25,1,00229,India
880904,2023-07-05,206,yakult,360,400,40,1,00229,India
775763,2023-07-05,207,coca cola,75,100,25,1,00404,India
775763,2023-07-05,212,amul cheese,250,315,65,1,00404,India
775763,2023-07-05,211,red bull,90,125,35,1,00404,India
212664,2023-07-05,202,milk,12,27,15,1,00283,India
212664,2023-07-05,206,yakult,360,400,40,1,00283,India
212664,2023-07-05,213,bisleri,6,15,9,1,00283,India
212664,2023-07-05,201,paneer,210,340,130,1,00283,India
812156,2023-07-05,204,strawberry yogurt,50,60,10,1,00018,India
812156,2023-07-05,209,pepsi,75,100,25,1,00018,India
812156,2023-07-05,213,bisleri,6,15,9,1,00018,India
812156,2023-07-05,203,mango yogurt,50,60,10,1,00018,India
111577,2023-07-05,201,paneer,210,340,130,1,00350,India
527284,2023-07-05,207,coca cola,75,100,25,1,00397,India
527284,2023-07-05,212,amul cheese,250,315,65,1,00397,India
527284,2023-07-05,210,mountain dew,75,100,25,1,00397,India
507129,2023-07-05,204,strawberry yogurt,50,60,10,1,00433,India
507129,2023-07-05,212,amul cheese,250,315,65,1,00433,India
507129,2023-07-05,210,mountain dew,75,100,25,1,00433,India
507129,2023-07-05,208,sprite,75,100,25,1,00433,India
413748,2023-07-05,203,mango yogurt,50,60,10,1,00373,India
413748,2023-07-05,204,strawberry yogurt,50,60,10,1,00373,India
413748,2023-07-05,209,pepsi,75,100,25,1,00373,India
441470,2023-07-05,210,mountain dew,75,100,25,1,00343,India
558671,2023-07-05,204,strawberry yogurt,50,60,10,1,00205,India
558671,2023-07-05,201,paneer,210,340,130,1,00205,India
558671,2023-07-05,208,sprite,75,100,25,1,00205,India
206490,2023-07-05,201,paneer,210,340,130,1,00257,India
206490,2023-07-05,207,coca cola,75,100,25,1,00257,India
206490,2023-07-05,213,bisleri,6,15,9,1,00257,India
335030,2023-07-05,206,yakult,360,400,40,1,00195,India
335030,2023-07-05,201,paneer,210,340,130,1,00195,India
335030,2023-07-05,204,strawberry yogurt,50,60,10,1,00195,India
335030,2023-07-05,202,milk,12,27,15,1,00195,India
335030,2023-07-05,208,sprite,75,100,25,1,00195,India
954814,2023-07-05,203,mango yogurt,50,60,10,1,00445,India
485440,2023-07-05,201,paneer,210,340,130,1,00097,India
485440,2023-07-05,211,red bull,90,125,35,1,00097,India
485440,2023-07-05,210,mountain dew,75,100,25,1,00097,India
543175,2023-07-05,210,mountain dew,75,100,25,1,00130,India
390468,2023-07-05,210,mountain dew,75,100,25,1,00206,India
390468,2023-07-05,205,classic yogurt,45,60,15,1,00206,India
390468,2023-07-05,203,mango yogurt,50,60,10,1,00206,India
414492,2023-07-05,206,yakult,360,400,40,1,00146,India
414492,2023-07-05,204,strawberry yogurt,50,60,10,1,00146,India
414492,2023-07-05,211,red bull,90,125,35,1,00146,India
414492,2023-07-05,201,paneer,210,340,130,1,00146,India
558815,2023-07-05,203,mango yogurt,50,60,10,1,00017,India
558815,2023-07-05,213,bisleri,6,15,9,1,00017,India
558815,2023-07-05,207,coca cola,75,100,25,1,00017,India
731001,2023-07-05,212,amul cheese,250,315,65,1,00365,India
731001,2023-07-05,208,sprite,75,100,25,1,00365,India
175624,2023-07-05,213,bisleri,6,15,9,1,00042,India
920110,2023-07-05,205,classic yogurt,45,60,15,1,00053,India
467623,2023-07-05,203,mango yogurt,50,60,10,1,00181,India
467623,2023-07-05,205,classic yogurt,45,60,15,1,00181,India
467623,2023-07-05,208,sprite,75,100,25,1,00181,India
467623,2023-07-05,206,yakult,360,400,40,1,00181,India
251151,2023-07-05,211,red bull,90,125,35,1,00218,India
189370,2023-07-05,208,sprite,75,100,25,1,00297,India
189370,2023-07-05,205,classic yogurt,45,60,15,1,00297,India
708886,2023-07-05,211,red bull,90,125,35,1,00018,India
346786,2023-07-05,211,red bull,90,125,35,1,00018,India
346786,2023-07-05,204,strawberry yogurt,50,60,10,1,00018,India
750054,2023-07-05,201,paneer,210,340,130,1,00474,India
768066,2023-07-05,212,amul cheese,250,315,65,1,00058,India
757328,2023-07-05,208,sprite,75,100,25,1,00234,India
757328,2023-07-05,211,red bull,90,125,35,1,00234,India
551856,2023-07-05,207,coca cola,75,100,25,1,00478,India
551856,2023-07-05,204,strawberry yogurt,50,60,10,1,00478,India
551856,2023-07-05,211,red bull,90,125,35,1,00478,India
624021,2023-07-05,203,mango yogurt,50,60,10,1,00386,India
624021,2023-07-05,207,coca cola,75,100,25,1,00386,India
624021,2023-07-05,204,strawberry yogurt,50,60,10,1,00386,India
422970,2023-07-05,209,pepsi,75,100,25,1,00266,India
422970,2023-07-05,208,sprite,75,100,25,1,00266,India
233104,2023-07-05,212,amul cheese,250,315,65,1,00434,India
233104,2023-07-05,211,red bull,90,125,35,1,00434,India
233104,2023-07-05,207,coca cola,75,100,25,1,00434,India
719487,2023-07-05,204,strawberry yogurt,50,60,10,1,00304,India
719487,2023-07-05,211,red bull,90,125,35,1,00304,India
719487,2023-07-05,213,bisleri,6,15,9,1,00304,India
719487,2023-07-05,212,amul cheese,250,315,65,1,00304,India
821840,2023-07-05,202,milk,12,27,15,1,00232,India
523654,2023-07-05,211,red bull,90,125,35,1,00199,India
268332,2023-07-05,213,bisleri,6,15,9,1,00233,India
268332,2023-07-05,211,red bull,90,125,35,1,00233,India
268332,2023-07-05,209,pepsi,75,100,25,1,00233,India
268332,2023-07-05,206,yakult,360,400,40,1,00233,India
268332,2023-07-05,208,sprite,75,100,25,1,00233,India
310101,2023-07-05,201,paneer,210,340,130,1,00086,India
310101,2023-07-05,211,red bull,90,125,35,1,00086,India
310101,2023-07-05,209,pepsi,75,100,25,1,00086,India
310101,2023-07-05,202,milk,12,27,15,1,00086,India
310101,2023-07-05,203,mango yogurt,50,60,10,1,00086,India
347097,2023-07-05,212,amul cheese,250,315,65,1,00179,India
347097,2023-07-05,201,paneer,210,340,130,1,00179,India
325204,2023-07-05,211,red bull,90,125,35,1,00333,India
291168,2023-07-05,202,milk,12,27,15,1,00071,India
992359,2023-07-05,205,classic yogurt,45,60,15,1,00229,India
992359,2023-07-05,209,pepsi,75,100,25,1,00229,India
194242,2023-07-05,201,paneer,210,340,130,1,00315,India
494689,2023-07-05,207,coca cola,75,100,25,1,00235,India
494689,2023-07-05,208,sprite,75,100,25,1,00235,India
494689,2023-07-05,201,paneer,210,340,130,1,00235,India
440408,2023-07-05,206,yakult,360,400,40,1,00113,India
440408,2023-07-05,213,bisleri,6,15,9,1,00113,India
440408,2023-07-05,204,strawberry yogurt,50,60,10,1,00113,India
948952,2023-07-05,202,milk,12,27,15,1,00343,India
948952,2023-07-05,203,mango yogurt,50,60,10,1,00343,India
948952,2023-07-05,206,yakult,360,400,40,1,00343,India
692071,2023-07-05,202,milk,12,27,15,1,00276,India
692071,2023-07-05,210,mountain dew,75,100,25,1,00276,India
692071,2023-07-05,209,pepsi,75,100,25,1,00276,India
209145,2023-07-05,204,strawberry yogurt,50,60,10,1,00131,India
209145,2023-07-05,206,yakult,360,400,40,1,00131,India
198029,2023-07-05,201,paneer,210,340,130,1,00095,India
526793,2023-07-05,211,red bull,90,125,35,1,00267,India
526793,2023-07-05,202,milk,12,27,15,1,00267,India
526793,2023-07-05,204,strawberry yogurt,50,60,10,1,00267,India
526793,2023-07-05,201,paneer,210,340,130,1,00267,India
655783,2023-07-05,207,coca cola,75,100,25,1,00322,India
655783,2023-07-05,206,yakult,360,400,40,1,00322,India
655783,2023-07-05,210,mountain dew,75,100,25,1,00322,India
697721,2023-07-05,212,amul cheese,250,315,65,1,00089,India
616904,2023-07-05,207,coca cola,75,100,25,1,00292,India
616904,2023-07-05,204,strawberry yogurt,50,60,10,1,00292,India
616904,2023-07-05,206,yakult,360,400,40,1,00292,India
616904,2023-07-05,208,sprite,75,100,25,1,00292,India
349446,2023-07-05,203,mango yogurt,50,60,10,1,00206,India
349446,2023-07-05,209,pepsi,75,100,25,1,00206,India
525747,2023-07-05,201,paneer,210,340,130,1,00368,India
525747,2023-07-05,204,strawberry yogurt,50,60,10,1,00368,India
525747,2023-07-05,210,mountain dew,75,100,25,1,00368,India
525747,2023-07-05,213,bisleri,6,15,9,1,00368,India
441732,2023-07-05,206,yakult,360,400,40,1,00307,India
441732,2023-07-05,212,amul cheese,250,315,65,1,00307,India
868450,2023-07-05,201,paneer,210,340,130,1,00440,India
868450,2023-07-05,208,sprite,75,100,25,1,00440,India
571153,2023-07-05,204,strawberry yogurt,50,60,10,1,00475,India
660074,2023-07-05,205,classic yogurt,45,60,15,1,00357,India
660074,2023-07-05,201,paneer,210,340,130,1,00357,India
171715,2023-07-05,207,coca cola,75,100,25,1,00048,India
171715,2023-07-05,203,mango yogurt,50,60,10,1,00048,India
171715,2023-07-05,212,amul cheese,250,315,65,1,00048,India
462973,2023-07-05,207,coca cola,75,100,25,1,00432,India
462973,2023-07-05,212,amul cheese,250,315,65,1,00432,India
690297,2023-07-05,208,sprite,75,100,25,1,00479,India
690297,2023-07-05,210,mountain dew,75,100,25,1,00479,India
690297,2023-07-05,212,amul cheese,250,315,65,1,00479,India
690297,2023-07-05,213,bisleri,6,15,9,1,00479,India
500645,2023-07-05,202,milk,12,27,15,1,00052,India
500645,2023-07-05,203,mango yogurt,50,60,10,1,00052,India
500645,2023-07-05,209,pepsi,75,100,25,1,00052,India
500645,2023-07-05,208,sprite,75,100,25,1,00052,India
620774,2023-07-05,209,pepsi,75,100,25,1,00446,India
398534,2023-07-05,206,yakult,360,400,40,1,00329,India
398534,2023-07-05,213,bisleri,6,15,9,1,00329,India
398534,2023-07-05,202,milk,12,27,15,1,00329,India
398534,2023-07-05,212,amul cheese,250,315,65,1,00329,India
309458,2023-07-06,209,pepsi,75,100,25,1,00027,India
380596,2023-07-06,207,coca cola,75,100,25,1,00438,India
112233,2023-07-06,211,red bull,90,125,35,1,00041,India
112233,2023-07-06,212,amul cheese,250,315,65,1,00041,India
922519,2023-07-06,211,red bull,90,125,35,1,00020,India
448905,2023-07-06,208,sprite,75,100,25,1,00129,India
448905,2023-07-06,204,strawberry yogurt,50,60,10,1,00129,India
448905,2023-07-06,206,yakult,360,400,40,1,00129,India
448905,2023-07-06,209,pepsi,75,100,25,1,00129,India
526539,2023-07-06,207,coca cola,75,100,25,1,00346,India
526539,2023-07-06,205,classic yogurt,45,60,15,1,00346,India
526539,2023-07-06,208,sprite,75,100,25,1,00346,India
526539,2023-07-06,204,strawberry yogurt,50,60,10,1,00346,India
600993,2023-07-06,212,amul cheese,250,315,65,1,00305,India
600993,2023-07-06,205,classic yogurt,45,60,15,1,00305,India
600993,2023-07-06,203,mango yogurt,50,60,10,1,00305,India
600993,2023-07-06,201,paneer,210,340,130,1,00305,India
942299,2023-07-06,201,paneer,210,340,130,1,00190,India
517781,2023-07-06,213,bisleri,6,15,9,1,00330,India
517781,2023-07-06,205,classic yogurt,45,60,15,1,00330,India
517781,2023-07-06,209,pepsi,75,100,25,1,00330,India
517781,2023-07-06,211,red bull,90,125,35,1,00330,India
517781,2023-07-06,210,mountain dew,75,100,25,1,00330,India
338522,2023-07-06,201,paneer,210,340,130,1,00348,India
338522,2023-07-06,212,amul cheese,250,315,65,1,00348,India
338522,2023-07-06,208,sprite,75,100,25,1,00348,India
581263,2023-07-06,208,sprite,75,100,25,1,00191,India
581263,2023-07-06,204,strawberry yogurt,50,60,10,1,00191,India
807402,2023-07-06,212,amul cheese,250,315,65,1,00335,India
484644,2023-07-06,210,mountain dew,75,100,25,1,00312,India
484644,2023-07-06,211,red bull,90,125,35,1,00312,India
484644,2023-07-06,202,milk,12,27,15,1,00312,India
825435,2023-07-06,205,classic yogurt,45,60,15,1,00140,India
825435,2023-07-06,203,mango yogurt,50,60,10,1,00140,India
825435,2023-07-06,212,amul cheese,250,315,65,1,00140,India
825435,2023-07-06,206,yakult,360,400,40,1,00140,India
339268,2023-07-06,202,milk,12,27,15,1,00146,India
339268,2023-07-06,210,mountain dew,75,100,25,1,00146,India
513599,2023-07-06,209,pepsi,75,100,25,1,00484,India
513599,2023-07-06,206,yakult,360,400,40,1,00484,India
741001,2023-07-06,212,amul cheese,250,315,65,1,00423,India
741001,2023-07-06,209,pepsi,75,100,25,1,00423,India
576939,2023-07-06,204,strawberry yogurt,50,60,10,1,00086,India
576939,2023-07-06,211,red bull,90,125,35,1,00086,India
576939,2023-07-06,207,coca cola,75,100,25,1,00086,India
576939,2023-07-06,202,milk,12,27,15,1,00086,India
576939,2023-07-06,201,paneer,210,340,130,1,00086,India
694933,2023-07-06,207,coca cola,75,100,25,1,00028,India
694933,2023-07-06,212,amul cheese,250,315,65,1,00028,India
694933,2023-07-06,203,mango yogurt,50,60,10,1,00028,India
865469,2023-07-06,203,mango yogurt,50,60,10,1,00490,India
603261,2023-07-06,205,classic yogurt,45,60,15,1,00263,India
367796,2023-07-06,201,paneer,210,340,130,1,00072,India
367796,2023-07-06,212,amul cheese,250,315,65,1,00072,India
367796,2023-07-06,210,mountain dew,75,100,25,1,00072,India
367796,2023-07-06,205,classic yogurt,45,60,15,1,00072,India
513561,2023-07-06,205,classic yogurt,45,60,15,1,00325,India
513561,2023-07-06,206,yakult,360,400,40,1,00325,India
513561,2023-07-06,207,coca cola,75,100,25,1,00325,India
513561,2023-07-06,211,red bull,90,125,35,1,00325,India
877203,2023-07-06,213,bisleri,6,15,9,1,00207,India
877203,2023-07-06,212,amul cheese,250,315,65,1,00207,India
877203,2023-07-06,206,yakult,360,400,40,1,00207,India
877203,2023-07-06,211,red bull,90,125,35,1,00207,India
186711,2023-07-06,213,bisleri,6,15,9,1,00226,India
186711,2023-07-06,206,yakult,360,400,40,1,00226,India
186711,2023-07-06,210,mountain dew,75,100,25,1,00226,India
186711,2023-07-06,203,mango yogurt,50,60,10,1,00226,India
135374,2023-07-06,204,strawberry yogurt,50,60,10,1,00356,India
135374,2023-07-06,201,paneer,210,340,130,1,00356,India
135374,2023-07-06,211,red bull,90,125,35,1,00356,India
245228,2023-07-06,201,paneer,210,340,130,1,00311,India
245228,2023-07-06,212,amul cheese,250,315,65,1,00311,India
245228,2023-07-06,210,mountain dew,75,100,25,1,00311,India
245228,2023-07-06,213,bisleri,6,15,9,1,00311,India
323873,2023-07-06,209,pepsi,75,100,25,1,00443,India
360329,2023-07-06,211,red bull,90,125,35,1,00213,India
360329,2023-07-06,212,amul cheese,250,315,65,1,00213,India
731453,2023-07-06,201,paneer,210,340,130,1,00089,India
731453,2023-07-06,205,classic yogurt,45,60,15,1,00089,India
731453,2023-07-06,207,coca cola,75,100,25,1,00089,India
731453,2023-07-06,209,pepsi,75,100,25,1,00089,India
203596,2023-07-06,205,classic yogurt,45,60,15,1,00170,India
203596,2023-07-06,212,amul cheese,250,315,65,1,00170,India
203596,2023-07-06,201,paneer,210,340,130,1,00170,India
203596,2023-07-06,203,mango yogurt,50,60,10,1,00170,India
203596,2023-07-06,207,coca cola,75,100,25,1,00170,India
128475,2023-07-06,211,red bull,90,125,35,1,00237,India
423259,2023-07-06,213,bisleri,6,15,9,1,00268,India
423259,2023-07-06,202,milk,12,27,15,1,00268,India
423259,2023-07-06,206,yakult,360,400,40,1,00268,India
423259,2023-07-06,204,strawberry yogurt,50,60,10,1,00268,India
279887,2023-07-06,207,coca cola,75,100,25,1,00383,India
279887,2023-07-06,206,yakult,360,400,40,1,00383,India
509940,2023-07-06,213,bisleri,6,15,9,1,00120,India
755486,2023-07-06,201,paneer,210,340,130,1,00012,India
852250,2023-07-06,202,milk,12,27,15,1,00470,India
852250,2023-07-06,207,coca cola,75,100,25,1,00470,India
852250,2023-07-06,205,classic yogurt,45,60,15,1,00470,India
852250,2023-07-06,208,sprite,75,100,25,1,00470,India
939759,2023-07-06,202,milk,12,27,15,1,00330,India
939759,2023-07-06,210,mountain dew,75,100,25,1,00330,India
939759,2023-07-06,211,red bull,90,125,35,1,00330,India
335550,2023-07-06,203,mango yogurt,50,60,10,1,00197,India
114243,2023-07-06,211,red bull,90,125,35,1,00229,India
114243,2023-07-06,201,paneer,210,340,130,1,00229,India
114243,2023-07-06,210,mountain dew,75,100,25,1,00229,India
433708,2023-07-06,203,mango yogurt,50,60,10,1,00226,India
433708,2023-07-06,201,paneer,210,340,130,1,00226,India
433708,2023-07-06,206,yakult,360,400,40,1,00226,India
433708,2023-07-06,211,red bull,90,125,35,1,00226,India
162528,2023-07-06,209,pepsi,75,100,25,1,00282,India
162528,2023-07-06,206,yakult,360,400,40,1,00282,India
162528,2023-07-06,202,milk,12,27,15,1,00282,India
198388,2023-07-06,211,red bull,90,125,35,1,00232,India
198388,2023-07-06,212,amul cheese,250,315,65,1,00232,India
198388,2023-07-06,202,milk,12,27,15,1,00232,India
688280,2023-07-06,210,mountain dew,75,100,25,1,00484,India
688280,2023-07-06,203,mango yogurt,50,60,10,1,00484,India
688280,2023-07-06,205,classic yogurt,45,60,15,1,00484,India
122409,2023-07-06,205,classic yogurt,45,60,15,1,00363,India
122409,2023-07-06,208,sprite,75,100,25,1,00363,India
256996,2023-07-06,201,paneer,210,340,130,1,00338,India
256996,2023-07-06,208,sprite,75,100,25,1,00338,India
283862,2023-07-06,208,sprite,75,100,25,1,00151,India
607705,2023-07-06,205,classic yogurt,45,60,15,1,00056,India
607705,2023-07-06,206,yakult,360,400,40,1,00056,India
607705,2023-07-06,212,amul cheese,250,315,65,1,00056,India
838411,2023-07-06,201,paneer,210,340,130,1,00175,India
498163,2023-07-06,211,red bull,90,125,35,1,00073,India
498163,2023-07-06,206,yakult,360,400,40,1,00073,India
498163,2023-07-06,203,mango yogurt,50,60,10,1,00073,India
498163,2023-07-06,207,coca cola,75,100,25,1,00073,India
142309,2023-07-06,210,mountain dew,75,100,25,1,00212,India
222651,2023-07-06,205,classic yogurt,45,60,15,1,00220,India
222651,2023-07-06,209,pepsi,75,100,25,1,00220,India
222651,2023-07-06,203,mango yogurt,50,60,10,1,00220,India
375052,2023-07-06,206,yakult,360,400,40,1,00462,India
375052,2023-07-06,207,coca cola,75,100,25,1,00462,India
375052,2023-07-06,201,paneer,210,340,130,1,00462,India
118352,2023-07-06,204,strawberry yogurt,50,60,10,1,00264,India
118352,2023-07-06,206,yakult,360,400,40,1,00264,India
118352,2023-07-06,205,classic yogurt,45,60,15,1,00264,India
646211,2023-07-07,210,mountain dew,75,100,25,1,00340,India
646211,2023-07-07,209,pepsi,75,100,25,1,00340,India
646211,2023-07-07,212,amul cheese,250,315,65,1,00340,India
646211,2023-07-07,206,yakult,360,400,40,1,00340,India
790786,2023-07-07,206,yakult,360,400,40,1,00231,India
790786,2023-07-07,201,paneer,210,340,130,1,00231,India
790786,2023-07-07,212,amul cheese,250,315,65,1,00231,India
969560,2023-07-07,210,mountain dew,75,100,25,1,00192,India
329658,2023-07-07,209,pepsi,75,100,25,1,00033,India
329658,2023-07-07,208,sprite,75,100,25,1,00033,India
329658,2023-07-07,202,milk,12,27,15,1,00033,India
329658,2023-07-07,207,coca cola,75,100,25,1,00033,India
329658,2023-07-07,213,bisleri,6,15,9,1,00033,India
307345,2023-07-07,209,pepsi,75,100,25,1,00348,India
828726,2023-07-07,205,classic yogurt,45,60,15,1,00215,India
828726,2023-07-07,206,yakult,360,400,40,1,00215,India
828726,2023-07-07,207,coca cola,75,100,25,1,00215,India
859173,2023-07-07,209,pepsi,75,100,25,1,00347,India
859173,2023-07-07,201,paneer,210,340,130,1,00347,India
859173,2023-07-07,208,sprite,75,100,25,1,00347,India
859173,2023-07-07,210,mountain dew,75,100,25,1,00347,India
884354,2023-07-07,208,sprite,75,100,25,1,00212,India
884354,2023-07-07,213,bisleri,6,15,9,1,00212,India
884354,2023-07-07,209,pepsi,75,100,25,1,00212,India
884354,2023-07-07,205,classic yogurt,45,60,15,1,00212,India
202697,2023-07-07,206,yakult,360,400,40,1,00253,India
202697,2023-07-07,203,mango yogurt,50,60,10,1,00253,India
202697,2023-07-07,204,strawberry yogurt,50,60,10,1,00253,India
699925,2023-07-07,206,yakult,360,400,40,1,00172,India
699925,2023-07-07,209,pepsi,75,100,25,1,00172,India
699925,2023-07-07,204,strawberry yogurt,50,60,10,1,00172,India
699925,2023-07-07,203,mango yogurt,50,60,10,1,00172,India
687406,2023-07-07,207,coca cola,75,100,25,1,00457,India
687406,2023-07-07,203,mango yogurt,50,60,10,1,00457,India
687406,2023-07-07,210,mountain dew,75,100,25,1,00457,India
687406,2023-07-07,208,sprite,75,100,25,1,00457,India
641218,2023-07-07,202,milk,12,27,15,1,00448,India
147859,2023-07-07,201,paneer,210,340,130,1,00455,India
147859,2023-07-07,202,milk,12,27,15,1,00455,India
147859,2023-07-07,211,red bull,90,125,35,1,00455,India
917646,2023-07-07,201,paneer,210,340,130,1,00207,India
917646,2023-07-07,202,milk,12,27,15,1,00207,India
917646,2023-07-07,206,yakult,360,400,40,1,00207,India
917646,2023-07-07,212,amul cheese,250,315,65,1,00207,India
757310,2023-07-07,202,milk,12,27,15,1,00395,India
757310,2023-07-07,207,coca cola,75,100,25,1,00395,India
950791,2023-07-07,202,milk,12,27,15,1,00460,India
950791,2023-07-07,211,red bull,90,125,35,1,00460,India
493087,2023-07-07,205,classic yogurt,45,60,15,1,00068,India
493087,2023-07-07,208,sprite,75,100,25,1,00068,India
423687,2023-07-07,201,paneer,210,340,130,1,00256,India
953620,2023-07-07,210,mountain dew,75,100,25,1,00397,India
657556,2023-07-07,213,bisleri,6,15,9,1,00116,India
657556,2023-07-07,209,pepsi,75,100,25,1,00116,India
862457,2023-07-07,202,milk,12,27,15,1,00148,India
862457,2023-07-07,210,mountain dew,75,100,25,1,00148,India
862457,2023-07-07,201,paneer,210,340,130,1,00148,India
862457,2023-07-07,206,yakult,360,400,40,1,00148,India
862457,2023-07-07,204,strawberry yogurt,50,60,10,1,00148,India
679874,2023-07-07,206,yakult,360,400,40,1,00063,India
719919,2023-07-07,202,milk,12,27,15,1,00077,India
719919,2023-07-07,206,yakult,360,400,40,1,00077,India
719919,2023-07-07,203,mango yogurt,50,60,10,1,00077,India
719919,2023-07-07,204,strawberry yogurt,50,60,10,1,00077,India
718396,2023-07-07,213,bisleri,6,15,9,1,00027,India
718396,2023-07-07,204,strawberry yogurt,50,60,10,1,00027,India
718396,2023-07-07,210,mountain dew,75,100,25,1,00027,India
611055,2023-07-07,201,paneer,210,340,130,1,00121,India
611055,2023-07-07,208,sprite,75,100,25,1,00121,India
611055,2023-07-07,213,bisleri,6,15,9,1,00121,India
793048,2023-07-07,206,yakult,360,400,40,1,00415,India
793048,2023-07-07,212,amul cheese,250,315,65,1,00415,India
793048,2023-07-07,209,pepsi,75,100,25,1,00415,India
259471,2023-07-07,208,sprite,75,100,25,1,00385,India
259471,2023-07-07,212,amul cheese,250,315,65,1,00385,India
177301,2023-07-07,209,pepsi,75,100,25,1,00134,India
177301,2023-07-07,207,coca cola,75,100,25,1,00134,India
177301,2023-07-07,206,yakult,360,400,40,1,00134,India
177301,2023-07-07,204,strawberry yogurt,50,60,10,1,00134,India
714365,2023-07-07,206,yakult,360,400,40,1,00080,India
714365,2023-07-07,212,amul cheese,250,315,65,1,00080,India
714365,2023-07-07,203,mango yogurt,50,60,10,1,00080,India
714365,2023-07-07,213,bisleri,6,15,9,1,00080,India
446131,2023-07-07,205,classic yogurt,45,60,15,1,00382,India
446131,2023-07-07,206,yakult,360,400,40,1,00382,India
446131,2023-07-07,213,bisleri,6,15,9,1,00382,India
417332,2023-07-07,212,amul cheese,250,315,65,1,00398,India
417332,2023-07-07,206,yakult,360,400,40,1,00398,India
417332,2023-07-07,211,red bull,90,125,35,1,00398,India
417332,2023-07-07,203,mango yogurt,50,60,10,1,00398,India
950884,2023-07-07,206,yakult,360,400,40,1,00043,India
950884,2023-07-07,207,coca cola,75,100,25,1,00043,India
950884,2023-07-07,201,paneer,210,340,130,1,00043,India
950884,2023-07-07,205,classic yogurt,45,60,15,1,00043,India
950884,2023-07-07,213,bisleri,6,15,9,1,00043,India
374529,2023-07-07,204,strawberry yogurt,50,60,10,1,00329,India
374529,2023-07-07,210,mountain dew,75,100,25,1,00329,India
374529,2023-07-07,206,yakult,360,400,40,1,00329,India
487931,2023-07-07,209,pepsi,75,100,25,1,00102,India
487931,2023-07-07,203,mango yogurt,50,60,10,1,00102,India
487931,2023-07-07,210,mountain dew,75,100,25,1,00102,India
487931,2023-07-07,206,yakult,360,400,40,1,00102,India
487931,2023-07-07,208,sprite,75,100,25,1,00102,India
247034,2023-07-07,202,milk,12,27,15,1,00161,India
247034,2023-07-07,213,bisleri,6,15,9,1,00161,India
247034,2023-07-07,210,mountain dew,75,100,25,1,00161,India
247034,2023-07-07,206,yakult,360,400,40,1,00161,India
247034,2023-07-07,205,classic yogurt,45,60,15,1,00161,India
941877,2023-07-07,212,amul cheese,250,315,65,1,00471,India
140211,2023-07-07,211,red bull,90,125,35,1,00104,India
140211,2023-07-07,204,strawberry yogurt,50,60,10,1,00104,India
140211,2023-07-07,212,amul cheese,250,315,65,1,00104,India
140211,2023-07-07,209,pepsi,75,100,25,1,00104,India
263807,2023-07-07,213,bisleri,6,15,9,1,00138,India
263807,2023-07-07,203,mango yogurt,50,60,10,1,00138,India
263807,2023-07-07,207,coca cola,75,100,25,1,00138,India
263807,2023-07-07,210,mountain dew,75,100,25,1,00138,India
278059,2023-07-07,205,classic yogurt,45,60,15,1,00177,India
339907,2023-07-07,201,paneer,210,340,130,1,00352,India
339907,2023-07-07,204,strawberry yogurt,50,60,10,1,00352,India
339907,2023-07-07,210,mountain dew,75,100,25,1,00352,India
214360,2023-07-07,207,coca cola,75,100,25,1,00392,India
214360,2023-07-07,209,pepsi,75,100,25,1,00392,India
746228,2023-07-07,207,coca cola,75,100,25,1,00341,India
459793,2023-07-07,208,sprite,75,100,25,1,00327,India
454418,2023-07-07,211,red bull,90,125,35,1,00309,India
703880,2023-07-07,207,coca cola,75,100,25,1,00495,India
703880,2023-07-07,209,pepsi,75,100,25,1,00495,India
703880,2023-07-07,210,mountain dew,75,100,25,1,00495,India
750775,2023-07-07,205,classic yogurt,45,60,15,1,00367,India
750775,2023-07-07,209,pepsi,75,100,25,1,00367,India
627145,2023-07-07,207,coca cola,75,100,25,1,00216,India
627145,2023-07-07,203,mango yogurt,50,60,10,1,00216,India
627145,2023-07-07,213,bisleri,6,15,9,1,00216,India
627145,2023-07-07,202,milk,12,27,15,1,00216,India
627145,2023-07-07,211,red bull,90,125,35,1,00216,India
705301,2023-07-07,210,mountain dew,75,100,25,1,00113,India
705301,2023-07-07,213,bisleri,6,15,9,1,00113,India
705301,2023-07-07,211,red bull,90,125,35,1,00113,India
705301,2023-07-07,201,paneer,210,340,130,1,00113,India
682893,2023-07-07,205,classic yogurt,45,60,15,1,00302,India
682893,2023-07-07,212,amul cheese,250,315,65,1,00302,India
682893,2023-07-07,206,yakult,360,400,40,1,00302,India
682893,2023-07-07,211,red bull,90,125,35,1,00302,India
180043,2023-07-07,201,paneer,210,340,130,1,00131,India
180043,2023-07-07,213,bisleri,6,15,9,1,00131,India
274822,2023-07-07,209,pepsi,75,100,25,1,00007,India
274822,2023-07-07,213,bisleri,6,15,9,1,00007,India
274822,2023-07-07,203,mango yogurt,50,60,10,1,00007,India
274822,2023-07-07,202,milk,12,27,15,1,00007,India
825275,2023-07-07,208,sprite,75,100,25,1,00111,India
755726,2023-07-07,202,milk,12,27,15,1,00228,India
755726,2023-07-07,201,paneer,210,340,130,1,00228,India
755726,2023-07-07,206,yakult,360,400,40,1,00228,India
755726,2023-07-07,203,mango yogurt,50,60,10,1,00228,India
838657,2023-07-07,208,sprite,75,100,25,1,00440,India
838657,2023-07-07,210,mountain dew,75,100,25,1,00440,India
760978,2023-07-07,210,mountain dew,75,100,25,1,00335,India
760978,2023-07-07,209,pepsi,75,100,25,1,00335,India
760978,2023-07-07,211,red bull,90,125,35,1,00335,India
232299,2023-07-07,213,bisleri,6,15,9,1,00209,India
232299,2023-07-07,209,pepsi,75,100,25,1,00209,India
232299,2023-07-07,202,milk,12,27,15,1,00209,India
232299,2023-07-07,211,red bull,90,125,35,1,00209,India
680817,2023-07-07,207,coca cola,75,100,25,1,00274,India
680817,2023-07-07,211,red bull,90,125,35,1,00274,India
491050,2023-07-07,205,classic yogurt,45,60,15,1,00318,India
491050,2023-07-07,212,amul cheese,250,315,65,1,00318,India
999846,2023-07-07,206,yakult,360,400,40,1,00101,India
289474,2023-07-07,205,classic yogurt,45,60,15,1,00285,India
289474,2023-07-07,213,bisleri,6,15,9,1,00285,India
289474,2023-07-07,204,strawberry yogurt,50,60,10,1,00285,India
289474,2023-07-07,203,mango yogurt,50,60,10,1,00285,India
590319,2023-07-07,205,classic yogurt,45,60,15,1,00180,India
590319,2023-07-07,204,strawberry yogurt,50,60,10,1,00180,India
590319,2023-07-07,203,mango yogurt,50,60,10,1,00180,India
590319,2023-07-07,202,milk,12,27,15,1,00180,India
786501,2023-07-07,206,yakult,360,400,40,1,00182,India
786501,2023-07-07,204,strawberry yogurt,50,60,10,1,00182,India
684598,2023-07-07,208,sprite,75,100,25,1,00242,India
684598,2023-07-07,209,pepsi,75,100,25,1,00242,India
684598,2023-07-07,202,milk,12,27,15,1,00242,India
684598,2023-07-07,204,strawberry yogurt,50,60,10,1,00242,India
884470,2023-07-07,201,paneer,210,340,130,1,00359,India
350974,2023-07-07,209,pepsi,75,100,25,1,00335,India
350974,2023-07-07,201,paneer,210,340,130,1,00335,India
369247,2023-07-07,205,classic yogurt,45,60,15,1,00304,India
369247,2023-07-07,201,paneer,210,340,130,1,00304,India
369247,2023-07-07,213,bisleri,6,15,9,1,00304,India
369247,2023-07-07,209,pepsi,75,100,25,1,00304,India
224876,2023-07-07,205,classic yogurt,45,60,15,1,00355,India
224876,2023-07-07,204,strawberry yogurt,50,60,10,1,00355,India
224876,2023-07-07,209,pepsi,75,100,25,1,00355,India
224876,2023-07-07,210,mountain dew,75,100,25,1,00355,India
224876,2023-07-07,211,red bull,90,125,35,1,00355,India
430540,2023-07-07,211,red bull,90,125,35,1,00262,India
369678,2023-07-07,211,red bull,90,125,35,1,00488,India
369678,2023-07-07,203,mango yogurt,50,60,10,1,00488,India
369678,2023-07-07,205,classic yogurt,45,60,15,1,00488,India
369678,2023-07-07,207,coca cola,75,100,25,1,00488,India
369678,2023-07-07,213,bisleri,6,15,9,1,00488,India
485695,2023-07-07,213,bisleri,6,15,9,1,00194,India
485695,2023-07-07,201,paneer,210,340,130,1,00194,India
485695,2023-07-07,203,mango yogurt,50,60,10,1,00194,India
485695,2023-07-07,207,coca cola,75,100,25,1,00194,India
485695,2023-07-07,211,red bull,90,125,35,1,00194,India
506378,2023-07-07,213,bisleri,6,15,9,1,00072,India
506378,2023-07-07,210,mountain dew,75,100,25,1,00072,India
506378,2023-07-07,207,coca cola,75,100,25,1,00072,India
506378,2023-07-07,201,paneer,210,340,130,1,00072,India
460153,2023-07-07,213,bisleri,6,15,9,1,00190,India
460153,2023-07-07,212,amul cheese,250,315,65,1,00190,India
587716,2023-07-07,211,red bull,90,125,35,1,00297,India
587716,2023-07-07,207,coca cola,75,100,25,1,00297,India
817841,2023-07-07,204,strawberry yogurt,50,60,10,1,00432,India
260630,2023-07-07,209,pepsi,75,100,25,1,00345,India
260630,2023-07-07,201,paneer,210,340,130,1,00345,India
429030,2023-07-07,207,coca cola,75,100,25,1,00082,India
429030,2023-07-07,206,yakult,360,400,40,1,00082,India
429030,2023-07-07,201,paneer,210,340,130,1,00082,India
825448,2023-07-07,212,amul cheese,250,315,65,1,00032,India
825448,2023-07-07,211,red bull,90,125,35,1,00032,India
825448,2023-07-07,205,classic yogurt,45,60,15,1,00032,India
825448,2023-07-07,202,milk,12,27,15,1,00032,India
331609,2023-07-07,207,coca cola,75,100,25,1,00278,India
695628,2023-07-07,203,mango yogurt,50,60,10,1,00182,India
243448,2023-07-07,207,coca cola,75,100,25,1,00419,India
243448,2023-07-07,204,strawberry yogurt,50,60,10,1,00419,India
243448,2023-07-07,203,mango yogurt,50,60,10,1,00419,India
837003,2023-07-07,204,strawberry yogurt,50,60,10,1,00298,India
837003,2023-07-07,209,pepsi,75,100,25,1,00298,India
501462,2023-07-07,203,mango yogurt,50,60,10,1,00055,India
501462,2023-07-07,201,paneer,210,340,130,1,00055,India
501462,2023-07-07,212,amul cheese,250,315,65,1,00055,India
501462,2023-07-07,208,sprite,75,100,25,1,00055,India
641104,2023-07-07,206,yakult,360,400,40,1,00019,India
641104,2023-07-07,202,milk,12,27,15,1,00019,India
747695,2023-07-07,207,coca cola,75,100,25,1,00440,India
747695,2023-07-07,206,yakult,360,400,40,1,00440,India
747695,2023-07-07,201,paneer,210,340,130,1,00440,India
730468,2023-07-07,202,milk,12,27,15,1,00482,India
730468,2023-07-07,203,mango yogurt,50,60,10,1,00482,India
730468,2023-07-07,211,red bull,90,125,35,1,00482,India
730468,2023-07-07,212,amul cheese,250,315,65,1,00482,India
730468,2023-07-07,209,pepsi,75,100,25,1,00482,India
610444,2023-07-07,203,mango yogurt,50,60,10,1,00362,India
610444,2023-07-07,211,red bull,90,125,35,1,00362,India
610444,2023-07-07,201,paneer,210,340,130,1,00362,India
610444,2023-07-07,205,classic yogurt,45,60,15,1,00362,India
610444,2023-07-07,210,mountain dew,75,100,25,1,00362,India
230837,2023-07-07,211,red bull,90,125,35,1,00107,India
724522,2023-07-07,209,pepsi,75,100,25,1,00129,India
724522,2023-07-07,207,coca cola,75,100,25,1,00129,India
724522,2023-07-07,201,paneer,210,340,130,1,00129,India
637109,2023-07-07,201,paneer,210,340,130,1,00452,India
637109,2023-07-07,205,classic yogurt,45,60,15,1,00452,India
314119,2023-07-07,206,yakult,360,400,40,1,00171,India
314119,2023-07-07,208,sprite,75,100,25,1,00171,India
225865,2023-07-07,208,sprite,75,100,25,1,00371,India
225865,2023-07-07,205,classic yogurt,45,60,15,1,00371,India
225865,2023-07-07,202,milk,12,27,15,1,00371,India
225865,2023-07-07,203,mango yogurt,50,60,10,1,00371,India
418196,2023-07-07,206,yakult,360,400,40,1,00399,India
418196,2023-07-07,202,milk,12,27,15,1,00399,India
395115,2023-07-07,205,classic yogurt,45,60,15,1,00448,India
395115,2023-07-07,210,mountain dew,75,100,25,1,00448,India
892274,2023-07-07,203,mango yogurt,50,60,10,1,00359,India
892274,2023-07-07,209,pepsi,75,100,25,1,00359,India
892274,2023-07-07,206,yakult,360,400,40,1,00359,India
683868,2023-07-07,209,pepsi,75,100,25,1,00092,India
612187,2023-07-07,212,amul cheese,250,315,65,1,00328,India
612187,2023-07-07,209,pepsi,75,100,25,1,00328,India
612187,2023-07-07,203,mango yogurt,50,60,10,1,00328,India
944581,2023-07-07,205,classic yogurt,45,60,15,1,00381,India
748099,2023-07-07,209,pepsi,75,100,25,1,00374,India
748099,2023-07-07,206,yakult,360,400,40,1,00374,India
748099,2023-07-07,203,mango yogurt,50,60,10,1,00374,India
667136,2023-07-07,204,strawberry yogurt,50,60,10,1,00411,India
667136,2023-07-07,212,amul cheese,250,315,65,1,00411,India
667136,2023-07-07,207,coca cola,75,100,25,1,00411,India
205343,2023-07-08,208,sprite,75,100,25,1,00438,India
205343,2023-07-08,201,paneer,210,340,130,1,00438,India
205343,2023-07-08,202,milk,12,27,15,1,00438,India
205343,2023-07-08,204,strawberry yogurt,50,60,10,1,00438,India
205343,2023-07-08,207,coca cola,75,100,25,1,00438,India
745397,2023-07-08,204,strawberry yogurt,50,60,10,1,00383,India
745397,2023-07-08,205,classic yogurt,45,60,15,1,00383,India
956743,2023-07-08,212,amul cheese,250,315,65,1,00090,India
956743,2023-07-08,202,milk,12,27,15,1,00090,India
310589,2023-07-08,211,red bull,90,125,35,1,00159,India
310589,2023-07-08,210,mountain dew,75,100,25,1,00159,India
310589,2023-07-08,207,coca cola,75,100,25,1,00159,India
310589,2023-07-08,204,strawberry yogurt,50,60,10,1,00159,India
310589,2023-07-08,203,mango yogurt,50,60,10,1,00159,India
394666,2023-07-08,207,coca cola,75,100,25,1,00148,India
394666,2023-07-08,203,mango yogurt,50,60,10,1,00148,India
394666,2023-07-08,212,amul cheese,250,315,65,1,00148,India
394666,2023-07-08,204,strawberry yogurt,50,60,10,1,00148,India
241270,2023-07-08,207,coca cola,75,100,25,1,00251,India
241270,2023-07-08,208,sprite,75,100,25,1,00251,India
241270,2023-07-08,212,amul cheese,250,315,65,1,00251,India
318057,2023-07-08,206,yakult,360,400,40,1,00430,India
437764,2023-07-08,206,yakult,360,400,40,1,00313,India
437764,2023-07-08,201,paneer,210,340,130,1,00313,India
343738,2023-07-08,206,yakult,360,400,40,1,00213,India
343738,2023-07-08,212,amul cheese,250,315,65,1,00213,India
343738,2023-07-08,202,milk,12,27,15,1,00213,India
343738,2023-07-08,213,bisleri,6,15,9,1,00213,India
923025,2023-07-08,202,milk,12,27,15,1,00010,India
923025,2023-07-08,201,paneer,210,340,130,1,00010,India
923025,2023-07-08,205,classic yogurt,45,60,15,1,00010,India
923025,2023-07-08,207,coca cola,75,100,25,1,00010,India
518686,2023-07-08,207,coca cola,75,100,25,1,00382,India
518686,2023-07-08,201,paneer,210,340,130,1,00382,India
518686,2023-07-08,212,amul cheese,250,315,65,1,00382,India
518686,2023-07-08,206,yakult,360,400,40,1,00382,India
938910,2023-07-08,202,milk,12,27,15,1,00462,India
938910,2023-07-08,203,mango yogurt,50,60,10,1,00462,India
938910,2023-07-08,208,sprite,75,100,25,1,00462,India
232384,2023-07-08,204,strawberry yogurt,50,60,10,1,00362,India
232384,2023-07-08,209,pepsi,75,100,25,1,00362,India
232384,2023-07-08,202,milk,12,27,15,1,00362,India
545138,2023-07-08,202,milk,12,27,15,1,00205,India
545138,2023-07-08,205,classic yogurt,45,60,15,1,00205,India
545138,2023-07-08,211,red bull,90,125,35,1,00205,India
545138,2023-07-08,206,yakult,360,400,40,1,00205,India
851814,2023-07-08,213,bisleri,6,15,9,1,00243,India
912874,2023-07-08,209,pepsi,75,100,25,1,00015,India
912874,2023-07-08,207,coca cola,75,100,25,1,00015,India
837485,2023-07-08,211,red bull,90,125,35,1,00297,India
837485,2023-07-08,202,milk,12,27,15,1,00297,India
837485,2023-07-08,209,pepsi,75,100,25,1,00297,India
953034,2023-07-08,211,red bull,90,125,35,1,00211,India
953034,2023-07-08,201,paneer,210,340,130,1,00211,India
926392,2023-07-08,205,classic yogurt,45,60,15,1,00198,India
926392,2023-07-08,207,coca cola,75,100,25,1,00198,India
926392,2023-07-08,209,pepsi,75,100,25,1,00198,India
926392,2023-07-08,213,bisleri,6,15,9,1,00198,India
926392,2023-07-08,203,mango yogurt,50,60,10,1,00198,India
246097,2023-07-08,208,sprite,75,100,25,1,00283,India
246097,2023-07-08,211,red bull,90,125,35,1,00283,India
661297,2023-07-08,210,mountain dew,75,100,25,1,00353,India
661297,2023-07-08,208,sprite,75,100,25,1,00353,India
661297,2023-07-08,201,paneer,210,340,130,1,00353,India
771163,2023-07-08,203,mango yogurt,50,60,10,1,00466,India
745962,2023-07-08,208,sprite,75,100,25,1,00408,India
159619,2023-07-08,208,sprite,75,100,25,1,00351,India
159619,2023-07-08,205,classic yogurt,45,60,15,1,00351,India
159619,2023-07-08,213,bisleri,6,15,9,1,00351,India
159619,2023-07-08,212,amul cheese,250,315,65,1,00351,India
159619,2023-07-08,207,coca cola,75,100,25,1,00351,India
149198,2023-07-08,212,amul cheese,250,315,65,1,00187,India
149198,2023-07-08,213,bisleri,6,15,9,1,00187,India
717240,2023-07-08,204,strawberry yogurt,50,60,10,1,00424,India
579917,2023-07-08,203,mango yogurt,50,60,10,1,00455,India
579917,2023-07-08,209,pepsi,75,100,25,1,00455,India
579917,2023-07-08,208,sprite,75,100,25,1,00455,India
203494,2023-07-08,207,coca cola,75,100,25,1,00066,India
203494,2023-07-08,209,pepsi,75,100,25,1,00066,India
203494,2023-07-08,201,paneer,210,340,130,1,00066,India
203494,2023-07-08,205,classic yogurt,45,60,15,1,00066,India
916710,2023-07-08,213,bisleri,6,15,9,1,00207,India
916710,2023-07-08,201,paneer,210,340,130,1,00207,India
916710,2023-07-08,210,mountain dew,75,100,25,1,00207,India
916710,2023-07-08,205,classic yogurt,45,60,15,1,00207,India
549547,2023-07-08,210,mountain dew,75,100,25,1,00412,India
549547,2023-07-08,203,mango yogurt,50,60,10,1,00412,India
549547,2023-07-08,209,pepsi,75,100,25,1,00412,India
549547,2023-07-08,207,coca cola,75,100,25,1,00412,India
251382,2023-07-08,207,coca cola,75,100,25,1,00269,India
251382,2023-07-08,211,red bull,90,125,35,1,00269,India
251382,2023-07-08,206,yakult,360,400,40,1,00269,India
251382,2023-07-08,209,pepsi,75,100,25,1,00269,India
737232,2023-07-08,212,amul cheese,250,315,65,1,00146,India
737232,2023-07-08,202,milk,12,27,15,1,00146,India
372488,2023-07-08,212,amul cheese,250,315,65,1,00254,India
219101,2023-07-08,207,coca cola,75,100,25,1,00220,India
219101,2023-07-08,211,red bull,90,125,35,1,00220,India
316872,2023-07-08,213,bisleri,6,15,9,1,00295,India
316872,2023-07-08,201,paneer,210,340,130,1,00295,India
140946,2023-07-08,210,mountain dew,75,100,25,1,00209,India
140946,2023-07-08,212,amul cheese,250,315,65,1,00209,India
140946,2023-07-08,202,milk,12,27,15,1,00209,India
140946,2023-07-08,205,classic yogurt,45,60,15,1,00209,India
319771,2023-07-08,211,red bull,90,125,35,1,00216,India
319771,2023-07-08,208,sprite,75,100,25,1,00216,India
319771,2023-07-08,213,bisleri,6,15,9,1,00216,India
321400,2023-07-08,210,mountain dew,75,100,25,1,00257,India
321400,2023-07-08,212,amul cheese,250,315,65,1,00257,India
321400,2023-07-08,204,strawberry yogurt,50,60,10,1,00257,India
321400,2023-07-08,203,mango yogurt,50,60,10,1,00257,India
321400,2023-07-08,205,classic yogurt,45,60,15,1,00257,India
550526,2023-07-08,203,mango yogurt,50,60,10,1,00300,India
550526,2023-07-08,202,milk,12,27,15,1,00300,India
900158,2023-07-08,206,yakult,360,400,40,1,00353,India
900158,2023-07-08,202,milk,12,27,15,1,00353,India
900158,2023-07-08,207,coca cola,75,100,25,1,00353,India
900158,2023-07-08,213,bisleri,6,15,9,1,00353,India
900158,2023-07-08,201,paneer,210,340,130,1,00353,India
611455,2023-07-08,208,sprite,75,100,25,1,00060,India
611455,2023-07-08,204,strawberry yogurt,50,60,10,1,00060,India
465591,2023-07-08,207,coca cola,75,100,25,1,00199,India
465591,2023-07-08,203,mango yogurt,50,60,10,1,00199,India
465591,2023-07-08,210,mountain dew,75,100,25,1,00199,India
465591,2023-07-08,213,bisleri,6,15,9,1,00199,India
465591,2023-07-08,208,sprite,75,100,25,1,00199,India
990057,2023-07-08,212,amul cheese,250,315,65,1,00180,India
423346,2023-07-08,208,sprite,75,100,25,1,00343,India
423346,2023-07-08,212,amul cheese,250,315,65,1,00343,India
400038,2023-07-08,206,yakult,360,400,40,1,00011,India
400038,2023-07-08,203,mango yogurt,50,60,10,1,00011,India
142512,2023-07-08,211,red bull,90,125,35,1,00292,India
142512,2023-07-08,205,classic yogurt,45,60,15,1,00292,India
142512,2023-07-08,212,amul cheese,250,315,65,1,00292,India
142512,2023-07-08,213,bisleri,6,15,9,1,00292,India
642926,2023-07-08,212,amul cheese,250,315,65,1,00286,India
320783,2023-07-08,206,yakult,360,400,40,1,00467,India
494444,2023-07-08,208,sprite,75,100,25,1,00023,India
494444,2023-07-08,203,mango yogurt,50,60,10,1,00023,India
619708,2023-07-08,212,amul cheese,250,315,65,1,00296,India
619708,2023-07-08,202,milk,12,27,15,1,00296,India
619708,2023-07-08,210,mountain dew,75,100,25,1,00296,India
246481,2023-07-08,209,pepsi,75,100,25,1,00428,India
196453,2023-07-08,212,amul cheese,250,315,65,1,00362,India
196453,2023-07-08,211,red bull,90,125,35,1,00362,India
196453,2023-07-08,204,strawberry yogurt,50,60,10,1,00362,India
196453,2023-07-08,205,classic yogurt,45,60,15,1,00362,India
608562,2023-07-08,206,yakult,360,400,40,1,00374,India
608562,2023-07-08,205,classic yogurt,45,60,15,1,00374,India
442711,2023-07-08,212,amul cheese,250,315,65,1,00328,India
877718,2023-07-08,206,yakult,360,400,40,1,00077,India
877718,2023-07-08,202,milk,12,27,15,1,00077,India
877718,2023-07-08,213,bisleri,6,15,9,1,00077,India
877718,2023-07-08,211,red bull,90,125,35,1,00077,India
788220,2023-07-08,202,milk,12,27,15,1,00301,India
788220,2023-07-08,207,coca cola,75,100,25,1,00301,India
379284,2023-07-08,206,yakult,360,400,40,1,00341,India
379284,2023-07-08,211,red bull,90,125,35,1,00341,India
379284,2023-07-08,208,sprite,75,100,25,1,00341,India
379284,2023-07-08,212,amul cheese,250,315,65,1,00341,India
359836,2023-07-08,210,mountain dew,75,100,25,1,00047,India
822845,2023-07-08,211,red bull,90,125,35,1,00193,India
822845,2023-07-08,213,bisleri,6,15,9,1,00193,India
815520,2023-07-08,205,classic yogurt,45,60,15,1,00058,India
815520,2023-07-08,204,strawberry yogurt,50,60,10,1,00058,India
153750,2023-07-08,213,bisleri,6,15,9,1,00010,India
153750,2023-07-08,207,coca cola,75,100,25,1,00010,India
153750,2023-07-08,201,paneer,210,340,130,1,00010,India
153750,2023-07-08,203,mango yogurt,50,60,10,1,00010,India
930436,2023-07-08,213,bisleri,6,15,9,1,00175,India
930436,2023-07-08,208,sprite,75,100,25,1,00175,India
703355,2023-07-08,204,strawberry yogurt,50,60,10,1,00404,India
703355,2023-07-08,210,mountain dew,75,100,25,1,00404,India
703355,2023-07-08,201,paneer,210,340,130,1,00404,India
496593,2023-07-08,210,mountain dew,75,100,25,1,00343,India
496593,2023-07-08,211,red bull,90,125,35,1,00343,India
580330,2023-07-08,207,coca cola,75,100,25,1,00201,India
580330,2023-07-08,209,pepsi,75,100,25,1,00201,India
580330,2023-07-08,208,sprite,75,100,25,1,00201,India
161225,2023-07-08,205,classic yogurt,45,60,15,1,00220,India
476480,2023-07-08,204,strawberry yogurt,50,60,10,1,00330,India
476480,2023-07-08,209,pepsi,75,100,25,1,00330,India
701955,2023-07-08,207,coca cola,75,100,25,1,00437,India
296168,2023-07-09,201,paneer,210,340,130,1,00410,India
968296,2023-07-09,210,mountain dew,75,100,25,1,00307,India
968296,2023-07-09,212,amul cheese,250,315,65,1,00307,India
799248,2023-07-09,204,strawberry yogurt,50,60,10,1,00174,India
799248,2023-07-09,210,mountain dew,75,100,25,1,00174,India
799248,2023-07-09,213,bisleri,6,15,9,1,00174,India
799248,2023-07-09,208,sprite,75,100,25,1,00174,India
799248,2023-07-09,207,coca cola,75,100,25,1,00174,India
799215,2023-07-09,203,mango yogurt,50,60,10,1,00202,India
125664,2023-07-09,205,classic yogurt,45,60,15,1,00252,India
971420,2023-07-09,209,pepsi,75,100,25,1,00325,India
613451,2023-07-09,203,mango yogurt,50,60,10,1,00122,India
613451,2023-07-09,212,amul cheese,250,315,65,1,00122,India
613451,2023-07-09,208,sprite,75,100,25,1,00122,India
613451,2023-07-09,213,bisleri,6,15,9,1,00122,India
613451,2023-07-09,210,mountain dew,75,100,25,1,00122,India
403057,2023-07-09,212,amul cheese,250,315,65,1,00192,India
403057,2023-07-09,201,paneer,210,340,130,1,00192,India
403057,2023-07-09,210,mountain dew,75,100,25,1,00192,India
403057,2023-07-09,205,classic yogurt,45,60,15,1,00192,India
680802,2023-07-09,203,mango yogurt,50,60,10,1,00080,India
680802,2023-07-09,205,classic yogurt,45,60,15,1,00080,India
680802,2023-07-09,209,pepsi,75,100,25,1,00080,India
689816,2023-07-09,210,mountain dew,75,100,25,1,00044,India
689816,2023-07-09,211,red bull,90,125,35,1,00044,India
689816,2023-07-09,209,pepsi,75,100,25,1,00044,India
788533,2023-07-09,204,strawberry yogurt,50,60,10,1,00118,India
788533,2023-07-09,207,coca cola,75,100,25,1,00118,India
788533,2023-07-09,208,sprite,75,100,25,1,00118,India
788533,2023-07-09,203,mango yogurt,50,60,10,1,00118,India
678467,2023-07-09,203,mango yogurt,50,60,10,1,00466,India
678467,2023-07-09,201,paneer,210,340,130,1,00466,India
678467,2023-07-09,206,yakult,360,400,40,1,00466,India
915072,2023-07-09,211,red bull,90,125,35,1,00481,India
915072,2023-07-09,207,coca cola,75,100,25,1,00481,India
957605,2023-07-09,205,classic yogurt,45,60,15,1,00419,India
957605,2023-07-09,212,amul cheese,250,315,65,1,00419,India
678420,2023-07-09,209,pepsi,75,100,25,1,00155,India
678420,2023-07-09,210,mountain dew,75,100,25,1,00155,India
104339,2023-07-09,202,milk,12,27,15,1,00050,India
104339,2023-07-09,213,bisleri,6,15,9,1,00050,India
104339,2023-07-09,209,pepsi,75,100,25,1,00050,India
104339,2023-07-09,212,amul cheese,250,315,65,1,00050,India
352986,2023-07-09,201,paneer,210,340,130,1,00041,India
352986,2023-07-09,205,classic yogurt,45,60,15,1,00041,India
352986,2023-07-09,211,red bull,90,125,35,1,00041,India
171032,2023-07-09,205,classic yogurt,45,60,15,1,00069,India
171032,2023-07-09,207,coca cola,75,100,25,1,00069,India
171032,2023-07-09,209,pepsi,75,100,25,1,00069,India
600869,2023-07-09,202,milk,12,27,15,1,00032,India
462859,2023-07-09,204,strawberry yogurt,50,60,10,1,00120,India
462859,2023-07-09,208,sprite,75,100,25,1,00120,India
462859,2023-07-09,209,pepsi,75,100,25,1,00120,India
462859,2023-07-09,201,paneer,210,340,130,1,00120,India
462859,2023-07-09,210,mountain dew,75,100,25,1,00120,India
634015,2023-07-09,209,pepsi,75,100,25,1,00413,India
559863,2023-07-09,203,mango yogurt,50,60,10,1,00387,India
559863,2023-07-09,206,yakult,360,400,40,1,00387,India
559863,2023-07-09,208,sprite,75,100,25,1,00387,India
559863,2023-07-09,213,bisleri,6,15,9,1,00387,India
188777,2023-07-09,202,milk,12,27,15,1,00035,India
829729,2023-07-09,208,sprite,75,100,25,1,00261,India
574311,2023-07-09,211,red bull,90,125,35,1,00231,India
574311,2023-07-09,208,sprite,75,100,25,1,00231,India
574311,2023-07-09,213,bisleri,6,15,9,1,00231,India
574311,2023-07-09,202,milk,12,27,15,1,00231,India
132145,2023-07-09,207,coca cola,75,100,25,1,00127,India
132145,2023-07-09,206,yakult,360,400,40,1,00127,India
481228,2023-07-09,211,red bull,90,125,35,1,00376,India
481228,2023-07-09,201,paneer,210,340,130,1,00376,India
721582,2023-07-09,205,classic yogurt,45,60,15,1,00148,India
729669,2023-07-09,210,mountain dew,75,100,25,1,00277,India
729669,2023-07-09,206,yakult,360,400,40,1,00277,India
729669,2023-07-09,202,milk,12,27,15,1,00277,India
742388,2023-07-09,211,red bull,90,125,35,1,00236,India
588258,2023-07-09,211,red bull,90,125,35,1,00309,India
588258,2023-07-09,210,mountain dew,75,100,25,1,00309,India
588258,2023-07-09,202,milk,12,27,15,1,00309,India
588258,2023-07-09,201,paneer,210,340,130,1,00309,India
588258,2023-07-09,212,amul cheese,250,315,65,1,00309,India
880653,2023-07-09,211,red bull,90,125,35,1,00162,India
505307,2023-07-09,212,amul cheese,250,315,65,1,00164,India
505307,2023-07-09,206,yakult,360,400,40,1,00164,India
505307,2023-07-09,209,pepsi,75,100,25,1,00164,India
505307,2023-07-09,202,milk,12,27,15,1,00164,India
889587,2023-07-09,206,yakult,360,400,40,1,00088,India
889587,2023-07-09,209,pepsi,75,100,25,1,00088,India
390402,2023-07-09,212,amul cheese,250,315,65,1,00487,India
390402,2023-07-09,203,mango yogurt,50,60,10,1,00487,India
243271,2023-07-09,202,milk,12,27,15,1,00322,India
243271,2023-07-09,208,sprite,75,100,25,1,00322,India
243271,2023-07-09,211,red bull,90,125,35,1,00322,India
243271,2023-07-09,213,bisleri,6,15,9,1,00322,India
243271,2023-07-09,207,coca cola,75,100,25,1,00322,India
469026,2023-07-09,212,amul cheese,250,315,65,1,00430,India
469026,2023-07-09,213,bisleri,6,15,9,1,00430,India
469026,2023-07-09,208,sprite,75,100,25,1,00430,India
687840,2023-07-09,210,mountain dew,75,100,25,1,00437,India
687840,2023-07-09,207,coca cola,75,100,25,1,00437,India
577578,2023-07-09,203,mango yogurt,50,60,10,1,00250,India
577578,2023-07-09,201,paneer,210,340,130,1,00250,India
577578,2023-07-09,208,sprite,75,100,25,1,00250,India
577578,2023-07-09,204,strawberry yogurt,50,60,10,1,00250,India
150999,2023-07-09,207,coca cola,75,100,25,1,00234,India
150999,2023-07-09,213,bisleri,6,15,9,1,00234,India
150999,2023-07-09,205,classic yogurt,45,60,15,1,00234,India
150999,2023-07-09,212,amul cheese,250,315,65,1,00234,India
150999,2023-07-09,209,pepsi,75,100,25,1,00234,India
668377,2023-07-09,212,amul cheese,250,315,65,1,00425,India
668377,2023-07-09,213,bisleri,6,15,9,1,00425,India
668377,2023-07-09,211,red bull,90,125,35,1,00425,India
461242,2023-07-09,213,bisleri,6,15,9,1,00492,India
461242,2023-07-09,212,amul cheese,250,315,65,1,00492,India
461242,2023-07-09,204,strawberry yogurt,50,60,10,1,00492,India
314077,2023-07-09,212,amul cheese,250,315,65,1,00368,India
314077,2023-07-09,207,coca cola,75,100,25,1,00368,India
653037,2023-07-09,210,mountain dew,75,100,25,1,00130,India
653037,2023-07-09,212,amul cheese,250,315,65,1,00130,India
436381,2023-07-09,211,red bull,90,125,35,1,00082,India
436381,2023-07-09,206,yakult,360,400,40,1,00082,India
436381,2023-07-09,208,sprite,75,100,25,1,00082,India
436381,2023-07-09,202,milk,12,27,15,1,00082,India
157676,2023-07-09,203,mango yogurt,50,60,10,1,00021,India
440311,2023-07-09,209,pepsi,75,100,25,1,00389,India
446262,2023-07-09,202,milk,12,27,15,1,00312,India
446262,2023-07-09,209,pepsi,75,100,25,1,00312,India
446262,2023-07-09,212,amul cheese,250,315,65,1,00312,India
446262,2023-07-09,211,red bull,90,125,35,1,00312,India
622969,2023-07-09,201,paneer,210,340,130,1,00221,India
445648,2023-07-09,209,pepsi,75,100,25,1,00225,India
445648,2023-07-09,203,mango yogurt,50,60,10,1,00225,India
897086,2023-07-09,206,yakult,360,400,40,1,00341,India
897086,2023-07-09,203,mango yogurt,50,60,10,1,00341,India
897086,2023-07-09,210,mountain dew,75,100,25,1,00341,India
897086,2023-07-09,209,pepsi,75,100,25,1,00341,India
353093,2023-07-09,205,classic yogurt,45,60,15,1,00086,India
353093,2023-07-09,211,red bull,90,125,35,1,00086,India
353093,2023-07-09,202,milk,12,27,15,1,00086,India
353093,2023-07-09,203,mango yogurt,50,60,10,1,00086,India
989205,2023-07-09,212,amul cheese,250,315,65,1,00477,India
408507,2023-07-09,201,paneer,210,340,130,1,00223,India
466234,2023-07-09,213,bisleri,6,15,9,1,00073,India
466234,2023-07-09,208,sprite,75,100,25,1,00073,India
712221,2023-07-09,210,mountain dew,75,100,25,1,00138,India
707173,2023-07-09,210,mountain dew,75,100,25,1,00351,India
707173,2023-07-09,206,yakult,360,400,40,1,00351,India
707173,2023-07-09,202,milk,12,27,15,1,00351,India
493174,2023-07-09,213,bisleri,6,15,9,1,00486,India
493174,2023-07-09,202,milk,12,27,15,1,00486,India
493174,2023-07-09,203,mango yogurt,50,60,10,1,00486,India
936127,2023-07-09,213,bisleri,6,15,9,1,00488,India
456124,2023-07-09,212,amul cheese,250,315,65,1,00117,India
456124,2023-07-09,209,pepsi,75,100,25,1,00117,India
376118,2023-07-09,210,mountain dew,75,100,25,1,00391,India
376118,2023-07-09,203,mango yogurt,50,60,10,1,00391,India
472539,2023-07-09,208,sprite,75,100,25,1,00248,India
814229,2023-07-09,212,amul cheese,250,315,65,1,00153,India
814229,2023-07-09,209,pepsi,75,100,25,1,00153,India
814229,2023-07-09,206,yakult,360,400,40,1,00153,India
279225,2023-07-09,204,strawberry yogurt,50,60,10,1,00258,India
279225,2023-07-09,210,mountain dew,75,100,25,1,00258,India
279225,2023-07-09,207,coca cola,75,100,25,1,00258,India
279225,2023-07-09,203,mango yogurt,50,60,10,1,00258,India
137145,2023-07-09,210,mountain dew,75,100,25,1,00390,India
137145,2023-07-09,208,sprite,75,100,25,1,00390,India
570533,2023-07-09,201,paneer,210,340,130,1,00343,India
570533,2023-07-09,208,sprite,75,100,25,1,00343,India
570533,2023-07-09,203,mango yogurt,50,60,10,1,00343,India
520499,2023-07-09,205,classic yogurt,45,60,15,1,00054,India
520499,2023-07-09,213,bisleri,6,15,9,1,00054,India
520499,2023-07-09,207,coca cola,75,100,25,1,00054,India
520499,2023-07-09,203,mango yogurt,50,60,10,1,00054,India
608308,2023-07-09,203,mango yogurt,50,60,10,1,00393,India
608308,2023-07-09,202,milk,12,27,15,1,00393,India
608308,2023-07-09,208,sprite,75,100,25,1,00393,India
608308,2023-07-09,213,bisleri,6,15,9,1,00393,India
919852,2023-07-09,210,mountain dew,75,100,25,1,00449,India
919852,2023-07-09,212,amul cheese,250,315,65,1,00449,India
919852,2023-07-09,203,mango yogurt,50,60,10,1,00449,India
919852,2023-07-09,211,red bull,90,125,35,1,00449,India
433940,2023-07-09,209,pepsi,75,100,25,1,00428,India
433940,2023-07-09,212,amul cheese,250,315,65,1,00428,India
963518,2023-07-09,210,mountain dew,75,100,25,1,00406,India
775466,2023-07-09,212,amul cheese,250,315,65,1,00267,India
775466,2023-07-09,203,mango yogurt,50,60,10,1,00267,India
775466,2023-07-09,207,coca cola,75,100,25,1,00267,India
775466,2023-07-09,210,mountain dew,75,100,25,1,00267,India
816843,2023-07-09,203,mango yogurt,50,60,10,1,00261,India
816843,2023-07-09,213,bisleri,6,15,9,1,00261,India
633688,2023-07-09,210,mountain dew,75,100,25,1,00300,India
366946,2023-07-09,205,classic yogurt,45,60,15,1,00058,India
884834,2023-07-09,202,milk,12,27,15,1,00388,India
884834,2023-07-09,204,strawberry yogurt,50,60,10,1,00388,India
884834,2023-07-09,201,paneer,210,340,130,1,00388,India
884834,2023-07-09,211,red bull,90,125,35,1,00388,India
234468,2023-07-09,202,milk,12,27,15,1,00432,India
234468,2023-07-09,209,pepsi,75,100,25,1,00432,India
829608,2023-07-09,210,mountain dew,75,100,25,1,00470,India
829608,2023-07-09,211,red bull,90,125,35,1,00470,India
829608,2023-07-09,209,pepsi,75,100,25,1,00470,India
829608,2023-07-09,204,strawberry yogurt,50,60,10,1,00470,India
829608,2023-07-09,205,classic yogurt,45,60,15,1,00470,India
874668,2023-07-09,211,red bull,90,125,35,1,00013,India
679361,2023-07-09,211,red bull,90,125,35,1,00469,India
679361,2023-07-09,205,classic yogurt,45,60,15,1,00469,India
313873,2023-07-09,206,yakult,360,400,40,1,00459,India
313873,2023-07-09,212,amul cheese,250,315,65,1,00459,India
313873,2023-07-09,211,red bull,90,125,35,1,00459,India
313873,2023-07-09,205,classic yogurt,45,60,15,1,00459,India
313873,2023-07-09,204,strawberry yogurt,50,60,10,1,00459,India
138817,2023-07-09,207,coca cola,75,100,25,1,00215,India
467117,2023-07-09,206,yakult,360,400,40,1,00422,India
467117,2023-07-09,212,amul cheese,250,315,65,1,00422,India
467117,2023-07-09,204,strawberry yogurt,50,60,10,1,00422,India
467117,2023-07-09,209,pepsi,75,100,25,1,00422,India
320431,2023-07-09,213,bisleri,6,15,9,1,00028,India
320431,2023-07-09,204,strawberry yogurt,50,60,10,1,00028,India
320431,2023-07-09,208,sprite,75,100,25,1,00028,India
320431,2023-07-09,209,pepsi,75,100,25,1,00028,India
776708,2023-07-09,202,milk,12,27,15,1,00485,India
776708,2023-07-09,205,classic yogurt,45,60,15,1,00485,India
481771,2023-07-09,202,milk,12,27,15,1,00416,India
481771,2023-07-09,213,bisleri,6,15,9,1,00416,India
481771,2023-07-09,208,sprite,75,100,25,1,00416,India
481771,2023-07-09,212,amul cheese,250,315,65,1,00416,India
315303,2023-07-09,211,red bull,90,125,35,1,00233,India
315303,2023-07-09,206,yakult,360,400,40,1,00233,India
315303,2023-07-09,207,coca cola,75,100,25,1,00233,India
219847,2023-07-09,203,mango yogurt,50,60,10,1,00021,India
219847,2023-07-09,210,mountain dew,75,100,25,1,00021,India
219847,2023-07-09,206,yakult,360,400,40,1,00021,India
219847,2023-07-09,205,classic yogurt,45,60,15,1,00021,India
117772,2023-07-10,213,bisleri,6,15,9,1,00367,India
117772,2023-07-10,201,paneer,210,340,130,1,00367,India
874443,2023-07-10,205,classic yogurt,45,60,15,1,00125,India
874443,2023-07-10,202,milk,12,27,15,1,00125,India
919091,2023-07-10,208,sprite,75,100,25,1,00421,India
919091,2023-07-10,201,paneer,210,340,130,1,00421,India
919091,2023-07-10,206,yakult,360,400,40,1,00421,India
850457,2023-07-10,207,coca cola,75,100,25,1,00274,India
850457,2023-07-10,203,mango yogurt,50,60,10,1,00274,India
850457,2023-07-10,204,strawberry yogurt,50,60,10,1,00274,India
850457,2023-07-10,212,amul cheese,250,315,65,1,00274,India
192996,2023-07-10,207,coca cola,75,100,25,1,00481,India
192996,2023-07-10,211,red bull,90,125,35,1,00481,India
228581,2023-07-10,209,pepsi,75,100,25,1,00411,India
228581,2023-07-10,211,red bull,90,125,35,1,00411,India
684214,2023-07-10,203,mango yogurt,50,60,10,1,00155,India
684214,2023-07-10,208,sprite,75,100,25,1,00155,India
684214,2023-07-10,210,mountain dew,75,100,25,1,00155,India
684214,2023-07-10,202,milk,12,27,15,1,00155,India
485056,2023-07-10,212,amul cheese,250,315,65,1,00334,India
991886,2023-07-10,209,pepsi,75,100,25,1,00066,India
991886,2023-07-10,202,milk,12,27,15,1,00066,India
991886,2023-07-10,208,sprite,75,100,25,1,00066,India
232747,2023-07-10,205,classic yogurt,45,60,15,1,00322,India
232747,2023-07-10,201,paneer,210,340,130,1,00322,India
781308,2023-07-10,201,paneer,210,340,130,1,00073,India
781308,2023-07-10,213,bisleri,6,15,9,1,00073,India
489068,2023-07-10,206,yakult,360,400,40,1,00082,India
489068,2023-07-10,207,coca cola,75,100,25,1,00082,India
731288,2023-07-10,208,sprite,75,100,25,1,00039,India
458909,2023-07-10,207,coca cola,75,100,25,1,00038,India
458909,2023-07-10,202,milk,12,27,15,1,00038,India
458909,2023-07-10,209,pepsi,75,100,25,1,00038,India
902571,2023-07-10,201,paneer,210,340,130,1,00031,India
902571,2023-07-10,207,coca cola,75,100,25,1,00031,India
902571,2023-07-10,205,classic yogurt,45,60,15,1,00031,India
902571,2023-07-10,211,red bull,90,125,35,1,00031,India
441732,2023-07-10,201,paneer,210,340,130,1,00307,India
441732,2023-07-10,204,strawberry yogurt,50,60,10,1,00307,India
441732,2023-07-10,213,bisleri,6,15,9,1,00307,India
645785,2023-07-10,202,milk,12,27,15,1,00018,India
645785,2023-07-10,213,bisleri,6,15,9,1,00018,India
645785,2023-07-10,207,coca cola,75,100,25,1,00018,India
645785,2023-07-10,201,paneer,210,340,130,1,00018,India
813718,2023-07-10,204,strawberry yogurt,50,60,10,1,00406,India
813718,2023-07-10,202,milk,12,27,15,1,00406,India
886716,2023-07-10,210,mountain dew,75,100,25,1,00273,India
314704,2023-07-10,205,classic yogurt,45,60,15,1,00472,India
314704,2023-07-10,208,sprite,75,100,25,1,00472,India
314704,2023-07-10,212,amul cheese,250,315,65,1,00472,India
314704,2023-07-10,209,pepsi,75,100,25,1,00472,India
452932,2023-07-10,211,red bull,90,125,35,1,00468,India
560807,2023-07-10,209,pepsi,75,100,25,1,00457,India
560807,2023-07-10,204,strawberry yogurt,50,60,10,1,00457,India
560807,2023-07-10,203,mango yogurt,50,60,10,1,00457,India
560807,2023-07-10,210,mountain dew,75,100,25,1,00457,India
526859,2023-07-10,212,amul cheese,250,315,65,1,00374,India
536324,2023-07-10,201,paneer,210,340,130,1,00003,India
536324,2023-07-10,202,milk,12,27,15,1,00003,India
676592,2023-07-10,202,milk,12,27,15,1,00183,India
575078,2023-07-10,210,mountain dew,75,100,25,1,00490,India
145204,2023-07-10,210,mountain dew,75,100,25,1,00200,India
888216,2023-07-10,207,coca cola,75,100,25,1,00453,India
888216,2023-07-10,205,classic yogurt,45,60,15,1,00453,India
888216,2023-07-10,209,pepsi,75,100,25,1,00453,India
370097,2023-07-10,212,amul cheese,250,315,65,1,00273,India
370097,2023-07-10,204,strawberry yogurt,50,60,10,1,00273,India
600583,2023-07-10,203,mango yogurt,50,60,10,1,00481,India
600583,2023-07-10,209,pepsi,75,100,25,1,00481,India
872324,2023-07-10,203,mango yogurt,50,60,10,1,00312,India
872324,2023-07-10,201,paneer,210,340,130,1,00312,India
872324,2023-07-10,204,strawberry yogurt,50,60,10,1,00312,India
810632,2023-07-10,208,sprite,75,100,25,1,00097,India
810632,2023-07-10,205,classic yogurt,45,60,15,1,00097,India
488838,2023-07-10,212,amul cheese,250,315,65,1,00216,India
333534,2023-07-10,208,sprite,75,100,25,1,00029,India
333534,2023-07-10,204,strawberry yogurt,50,60,10,1,00029,India
478134,2023-07-10,203,mango yogurt,50,60,10,1,00404,India
478134,2023-07-10,211,red bull,90,125,35,1,00404,India
478134,2023-07-10,212,amul cheese,250,315,65,1,00404,India
582930,2023-07-10,201,paneer,210,340,130,1,00192,India
582930,2023-07-10,213,bisleri,6,15,9,1,00192,India
582930,2023-07-10,207,coca cola,75,100,25,1,00192,India
472822,2023-07-10,212,amul cheese,250,315,65,1,00319,India
472822,2023-07-10,201,paneer,210,340,130,1,00319,India
312596,2023-07-10,212,amul cheese,250,315,65,1,00050,India
312596,2023-07-10,209,pepsi,75,100,25,1,00050,India
312596,2023-07-10,205,classic yogurt,45,60,15,1,00050,India
312596,2023-07-10,201,paneer,210,340,130,1,00050,India
874117,2023-07-10,208,sprite,75,100,25,1,00159,India
480287,2023-07-10,213,bisleri,6,15,9,1,00355,India
480287,2023-07-10,204,strawberry yogurt,50,60,10,1,00355,India
480287,2023-07-10,206,yakult,360,400,40,1,00355,India
758177,2023-07-10,209,pepsi,75,100,25,1,00485,India
758177,2023-07-10,206,yakult,360,400,40,1,00485,India
758177,2023-07-10,211,red bull,90,125,35,1,00485,India
379624,2023-07-10,204,strawberry yogurt,50,60,10,1,00114,India
682403,2023-07-10,212,amul cheese,250,315,65,1,00433,India
682403,2023-07-10,205,classic yogurt,45,60,15,1,00433,India
682403,2023-07-10,202,milk,12,27,15,1,00433,India
292739,2023-07-10,201,paneer,210,340,130,1,00192,India
292739,2023-07-10,211,red bull,90,125,35,1,00192,India
292739,2023-07-10,205,classic yogurt,45,60,15,1,00192,India
831832,2023-07-10,209,pepsi,75,100,25,1,00346,India
978658,2023-07-10,209,pepsi,75,100,25,1,00181,India
978658,2023-07-10,204,strawberry yogurt,50,60,10,1,00181,India
978658,2023-07-10,202,milk,12,27,15,1,00181,India
978658,2023-07-10,207,coca cola,75,100,25,1,00181,India
875211,2023-07-10,201,paneer,210,340,130,1,00163,India
875211,2023-07-10,213,bisleri,6,15,9,1,00163,India
221642,2023-07-10,206,yakult,360,400,40,1,00313,India
221642,2023-07-10,205,classic yogurt,45,60,15,1,00313,India
221642,2023-07-10,212,amul cheese,250,315,65,1,00313,India
221642,2023-07-10,213,bisleri,6,15,9,1,00313,India
253006,2023-07-10,211,red bull,90,125,35,1,00066,India
253006,2023-07-10,210,mountain dew,75,100,25,1,00066,India
253006,2023-07-10,204,strawberry yogurt,50,60,10,1,00066,India
708705,2023-07-10,212,amul cheese,250,315,65,1,00363,India
708705,2023-07-10,204,strawberry yogurt,50,60,10,1,00363,India
708705,2023-07-10,208,sprite,75,100,25,1,00363,India
708705,2023-07-10,201,paneer,210,340,130,1,00363,India
709994,2023-07-10,205,classic yogurt,45,60,15,1,00309,India
709994,2023-07-10,208,sprite,75,100,25,1,00309,India
709994,2023-07-10,203,mango yogurt,50,60,10,1,00309,India
283863,2023-07-10,207,coca cola,75,100,25,1,00330,India
507842,2023-07-10,211,red bull,90,125,35,1,00196,India
507842,2023-07-10,201,paneer,210,340,130,1,00196,India
195818,2023-07-10,207,coca cola,75,100,25,1,00415,India
195818,2023-07-10,209,pepsi,75,100,25,1,00415,India
195818,2023-07-10,201,paneer,210,340,130,1,00415,India
549647,2023-07-10,212,amul cheese,250,315,65,1,00423,India
549647,2023-07-10,210,mountain dew,75,100,25,1,00423,India
147088,2023-07-10,207,coca cola,75,100,25,1,00343,India
899390,2023-07-10,211,red bull,90,125,35,1,00138,India
899390,2023-07-10,201,paneer,210,340,130,1,00138,India
953327,2023-07-10,208,sprite,75,100,25,1,00283,India
953327,2023-07-10,201,paneer,210,340,130,1,00283,India
953327,2023-07-10,211,red bull,90,125,35,1,00283,India
271965,2023-07-10,207,coca cola,75,100,25,1,00046,India
980138,2023-07-10,207,coca cola,75,100,25,1,00217,India
396016,2023-07-10,206,yakult,360,400,40,1,00421,India
396016,2023-07-10,212,amul cheese,250,315,65,1,00421,India
396016,2023-07-10,204,strawberry yogurt,50,60,10,1,00421,India
396016,2023-07-10,210,mountain dew,75,100,25,1,00421,India
364190,2023-07-10,202,milk,12,27,15,1,00294,India
364190,2023-07-10,213,bisleri,6,15,9,1,00294,India
364190,2023-07-10,212,amul cheese,250,315,65,1,00294,India
744610,2023-07-10,201,paneer,210,340,130,1,00182,India
744610,2023-07-10,206,yakult,360,400,40,1,00182,India
744610,2023-07-10,212,amul cheese,250,315,65,1,00182,India
702651,2023-07-10,207,coca cola,75,100,25,1,00151,India
702651,2023-07-10,206,yakult,360,400,40,1,00151,India
702651,2023-07-10,211,red bull,90,125,35,1,00151,India
702651,2023-07-10,208,sprite,75,100,25,1,00151,India
108730,2023-07-10,208,sprite,75,100,25,1,00065,India
108730,2023-07-10,209,pepsi,75,100,25,1,00065,India
492349,2023-07-10,202,milk,12,27,15,1,00039,India
757501,2023-07-10,207,coca cola,75,100,25,1,00217,India
295762,2023-07-10,211,red bull,90,125,35,1,00047,India
295762,2023-07-10,212,amul cheese,250,315,65,1,00047,India
295762,2023-07-10,202,milk,12,27,15,1,00047,India
295762,2023-07-10,206,yakult,360,400,40,1,00047,India
804375,2023-07-10,209,pepsi,75,100,25,1,00295,India
804375,2023-07-10,204,strawberry yogurt,50,60,10,1,00295,India
804375,2023-07-10,210,mountain dew,75,100,25,1,00295,India
804375,2023-07-10,211,red bull,90,125,35,1,00295,India
947328,2023-07-10,202,milk,12,27,15,1,00294,India
584120,2023-07-10,201,paneer,210,340,130,1,00405,India
584120,2023-07-10,210,mountain dew,75,100,25,1,00405,India
584120,2023-07-10,212,amul cheese,250,315,65,1,00405,India
584120,2023-07-10,211,red bull,90,125,35,1,00405,India
584120,2023-07-10,209,pepsi,75,100,25,1,00405,India
662359,2023-07-10,205,classic yogurt,45,60,15,1,00370,India
662359,2023-07-10,213,bisleri,6,15,9,1,00370,India
662359,2023-07-10,208,sprite,75,100,25,1,00370,India
705070,2023-07-10,209,pepsi,75,100,25,1,00342,India
705070,2023-07-10,205,classic yogurt,45,60,15,1,00342,India
705070,2023-07-10,206,yakult,360,400,40,1,00342,India
705070,2023-07-10,208,sprite,75,100,25,1,00342,India
107043,2023-07-10,204,strawberry yogurt,50,60,10,1,00266,India
107043,2023-07-10,206,yakult,360,400,40,1,00266,India
119758,2023-07-10,204,strawberry yogurt,50,60,10,1,00227,India
119758,2023-07-10,201,paneer,210,340,130,1,00227,India
187469,2023-07-10,210,mountain dew,75,100,25,1,00282,India
187469,2023-07-10,211,red bull,90,125,35,1,00282,India
187469,2023-07-10,202,milk,12,27,15,1,00282,India
246526,2023-07-10,210,mountain dew,75,100,25,1,00241,India
276073,2023-07-10,209,pepsi,75,100,25,1,00405,India
276073,2023-07-10,206,yakult,360,400,40,1,00405,India
136394,2023-07-10,212,amul cheese,250,315,65,1,00283,India
136394,2023-07-10,210,mountain dew,75,100,25,1,00283,India
136394,2023-07-10,208,sprite,75,100,25,1,00283,India
136394,2023-07-10,211,red bull,90,125,35,1,00283,India
136394,2023-07-10,213,bisleri,6,15,9,1,00283,India
686022,2023-07-10,202,milk,12,27,15,1,00064,India
616454,2023-07-10,201,paneer,210,340,130,1,00100,India
616454,2023-07-10,205,classic yogurt,45,60,15,1,00100,India
616454,2023-07-10,211,red bull,90,125,35,1,00100,India
616454,2023-07-10,212,amul cheese,250,315,65,1,00100,India
616454,2023-07-10,206,yakult,360,400,40,1,00100,India
740227,2023-07-10,209,pepsi,75,100,25,1,00317,India
740227,2023-07-10,210,mountain dew,75,100,25,1,00317,India
740227,2023-07-10,201,paneer,210,340,130,1,00317,India
501697,2023-07-10,201,paneer,210,340,130,1,00173,India
501697,2023-07-10,207,coca cola,75,100,25,1,00173,India
501697,2023-07-10,202,milk,12,27,15,1,00173,India
501697,2023-07-10,208,sprite,75,100,25,1,00173,India
942292,2023-07-10,208,sprite,75,100,25,1,00226,India
942292,2023-07-10,212,amul cheese,250,315,65,1,00226,India
504521,2023-07-10,208,sprite,75,100,25,1,00493,India
504521,2023-07-10,201,paneer,210,340,130,1,00493,India
824546,2023-07-10,210,mountain dew,75,100,25,1,00380,India
306964,2023-07-11,213,bisleri,6,15,9,1,00350,India
306964,2023-07-11,212,amul cheese,250,315,65,1,00350,India
306964,2023-07-11,209,pepsi,75,100,25,1,00350,India
306964,2023-07-11,210,mountain dew,75,100,25,1,00350,India
501976,2023-07-11,212,amul cheese,250,315,65,1,00333,India
501976,2023-07-11,202,milk,12,27,15,1,00333,India
551553,2023-07-11,203,mango yogurt,50,60,10,1,00016,India
551553,2023-07-11,210,mountain dew,75,100,25,1,00016,India
551553,2023-07-11,207,coca cola,75,100,25,1,00016,India
326576,2023-07-11,202,milk,12,27,15,1,00029,India
326576,2023-07-11,203,mango yogurt,50,60,10,1,00029,India
326576,2023-07-11,207,coca cola,75,100,25,1,00029,India
831356,2023-07-11,213,bisleri,6,15,9,1,00498,India
831356,2023-07-11,204,strawberry yogurt,50,60,10,1,00498,India
831356,2023-07-11,211,red bull,90,125,35,1,00498,India
831356,2023-07-11,208,sprite,75,100,25,1,00498,India
475507,2023-07-11,205,classic yogurt,45,60,15,1,00434,India
475507,2023-07-11,208,sprite,75,100,25,1,00434,India
600533,2023-07-11,206,yakult,360,400,40,1,00473,India
626769,2023-07-11,207,coca cola,75,100,25,1,00364,India
626769,2023-07-11,206,yakult,360,400,40,1,00364,India
626769,2023-07-11,210,mountain dew,75,100,25,1,00364,India
626769,2023-07-11,212,amul cheese,250,315,65,1,00364,India
972923,2023-07-11,201,paneer,210,340,130,1,00202,India
556764,2023-07-11,212,amul cheese,250,315,65,1,00376,India
556764,2023-07-11,206,yakult,360,400,40,1,00376,India
556764,2023-07-11,209,pepsi,75,100,25,1,00376,India
556764,2023-07-11,205,classic yogurt,45,60,15,1,00376,India
547758,2023-07-11,201,paneer,210,340,130,1,00307,India
547758,2023-07-11,202,milk,12,27,15,1,00307,India
918884,2023-07-11,204,strawberry yogurt,50,60,10,1,00244,India
918884,2023-07-11,211,red bull,90,125,35,1,00244,India
491641,2023-07-11,207,coca cola,75,100,25,1,00326,India
491641,2023-07-11,205,classic yogurt,45,60,15,1,00326,India
524223,2023-07-11,203,mango yogurt,50,60,10,1,00221,India
234567,2023-07-11,202,milk,12,27,15,1,00385,India
234567,2023-07-11,201,paneer,210,340,130,1,00385,India
234567,2023-07-11,212,amul cheese,250,315,65,1,00385,India
234567,2023-07-11,203,mango yogurt,50,60,10,1,00385,India
234567,2023-07-11,211,red bull,90,125,35,1,00385,India
389403,2023-07-11,204,strawberry yogurt,50,60,10,1,00404,India
389403,2023-07-11,211,red bull,90,125,35,1,00404,India
389403,2023-07-11,213,bisleri,6,15,9,1,00404,India
389403,2023-07-11,202,milk,12,27,15,1,00404,India
545158,2023-07-11,205,classic yogurt,45,60,15,1,00206,India
545158,2023-07-11,206,yakult,360,400,40,1,00206,India
545158,2023-07-11,203,mango yogurt,50,60,10,1,00206,India
366396,2023-07-11,209,pepsi,75,100,25,1,00111,India
366396,2023-07-11,206,yakult,360,400,40,1,00111,India
366396,2023-07-11,212,amul cheese,250,315,65,1,00111,India
366396,2023-07-11,202,milk,12,27,15,1,00111,India
658672,2023-07-11,201,paneer,210,340,130,1,00179,India
658672,2023-07-11,208,sprite,75,100,25,1,00179,India
658672,2023-07-11,207,coca cola,75,100,25,1,00179,India
658672,2023-07-11,202,milk,12,27,15,1,00179,India
914298,2023-07-11,209,pepsi,75,100,25,1,00320,India
914298,2023-07-11,208,sprite,75,100,25,1,00320,India
195517,2023-07-11,213,bisleri,6,15,9,1,00404,India
195517,2023-07-11,209,pepsi,75,100,25,1,00404,India
195517,2023-07-11,206,yakult,360,400,40,1,00404,India
195517,2023-07-11,211,red bull,90,125,35,1,00404,India
401011,2023-07-11,211,red bull,90,125,35,1,00381,India
401011,2023-07-11,213,bisleri,6,15,9,1,00381,India
401011,2023-07-11,203,mango yogurt,50,60,10,1,00381,India
401011,2023-07-11,209,pepsi,75,100,25,1,00381,India
179933,2023-07-11,213,bisleri,6,15,9,1,00053,India
880644,2023-07-11,212,amul cheese,250,315,65,1,00459,India
880644,2023-07-11,206,yakult,360,400,40,1,00459,India
880644,2023-07-11,203,mango yogurt,50,60,10,1,00459,India
880644,2023-07-11,201,paneer,210,340,130,1,00459,India
880644,2023-07-11,204,strawberry yogurt,50,60,10,1,00459,India
961302,2023-07-11,203,mango yogurt,50,60,10,1,00380,India
961302,2023-07-11,208,sprite,75,100,25,1,00380,India
961302,2023-07-11,202,milk,12,27,15,1,00380,India
961302,2023-07-11,205,classic yogurt,45,60,15,1,00380,India
291183,2023-07-11,209,pepsi,75,100,25,1,00295,India
802631,2023-07-11,201,paneer,210,340,130,1,00398,India
802631,2023-07-11,202,milk,12,27,15,1,00398,India
802631,2023-07-11,208,sprite,75,100,25,1,00398,India
638148,2023-07-11,203,mango yogurt,50,60,10,1,00499,India
651024,2023-07-11,205,classic yogurt,45,60,15,1,00435,India
651024,2023-07-11,208,sprite,75,100,25,1,00435,India
651024,2023-07-11,203,mango yogurt,50,60,10,1,00435,India
651024,2023-07-11,206,yakult,360,400,40,1,00435,India
164188,2023-07-11,205,classic yogurt,45,60,15,1,00191,India
164188,2023-07-11,201,paneer,210,340,130,1,00191,India
439269,2023-07-11,208,sprite,75,100,25,1,00295,India
439269,2023-07-11,211,red bull,90,125,35,1,00295,India
439269,2023-07-11,210,mountain dew,75,100,25,1,00295,India
439269,2023-07-11,206,yakult,360,400,40,1,00295,India
429071,2023-07-11,202,milk,12,27,15,1,00032,India
453648,2023-07-11,206,yakult,360,400,40,1,00396,India
453648,2023-07-11,209,pepsi,75,100,25,1,00396,India
453648,2023-07-11,208,sprite,75,100,25,1,00396,India
453648,2023-07-11,204,strawberry yogurt,50,60,10,1,00396,India
453648,2023-07-11,211,red bull,90,125,35,1,00396,India
777160,2023-07-11,205,classic yogurt,45,60,15,1,00019,India
777160,2023-07-11,202,milk,12,27,15,1,00019,India
777160,2023-07-11,208,sprite,75,100,25,1,00019,India
777160,2023-07-11,207,coca cola,75,100,25,1,00019,India
777160,2023-07-11,209,pepsi,75,100,25,1,00019,India
968380,2023-07-11,210,mountain dew,75,100,25,1,00418,India
800360,2023-07-11,206,yakult,360,400,40,1,00414,India
800360,2023-07-11,203,mango yogurt,50,60,10,1,00414,India
402766,2023-07-11,205,classic yogurt,45,60,15,1,00128,India
402766,2023-07-11,207,coca cola,75,100,25,1,00128,India
402766,2023-07-11,209,pepsi,75,100,25,1,00128,India
255020,2023-07-11,211,red bull,90,125,35,1,00172,India
283943,2023-07-11,210,mountain dew,75,100,25,1,00319,India
283943,2023-07-11,203,mango yogurt,50,60,10,1,00319,India
283943,2023-07-11,211,red bull,90,125,35,1,00319,India
283943,2023-07-11,212,amul cheese,250,315,65,1,00319,India
598727,2023-07-11,208,sprite,75,100,25,1,00026,India
487875,2023-07-11,208,sprite,75,100,25,1,00430,India
978271,2023-07-11,209,pepsi,75,100,25,1,00259,India
978271,2023-07-11,207,coca cola,75,100,25,1,00259,India
978271,2023-07-11,206,yakult,360,400,40,1,00259,India
266276,2023-07-11,203,mango yogurt,50,60,10,1,00162,India
266276,2023-07-11,202,milk,12,27,15,1,00162,India
266276,2023-07-11,206,yakult,360,400,40,1,00162,India
679806,2023-07-11,209,pepsi,75,100,25,1,00062,India
309570,2023-07-11,209,pepsi,75,100,25,1,00237,India
309570,2023-07-11,213,bisleri,6,15,9,1,00237,India
309570,2023-07-11,202,milk,12,27,15,1,00237,India
309570,2023-07-11,201,paneer,210,340,130,1,00237,India
309570,2023-07-11,210,mountain dew,75,100,25,1,00237,India
549491,2023-07-11,201,paneer,210,340,130,1,00358,India
549491,2023-07-11,207,coca cola,75,100,25,1,00358,India
549491,2023-07-11,205,classic yogurt,45,60,15,1,00358,India
927351,2023-07-11,202,milk,12,27,15,1,00107,India
927351,2023-07-11,210,mountain dew,75,100,25,1,00107,India
927351,2023-07-11,213,bisleri,6,15,9,1,00107,India
927351,2023-07-11,206,yakult,360,400,40,1,00107,India
808509,2023-07-11,210,mountain dew,75,100,25,1,00050,India
970267,2023-07-11,211,red bull,90,125,35,1,00351,India
830707,2023-07-11,205,classic yogurt,45,60,15,1,00430,India
830707,2023-07-11,204,strawberry yogurt,50,60,10,1,00430,India
830707,2023-07-11,212,amul cheese,250,315,65,1,00430,India
830707,2023-07-11,213,bisleri,6,15,9,1,00430,India
963730,2023-07-11,202,milk,12,27,15,1,00113,India
963730,2023-07-11,212,amul cheese,250,315,65,1,00113,India
963730,2023-07-11,210,mountain dew,75,100,25,1,00113,India
963730,2023-07-11,201,paneer,210,340,130,1,00113,India
963730,2023-07-11,207,coca cola,75,100,25,1,00113,India
475653,2023-07-11,210,mountain dew,75,100,25,1,00110,India
475653,2023-07-11,202,milk,12,27,15,1,00110,India
898871,2023-07-11,206,yakult,360,400,40,1,00044,India
898871,2023-07-11,203,mango yogurt,50,60,10,1,00044,India
705567,2023-07-11,206,yakult,360,400,40,1,00139,India
705567,2023-07-11,201,paneer,210,340,130,1,00139,India
705567,2023-07-11,208,sprite,75,100,25,1,00139,India
468782,2023-07-11,205,classic yogurt,45,60,15,1,00500,India
468782,2023-07-11,211,red bull,90,125,35,1,00500,India
468782,2023-07-11,201,paneer,210,340,130,1,00500,India
468782,2023-07-11,206,yakult,360,400,40,1,00500,India
228684,2023-07-11,203,mango yogurt,50,60,10,1,00183,India
125909,2023-07-11,202,milk,12,27,15,1,00409,India
705992,2023-07-11,204,strawberry yogurt,50,60,10,1,00013,India
705992,2023-07-11,212,amul cheese,250,315,65,1,00013,India
705992,2023-07-11,206,yakult,360,400,40,1,00013,India
705992,2023-07-11,208,sprite,75,100,25,1,00013,India
705992,2023-07-11,211,red bull,90,125,35,1,00013,India
698283,2023-07-11,204,strawberry yogurt,50,60,10,1,00288,India
698283,2023-07-11,201,paneer,210,340,130,1,00288,India
467073,2023-07-11,210,mountain dew,75,100,25,1,00390,India
754502,2023-07-11,204,strawberry yogurt,50,60,10,1,00179,India
145985,2023-07-11,210,mountain dew,75,100,25,1,00043,India
281887,2023-07-11,202,milk,12,27,15,1,00069,India
516977,2023-07-11,203,mango yogurt,50,60,10,1,00216,India
516977,2023-07-11,213,bisleri,6,15,9,1,00216,India
237429,2023-07-11,201,paneer,210,340,130,1,00480,India
237429,2023-07-11,210,mountain dew,75,100,25,1,00480,India
237429,2023-07-11,211,red bull,90,125,35,1,00480,India
266573,2023-07-11,208,sprite,75,100,25,1,00023,India
266573,2023-07-11,212,amul cheese,250,315,65,1,00023,India
266573,2023-07-11,203,mango yogurt,50,60,10,1,00023,India
782352,2023-07-11,203,mango yogurt,50,60,10,1,00173,India
104261,2023-07-11,206,yakult,360,400,40,1,00083,India
617339,2023-07-11,212,amul cheese,250,315,65,1,00132,India
617339,2023-07-11,203,mango yogurt,50,60,10,1,00132,India
617339,2023-07-11,201,paneer,210,340,130,1,00132,India
617339,2023-07-11,202,milk,12,27,15,1,00132,India
821735,2023-07-11,205,classic yogurt,45,60,15,1,00046,India
821735,2023-07-11,212,amul cheese,250,315,65,1,00046,India
821735,2023-07-11,208,sprite,75,100,25,1,00046,India
487986,2023-07-11,210,mountain dew,75,100,25,1,00330,India
487986,2023-07-11,206,yakult,360,400,40,1,00330,India
487986,2023-07-11,211,red bull,90,125,35,1,00330,India
174810,2023-07-11,213,bisleri,6,15,9,1,00201,India
174810,2023-07-11,210,mountain dew,75,100,25,1,00201,India
174810,2023-07-11,202,milk,12,27,15,1,00201,India
234789,2023-07-11,206,yakult,360,400,40,1,00099,India
234789,2023-07-11,208,sprite,75,100,25,1,00099,India
623091,2023-07-11,201,paneer,210,340,130,1,00022,India
623091,2023-07-11,212,amul cheese,250,315,65,1,00022,India
623091,2023-07-11,206,yakult,360,400,40,1,00022,India
874378,2023-07-11,213,bisleri,6,15,9,1,00301,India
874378,2023-07-11,205,classic yogurt,45,60,15,1,00301,India
874378,2023-07-11,210,mountain dew,75,100,25,1,00301,India
690747,2023-07-11,201,paneer,210,340,130,1,00154,India
664579,2023-07-12,211,red bull,90,125,35,1,00342,India
664579,2023-07-12,209,pepsi,75,100,25,1,00342,India
949564,2023-07-12,205,classic yogurt,45,60,15,1,00157,India
949564,2023-07-12,204,strawberry yogurt,50,60,10,1,00157,India
554829,2023-07-12,209,pepsi,75,100,25,1,00245,India
554829,2023-07-12,201,paneer,210,340,130,1,00245,India
554829,2023-07-12,210,mountain dew,75,100,25,1,00245,India
554829,2023-07-12,212,amul cheese,250,315,65,1,00245,India
266945,2023-07-12,211,red bull,90,125,35,1,00302,India
266945,2023-07-12,202,milk,12,27,15,1,00302,India
266945,2023-07-12,210,mountain dew,75,100,25,1,00302,India
266945,2023-07-12,208,sprite,75,100,25,1,00302,India
521524,2023-07-12,208,sprite,75,100,25,1,00042,India
521524,2023-07-12,202,milk,12,27,15,1,00042,India
665313,2023-07-12,201,paneer,210,340,130,1,00183,India
665313,2023-07-12,212,amul cheese,250,315,65,1,00183,India
559732,2023-07-12,213,bisleri,6,15,9,1,00245,India
559732,2023-07-12,206,yakult,360,400,40,1,00245,India
559732,2023-07-12,207,coca cola,75,100,25,1,00245,India
199047,2023-07-12,212,amul cheese,250,315,65,1,00077,India
199047,2023-07-12,207,coca cola,75,100,25,1,00077,India
199047,2023-07-12,205,classic yogurt,45,60,15,1,00077,India
789687,2023-07-12,205,classic yogurt,45,60,15,1,00088,India
789687,2023-07-12,208,sprite,75,100,25,1,00088,India
327744,2023-07-12,208,sprite,75,100,25,1,00096,India
327744,2023-07-12,206,yakult,360,400,40,1,00096,India
327744,2023-07-12,207,coca cola,75,100,25,1,00096,India
327744,2023-07-12,203,mango yogurt,50,60,10,1,00096,India
112786,2023-07-12,206,yakult,360,400,40,1,00202,India
112786,2023-07-12,209,pepsi,75,100,25,1,00202,India
880377,2023-07-12,206,yakult,360,400,40,1,00153,India
100664,2023-07-12,213,bisleri,6,15,9,1,00329,India
100664,2023-07-12,211,red bull,90,125,35,1,00329,India
100664,2023-07-12,206,yakult,360,400,40,1,00329,India
473391,2023-07-12,204,strawberry yogurt,50,60,10,1,00251,India
473391,2023-07-12,210,mountain dew,75,100,25,1,00251,India
473391,2023-07-12,211,red bull,90,125,35,1,00251,India
852566,2023-07-12,201,paneer,210,340,130,1,00109,India
852566,2023-07-12,207,coca cola,75,100,25,1,00109,India
852566,2023-07-12,211,red bull,90,125,35,1,00109,India
607288,2023-07-12,211,red bull,90,125,35,1,00210,India
607288,2023-07-12,203,mango yogurt,50,60,10,1,00210,India
607288,2023-07-12,206,yakult,360,400,40,1,00210,India
813415,2023-07-12,206,yakult,360,400,40,1,00301,India
813415,2023-07-12,205,classic yogurt,45,60,15,1,00301,India
813415,2023-07-12,204,strawberry yogurt,50,60,10,1,00301,India
813415,2023-07-12,201,paneer,210,340,130,1,00301,India
813415,2023-07-12,210,mountain dew,75,100,25,1,00301,India
428759,2023-07-12,210,mountain dew,75,100,25,1,00296,India
428759,2023-07-12,204,strawberry yogurt,50,60,10,1,00296,India
592266,2023-07-12,205,classic yogurt,45,60,15,1,00221,India
592266,2023-07-12,206,yakult,360,400,40,1,00221,India
430557,2023-07-12,210,mountain dew,75,100,25,1,00134,India
430557,2023-07-12,213,bisleri,6,15,9,1,00134,India
353404,2023-07-12,209,pepsi,75,100,25,1,00259,India
353404,2023-07-12,207,coca cola,75,100,25,1,00259,India
353404,2023-07-12,206,yakult,360,400,40,1,00259,India
353404,2023-07-12,201,paneer,210,340,130,1,00259,India
151147,2023-07-12,201,paneer,210,340,130,1,00402,India
151147,2023-07-12,205,classic yogurt,45,60,15,1,00402,India
151147,2023-07-12,208,sprite,75,100,25,1,00402,India
850477,2023-07-12,209,pepsi,75,100,25,1,00394,India
850477,2023-07-12,202,milk,12,27,15,1,00394,India
850477,2023-07-12,211,red bull,90,125,35,1,00394,India
850477,2023-07-12,207,coca cola,75,100,25,1,00394,India
845577,2023-07-12,206,yakult,360,400,40,1,00333,India
845577,2023-07-12,202,milk,12,27,15,1,00333,India
952588,2023-07-12,203,mango yogurt,50,60,10,1,00128,India
952588,2023-07-12,213,bisleri,6,15,9,1,00128,India
952588,2023-07-12,210,mountain dew,75,100,25,1,00128,India
952588,2023-07-12,209,pepsi,75,100,25,1,00128,India
952588,2023-07-12,211,red bull,90,125,35,1,00128,India
287765,2023-07-12,204,strawberry yogurt,50,60,10,1,00223,India
287765,2023-07-12,211,red bull,90,125,35,1,00223,India
287765,2023-07-12,210,mountain dew,75,100,25,1,00223,India
287765,2023-07-12,207,coca cola,75,100,25,1,00223,India
788524,2023-07-12,210,mountain dew,75,100,25,1,00372,India
788524,2023-07-12,207,coca cola,75,100,25,1,00372,India
788524,2023-07-12,202,milk,12,27,15,1,00372,India
788524,2023-07-12,209,pepsi,75,100,25,1,00372,India
864850,2023-07-12,213,bisleri,6,15,9,1,00110,India
864850,2023-07-12,212,amul cheese,250,315,65,1,00110,India
864850,2023-07-12,209,pepsi,75,100,25,1,00110,India
102963,2023-07-12,203,mango yogurt,50,60,10,1,00028,India
373813,2023-07-12,213,bisleri,6,15,9,1,00023,India
373813,2023-07-12,208,sprite,75,100,25,1,00023,India
373813,2023-07-12,206,yakult,360,400,40,1,00023,India
156684,2023-07-12,205,classic yogurt,45,60,15,1,00047,India
618287,2023-07-12,201,paneer,210,340,130,1,00483,India
618287,2023-07-12,204,strawberry yogurt,50,60,10,1,00483,India
618287,2023-07-12,212,amul cheese,250,315,65,1,00483,India
618287,2023-07-12,211,red bull,90,125,35,1,00483,India
733578,2023-07-12,201,paneer,210,340,130,1,00252,India
733578,2023-07-12,209,pepsi,75,100,25,1,00252,India
733578,2023-07-12,208,sprite,75,100,25,1,00252,India
887669,2023-07-12,205,classic yogurt,45,60,15,1,00098,India
887669,2023-07-12,203,mango yogurt,50,60,10,1,00098,India
887669,2023-07-12,202,milk,12,27,15,1,00098,India
887669,2023-07-12,213,bisleri,6,15,9,1,00098,India
881747,2023-07-12,201,paneer,210,340,130,1,00407,India
118024,2023-07-12,208,sprite,75,100,25,1,00348,India
118024,2023-07-12,204,strawberry yogurt,50,60,10,1,00348,India
118024,2023-07-12,206,yakult,360,400,40,1,00348,India
118024,2023-07-12,213,bisleri,6,15,9,1,00348,India
118024,2023-07-12,207,coca cola,75,100,25,1,00348,India
342615,2023-07-12,204,strawberry yogurt,50,60,10,1,00313,India
342615,2023-07-12,211,red bull,90,125,35,1,00313,India
342615,2023-07-12,201,paneer,210,340,130,1,00313,India
342615,2023-07-12,206,yakult,360,400,40,1,00313,India
317148,2023-07-12,210,mountain dew,75,100,25,1,00296,India
317148,2023-07-12,201,paneer,210,340,130,1,00296,India
317148,2023-07-12,209,pepsi,75,100,25,1,00296,India
317148,2023-07-12,212,amul cheese,250,315,65,1,00296,India
439691,2023-07-12,202,milk,12,27,15,1,00415,India
776980,2023-07-12,208,sprite,75,100,25,1,00073,India
776980,2023-07-12,203,mango yogurt,50,60,10,1,00073,India
776980,2023-07-12,209,pepsi,75,100,25,1,00073,India
776980,2023-07-12,202,milk,12,27,15,1,00073,India
961484,2023-07-12,206,yakult,360,400,40,1,00365,India
961484,2023-07-12,207,coca cola,75,100,25,1,00365,India
404423,2023-07-12,209,pepsi,75,100,25,1,00224,India
404423,2023-07-12,208,sprite,75,100,25,1,00224,India
404423,2023-07-12,201,paneer,210,340,130,1,00224,India
821810,2023-07-12,208,sprite,75,100,25,1,00156,India
588480,2023-07-12,203,mango yogurt,50,60,10,1,00193,India
588480,2023-07-12,204,strawberry yogurt,50,60,10,1,00193,India
588480,2023-07-12,213,bisleri,6,15,9,1,00193,India
326639,2023-07-12,207,coca cola,75,100,25,1,00436,India
326639,2023-07-12,203,mango yogurt,50,60,10,1,00436,India
326639,2023-07-12,205,classic yogurt,45,60,15,1,00436,India
661148,2023-07-12,209,pepsi,75,100,25,1,00138,India
661148,2023-07-12,205,classic yogurt,45,60,15,1,00138,India
893710,2023-07-12,206,yakult,360,400,40,1,00309,India
363013,2023-07-12,209,pepsi,75,100,25,1,00227,India
363013,2023-07-12,212,amul cheese,250,315,65,1,00227,India
363013,2023-07-12,202,milk,12,27,15,1,00227,India
363013,2023-07-12,206,yakult,360,400,40,1,00227,India
839406,2023-07-12,212,amul cheese,250,315,65,1,00036,India
588284,2023-07-12,203,mango yogurt,50,60,10,1,00307,India
588284,2023-07-12,205,classic yogurt,45,60,15,1,00307,India
717226,2023-07-12,212,amul cheese,250,315,65,1,00445,India
715623,2023-07-12,209,pepsi,75,100,25,1,00077,India
715623,2023-07-12,201,paneer,210,340,130,1,00077,India
715623,2023-07-12,212,amul cheese,250,315,65,1,00077,India
715623,2023-07-12,208,sprite,75,100,25,1,00077,India
572358,2023-07-12,201,paneer,210,340,130,1,00465,India
779380,2023-07-12,203,mango yogurt,50,60,10,1,00190,India
779380,2023-07-12,205,classic yogurt,45,60,15,1,00190,India
779380,2023-07-12,208,sprite,75,100,25,1,00190,India
779380,2023-07-12,209,pepsi,75,100,25,1,00190,India
738337,2023-07-12,208,sprite,75,100,25,1,00155,India
738337,2023-07-12,213,bisleri,6,15,9,1,00155,India
953606,2023-07-12,210,mountain dew,75,100,25,1,00097,India
953606,2023-07-12,209,pepsi,75,100,25,1,00097,India
921052,2023-07-12,201,paneer,210,340,130,1,00464,India
921052,2023-07-12,207,coca cola,75,100,25,1,00464,India
921052,2023-07-12,211,red bull,90,125,35,1,00464,India
921052,2023-07-12,213,bisleri,6,15,9,1,00464,India
944668,2023-07-12,205,classic yogurt,45,60,15,1,00009,India
944668,2023-07-12,212,amul cheese,250,315,65,1,00009,India
944668,2023-07-12,209,pepsi,75,100,25,1,00009,India
774404,2023-07-12,209,pepsi,75,100,25,1,00436,India
774404,2023-07-12,203,mango yogurt,50,60,10,1,00436,India
774404,2023-07-12,202,milk,12,27,15,1,00436,India
925645,2023-07-12,210,mountain dew,75,100,25,1,00237,India
925645,2023-07-12,205,classic yogurt,45,60,15,1,00237,India
925645,2023-07-12,209,pepsi,75,100,25,1,00237,India
925645,2023-07-12,202,milk,12,27,15,1,00237,India
925645,2023-07-12,208,sprite,75,100,25,1,00237,India
813835,2023-07-12,206,yakult,360,400,40,1,00288,India
813835,2023-07-12,204,strawberry yogurt,50,60,10,1,00288,India
813835,2023-07-12,207,coca cola,75,100,25,1,00288,India
914010,2023-07-12,203,mango yogurt,50,60,10,1,00293,India
453003,2023-07-12,210,mountain dew,75,100,25,1,00496,India
453003,2023-07-12,201,paneer,210,340,130,1,00496,India
453003,2023-07-12,208,sprite,75,100,25,1,00496,India
453003,2023-07-12,213,bisleri,6,15,9,1,00496,India
595198,2023-07-12,213,bisleri,6,15,9,1,00009,India
595198,2023-07-12,207,coca cola,75,100,25,1,00009,India
595198,2023-07-12,206,yakult,360,400,40,1,00009,India
404182,2023-07-13,210,mountain dew,75,100,25,1,00389,India
404182,2023-07-13,204,strawberry yogurt,50,60,10,1,00389,India
404182,2023-07-13,201,paneer,210,340,130,1,00389,India
404182,2023-07-13,212,amul cheese,250,315,65,1,00389,India
309324,2023-07-13,207,coca cola,75,100,25,1,00349,India
309324,2023-07-13,209,pepsi,75,100,25,1,00349,India
309324,2023-07-13,212,amul cheese,250,315,65,1,00349,India
386497,2023-07-13,212,amul cheese,250,315,65,1,00131,India
386497,2023-07-13,205,classic yogurt,45,60,15,1,00131,India
386497,2023-07-13,206,yakult,360,400,40,1,00131,India
386497,2023-07-13,213,bisleri,6,15,9,1,00131,India
743008,2023-07-13,201,paneer,210,340,130,1,00345,India
743008,2023-07-13,205,classic yogurt,45,60,15,1,00345,India
743008,2023-07-13,213,bisleri,6,15,9,1,00345,India
303506,2023-07-13,202,milk,12,27,15,1,00211,India
303506,2023-07-13,204,strawberry yogurt,50,60,10,1,00211,India
392000,2023-07-13,210,mountain dew,75,100,25,1,00222,India
392000,2023-07-13,205,classic yogurt,45,60,15,1,00222,India
115332,2023-07-13,202,milk,12,27,15,1,00096,India
351608,2023-07-13,210,mountain dew,75,100,25,1,00255,India
351608,2023-07-13,206,yakult,360,400,40,1,00255,India
351608,2023-07-13,203,mango yogurt,50,60,10,1,00255,India
351608,2023-07-13,204,strawberry yogurt,50,60,10,1,00255,India
879904,2023-07-13,202,milk,12,27,15,1,00427,India
923237,2023-07-13,213,bisleri,6,15,9,1,00317,India
923237,2023-07-13,204,strawberry yogurt,50,60,10,1,00317,India
923237,2023-07-13,205,classic yogurt,45,60,15,1,00317,India
923237,2023-07-13,209,pepsi,75,100,25,1,00317,India
923237,2023-07-13,208,sprite,75,100,25,1,00317,India
439069,2023-07-13,208,sprite,75,100,25,1,00075,India
439069,2023-07-13,201,paneer,210,340,130,1,00075,India
439069,2023-07-13,207,coca cola,75,100,25,1,00075,India
721168,2023-07-13,209,pepsi,75,100,25,1,00451,India
721168,2023-07-13,213,bisleri,6,15,9,1,00451,India
952259,2023-07-13,209,pepsi,75,100,25,1,00179,India
952259,2023-07-13,212,amul cheese,250,315,65,1,00179,India
952259,2023-07-13,208,sprite,75,100,25,1,00179,India
952259,2023-07-13,206,yakult,360,400,40,1,00179,India
317078,2023-07-13,210,mountain dew,75,100,25,1,00430,India
317078,2023-07-13,208,sprite,75,100,25,1,00430,India
317078,2023-07-13,213,bisleri,6,15,9,1,00430,India
543988,2023-07-13,207,coca cola,75,100,25,1,00184,India
543988,2023-07-13,201,paneer,210,340,130,1,00184,India
859701,2023-07-13,201,paneer,210,340,130,1,00009,India
387298,2023-07-13,208,sprite,75,100,25,1,00441,India
387298,2023-07-13,207,coca cola,75,100,25,1,00441,India
365756,2023-07-13,211,red bull,90,125,35,1,00184,India
365756,2023-07-13,213,bisleri,6,15,9,1,00184,India
884780,2023-07-13,209,pepsi,75,100,25,1,00269,India
884780,2023-07-13,212,amul cheese,250,315,65,1,00269,India
717994,2023-07-13,213,bisleri,6,15,9,1,00209,India
717994,2023-07-13,202,milk,12,27,15,1,00209,India
953001,2023-07-13,204,strawberry yogurt,50,60,10,1,00464,India
953001,2023-07-13,205,classic yogurt,45,60,15,1,00464,India
859957,2023-07-13,213,bisleri,6,15,9,1,00278,India
634099,2023-07-13,204,strawberry yogurt,50,60,10,1,00460,India
634099,2023-07-13,205,classic yogurt,45,60,15,1,00460,India
634099,2023-07-13,206,yakult,360,400,40,1,00460,India
634099,2023-07-13,208,sprite,75,100,25,1,00460,India
422099,2023-07-13,208,sprite,75,100,25,1,00378,India
422099,2023-07-13,212,amul cheese,250,315,65,1,00378,India
422099,2023-07-13,207,coca cola,75,100,25,1,00378,India
422099,2023-07-13,205,classic yogurt,45,60,15,1,00378,India
598914,2023-07-13,205,classic yogurt,45,60,15,1,00420,India
730609,2023-07-13,208,sprite,75,100,25,1,00130,India
730609,2023-07-13,204,strawberry yogurt,50,60,10,1,00130,India
730609,2023-07-13,211,red bull,90,125,35,1,00130,India
329352,2023-07-13,202,milk,12,27,15,1,00246,India
197039,2023-07-13,208,sprite,75,100,25,1,00269,India
197039,2023-07-13,201,paneer,210,340,130,1,00269,India
197039,2023-07-13,209,pepsi,75,100,25,1,00269,India
197039,2023-07-13,213,bisleri,6,15,9,1,00269,India
446122,2023-07-13,202,milk,12,27,15,1,00335,India
446122,2023-07-13,212,amul cheese,250,315,65,1,00335,India
446122,2023-07-13,205,classic yogurt,45,60,15,1,00335,India
446122,2023-07-13,201,paneer,210,340,130,1,00335,India
881406,2023-07-13,205,classic yogurt,45,60,15,1,00365,India
700311,2023-07-13,204,strawberry yogurt,50,60,10,1,00305,India
700311,2023-07-13,205,classic yogurt,45,60,15,1,00305,India
599445,2023-07-13,210,mountain dew,75,100,25,1,00377,India
599445,2023-07-13,209,pepsi,75,100,25,1,00377,India
599445,2023-07-13,211,red bull,90,125,35,1,00377,India
753317,2023-07-13,207,coca cola,75,100,25,1,00326,India
105477,2023-07-13,210,mountain dew,75,100,25,1,00168,India
843178,2023-07-13,202,milk,12,27,15,1,00307,India
843178,2023-07-13,201,paneer,210,340,130,1,00307,India
151030,2023-07-13,201,paneer,210,340,130,1,00491,India
151030,2023-07-13,211,red bull,90,125,35,1,00491,India
151030,2023-07-13,212,amul cheese,250,315,65,1,00491,India
413121,2023-07-13,211,red bull,90,125,35,1,00314,India
413121,2023-07-13,205,classic yogurt,45,60,15,1,00314,India
413121,2023-07-13,203,mango yogurt,50,60,10,1,00314,India
413121,2023-07-13,206,yakult,360,400,40,1,00314,India
483740,2023-07-13,202,milk,12,27,15,1,00368,India
483740,2023-07-13,211,red bull,90,125,35,1,00368,India
571778,2023-07-13,201,paneer,210,340,130,1,00500,India
571778,2023-07-13,210,mountain dew,75,100,25,1,00500,India
584711,2023-07-13,211,red bull,90,125,35,1,00083,India
584711,2023-07-13,208,sprite,75,100,25,1,00083,India
584711,2023-07-13,210,mountain dew,75,100,25,1,00083,India
584711,2023-07-13,203,mango yogurt,50,60,10,1,00083,India
584711,2023-07-13,212,amul cheese,250,315,65,1,00083,India
939083,2023-07-13,201,paneer,210,340,130,1,00220,India
939083,2023-07-13,202,milk,12,27,15,1,00220,India
939083,2023-07-13,205,classic yogurt,45,60,15,1,00220,India
688413,2023-07-13,209,pepsi,75,100,25,1,00406,India
696773,2023-07-13,209,pepsi,75,100,25,1,00227,India
247858,2023-07-13,206,yakult,360,400,40,1,00480,India
247858,2023-07-13,212,amul cheese,250,315,65,1,00480,India
247858,2023-07-13,210,mountain dew,75,100,25,1,00480,India
247858,2023-07-13,211,red bull,90,125,35,1,00480,India
733083,2023-07-13,207,coca cola,75,100,25,1,00280,India
881393,2023-07-13,212,amul cheese,250,315,65,1,00363,India
881393,2023-07-13,208,sprite,75,100,25,1,00363,India
881393,2023-07-13,206,yakult,360,400,40,1,00363,India
118242,2023-07-13,202,milk,12,27,15,1,00085,India
118242,2023-07-13,208,sprite,75,100,25,1,00085,India
118242,2023-07-13,211,red bull,90,125,35,1,00085,India
118242,2023-07-13,204,strawberry yogurt,50,60,10,1,00085,India
815758,2023-07-13,207,coca cola,75,100,25,1,00431,India
815758,2023-07-13,203,mango yogurt,50,60,10,1,00431,India
815758,2023-07-13,210,mountain dew,75,100,25,1,00431,India
815758,2023-07-13,212,amul cheese,250,315,65,1,00431,India
815758,2023-07-13,211,red bull,90,125,35,1,00431,India
444120,2023-07-13,203,mango yogurt,50,60,10,1,00436,India
444120,2023-07-13,210,mountain dew,75,100,25,1,00436,India
444120,2023-07-13,209,pepsi,75,100,25,1,00436,India
909744,2023-07-13,203,mango yogurt,50,60,10,1,00233,India
909744,2023-07-13,211,red bull,90,125,35,1,00233,India
909744,2023-07-13,207,coca cola,75,100,25,1,00233,India
909744,2023-07-13,201,paneer,210,340,130,1,00233,India
846485,2023-07-13,204,strawberry yogurt,50,60,10,1,00133,India
846485,2023-07-13,205,classic yogurt,45,60,15,1,00133,India
846485,2023-07-13,212,amul cheese,250,315,65,1,00133,India
255322,2023-07-13,212,amul cheese,250,315,65,1,00367,India
255322,2023-07-13,203,mango yogurt,50,60,10,1,00367,India
255322,2023-07-13,204,strawberry yogurt,50,60,10,1,00367,India
255322,2023-07-13,201,paneer,210,340,130,1,00367,India
164219,2023-07-13,208,sprite,75,100,25,1,00076,India
164219,2023-07-13,213,bisleri,6,15,9,1,00076,India
723134,2023-07-13,213,bisleri,6,15,9,1,00029,India
723134,2023-07-13,212,amul cheese,250,315,65,1,00029,India
723134,2023-07-13,208,sprite,75,100,25,1,00029,India
926371,2023-07-13,204,strawberry yogurt,50,60,10,1,00456,India
926371,2023-07-13,209,pepsi,75,100,25,1,00456,India
812451,2023-07-13,208,sprite,75,100,25,1,00373,India
812451,2023-07-13,204,strawberry yogurt,50,60,10,1,00373,India
376946,2023-07-13,205,classic yogurt,45,60,15,1,00326,India
376946,2023-07-13,211,red bull,90,125,35,1,00326,India
376946,2023-07-13,209,pepsi,75,100,25,1,00326,India
927063,2023-07-13,202,milk,12,27,15,1,00322,India
927063,2023-07-13,205,classic yogurt,45,60,15,1,00322,India
927063,2023-07-13,201,paneer,210,340,130,1,00322,India
451345,2023-07-13,211,red bull,90,125,35,1,00153,India
451345,2023-07-13,203,mango yogurt,50,60,10,1,00153,India
451345,2023-07-13,208,sprite,75,100,25,1,00153,India
111643,2023-07-14,211,red bull,90,125,35,1,00327,India
111643,2023-07-14,203,mango yogurt,50,60,10,1,00327,India
111643,2023-07-14,209,pepsi,75,100,25,1,00327,India
594894,2023-07-14,203,mango yogurt,50,60,10,1,00460,India
594894,2023-07-14,204,strawberry yogurt,50,60,10,1,00460,India
210183,2023-07-14,205,classic yogurt,45,60,15,1,00289,India
210183,2023-07-14,209,pepsi,75,100,25,1,00289,India
210183,2023-07-14,208,sprite,75,100,25,1,00289,India
210183,2023-07-14,202,milk,12,27,15,1,00289,India
812787,2023-07-14,213,bisleri,6,15,9,1,00056,India
812787,2023-07-14,211,red bull,90,125,35,1,00056,India
812787,2023-07-14,208,sprite,75,100,25,1,00056,India
812787,2023-07-14,201,paneer,210,340,130,1,00056,India
812787,2023-07-14,212,amul cheese,250,315,65,1,00056,India
273679,2023-07-14,205,classic yogurt,45,60,15,1,00412,India
273679,2023-07-14,209,pepsi,75,100,25,1,00412,India
273679,2023-07-14,213,bisleri,6,15,9,1,00412,India
333856,2023-07-14,207,coca cola,75,100,25,1,00204,India
333856,2023-07-14,202,milk,12,27,15,1,00204,India
333856,2023-07-14,205,classic yogurt,45,60,15,1,00204,India
868330,2023-07-14,210,mountain dew,75,100,25,1,00375,India
616811,2023-07-14,206,yakult,360,400,40,1,00319,India
616811,2023-07-14,211,red bull,90,125,35,1,00319,India
968983,2023-07-14,206,yakult,360,400,40,1,00348,India
195724,2023-07-14,209,pepsi,75,100,25,1,00462,India
195724,2023-07-14,202,milk,12,27,15,1,00462,India
111076,2023-07-14,212,amul cheese,250,315,65,1,00025,India
870418,2023-07-14,205,classic yogurt,45,60,15,1,00373,India
784368,2023-07-14,206,yakult,360,400,40,1,00019,India
784368,2023-07-14,201,paneer,210,340,130,1,00019,India
784368,2023-07-14,203,mango yogurt,50,60,10,1,00019,India
784368,2023-07-14,209,pepsi,75,100,25,1,00019,India
156417,2023-07-14,211,red bull,90,125,35,1,00052,India
156417,2023-07-14,204,strawberry yogurt,50,60,10,1,00052,India
156417,2023-07-14,212,amul cheese,250,315,65,1,00052,India
156417,2023-07-14,210,mountain dew,75,100,25,1,00052,India
776217,2023-07-14,210,mountain dew,75,100,25,1,00042,India
197979,2023-07-14,207,coca cola,75,100,25,1,00500,India
236411,2023-07-14,201,paneer,210,340,130,1,00152,India
236411,2023-07-14,207,coca cola,75,100,25,1,00152,India
236411,2023-07-14,213,bisleri,6,15,9,1,00152,India
762028,2023-07-14,210,mountain dew,75,100,25,1,00201,India
762028,2023-07-14,205,classic yogurt,45,60,15,1,00201,India
762028,2023-07-14,213,bisleri,6,15,9,1,00201,India
762028,2023-07-14,212,amul cheese,250,315,65,1,00201,India
762028,2023-07-14,208,sprite,75,100,25,1,00201,India
596486,2023-07-14,208,sprite,75,100,25,1,00071,India
596486,2023-07-14,209,pepsi,75,100,25,1,00071,India
596486,2023-07-14,204,strawberry yogurt,50,60,10,1,00071,India
596486,2023-07-14,207,coca cola,75,100,25,1,00071,India
596486,2023-07-14,212,amul cheese,250,315,65,1,00071,India
433809,2023-07-14,211,red bull,90,125,35,1,00119,India
433809,2023-07-14,212,amul cheese,250,315,65,1,00119,India
433809,2023-07-14,208,sprite,75,100,25,1,00119,India
481156,2023-07-14,208,sprite,75,100,25,1,00111,India
878778,2023-07-14,210,mountain dew,75,100,25,1,00020,India
878778,2023-07-14,207,coca cola,75,100,25,1,00020,India
878778,2023-07-14,212,amul cheese,250,315,65,1,00020,India
176145,2023-07-14,210,mountain dew,75,100,25,1,00243,India
120815,2023-07-14,208,sprite,75,100,25,1,00141,India
478235,2023-07-14,212,amul cheese,250,315,65,1,00145,India
478235,2023-07-14,203,mango yogurt,50,60,10,1,00145,India
478235,2023-07-14,211,red bull,90,125,35,1,00145,India
353915,2023-07-14,203,mango yogurt,50,60,10,1,00355,India
353915,2023-07-14,202,milk,12,27,15,1,00355,India
353915,2023-07-14,201,paneer,210,340,130,1,00355,India
353915,2023-07-14,213,bisleri,6,15,9,1,00355,India
737856,2023-07-14,209,pepsi,75,100,25,1,00286,India
737856,2023-07-14,205,classic yogurt,45,60,15,1,00286,India
527937,2023-07-14,201,paneer,210,340,130,1,00001,India
527937,2023-07-14,211,red bull,90,125,35,1,00001,India
527937,2023-07-14,207,coca cola,75,100,25,1,00001,India
527937,2023-07-14,210,mountain dew,75,100,25,1,00001,India
527937,2023-07-14,208,sprite,75,100,25,1,00001,India
146676,2023-07-14,213,bisleri,6,15,9,1,00263,India
146676,2023-07-14,212,amul cheese,250,315,65,1,00263,India
146676,2023-07-14,204,strawberry yogurt,50,60,10,1,00263,India
817662,2023-07-14,202,milk,12,27,15,1,00225,India
817662,2023-07-14,205,classic yogurt,45,60,15,1,00225,India
196680,2023-07-14,210,mountain dew,75,100,25,1,00485,India
196680,2023-07-14,207,coca cola,75,100,25,1,00485,India
190438,2023-07-14,207,coca cola,75,100,25,1,00383,India
190438,2023-07-14,205,classic yogurt,45,60,15,1,00383,India
312647,2023-07-14,206,yakult,360,400,40,1,00174,India
312647,2023-07-14,210,mountain dew,75,100,25,1,00174,India
116728,2023-07-14,201,paneer,210,340,130,1,00024,India
116728,2023-07-14,209,pepsi,75,100,25,1,00024,India
116728,2023-07-14,202,milk,12,27,15,1,00024,India
820799,2023-07-14,211,red bull,90,125,35,1,00413,India
820799,2023-07-14,203,mango yogurt,50,60,10,1,00413,India
820799,2023-07-14,208,sprite,75,100,25,1,00413,India
820799,2023-07-14,202,milk,12,27,15,1,00413,India
721531,2023-07-14,213,bisleri,6,15,9,1,00008,India
721531,2023-07-14,208,sprite,75,100,25,1,00008,India
721531,2023-07-14,204,strawberry yogurt,50,60,10,1,00008,India
721531,2023-07-14,202,milk,12,27,15,1,00008,India
274699,2023-07-14,202,milk,12,27,15,1,00196,India
274699,2023-07-14,203,mango yogurt,50,60,10,1,00196,India
170882,2023-07-14,209,pepsi,75,100,25,1,00352,India
170882,2023-07-14,204,strawberry yogurt,50,60,10,1,00352,India
170882,2023-07-14,211,red bull,90,125,35,1,00352,India
170882,2023-07-14,210,mountain dew,75,100,25,1,00352,India
812371,2023-07-14,206,yakult,360,400,40,1,00251,India
812371,2023-07-14,205,classic yogurt,45,60,15,1,00251,India
812371,2023-07-14,207,coca cola,75,100,25,1,00251,India
520519,2023-07-14,206,yakult,360,400,40,1,00056,India
520519,2023-07-14,201,paneer,210,340,130,1,00056,India
520519,2023-07-14,203,mango yogurt,50,60,10,1,00056,India
520519,2023-07-14,210,mountain dew,75,100,25,1,00056,India
912709,2023-07-14,209,pepsi,75,100,25,1,00320,India
912709,2023-07-14,208,sprite,75,100,25,1,00320,India
195562,2023-07-14,205,classic yogurt,45,60,15,1,00365,India
195562,2023-07-14,212,amul cheese,250,315,65,1,00365,India
195562,2023-07-14,211,red bull,90,125,35,1,00365,India
195562,2023-07-14,210,mountain dew,75,100,25,1,00365,India
498514,2023-07-14,204,strawberry yogurt,50,60,10,1,00031,India
498514,2023-07-14,202,milk,12,27,15,1,00031,India
498514,2023-07-14,210,mountain dew,75,100,25,1,00031,India
498514,2023-07-14,209,pepsi,75,100,25,1,00031,India
498514,2023-07-14,203,mango yogurt,50,60,10,1,00031,India
224472,2023-07-14,211,red bull,90,125,35,1,00156,India
224472,2023-07-14,206,yakult,360,400,40,1,00156,India
224472,2023-07-14,202,milk,12,27,15,1,00156,India
480585,2023-07-14,207,coca cola,75,100,25,1,00316,India
480585,2023-07-14,211,red bull,90,125,35,1,00316,India
480585,2023-07-14,210,mountain dew,75,100,25,1,00316,India
516104,2023-07-14,202,milk,12,27,15,1,00160,India
516104,2023-07-14,204,strawberry yogurt,50,60,10,1,00160,India
916545,2023-07-14,207,coca cola,75,100,25,1,00172,India
916545,2023-07-14,211,red bull,90,125,35,1,00172,India
916545,2023-07-14,213,bisleri,6,15,9,1,00172,India
308011,2023-07-14,212,amul cheese,250,315,65,1,00065,India
889212,2023-07-14,201,paneer,210,340,130,1,00041,India
398517,2023-07-14,202,milk,12,27,15,1,00079,India
398517,2023-07-14,209,pepsi,75,100,25,1,00079,India
398517,2023-07-14,203,mango yogurt,50,60,10,1,00079,India
398517,2023-07-14,213,bisleri,6,15,9,1,00079,India
959777,2023-07-14,207,coca cola,75,100,25,1,00131,India
959777,2023-07-14,211,red bull,90,125,35,1,00131,India
959777,2023-07-14,204,strawberry yogurt,50,60,10,1,00131,India
959777,2023-07-14,201,paneer,210,340,130,1,00131,India
959777,2023-07-14,212,amul cheese,250,315,65,1,00131,India
398950,2023-07-14,207,coca cola,75,100,25,1,00447,India
769545,2023-07-14,213,bisleri,6,15,9,1,00005,India
769545,2023-07-14,207,coca cola,75,100,25,1,00005,India
769545,2023-07-14,201,paneer,210,340,130,1,00005,India
878925,2023-07-14,201,paneer,210,340,130,1,00274,India
878925,2023-07-14,202,milk,12,27,15,1,00274,India
878925,2023-07-14,209,pepsi,75,100,25,1,00274,India
878925,2023-07-14,208,sprite,75,100,25,1,00274,India
878925,2023-07-14,207,coca cola,75,100,25,1,00274,India
740339,2023-07-14,201,paneer,210,340,130,1,00311,India
740339,2023-07-14,202,milk,12,27,15,1,00311,India
460490,2023-07-14,204,strawberry yogurt,50,60,10,1,00194,India
460490,2023-07-14,206,yakult,360,400,40,1,00194,India
729008,2023-07-14,211,red bull,90,125,35,1,00175,India
729008,2023-07-14,210,mountain dew,75,100,25,1,00175,India
729008,2023-07-14,207,coca cola,75,100,25,1,00175,India
813479,2023-07-14,208,sprite,75,100,25,1,00153,India
813479,2023-07-14,204,strawberry yogurt,50,60,10,1,00153,India
813479,2023-07-14,201,paneer,210,340,130,1,00153,India
813479,2023-07-14,211,red bull,90,125,35,1,00153,India
813479,2023-07-14,205,classic yogurt,45,60,15,1,00153,India
938169,2023-07-14,210,mountain dew,75,100,25,1,00327,India
938169,2023-07-14,201,paneer,210,340,130,1,00327,India
938169,2023-07-14,211,red bull,90,125,35,1,00327,India
938169,2023-07-14,209,pepsi,75,100,25,1,00327,India
938169,2023-07-14,208,sprite,75,100,25,1,00327,India
812466,2023-07-14,209,pepsi,75,100,25,1,00213,India
240400,2023-07-14,204,strawberry yogurt,50,60,10,1,00213,India
240400,2023-07-14,207,coca cola,75,100,25,1,00213,India
240400,2023-07-14,213,bisleri,6,15,9,1,00213,India
353536,2023-07-14,204,strawberry yogurt,50,60,10,1,00168,India
353536,2023-07-14,201,paneer,210,340,130,1,00168,India
434737,2023-07-14,210,mountain dew,75,100,25,1,00152,India
434737,2023-07-14,208,sprite,75,100,25,1,00152,India
768902,2023-07-14,201,paneer,210,340,130,1,00282,India
768902,2023-07-14,211,red bull,90,125,35,1,00282,India
768902,2023-07-14,206,yakult,360,400,40,1,00282,India
427670,2023-07-14,211,red bull,90,125,35,1,00378,India
427670,2023-07-14,204,strawberry yogurt,50,60,10,1,00378,India
427670,2023-07-14,205,classic yogurt,45,60,15,1,00378,India
427670,2023-07-14,208,sprite,75,100,25,1,00378,India
840641,2023-07-14,211,red bull,90,125,35,1,00395,India
840641,2023-07-14,206,yakult,360,400,40,1,00395,India
840641,2023-07-14,213,bisleri,6,15,9,1,00395,India
840641,2023-07-14,212,amul cheese,250,315,65,1,00395,India
573627,2023-07-14,212,amul cheese,250,315,65,1,00189,India
303385,2023-07-14,205,classic yogurt,45,60,15,1,00468,India
303385,2023-07-14,213,bisleri,6,15,9,1,00468,India
303385,2023-07-14,207,coca cola,75,100,25,1,00468,India
303385,2023-07-14,204,strawberry yogurt,50,60,10,1,00468,India
947936,2023-07-14,203,mango yogurt,50,60,10,1,00353,India
239261,2023-07-14,211,red bull,90,125,35,1,00358,India
595480,2023-07-14,209,pepsi,75,100,25,1,00467,India
595480,2023-07-14,213,bisleri,6,15,9,1,00467,India
685323,2023-07-14,208,sprite,75,100,25,1,00260,India
685323,2023-07-14,213,bisleri,6,15,9,1,00260,India
685323,2023-07-14,204,strawberry yogurt,50,60,10,1,00260,India
685323,2023-07-14,210,mountain dew,75,100,25,1,00260,India
159897,2023-07-14,212,amul cheese,250,315,65,1,00476,India
159897,2023-07-14,201,paneer,210,340,130,1,00476,India
159897,2023-07-14,210,mountain dew,75,100,25,1,00476,India
610268,2023-07-14,201,paneer,210,340,130,1,00327,India
610268,2023-07-14,212,amul cheese,250,315,65,1,00327,India
294733,2023-07-14,212,amul cheese,250,315,65,1,00234,India
568709,2023-07-14,202,milk,12,27,15,1,00062,India
568709,2023-07-14,204,strawberry yogurt,50,60,10,1,00062,India
568709,2023-07-14,207,coca cola,75,100,25,1,00062,India
586928,2023-07-14,202,milk,12,27,15,1,00146,India
586928,2023-07-14,205,classic yogurt,45,60,15,1,00146,India
586928,2023-07-14,213,bisleri,6,15,9,1,00146,India
586928,2023-07-14,208,sprite,75,100,25,1,00146,India
586928,2023-07-14,206,yakult,360,400,40,1,00146,India
987106,2023-07-14,211,red bull,90,125,35,1,00006,India
736760,2023-07-14,206,yakult,360,400,40,1,00171,India
736760,2023-07-14,207,coca cola,75,100,25,1,00171,India
264250,2023-07-14,204,strawberry yogurt,50,60,10,1,00279,India
264250,2023-07-14,202,milk,12,27,15,1,00279,India
247752,2023-07-14,213,bisleri,6,15,9,1,00297,India
247752,2023-07-14,203,mango yogurt,50,60,10,1,00297,India
291100,2023-07-14,203,mango yogurt,50,60,10,1,00394,India
291100,2023-07-14,205,classic yogurt,45,60,15,1,00394,India
357223,2023-07-14,208,sprite,75,100,25,1,00217,India
357223,2023-07-14,203,mango yogurt,50,60,10,1,00217,India
497120,2023-07-14,202,milk,12,27,15,1,00075,India
497120,2023-07-14,204,strawberry yogurt,50,60,10,1,00075,India
158723,2023-07-14,204,strawberry yogurt,50,60,10,1,00469,India
158723,2023-07-14,203,mango yogurt,50,60,10,1,00469,India
158723,2023-07-14,212,amul cheese,250,315,65,1,00469,India
158723,2023-07-14,206,yakult,360,400,40,1,00469,India
911202,2023-07-14,212,amul cheese,250,315,65,1,00121,India
911202,2023-07-14,203,mango yogurt,50,60,10,1,00121,India
911202,2023-07-14,208,sprite,75,100,25,1,00121,India
484671,2023-07-14,211,red bull,90,125,35,1,00164,India
484671,2023-07-14,205,classic yogurt,45,60,15,1,00164,India
969997,2023-07-14,207,coca cola,75,100,25,1,00087,India
969997,2023-07-14,209,pepsi,75,100,25,1,00087,India
969997,2023-07-14,208,sprite,75,100,25,1,00087,India
969997,2023-07-14,206,yakult,360,400,40,1,00087,India
619274,2023-07-14,207,coca cola,75,100,25,1,00378,India
619274,2023-07-14,206,yakult,360,400,40,1,00378,India
619274,2023-07-14,212,amul cheese,250,315,65,1,00378,India
826073,2023-07-14,208,sprite,75,100,25,1,00324,India
826073,2023-07-14,203,mango yogurt,50,60,10,1,00324,India
826073,2023-07-14,202,milk,12,27,15,1,00324,India
826073,2023-07-14,212,amul cheese,250,315,65,1,00324,India
826073,2023-07-14,209,pepsi,75,100,25,1,00324,India
274775,2023-07-14,213,bisleri,6,15,9,1,00433,India
274775,2023-07-14,210,mountain dew,75,100,25,1,00433,India
274775,2023-07-14,208,sprite,75,100,25,1,00433,India
274775,2023-07-14,212,amul cheese,250,315,65,1,00433,India
941475,2023-07-14,208,sprite,75,100,25,1,00026,India
941475,2023-07-14,204,strawberry yogurt,50,60,10,1,00026,India
561509,2023-07-14,212,amul cheese,250,315,65,1,00424,India
561509,2023-07-14,205,classic yogurt,45,60,15,1,00424,India
561509,2023-07-14,208,sprite,75,100,25,1,00424,India
561509,2023-07-14,213,bisleri,6,15,9,1,00424,India
801127,2023-07-14,208,sprite,75,100,25,1,00461,India
801127,2023-07-14,207,coca cola,75,100,25,1,00461,India
801127,2023-07-14,203,mango yogurt,50,60,10,1,00461,India
801127,2023-07-14,213,bisleri,6,15,9,1,00461,India
801127,2023-07-14,210,mountain dew,75,100,25,1,00461,India
977934,2023-07-14,202,milk,12,27,15,1,00433,India
755674,2023-07-14,202,milk,12,27,15,1,00497,India
755674,2023-07-14,206,yakult,360,400,40,1,00497,India
755674,2023-07-14,212,amul cheese,250,315,65,1,00497,India
842288,2023-07-14,212,amul cheese,250,315,65,1,00041,India
862579,2023-07-14,206,yakult,360,400,40,1,00302,India
862579,2023-07-14,204,strawberry yogurt,50,60,10,1,00302,India
862579,2023-07-14,211,red bull,90,125,35,1,00302,India
862579,2023-07-14,202,milk,12,27,15,1,00302,India
795905,2023-07-15,207,coca cola,75,100,25,1,00027,India
700880,2023-07-15,201,paneer,210,340,130,1,00003,India
700880,2023-07-15,213,bisleri,6,15,9,1,00003,India
700880,2023-07-15,210,mountain dew,75,100,25,1,00003,India
605982,2023-07-15,203,mango yogurt,50,60,10,1,00198,India
690886,2023-07-15,207,coca cola,75,100,25,1,00343,India
690886,2023-07-15,210,mountain dew,75,100,25,1,00343,India
690886,2023-07-15,213,bisleri,6,15,9,1,00343,India
690886,2023-07-15,205,classic yogurt,45,60,15,1,00343,India
706239,2023-07-15,213,bisleri,6,15,9,1,00193,India
706239,2023-07-15,201,paneer,210,340,130,1,00193,India
706239,2023-07-15,212,amul cheese,250,315,65,1,00193,India
822169,2023-07-15,209,pepsi,75,100,25,1,00171,India
822169,2023-07-15,212,amul cheese,250,315,65,1,00171,India
822169,2023-07-15,203,mango yogurt,50,60,10,1,00171,India
822169,2023-07-15,201,paneer,210,340,130,1,00171,India
822169,2023-07-15,211,red bull,90,125,35,1,00171,India
339814,2023-07-15,208,sprite,75,100,25,1,00457,India
339814,2023-07-15,211,red bull,90,125,35,1,00457,India
339814,2023-07-15,202,milk,12,27,15,1,00457,India
148066,2023-07-15,205,classic yogurt,45,60,15,1,00184,India
333683,2023-07-15,212,amul cheese,250,315,65,1,00315,India
333683,2023-07-15,203,mango yogurt,50,60,10,1,00315,India
333683,2023-07-15,201,paneer,210,340,130,1,00315,India
333683,2023-07-15,213,bisleri,6,15,9,1,00315,India
333683,2023-07-15,206,yakult,360,400,40,1,00315,India
336967,2023-07-15,208,sprite,75,100,25,1,00291,India
336967,2023-07-15,213,bisleri,6,15,9,1,00291,India
336967,2023-07-15,212,amul cheese,250,315,65,1,00291,India
312344,2023-07-15,208,sprite,75,100,25,1,00238,India
312344,2023-07-15,210,mountain dew,75,100,25,1,00238,India
312344,2023-07-15,202,milk,12,27,15,1,00238,India
366693,2023-07-15,207,coca cola,75,100,25,1,00438,India
366693,2023-07-15,204,strawberry yogurt,50,60,10,1,00438,India
774074,2023-07-15,209,pepsi,75,100,25,1,00364,India
921845,2023-07-15,211,red bull,90,125,35,1,00413,India
921845,2023-07-15,210,mountain dew,75,100,25,1,00413,India
921845,2023-07-15,201,paneer,210,340,130,1,00413,India
921845,2023-07-15,212,amul cheese,250,315,65,1,00413,India
726981,2023-07-15,207,coca cola,75,100,25,1,00173,India
726981,2023-07-15,211,red bull,90,125,35,1,00173,India
726981,2023-07-15,212,amul cheese,250,315,65,1,00173,India
726981,2023-07-15,204,strawberry yogurt,50,60,10,1,00173,India
774461,2023-07-15,210,mountain dew,75,100,25,1,00051,India
774461,2023-07-15,213,bisleri,6,15,9,1,00051,India
774461,2023-07-15,211,red bull,90,125,35,1,00051,India
774461,2023-07-15,206,yakult,360,400,40,1,00051,India
934617,2023-07-15,207,coca cola,75,100,25,1,00084,India
882778,2023-07-15,202,milk,12,27,15,1,00062,India
882778,2023-07-15,205,classic yogurt,45,60,15,1,00062,India
882778,2023-07-15,210,mountain dew,75,100,25,1,00062,India
447230,2023-07-15,211,red bull,90,125,35,1,00077,India
398815,2023-07-15,202,milk,12,27,15,1,00161,India
398815,2023-07-15,211,red bull,90,125,35,1,00161,India
398815,2023-07-15,203,mango yogurt,50,60,10,1,00161,India
413790,2023-07-15,201,paneer,210,340,130,1,00463,India
413790,2023-07-15,210,mountain dew,75,100,25,1,00463,India
132883,2023-07-15,213,bisleri,6,15,9,1,00169,India
132883,2023-07-15,209,pepsi,75,100,25,1,00169,India
132883,2023-07-15,202,milk,12,27,15,1,00169,India
132883,2023-07-15,211,red bull,90,125,35,1,00169,India
992375,2023-07-15,205,classic yogurt,45,60,15,1,00215,India
992375,2023-07-15,201,paneer,210,340,130,1,00215,India
687700,2023-07-15,202,milk,12,27,15,1,00435,India
687700,2023-07-15,210,mountain dew,75,100,25,1,00435,India
687700,2023-07-15,213,bisleri,6,15,9,1,00435,India
687700,2023-07-15,209,pepsi,75,100,25,1,00435,India
687700,2023-07-15,212,amul cheese,250,315,65,1,00435,India
899021,2023-07-15,206,yakult,360,400,40,1,00382,India
899021,2023-07-15,213,bisleri,6,15,9,1,00382,India
914403,2023-07-15,207,coca cola,75,100,25,1,00472,India
914403,2023-07-15,201,paneer,210,340,130,1,00472,India
914403,2023-07-15,205,classic yogurt,45,60,15,1,00472,India
879195,2023-07-15,208,sprite,75,100,25,1,00050,India
879195,2023-07-15,206,yakult,360,400,40,1,00050,India
879195,2023-07-15,211,red bull,90,125,35,1,00050,India
591318,2023-07-15,201,paneer,210,340,130,1,00283,India
591318,2023-07-15,204,strawberry yogurt,50,60,10,1,00283,India
591318,2023-07-15,210,mountain dew,75,100,25,1,00283,India
249603,2023-07-15,213,bisleri,6,15,9,1,00284,India
249603,2023-07-15,209,pepsi,75,100,25,1,00284,India
249603,2023-07-15,207,coca cola,75,100,25,1,00284,India
249603,2023-07-15,205,classic yogurt,45,60,15,1,00284,India
129579,2023-07-15,211,red bull,90,125,35,1,00437,India
219302,2023-07-15,201,paneer,210,340,130,1,00264,India
219302,2023-07-15,212,amul cheese,250,315,65,1,00264,India
219302,2023-07-15,204,strawberry yogurt,50,60,10,1,00264,India
540030,2023-07-15,209,pepsi,75,100,25,1,00099,India
540030,2023-07-15,210,mountain dew,75,100,25,1,00099,India
540030,2023-07-15,202,milk,12,27,15,1,00099,India
540030,2023-07-15,203,mango yogurt,50,60,10,1,00099,India
327245,2023-07-15,209,pepsi,75,100,25,1,00010,India
327245,2023-07-15,203,mango yogurt,50,60,10,1,00010,India
327245,2023-07-15,201,paneer,210,340,130,1,00010,India
327245,2023-07-15,208,sprite,75,100,25,1,00010,India
365357,2023-07-15,202,milk,12,27,15,1,00204,India
365357,2023-07-15,211,red bull,90,125,35,1,00204,India
220623,2023-07-15,213,bisleri,6,15,9,1,00494,India
220623,2023-07-15,207,coca cola,75,100,25,1,00494,India
127314,2023-07-15,213,bisleri,6,15,9,1,00333,India
127314,2023-07-15,202,milk,12,27,15,1,00333,India
127314,2023-07-15,210,mountain dew,75,100,25,1,00333,India
127314,2023-07-15,203,mango yogurt,50,60,10,1,00333,India
640883,2023-07-15,202,milk,12,27,15,1,00076,India
640883,2023-07-15,205,classic yogurt,45,60,15,1,00076,India
640883,2023-07-15,201,paneer,210,340,130,1,00076,India
640883,2023-07-15,206,yakult,360,400,40,1,00076,India
640883,2023-07-15,203,mango yogurt,50,60,10,1,00076,India
437414,2023-07-15,208,sprite,75,100,25,1,00078,India
437414,2023-07-15,204,strawberry yogurt,50,60,10,1,00078,India
437414,2023-07-15,206,yakult,360,400,40,1,00078,India
437414,2023-07-15,203,mango yogurt,50,60,10,1,00078,India
437414,2023-07-15,205,classic yogurt,45,60,15,1,00078,India
345512,2023-07-15,212,amul cheese,250,315,65,1,00024,India
345512,2023-07-15,202,milk,12,27,15,1,00024,India
345512,2023-07-15,208,sprite,75,100,25,1,00024,India
345512,2023-07-15,204,strawberry yogurt,50,60,10,1,00024,India
465480,2023-07-15,212,amul cheese,250,315,65,1,00027,India
465480,2023-07-15,209,pepsi,75,100,25,1,00027,India
103706,2023-07-15,209,pepsi,75,100,25,1,00255,India
103706,2023-07-15,204,strawberry yogurt,50,60,10,1,00255,India
172784,2023-07-15,208,sprite,75,100,25,1,00131,India
172784,2023-07-15,212,amul cheese,250,315,65,1,00131,India
172784,2023-07-15,205,classic yogurt,45,60,15,1,00131,India
861139,2023-07-15,213,bisleri,6,15,9,1,00363,India
894081,2023-07-15,205,classic yogurt,45,60,15,1,00350,India
166377,2023-07-15,211,red bull,90,125,35,1,00189,India
166377,2023-07-15,205,classic yogurt,45,60,15,1,00189,India
166377,2023-07-15,207,coca cola,75,100,25,1,00189,India
429765,2023-07-15,201,paneer,210,340,130,1,00161,India
429765,2023-07-15,204,strawberry yogurt,50,60,10,1,00161,India
429765,2023-07-15,205,classic yogurt,45,60,15,1,00161,India
429765,2023-07-15,202,milk,12,27,15,1,00161,India
314239,2023-07-15,204,strawberry yogurt,50,60,10,1,00221,India
314239,2023-07-15,212,amul cheese,250,315,65,1,00221,India
314239,2023-07-15,205,classic yogurt,45,60,15,1,00221,India
314239,2023-07-15,211,red bull,90,125,35,1,00221,India
879415,2023-07-15,211,red bull,90,125,35,1,00458,India
879415,2023-07-15,213,bisleri,6,15,9,1,00458,India
441222,2023-07-15,212,amul cheese,250,315,65,1,00460,India
441222,2023-07-15,209,pepsi,75,100,25,1,00460,India
441222,2023-07-15,204,strawberry yogurt,50,60,10,1,00460,India
441222,2023-07-15,201,paneer,210,340,130,1,00460,India
441222,2023-07-15,213,bisleri,6,15,9,1,00460,India
842633,2023-07-15,203,mango yogurt,50,60,10,1,00442,India
842633,2023-07-15,213,bisleri,6,15,9,1,00442,India
842633,2023-07-15,208,sprite,75,100,25,1,00442,India
165655,2023-07-15,203,mango yogurt,50,60,10,1,00056,India
165655,2023-07-15,208,sprite,75,100,25,1,00056,India
165655,2023-07-15,211,red bull,90,125,35,1,00056,India
776673,2023-07-15,213,bisleri,6,15,9,1,00433,India
776673,2023-07-15,210,mountain dew,75,100,25,1,00433,India
776673,2023-07-15,209,pepsi,75,100,25,1,00433,India
632365,2023-07-15,207,coca cola,75,100,25,1,00433,India
797553,2023-07-15,213,bisleri,6,15,9,1,00474,India
797553,2023-07-15,210,mountain dew,75,100,25,1,00474,India
797553,2023-07-15,203,mango yogurt,50,60,10,1,00474,India
758464,2023-07-15,204,strawberry yogurt,50,60,10,1,00462,India
758464,2023-07-15,210,mountain dew,75,100,25,1,00462,India
758464,2023-07-15,211,red bull,90,125,35,1,00462,India
220440,2023-07-15,208,sprite,75,100,25,1,00320,India
220440,2023-07-15,203,mango yogurt,50,60,10,1,00320,India
220440,2023-07-15,213,bisleri,6,15,9,1,00320,India
220440,2023-07-15,212,amul cheese,250,315,65,1,00320,India
438479,2023-07-15,211,red bull,90,125,35,1,00055,India
438479,2023-07-15,208,sprite,75,100,25,1,00055,India
438479,2023-07-15,206,yakult,360,400,40,1,00055,India
438479,2023-07-15,202,milk,12,27,15,1,00055,India
431949,2023-07-15,211,red bull,90,125,35,1,00278,India
431949,2023-07-15,206,yakult,360,400,40,1,00278,India
431949,2023-07-15,213,bisleri,6,15,9,1,00278,India
813245,2023-07-15,205,classic yogurt,45,60,15,1,00042,India
813245,2023-07-15,213,bisleri,6,15,9,1,00042,India
982116,2023-07-15,207,coca cola,75,100,25,1,00380,India
982116,2023-07-15,213,bisleri,6,15,9,1,00380,India
982116,2023-07-15,212,amul cheese,250,315,65,1,00380,India
982116,2023-07-15,211,red bull,90,125,35,1,00380,India
209089,2023-07-15,210,mountain dew,75,100,25,1,00210,India
209089,2023-07-15,207,coca cola,75,100,25,1,00210,India
888444,2023-07-15,201,paneer,210,340,130,1,00325,India
888444,2023-07-15,207,coca cola,75,100,25,1,00325,India
888444,2023-07-15,212,amul cheese,250,315,65,1,00325,India
888444,2023-07-15,213,bisleri,6,15,9,1,00325,India
441005,2023-07-15,208,sprite,75,100,25,1,00303,India
441005,2023-07-15,207,coca cola,75,100,25,1,00303,India
441005,2023-07-15,213,bisleri,6,15,9,1,00303,India
441005,2023-07-15,204,strawberry yogurt,50,60,10,1,00303,India
441005,2023-07-15,202,milk,12,27,15,1,00303,India
337381,2023-07-15,203,mango yogurt,50,60,10,1,00257,India
337381,2023-07-15,209,pepsi,75,100,25,1,00257,India
274577,2023-07-15,204,strawberry yogurt,50,60,10,1,00443,India
274577,2023-07-15,201,paneer,210,340,130,1,00443,India
274577,2023-07-15,203,mango yogurt,50,60,10,1,00443,India
461327,2023-07-15,201,paneer,210,340,130,1,00001,India
288778,2023-07-15,211,red bull,90,125,35,1,00480,India
288778,2023-07-15,213,bisleri,6,15,9,1,00480,India
288778,2023-07-15,201,paneer,210,340,130,1,00480,India
689321,2023-07-15,204,strawberry yogurt,50,60,10,1,00426,India
689321,2023-07-15,206,yakult,360,400,40,1,00426,India
266011,2023-07-16,211,red bull,90,125,35,1,00185,India
266011,2023-07-16,208,sprite,75,100,25,1,00185,India
266011,2023-07-16,201,paneer,210,340,130,1,00185,India
266011,2023-07-16,210,mountain dew,75,100,25,1,00185,India
913924,2023-07-16,210,mountain dew,75,100,25,1,00406,India
913924,2023-07-16,209,pepsi,75,100,25,1,00406,India
913924,2023-07-16,205,classic yogurt,45,60,15,1,00406,India
913924,2023-07-16,213,bisleri,6,15,9,1,00406,India
125961,2023-07-16,211,red bull,90,125,35,1,00465,India
125961,2023-07-16,205,classic yogurt,45,60,15,1,00465,India
125961,2023-07-16,208,sprite,75,100,25,1,00465,India
132940,2023-07-16,202,milk,12,27,15,1,00106,India
132940,2023-07-16,205,classic yogurt,45,60,15,1,00106,India
132940,2023-07-16,211,red bull,90,125,35,1,00106,India
159801,2023-07-16,207,coca cola,75,100,25,1,00291,India
159801,2023-07-16,211,red bull,90,125,35,1,00291,India
159801,2023-07-16,205,classic yogurt,45,60,15,1,00291,India
163657,2023-07-16,204,strawberry yogurt,50,60,10,1,00202,India
163657,2023-07-16,209,pepsi,75,100,25,1,00202,India
163657,2023-07-16,205,classic yogurt,45,60,15,1,00202,India
163657,2023-07-16,206,yakult,360,400,40,1,00202,India
163657,2023-07-16,202,milk,12,27,15,1,00202,India
577962,2023-07-16,203,mango yogurt,50,60,10,1,00121,India
577962,2023-07-16,210,mountain dew,75,100,25,1,00121,India
139213,2023-07-16,210,mountain dew,75,100,25,1,00273,India
139213,2023-07-16,201,paneer,210,340,130,1,00273,India
139213,2023-07-16,211,red bull,90,125,35,1,00273,India
951071,2023-07-16,202,milk,12,27,15,1,00158,India
951071,2023-07-16,210,mountain dew,75,100,25,1,00158,India
951071,2023-07-16,206,yakult,360,400,40,1,00158,India
951071,2023-07-16,211,red bull,90,125,35,1,00158,India
404204,2023-07-16,213,bisleri,6,15,9,1,00230,India
404204,2023-07-16,202,milk,12,27,15,1,00230,India
404204,2023-07-16,208,sprite,75,100,25,1,00230,India
404204,2023-07-16,204,strawberry yogurt,50,60,10,1,00230,India
479269,2023-07-16,205,classic yogurt,45,60,15,1,00122,India
479269,2023-07-16,207,coca cola,75,100,25,1,00122,India
479269,2023-07-16,211,red bull,90,125,35,1,00122,India
479269,2023-07-16,201,paneer,210,340,130,1,00122,India
799929,2023-07-16,210,mountain dew,75,100,25,1,00481,India
799929,2023-07-16,212,amul cheese,250,315,65,1,00481,India
799929,2023-07-16,203,mango yogurt,50,60,10,1,00481,India
799929,2023-07-16,208,sprite,75,100,25,1,00481,India
406599,2023-07-16,212,amul cheese,250,315,65,1,00492,India
406599,2023-07-16,201,paneer,210,340,130,1,00492,India
406599,2023-07-16,209,pepsi,75,100,25,1,00492,India
406599,2023-07-16,211,red bull,90,125,35,1,00492,India
640816,2023-07-16,208,sprite,75,100,25,1,00301,India
640816,2023-07-16,213,bisleri,6,15,9,1,00301,India
624012,2023-07-16,205,classic yogurt,45,60,15,1,00053,India
624012,2023-07-16,201,paneer,210,340,130,1,00053,India
369511,2023-07-16,202,milk,12,27,15,1,00239,India
482993,2023-07-16,205,classic yogurt,45,60,15,1,00206,India
482993,2023-07-16,208,sprite,75,100,25,1,00206,India
482993,2023-07-16,209,pepsi,75,100,25,1,00206,India
482993,2023-07-16,203,mango yogurt,50,60,10,1,00206,India
186633,2023-07-16,207,coca cola,75,100,25,1,00496,India
186633,2023-07-16,201,paneer,210,340,130,1,00496,India
186633,2023-07-16,208,sprite,75,100,25,1,00496,India
300090,2023-07-16,204,strawberry yogurt,50,60,10,1,00257,India
829593,2023-07-16,212,amul cheese,250,315,65,1,00028,India
281863,2023-07-16,208,sprite,75,100,25,1,00329,India
281863,2023-07-16,206,yakult,360,400,40,1,00329,India
281863,2023-07-16,211,red bull,90,125,35,1,00329,India
281863,2023-07-16,207,coca cola,75,100,25,1,00329,India
465687,2023-07-16,209,pepsi,75,100,25,1,00220,India
465687,2023-07-16,213,bisleri,6,15,9,1,00220,India
465687,2023-07-16,204,strawberry yogurt,50,60,10,1,00220,India
869776,2023-07-16,206,yakult,360,400,40,1,00416,India
869776,2023-07-16,208,sprite,75,100,25,1,00416,India
180391,2023-07-16,210,mountain dew,75,100,25,1,00251,India
818222,2023-07-16,204,strawberry yogurt,50,60,10,1,00360,India
207742,2023-07-16,203,mango yogurt,50,60,10,1,00348,India
207742,2023-07-16,205,classic yogurt,45,60,15,1,00348,India
207742,2023-07-16,213,bisleri,6,15,9,1,00348,India
207742,2023-07-16,206,yakult,360,400,40,1,00348,India
853046,2023-07-16,201,paneer,210,340,130,1,00467,India
853046,2023-07-16,213,bisleri,6,15,9,1,00467,India
853046,2023-07-16,210,mountain dew,75,100,25,1,00467,India
561526,2023-07-16,211,red bull,90,125,35,1,00495,India
561526,2023-07-16,207,coca cola,75,100,25,1,00495,India
561526,2023-07-16,208,sprite,75,100,25,1,00495,India
561526,2023-07-16,205,classic yogurt,45,60,15,1,00495,India
329950,2023-07-16,207,coca cola,75,100,25,1,00468,India
345110,2023-07-16,202,milk,12,27,15,1,00250,India
345110,2023-07-16,210,mountain dew,75,100,25,1,00250,India
345110,2023-07-16,213,bisleri,6,15,9,1,00250,India
345110,2023-07-16,209,pepsi,75,100,25,1,00250,India
345110,2023-07-16,204,strawberry yogurt,50,60,10,1,00250,India
887400,2023-07-16,213,bisleri,6,15,9,1,00282,India
887400,2023-07-16,206,yakult,360,400,40,1,00282,India
341563,2023-07-16,210,mountain dew,75,100,25,1,00207,India
398205,2023-07-16,201,paneer,210,340,130,1,00293,India
398205,2023-07-16,207,coca cola,75,100,25,1,00293,India
398205,2023-07-16,211,red bull,90,125,35,1,00293,India
683760,2023-07-16,201,paneer,210,340,130,1,00495,India
338775,2023-07-16,213,bisleri,6,15,9,1,00446,India
338775,2023-07-16,209,pepsi,75,100,25,1,00446,India
152935,2023-07-16,212,amul cheese,250,315,65,1,00286,India
152935,2023-07-16,208,sprite,75,100,25,1,00286,India
152935,2023-07-16,209,pepsi,75,100,25,1,00286,India
152935,2023-07-16,201,paneer,210,340,130,1,00286,India
669673,2023-07-16,205,classic yogurt,45,60,15,1,00336,India
669673,2023-07-16,204,strawberry yogurt,50,60,10,1,00336,India
669673,2023-07-16,210,mountain dew,75,100,25,1,00336,India
999911,2023-07-16,206,yakult,360,400,40,1,00154,India
999911,2023-07-16,201,paneer,210,340,130,1,00154,India
204835,2023-07-16,206,yakult,360,400,40,1,00373,India
745532,2023-07-16,206,yakult,360,400,40,1,00284,India
558426,2023-07-16,211,red bull,90,125,35,1,00071,India
558426,2023-07-16,212,amul cheese,250,315,65,1,00071,India
558426,2023-07-16,208,sprite,75,100,25,1,00071,India
558426,2023-07-16,210,mountain dew,75,100,25,1,00071,India
114306,2023-07-16,203,mango yogurt,50,60,10,1,00144,India
114306,2023-07-16,207,coca cola,75,100,25,1,00144,India
114306,2023-07-16,208,sprite,75,100,25,1,00144,India
386362,2023-07-16,202,milk,12,27,15,1,00136,India
523007,2023-07-16,204,strawberry yogurt,50,60,10,1,00357,India
523007,2023-07-16,201,paneer,210,340,130,1,00357,India
523007,2023-07-16,211,red bull,90,125,35,1,00357,India
475364,2023-07-16,202,milk,12,27,15,1,00399,India
475364,2023-07-16,208,sprite,75,100,25,1,00399,India
879580,2023-07-16,209,pepsi,75,100,25,1,00407,India
348845,2023-07-16,208,sprite,75,100,25,1,00262,India
348845,2023-07-16,211,red bull,90,125,35,1,00262,India
397027,2023-07-16,209,pepsi,75,100,25,1,00201,India
998561,2023-07-16,205,classic yogurt,45,60,15,1,00237,India
998561,2023-07-16,203,mango yogurt,50,60,10,1,00237,India
652555,2023-07-16,207,coca cola,75,100,25,1,00325,India
652555,2023-07-16,203,mango yogurt,50,60,10,1,00325,India
900847,2023-07-16,209,pepsi,75,100,25,1,00007,India
292602,2023-07-16,209,pepsi,75,100,25,1,00060,India
292602,2023-07-16,204,strawberry yogurt,50,60,10,1,00060,India
292602,2023-07-16,206,yakult,360,400,40,1,00060,India
292602,2023-07-16,210,mountain dew,75,100,25,1,00060,India
225699,2023-07-16,208,sprite,75,100,25,1,00266,India
225699,2023-07-16,206,yakult,360,400,40,1,00266,India
225699,2023-07-16,205,classic yogurt,45,60,15,1,00266,India
988884,2023-07-16,208,sprite,75,100,25,1,00077,India
988884,2023-07-16,206,yakult,360,400,40,1,00077,India
327240,2023-07-16,201,paneer,210,340,130,1,00124,India
327240,2023-07-16,212,amul cheese,250,315,65,1,00124,India
246717,2023-07-16,202,milk,12,27,15,1,00158,India
246717,2023-07-16,203,mango yogurt,50,60,10,1,00158,India
246717,2023-07-16,211,red bull,90,125,35,1,00158,India
246717,2023-07-16,205,classic yogurt,45,60,15,1,00158,India
246717,2023-07-16,201,paneer,210,340,130,1,00158,India
963734,2023-07-16,206,yakult,360,400,40,1,00301,India
963734,2023-07-16,209,pepsi,75,100,25,1,00301,India
963734,2023-07-16,202,milk,12,27,15,1,00301,India
458880,2023-07-16,206,yakult,360,400,40,1,00350,India
458880,2023-07-16,207,coca cola,75,100,25,1,00350,India
458880,2023-07-16,205,classic yogurt,45,60,15,1,00350,India
458880,2023-07-16,209,pepsi,75,100,25,1,00350,India
458880,2023-07-16,211,red bull,90,125,35,1,00350,India
522066,2023-07-16,209,pepsi,75,100,25,1,00215,India
522066,2023-07-16,210,mountain dew,75,100,25,1,00215,India
522066,2023-07-16,202,milk,12,27,15,1,00215,India
750216,2023-07-16,203,mango yogurt,50,60,10,1,00465,India
750216,2023-07-16,212,amul cheese,250,315,65,1,00465,India
750216,2023-07-16,206,yakult,360,400,40,1,00465,India
750216,2023-07-16,205,classic yogurt,45,60,15,1,00465,India
798669,2023-07-16,209,pepsi,75,100,25,1,00462,India
798669,2023-07-16,207,coca cola,75,100,25,1,00462,India
798669,2023-07-16,202,milk,12,27,15,1,00462,India
798669,2023-07-16,204,strawberry yogurt,50,60,10,1,00462,India
988335,2023-07-16,204,strawberry yogurt,50,60,10,1,00156,India
988335,2023-07-16,201,paneer,210,340,130,1,00156,India
289282,2023-07-16,210,mountain dew,75,100,25,1,00400,India
289282,2023-07-16,209,pepsi,75,100,25,1,00400,India
289282,2023-07-16,204,strawberry yogurt,50,60,10,1,00400,India
289282,2023-07-16,208,sprite,75,100,25,1,00400,India
355042,2023-07-16,209,pepsi,75,100,25,1,00047,India
355042,2023-07-16,206,yakult,360,400,40,1,00047,India
952817,2023-07-16,208,sprite,75,100,25,1,00462,India
952817,2023-07-16,207,coca cola,75,100,25,1,00462,India
791947,2023-07-16,207,coca cola,75,100,25,1,00257,India
685763,2023-07-16,213,bisleri,6,15,9,1,00163,India
685763,2023-07-16,207,coca cola,75,100,25,1,00163,India
685763,2023-07-16,211,red bull,90,125,35,1,00163,India
685763,2023-07-16,210,mountain dew,75,100,25,1,00163,India
151288,2023-07-16,201,paneer,210,340,130,1,00235,India
151288,2023-07-16,206,yakult,360,400,40,1,00235,India
865649,2023-07-16,205,classic yogurt,45,60,15,1,00476,India
865649,2023-07-16,213,bisleri,6,15,9,1,00476,India
865649,2023-07-16,209,pepsi,75,100,25,1,00476,India
865649,2023-07-16,201,paneer,210,340,130,1,00476,India
537795,2023-07-16,208,sprite,75,100,25,1,00309,India
557115,2023-07-16,210,mountain dew,75,100,25,1,00489,India
557115,2023-07-16,206,yakult,360,400,40,1,00489,India
557115,2023-07-16,204,strawberry yogurt,50,60,10,1,00489,India
105609,2023-07-16,205,classic yogurt,45,60,15,1,00005,India
105609,2023-07-16,207,coca cola,75,100,25,1,00005,India
561786,2023-07-16,201,paneer,210,340,130,1,00140,India
561786,2023-07-16,208,sprite,75,100,25,1,00140,India
561786,2023-07-16,203,mango yogurt,50,60,10,1,00140,India
473566,2023-07-16,209,pepsi,75,100,25,1,00300,India
473566,2023-07-16,206,yakult,360,400,40,1,00300,India
473566,2023-07-16,204,strawberry yogurt,50,60,10,1,00300,India
473566,2023-07-16,203,mango yogurt,50,60,10,1,00300,India
787324,2023-07-16,201,paneer,210,340,130,1,00346,India
787324,2023-07-16,211,red bull,90,125,35,1,00346,India
787324,2023-07-16,207,coca cola,75,100,25,1,00346,India
787324,2023-07-16,209,pepsi,75,100,25,1,00346,India
175463,2023-07-16,205,classic yogurt,45,60,15,1,00386,India
175463,2023-07-16,208,sprite,75,100,25,1,00386,India
175463,2023-07-16,209,pepsi,75,100,25,1,00386,India
175463,2023-07-16,201,paneer,210,340,130,1,00386,India
366519,2023-07-16,213,bisleri,6,15,9,1,00399,India
366519,2023-07-16,206,yakult,360,400,40,1,00399,India
366519,2023-07-16,204,strawberry yogurt,50,60,10,1,00399,India
366519,2023-07-16,203,mango yogurt,50,60,10,1,00399,India
366519,2023-07-16,211,red bull,90,125,35,1,00399,India
490283,2023-07-16,212,amul cheese,250,315,65,1,00084,India
490283,2023-07-16,213,bisleri,6,15,9,1,00084,India
490283,2023-07-16,204,strawberry yogurt,50,60,10,1,00084,India
490283,2023-07-16,206,yakult,360,400,40,1,00084,India
938334,2023-07-16,203,mango yogurt,50,60,10,1,00396,India
938334,2023-07-16,209,pepsi,75,100,25,1,00396,India
460585,2023-07-16,202,milk,12,27,15,1,00163,India
141267,2023-07-16,204,strawberry yogurt,50,60,10,1,00132,India
714100,2023-07-16,209,pepsi,75,100,25,1,00140,India
907037,2023-07-16,202,milk,12,27,15,1,00469,India
907037,2023-07-16,203,mango yogurt,50,60,10,1,00469,India
907037,2023-07-16,210,mountain dew,75,100,25,1,00469,India
907037,2023-07-16,211,red bull,90,125,35,1,00469,India
383017,2023-07-16,203,mango yogurt,50,60,10,1,00485,India
383017,2023-07-16,201,paneer,210,340,130,1,00485,India
383017,2023-07-16,209,pepsi,75,100,25,1,00485,India
867485,2023-07-16,212,amul cheese,250,315,65,1,00082,India
592707,2023-07-16,213,bisleri,6,15,9,1,00214,India
870731,2023-07-16,202,milk,12,27,15,1,00303,India
870731,2023-07-16,209,pepsi,75,100,25,1,00303,India
870731,2023-07-16,210,mountain dew,75,100,25,1,00303,India
870731,2023-07-16,207,coca cola,75,100,25,1,00303,India
870731,2023-07-16,212,amul cheese,250,315,65,1,00303,India
107590,2023-07-16,203,mango yogurt,50,60,10,1,00196,India
107590,2023-07-16,202,milk,12,27,15,1,00196,India
107590,2023-07-16,206,yakult,360,400,40,1,00196,India
107590,2023-07-16,212,amul cheese,250,315,65,1,00196,India
256439,2023-07-16,204,strawberry yogurt,50,60,10,1,00166,India
256439,2023-07-16,212,amul cheese,250,315,65,1,00166,India
256439,2023-07-16,206,yakult,360,400,40,1,00166,India
256439,2023-07-16,203,mango yogurt,50,60,10,1,00166,India
256439,2023-07-16,209,pepsi,75,100,25,1,00166,India
732728,2023-07-16,206,yakult,360,400,40,1,00437,India
732728,2023-07-16,212,amul cheese,250,315,65,1,00437,India
731898,2023-07-16,213,bisleri,6,15,9,1,00049,India
731898,2023-07-16,205,classic yogurt,45,60,15,1,00049,India
731898,2023-07-16,207,coca cola,75,100,25,1,00049,India
609411,2023-07-16,211,red bull,90,125,35,1,00469,India
609411,2023-07-16,213,bisleri,6,15,9,1,00469,India
661949,2023-07-16,210,mountain dew,75,100,25,1,00048,India
661949,2023-07-16,201,paneer,210,340,130,1,00048,India
661949,2023-07-16,211,red bull,90,125,35,1,00048,India
661949,2023-07-16,205,classic yogurt,45,60,15,1,00048,India
662402,2023-07-16,203,mango yogurt,50,60,10,1,00301,India
662402,2023-07-16,213,bisleri,6,15,9,1,00301,India
662402,2023-07-16,212,amul cheese,250,315,65,1,00301,India
612609,2023-07-16,207,coca cola,75,100,25,1,00304,India
612609,2023-07-16,203,mango yogurt,50,60,10,1,00304,India
612609,2023-07-16,208,sprite,75,100,25,1,00304,India
443385,2023-07-16,207,coca cola,75,100,25,1,00081,India
443385,2023-07-16,209,pepsi,75,100,25,1,00081,India
908128,2023-07-17,207,coca cola,75,100,25,1,00275,India
908128,2023-07-17,202,milk,12,27,15,1,00275,India
351066,2023-07-17,213,bisleri,6,15,9,1,00396,India
351066,2023-07-17,211,red bull,90,125,35,1,00396,India
351066,2023-07-17,201,paneer,210,340,130,1,00396,India
584796,2023-07-17,209,pepsi,75,100,25,1,00273,India
584796,2023-07-17,210,mountain dew,75,100,25,1,00273,India
109568,2023-07-17,208,sprite,75,100,25,1,00411,India
109568,2023-07-17,204,strawberry yogurt,50,60,10,1,00411,India
198366,2023-07-17,203,mango yogurt,50,60,10,1,00112,India
198366,2023-07-17,204,strawberry yogurt,50,60,10,1,00112,India
198366,2023-07-17,207,coca cola,75,100,25,1,00112,India
198366,2023-07-17,202,milk,12,27,15,1,00112,India
794386,2023-07-17,209,pepsi,75,100,25,1,00130,India
794386,2023-07-17,202,milk,12,27,15,1,00130,India
794386,2023-07-17,212,amul cheese,250,315,65,1,00130,India
794386,2023-07-17,207,coca cola,75,100,25,1,00130,India
785436,2023-07-17,210,mountain dew,75,100,25,1,00032,India
929952,2023-07-17,212,amul cheese,250,315,65,1,00411,India
929952,2023-07-17,205,classic yogurt,45,60,15,1,00411,India
929952,2023-07-17,206,yakult,360,400,40,1,00411,India
929952,2023-07-17,210,mountain dew,75,100,25,1,00411,India
358864,2023-07-17,204,strawberry yogurt,50,60,10,1,00045,India
358864,2023-07-17,209,pepsi,75,100,25,1,00045,India
364558,2023-07-17,202,milk,12,27,15,1,00410,India
339548,2023-07-17,212,amul cheese,250,315,65,1,00207,India
339548,2023-07-17,201,paneer,210,340,130,1,00207,India
354556,2023-07-17,213,bisleri,6,15,9,1,00219,India
354556,2023-07-17,204,strawberry yogurt,50,60,10,1,00219,India
354556,2023-07-17,210,mountain dew,75,100,25,1,00219,India
449514,2023-07-17,202,milk,12,27,15,1,00077,India
553414,2023-07-17,206,yakult,360,400,40,1,00409,India
553414,2023-07-17,209,pepsi,75,100,25,1,00409,India
553414,2023-07-17,210,mountain dew,75,100,25,1,00409,India
563638,2023-07-17,206,yakult,360,400,40,1,00442,India
563638,2023-07-17,201,paneer,210,340,130,1,00442,India
305862,2023-07-17,207,coca cola,75,100,25,1,00268,India
305862,2023-07-17,211,red bull,90,125,35,1,00268,India
305862,2023-07-17,209,pepsi,75,100,25,1,00268,India
960440,2023-07-17,208,sprite,75,100,25,1,00390,India
960440,2023-07-17,207,coca cola,75,100,25,1,00390,India
960440,2023-07-17,213,bisleri,6,15,9,1,00390,India
960440,2023-07-17,204,strawberry yogurt,50,60,10,1,00390,India
894871,2023-07-17,209,pepsi,75,100,25,1,00161,India
894871,2023-07-17,207,coca cola,75,100,25,1,00161,India
894871,2023-07-17,212,amul cheese,250,315,65,1,00161,India
973180,2023-07-17,201,paneer,210,340,130,1,00330,India
973180,2023-07-17,213,bisleri,6,15,9,1,00330,India
114487,2023-07-17,213,bisleri,6,15,9,1,00367,India
114487,2023-07-17,208,sprite,75,100,25,1,00367,India
114487,2023-07-17,205,classic yogurt,45,60,15,1,00367,India
114487,2023-07-17,206,yakult,360,400,40,1,00367,India
302839,2023-07-17,212,amul cheese,250,315,65,1,00111,India
302839,2023-07-17,207,coca cola,75,100,25,1,00111,India
179791,2023-07-17,209,pepsi,75,100,25,1,00172,India
179791,2023-07-17,211,red bull,90,125,35,1,00172,India
179791,2023-07-17,201,paneer,210,340,130,1,00172,India
179791,2023-07-17,207,coca cola,75,100,25,1,00172,India
380234,2023-07-17,204,strawberry yogurt,50,60,10,1,00329,India
380234,2023-07-17,203,mango yogurt,50,60,10,1,00329,India
380234,2023-07-17,202,milk,12,27,15,1,00329,India
380234,2023-07-17,208,sprite,75,100,25,1,00329,India
784512,2023-07-17,213,bisleri,6,15,9,1,00277,India
784512,2023-07-17,209,pepsi,75,100,25,1,00277,India
499498,2023-07-17,204,strawberry yogurt,50,60,10,1,00260,India
499498,2023-07-17,205,classic yogurt,45,60,15,1,00260,India
499498,2023-07-17,212,amul cheese,250,315,65,1,00260,India
445999,2023-07-17,213,bisleri,6,15,9,1,00010,India
445999,2023-07-17,212,amul cheese,250,315,65,1,00010,India
821508,2023-07-17,211,red bull,90,125,35,1,00156,India
906580,2023-07-17,204,strawberry yogurt,50,60,10,1,00038,India
488325,2023-07-17,204,strawberry yogurt,50,60,10,1,00071,India
488325,2023-07-17,207,coca cola,75,100,25,1,00071,India
488325,2023-07-17,201,paneer,210,340,130,1,00071,India
433516,2023-07-17,204,strawberry yogurt,50,60,10,1,00268,India
433516,2023-07-17,210,mountain dew,75,100,25,1,00268,India
708584,2023-07-17,202,milk,12,27,15,1,00373,India
708584,2023-07-17,205,classic yogurt,45,60,15,1,00373,India
708584,2023-07-17,209,pepsi,75,100,25,1,00373,India
506001,2023-07-17,209,pepsi,75,100,25,1,00032,India
506001,2023-07-17,206,yakult,360,400,40,1,00032,India
506001,2023-07-17,210,mountain dew,75,100,25,1,00032,India
118799,2023-07-17,213,bisleri,6,15,9,1,00031,India
118799,2023-07-17,204,strawberry yogurt,50,60,10,1,00031,India
118799,2023-07-17,209,pepsi,75,100,25,1,00031,India
118799,2023-07-17,212,amul cheese,250,315,65,1,00031,India
743513,2023-07-17,213,bisleri,6,15,9,1,00479,India
743513,2023-07-17,209,pepsi,75,100,25,1,00479,India
743513,2023-07-17,207,coca cola,75,100,25,1,00479,India
743513,2023-07-17,210,mountain dew,75,100,25,1,00479,India
234505,2023-07-17,203,mango yogurt,50,60,10,1,00091,India
234505,2023-07-17,202,milk,12,27,15,1,00091,India
234505,2023-07-17,204,strawberry yogurt,50,60,10,1,00091,India
234505,2023-07-17,205,classic yogurt,45,60,15,1,00091,India
890143,2023-07-17,205,classic yogurt,45,60,15,1,00315,India
890143,2023-07-17,213,bisleri,6,15,9,1,00315,India
890143,2023-07-17,202,milk,12,27,15,1,00315,India
215595,2023-07-17,204,strawberry yogurt,50,60,10,1,00136,India
215595,2023-07-17,210,mountain dew,75,100,25,1,00136,India
215595,2023-07-17,201,paneer,210,340,130,1,00136,India
215595,2023-07-17,209,pepsi,75,100,25,1,00136,India
420306,2023-07-17,211,red bull,90,125,35,1,00194,India
346014,2023-07-17,211,red bull,90,125,35,1,00115,India
346014,2023-07-17,209,pepsi,75,100,25,1,00115,India
346014,2023-07-17,204,strawberry yogurt,50,60,10,1,00115,India
648361,2023-07-17,213,bisleri,6,15,9,1,00269,India
649875,2023-07-17,209,pepsi,75,100,25,1,00081,India
649875,2023-07-17,204,strawberry yogurt,50,60,10,1,00081,India
649875,2023-07-17,212,amul cheese,250,315,65,1,00081,India
649875,2023-07-17,201,paneer,210,340,130,1,00081,India
649875,2023-07-17,211,red bull,90,125,35,1,00081,India
104597,2023-07-17,205,classic yogurt,45,60,15,1,00291,India
104597,2023-07-17,210,mountain dew,75,100,25,1,00291,India
104597,2023-07-17,211,red bull,90,125,35,1,00291,India
887202,2023-07-17,201,paneer,210,340,130,1,00151,India
887202,2023-07-17,203,mango yogurt,50,60,10,1,00151,India
810197,2023-07-17,201,paneer,210,340,130,1,00225,India
810197,2023-07-17,209,pepsi,75,100,25,1,00225,India
810197,2023-07-17,206,yakult,360,400,40,1,00225,India
176344,2023-07-17,204,strawberry yogurt,50,60,10,1,00245,India
176344,2023-07-17,202,milk,12,27,15,1,00245,India
333997,2023-07-17,210,mountain dew,75,100,25,1,00053,India
690212,2023-07-17,203,mango yogurt,50,60,10,1,00364,India
690212,2023-07-17,212,amul cheese,250,315,65,1,00364,India
659075,2023-07-17,201,paneer,210,340,130,1,00055,India
659075,2023-07-17,202,milk,12,27,15,1,00055,India
659075,2023-07-17,210,mountain dew,75,100,25,1,00055,India
583238,2023-07-17,204,strawberry yogurt,50,60,10,1,00052,India
583238,2023-07-17,202,milk,12,27,15,1,00052,India
583238,2023-07-17,211,red bull,90,125,35,1,00052,India
832255,2023-07-17,208,sprite,75,100,25,1,00297,India
832255,2023-07-17,209,pepsi,75,100,25,1,00297,India
832255,2023-07-17,201,paneer,210,340,130,1,00297,India
943230,2023-07-17,210,mountain dew,75,100,25,1,00225,India
943230,2023-07-17,203,mango yogurt,50,60,10,1,00225,India
943230,2023-07-17,207,coca cola,75,100,25,1,00225,India
943230,2023-07-17,209,pepsi,75,100,25,1,00225,India
943230,2023-07-17,204,strawberry yogurt,50,60,10,1,00225,India
884073,2023-07-17,207,coca cola,75,100,25,1,00211,India
884073,2023-07-17,204,strawberry yogurt,50,60,10,1,00211,India
884073,2023-07-17,210,mountain dew,75,100,25,1,00211,India
884073,2023-07-17,206,yakult,360,400,40,1,00211,India
969475,2023-07-17,209,pepsi,75,100,25,1,00188,India
969475,2023-07-17,203,mango yogurt,50,60,10,1,00188,India
969475,2023-07-17,205,classic yogurt,45,60,15,1,00188,India
969475,2023-07-17,204,strawberry yogurt,50,60,10,1,00188,India
498470,2023-07-17,211,red bull,90,125,35,1,00334,India
498470,2023-07-17,210,mountain dew,75,100,25,1,00334,India
498470,2023-07-17,203,mango yogurt,50,60,10,1,00334,India
784621,2023-07-17,208,sprite,75,100,25,1,00483,India
305085,2023-07-17,201,paneer,210,340,130,1,00352,India
305085,2023-07-17,213,bisleri,6,15,9,1,00352,India
305085,2023-07-17,212,amul cheese,250,315,65,1,00352,India
424380,2023-07-17,209,pepsi,75,100,25,1,00127,India
813830,2023-07-17,202,milk,12,27,15,1,00331,India
813830,2023-07-17,203,mango yogurt,50,60,10,1,00331,India
813830,2023-07-17,210,mountain dew,75,100,25,1,00331,India
180764,2023-07-17,205,classic yogurt,45,60,15,1,00377,India
180764,2023-07-17,209,pepsi,75,100,25,1,00377,India
180764,2023-07-17,206,yakult,360,400,40,1,00377,India
120279,2023-07-17,206,yakult,360,400,40,1,00287,India
120279,2023-07-17,211,red bull,90,125,35,1,00287,India
120279,2023-07-17,212,amul cheese,250,315,65,1,00287,India
697478,2023-07-17,202,milk,12,27,15,1,00407,India
697478,2023-07-17,212,amul cheese,250,315,65,1,00407,India
697478,2023-07-17,201,paneer,210,340,130,1,00407,India
697478,2023-07-17,207,coca cola,75,100,25,1,00407,India
834561,2023-07-18,205,classic yogurt,45,60,15,1,00340,India
834561,2023-07-18,208,sprite,75,100,25,1,00340,India
677249,2023-07-18,212,amul cheese,250,315,65,1,00004,India
677249,2023-07-18,211,red bull,90,125,35,1,00004,India
677249,2023-07-18,210,mountain dew,75,100,25,1,00004,India
677249,2023-07-18,201,paneer,210,340,130,1,00004,India
917790,2023-07-18,210,mountain dew,75,100,25,1,00257,India
917790,2023-07-18,208,sprite,75,100,25,1,00257,India
277939,2023-07-18,212,amul cheese,250,315,65,1,00055,India
277939,2023-07-18,206,yakult,360,400,40,1,00055,India
741430,2023-07-18,207,coca cola,75,100,25,1,00496,India
741430,2023-07-18,211,red bull,90,125,35,1,00496,India
741430,2023-07-18,210,mountain dew,75,100,25,1,00496,India
181032,2023-07-18,208,sprite,75,100,25,1,00478,India
900048,2023-07-18,203,mango yogurt,50,60,10,1,00201,India
900048,2023-07-18,212,amul cheese,250,315,65,1,00201,India
900048,2023-07-18,205,classic yogurt,45,60,15,1,00201,India
900048,2023-07-18,211,red bull,90,125,35,1,00201,India
430902,2023-07-18,208,sprite,75,100,25,1,00092,India
430902,2023-07-18,206,yakult,360,400,40,1,00092,India
430902,2023-07-18,209,pepsi,75,100,25,1,00092,India
430902,2023-07-18,202,milk,12,27,15,1,00092,India
352004,2023-07-18,211,red bull,90,125,35,1,00064,India
352004,2023-07-18,213,bisleri,6,15,9,1,00064,India
472025,2023-07-18,211,red bull,90,125,35,1,00105,India
318370,2023-07-18,204,strawberry yogurt,50,60,10,1,00448,India
318370,2023-07-18,210,mountain dew,75,100,25,1,00448,India
318370,2023-07-18,202,milk,12,27,15,1,00448,India
318370,2023-07-18,213,bisleri,6,15,9,1,00448,India
292938,2023-07-18,203,mango yogurt,50,60,10,1,00461,India
292938,2023-07-18,205,classic yogurt,45,60,15,1,00461,India
292938,2023-07-18,202,milk,12,27,15,1,00461,India
292938,2023-07-18,201,paneer,210,340,130,1,00461,India
138259,2023-07-18,210,mountain dew,75,100,25,1,00384,India
110499,2023-07-18,203,mango yogurt,50,60,10,1,00081,India
110499,2023-07-18,208,sprite,75,100,25,1,00081,India
110499,2023-07-18,202,milk,12,27,15,1,00081,India
110499,2023-07-18,205,classic yogurt,45,60,15,1,00081,India
110499,2023-07-18,209,pepsi,75,100,25,1,00081,India
910913,2023-07-18,213,bisleri,6,15,9,1,00039,India
910913,2023-07-18,211,red bull,90,125,35,1,00039,India
910913,2023-07-18,204,strawberry yogurt,50,60,10,1,00039,India
910913,2023-07-18,207,coca cola,75,100,25,1,00039,India
337003,2023-07-18,202,milk,12,27,15,1,00277,India
337003,2023-07-18,208,sprite,75,100,25,1,00277,India
337003,2023-07-18,212,amul cheese,250,315,65,1,00277,India
337003,2023-07-18,205,classic yogurt,45,60,15,1,00277,India
810692,2023-07-18,206,yakult,360,400,40,1,00048,India
810692,2023-07-18,211,red bull,90,125,35,1,00048,India
810692,2023-07-18,201,paneer,210,340,130,1,00048,India
810692,2023-07-18,204,strawberry yogurt,50,60,10,1,00048,India
555094,2023-07-18,203,mango yogurt,50,60,10,1,00391,India
555094,2023-07-18,209,pepsi,75,100,25,1,00391,India
555094,2023-07-18,208,sprite,75,100,25,1,00391,India
555094,2023-07-18,206,yakult,360,400,40,1,00391,India
890537,2023-07-18,206,yakult,360,400,40,1,00158,India
890537,2023-07-18,202,milk,12,27,15,1,00158,India
890537,2023-07-18,201,paneer,210,340,130,1,00158,India
583607,2023-07-18,205,classic yogurt,45,60,15,1,00349,India
633917,2023-07-18,210,mountain dew,75,100,25,1,00181,India
583815,2023-07-18,212,amul cheese,250,315,65,1,00093,India
595981,2023-07-18,212,amul cheese,250,315,65,1,00205,India
921526,2023-07-18,213,bisleri,6,15,9,1,00151,India
310948,2023-07-18,213,bisleri,6,15,9,1,00323,India
216281,2023-07-18,206,yakult,360,400,40,1,00411,India
216281,2023-07-18,207,coca cola,75,100,25,1,00411,India
216281,2023-07-18,201,paneer,210,340,130,1,00411,India
216281,2023-07-18,203,mango yogurt,50,60,10,1,00411,India
694637,2023-07-18,206,yakult,360,400,40,1,00310,India
694637,2023-07-18,213,bisleri,6,15,9,1,00310,India
957420,2023-07-18,207,coca cola,75,100,25,1,00411,India
957420,2023-07-18,213,bisleri,6,15,9,1,00411,India
332590,2023-07-18,210,mountain dew,75,100,25,1,00192,India
332590,2023-07-18,206,yakult,360,400,40,1,00192,India
337914,2023-07-18,211,red bull,90,125,35,1,00141,India
337914,2023-07-18,212,amul cheese,250,315,65,1,00141,India
379184,2023-07-18,208,sprite,75,100,25,1,00281,India
379184,2023-07-18,211,red bull,90,125,35,1,00281,India
379184,2023-07-18,210,mountain dew,75,100,25,1,00281,India
379184,2023-07-18,209,pepsi,75,100,25,1,00281,India
556084,2023-07-18,201,paneer,210,340,130,1,00368,India
556084,2023-07-18,208,sprite,75,100,25,1,00368,India
556084,2023-07-18,203,mango yogurt,50,60,10,1,00368,India
360162,2023-07-18,208,sprite,75,100,25,1,00410,India
360162,2023-07-18,203,mango yogurt,50,60,10,1,00410,India
360162,2023-07-18,212,amul cheese,250,315,65,1,00410,India
725113,2023-07-18,213,bisleri,6,15,9,1,00306,India
725113,2023-07-18,205,classic yogurt,45,60,15,1,00306,India
668634,2023-07-18,209,pepsi,75,100,25,1,00305,India
668634,2023-07-18,204,strawberry yogurt,50,60,10,1,00305,India
269238,2023-07-18,210,mountain dew,75,100,25,1,00233,India
269238,2023-07-18,212,amul cheese,250,315,65,1,00233,India
269238,2023-07-18,208,sprite,75,100,25,1,00233,India
603040,2023-07-18,209,pepsi,75,100,25,1,00125,India
603040,2023-07-18,212,amul cheese,250,315,65,1,00125,India
603040,2023-07-18,206,yakult,360,400,40,1,00125,India
603040,2023-07-18,208,sprite,75,100,25,1,00125,India
603040,2023-07-18,204,strawberry yogurt,50,60,10,1,00125,India
770737,2023-07-18,211,red bull,90,125,35,1,00214,India
770737,2023-07-18,212,amul cheese,250,315,65,1,00214,India
770737,2023-07-18,201,paneer,210,340,130,1,00214,India
128204,2023-07-18,206,yakult,360,400,40,1,00395,India
128204,2023-07-18,213,bisleri,6,15,9,1,00395,India
798521,2023-07-18,209,pepsi,75,100,25,1,00006,India
347282,2023-07-18,206,yakult,360,400,40,1,00424,India
347282,2023-07-18,211,red bull,90,125,35,1,00424,India
347282,2023-07-18,213,bisleri,6,15,9,1,00424,India
807517,2023-07-18,204,strawberry yogurt,50,60,10,1,00194,India
807517,2023-07-18,201,paneer,210,340,130,1,00194,India
191712,2023-07-18,207,coca cola,75,100,25,1,00042,India
191712,2023-07-18,202,milk,12,27,15,1,00042,India
191712,2023-07-18,210,mountain dew,75,100,25,1,00042,India
191712,2023-07-18,206,yakult,360,400,40,1,00042,India
191712,2023-07-18,203,mango yogurt,50,60,10,1,00042,India
419244,2023-07-18,210,mountain dew,75,100,25,1,00499,India
419244,2023-07-18,202,milk,12,27,15,1,00499,India
752873,2023-07-18,212,amul cheese,250,315,65,1,00316,India
752873,2023-07-18,203,mango yogurt,50,60,10,1,00316,India
752873,2023-07-18,209,pepsi,75,100,25,1,00316,India
779934,2023-07-18,208,sprite,75,100,25,1,00356,India
779934,2023-07-18,206,yakult,360,400,40,1,00356,India
360249,2023-07-18,205,classic yogurt,45,60,15,1,00104,India
360249,2023-07-18,202,milk,12,27,15,1,00104,India
550440,2023-07-18,209,pepsi,75,100,25,1,00461,India
550440,2023-07-18,213,bisleri,6,15,9,1,00461,India
550440,2023-07-18,212,amul cheese,250,315,65,1,00461,India
550440,2023-07-18,205,classic yogurt,45,60,15,1,00461,India
705969,2023-07-18,205,classic yogurt,45,60,15,1,00074,India
705969,2023-07-18,204,strawberry yogurt,50,60,10,1,00074,India
705969,2023-07-18,211,red bull,90,125,35,1,00074,India
705969,2023-07-18,208,sprite,75,100,25,1,00074,India
617287,2023-07-18,213,bisleri,6,15,9,1,00256,India
617287,2023-07-18,212,amul cheese,250,315,65,1,00256,India
617287,2023-07-18,208,sprite,75,100,25,1,00256,India
138654,2023-07-18,213,bisleri,6,15,9,1,00489,India
138654,2023-07-18,201,paneer,210,340,130,1,00489,India
138654,2023-07-18,206,yakult,360,400,40,1,00489,India
138654,2023-07-18,212,amul cheese,250,315,65,1,00489,India
858086,2023-07-18,202,milk,12,27,15,1,00054,India
858086,2023-07-18,206,yakult,360,400,40,1,00054,India
774145,2023-07-18,212,amul cheese,250,315,65,1,00235,India
119697,2023-07-18,210,mountain dew,75,100,25,1,00422,India
302699,2023-07-18,205,classic yogurt,45,60,15,1,00011,India
302699,2023-07-18,213,bisleri,6,15,9,1,00011,India
511392,2023-07-18,210,mountain dew,75,100,25,1,00246,India
511392,2023-07-18,204,strawberry yogurt,50,60,10,1,00246,India
511392,2023-07-18,205,classic yogurt,45,60,15,1,00246,India
511392,2023-07-18,202,milk,12,27,15,1,00246,India
203675,2023-07-18,211,red bull,90,125,35,1,00221,India
203675,2023-07-18,204,strawberry yogurt,50,60,10,1,00221,India
203675,2023-07-18,208,sprite,75,100,25,1,00221,India
203675,2023-07-18,212,amul cheese,250,315,65,1,00221,India
489708,2023-07-18,201,paneer,210,340,130,1,00466,India
489708,2023-07-18,207,coca cola,75,100,25,1,00466,India
489708,2023-07-18,209,pepsi,75,100,25,1,00466,India
489708,2023-07-18,203,mango yogurt,50,60,10,1,00466,India
489708,2023-07-18,206,yakult,360,400,40,1,00466,India
836714,2023-07-18,208,sprite,75,100,25,1,00282,India
836714,2023-07-18,209,pepsi,75,100,25,1,00282,India
836714,2023-07-18,207,coca cola,75,100,25,1,00282,India
836714,2023-07-18,204,strawberry yogurt,50,60,10,1,00282,India
856773,2023-07-18,206,yakult,360,400,40,1,00142,India
856773,2023-07-18,208,sprite,75,100,25,1,00142,India
856773,2023-07-18,203,mango yogurt,50,60,10,1,00142,India
856773,2023-07-18,201,paneer,210,340,130,1,00142,India
795978,2023-07-18,206,yakult,360,400,40,1,00144,India
795978,2023-07-18,213,bisleri,6,15,9,1,00144,India
795978,2023-07-18,203,mango yogurt,50,60,10,1,00144,India
795978,2023-07-18,211,red bull,90,125,35,1,00144,India
795978,2023-07-18,207,coca cola,75,100,25,1,00144,India
562007,2023-07-18,209,pepsi,75,100,25,1,00067,India
562007,2023-07-18,204,strawberry yogurt,50,60,10,1,00067,India
562007,2023-07-18,213,bisleri,6,15,9,1,00067,India
584913,2023-07-18,205,classic yogurt,45,60,15,1,00010,India
584913,2023-07-18,203,mango yogurt,50,60,10,1,00010,India
584913,2023-07-18,204,strawberry yogurt,50,60,10,1,00010,India
973303,2023-07-19,206,yakult,360,400,40,1,00375,India
973303,2023-07-19,208,sprite,75,100,25,1,00375,India
973303,2023-07-19,205,classic yogurt,45,60,15,1,00375,India
973303,2023-07-19,202,milk,12,27,15,1,00375,India
973303,2023-07-19,209,pepsi,75,100,25,1,00375,India
528703,2023-07-19,206,yakult,360,400,40,1,00037,India
528703,2023-07-19,203,mango yogurt,50,60,10,1,00037,India
528703,2023-07-19,212,amul cheese,250,315,65,1,00037,India
528703,2023-07-19,207,coca cola,75,100,25,1,00037,India
490521,2023-07-19,202,milk,12,27,15,1,00165,India
490521,2023-07-19,209,pepsi,75,100,25,1,00165,India
490521,2023-07-19,207,coca cola,75,100,25,1,00165,India
490521,2023-07-19,206,yakult,360,400,40,1,00165,India
520520,2023-07-19,212,amul cheese,250,315,65,1,00127,India
520520,2023-07-19,206,yakult,360,400,40,1,00127,India
520520,2023-07-19,209,pepsi,75,100,25,1,00127,India
520520,2023-07-19,203,mango yogurt,50,60,10,1,00127,India
614730,2023-07-19,210,mountain dew,75,100,25,1,00199,India
641802,2023-07-19,210,mountain dew,75,100,25,1,00442,India
641802,2023-07-19,209,pepsi,75,100,25,1,00442,India
352071,2023-07-19,210,mountain dew,75,100,25,1,00171,India
352071,2023-07-19,209,pepsi,75,100,25,1,00171,India
109589,2023-07-19,211,red bull,90,125,35,1,00110,India
109589,2023-07-19,210,mountain dew,75,100,25,1,00110,India
109589,2023-07-19,207,coca cola,75,100,25,1,00110,India
763033,2023-07-19,209,pepsi,75,100,25,1,00337,India
763033,2023-07-19,205,classic yogurt,45,60,15,1,00337,India
691354,2023-07-19,208,sprite,75,100,25,1,00133,India
691354,2023-07-19,206,yakult,360,400,40,1,00133,India
691354,2023-07-19,204,strawberry yogurt,50,60,10,1,00133,India
691354,2023-07-19,213,bisleri,6,15,9,1,00133,India
295924,2023-07-19,202,milk,12,27,15,1,00186,India
295924,2023-07-19,203,mango yogurt,50,60,10,1,00186,India
295924,2023-07-19,207,coca cola,75,100,25,1,00186,India
404742,2023-07-19,207,coca cola,75,100,25,1,00007,India
404742,2023-07-19,210,mountain dew,75,100,25,1,00007,India
404742,2023-07-19,208,sprite,75,100,25,1,00007,India
383224,2023-07-19,207,coca cola,75,100,25,1,00496,India
383224,2023-07-19,211,red bull,90,125,35,1,00496,India
383224,2023-07-19,204,strawberry yogurt,50,60,10,1,00496,India
383224,2023-07-19,205,classic yogurt,45,60,15,1,00496,India
783527,2023-07-19,208,sprite,75,100,25,1,00211,India
783527,2023-07-19,204,strawberry yogurt,50,60,10,1,00211,India
778919,2023-07-19,211,red bull,90,125,35,1,00353,India
778919,2023-07-19,210,mountain dew,75,100,25,1,00353,India
778919,2023-07-19,203,mango yogurt,50,60,10,1,00353,India
778919,2023-07-19,206,yakult,360,400,40,1,00353,India
726922,2023-07-19,205,classic yogurt,45,60,15,1,00479,India
726922,2023-07-19,208,sprite,75,100,25,1,00479,India
726922,2023-07-19,211,red bull,90,125,35,1,00479,India
510380,2023-07-19,201,paneer,210,340,130,1,00227,India
510380,2023-07-19,204,strawberry yogurt,50,60,10,1,00227,India
510380,2023-07-19,209,pepsi,75,100,25,1,00227,India
510380,2023-07-19,203,mango yogurt,50,60,10,1,00227,India
522929,2023-07-19,210,mountain dew,75,100,25,1,00136,India
522929,2023-07-19,203,mango yogurt,50,60,10,1,00136,India
522929,2023-07-19,204,strawberry yogurt,50,60,10,1,00136,India
522929,2023-07-19,201,paneer,210,340,130,1,00136,India
316396,2023-07-19,212,amul cheese,250,315,65,1,00033,India
316396,2023-07-19,207,coca cola,75,100,25,1,00033,India
316396,2023-07-19,201,paneer,210,340,130,1,00033,India
316396,2023-07-19,211,red bull,90,125,35,1,00033,India
316396,2023-07-19,204,strawberry yogurt,50,60,10,1,00033,India
585599,2023-07-19,212,amul cheese,250,315,65,1,00436,India
585599,2023-07-19,206,yakult,360,400,40,1,00436,India
585599,2023-07-19,205,classic yogurt,45,60,15,1,00436,India
585599,2023-07-19,209,pepsi,75,100,25,1,00436,India
208081,2023-07-19,201,paneer,210,340,130,1,00413,India
208081,2023-07-19,202,milk,12,27,15,1,00413,India
208081,2023-07-19,209,pepsi,75,100,25,1,00413,India
208081,2023-07-19,204,strawberry yogurt,50,60,10,1,00413,India
171748,2023-07-19,204,strawberry yogurt,50,60,10,1,00168,India
171748,2023-07-19,210,mountain dew,75,100,25,1,00168,India
171748,2023-07-19,208,sprite,75,100,25,1,00168,India
350647,2023-07-19,205,classic yogurt,45,60,15,1,00357,India
350647,2023-07-19,210,mountain dew,75,100,25,1,00357,India
350647,2023-07-19,203,mango yogurt,50,60,10,1,00357,India
350647,2023-07-19,208,sprite,75,100,25,1,00357,India
399019,2023-07-19,210,mountain dew,75,100,25,1,00420,India
399019,2023-07-19,206,yakult,360,400,40,1,00420,India
399019,2023-07-19,204,strawberry yogurt,50,60,10,1,00420,India
150848,2023-07-19,212,amul cheese,250,315,65,1,00203,India
748712,2023-07-19,212,amul cheese,250,315,65,1,00058,India
748712,2023-07-19,205,classic yogurt,45,60,15,1,00058,India
748712,2023-07-19,208,sprite,75,100,25,1,00058,India
748712,2023-07-19,206,yakult,360,400,40,1,00058,India
748712,2023-07-19,211,red bull,90,125,35,1,00058,India
973093,2023-07-19,213,bisleri,6,15,9,1,00101,India
536159,2023-07-19,210,mountain dew,75,100,25,1,00288,India
536159,2023-07-19,213,bisleri,6,15,9,1,00288,India
536159,2023-07-19,209,pepsi,75,100,25,1,00288,India
990877,2023-07-19,212,amul cheese,250,315,65,1,00053,India
990877,2023-07-19,205,classic yogurt,45,60,15,1,00053,India
595757,2023-07-19,206,yakult,360,400,40,1,00242,India
595757,2023-07-19,211,red bull,90,125,35,1,00242,India
595757,2023-07-19,205,classic yogurt,45,60,15,1,00242,India
595757,2023-07-19,208,sprite,75,100,25,1,00242,India
213588,2023-07-19,212,amul cheese,250,315,65,1,00440,India
213588,2023-07-19,210,mountain dew,75,100,25,1,00440,India
106356,2023-07-19,202,milk,12,27,15,1,00437,India
106356,2023-07-19,204,strawberry yogurt,50,60,10,1,00437,India
106356,2023-07-19,203,mango yogurt,50,60,10,1,00437,India
106356,2023-07-19,208,sprite,75,100,25,1,00437,India
563142,2023-07-19,212,amul cheese,250,315,65,1,00201,India
563142,2023-07-19,211,red bull,90,125,35,1,00201,India
446166,2023-07-19,210,mountain dew,75,100,25,1,00296,India
446166,2023-07-19,202,milk,12,27,15,1,00296,India
446166,2023-07-19,211,red bull,90,125,35,1,00296,India
610956,2023-07-19,209,pepsi,75,100,25,1,00031,India
183805,2023-07-19,204,strawberry yogurt,50,60,10,1,00475,India
183805,2023-07-19,211,red bull,90,125,35,1,00475,India
183805,2023-07-19,209,pepsi,75,100,25,1,00475,India
159349,2023-07-19,209,pepsi,75,100,25,1,00119,India
159349,2023-07-19,206,yakult,360,400,40,1,00119,India
159349,2023-07-19,212,amul cheese,250,315,65,1,00119,India
159349,2023-07-19,204,strawberry yogurt,50,60,10,1,00119,India
159349,2023-07-19,203,mango yogurt,50,60,10,1,00119,India
226967,2023-07-19,212,amul cheese,250,315,65,1,00209,India
226967,2023-07-19,209,pepsi,75,100,25,1,00209,India
226967,2023-07-19,211,red bull,90,125,35,1,00209,India
226967,2023-07-19,210,mountain dew,75,100,25,1,00209,India
743035,2023-07-19,201,paneer,210,340,130,1,00074,India
743035,2023-07-19,204,strawberry yogurt,50,60,10,1,00074,India
743035,2023-07-19,210,mountain dew,75,100,25,1,00074,India
255682,2023-07-19,201,paneer,210,340,130,1,00324,India
255682,2023-07-19,207,coca cola,75,100,25,1,00324,India
255682,2023-07-19,205,classic yogurt,45,60,15,1,00324,India
825491,2023-07-19,205,classic yogurt,45,60,15,1,00021,India
793894,2023-07-19,213,bisleri,6,15,9,1,00256,India
793894,2023-07-19,211,red bull,90,125,35,1,00256,India
822320,2023-07-19,206,yakult,360,400,40,1,00153,India
822320,2023-07-19,205,classic yogurt,45,60,15,1,00153,India
822320,2023-07-19,212,amul cheese,250,315,65,1,00153,India
822320,2023-07-19,202,milk,12,27,15,1,00153,India
391491,2023-07-19,204,strawberry yogurt,50,60,10,1,00144,India
669517,2023-07-19,205,classic yogurt,45,60,15,1,00088,India
103668,2023-07-19,212,amul cheese,250,315,65,1,00153,India
103668,2023-07-19,202,milk,12,27,15,1,00153,India
103668,2023-07-19,205,classic yogurt,45,60,15,1,00153,India
103668,2023-07-19,203,mango yogurt,50,60,10,1,00153,India
112342,2023-07-19,208,sprite,75,100,25,1,00178,India
112342,2023-07-19,211,red bull,90,125,35,1,00178,India
993598,2023-07-19,212,amul cheese,250,315,65,1,00346,India
993598,2023-07-19,204,strawberry yogurt,50,60,10,1,00346,India
482401,2023-07-19,212,amul cheese,250,315,65,1,00420,India
482401,2023-07-19,203,mango yogurt,50,60,10,1,00420,India
482401,2023-07-19,210,mountain dew,75,100,25,1,00420,India
426749,2023-07-19,202,milk,12,27,15,1,00453,India
426749,2023-07-19,206,yakult,360,400,40,1,00453,India
628500,2023-07-19,207,coca cola,75,100,25,1,00313,India
628500,2023-07-19,212,amul cheese,250,315,65,1,00313,India
754092,2023-07-19,202,milk,12,27,15,1,00007,India
754092,2023-07-19,210,mountain dew,75,100,25,1,00007,India
754092,2023-07-19,211,red bull,90,125,35,1,00007,India
754092,2023-07-19,204,strawberry yogurt,50,60,10,1,00007,India
859097,2023-07-20,207,coca cola,75,100,25,1,00200,India
303241,2023-07-20,213,bisleri,6,15,9,1,00179,India
303241,2023-07-20,206,yakult,360,400,40,1,00179,India
446115,2023-07-20,210,mountain dew,75,100,25,1,00467,India
446115,2023-07-20,204,strawberry yogurt,50,60,10,1,00467,India
475119,2023-07-20,207,coca cola,75,100,25,1,00269,India
475119,2023-07-20,205,classic yogurt,45,60,15,1,00269,India
475119,2023-07-20,206,yakult,360,400,40,1,00269,India
475119,2023-07-20,201,paneer,210,340,130,1,00269,India
495667,2023-07-20,206,yakult,360,400,40,1,00407,India
239648,2023-07-20,213,bisleri,6,15,9,1,00230,India
239648,2023-07-20,209,pepsi,75,100,25,1,00230,India
239648,2023-07-20,212,amul cheese,250,315,65,1,00230,India
804170,2023-07-20,203,mango yogurt,50,60,10,1,00479,India
804170,2023-07-20,201,paneer,210,340,130,1,00479,India
804170,2023-07-20,202,milk,12,27,15,1,00479,India
876806,2023-07-20,205,classic yogurt,45,60,15,1,00242,India
876806,2023-07-20,203,mango yogurt,50,60,10,1,00242,India
876806,2023-07-20,201,paneer,210,340,130,1,00242,India
645210,2023-07-20,205,classic yogurt,45,60,15,1,00454,India
645210,2023-07-20,208,sprite,75,100,25,1,00454,India
248190,2023-07-20,203,mango yogurt,50,60,10,1,00083,India
248190,2023-07-20,212,amul cheese,250,315,65,1,00083,India
965795,2023-07-20,206,yakult,360,400,40,1,00432,India
246384,2023-07-20,203,mango yogurt,50,60,10,1,00112,India
246384,2023-07-20,210,mountain dew,75,100,25,1,00112,India
351329,2023-07-20,204,strawberry yogurt,50,60,10,1,00106,India
351329,2023-07-20,206,yakult,360,400,40,1,00106,India
929125,2023-07-20,203,mango yogurt,50,60,10,1,00121,India
929125,2023-07-20,204,strawberry yogurt,50,60,10,1,00121,India
929125,2023-07-20,213,bisleri,6,15,9,1,00121,India
929125,2023-07-20,201,paneer,210,340,130,1,00121,India
783985,2023-07-20,204,strawberry yogurt,50,60,10,1,00050,India
783985,2023-07-20,212,amul cheese,250,315,65,1,00050,India
783985,2023-07-20,213,bisleri,6,15,9,1,00050,India
894931,2023-07-20,208,sprite,75,100,25,1,00365,India
829735,2023-07-20,207,coca cola,75,100,25,1,00454,India
595732,2023-07-20,202,milk,12,27,15,1,00424,India
595732,2023-07-20,212,amul cheese,250,315,65,1,00424,India
383285,2023-07-20,210,mountain dew,75,100,25,1,00464,India
383285,2023-07-20,202,milk,12,27,15,1,00464,India
383285,2023-07-20,201,paneer,210,340,130,1,00464,India
580597,2023-07-20,212,amul cheese,250,315,65,1,00433,India
580597,2023-07-20,207,coca cola,75,100,25,1,00433,India
667636,2023-07-20,201,paneer,210,340,130,1,00137,India
355591,2023-07-20,206,yakult,360,400,40,1,00101,India
355591,2023-07-20,202,milk,12,27,15,1,00101,India
355591,2023-07-20,204,strawberry yogurt,50,60,10,1,00101,India
410682,2023-07-20,205,classic yogurt,45,60,15,1,00485,India
410682,2023-07-20,210,mountain dew,75,100,25,1,00485,India
653272,2023-07-20,205,classic yogurt,45,60,15,1,00485,India
653272,2023-07-20,201,paneer,210,340,130,1,00485,India
653272,2023-07-20,202,milk,12,27,15,1,00485,India
653272,2023-07-20,204,strawberry yogurt,50,60,10,1,00485,India
666303,2023-07-20,213,bisleri,6,15,9,1,00397,India
666303,2023-07-20,210,mountain dew,75,100,25,1,00397,India
666303,2023-07-20,202,milk,12,27,15,1,00397,India
666303,2023-07-20,204,strawberry yogurt,50,60,10,1,00397,India
666303,2023-07-20,208,sprite,75,100,25,1,00397,India
796847,2023-07-20,209,pepsi,75,100,25,1,00480,India
796847,2023-07-20,202,milk,12,27,15,1,00480,India
167538,2023-07-20,204,strawberry yogurt,50,60,10,1,00351,India
167538,2023-07-20,213,bisleri,6,15,9,1,00351,India
167538,2023-07-20,212,amul cheese,250,315,65,1,00351,India
167538,2023-07-20,211,red bull,90,125,35,1,00351,India
488996,2023-07-20,201,paneer,210,340,130,1,00163,India
488996,2023-07-20,207,coca cola,75,100,25,1,00163,India
488996,2023-07-20,205,classic yogurt,45,60,15,1,00163,India
488996,2023-07-20,210,mountain dew,75,100,25,1,00163,India
170689,2023-07-20,212,amul cheese,250,315,65,1,00491,India
170689,2023-07-20,203,mango yogurt,50,60,10,1,00491,India
170689,2023-07-20,213,bisleri,6,15,9,1,00491,India
170689,2023-07-20,201,paneer,210,340,130,1,00491,India
305453,2023-07-20,207,coca cola,75,100,25,1,00229,India
748770,2023-07-20,209,pepsi,75,100,25,1,00032,India
748770,2023-07-20,207,coca cola,75,100,25,1,00032,India
748770,2023-07-20,212,amul cheese,250,315,65,1,00032,India
748770,2023-07-20,203,mango yogurt,50,60,10,1,00032,India
728779,2023-07-20,208,sprite,75,100,25,1,00302,India
249985,2023-07-20,212,amul cheese,250,315,65,1,00420,India
249985,2023-07-20,202,milk,12,27,15,1,00420,India
266663,2023-07-20,204,strawberry yogurt,50,60,10,1,00117,India
266663,2023-07-20,212,amul cheese,250,315,65,1,00117,India
872050,2023-07-20,208,sprite,75,100,25,1,00006,India
872050,2023-07-20,211,red bull,90,125,35,1,00006,India
872050,2023-07-20,206,yakult,360,400,40,1,00006,India
213622,2023-07-20,204,strawberry yogurt,50,60,10,1,00072,India
228018,2023-07-20,213,bisleri,6,15,9,1,00354,India
802130,2023-07-20,209,pepsi,75,100,25,1,00120,India
802130,2023-07-20,205,classic yogurt,45,60,15,1,00120,India
802130,2023-07-20,201,paneer,210,340,130,1,00120,India
802130,2023-07-20,210,mountain dew,75,100,25,1,00120,India
630308,2023-07-20,201,paneer,210,340,130,1,00451,India
114104,2023-07-20,210,mountain dew,75,100,25,1,00208,India
114104,2023-07-20,204,strawberry yogurt,50,60,10,1,00208,India
114104,2023-07-20,206,yakult,360,400,40,1,00208,India
114104,2023-07-20,203,mango yogurt,50,60,10,1,00208,India
114104,2023-07-20,212,amul cheese,250,315,65,1,00208,India
985461,2023-07-20,208,sprite,75,100,25,1,00467,India
985461,2023-07-20,213,bisleri,6,15,9,1,00467,India
795712,2023-07-20,210,mountain dew,75,100,25,1,00371,India
795712,2023-07-20,204,strawberry yogurt,50,60,10,1,00371,India
795712,2023-07-20,202,milk,12,27,15,1,00371,India
989030,2023-07-20,213,bisleri,6,15,9,1,00417,India
989030,2023-07-20,207,coca cola,75,100,25,1,00417,India
960386,2023-07-20,206,yakult,360,400,40,1,00442,India
960386,2023-07-20,213,bisleri,6,15,9,1,00442,India
899012,2023-07-20,202,milk,12,27,15,1,00161,India
899012,2023-07-20,201,paneer,210,340,130,1,00161,India
899012,2023-07-20,208,sprite,75,100,25,1,00161,India
899012,2023-07-20,212,amul cheese,250,315,65,1,00161,India
516616,2023-07-20,201,paneer,210,340,130,1,00101,India
516616,2023-07-20,203,mango yogurt,50,60,10,1,00101,India
516616,2023-07-20,212,amul cheese,250,315,65,1,00101,India
882812,2023-07-20,201,paneer,210,340,130,1,00447,India
882812,2023-07-20,212,amul cheese,250,315,65,1,00447,India
106783,2023-07-20,209,pepsi,75,100,25,1,00392,India
106783,2023-07-20,208,sprite,75,100,25,1,00392,India
296355,2023-07-20,205,classic yogurt,45,60,15,1,00010,India
296355,2023-07-20,201,paneer,210,340,130,1,00010,India
296355,2023-07-20,210,mountain dew,75,100,25,1,00010,India
296355,2023-07-20,204,strawberry yogurt,50,60,10,1,00010,India
296355,2023-07-20,202,milk,12,27,15,1,00010,India
459452,2023-07-20,201,paneer,210,340,130,1,00487,India
459452,2023-07-20,212,amul cheese,250,315,65,1,00487,India
459452,2023-07-20,204,strawberry yogurt,50,60,10,1,00487,India
459452,2023-07-20,208,sprite,75,100,25,1,00487,India
500616,2023-07-20,201,paneer,210,340,130,1,00266,India
994143,2023-07-20,213,bisleri,6,15,9,1,00422,India
994143,2023-07-20,205,classic yogurt,45,60,15,1,00422,India
994143,2023-07-20,203,mango yogurt,50,60,10,1,00422,India
233313,2023-07-20,207,coca cola,75,100,25,1,00037,India
238743,2023-07-20,201,paneer,210,340,130,1,00290,India
238743,2023-07-20,207,coca cola,75,100,25,1,00290,India
238743,2023-07-20,213,bisleri,6,15,9,1,00290,India
238743,2023-07-20,206,yakult,360,400,40,1,00290,India
238743,2023-07-20,202,milk,12,27,15,1,00290,India
106362,2023-07-20,203,mango yogurt,50,60,10,1,00474,India
106362,2023-07-20,210,mountain dew,75,100,25,1,00474,India
441925,2023-07-20,206,yakult,360,400,40,1,00469,India
441925,2023-07-20,209,pepsi,75,100,25,1,00469,India
441925,2023-07-20,210,mountain dew,75,100,25,1,00469,India
441925,2023-07-20,212,amul cheese,250,315,65,1,00469,India
441925,2023-07-20,205,classic yogurt,45,60,15,1,00469,India
346068,2023-07-20,213,bisleri,6,15,9,1,00435,India
346068,2023-07-20,201,paneer,210,340,130,1,00435,India
346068,2023-07-20,210,mountain dew,75,100,25,1,00435,India
847859,2023-07-20,206,yakult,360,400,40,1,00164,India
847859,2023-07-20,210,mountain dew,75,100,25,1,00164,India
106218,2023-07-20,204,strawberry yogurt,50,60,10,1,00381,India
106218,2023-07-20,210,mountain dew,75,100,25,1,00381,India
106218,2023-07-20,205,classic yogurt,45,60,15,1,00381,India
106218,2023-07-20,212,amul cheese,250,315,65,1,00381,India
731289,2023-07-20,203,mango yogurt,50,60,10,1,00222,India
731289,2023-07-20,205,classic yogurt,45,60,15,1,00222,India
640938,2023-07-20,211,red bull,90,125,35,1,00232,India
640938,2023-07-20,203,mango yogurt,50,60,10,1,00232,India
519850,2023-07-20,208,sprite,75,100,25,1,00296,India
519850,2023-07-20,209,pepsi,75,100,25,1,00296,India
519850,2023-07-20,206,yakult,360,400,40,1,00296,India
947235,2023-07-20,212,amul cheese,250,315,65,1,00098,India
947235,2023-07-20,203,mango yogurt,50,60,10,1,00098,India
947235,2023-07-20,207,coca cola,75,100,25,1,00098,India
947235,2023-07-20,206,yakult,360,400,40,1,00098,India
808774,2023-07-20,213,bisleri,6,15,9,1,00182,India
808774,2023-07-20,203,mango yogurt,50,60,10,1,00182,India
131801,2023-07-20,207,coca cola,75,100,25,1,00386,India
131801,2023-07-20,206,yakult,360,400,40,1,00386,India
631686,2023-07-20,208,sprite,75,100,25,1,00154,India
631686,2023-07-20,211,red bull,90,125,35,1,00154,India
631686,2023-07-20,207,coca cola,75,100,25,1,00154,India
166217,2023-07-20,208,sprite,75,100,25,1,00138,India
166217,2023-07-20,207,coca cola,75,100,25,1,00138,India
166217,2023-07-20,201,paneer,210,340,130,1,00138,India
166217,2023-07-20,209,pepsi,75,100,25,1,00138,India
451247,2023-07-20,207,coca cola,75,100,25,1,00221,India
451247,2023-07-20,213,bisleri,6,15,9,1,00221,India
447460,2023-07-20,202,milk,12,27,15,1,00155,India
447460,2023-07-20,204,strawberry yogurt,50,60,10,1,00155,India
447460,2023-07-20,203,mango yogurt,50,60,10,1,00155,India
976028,2023-07-20,207,coca cola,75,100,25,1,00436,India
976028,2023-07-20,208,sprite,75,100,25,1,00436,India
158631,2023-07-20,209,pepsi,75,100,25,1,00322,India
158631,2023-07-20,207,coca cola,75,100,25,1,00322,India
920707,2023-07-20,208,sprite,75,100,25,1,00244,India
920707,2023-07-20,209,pepsi,75,100,25,1,00244,India
261851,2023-07-20,211,red bull,90,125,35,1,00325,India
261851,2023-07-20,203,mango yogurt,50,60,10,1,00325,India
261851,2023-07-20,209,pepsi,75,100,25,1,00325,India
261851,2023-07-20,204,strawberry yogurt,50,60,10,1,00325,India
261851,2023-07-20,207,coca cola,75,100,25,1,00325,India
999807,2023-07-20,206,yakult,360,400,40,1,00071,India
220671,2023-07-20,213,bisleri,6,15,9,1,00117,India
220671,2023-07-20,212,amul cheese,250,315,65,1,00117,India
314639,2023-07-20,204,strawberry yogurt,50,60,10,1,00133,India
314639,2023-07-20,201,paneer,210,340,130,1,00133,India
314639,2023-07-20,212,amul cheese,250,315,65,1,00133,India
205380,2023-07-20,204,strawberry yogurt,50,60,10,1,00440,India
205380,2023-07-20,202,milk,12,27,15,1,00440,India
205380,2023-07-20,203,mango yogurt,50,60,10,1,00440,India
205380,2023-07-20,209,pepsi,75,100,25,1,00440,India
578104,2023-07-20,211,red bull,90,125,35,1,00306,India
578104,2023-07-20,210,mountain dew,75,100,25,1,00306,India
810593,2023-07-20,205,classic yogurt,45,60,15,1,00084,India
810593,2023-07-20,213,bisleri,6,15,9,1,00084,India
810593,2023-07-20,211,red bull,90,125,35,1,00084,India
810593,2023-07-20,210,mountain dew,75,100,25,1,00084,India
551191,2023-07-20,212,amul cheese,250,315,65,1,00175,India
498973,2023-07-20,211,red bull,90,125,35,1,00252,India
498973,2023-07-20,212,amul cheese,250,315,65,1,00252,India
499196,2023-07-20,203,mango yogurt,50,60,10,1,00344,India
499196,2023-07-20,201,paneer,210,340,130,1,00344,India
822333,2023-07-20,203,mango yogurt,50,60,10,1,00085,India
606083,2023-07-20,203,mango yogurt,50,60,10,1,00099,India
301479,2023-07-20,202,milk,12,27,15,1,00003,India
301479,2023-07-20,204,strawberry yogurt,50,60,10,1,00003,India
769570,2023-07-20,209,pepsi,75,100,25,1,00313,India
295094,2023-07-21,205,classic yogurt,45,60,15,1,00213,India
744425,2023-07-21,211,red bull,90,125,35,1,00317,India
744425,2023-07-21,202,milk,12,27,15,1,00317,India
558316,2023-07-21,205,classic yogurt,45,60,15,1,00058,India
558316,2023-07-21,208,sprite,75,100,25,1,00058,India
558316,2023-07-21,211,red bull,90,125,35,1,00058,India
104845,2023-07-21,208,sprite,75,100,25,1,00160,India
104845,2023-07-21,212,amul cheese,250,315,65,1,00160,India
104845,2023-07-21,205,classic yogurt,45,60,15,1,00160,India
104845,2023-07-21,209,pepsi,75,100,25,1,00160,India
838265,2023-07-21,207,coca cola,75,100,25,1,00286,India
838265,2023-07-21,202,milk,12,27,15,1,00286,India
838265,2023-07-21,209,pepsi,75,100,25,1,00286,India
838265,2023-07-21,203,mango yogurt,50,60,10,1,00286,India
156501,2023-07-21,204,strawberry yogurt,50,60,10,1,00207,India
156501,2023-07-21,208,sprite,75,100,25,1,00207,India
740715,2023-07-21,202,milk,12,27,15,1,00293,India
740715,2023-07-21,208,sprite,75,100,25,1,00293,India
740715,2023-07-21,207,coca cola,75,100,25,1,00293,India
740715,2023-07-21,205,classic yogurt,45,60,15,1,00293,India
886187,2023-07-21,204,strawberry yogurt,50,60,10,1,00165,India
886187,2023-07-21,205,classic yogurt,45,60,15,1,00165,India
800161,2023-07-21,203,mango yogurt,50,60,10,1,00384,India
800161,2023-07-21,212,amul cheese,250,315,65,1,00384,India
648732,2023-07-21,206,yakult,360,400,40,1,00364,India
648732,2023-07-21,208,sprite,75,100,25,1,00364,India
717355,2023-07-21,206,yakult,360,400,40,1,00058,India
422178,2023-07-21,204,strawberry yogurt,50,60,10,1,00311,India
422178,2023-07-21,213,bisleri,6,15,9,1,00311,India
422178,2023-07-21,211,red bull,90,125,35,1,00311,India
422178,2023-07-21,206,yakult,360,400,40,1,00311,India
422178,2023-07-21,209,pepsi,75,100,25,1,00311,India
869858,2023-07-21,208,sprite,75,100,25,1,00398,India
532937,2023-07-21,205,classic yogurt,45,60,15,1,00319,India
532937,2023-07-21,210,mountain dew,75,100,25,1,00319,India
532937,2023-07-21,209,pepsi,75,100,25,1,00319,India
728131,2023-07-21,210,mountain dew,75,100,25,1,00101,India
728131,2023-07-21,213,bisleri,6,15,9,1,00101,India
728131,2023-07-21,207,coca cola,75,100,25,1,00101,India
728131,2023-07-21,203,mango yogurt,50,60,10,1,00101,India
773271,2023-07-21,202,milk,12,27,15,1,00124,India
773271,2023-07-21,213,bisleri,6,15,9,1,00124,India
511681,2023-07-21,203,mango yogurt,50,60,10,1,00256,India
511681,2023-07-21,213,bisleri,6,15,9,1,00256,India
568536,2023-07-21,205,classic yogurt,45,60,15,1,00384,India
568536,2023-07-21,209,pepsi,75,100,25,1,00384,India
568536,2023-07-21,207,coca cola,75,100,25,1,00384,India
568536,2023-07-21,203,mango yogurt,50,60,10,1,00384,India
722523,2023-07-21,206,yakult,360,400,40,1,00065,India
722523,2023-07-21,203,mango yogurt,50,60,10,1,00065,India
722523,2023-07-21,210,mountain dew,75,100,25,1,00065,India
209380,2023-07-21,206,yakult,360,400,40,1,00062,India
209380,2023-07-21,212,amul cheese,250,315,65,1,00062,India
209380,2023-07-21,204,strawberry yogurt,50,60,10,1,00062,India
896617,2023-07-21,210,mountain dew,75,100,25,1,00394,India
580086,2023-07-21,211,red bull,90,125,35,1,00108,India
580086,2023-07-21,206,yakult,360,400,40,1,00108,India
580086,2023-07-21,204,strawberry yogurt,50,60,10,1,00108,India
909854,2023-07-21,202,milk,12,27,15,1,00306,India
909854,2023-07-21,211,red bull,90,125,35,1,00306,India
909854,2023-07-21,207,coca cola,75,100,25,1,00306,India
238854,2023-07-21,209,pepsi,75,100,25,1,00089,India
317299,2023-07-21,211,red bull,90,125,35,1,00138,India
317299,2023-07-21,210,mountain dew,75,100,25,1,00138,India
177020,2023-07-21,205,classic yogurt,45,60,15,1,00059,India
177020,2023-07-21,210,mountain dew,75,100,25,1,00059,India
807006,2023-07-21,207,coca cola,75,100,25,1,00483,India
807006,2023-07-21,209,pepsi,75,100,25,1,00483,India
673874,2023-07-21,207,coca cola,75,100,25,1,00262,India
673874,2023-07-21,204,strawberry yogurt,50,60,10,1,00262,India
673874,2023-07-21,205,classic yogurt,45,60,15,1,00262,India
673874,2023-07-21,208,sprite,75,100,25,1,00262,India
673874,2023-07-21,210,mountain dew,75,100,25,1,00262,India
576090,2023-07-21,207,coca cola,75,100,25,1,00339,India
576090,2023-07-21,210,mountain dew,75,100,25,1,00339,India
523793,2023-07-21,208,sprite,75,100,25,1,00389,India
959743,2023-07-21,203,mango yogurt,50,60,10,1,00193,India
959743,2023-07-21,204,strawberry yogurt,50,60,10,1,00193,India
959743,2023-07-21,202,milk,12,27,15,1,00193,India
967677,2023-07-21,202,milk,12,27,15,1,00195,India
967677,2023-07-21,207,coca cola,75,100,25,1,00195,India
967677,2023-07-21,206,yakult,360,400,40,1,00195,India
439122,2023-07-21,203,mango yogurt,50,60,10,1,00303,India
439122,2023-07-21,204,strawberry yogurt,50,60,10,1,00303,India
439122,2023-07-21,210,mountain dew,75,100,25,1,00303,India
439122,2023-07-21,213,bisleri,6,15,9,1,00303,India
614094,2023-07-21,203,mango yogurt,50,60,10,1,00249,India
614094,2023-07-21,202,milk,12,27,15,1,00249,India
614094,2023-07-21,201,paneer,210,340,130,1,00249,India
176433,2023-07-21,201,paneer,210,340,130,1,00188,India
559440,2023-07-21,202,milk,12,27,15,1,00381,India
608685,2023-07-21,205,classic yogurt,45,60,15,1,00445,India
608685,2023-07-21,202,milk,12,27,15,1,00445,India
608685,2023-07-21,212,amul cheese,250,315,65,1,00445,India
608685,2023-07-21,203,mango yogurt,50,60,10,1,00445,India
414932,2023-07-21,208,sprite,75,100,25,1,00397,India
414932,2023-07-21,202,milk,12,27,15,1,00397,India
916877,2023-07-21,201,paneer,210,340,130,1,00034,India
916877,2023-07-21,206,yakult,360,400,40,1,00034,India
916877,2023-07-21,204,strawberry yogurt,50,60,10,1,00034,India
916877,2023-07-21,213,bisleri,6,15,9,1,00034,India
384224,2023-07-21,210,mountain dew,75,100,25,1,00083,India
384224,2023-07-21,205,classic yogurt,45,60,15,1,00083,India
107951,2023-07-21,212,amul cheese,250,315,65,1,00137,India
107951,2023-07-21,211,red bull,90,125,35,1,00137,India
107951,2023-07-21,201,paneer,210,340,130,1,00137,India
107951,2023-07-21,205,classic yogurt,45,60,15,1,00137,India
866042,2023-07-21,210,mountain dew,75,100,25,1,00182,India
866042,2023-07-21,211,red bull,90,125,35,1,00182,India
563167,2023-07-21,206,yakult,360,400,40,1,00089,India
563167,2023-07-21,201,paneer,210,340,130,1,00089,India
258874,2023-07-21,208,sprite,75,100,25,1,00392,India
258874,2023-07-21,206,yakult,360,400,40,1,00392,India
258874,2023-07-21,213,bisleri,6,15,9,1,00392,India
612991,2023-07-21,207,coca cola,75,100,25,1,00139,India
612991,2023-07-21,204,strawberry yogurt,50,60,10,1,00139,India
612991,2023-07-21,212,amul cheese,250,315,65,1,00139,India
816500,2023-07-21,208,sprite,75,100,25,1,00242,India
816500,2023-07-21,204,strawberry yogurt,50,60,10,1,00242,India
816500,2023-07-21,202,milk,12,27,15,1,00242,India
816500,2023-07-21,207,coca cola,75,100,25,1,00242,India
421218,2023-07-21,209,pepsi,75,100,25,1,00106,India
309953,2023-07-21,212,amul cheese,250,315,65,1,00095,India
309953,2023-07-21,206,yakult,360,400,40,1,00095,India
685308,2023-07-21,201,paneer,210,340,130,1,00495,India
685308,2023-07-21,211,red bull,90,125,35,1,00495,India
685308,2023-07-21,209,pepsi,75,100,25,1,00495,India
246705,2023-07-21,201,paneer,210,340,130,1,00127,India
729825,2023-07-21,211,red bull,90,125,35,1,00028,India
729825,2023-07-21,202,milk,12,27,15,1,00028,India
604820,2023-07-21,210,mountain dew,75,100,25,1,00171,India
604820,2023-07-21,202,milk,12,27,15,1,00171,India
833936,2023-07-21,204,strawberry yogurt,50,60,10,1,00054,India
320454,2023-07-21,213,bisleri,6,15,9,1,00353,India
320454,2023-07-21,203,mango yogurt,50,60,10,1,00353,India
320454,2023-07-21,205,classic yogurt,45,60,15,1,00353,India
320454,2023-07-21,209,pepsi,75,100,25,1,00353,India
917537,2023-07-21,211,red bull,90,125,35,1,00498,India
917537,2023-07-21,204,strawberry yogurt,50,60,10,1,00498,India
917537,2023-07-21,213,bisleri,6,15,9,1,00498,India
917537,2023-07-21,201,paneer,210,340,130,1,00498,India
180536,2023-07-21,213,bisleri,6,15,9,1,00135,India
180536,2023-07-21,211,red bull,90,125,35,1,00135,India
966849,2023-07-21,212,amul cheese,250,315,65,1,00099,India
885135,2023-07-21,212,amul cheese,250,315,65,1,00154,India
885135,2023-07-21,209,pepsi,75,100,25,1,00154,India
885135,2023-07-21,203,mango yogurt,50,60,10,1,00154,India
814626,2023-07-21,209,pepsi,75,100,25,1,00237,India
748371,2023-07-21,210,mountain dew,75,100,25,1,00047,India
748371,2023-07-21,204,strawberry yogurt,50,60,10,1,00047,India
537226,2023-07-21,203,mango yogurt,50,60,10,1,00054,India
537226,2023-07-21,209,pepsi,75,100,25,1,00054,India
537226,2023-07-21,208,sprite,75,100,25,1,00054,India
537226,2023-07-21,202,milk,12,27,15,1,00054,India
537226,2023-07-21,204,strawberry yogurt,50,60,10,1,00054,India
233695,2023-07-21,207,coca cola,75,100,25,1,00352,India
200381,2023-07-21,205,classic yogurt,45,60,15,1,00119,India
200381,2023-07-21,206,yakult,360,400,40,1,00119,India
200381,2023-07-21,201,paneer,210,340,130,1,00119,India
306209,2023-07-21,207,coca cola,75,100,25,1,00046,India
282349,2023-07-21,207,coca cola,75,100,25,1,00301,India
282349,2023-07-21,203,mango yogurt,50,60,10,1,00301,India
282349,2023-07-21,209,pepsi,75,100,25,1,00301,India
282349,2023-07-21,204,strawberry yogurt,50,60,10,1,00301,India
718215,2023-07-21,209,pepsi,75,100,25,1,00125,India
718215,2023-07-21,201,paneer,210,340,130,1,00125,India
445649,2023-07-21,203,mango yogurt,50,60,10,1,00133,India
871115,2023-07-21,206,yakult,360,400,40,1,00479,India
871115,2023-07-21,211,red bull,90,125,35,1,00479,India
871115,2023-07-21,205,classic yogurt,45,60,15,1,00479,India
871115,2023-07-21,208,sprite,75,100,25,1,00479,India
216580,2023-07-21,207,coca cola,75,100,25,1,00448,India
216580,2023-07-21,203,mango yogurt,50,60,10,1,00448,India
216580,2023-07-21,212,amul cheese,250,315,65,1,00448,India
216580,2023-07-21,205,classic yogurt,45,60,15,1,00448,India
181131,2023-07-21,210,mountain dew,75,100,25,1,00219,India
181131,2023-07-21,201,paneer,210,340,130,1,00219,India
181131,2023-07-21,211,red bull,90,125,35,1,00219,India
181131,2023-07-21,209,pepsi,75,100,25,1,00219,India
611049,2023-07-21,212,amul cheese,250,315,65,1,00335,India
611049,2023-07-21,211,red bull,90,125,35,1,00335,India
469551,2023-07-21,213,bisleri,6,15,9,1,00235,India
469551,2023-07-21,210,mountain dew,75,100,25,1,00235,India
469551,2023-07-21,203,mango yogurt,50,60,10,1,00235,India
382900,2023-07-21,202,milk,12,27,15,1,00418,India
101338,2023-07-21,205,classic yogurt,45,60,15,1,00392,India
101338,2023-07-21,204,strawberry yogurt,50,60,10,1,00392,India
845880,2023-07-21,205,classic yogurt,45,60,15,1,00231,India
845880,2023-07-21,204,strawberry yogurt,50,60,10,1,00231,India
845880,2023-07-21,201,paneer,210,340,130,1,00231,India
845880,2023-07-21,209,pepsi,75,100,25,1,00231,India
522788,2023-07-21,213,bisleri,6,15,9,1,00089,India
522788,2023-07-21,207,coca cola,75,100,25,1,00089,India
939099,2023-07-21,211,red bull,90,125,35,1,00287,India
153976,2023-07-21,209,pepsi,75,100,25,1,00449,India
153976,2023-07-21,211,red bull,90,125,35,1,00449,India
153976,2023-07-21,201,paneer,210,340,130,1,00449,India
153976,2023-07-21,206,yakult,360,400,40,1,00449,India
153976,2023-07-21,204,strawberry yogurt,50,60,10,1,00449,India
808430,2023-07-21,209,pepsi,75,100,25,1,00027,India
808430,2023-07-21,202,milk,12,27,15,1,00027,India
480658,2023-07-21,206,yakult,360,400,40,1,00476,India
480658,2023-07-21,201,paneer,210,340,130,1,00476,India
480658,2023-07-21,202,milk,12,27,15,1,00476,India
480658,2023-07-21,211,red bull,90,125,35,1,00476,India
480658,2023-07-21,203,mango yogurt,50,60,10,1,00476,India
447421,2023-07-21,212,amul cheese,250,315,65,1,00175,India
447421,2023-07-21,201,paneer,210,340,130,1,00175,India
447421,2023-07-21,207,coca cola,75,100,25,1,00175,India
982634,2023-07-21,202,milk,12,27,15,1,00092,India
982634,2023-07-21,204,strawberry yogurt,50,60,10,1,00092,India
982634,2023-07-21,203,mango yogurt,50,60,10,1,00092,India
597684,2023-07-21,207,coca cola,75,100,25,1,00401,India
452434,2023-07-21,209,pepsi,75,100,25,1,00165,India
452434,2023-07-21,207,coca cola,75,100,25,1,00165,India
933468,2023-07-21,205,classic yogurt,45,60,15,1,00219,India
187937,2023-07-21,203,mango yogurt,50,60,10,1,00042,India
187937,2023-07-21,205,classic yogurt,45,60,15,1,00042,India
187937,2023-07-21,210,mountain dew,75,100,25,1,00042,India
348068,2023-07-21,213,bisleri,6,15,9,1,00349,India
348068,2023-07-21,203,mango yogurt,50,60,10,1,00349,India
348068,2023-07-21,210,mountain dew,75,100,25,1,00349,India
449437,2023-07-21,211,red bull,90,125,35,1,00099,India
449437,2023-07-21,206,yakult,360,400,40,1,00099,India
770016,2023-07-21,212,amul cheese,250,315,65,1,00447,India
770016,2023-07-21,208,sprite,75,100,25,1,00447,India
774008,2023-07-21,211,red bull,90,125,35,1,00231,India
774008,2023-07-21,203,mango yogurt,50,60,10,1,00231,India
774008,2023-07-21,213,bisleri,6,15,9,1,00231,India
649733,2023-07-21,203,mango yogurt,50,60,10,1,00430,India
729866,2023-07-21,206,yakult,360,400,40,1,00071,India
729866,2023-07-21,205,classic yogurt,45,60,15,1,00071,India
729866,2023-07-21,203,mango yogurt,50,60,10,1,00071,India
729866,2023-07-21,202,milk,12,27,15,1,00071,India
246926,2023-07-21,205,classic yogurt,45,60,15,1,00219,India
170753,2023-07-21,203,mango yogurt,50,60,10,1,00006,India
170753,2023-07-21,208,sprite,75,100,25,1,00006,India
170753,2023-07-21,202,milk,12,27,15,1,00006,India
952025,2023-07-21,210,mountain dew,75,100,25,1,00121,India
952025,2023-07-21,203,mango yogurt,50,60,10,1,00121,India
952025,2023-07-21,208,sprite,75,100,25,1,00121,India
952025,2023-07-21,213,bisleri,6,15,9,1,00121,India
544475,2023-07-21,205,classic yogurt,45,60,15,1,00137,India
544475,2023-07-21,210,mountain dew,75,100,25,1,00137,India
544475,2023-07-21,207,coca cola,75,100,25,1,00137,India
547275,2023-07-21,204,strawberry yogurt,50,60,10,1,00153,India
547275,2023-07-21,208,sprite,75,100,25,1,00153,India
573778,2023-07-21,208,sprite,75,100,25,1,00276,India
573778,2023-07-21,210,mountain dew,75,100,25,1,00276,India
573778,2023-07-21,203,mango yogurt,50,60,10,1,00276,India
573778,2023-07-21,212,amul cheese,250,315,65,1,00276,India
747437,2023-07-22,201,paneer,210,340,130,1,00186,India
674995,2023-07-22,213,bisleri,6,15,9,1,00296,India
674995,2023-07-22,201,paneer,210,340,130,1,00296,India
674995,2023-07-22,211,red bull,90,125,35,1,00296,India
842914,2023-07-22,209,pepsi,75,100,25,1,00119,India
842914,2023-07-22,207,coca cola,75,100,25,1,00119,India
842914,2023-07-22,205,classic yogurt,45,60,15,1,00119,India
842914,2023-07-22,210,mountain dew,75,100,25,1,00119,India
932496,2023-07-22,212,amul cheese,250,315,65,1,00345,India
932496,2023-07-22,206,yakult,360,400,40,1,00345,India
932496,2023-07-22,202,milk,12,27,15,1,00345,India
932496,2023-07-22,213,bisleri,6,15,9,1,00345,India
932496,2023-07-22,211,red bull,90,125,35,1,00345,India
126938,2023-07-22,209,pepsi,75,100,25,1,00302,India
133468,2023-07-22,210,mountain dew,75,100,25,1,00338,India
133468,2023-07-22,213,bisleri,6,15,9,1,00338,India
235279,2023-07-22,211,red bull,90,125,35,1,00053,India
529471,2023-07-22,206,yakult,360,400,40,1,00328,India
529471,2023-07-22,203,mango yogurt,50,60,10,1,00328,India
529471,2023-07-22,209,pepsi,75,100,25,1,00328,India
529471,2023-07-22,208,sprite,75,100,25,1,00328,India
529471,2023-07-22,211,red bull,90,125,35,1,00328,India
381480,2023-07-22,203,mango yogurt,50,60,10,1,00452,India
221161,2023-07-22,207,coca cola,75,100,25,1,00041,India
221161,2023-07-22,202,milk,12,27,15,1,00041,India
381567,2023-07-22,202,milk,12,27,15,1,00231,India
381567,2023-07-22,204,strawberry yogurt,50,60,10,1,00231,India
607694,2023-07-22,212,amul cheese,250,315,65,1,00477,India
607694,2023-07-22,210,mountain dew,75,100,25,1,00477,India
607694,2023-07-22,213,bisleri,6,15,9,1,00477,India
607694,2023-07-22,202,milk,12,27,15,1,00477,India
607694,2023-07-22,201,paneer,210,340,130,1,00477,India
765410,2023-07-22,208,sprite,75,100,25,1,00231,India
765410,2023-07-22,202,milk,12,27,15,1,00231,India
375083,2023-07-22,207,coca cola,75,100,25,1,00017,India
375083,2023-07-22,201,paneer,210,340,130,1,00017,India
375083,2023-07-22,203,mango yogurt,50,60,10,1,00017,India
249506,2023-07-22,205,classic yogurt,45,60,15,1,00255,India
249506,2023-07-22,212,amul cheese,250,315,65,1,00255,India
249506,2023-07-22,211,red bull,90,125,35,1,00255,India
379041,2023-07-22,207,coca cola,75,100,25,1,00482,India
379041,2023-07-22,208,sprite,75,100,25,1,00482,India
379041,2023-07-22,210,mountain dew,75,100,25,1,00482,India
129387,2023-07-22,210,mountain dew,75,100,25,1,00415,India
129387,2023-07-22,207,coca cola,75,100,25,1,00415,India
129387,2023-07-22,206,yakult,360,400,40,1,00415,India
129387,2023-07-22,205,classic yogurt,45,60,15,1,00415,India
129387,2023-07-22,204,strawberry yogurt,50,60,10,1,00415,India
120466,2023-07-22,205,classic yogurt,45,60,15,1,00100,India
120466,2023-07-22,210,mountain dew,75,100,25,1,00100,India
780159,2023-07-22,207,coca cola,75,100,25,1,00345,India
780159,2023-07-22,210,mountain dew,75,100,25,1,00345,India
780159,2023-07-22,202,milk,12,27,15,1,00345,India
115092,2023-07-22,211,red bull,90,125,35,1,00035,India
115092,2023-07-22,201,paneer,210,340,130,1,00035,India
916433,2023-07-22,203,mango yogurt,50,60,10,1,00238,India
935179,2023-07-22,207,coca cola,75,100,25,1,00431,India
935179,2023-07-22,213,bisleri,6,15,9,1,00431,India
935179,2023-07-22,208,sprite,75,100,25,1,00431,India
935179,2023-07-22,205,classic yogurt,45,60,15,1,00431,India
835629,2023-07-22,213,bisleri,6,15,9,1,00469,India
835629,2023-07-22,201,paneer,210,340,130,1,00469,India
835629,2023-07-22,202,milk,12,27,15,1,00469,India
262367,2023-07-22,207,coca cola,75,100,25,1,00081,India
546654,2023-07-22,207,coca cola,75,100,25,1,00210,India
613003,2023-07-22,205,classic yogurt,45,60,15,1,00396,India
613003,2023-07-22,213,bisleri,6,15,9,1,00396,India
613003,2023-07-22,209,pepsi,75,100,25,1,00396,India
151770,2023-07-22,211,red bull,90,125,35,1,00072,India
151770,2023-07-22,205,classic yogurt,45,60,15,1,00072,India
151770,2023-07-22,210,mountain dew,75,100,25,1,00072,India
151770,2023-07-22,204,strawberry yogurt,50,60,10,1,00072,India
151770,2023-07-22,206,yakult,360,400,40,1,00072,India
809202,2023-07-22,204,strawberry yogurt,50,60,10,1,00342,India
809202,2023-07-22,205,classic yogurt,45,60,15,1,00342,India
809202,2023-07-22,207,coca cola,75,100,25,1,00342,India
809202,2023-07-22,209,pepsi,75,100,25,1,00342,India
809202,2023-07-22,206,yakult,360,400,40,1,00342,India
817741,2023-07-22,212,amul cheese,250,315,65,1,00308,India
421246,2023-07-22,206,yakult,360,400,40,1,00254,India
421246,2023-07-22,212,amul cheese,250,315,65,1,00254,India
421246,2023-07-22,204,strawberry yogurt,50,60,10,1,00254,India
591251,2023-07-22,206,yakult,360,400,40,1,00045,India
591251,2023-07-22,208,sprite,75,100,25,1,00045,India
591251,2023-07-22,210,mountain dew,75,100,25,1,00045,India
591251,2023-07-22,201,paneer,210,340,130,1,00045,India
794082,2023-07-22,206,yakult,360,400,40,1,00024,India
291762,2023-07-22,212,amul cheese,250,315,65,1,00403,India
291762,2023-07-22,213,bisleri,6,15,9,1,00403,India
864132,2023-07-22,201,paneer,210,340,130,1,00164,India
504104,2023-07-22,202,milk,12,27,15,1,00445,India
337157,2023-07-22,213,bisleri,6,15,9,1,00173,India
226555,2023-07-22,208,sprite,75,100,25,1,00233,India
226555,2023-07-22,203,mango yogurt,50,60,10,1,00233,India
226555,2023-07-22,205,classic yogurt,45,60,15,1,00233,India
226555,2023-07-22,206,yakult,360,400,40,1,00233,India
834086,2023-07-22,207,coca cola,75,100,25,1,00136,India
526007,2023-07-22,202,milk,12,27,15,1,00315,India
526007,2023-07-22,201,paneer,210,340,130,1,00315,India
526007,2023-07-22,213,bisleri,6,15,9,1,00315,India
526007,2023-07-22,207,coca cola,75,100,25,1,00315,India
704441,2023-07-22,205,classic yogurt,45,60,15,1,00237,India
704441,2023-07-22,213,bisleri,6,15,9,1,00237,India
704441,2023-07-22,209,pepsi,75,100,25,1,00237,India
471149,2023-07-22,205,classic yogurt,45,60,15,1,00169,India
471149,2023-07-22,204,strawberry yogurt,50,60,10,1,00169,India
471149,2023-07-22,203,mango yogurt,50,60,10,1,00169,India
471149,2023-07-22,210,mountain dew,75,100,25,1,00169,India
206967,2023-07-22,207,coca cola,75,100,25,1,00032,India
206967,2023-07-22,208,sprite,75,100,25,1,00032,India
206967,2023-07-22,211,red bull,90,125,35,1,00032,India
453589,2023-07-22,209,pepsi,75,100,25,1,00348,India
453589,2023-07-22,208,sprite,75,100,25,1,00348,India
453589,2023-07-22,212,amul cheese,250,315,65,1,00348,India
453589,2023-07-22,206,yakult,360,400,40,1,00348,India
889268,2023-07-22,202,milk,12,27,15,1,00106,India
889268,2023-07-22,207,coca cola,75,100,25,1,00106,India
472722,2023-07-22,204,strawberry yogurt,50,60,10,1,00248,India
472722,2023-07-22,207,coca cola,75,100,25,1,00248,India
989951,2023-07-22,211,red bull,90,125,35,1,00461,India
989951,2023-07-22,203,mango yogurt,50,60,10,1,00461,India
989951,2023-07-22,206,yakult,360,400,40,1,00461,India
989951,2023-07-22,207,coca cola,75,100,25,1,00461,India
989951,2023-07-22,210,mountain dew,75,100,25,1,00461,India
512627,2023-07-22,210,mountain dew,75,100,25,1,00043,India
512627,2023-07-22,211,red bull,90,125,35,1,00043,India
512627,2023-07-22,201,paneer,210,340,130,1,00043,India
512627,2023-07-22,204,strawberry yogurt,50,60,10,1,00043,India
256808,2023-07-22,208,sprite,75,100,25,1,00313,India
256808,2023-07-22,205,classic yogurt,45,60,15,1,00313,India
256808,2023-07-22,207,coca cola,75,100,25,1,00313,India
844936,2023-07-22,208,sprite,75,100,25,1,00334,India
377085,2023-07-22,208,sprite,75,100,25,1,00180,India
377085,2023-07-22,211,red bull,90,125,35,1,00180,India
865692,2023-07-22,202,milk,12,27,15,1,00377,India
865692,2023-07-22,206,yakult,360,400,40,1,00377,India
903424,2023-07-22,212,amul cheese,250,315,65,1,00284,India
841667,2023-07-22,211,red bull,90,125,35,1,00169,India
841667,2023-07-22,208,sprite,75,100,25,1,00169,India
841667,2023-07-22,204,strawberry yogurt,50,60,10,1,00169,India
841667,2023-07-22,207,coca cola,75,100,25,1,00169,India
457520,2023-07-22,203,mango yogurt,50,60,10,1,00496,India
457520,2023-07-22,213,bisleri,6,15,9,1,00496,India
457520,2023-07-22,205,classic yogurt,45,60,15,1,00496,India
622512,2023-07-22,213,bisleri,6,15,9,1,00368,India
622512,2023-07-22,205,classic yogurt,45,60,15,1,00368,India
622512,2023-07-22,201,paneer,210,340,130,1,00368,India
969933,2023-07-22,204,strawberry yogurt,50,60,10,1,00004,India
969933,2023-07-22,207,coca cola,75,100,25,1,00004,India
969933,2023-07-22,208,sprite,75,100,25,1,00004,India
969933,2023-07-22,205,classic yogurt,45,60,15,1,00004,India
356907,2023-07-22,206,yakult,360,400,40,1,00492,India
356907,2023-07-22,211,red bull,90,125,35,1,00492,India
356907,2023-07-22,208,sprite,75,100,25,1,00492,India
356907,2023-07-22,212,amul cheese,250,315,65,1,00492,India
523901,2023-07-22,211,red bull,90,125,35,1,00121,India
523901,2023-07-22,201,paneer,210,340,130,1,00121,India
523901,2023-07-22,204,strawberry yogurt,50,60,10,1,00121,India
523901,2023-07-22,209,pepsi,75,100,25,1,00121,India
553212,2023-07-22,211,red bull,90,125,35,1,00124,India
553212,2023-07-22,205,classic yogurt,45,60,15,1,00124,India
401197,2023-07-22,212,amul cheese,250,315,65,1,00281,India
401197,2023-07-22,202,milk,12,27,15,1,00281,India
609565,2023-07-22,201,paneer,210,340,130,1,00384,India
609565,2023-07-22,206,yakult,360,400,40,1,00384,India
107006,2023-07-22,202,milk,12,27,15,1,00167,India
107006,2023-07-22,210,mountain dew,75,100,25,1,00167,India
108108,2023-07-22,202,milk,12,27,15,1,00122,India
108108,2023-07-22,203,mango yogurt,50,60,10,1,00122,India
108108,2023-07-22,201,paneer,210,340,130,1,00122,India
108108,2023-07-22,207,coca cola,75,100,25,1,00122,India
108900,2023-07-22,207,coca cola,75,100,25,1,00220,India
512761,2023-07-22,201,paneer,210,340,130,1,00017,India
512761,2023-07-22,210,mountain dew,75,100,25,1,00017,India
512761,2023-07-22,213,bisleri,6,15,9,1,00017,India
512761,2023-07-22,205,classic yogurt,45,60,15,1,00017,India
122246,2023-07-23,201,paneer,210,340,130,1,00172,India
122246,2023-07-23,206,yakult,360,400,40,1,00172,India
122246,2023-07-23,202,milk,12,27,15,1,00172,India
122246,2023-07-23,205,classic yogurt,45,60,15,1,00172,India
965706,2023-07-23,208,sprite,75,100,25,1,00030,India
824883,2023-07-23,206,yakult,360,400,40,1,00261,India
755274,2023-07-23,203,mango yogurt,50,60,10,1,00478,India
755274,2023-07-23,209,pepsi,75,100,25,1,00478,India
755274,2023-07-23,207,coca cola,75,100,25,1,00478,India
727867,2023-07-23,203,mango yogurt,50,60,10,1,00199,India
727867,2023-07-23,204,strawberry yogurt,50,60,10,1,00199,India
727867,2023-07-23,202,milk,12,27,15,1,00199,India
727867,2023-07-23,211,red bull,90,125,35,1,00199,India
883609,2023-07-23,212,amul cheese,250,315,65,1,00292,India
883609,2023-07-23,202,milk,12,27,15,1,00292,India
883609,2023-07-23,204,strawberry yogurt,50,60,10,1,00292,India
883609,2023-07-23,211,red bull,90,125,35,1,00292,India
821988,2023-07-23,213,bisleri,6,15,9,1,00475,India
821988,2023-07-23,205,classic yogurt,45,60,15,1,00475,India
414838,2023-07-23,201,paneer,210,340,130,1,00259,India
582248,2023-07-23,203,mango yogurt,50,60,10,1,00098,India
582248,2023-07-23,205,classic yogurt,45,60,15,1,00098,India
687124,2023-07-23,208,sprite,75,100,25,1,00479,India
687124,2023-07-23,212,amul cheese,250,315,65,1,00479,India
687124,2023-07-23,213,bisleri,6,15,9,1,00479,India
478855,2023-07-23,205,classic yogurt,45,60,15,1,00188,India
478855,2023-07-23,211,red bull,90,125,35,1,00188,India
478855,2023-07-23,210,mountain dew,75,100,25,1,00188,India
478855,2023-07-23,203,mango yogurt,50,60,10,1,00188,India
604485,2023-07-23,211,red bull,90,125,35,1,00357,India
604485,2023-07-23,201,paneer,210,340,130,1,00357,India
558308,2023-07-23,208,sprite,75,100,25,1,00134,India
558308,2023-07-23,211,red bull,90,125,35,1,00134,India
558308,2023-07-23,203,mango yogurt,50,60,10,1,00134,India
553885,2023-07-23,210,mountain dew,75,100,25,1,00136,India
394294,2023-07-23,212,amul cheese,250,315,65,1,00052,India
394294,2023-07-23,211,red bull,90,125,35,1,00052,India
394294,2023-07-23,205,classic yogurt,45,60,15,1,00052,India
135318,2023-07-23,213,bisleri,6,15,9,1,00478,India
135318,2023-07-23,208,sprite,75,100,25,1,00478,India
135318,2023-07-23,204,strawberry yogurt,50,60,10,1,00478,India
135318,2023-07-23,205,classic yogurt,45,60,15,1,00478,India
825204,2023-07-23,209,pepsi,75,100,25,1,00464,India
825204,2023-07-23,202,milk,12,27,15,1,00464,India
825204,2023-07-23,212,amul cheese,250,315,65,1,00464,India
825204,2023-07-23,204,strawberry yogurt,50,60,10,1,00464,India
825204,2023-07-23,207,coca cola,75,100,25,1,00464,India
494122,2023-07-23,208,sprite,75,100,25,1,00469,India
494122,2023-07-23,212,amul cheese,250,315,65,1,00469,India
494122,2023-07-23,205,classic yogurt,45,60,15,1,00469,India
494122,2023-07-23,203,mango yogurt,50,60,10,1,00469,India
383848,2023-07-23,209,pepsi,75,100,25,1,00023,India
383848,2023-07-23,204,strawberry yogurt,50,60,10,1,00023,India
353778,2023-07-23,202,milk,12,27,15,1,00345,India
353778,2023-07-23,206,yakult,360,400,40,1,00345,India
353778,2023-07-23,211,red bull,90,125,35,1,00345,India
353778,2023-07-23,212,amul cheese,250,315,65,1,00345,India
427448,2023-07-23,203,mango yogurt,50,60,10,1,00152,India
427448,2023-07-23,213,bisleri,6,15,9,1,00152,India
427448,2023-07-23,209,pepsi,75,100,25,1,00152,India
197062,2023-07-23,207,coca cola,75,100,25,1,00209,India
197062,2023-07-23,206,yakult,360,400,40,1,00209,India
197062,2023-07-23,212,amul cheese,250,315,65,1,00209,India
954641,2023-07-23,210,mountain dew,75,100,25,1,00408,India
954641,2023-07-23,207,coca cola,75,100,25,1,00408,India
954641,2023-07-23,205,classic yogurt,45,60,15,1,00408,India
954641,2023-07-23,209,pepsi,75,100,25,1,00408,India
708017,2023-07-23,201,paneer,210,340,130,1,00228,India
708017,2023-07-23,209,pepsi,75,100,25,1,00228,India
708017,2023-07-23,211,red bull,90,125,35,1,00228,India
263659,2023-07-23,203,mango yogurt,50,60,10,1,00022,India
941047,2023-07-23,212,amul cheese,250,315,65,1,00174,India
941047,2023-07-23,207,coca cola,75,100,25,1,00174,India
164996,2023-07-23,206,yakult,360,400,40,1,00155,India
164996,2023-07-23,202,milk,12,27,15,1,00155,India
950273,2023-07-23,204,strawberry yogurt,50,60,10,1,00351,India
564434,2023-07-23,210,mountain dew,75,100,25,1,00276,India
564434,2023-07-23,206,yakult,360,400,40,1,00276,India
859675,2023-07-23,210,mountain dew,75,100,25,1,00442,India
943578,2023-07-23,210,mountain dew,75,100,25,1,00145,India
438142,2023-07-23,208,sprite,75,100,25,1,00175,India
438142,2023-07-23,203,mango yogurt,50,60,10,1,00175,India
438142,2023-07-23,202,milk,12,27,15,1,00175,India
315708,2023-07-23,209,pepsi,75,100,25,1,00022,India
315708,2023-07-23,212,amul cheese,250,315,65,1,00022,India
315708,2023-07-23,207,coca cola,75,100,25,1,00022,India
315708,2023-07-23,203,mango yogurt,50,60,10,1,00022,India
188002,2023-07-23,202,milk,12,27,15,1,00418,India
188002,2023-07-23,211,red bull,90,125,35,1,00418,India
453639,2023-07-23,207,coca cola,75,100,25,1,00039,India
453639,2023-07-23,204,strawberry yogurt,50,60,10,1,00039,India
453639,2023-07-23,202,milk,12,27,15,1,00039,India
453639,2023-07-23,203,mango yogurt,50,60,10,1,00039,India
453639,2023-07-23,206,yakult,360,400,40,1,00039,India
325078,2023-07-23,202,milk,12,27,15,1,00467,India
325078,2023-07-23,207,coca cola,75,100,25,1,00467,India
880514,2023-07-23,210,mountain dew,75,100,25,1,00410,India
880514,2023-07-23,207,coca cola,75,100,25,1,00410,India
880514,2023-07-23,213,bisleri,6,15,9,1,00410,India
907923,2023-07-23,210,mountain dew,75,100,25,1,00028,India
907923,2023-07-23,212,amul cheese,250,315,65,1,00028,India
255699,2023-07-23,207,coca cola,75,100,25,1,00031,India
255699,2023-07-23,209,pepsi,75,100,25,1,00031,India
602759,2023-07-23,202,milk,12,27,15,1,00366,India
602759,2023-07-23,205,classic yogurt,45,60,15,1,00366,India
602759,2023-07-23,213,bisleri,6,15,9,1,00366,India
667236,2023-07-23,213,bisleri,6,15,9,1,00249,India
667236,2023-07-23,212,amul cheese,250,315,65,1,00249,India
667236,2023-07-23,206,yakult,360,400,40,1,00249,India
667236,2023-07-23,203,mango yogurt,50,60,10,1,00249,India
749119,2023-07-23,203,mango yogurt,50,60,10,1,00468,India
749119,2023-07-23,213,bisleri,6,15,9,1,00468,India
749119,2023-07-23,205,classic yogurt,45,60,15,1,00468,India
749119,2023-07-23,210,mountain dew,75,100,25,1,00468,India
749119,2023-07-23,204,strawberry yogurt,50,60,10,1,00468,India
447278,2023-07-23,207,coca cola,75,100,25,1,00237,India
447278,2023-07-23,205,classic yogurt,45,60,15,1,00237,India
795789,2023-07-23,210,mountain dew,75,100,25,1,00483,India
795789,2023-07-23,204,strawberry yogurt,50,60,10,1,00483,India
795789,2023-07-23,213,bisleri,6,15,9,1,00483,India
795789,2023-07-23,201,paneer,210,340,130,1,00483,India
285238,2023-07-23,201,paneer,210,340,130,1,00060,India
285238,2023-07-23,210,mountain dew,75,100,25,1,00060,India
285238,2023-07-23,203,mango yogurt,50,60,10,1,00060,India
285238,2023-07-23,207,coca cola,75,100,25,1,00060,India
433258,2023-07-23,212,amul cheese,250,315,65,1,00360,India
433258,2023-07-23,204,strawberry yogurt,50,60,10,1,00360,India
433258,2023-07-23,208,sprite,75,100,25,1,00360,India
148175,2023-07-23,213,bisleri,6,15,9,1,00003,India
148175,2023-07-23,204,strawberry yogurt,50,60,10,1,00003,India
148175,2023-07-23,201,paneer,210,340,130,1,00003,India
150730,2023-07-23,211,red bull,90,125,35,1,00161,India
150730,2023-07-23,204,strawberry yogurt,50,60,10,1,00161,India
150730,2023-07-23,201,paneer,210,340,130,1,00161,India
150730,2023-07-23,207,coca cola,75,100,25,1,00161,India
150730,2023-07-23,202,milk,12,27,15,1,00161,India
756526,2023-07-23,206,yakult,360,400,40,1,00295,India
731632,2023-07-23,211,red bull,90,125,35,1,00406,India
731632,2023-07-23,203,mango yogurt,50,60,10,1,00406,India
804420,2023-07-23,212,amul cheese,250,315,65,1,00461,India
804420,2023-07-23,207,coca cola,75,100,25,1,00461,India
804420,2023-07-23,202,milk,12,27,15,1,00461,India
804420,2023-07-23,206,yakult,360,400,40,1,00461,India
403709,2023-07-23,204,strawberry yogurt,50,60,10,1,00239,India
146175,2023-07-23,202,milk,12,27,15,1,00028,India
146175,2023-07-23,206,yakult,360,400,40,1,00028,India
146175,2023-07-23,207,coca cola,75,100,25,1,00028,India
146175,2023-07-23,213,bisleri,6,15,9,1,00028,India
913987,2023-07-23,202,milk,12,27,15,1,00151,India
411064,2023-07-23,213,bisleri,6,15,9,1,00264,India
411064,2023-07-23,204,strawberry yogurt,50,60,10,1,00264,India
200192,2023-07-23,213,bisleri,6,15,9,1,00204,India
263845,2023-07-23,205,classic yogurt,45,60,15,1,00426,India
203497,2023-07-23,206,yakult,360,400,40,1,00228,India
203497,2023-07-23,203,mango yogurt,50,60,10,1,00228,India
203497,2023-07-23,202,milk,12,27,15,1,00228,India
203497,2023-07-23,211,red bull,90,125,35,1,00228,India
578617,2023-07-23,204,strawberry yogurt,50,60,10,1,00389,India
578617,2023-07-23,202,milk,12,27,15,1,00389,India
578617,2023-07-23,206,yakult,360,400,40,1,00389,India
865395,2023-07-23,213,bisleri,6,15,9,1,00150,India
865395,2023-07-23,212,amul cheese,250,315,65,1,00150,India
362451,2023-07-23,201,paneer,210,340,130,1,00366,India
939826,2023-07-23,208,sprite,75,100,25,1,00327,India
939826,2023-07-23,205,classic yogurt,45,60,15,1,00327,India
795647,2023-07-24,206,yakult,360,400,40,1,00329,India
795647,2023-07-24,207,coca cola,75,100,25,1,00329,India
393786,2023-07-24,206,yakult,360,400,40,1,00205,India
393786,2023-07-24,202,milk,12,27,15,1,00205,India
673348,2023-07-24,204,strawberry yogurt,50,60,10,1,00082,India
673348,2023-07-24,213,bisleri,6,15,9,1,00082,India
496565,2023-07-24,201,paneer,210,340,130,1,00350,India
307736,2023-07-24,212,amul cheese,250,315,65,1,00298,India
307736,2023-07-24,211,red bull,90,125,35,1,00298,India
307736,2023-07-24,201,paneer,210,340,130,1,00298,India
307736,2023-07-24,203,mango yogurt,50,60,10,1,00298,India
623326,2023-07-24,201,paneer,210,340,130,1,00407,India
623326,2023-07-24,206,yakult,360,400,40,1,00407,India
964744,2023-07-24,211,red bull,90,125,35,1,00241,India
938613,2023-07-24,204,strawberry yogurt,50,60,10,1,00032,India
938613,2023-07-24,211,red bull,90,125,35,1,00032,India
938613,2023-07-24,205,classic yogurt,45,60,15,1,00032,India
924107,2023-07-24,201,paneer,210,340,130,1,00113,India
924107,2023-07-24,203,mango yogurt,50,60,10,1,00113,India
970039,2023-07-24,206,yakult,360,400,40,1,00215,India
970039,2023-07-24,210,mountain dew,75,100,25,1,00215,India
970039,2023-07-24,203,mango yogurt,50,60,10,1,00215,India
519927,2023-07-24,203,mango yogurt,50,60,10,1,00348,India
687463,2023-07-24,210,mountain dew,75,100,25,1,00030,India
687463,2023-07-24,206,yakult,360,400,40,1,00030,India
687463,2023-07-24,209,pepsi,75,100,25,1,00030,India
236075,2023-07-24,202,milk,12,27,15,1,00351,India
401541,2023-07-24,202,milk,12,27,15,1,00065,India
401541,2023-07-24,204,strawberry yogurt,50,60,10,1,00065,India
401541,2023-07-24,213,bisleri,6,15,9,1,00065,India
401541,2023-07-24,206,yakult,360,400,40,1,00065,India
390012,2023-07-24,211,red bull,90,125,35,1,00138,India
390012,2023-07-24,213,bisleri,6,15,9,1,00138,India
390012,2023-07-24,209,pepsi,75,100,25,1,00138,India
580427,2023-07-24,201,paneer,210,340,130,1,00493,India
580427,2023-07-24,211,red bull,90,125,35,1,00493,India
582195,2023-07-24,208,sprite,75,100,25,1,00386,India
582195,2023-07-24,202,milk,12,27,15,1,00386,India
560878,2023-07-24,209,pepsi,75,100,25,1,00488,India
329173,2023-07-24,203,mango yogurt,50,60,10,1,00311,India
329173,2023-07-24,209,pepsi,75,100,25,1,00311,India
195958,2023-07-24,211,red bull,90,125,35,1,00429,India
195958,2023-07-24,210,mountain dew,75,100,25,1,00429,India
994225,2023-07-24,205,classic yogurt,45,60,15,1,00324,India
994225,2023-07-24,212,amul cheese,250,315,65,1,00324,India
994225,2023-07-24,201,paneer,210,340,130,1,00324,India
994225,2023-07-24,208,sprite,75,100,25,1,00324,India
994225,2023-07-24,202,milk,12,27,15,1,00324,India
225323,2023-07-24,204,strawberry yogurt,50,60,10,1,00360,India
932418,2023-07-24,213,bisleri,6,15,9,1,00008,India
176507,2023-07-24,213,bisleri,6,15,9,1,00318,India
176507,2023-07-24,206,yakult,360,400,40,1,00318,India
272583,2023-07-24,205,classic yogurt,45,60,15,1,00137,India
272583,2023-07-24,201,paneer,210,340,130,1,00137,India
817628,2023-07-24,204,strawberry yogurt,50,60,10,1,00343,India
817628,2023-07-24,202,milk,12,27,15,1,00343,India
817628,2023-07-24,211,red bull,90,125,35,1,00343,India
817628,2023-07-24,206,yakult,360,400,40,1,00343,India
587661,2023-07-24,208,sprite,75,100,25,1,00117,India
587661,2023-07-24,212,amul cheese,250,315,65,1,00117,India
408359,2023-07-24,202,milk,12,27,15,1,00091,India
408359,2023-07-24,209,pepsi,75,100,25,1,00091,India
408359,2023-07-24,212,amul cheese,250,315,65,1,00091,India
737344,2023-07-24,206,yakult,360,400,40,1,00107,India
737344,2023-07-24,207,coca cola,75,100,25,1,00107,India
737344,2023-07-24,205,classic yogurt,45,60,15,1,00107,India
737344,2023-07-24,201,paneer,210,340,130,1,00107,India
737344,2023-07-24,203,mango yogurt,50,60,10,1,00107,India
728147,2023-07-24,207,coca cola,75,100,25,1,00224,India
728147,2023-07-24,211,red bull,90,125,35,1,00224,India
728147,2023-07-24,205,classic yogurt,45,60,15,1,00224,India
728147,2023-07-24,201,paneer,210,340,130,1,00224,India
582168,2023-07-24,201,paneer,210,340,130,1,00494,India
582168,2023-07-24,210,mountain dew,75,100,25,1,00494,India
582168,2023-07-24,208,sprite,75,100,25,1,00494,India
582168,2023-07-24,212,amul cheese,250,315,65,1,00494,India
587587,2023-07-24,208,sprite,75,100,25,1,00323,India
587587,2023-07-24,205,classic yogurt,45,60,15,1,00323,India
587587,2023-07-24,202,milk,12,27,15,1,00323,India
587587,2023-07-24,210,mountain dew,75,100,25,1,00323,India
856002,2023-07-24,206,yakult,360,400,40,1,00226,India
856002,2023-07-24,212,amul cheese,250,315,65,1,00226,India
856002,2023-07-24,202,milk,12,27,15,1,00226,India
234316,2023-07-24,203,mango yogurt,50,60,10,1,00076,India
234316,2023-07-24,205,classic yogurt,45,60,15,1,00076,India
234316,2023-07-24,213,bisleri,6,15,9,1,00076,India
234316,2023-07-24,211,red bull,90,125,35,1,00076,India
635118,2023-07-24,210,mountain dew,75,100,25,1,00431,India
635118,2023-07-24,206,yakult,360,400,40,1,00431,India
635118,2023-07-24,207,coca cola,75,100,25,1,00431,India
635118,2023-07-24,205,classic yogurt,45,60,15,1,00431,India
563651,2023-07-24,201,paneer,210,340,130,1,00388,India
563651,2023-07-24,206,yakult,360,400,40,1,00388,India
563651,2023-07-24,208,sprite,75,100,25,1,00388,India
465166,2023-07-24,213,bisleri,6,15,9,1,00245,India
465166,2023-07-24,207,coca cola,75,100,25,1,00245,India
926520,2023-07-24,202,milk,12,27,15,1,00098,India
926520,2023-07-24,212,amul cheese,250,315,65,1,00098,India
926520,2023-07-24,205,classic yogurt,45,60,15,1,00098,India
926520,2023-07-24,203,mango yogurt,50,60,10,1,00098,India
926520,2023-07-24,201,paneer,210,340,130,1,00098,India
951180,2023-07-24,213,bisleri,6,15,9,1,00384,India
951180,2023-07-24,202,milk,12,27,15,1,00384,India
951180,2023-07-24,209,pepsi,75,100,25,1,00384,India
951180,2023-07-24,211,red bull,90,125,35,1,00384,India
493983,2023-07-24,210,mountain dew,75,100,25,1,00054,India
493983,2023-07-24,212,amul cheese,250,315,65,1,00054,India
493983,2023-07-24,201,paneer,210,340,130,1,00054,India
493983,2023-07-24,211,red bull,90,125,35,1,00054,India
817990,2023-07-24,201,paneer,210,340,130,1,00057,India
817990,2023-07-24,209,pepsi,75,100,25,1,00057,India
753558,2023-07-24,210,mountain dew,75,100,25,1,00478,India
548803,2023-07-24,206,yakult,360,400,40,1,00163,India
548803,2023-07-24,205,classic yogurt,45,60,15,1,00163,India
548803,2023-07-24,213,bisleri,6,15,9,1,00163,India
548803,2023-07-24,201,paneer,210,340,130,1,00163,India
306059,2023-07-24,204,strawberry yogurt,50,60,10,1,00414,India
306059,2023-07-24,210,mountain dew,75,100,25,1,00414,India
862181,2023-07-24,208,sprite,75,100,25,1,00143,India
862181,2023-07-24,206,yakult,360,400,40,1,00143,India
862181,2023-07-24,201,paneer,210,340,130,1,00143,India
862181,2023-07-24,213,bisleri,6,15,9,1,00143,India
862181,2023-07-24,202,milk,12,27,15,1,00143,India
889916,2023-07-24,202,milk,12,27,15,1,00452,India
889916,2023-07-24,213,bisleri,6,15,9,1,00452,India
767026,2023-07-24,201,paneer,210,340,130,1,00325,India
767026,2023-07-24,212,amul cheese,250,315,65,1,00325,India
767026,2023-07-24,205,classic yogurt,45,60,15,1,00325,India
767026,2023-07-24,213,bisleri,6,15,9,1,00325,India
226189,2023-07-24,203,mango yogurt,50,60,10,1,00348,India
226189,2023-07-24,208,sprite,75,100,25,1,00348,India
550398,2023-07-24,210,mountain dew,75,100,25,1,00435,India
550398,2023-07-24,201,paneer,210,340,130,1,00435,India
730981,2023-07-24,212,amul cheese,250,315,65,1,00278,India
816522,2023-07-24,211,red bull,90,125,35,1,00263,India
816522,2023-07-24,206,yakult,360,400,40,1,00263,India
816522,2023-07-24,201,paneer,210,340,130,1,00263,India
816522,2023-07-24,208,sprite,75,100,25,1,00263,India
134299,2023-07-24,209,pepsi,75,100,25,1,00295,India
549387,2023-07-24,205,classic yogurt,45,60,15,1,00036,India
549387,2023-07-24,207,coca cola,75,100,25,1,00036,India
549387,2023-07-24,213,bisleri,6,15,9,1,00036,India
549387,2023-07-24,201,paneer,210,340,130,1,00036,India
549387,2023-07-24,206,yakult,360,400,40,1,00036,India
960607,2023-07-24,204,strawberry yogurt,50,60,10,1,00311,India
960607,2023-07-24,203,mango yogurt,50,60,10,1,00311,India
960607,2023-07-24,201,paneer,210,340,130,1,00311,India
430128,2023-07-24,210,mountain dew,75,100,25,1,00396,India
430128,2023-07-24,208,sprite,75,100,25,1,00396,India
430128,2023-07-24,211,red bull,90,125,35,1,00396,India
730757,2023-07-24,210,mountain dew,75,100,25,1,00334,India
636640,2023-07-24,213,bisleri,6,15,9,1,00118,India
636640,2023-07-24,201,paneer,210,340,130,1,00118,India
636640,2023-07-24,204,strawberry yogurt,50,60,10,1,00118,India
636640,2023-07-24,210,mountain dew,75,100,25,1,00118,India
670606,2023-07-24,203,mango yogurt,50,60,10,1,00349,India
311797,2023-07-25,209,pepsi,75,100,25,1,00038,India
743643,2023-07-25,213,bisleri,6,15,9,1,00018,India
680641,2023-07-25,206,yakult,360,400,40,1,00135,India
680641,2023-07-25,202,milk,12,27,15,1,00135,India
680641,2023-07-25,209,pepsi,75,100,25,1,00135,India
420987,2023-07-25,209,pepsi,75,100,25,1,00058,India
950605,2023-07-25,203,mango yogurt,50,60,10,1,00085,India
950605,2023-07-25,201,paneer,210,340,130,1,00085,India
950605,2023-07-25,204,strawberry yogurt,50,60,10,1,00085,India
950605,2023-07-25,206,yakult,360,400,40,1,00085,India
950605,2023-07-25,202,milk,12,27,15,1,00085,India
463003,2023-07-25,205,classic yogurt,45,60,15,1,00282,India
463003,2023-07-25,206,yakult,360,400,40,1,00282,India
463003,2023-07-25,209,pepsi,75,100,25,1,00282,India
463003,2023-07-25,213,bisleri,6,15,9,1,00282,India
918740,2023-07-25,201,paneer,210,340,130,1,00375,India
918740,2023-07-25,212,amul cheese,250,315,65,1,00375,India
918740,2023-07-25,213,bisleri,6,15,9,1,00375,India
631369,2023-07-25,202,milk,12,27,15,1,00148,India
631369,2023-07-25,211,red bull,90,125,35,1,00148,India
664203,2023-07-25,211,red bull,90,125,35,1,00136,India
664203,2023-07-25,202,milk,12,27,15,1,00136,India
925746,2023-07-25,209,pepsi,75,100,25,1,00298,India
304065,2023-07-25,206,yakult,360,400,40,1,00458,India
304065,2023-07-25,203,mango yogurt,50,60,10,1,00458,India
304065,2023-07-25,211,red bull,90,125,35,1,00458,India
104152,2023-07-25,213,bisleri,6,15,9,1,00065,India
104152,2023-07-25,203,mango yogurt,50,60,10,1,00065,India
298139,2023-07-25,203,mango yogurt,50,60,10,1,00276,India
298139,2023-07-25,201,paneer,210,340,130,1,00276,India
298139,2023-07-25,213,bisleri,6,15,9,1,00276,India
619616,2023-07-25,206,yakult,360,400,40,1,00265,India
619616,2023-07-25,212,amul cheese,250,315,65,1,00265,India
288226,2023-07-25,203,mango yogurt,50,60,10,1,00177,India
288226,2023-07-25,207,coca cola,75,100,25,1,00177,India
288226,2023-07-25,212,amul cheese,250,315,65,1,00177,India
288226,2023-07-25,211,red bull,90,125,35,1,00177,India
797732,2023-07-25,211,red bull,90,125,35,1,00165,India
797732,2023-07-25,213,bisleri,6,15,9,1,00165,India
797732,2023-07-25,201,paneer,210,340,130,1,00165,India
216082,2023-07-25,209,pepsi,75,100,25,1,00051,India
198787,2023-07-25,205,classic yogurt,45,60,15,1,00222,India
198787,2023-07-25,201,paneer,210,340,130,1,00222,India
198787,2023-07-25,211,red bull,90,125,35,1,00222,India
198787,2023-07-25,204,strawberry yogurt,50,60,10,1,00222,India
198787,2023-07-25,212,amul cheese,250,315,65,1,00222,India
419824,2023-07-25,204,strawberry yogurt,50,60,10,1,00076,India
419824,2023-07-25,205,classic yogurt,45,60,15,1,00076,India
419824,2023-07-25,207,coca cola,75,100,25,1,00076,India
782432,2023-07-25,201,paneer,210,340,130,1,00157,India
782432,2023-07-25,213,bisleri,6,15,9,1,00157,India
320256,2023-07-25,213,bisleri,6,15,9,1,00227,India
320256,2023-07-25,204,strawberry yogurt,50,60,10,1,00227,India
931145,2023-07-25,205,classic yogurt,45,60,15,1,00296,India
516859,2023-07-25,212,amul cheese,250,315,65,1,00176,India
516859,2023-07-25,210,mountain dew,75,100,25,1,00176,India
516859,2023-07-25,213,bisleri,6,15,9,1,00176,India
992937,2023-07-25,210,mountain dew,75,100,25,1,00095,India
992937,2023-07-25,207,coca cola,75,100,25,1,00095,India
992937,2023-07-25,208,sprite,75,100,25,1,00095,India
383427,2023-07-25,209,pepsi,75,100,25,1,00109,India
383427,2023-07-25,203,mango yogurt,50,60,10,1,00109,India
383427,2023-07-25,213,bisleri,6,15,9,1,00109,India
383427,2023-07-25,208,sprite,75,100,25,1,00109,India
383427,2023-07-25,201,paneer,210,340,130,1,00109,India
517547,2023-07-25,210,mountain dew,75,100,25,1,00339,India
517547,2023-07-25,212,amul cheese,250,315,65,1,00339,India
517547,2023-07-25,207,coca cola,75,100,25,1,00339,India
517547,2023-07-25,203,mango yogurt,50,60,10,1,00339,India
765462,2023-07-25,211,red bull,90,125,35,1,00132,India
765462,2023-07-25,209,pepsi,75,100,25,1,00132,India
765462,2023-07-25,213,bisleri,6,15,9,1,00132,India
187500,2023-07-25,204,strawberry yogurt,50,60,10,1,00494,India
187500,2023-07-25,207,coca cola,75,100,25,1,00494,India
187631,2023-07-25,201,paneer,210,340,130,1,00224,India
187631,2023-07-25,213,bisleri,6,15,9,1,00224,India
843482,2023-07-25,206,yakult,360,400,40,1,00243,India
124082,2023-07-25,207,coca cola,75,100,25,1,00213,India
319552,2023-07-25,203,mango yogurt,50,60,10,1,00224,India
319552,2023-07-25,210,mountain dew,75,100,25,1,00224,India
319552,2023-07-25,212,amul cheese,250,315,65,1,00224,India
319552,2023-07-25,205,classic yogurt,45,60,15,1,00224,India
319552,2023-07-25,202,milk,12,27,15,1,00224,India
855153,2023-07-25,213,bisleri,6,15,9,1,00175,India
855153,2023-07-25,202,milk,12,27,15,1,00175,India
863344,2023-07-25,213,bisleri,6,15,9,1,00355,India
863344,2023-07-25,208,sprite,75,100,25,1,00355,India
385201,2023-07-25,202,milk,12,27,15,1,00272,India
385201,2023-07-25,207,coca cola,75,100,25,1,00272,India
868434,2023-07-25,213,bisleri,6,15,9,1,00395,India
868434,2023-07-25,201,paneer,210,340,130,1,00395,India
311551,2023-07-25,206,yakult,360,400,40,1,00077,India
311551,2023-07-25,209,pepsi,75,100,25,1,00077,India
311551,2023-07-25,207,coca cola,75,100,25,1,00077,India
311551,2023-07-25,205,classic yogurt,45,60,15,1,00077,India
311551,2023-07-25,208,sprite,75,100,25,1,00077,India
964602,2023-07-25,208,sprite,75,100,25,1,00182,India
964602,2023-07-25,213,bisleri,6,15,9,1,00182,India
286384,2023-07-25,209,pepsi,75,100,25,1,00463,India
969261,2023-07-25,210,mountain dew,75,100,25,1,00257,India
969261,2023-07-25,207,coca cola,75,100,25,1,00257,India
468504,2023-07-25,208,sprite,75,100,25,1,00208,India
468504,2023-07-25,203,mango yogurt,50,60,10,1,00208,India
620604,2023-07-25,211,red bull,90,125,35,1,00030,India
620604,2023-07-25,208,sprite,75,100,25,1,00030,India
620604,2023-07-25,209,pepsi,75,100,25,1,00030,India
620604,2023-07-25,210,mountain dew,75,100,25,1,00030,India
457287,2023-07-25,201,paneer,210,340,130,1,00132,India
457287,2023-07-25,206,yakult,360,400,40,1,00132,India
457287,2023-07-25,204,strawberry yogurt,50,60,10,1,00132,India
128618,2023-07-25,202,milk,12,27,15,1,00124,India
128618,2023-07-25,207,coca cola,75,100,25,1,00124,India
128618,2023-07-25,209,pepsi,75,100,25,1,00124,India
764375,2023-07-25,212,amul cheese,250,315,65,1,00371,India
764375,2023-07-25,202,milk,12,27,15,1,00371,India
764375,2023-07-25,205,classic yogurt,45,60,15,1,00371,India
324641,2023-07-25,204,strawberry yogurt,50,60,10,1,00380,India
324641,2023-07-25,210,mountain dew,75,100,25,1,00380,India
145496,2023-07-25,213,bisleri,6,15,9,1,00140,India
145496,2023-07-25,204,strawberry yogurt,50,60,10,1,00140,India
145496,2023-07-25,205,classic yogurt,45,60,15,1,00140,India
501272,2023-07-25,202,milk,12,27,15,1,00216,India
501272,2023-07-25,210,mountain dew,75,100,25,1,00216,India
159846,2023-07-25,201,paneer,210,340,130,1,00481,India
438696,2023-07-25,208,sprite,75,100,25,1,00193,India
438696,2023-07-25,204,strawberry yogurt,50,60,10,1,00193,India
498050,2023-07-25,210,mountain dew,75,100,25,1,00099,India
498050,2023-07-25,203,mango yogurt,50,60,10,1,00099,India
498050,2023-07-25,213,bisleri,6,15,9,1,00099,India
868278,2023-07-25,206,yakult,360,400,40,1,00206,India
868278,2023-07-25,210,mountain dew,75,100,25,1,00206,India
868278,2023-07-25,212,amul cheese,250,315,65,1,00206,India
868278,2023-07-25,205,classic yogurt,45,60,15,1,00206,India
321045,2023-07-25,202,milk,12,27,15,1,00390,India
321045,2023-07-25,208,sprite,75,100,25,1,00390,India
321045,2023-07-25,211,red bull,90,125,35,1,00390,India
890088,2023-07-25,201,paneer,210,340,130,1,00076,India
890088,2023-07-25,211,red bull,90,125,35,1,00076,India
890088,2023-07-25,210,mountain dew,75,100,25,1,00076,India
890088,2023-07-25,207,coca cola,75,100,25,1,00076,India
688469,2023-07-25,205,classic yogurt,45,60,15,1,00490,India
688469,2023-07-25,201,paneer,210,340,130,1,00490,India
464717,2023-07-25,201,paneer,210,340,130,1,00123,India
489559,2023-07-25,213,bisleri,6,15,9,1,00242,India
489559,2023-07-25,203,mango yogurt,50,60,10,1,00242,India
805886,2023-07-25,209,pepsi,75,100,25,1,00383,India
805886,2023-07-25,212,amul cheese,250,315,65,1,00383,India
805886,2023-07-25,206,yakult,360,400,40,1,00383,India
805886,2023-07-25,203,mango yogurt,50,60,10,1,00383,India
805886,2023-07-25,202,milk,12,27,15,1,00383,India
612448,2023-07-25,212,amul cheese,250,315,65,1,00227,India
198650,2023-07-25,206,yakult,360,400,40,1,00040,India
198650,2023-07-25,210,mountain dew,75,100,25,1,00040,India
198650,2023-07-25,201,paneer,210,340,130,1,00040,India
360344,2023-07-25,213,bisleri,6,15,9,1,00383,India
360344,2023-07-25,208,sprite,75,100,25,1,00383,India
388973,2023-07-25,201,paneer,210,340,130,1,00433,India
388973,2023-07-25,206,yakult,360,400,40,1,00433,India
388973,2023-07-25,213,bisleri,6,15,9,1,00433,India
388973,2023-07-25,202,milk,12,27,15,1,00433,India
690952,2023-07-25,212,amul cheese,250,315,65,1,00439,India
398904,2023-07-25,201,paneer,210,340,130,1,00214,India
398904,2023-07-25,210,mountain dew,75,100,25,1,00214,India
398904,2023-07-25,209,pepsi,75,100,25,1,00214,India
398904,2023-07-25,208,sprite,75,100,25,1,00214,India
331636,2023-07-25,204,strawberry yogurt,50,60,10,1,00317,India
331636,2023-07-25,206,yakult,360,400,40,1,00317,India
331636,2023-07-25,210,mountain dew,75,100,25,1,00317,India
331636,2023-07-25,201,paneer,210,340,130,1,00317,India
128115,2023-07-25,204,strawberry yogurt,50,60,10,1,00449,India
128115,2023-07-25,212,amul cheese,250,315,65,1,00449,India
128115,2023-07-25,205,classic yogurt,45,60,15,1,00449,India
323661,2023-07-25,204,strawberry yogurt,50,60,10,1,00343,India
323661,2023-07-25,207,coca cola,75,100,25,1,00343,India
323661,2023-07-25,205,classic yogurt,45,60,15,1,00343,India
686850,2023-07-25,206,yakult,360,400,40,1,00416,India
686850,2023-07-25,211,red bull,90,125,35,1,00416,India
686850,2023-07-25,209,pepsi,75,100,25,1,00416,India
686850,2023-07-25,202,milk,12,27,15,1,00416,India
686850,2023-07-25,212,amul cheese,250,315,65,1,00416,India
711619,2023-07-25,212,amul cheese,250,315,65,1,00022,India
711619,2023-07-25,203,mango yogurt,50,60,10,1,00022,India
711619,2023-07-25,209,pepsi,75,100,25,1,00022,India
460413,2023-07-25,210,mountain dew,75,100,25,1,00227,India
637078,2023-07-25,205,classic yogurt,45,60,15,1,00184,India
637078,2023-07-25,201,paneer,210,340,130,1,00184,India
637078,2023-07-25,204,strawberry yogurt,50,60,10,1,00184,India
637078,2023-07-25,202,milk,12,27,15,1,00184,India
557463,2023-07-25,209,pepsi,75,100,25,1,00477,India
153788,2023-07-25,213,bisleri,6,15,9,1,00448,India
153788,2023-07-25,210,mountain dew,75,100,25,1,00448,India
153788,2023-07-25,202,milk,12,27,15,1,00448,India
153788,2023-07-25,211,red bull,90,125,35,1,00448,India
991996,2023-07-25,204,strawberry yogurt,50,60,10,1,00230,India
991996,2023-07-25,212,amul cheese,250,315,65,1,00230,India
991996,2023-07-25,203,mango yogurt,50,60,10,1,00230,India
438531,2023-07-25,207,coca cola,75,100,25,1,00042,India
438531,2023-07-25,210,mountain dew,75,100,25,1,00042,India
438531,2023-07-25,211,red bull,90,125,35,1,00042,India
526420,2023-07-25,202,milk,12,27,15,1,00466,India
526420,2023-07-25,209,pepsi,75,100,25,1,00466,India
526420,2023-07-25,207,coca cola,75,100,25,1,00466,India
526420,2023-07-25,208,sprite,75,100,25,1,00466,India
526420,2023-07-25,206,yakult,360,400,40,1,00466,India
783249,2023-07-25,211,red bull,90,125,35,1,00017,India
783249,2023-07-25,201,paneer,210,340,130,1,00017,India
783249,2023-07-25,207,coca cola,75,100,25,1,00017,India
783249,2023-07-25,203,mango yogurt,50,60,10,1,00017,India
168917,2023-07-25,203,mango yogurt,50,60,10,1,00184,India
168917,2023-07-25,213,bisleri,6,15,9,1,00184,India
375644,2023-07-25,204,strawberry yogurt,50,60,10,1,00095,India
748011,2023-07-25,205,classic yogurt,45,60,15,1,00363,India
197806,2023-07-25,207,coca cola,75,100,25,1,00362,India
197806,2023-07-25,204,strawberry yogurt,50,60,10,1,00362,India
197806,2023-07-25,206,yakult,360,400,40,1,00362,India
197806,2023-07-25,212,amul cheese,250,315,65,1,00362,India
114719,2023-07-25,213,bisleri,6,15,9,1,00247,India
114719,2023-07-25,203,mango yogurt,50,60,10,1,00247,India
114719,2023-07-25,212,amul cheese,250,315,65,1,00247,India
114719,2023-07-25,208,sprite,75,100,25,1,00247,India
404835,2023-07-25,213,bisleri,6,15,9,1,00380,India
404835,2023-07-25,209,pepsi,75,100,25,1,00380,India
404835,2023-07-25,205,classic yogurt,45,60,15,1,00380,India
147502,2023-07-25,211,red bull,90,125,35,1,00321,India
583230,2023-07-25,211,red bull,90,125,35,1,00389,India
819896,2023-07-26,206,yakult,360,400,40,1,00481,India
819896,2023-07-26,204,strawberry yogurt,50,60,10,1,00481,India
819896,2023-07-26,202,milk,12,27,15,1,00481,India
819896,2023-07-26,210,mountain dew,75,100,25,1,00481,India
819896,2023-07-26,209,pepsi,75,100,25,1,00481,India
698327,2023-07-26,212,amul cheese,250,315,65,1,00112,India
698327,2023-07-26,210,mountain dew,75,100,25,1,00112,India
698327,2023-07-26,204,strawberry yogurt,50,60,10,1,00112,India
373852,2023-07-26,209,pepsi,75,100,25,1,00335,India
373852,2023-07-26,201,paneer,210,340,130,1,00335,India
373852,2023-07-26,213,bisleri,6,15,9,1,00335,India
373852,2023-07-26,210,mountain dew,75,100,25,1,00335,India
373852,2023-07-26,202,milk,12,27,15,1,00335,India
461559,2023-07-26,210,mountain dew,75,100,25,1,00092,India
461559,2023-07-26,209,pepsi,75,100,25,1,00092,India
931846,2023-07-26,208,sprite,75,100,25,1,00232,India
931846,2023-07-26,213,bisleri,6,15,9,1,00232,India
931846,2023-07-26,202,milk,12,27,15,1,00232,India
971465,2023-07-26,207,coca cola,75,100,25,1,00174,India
971465,2023-07-26,208,sprite,75,100,25,1,00174,India
971465,2023-07-26,212,amul cheese,250,315,65,1,00174,India
971465,2023-07-26,203,mango yogurt,50,60,10,1,00174,India
779772,2023-07-26,205,classic yogurt,45,60,15,1,00310,India
779772,2023-07-26,209,pepsi,75,100,25,1,00310,India
372985,2023-07-26,212,amul cheese,250,315,65,1,00161,India
372985,2023-07-26,202,milk,12,27,15,1,00161,India
372985,2023-07-26,203,mango yogurt,50,60,10,1,00161,India
372985,2023-07-26,209,pepsi,75,100,25,1,00161,India
405661,2023-07-26,203,mango yogurt,50,60,10,1,00347,India
405661,2023-07-26,209,pepsi,75,100,25,1,00347,India
449184,2023-07-26,210,mountain dew,75,100,25,1,00242,India
449184,2023-07-26,201,paneer,210,340,130,1,00242,India
449184,2023-07-26,209,pepsi,75,100,25,1,00242,India
867984,2023-07-26,209,pepsi,75,100,25,1,00087,India
867984,2023-07-26,207,coca cola,75,100,25,1,00087,India
867984,2023-07-26,208,sprite,75,100,25,1,00087,India
867984,2023-07-26,205,classic yogurt,45,60,15,1,00087,India
656671,2023-07-26,207,coca cola,75,100,25,1,00193,India
656671,2023-07-26,213,bisleri,6,15,9,1,00193,India
656671,2023-07-26,204,strawberry yogurt,50,60,10,1,00193,India
656671,2023-07-26,208,sprite,75,100,25,1,00193,India
794369,2023-07-26,207,coca cola,75,100,25,1,00241,India
794369,2023-07-26,210,mountain dew,75,100,25,1,00241,India
794369,2023-07-26,203,mango yogurt,50,60,10,1,00241,India
794369,2023-07-26,204,strawberry yogurt,50,60,10,1,00241,India
794369,2023-07-26,206,yakult,360,400,40,1,00241,India
584747,2023-07-26,212,amul cheese,250,315,65,1,00223,India
584747,2023-07-26,201,paneer,210,340,130,1,00223,India
584747,2023-07-26,203,mango yogurt,50,60,10,1,00223,India
480746,2023-07-26,212,amul cheese,250,315,65,1,00021,India
480746,2023-07-26,211,red bull,90,125,35,1,00021,India
569444,2023-07-26,210,mountain dew,75,100,25,1,00305,India
569444,2023-07-26,212,amul cheese,250,315,65,1,00305,India
569444,2023-07-26,201,paneer,210,340,130,1,00305,India
569444,2023-07-26,204,strawberry yogurt,50,60,10,1,00305,India
569444,2023-07-26,209,pepsi,75,100,25,1,00305,India
695892,2023-07-26,208,sprite,75,100,25,1,00465,India
695892,2023-07-26,204,strawberry yogurt,50,60,10,1,00465,India
695892,2023-07-26,201,paneer,210,340,130,1,00465,India
276557,2023-07-26,213,bisleri,6,15,9,1,00269,India
276557,2023-07-26,211,red bull,90,125,35,1,00269,India
276557,2023-07-26,201,paneer,210,340,130,1,00269,India
276557,2023-07-26,212,amul cheese,250,315,65,1,00269,India
467349,2023-07-26,204,strawberry yogurt,50,60,10,1,00062,India
175951,2023-07-26,203,mango yogurt,50,60,10,1,00018,India
175951,2023-07-26,204,strawberry yogurt,50,60,10,1,00018,India
175951,2023-07-26,213,bisleri,6,15,9,1,00018,India
175951,2023-07-26,212,amul cheese,250,315,65,1,00018,India
941397,2023-07-26,210,mountain dew,75,100,25,1,00010,India
941397,2023-07-26,208,sprite,75,100,25,1,00010,India
941397,2023-07-26,204,strawberry yogurt,50,60,10,1,00010,India
854859,2023-07-26,204,strawberry yogurt,50,60,10,1,00391,India
854859,2023-07-26,203,mango yogurt,50,60,10,1,00391,India
854859,2023-07-26,211,red bull,90,125,35,1,00391,India
543593,2023-07-26,202,milk,12,27,15,1,00375,India
543593,2023-07-26,203,mango yogurt,50,60,10,1,00375,India
543593,2023-07-26,206,yakult,360,400,40,1,00375,India
543593,2023-07-26,209,pepsi,75,100,25,1,00375,India
664898,2023-07-26,208,sprite,75,100,25,1,00080,India
664898,2023-07-26,203,mango yogurt,50,60,10,1,00080,India
664898,2023-07-26,211,red bull,90,125,35,1,00080,India
493075,2023-07-26,204,strawberry yogurt,50,60,10,1,00226,India
493075,2023-07-26,206,yakult,360,400,40,1,00226,India
493075,2023-07-26,202,milk,12,27,15,1,00226,India
493075,2023-07-26,213,bisleri,6,15,9,1,00226,India
198376,2023-07-26,208,sprite,75,100,25,1,00406,India
518713,2023-07-26,205,classic yogurt,45,60,15,1,00128,India
518713,2023-07-26,213,bisleri,6,15,9,1,00128,India
126073,2023-07-26,201,paneer,210,340,130,1,00155,India
126073,2023-07-26,211,red bull,90,125,35,1,00155,India
208330,2023-07-26,210,mountain dew,75,100,25,1,00140,India
208330,2023-07-26,203,mango yogurt,50,60,10,1,00140,India
208330,2023-07-26,208,sprite,75,100,25,1,00140,India
208330,2023-07-26,211,red bull,90,125,35,1,00140,India
626234,2023-07-26,206,yakult,360,400,40,1,00150,India
626234,2023-07-26,204,strawberry yogurt,50,60,10,1,00150,India
626234,2023-07-26,212,amul cheese,250,315,65,1,00150,India
626234,2023-07-26,208,sprite,75,100,25,1,00150,India
158142,2023-07-26,205,classic yogurt,45,60,15,1,00184,India
148028,2023-07-26,210,mountain dew,75,100,25,1,00283,India
148028,2023-07-26,212,amul cheese,250,315,65,1,00283,India
148028,2023-07-26,201,paneer,210,340,130,1,00283,India
919197,2023-07-26,211,red bull,90,125,35,1,00037,India
919197,2023-07-26,205,classic yogurt,45,60,15,1,00037,India
854532,2023-07-26,208,sprite,75,100,25,1,00062,India
854532,2023-07-26,202,milk,12,27,15,1,00062,India
854532,2023-07-26,211,red bull,90,125,35,1,00062,India
555232,2023-07-26,207,coca cola,75,100,25,1,00275,India
555232,2023-07-26,209,pepsi,75,100,25,1,00275,India
555232,2023-07-26,204,strawberry yogurt,50,60,10,1,00275,India
555232,2023-07-26,210,mountain dew,75,100,25,1,00275,India
555232,2023-07-26,201,paneer,210,340,130,1,00275,India
372139,2023-07-26,207,coca cola,75,100,25,1,00416,India
372139,2023-07-26,209,pepsi,75,100,25,1,00416,India
372139,2023-07-26,210,mountain dew,75,100,25,1,00416,India
372139,2023-07-26,212,amul cheese,250,315,65,1,00416,India
818538,2023-07-26,204,strawberry yogurt,50,60,10,1,00301,India
302455,2023-07-26,205,classic yogurt,45,60,15,1,00239,India
302455,2023-07-26,210,mountain dew,75,100,25,1,00239,India
819771,2023-07-26,212,amul cheese,250,315,65,1,00437,India
819771,2023-07-26,201,paneer,210,340,130,1,00437,India
819771,2023-07-26,204,strawberry yogurt,50,60,10,1,00437,India
819771,2023-07-26,211,red bull,90,125,35,1,00437,India
229566,2023-07-26,205,classic yogurt,45,60,15,1,00099,India
996684,2023-07-26,205,classic yogurt,45,60,15,1,00231,India
996684,2023-07-26,206,yakult,360,400,40,1,00231,India
749518,2023-07-26,213,bisleri,6,15,9,1,00415,India
749518,2023-07-26,203,mango yogurt,50,60,10,1,00415,India
749518,2023-07-26,201,paneer,210,340,130,1,00415,India
749518,2023-07-26,207,coca cola,75,100,25,1,00415,India
148622,2023-07-26,210,mountain dew,75,100,25,1,00248,India
148622,2023-07-26,202,milk,12,27,15,1,00248,India
148622,2023-07-26,211,red bull,90,125,35,1,00248,India
912491,2023-07-26,213,bisleri,6,15,9,1,00407,India
912491,2023-07-26,203,mango yogurt,50,60,10,1,00407,India
466830,2023-07-26,211,red bull,90,125,35,1,00382,India
466830,2023-07-26,212,amul cheese,250,315,65,1,00382,India
466830,2023-07-26,205,classic yogurt,45,60,15,1,00382,India
487907,2023-07-26,210,mountain dew,75,100,25,1,00187,India
487907,2023-07-26,205,classic yogurt,45,60,15,1,00187,India
487907,2023-07-26,211,red bull,90,125,35,1,00187,India
498499,2023-07-26,204,strawberry yogurt,50,60,10,1,00035,India
498499,2023-07-26,209,pepsi,75,100,25,1,00035,India
498499,2023-07-26,210,mountain dew,75,100,25,1,00035,India
498499,2023-07-26,213,bisleri,6,15,9,1,00035,India
401031,2023-07-26,212,amul cheese,250,315,65,1,00313,India
401031,2023-07-26,204,strawberry yogurt,50,60,10,1,00313,India
401031,2023-07-26,208,sprite,75,100,25,1,00313,India
401031,2023-07-26,207,coca cola,75,100,25,1,00313,India
401031,2023-07-26,210,mountain dew,75,100,25,1,00313,India
779418,2023-07-26,213,bisleri,6,15,9,1,00258,India
779418,2023-07-26,201,paneer,210,340,130,1,00258,India
589669,2023-07-26,211,red bull,90,125,35,1,00185,India
589669,2023-07-26,213,bisleri,6,15,9,1,00185,India
589669,2023-07-26,206,yakult,360,400,40,1,00185,India
589669,2023-07-26,204,strawberry yogurt,50,60,10,1,00185,India
770517,2023-07-26,201,paneer,210,340,130,1,00268,India
770517,2023-07-26,205,classic yogurt,45,60,15,1,00268,India
516307,2023-07-26,207,coca cola,75,100,25,1,00301,India
516307,2023-07-26,201,paneer,210,340,130,1,00301,India
516307,2023-07-26,206,yakult,360,400,40,1,00301,India
472347,2023-07-26,208,sprite,75,100,25,1,00260,India
472347,2023-07-26,203,mango yogurt,50,60,10,1,00260,India
364853,2023-07-26,208,sprite,75,100,25,1,00441,India
658446,2023-07-27,211,red bull,90,125,35,1,00460,India
658446,2023-07-27,202,milk,12,27,15,1,00460,India
658446,2023-07-27,201,paneer,210,340,130,1,00460,India
975097,2023-07-27,204,strawberry yogurt,50,60,10,1,00089,India
975097,2023-07-27,202,milk,12,27,15,1,00089,India
855413,2023-07-27,203,mango yogurt,50,60,10,1,00423,India
855413,2023-07-27,209,pepsi,75,100,25,1,00423,India
855413,2023-07-27,210,mountain dew,75,100,25,1,00423,India
855413,2023-07-27,213,bisleri,6,15,9,1,00423,India
610280,2023-07-27,211,red bull,90,125,35,1,00244,India
959651,2023-07-27,209,pepsi,75,100,25,1,00321,India
846016,2023-07-27,204,strawberry yogurt,50,60,10,1,00293,India
704087,2023-07-27,212,amul cheese,250,315,65,1,00421,India
704087,2023-07-27,201,paneer,210,340,130,1,00421,India
557181,2023-07-27,202,milk,12,27,15,1,00072,India
557181,2023-07-27,208,sprite,75,100,25,1,00072,India
966241,2023-07-27,204,strawberry yogurt,50,60,10,1,00352,India
966241,2023-07-27,210,mountain dew,75,100,25,1,00352,India
282309,2023-07-27,209,pepsi,75,100,25,1,00353,India
282309,2023-07-27,201,paneer,210,340,130,1,00353,India
152393,2023-07-27,205,classic yogurt,45,60,15,1,00405,India
152393,2023-07-27,203,mango yogurt,50,60,10,1,00405,India
152393,2023-07-27,206,yakult,360,400,40,1,00405,India
152393,2023-07-27,213,bisleri,6,15,9,1,00405,India
344263,2023-07-27,209,pepsi,75,100,25,1,00399,India
344263,2023-07-27,203,mango yogurt,50,60,10,1,00399,India
607742,2023-07-27,208,sprite,75,100,25,1,00082,India
607742,2023-07-27,212,amul cheese,250,315,65,1,00082,India
607742,2023-07-27,207,coca cola,75,100,25,1,00082,India
607742,2023-07-27,211,red bull,90,125,35,1,00082,India
977181,2023-07-27,201,paneer,210,340,130,1,00369,India
347238,2023-07-27,203,mango yogurt,50,60,10,1,00225,India
347238,2023-07-27,205,classic yogurt,45,60,15,1,00225,India
347238,2023-07-27,209,pepsi,75,100,25,1,00225,India
347238,2023-07-27,201,paneer,210,340,130,1,00225,India
347238,2023-07-27,213,bisleri,6,15,9,1,00225,India
738630,2023-07-27,213,bisleri,6,15,9,1,00257,India
738630,2023-07-27,212,amul cheese,250,315,65,1,00257,India
272789,2023-07-27,213,bisleri,6,15,9,1,00062,India
272789,2023-07-27,205,classic yogurt,45,60,15,1,00062,India
948697,2023-07-27,212,amul cheese,250,315,65,1,00048,India
948697,2023-07-27,209,pepsi,75,100,25,1,00048,India
609424,2023-07-27,207,coca cola,75,100,25,1,00050,India
609424,2023-07-27,209,pepsi,75,100,25,1,00050,India
609424,2023-07-27,213,bisleri,6,15,9,1,00050,India
155419,2023-07-27,207,coca cola,75,100,25,1,00254,India
876839,2023-07-27,204,strawberry yogurt,50,60,10,1,00294,India
876839,2023-07-27,207,coca cola,75,100,25,1,00294,India
904639,2023-07-27,213,bisleri,6,15,9,1,00324,India
904639,2023-07-27,208,sprite,75,100,25,1,00324,India
904639,2023-07-27,212,amul cheese,250,315,65,1,00324,India
371603,2023-07-27,204,strawberry yogurt,50,60,10,1,00255,India
371603,2023-07-27,208,sprite,75,100,25,1,00255,India
371603,2023-07-27,210,mountain dew,75,100,25,1,00255,India
787738,2023-07-27,213,bisleri,6,15,9,1,00423,India
787738,2023-07-27,206,yakult,360,400,40,1,00423,India
787738,2023-07-27,212,amul cheese,250,315,65,1,00423,India
106398,2023-07-27,206,yakult,360,400,40,1,00495,India
106398,2023-07-27,213,bisleri,6,15,9,1,00495,India
106398,2023-07-27,210,mountain dew,75,100,25,1,00495,India
106398,2023-07-27,207,coca cola,75,100,25,1,00495,India
324308,2023-07-27,210,mountain dew,75,100,25,1,00500,India
324308,2023-07-27,206,yakult,360,400,40,1,00500,India
964558,2023-07-27,201,paneer,210,340,130,1,00308,India
964558,2023-07-27,211,red bull,90,125,35,1,00308,India
543161,2023-07-27,212,amul cheese,250,315,65,1,00147,India
543161,2023-07-27,209,pepsi,75,100,25,1,00147,India
543161,2023-07-27,211,red bull,90,125,35,1,00147,India
177469,2023-07-27,212,amul cheese,250,315,65,1,00412,India
177469,2023-07-27,203,mango yogurt,50,60,10,1,00412,India
177469,2023-07-27,207,coca cola,75,100,25,1,00412,India
177469,2023-07-27,205,classic yogurt,45,60,15,1,00412,India
434138,2023-07-27,213,bisleri,6,15,9,1,00158,India
434138,2023-07-27,212,amul cheese,250,315,65,1,00158,India
680136,2023-07-27,205,classic yogurt,45,60,15,1,00192,India
932902,2023-07-27,202,milk,12,27,15,1,00005,India
932902,2023-07-27,208,sprite,75,100,25,1,00005,India
973358,2023-07-27,208,sprite,75,100,25,1,00269,India
973358,2023-07-27,212,amul cheese,250,315,65,1,00269,India
973358,2023-07-27,206,yakult,360,400,40,1,00269,India
973358,2023-07-27,203,mango yogurt,50,60,10,1,00269,India
626232,2023-07-27,207,coca cola,75,100,25,1,00063,India
626232,2023-07-27,204,strawberry yogurt,50,60,10,1,00063,India
626232,2023-07-27,213,bisleri,6,15,9,1,00063,India
641445,2023-07-27,202,milk,12,27,15,1,00110,India
318189,2023-07-27,210,mountain dew,75,100,25,1,00014,India
318189,2023-07-27,208,sprite,75,100,25,1,00014,India
318189,2023-07-27,201,paneer,210,340,130,1,00014,India
318189,2023-07-27,207,coca cola,75,100,25,1,00014,India
318189,2023-07-27,204,strawberry yogurt,50,60,10,1,00014,India
739910,2023-07-27,208,sprite,75,100,25,1,00207,India
800740,2023-07-27,202,milk,12,27,15,1,00235,India
800740,2023-07-27,210,mountain dew,75,100,25,1,00235,India
800740,2023-07-27,209,pepsi,75,100,25,1,00235,India
921850,2023-07-27,211,red bull,90,125,35,1,00264,India
921850,2023-07-27,201,paneer,210,340,130,1,00264,India
921850,2023-07-27,206,yakult,360,400,40,1,00264,India
201770,2023-07-27,205,classic yogurt,45,60,15,1,00438,India
201770,2023-07-27,201,paneer,210,340,130,1,00438,India
201770,2023-07-27,211,red bull,90,125,35,1,00438,India
827048,2023-07-27,206,yakult,360,400,40,1,00452,India
827048,2023-07-27,212,amul cheese,250,315,65,1,00452,India
194343,2023-07-27,213,bisleri,6,15,9,1,00012,India
194343,2023-07-27,205,classic yogurt,45,60,15,1,00012,India
194343,2023-07-27,203,mango yogurt,50,60,10,1,00012,India
194343,2023-07-27,201,paneer,210,340,130,1,00012,India
685127,2023-07-27,211,red bull,90,125,35,1,00428,India
685127,2023-07-27,205,classic yogurt,45,60,15,1,00428,India
685127,2023-07-27,210,mountain dew,75,100,25,1,00428,India
685127,2023-07-27,213,bisleri,6,15,9,1,00428,India
897743,2023-07-27,203,mango yogurt,50,60,10,1,00226,India
897743,2023-07-27,208,sprite,75,100,25,1,00226,India
897743,2023-07-27,201,paneer,210,340,130,1,00226,India
897743,2023-07-27,202,milk,12,27,15,1,00226,India
191595,2023-07-27,207,coca cola,75,100,25,1,00049,India
191595,2023-07-27,201,paneer,210,340,130,1,00049,India
191595,2023-07-27,203,mango yogurt,50,60,10,1,00049,India
191595,2023-07-27,212,amul cheese,250,315,65,1,00049,India
960389,2023-07-27,203,mango yogurt,50,60,10,1,00325,India
960389,2023-07-27,210,mountain dew,75,100,25,1,00325,India
960389,2023-07-27,206,yakult,360,400,40,1,00325,India
425360,2023-07-27,203,mango yogurt,50,60,10,1,00321,India
771015,2023-07-27,203,mango yogurt,50,60,10,1,00212,India
771015,2023-07-27,206,yakult,360,400,40,1,00212,India
771015,2023-07-27,213,bisleri,6,15,9,1,00212,India
771015,2023-07-27,211,red bull,90,125,35,1,00212,India
835336,2023-07-27,204,strawberry yogurt,50,60,10,1,00244,India
835336,2023-07-27,212,amul cheese,250,315,65,1,00244,India
835336,2023-07-27,203,mango yogurt,50,60,10,1,00244,India
598883,2023-07-27,205,classic yogurt,45,60,15,1,00322,India
598883,2023-07-27,207,coca cola,75,100,25,1,00322,India
310630,2023-07-27,212,amul cheese,250,315,65,1,00133,India
310630,2023-07-27,203,mango yogurt,50,60,10,1,00133,India
310630,2023-07-27,204,strawberry yogurt,50,60,10,1,00133,India
941550,2023-07-27,211,red bull,90,125,35,1,00314,India
941550,2023-07-27,205,classic yogurt,45,60,15,1,00314,India
941550,2023-07-27,210,mountain dew,75,100,25,1,00314,India
941550,2023-07-27,202,milk,12,27,15,1,00314,India
941550,2023-07-27,209,pepsi,75,100,25,1,00314,India
639082,2023-07-27,203,mango yogurt,50,60,10,1,00242,India
639082,2023-07-27,207,coca cola,75,100,25,1,00242,India
568546,2023-07-27,207,coca cola,75,100,25,1,00304,India
568546,2023-07-27,213,bisleri,6,15,9,1,00304,India
551360,2023-07-27,209,pepsi,75,100,25,1,00050,India
551360,2023-07-27,212,amul cheese,250,315,65,1,00050,India
779895,2023-07-27,210,mountain dew,75,100,25,1,00049,India
779895,2023-07-27,212,amul cheese,250,315,65,1,00049,India
779895,2023-07-27,211,red bull,90,125,35,1,00049,India
779895,2023-07-27,206,yakult,360,400,40,1,00049,India
779895,2023-07-27,201,paneer,210,340,130,1,00049,India
696605,2023-07-27,208,sprite,75,100,25,1,00033,India
696605,2023-07-27,211,red bull,90,125,35,1,00033,India
969022,2023-07-27,203,mango yogurt,50,60,10,1,00168,India
969022,2023-07-27,205,classic yogurt,45,60,15,1,00168,India
165403,2023-07-27,205,classic yogurt,45,60,15,1,00096,India
359809,2023-07-27,204,strawberry yogurt,50,60,10,1,00021,India
735537,2023-07-27,205,classic yogurt,45,60,15,1,00056,India
735537,2023-07-27,203,mango yogurt,50,60,10,1,00056,India
735537,2023-07-27,201,paneer,210,340,130,1,00056,India
735537,2023-07-27,208,sprite,75,100,25,1,00056,India
735537,2023-07-27,210,mountain dew,75,100,25,1,00056,India
398003,2023-07-28,210,mountain dew,75,100,25,1,00268,India
398003,2023-07-28,206,yakult,360,400,40,1,00268,India
398003,2023-07-28,211,red bull,90,125,35,1,00268,India
398003,2023-07-28,212,amul cheese,250,315,65,1,00268,India
681449,2023-07-28,208,sprite,75,100,25,1,00143,India
681449,2023-07-28,202,milk,12,27,15,1,00143,India
183541,2023-07-28,204,strawberry yogurt,50,60,10,1,00372,India
183541,2023-07-28,209,pepsi,75,100,25,1,00372,India
321997,2023-07-28,205,classic yogurt,45,60,15,1,00190,India
321997,2023-07-28,211,red bull,90,125,35,1,00190,India
321997,2023-07-28,203,mango yogurt,50,60,10,1,00190,India
321997,2023-07-28,210,mountain dew,75,100,25,1,00190,India
932907,2023-07-28,210,mountain dew,75,100,25,1,00174,India
932907,2023-07-28,203,mango yogurt,50,60,10,1,00174,India
932907,2023-07-28,202,milk,12,27,15,1,00174,India
932907,2023-07-28,201,paneer,210,340,130,1,00174,India
397624,2023-07-28,206,yakult,360,400,40,1,00078,India
204928,2023-07-28,208,sprite,75,100,25,1,00401,India
204928,2023-07-28,213,bisleri,6,15,9,1,00401,India
204928,2023-07-28,210,mountain dew,75,100,25,1,00401,India
204928,2023-07-28,212,amul cheese,250,315,65,1,00401,India
187377,2023-07-28,203,mango yogurt,50,60,10,1,00010,India
187377,2023-07-28,211,red bull,90,125,35,1,00010,India
187377,2023-07-28,213,bisleri,6,15,9,1,00010,India
786198,2023-07-28,203,mango yogurt,50,60,10,1,00100,India
786198,2023-07-28,210,mountain dew,75,100,25,1,00100,India
786198,2023-07-28,208,sprite,75,100,25,1,00100,India
533489,2023-07-28,211,red bull,90,125,35,1,00067,India
533489,2023-07-28,209,pepsi,75,100,25,1,00067,India
161575,2023-07-28,213,bisleri,6,15,9,1,00234,India
161575,2023-07-28,209,pepsi,75,100,25,1,00234,India
548422,2023-07-28,213,bisleri,6,15,9,1,00336,India
548422,2023-07-28,203,mango yogurt,50,60,10,1,00336,India
205726,2023-07-28,204,strawberry yogurt,50,60,10,1,00066,India
400605,2023-07-28,213,bisleri,6,15,9,1,00115,India
400605,2023-07-28,206,yakult,360,400,40,1,00115,India
400605,2023-07-28,209,pepsi,75,100,25,1,00115,India
911794,2023-07-28,201,paneer,210,340,130,1,00025,India
911794,2023-07-28,212,amul cheese,250,315,65,1,00025,India
911794,2023-07-28,205,classic yogurt,45,60,15,1,00025,India
911794,2023-07-28,210,mountain dew,75,100,25,1,00025,India
320177,2023-07-28,208,sprite,75,100,25,1,00302,India
838566,2023-07-28,208,sprite,75,100,25,1,00408,India
478979,2023-07-28,202,milk,12,27,15,1,00013,India
478979,2023-07-28,210,mountain dew,75,100,25,1,00013,India
478979,2023-07-28,204,strawberry yogurt,50,60,10,1,00013,India
478979,2023-07-28,208,sprite,75,100,25,1,00013,India
406010,2023-07-28,205,classic yogurt,45,60,15,1,00364,India
406010,2023-07-28,206,yakult,360,400,40,1,00364,India
406010,2023-07-28,210,mountain dew,75,100,25,1,00364,India
965215,2023-07-28,211,red bull,90,125,35,1,00132,India
175770,2023-07-28,205,classic yogurt,45,60,15,1,00322,India
175770,2023-07-28,208,sprite,75,100,25,1,00322,India
175770,2023-07-28,211,red bull,90,125,35,1,00322,India
435382,2023-07-28,202,milk,12,27,15,1,00199,India
982952,2023-07-28,205,classic yogurt,45,60,15,1,00443,India
982952,2023-07-28,209,pepsi,75,100,25,1,00443,India
982952,2023-07-28,206,yakult,360,400,40,1,00443,India
569962,2023-07-28,206,yakult,360,400,40,1,00120,India
569962,2023-07-28,207,coca cola,75,100,25,1,00120,India
569962,2023-07-28,210,mountain dew,75,100,25,1,00120,India
406012,2023-07-28,209,pepsi,75,100,25,1,00069,India
406012,2023-07-28,207,coca cola,75,100,25,1,00069,India
406012,2023-07-28,204,strawberry yogurt,50,60,10,1,00069,India
406012,2023-07-28,206,yakult,360,400,40,1,00069,India
406012,2023-07-28,213,bisleri,6,15,9,1,00069,India
467899,2023-07-28,207,coca cola,75,100,25,1,00271,India
467899,2023-07-28,212,amul cheese,250,315,65,1,00271,India
467899,2023-07-28,211,red bull,90,125,35,1,00271,India
300399,2023-07-28,212,amul cheese,250,315,65,1,00182,India
300399,2023-07-28,201,paneer,210,340,130,1,00182,India
300399,2023-07-28,203,mango yogurt,50,60,10,1,00182,India
300399,2023-07-28,209,pepsi,75,100,25,1,00182,India
300399,2023-07-28,205,classic yogurt,45,60,15,1,00182,India
224746,2023-07-28,213,bisleri,6,15,9,1,00326,India
224746,2023-07-28,209,pepsi,75,100,25,1,00326,India
852559,2023-07-28,211,red bull,90,125,35,1,00250,India
852559,2023-07-28,206,yakult,360,400,40,1,00250,India
852559,2023-07-28,209,pepsi,75,100,25,1,00250,India
297492,2023-07-28,201,paneer,210,340,130,1,00148,India
297492,2023-07-28,204,strawberry yogurt,50,60,10,1,00148,India
724601,2023-07-28,202,milk,12,27,15,1,00417,India
724601,2023-07-28,205,classic yogurt,45,60,15,1,00417,India
724601,2023-07-28,203,mango yogurt,50,60,10,1,00417,India
639690,2023-07-28,213,bisleri,6,15,9,1,00257,India
639690,2023-07-28,209,pepsi,75,100,25,1,00257,India
887631,2023-07-28,204,strawberry yogurt,50,60,10,1,00038,India
887631,2023-07-28,201,paneer,210,340,130,1,00038,India
479623,2023-07-28,208,sprite,75,100,25,1,00324,India
479623,2023-07-28,204,strawberry yogurt,50,60,10,1,00324,India
479623,2023-07-28,213,bisleri,6,15,9,1,00324,India
816333,2023-07-28,202,milk,12,27,15,1,00472,India
713162,2023-07-28,201,paneer,210,340,130,1,00343,India
399181,2023-07-28,209,pepsi,75,100,25,1,00227,India
399181,2023-07-28,204,strawberry yogurt,50,60,10,1,00227,India
399181,2023-07-28,206,yakult,360,400,40,1,00227,India
902825,2023-07-28,212,amul cheese,250,315,65,1,00278,India
902825,2023-07-28,203,mango yogurt,50,60,10,1,00278,India
902825,2023-07-28,211,red bull,90,125,35,1,00278,India
276471,2023-07-28,210,mountain dew,75,100,25,1,00473,India
276471,2023-07-28,207,coca cola,75,100,25,1,00473,India
276471,2023-07-28,212,amul cheese,250,315,65,1,00473,India
276471,2023-07-28,209,pepsi,75,100,25,1,00473,India
754498,2023-07-28,204,strawberry yogurt,50,60,10,1,00031,India
754498,2023-07-28,207,coca cola,75,100,25,1,00031,India
754498,2023-07-28,211,red bull,90,125,35,1,00031,India
754498,2023-07-28,210,mountain dew,75,100,25,1,00031,India
754498,2023-07-28,206,yakult,360,400,40,1,00031,India
959049,2023-07-28,208,sprite,75,100,25,1,00437,India
959049,2023-07-28,212,amul cheese,250,315,65,1,00437,India
959049,2023-07-28,211,red bull,90,125,35,1,00437,India
715355,2023-07-28,204,strawberry yogurt,50,60,10,1,00422,India
715355,2023-07-28,208,sprite,75,100,25,1,00422,India
715355,2023-07-28,206,yakult,360,400,40,1,00422,India
715355,2023-07-28,205,classic yogurt,45,60,15,1,00422,India
994919,2023-07-28,205,classic yogurt,45,60,15,1,00003,India
846858,2023-07-28,212,amul cheese,250,315,65,1,00433,India
846858,2023-07-28,208,sprite,75,100,25,1,00433,India
846858,2023-07-28,201,paneer,210,340,130,1,00433,India
846858,2023-07-28,209,pepsi,75,100,25,1,00433,India
229693,2023-07-28,208,sprite,75,100,25,1,00301,India
680020,2023-07-28,202,milk,12,27,15,1,00331,India
680020,2023-07-28,201,paneer,210,340,130,1,00331,India
769110,2023-07-28,201,paneer,210,340,130,1,00192,India
769110,2023-07-28,213,bisleri,6,15,9,1,00192,India
769110,2023-07-28,207,coca cola,75,100,25,1,00192,India
179662,2023-07-28,208,sprite,75,100,25,1,00360,India
179662,2023-07-28,204,strawberry yogurt,50,60,10,1,00360,India
179662,2023-07-28,205,classic yogurt,45,60,15,1,00360,India
753170,2023-07-28,213,bisleri,6,15,9,1,00386,India
753170,2023-07-28,211,red bull,90,125,35,1,00386,India
155041,2023-07-28,213,bisleri,6,15,9,1,00432,India
155041,2023-07-28,206,yakult,360,400,40,1,00432,India
155041,2023-07-28,207,coca cola,75,100,25,1,00432,India
155041,2023-07-28,204,strawberry yogurt,50,60,10,1,00432,India
918965,2023-07-28,204,strawberry yogurt,50,60,10,1,00253,India
918965,2023-07-28,205,classic yogurt,45,60,15,1,00253,India
432185,2023-07-28,208,sprite,75,100,25,1,00029,India
432185,2023-07-28,202,milk,12,27,15,1,00029,India
158924,2023-07-28,211,red bull,90,125,35,1,00193,India
158924,2023-07-28,202,milk,12,27,15,1,00193,India
158924,2023-07-28,206,yakult,360,400,40,1,00193,India
158924,2023-07-28,210,mountain dew,75,100,25,1,00193,India
524821,2023-07-28,208,sprite,75,100,25,1,00499,India
524821,2023-07-28,206,yakult,360,400,40,1,00499,India
524821,2023-07-28,209,pepsi,75,100,25,1,00499,India
243470,2023-07-28,204,strawberry yogurt,50,60,10,1,00277,India
243470,2023-07-28,211,red bull,90,125,35,1,00277,India
243470,2023-07-28,210,mountain dew,75,100,25,1,00277,India
243470,2023-07-28,205,classic yogurt,45,60,15,1,00277,India
200533,2023-07-28,202,milk,12,27,15,1,00375,India
200533,2023-07-28,208,sprite,75,100,25,1,00375,India
811696,2023-07-28,210,mountain dew,75,100,25,1,00466,India
149113,2023-07-28,206,yakult,360,400,40,1,00264,India
776173,2023-07-28,209,pepsi,75,100,25,1,00021,India
617309,2023-07-28,211,red bull,90,125,35,1,00058,India
617309,2023-07-28,205,classic yogurt,45,60,15,1,00058,India
617309,2023-07-28,210,mountain dew,75,100,25,1,00058,India
617309,2023-07-28,212,amul cheese,250,315,65,1,00058,India
231067,2023-07-28,201,paneer,210,340,130,1,00229,India
231067,2023-07-28,213,bisleri,6,15,9,1,00229,India
231067,2023-07-28,209,pepsi,75,100,25,1,00229,India
231067,2023-07-28,202,milk,12,27,15,1,00229,India
157149,2023-07-28,201,paneer,210,340,130,1,00483,India
157149,2023-07-28,207,coca cola,75,100,25,1,00483,India
157149,2023-07-28,204,strawberry yogurt,50,60,10,1,00483,India
548916,2023-07-28,213,bisleri,6,15,9,1,00323,India
548916,2023-07-28,204,strawberry yogurt,50,60,10,1,00323,India
769174,2023-07-28,202,milk,12,27,15,1,00307,India
769174,2023-07-28,211,red bull,90,125,35,1,00307,India
215108,2023-07-28,212,amul cheese,250,315,65,1,00290,India
215108,2023-07-28,209,pepsi,75,100,25,1,00290,India
245163,2023-07-28,213,bisleri,6,15,9,1,00170,India
245163,2023-07-28,202,milk,12,27,15,1,00170,India
209316,2023-07-28,202,milk,12,27,15,1,00498,India
741660,2023-07-28,209,pepsi,75,100,25,1,00262,India
741660,2023-07-28,205,classic yogurt,45,60,15,1,00262,India
741660,2023-07-28,207,coca cola,75,100,25,1,00262,India
472390,2023-07-28,211,red bull,90,125,35,1,00491,India
472390,2023-07-28,201,paneer,210,340,130,1,00491,India
472390,2023-07-28,202,milk,12,27,15,1,00491,India
472390,2023-07-28,209,pepsi,75,100,25,1,00491,India
595410,2023-07-28,209,pepsi,75,100,25,1,00260,India
595410,2023-07-28,201,paneer,210,340,130,1,00260,India
595410,2023-07-28,202,milk,12,27,15,1,00260,India
965745,2023-07-28,206,yakult,360,400,40,1,00182,India
965745,2023-07-28,212,amul cheese,250,315,65,1,00182,India
965745,2023-07-28,211,red bull,90,125,35,1,00182,India
965745,2023-07-28,209,pepsi,75,100,25,1,00182,India
985114,2023-07-28,211,red bull,90,125,35,1,00220,India
632915,2023-07-28,203,mango yogurt,50,60,10,1,00023,India
632915,2023-07-28,202,milk,12,27,15,1,00023,India
632915,2023-07-28,205,classic yogurt,45,60,15,1,00023,India
260331,2023-07-28,209,pepsi,75,100,25,1,00411,India
260331,2023-07-28,206,yakult,360,400,40,1,00411,India
129064,2023-07-28,208,sprite,75,100,25,1,00387,India
129064,2023-07-28,203,mango yogurt,50,60,10,1,00387,India
682053,2023-07-28,207,coca cola,75,100,25,1,00067,India
746242,2023-07-28,201,paneer,210,340,130,1,00355,India
746242,2023-07-28,211,red bull,90,125,35,1,00355,India
746242,2023-07-28,203,mango yogurt,50,60,10,1,00355,India
746242,2023-07-28,204,strawberry yogurt,50,60,10,1,00355,India
746242,2023-07-28,202,milk,12,27,15,1,00355,India
539593,2023-07-28,201,paneer,210,340,130,1,00210,India
539593,2023-07-28,207,coca cola,75,100,25,1,00210,India
372879,2023-07-28,208,sprite,75,100,25,1,00221,India
372879,2023-07-28,213,bisleri,6,15,9,1,00221,India
372879,2023-07-28,206,yakult,360,400,40,1,00221,India
372879,2023-07-28,201,paneer,210,340,130,1,00221,India
372879,2023-07-28,210,mountain dew,75,100,25,1,00221,India
465071,2023-07-28,210,mountain dew,75,100,25,1,00178,India
465071,2023-07-28,202,milk,12,27,15,1,00178,India
817917,2023-07-28,203,mango yogurt,50,60,10,1,00066,India
817917,2023-07-28,209,pepsi,75,100,25,1,00066,India
817917,2023-07-28,211,red bull,90,125,35,1,00066,India
817917,2023-07-28,213,bisleri,6,15,9,1,00066,India
817917,2023-07-28,206,yakult,360,400,40,1,00066,India
263526,2023-07-28,212,amul cheese,250,315,65,1,00436,India
263526,2023-07-28,201,paneer,210,340,130,1,00436,India
263526,2023-07-28,211,red bull,90,125,35,1,00436,India
263526,2023-07-28,206,yakult,360,400,40,1,00436,India
343163,2023-07-28,207,coca cola,75,100,25,1,00260,India
343163,2023-07-28,211,red bull,90,125,35,1,00260,India
343163,2023-07-28,208,sprite,75,100,25,1,00260,India
343163,2023-07-28,205,classic yogurt,45,60,15,1,00260,India
746831,2023-07-28,201,paneer,210,340,130,1,00161,India
746831,2023-07-28,208,sprite,75,100,25,1,00161,India
746831,2023-07-28,205,classic yogurt,45,60,15,1,00161,India
680975,2023-07-28,205,classic yogurt,45,60,15,1,00302,India
680975,2023-07-28,207,coca cola,75,100,25,1,00302,India
605834,2023-07-28,206,yakult,360,400,40,1,00056,India
605834,2023-07-28,208,sprite,75,100,25,1,00056,India
605834,2023-07-28,212,amul cheese,250,315,65,1,00056,India
605834,2023-07-28,211,red bull,90,125,35,1,00056,India
468487,2023-07-28,204,strawberry yogurt,50,60,10,1,00183,India
468487,2023-07-28,206,yakult,360,400,40,1,00183,India
468487,2023-07-28,207,coca cola,75,100,25,1,00183,India
468487,2023-07-28,212,amul cheese,250,315,65,1,00183,India
418942,2023-07-28,204,strawberry yogurt,50,60,10,1,00023,India
418942,2023-07-28,208,sprite,75,100,25,1,00023,India
418942,2023-07-28,206,yakult,360,400,40,1,00023,India
497172,2023-07-28,206,yakult,360,400,40,1,00198,India
497172,2023-07-28,203,mango yogurt,50,60,10,1,00198,India
732836,2023-07-28,205,classic yogurt,45,60,15,1,00013,India
732836,2023-07-28,203,mango yogurt,50,60,10,1,00013,India
290555,2023-07-28,202,milk,12,27,15,1,00364,India
548801,2023-07-28,201,paneer,210,340,130,1,00256,India
548801,2023-07-28,213,bisleri,6,15,9,1,00256,India
548801,2023-07-28,202,milk,12,27,15,1,00256,India
604833,2023-07-29,206,yakult,360,400,40,1,00085,India
604833,2023-07-29,212,amul cheese,250,315,65,1,00085,India
604833,2023-07-29,211,red bull,90,125,35,1,00085,India
604833,2023-07-29,205,classic yogurt,45,60,15,1,00085,India
895151,2023-07-29,204,strawberry yogurt,50,60,10,1,00312,India
895151,2023-07-29,211,red bull,90,125,35,1,00312,India
283022,2023-07-29,212,amul cheese,250,315,65,1,00201,India
283022,2023-07-29,209,pepsi,75,100,25,1,00201,India
283022,2023-07-29,207,coca cola,75,100,25,1,00201,India
283022,2023-07-29,204,strawberry yogurt,50,60,10,1,00201,India
283022,2023-07-29,202,milk,12,27,15,1,00201,India
170326,2023-07-29,209,pepsi,75,100,25,1,00120,India
170326,2023-07-29,204,strawberry yogurt,50,60,10,1,00120,India
574843,2023-07-29,210,mountain dew,75,100,25,1,00311,India
357915,2023-07-29,210,mountain dew,75,100,25,1,00125,India
567344,2023-07-29,208,sprite,75,100,25,1,00120,India
567344,2023-07-29,207,coca cola,75,100,25,1,00120,India
567344,2023-07-29,213,bisleri,6,15,9,1,00120,India
612561,2023-07-29,202,milk,12,27,15,1,00192,India
612561,2023-07-29,204,strawberry yogurt,50,60,10,1,00192,India
612561,2023-07-29,211,red bull,90,125,35,1,00192,India
971555,2023-07-29,202,milk,12,27,15,1,00476,India
971555,2023-07-29,208,sprite,75,100,25,1,00476,India
971555,2023-07-29,212,amul cheese,250,315,65,1,00476,India
971555,2023-07-29,213,bisleri,6,15,9,1,00476,India
971555,2023-07-29,210,mountain dew,75,100,25,1,00476,India
698887,2023-07-29,201,paneer,210,340,130,1,00196,India
698887,2023-07-29,204,strawberry yogurt,50,60,10,1,00196,India
849253,2023-07-29,202,milk,12,27,15,1,00466,India
849253,2023-07-29,203,mango yogurt,50,60,10,1,00466,India
443357,2023-07-29,209,pepsi,75,100,25,1,00459,India
443357,2023-07-29,202,milk,12,27,15,1,00459,India
443357,2023-07-29,207,coca cola,75,100,25,1,00459,India
443357,2023-07-29,201,paneer,210,340,130,1,00459,India
806243,2023-07-29,213,bisleri,6,15,9,1,00348,India
806243,2023-07-29,205,classic yogurt,45,60,15,1,00348,India
806243,2023-07-29,207,coca cola,75,100,25,1,00348,India
806243,2023-07-29,204,strawberry yogurt,50,60,10,1,00348,India
214264,2023-07-29,201,paneer,210,340,130,1,00176,India
842733,2023-07-29,209,pepsi,75,100,25,1,00016,India
842733,2023-07-29,201,paneer,210,340,130,1,00016,India
104903,2023-07-29,208,sprite,75,100,25,1,00033,India
181012,2023-07-29,209,pepsi,75,100,25,1,00242,India
395259,2023-07-29,208,sprite,75,100,25,1,00337,India
395259,2023-07-29,203,mango yogurt,50,60,10,1,00337,India
395259,2023-07-29,202,milk,12,27,15,1,00337,India
395259,2023-07-29,209,pepsi,75,100,25,1,00337,India
606465,2023-07-29,209,pepsi,75,100,25,1,00471,India
606465,2023-07-29,211,red bull,90,125,35,1,00471,India
469123,2023-07-29,206,yakult,360,400,40,1,00419,India
469123,2023-07-29,202,milk,12,27,15,1,00419,India
290000,2023-07-29,210,mountain dew,75,100,25,1,00318,India
631650,2023-07-29,202,milk,12,27,15,1,00099,India
631650,2023-07-29,201,paneer,210,340,130,1,00099,India
631650,2023-07-29,212,amul cheese,250,315,65,1,00099,India
963327,2023-07-29,205,classic yogurt,45,60,15,1,00127,India
963327,2023-07-29,210,mountain dew,75,100,25,1,00127,India
963327,2023-07-29,207,coca cola,75,100,25,1,00127,India
963327,2023-07-29,208,sprite,75,100,25,1,00127,India
963327,2023-07-29,203,mango yogurt,50,60,10,1,00127,India
663023,2023-07-29,207,coca cola,75,100,25,1,00028,India
663023,2023-07-29,203,mango yogurt,50,60,10,1,00028,India
435708,2023-07-29,206,yakult,360,400,40,1,00045,India
435708,2023-07-29,209,pepsi,75,100,25,1,00045,India
435708,2023-07-29,203,mango yogurt,50,60,10,1,00045,India
306232,2023-07-29,210,mountain dew,75,100,25,1,00390,India
671628,2023-07-29,213,bisleri,6,15,9,1,00089,India
671628,2023-07-29,210,mountain dew,75,100,25,1,00089,India
671628,2023-07-29,207,coca cola,75,100,25,1,00089,India
644539,2023-07-29,202,milk,12,27,15,1,00095,India
644539,2023-07-29,211,red bull,90,125,35,1,00095,India
644539,2023-07-29,212,amul cheese,250,315,65,1,00095,India
644539,2023-07-29,210,mountain dew,75,100,25,1,00095,India
644539,2023-07-29,207,coca cola,75,100,25,1,00095,India
890299,2023-07-29,209,pepsi,75,100,25,1,00392,India
238923,2023-07-29,209,pepsi,75,100,25,1,00156,India
238923,2023-07-29,205,classic yogurt,45,60,15,1,00156,India
952402,2023-07-29,208,sprite,75,100,25,1,00253,India
952402,2023-07-29,204,strawberry yogurt,50,60,10,1,00253,India
952402,2023-07-29,201,paneer,210,340,130,1,00253,India
952402,2023-07-29,202,milk,12,27,15,1,00253,India
992461,2023-07-29,212,amul cheese,250,315,65,1,00404,India
992461,2023-07-29,211,red bull,90,125,35,1,00404,India
992461,2023-07-29,201,paneer,210,340,130,1,00404,India
249484,2023-07-29,211,red bull,90,125,35,1,00249,India
249484,2023-07-29,207,coca cola,75,100,25,1,00249,India
249484,2023-07-29,212,amul cheese,250,315,65,1,00249,India
249484,2023-07-29,201,paneer,210,340,130,1,00249,India
607020,2023-07-29,202,milk,12,27,15,1,00343,India
607020,2023-07-29,212,amul cheese,250,315,65,1,00343,India
272906,2023-07-29,205,classic yogurt,45,60,15,1,00267,India
272906,2023-07-29,211,red bull,90,125,35,1,00267,India
272906,2023-07-29,208,sprite,75,100,25,1,00267,India
393306,2023-07-29,206,yakult,360,400,40,1,00044,India
393306,2023-07-29,209,pepsi,75,100,25,1,00044,India
931621,2023-07-29,212,amul cheese,250,315,65,1,00370,India
931621,2023-07-29,207,coca cola,75,100,25,1,00370,India
931621,2023-07-29,202,milk,12,27,15,1,00370,India
931621,2023-07-29,208,sprite,75,100,25,1,00370,India
156801,2023-07-29,206,yakult,360,400,40,1,00317,India
156801,2023-07-29,212,amul cheese,250,315,65,1,00317,India
156801,2023-07-29,211,red bull,90,125,35,1,00317,India
156801,2023-07-29,209,pepsi,75,100,25,1,00317,India
467488,2023-07-29,205,classic yogurt,45,60,15,1,00047,India
718217,2023-07-29,206,yakult,360,400,40,1,00168,India
526000,2023-07-29,202,milk,12,27,15,1,00010,India
591948,2023-07-29,213,bisleri,6,15,9,1,00073,India
591948,2023-07-29,203,mango yogurt,50,60,10,1,00073,India
591948,2023-07-29,202,milk,12,27,15,1,00073,India
654586,2023-07-29,207,coca cola,75,100,25,1,00327,India
654586,2023-07-29,206,yakult,360,400,40,1,00327,India
784443,2023-07-29,202,milk,12,27,15,1,00331,India
784443,2023-07-29,204,strawberry yogurt,50,60,10,1,00331,India
784443,2023-07-29,213,bisleri,6,15,9,1,00331,India
784443,2023-07-29,209,pepsi,75,100,25,1,00331,India
422244,2023-07-29,205,classic yogurt,45,60,15,1,00220,India
744534,2023-07-29,203,mango yogurt,50,60,10,1,00138,India
965815,2023-07-29,201,paneer,210,340,130,1,00169,India
965815,2023-07-29,211,red bull,90,125,35,1,00169,India
213462,2023-07-29,211,red bull,90,125,35,1,00381,India
213462,2023-07-29,204,strawberry yogurt,50,60,10,1,00381,India
860875,2023-07-29,201,paneer,210,340,130,1,00010,India
860875,2023-07-29,205,classic yogurt,45,60,15,1,00010,India
860875,2023-07-29,203,mango yogurt,50,60,10,1,00010,India
133924,2023-07-29,204,strawberry yogurt,50,60,10,1,00247,India
133924,2023-07-29,205,classic yogurt,45,60,15,1,00247,India
133924,2023-07-29,212,amul cheese,250,315,65,1,00247,India
133924,2023-07-29,210,mountain dew,75,100,25,1,00247,India
133924,2023-07-29,211,red bull,90,125,35,1,00247,India
591909,2023-07-29,202,milk,12,27,15,1,00008,India
591909,2023-07-29,206,yakult,360,400,40,1,00008,India
591909,2023-07-29,207,coca cola,75,100,25,1,00008,India
591909,2023-07-29,211,red bull,90,125,35,1,00008,India
214012,2023-07-29,206,yakult,360,400,40,1,00316,India
214012,2023-07-29,208,sprite,75,100,25,1,00316,India
214012,2023-07-29,210,mountain dew,75,100,25,1,00316,India
422017,2023-07-29,207,coca cola,75,100,25,1,00310,India
422017,2023-07-29,203,mango yogurt,50,60,10,1,00310,India
422017,2023-07-29,212,amul cheese,250,315,65,1,00310,India
422017,2023-07-29,205,classic yogurt,45,60,15,1,00310,India
422017,2023-07-29,204,strawberry yogurt,50,60,10,1,00310,India
990320,2023-07-29,207,coca cola,75,100,25,1,00384,India
990320,2023-07-29,213,bisleri,6,15,9,1,00384,India
285454,2023-07-29,205,classic yogurt,45,60,15,1,00090,India
285454,2023-07-29,203,mango yogurt,50,60,10,1,00090,India
285454,2023-07-29,202,milk,12,27,15,1,00090,India
285454,2023-07-29,210,mountain dew,75,100,25,1,00090,India
819162,2023-07-29,210,mountain dew,75,100,25,1,00023,India
819162,2023-07-29,212,amul cheese,250,315,65,1,00023,India
819162,2023-07-29,206,yakult,360,400,40,1,00023,India
100587,2023-07-29,201,paneer,210,340,130,1,00286,India
327179,2023-07-29,203,mango yogurt,50,60,10,1,00386,India
327179,2023-07-29,201,paneer,210,340,130,1,00386,India
327179,2023-07-29,209,pepsi,75,100,25,1,00386,India
224116,2023-07-29,206,yakult,360,400,40,1,00018,India
224116,2023-07-29,205,classic yogurt,45,60,15,1,00018,India
224116,2023-07-29,210,mountain dew,75,100,25,1,00018,India
224116,2023-07-29,209,pepsi,75,100,25,1,00018,India
224116,2023-07-29,208,sprite,75,100,25,1,00018,India
742376,2023-07-29,207,coca cola,75,100,25,1,00371,India
742376,2023-07-29,206,yakult,360,400,40,1,00371,India
519716,2023-07-29,209,pepsi,75,100,25,1,00401,India
519716,2023-07-29,207,coca cola,75,100,25,1,00401,India
519716,2023-07-29,204,strawberry yogurt,50,60,10,1,00401,India
519716,2023-07-29,212,amul cheese,250,315,65,1,00401,India
519716,2023-07-29,201,paneer,210,340,130,1,00401,India
362639,2023-07-29,209,pepsi,75,100,25,1,00046,India
362639,2023-07-29,206,yakult,360,400,40,1,00046,India
675577,2023-07-29,213,bisleri,6,15,9,1,00167,India
675577,2023-07-29,209,pepsi,75,100,25,1,00167,India
675577,2023-07-29,208,sprite,75,100,25,1,00167,India
836826,2023-07-29,205,classic yogurt,45,60,15,1,00117,India
836826,2023-07-29,206,yakult,360,400,40,1,00117,India
836826,2023-07-29,213,bisleri,6,15,9,1,00117,India
284910,2023-07-29,202,milk,12,27,15,1,00201,India
284910,2023-07-29,206,yakult,360,400,40,1,00201,India
284910,2023-07-29,201,paneer,210,340,130,1,00201,India
284910,2023-07-29,212,amul cheese,250,315,65,1,00201,India
870131,2023-07-29,209,pepsi,75,100,25,1,00249,India
870131,2023-07-29,212,amul cheese,250,315,65,1,00249,India
499941,2023-07-29,206,yakult,360,400,40,1,00032,India
499941,2023-07-29,210,mountain dew,75,100,25,1,00032,India
499941,2023-07-29,208,sprite,75,100,25,1,00032,India
251429,2023-07-29,210,mountain dew,75,100,25,1,00195,India
251429,2023-07-29,209,pepsi,75,100,25,1,00195,India
251429,2023-07-29,205,classic yogurt,45,60,15,1,00195,India
786875,2023-07-29,204,strawberry yogurt,50,60,10,1,00462,India
786875,2023-07-29,211,red bull,90,125,35,1,00462,India
741028,2023-07-29,209,pepsi,75,100,25,1,00473,India
879314,2023-07-29,201,paneer,210,340,130,1,00228,India
599318,2023-07-29,205,classic yogurt,45,60,15,1,00419,India
238891,2023-07-29,213,bisleri,6,15,9,1,00262,India
238891,2023-07-29,204,strawberry yogurt,50,60,10,1,00262,India
979818,2023-07-29,208,sprite,75,100,25,1,00045,India
979818,2023-07-29,204,strawberry yogurt,50,60,10,1,00045,India
979818,2023-07-29,203,mango yogurt,50,60,10,1,00045,India
400698,2023-07-29,206,yakult,360,400,40,1,00006,India
443128,2023-07-29,208,sprite,75,100,25,1,00117,India
443128,2023-07-29,206,yakult,360,400,40,1,00117,India
683269,2023-07-29,206,yakult,360,400,40,1,00269,India
683269,2023-07-29,202,milk,12,27,15,1,00269,India
222136,2023-07-29,206,yakult,360,400,40,1,00161,India
675906,2023-07-29,203,mango yogurt,50,60,10,1,00332,India
675906,2023-07-29,213,bisleri,6,15,9,1,00332,India
675906,2023-07-29,208,sprite,75,100,25,1,00332,India
675906,2023-07-29,201,paneer,210,340,130,1,00332,India
618831,2023-07-29,203,mango yogurt,50,60,10,1,00292,India
618831,2023-07-29,207,coca cola,75,100,25,1,00292,India
359617,2023-07-29,211,red bull,90,125,35,1,00255,India
359617,2023-07-29,209,pepsi,75,100,25,1,00255,India
359617,2023-07-29,201,paneer,210,340,130,1,00255,India
359617,2023-07-29,207,coca cola,75,100,25,1,00255,India
398048,2023-07-29,201,paneer,210,340,130,1,00013,India
398048,2023-07-29,208,sprite,75,100,25,1,00013,India
884493,2023-07-29,202,milk,12,27,15,1,00233,India
884493,2023-07-29,210,mountain dew,75,100,25,1,00233,India
884493,2023-07-29,208,sprite,75,100,25,1,00233,India
559924,2023-07-29,210,mountain dew,75,100,25,1,00486,India
723305,2023-07-29,201,paneer,210,340,130,1,00260,India
723305,2023-07-29,212,amul cheese,250,315,65,1,00260,India
723305,2023-07-29,202,milk,12,27,15,1,00260,India
723305,2023-07-29,211,red bull,90,125,35,1,00260,India
238956,2023-07-29,209,pepsi,75,100,25,1,00474,India
238956,2023-07-29,205,classic yogurt,45,60,15,1,00474,India
238956,2023-07-29,203,mango yogurt,50,60,10,1,00474,India
821742,2023-07-29,202,milk,12,27,15,1,00479,India
821742,2023-07-29,213,bisleri,6,15,9,1,00479,India
522833,2023-07-29,210,mountain dew,75,100,25,1,00052,India
522833,2023-07-29,203,mango yogurt,50,60,10,1,00052,India
583984,2023-07-29,204,strawberry yogurt,50,60,10,1,00269,India
583984,2023-07-29,208,sprite,75,100,25,1,00269,India
317390,2023-07-29,207,coca cola,75,100,25,1,00050,India
317390,2023-07-29,205,classic yogurt,45,60,15,1,00050,India
645289,2023-07-29,210,mountain dew,75,100,25,1,00392,India
645289,2023-07-29,203,mango yogurt,50,60,10,1,00392,India
645289,2023-07-29,205,classic yogurt,45,60,15,1,00392,India
225675,2023-07-29,204,strawberry yogurt,50,60,10,1,00456,India
225675,2023-07-29,208,sprite,75,100,25,1,00456,India
225675,2023-07-29,210,mountain dew,75,100,25,1,00456,India
225675,2023-07-29,209,pepsi,75,100,25,1,00456,India
290565,2023-07-29,212,amul cheese,250,315,65,1,00448,India
290565,2023-07-29,213,bisleri,6,15,9,1,00448,India
767709,2023-07-29,208,sprite,75,100,25,1,00216,India
767709,2023-07-29,205,classic yogurt,45,60,15,1,00216,India
767709,2023-07-29,212,amul cheese,250,315,65,1,00216,India
257463,2023-07-29,209,pepsi,75,100,25,1,00452,India
557015,2023-07-29,210,mountain dew,75,100,25,1,00500,India
557015,2023-07-29,201,paneer,210,340,130,1,00500,India
462493,2023-07-29,213,bisleri,6,15,9,1,00193,India
462493,2023-07-29,207,coca cola,75,100,25,1,00193,India
462493,2023-07-29,202,milk,12,27,15,1,00193,India
462493,2023-07-29,212,amul cheese,250,315,65,1,00193,India
528604,2023-07-29,207,coca cola,75,100,25,1,00069,India
528604,2023-07-29,212,amul cheese,250,315,65,1,00069,India
707581,2023-07-30,207,coca cola,75,100,25,1,00221,India
913723,2023-07-30,212,amul cheese,250,315,65,1,00242,India
913723,2023-07-30,213,bisleri,6,15,9,1,00242,India
913723,2023-07-30,204,strawberry yogurt,50,60,10,1,00242,India
913723,2023-07-30,208,sprite,75,100,25,1,00242,India
479523,2023-07-30,211,red bull,90,125,35,1,00400,India
479523,2023-07-30,204,strawberry yogurt,50,60,10,1,00400,India
479523,2023-07-30,201,paneer,210,340,130,1,00400,India
479523,2023-07-30,212,amul cheese,250,315,65,1,00400,India
479523,2023-07-30,203,mango yogurt,50,60,10,1,00400,India
567467,2023-07-30,208,sprite,75,100,25,1,00222,India
567467,2023-07-30,211,red bull,90,125,35,1,00222,India
567467,2023-07-30,207,coca cola,75,100,25,1,00222,India
567467,2023-07-30,210,mountain dew,75,100,25,1,00222,India
626749,2023-07-30,209,pepsi,75,100,25,1,00324,India
626749,2023-07-30,213,bisleri,6,15,9,1,00324,India
626749,2023-07-30,203,mango yogurt,50,60,10,1,00324,India
686514,2023-07-30,212,amul cheese,250,315,65,1,00458,India
686514,2023-07-30,202,milk,12,27,15,1,00458,India
686514,2023-07-30,213,bisleri,6,15,9,1,00458,India
686514,2023-07-30,206,yakult,360,400,40,1,00458,India
162030,2023-07-30,208,sprite,75,100,25,1,00395,India
162030,2023-07-30,206,yakult,360,400,40,1,00395,India
162030,2023-07-30,210,mountain dew,75,100,25,1,00395,India
162030,2023-07-30,211,red bull,90,125,35,1,00395,India
564035,2023-07-30,206,yakult,360,400,40,1,00056,India
564035,2023-07-30,205,classic yogurt,45,60,15,1,00056,India
564035,2023-07-30,202,milk,12,27,15,1,00056,India
407798,2023-07-30,204,strawberry yogurt,50,60,10,1,00203,India
407798,2023-07-30,205,classic yogurt,45,60,15,1,00203,India
407798,2023-07-30,202,milk,12,27,15,1,00203,India
158965,2023-07-30,205,classic yogurt,45,60,15,1,00129,India
235759,2023-07-30,201,paneer,210,340,130,1,00450,India
235759,2023-07-30,204,strawberry yogurt,50,60,10,1,00450,India
322990,2023-07-30,213,bisleri,6,15,9,1,00156,India
322990,2023-07-30,211,red bull,90,125,35,1,00156,India
322990,2023-07-30,208,sprite,75,100,25,1,00156,India
259253,2023-07-30,205,classic yogurt,45,60,15,1,00088,India
259253,2023-07-30,212,amul cheese,250,315,65,1,00088,India
259253,2023-07-30,202,milk,12,27,15,1,00088,India
614337,2023-07-30,206,yakult,360,400,40,1,00223,India
614337,2023-07-30,208,sprite,75,100,25,1,00223,India
614337,2023-07-30,203,mango yogurt,50,60,10,1,00223,India
614337,2023-07-30,212,amul cheese,250,315,65,1,00223,India
614337,2023-07-30,201,paneer,210,340,130,1,00223,India
867286,2023-07-30,204,strawberry yogurt,50,60,10,1,00314,India
867286,2023-07-30,210,mountain dew,75,100,25,1,00314,India
867286,2023-07-30,209,pepsi,75,100,25,1,00314,India
178081,2023-07-30,208,sprite,75,100,25,1,00057,India
178081,2023-07-30,206,yakult,360,400,40,1,00057,India
178081,2023-07-30,203,mango yogurt,50,60,10,1,00057,India
388080,2023-07-30,205,classic yogurt,45,60,15,1,00187,India
388080,2023-07-30,207,coca cola,75,100,25,1,00187,India
388080,2023-07-30,208,sprite,75,100,25,1,00187,India
388080,2023-07-30,210,mountain dew,75,100,25,1,00187,India
388080,2023-07-30,212,amul cheese,250,315,65,1,00187,India
248016,2023-07-30,203,mango yogurt,50,60,10,1,00121,India
248016,2023-07-30,207,coca cola,75,100,25,1,00121,India
248016,2023-07-30,213,bisleri,6,15,9,1,00121,India
816328,2023-07-30,208,sprite,75,100,25,1,00183,India
343926,2023-07-30,208,sprite,75,100,25,1,00151,India
343926,2023-07-30,211,red bull,90,125,35,1,00151,India
343926,2023-07-30,206,yakult,360,400,40,1,00151,India
343926,2023-07-30,213,bisleri,6,15,9,1,00151,India
343926,2023-07-30,203,mango yogurt,50,60,10,1,00151,India
962154,2023-07-30,209,pepsi,75,100,25,1,00001,India
926663,2023-07-30,206,yakult,360,400,40,1,00359,India
566633,2023-07-30,211,red bull,90,125,35,1,00481,India
292481,2023-07-30,210,mountain dew,75,100,25,1,00453,India
292481,2023-07-30,213,bisleri,6,15,9,1,00453,India
292481,2023-07-30,205,classic yogurt,45,60,15,1,00453,India
993458,2023-07-30,213,bisleri,6,15,9,1,00394,India
993458,2023-07-30,205,classic yogurt,45,60,15,1,00394,India
993458,2023-07-30,203,mango yogurt,50,60,10,1,00394,India
271321,2023-07-30,210,mountain dew,75,100,25,1,00169,India
271321,2023-07-30,206,yakult,360,400,40,1,00169,India
271321,2023-07-30,202,milk,12,27,15,1,00169,India
271321,2023-07-30,204,strawberry yogurt,50,60,10,1,00169,India
256731,2023-07-30,207,coca cola,75,100,25,1,00125,India
256731,2023-07-30,210,mountain dew,75,100,25,1,00125,India
256731,2023-07-30,203,mango yogurt,50,60,10,1,00125,India
112120,2023-07-30,209,pepsi,75,100,25,1,00087,India
112120,2023-07-30,202,milk,12,27,15,1,00087,India
112120,2023-07-30,213,bisleri,6,15,9,1,00087,India
112120,2023-07-30,210,mountain dew,75,100,25,1,00087,India
112120,2023-07-30,204,strawberry yogurt,50,60,10,1,00087,India
606544,2023-07-30,204,strawberry yogurt,50,60,10,1,00129,India
606544,2023-07-30,207,coca cola,75,100,25,1,00129,India
606544,2023-07-30,203,mango yogurt,50,60,10,1,00129,India
884198,2023-07-30,211,red bull,90,125,35,1,00314,India
884198,2023-07-30,207,coca cola,75,100,25,1,00314,India
225919,2023-07-30,210,mountain dew,75,100,25,1,00200,India
225919,2023-07-30,203,mango yogurt,50,60,10,1,00200,India
225919,2023-07-30,202,milk,12,27,15,1,00200,India
225919,2023-07-30,209,pepsi,75,100,25,1,00200,India
225919,2023-07-30,204,strawberry yogurt,50,60,10,1,00200,India
966585,2023-07-30,203,mango yogurt,50,60,10,1,00440,India
966585,2023-07-30,207,coca cola,75,100,25,1,00440,India
966585,2023-07-30,201,paneer,210,340,130,1,00440,India
966585,2023-07-30,209,pepsi,75,100,25,1,00440,India
546129,2023-07-30,208,sprite,75,100,25,1,00107,India
235429,2023-07-30,201,paneer,210,340,130,1,00050,India
235429,2023-07-30,210,mountain dew,75,100,25,1,00050,India
235429,2023-07-30,209,pepsi,75,100,25,1,00050,India
235429,2023-07-30,202,milk,12,27,15,1,00050,India
952692,2023-07-30,213,bisleri,6,15,9,1,00356,India
952692,2023-07-30,208,sprite,75,100,25,1,00356,India
224438,2023-07-30,202,milk,12,27,15,1,00147,India
224438,2023-07-30,207,coca cola,75,100,25,1,00147,India
224438,2023-07-30,205,classic yogurt,45,60,15,1,00147,India
224438,2023-07-30,209,pepsi,75,100,25,1,00147,India
107372,2023-07-30,213,bisleri,6,15,9,1,00058,India
107372,2023-07-30,212,amul cheese,250,315,65,1,00058,India
591604,2023-07-30,213,bisleri,6,15,9,1,00183,India
591604,2023-07-30,208,sprite,75,100,25,1,00183,India
460314,2023-07-30,213,bisleri,6,15,9,1,00128,India
460314,2023-07-30,207,coca cola,75,100,25,1,00128,India
460314,2023-07-30,203,mango yogurt,50,60,10,1,00128,India
972680,2023-07-30,207,coca cola,75,100,25,1,00370,India
972680,2023-07-30,213,bisleri,6,15,9,1,00370,India
972680,2023-07-30,210,mountain dew,75,100,25,1,00370,India
100403,2023-07-30,202,milk,12,27,15,1,00102,India
100403,2023-07-30,208,sprite,75,100,25,1,00102,India
100403,2023-07-30,206,yakult,360,400,40,1,00102,India
502752,2023-07-30,207,coca cola,75,100,25,1,00203,India
472797,2023-07-30,210,mountain dew,75,100,25,1,00234,India
615753,2023-07-30,209,pepsi,75,100,25,1,00147,India
809629,2023-07-30,208,sprite,75,100,25,1,00403,India
809629,2023-07-30,209,pepsi,75,100,25,1,00403,India
383967,2023-07-30,202,milk,12,27,15,1,00058,India
383967,2023-07-30,212,amul cheese,250,315,65,1,00058,India
826742,2023-07-30,209,pepsi,75,100,25,1,00442,India
826742,2023-07-30,207,coca cola,75,100,25,1,00442,India
826742,2023-07-30,213,bisleri,6,15,9,1,00442,India
493641,2023-07-30,203,mango yogurt,50,60,10,1,00217,India
493641,2023-07-30,202,milk,12,27,15,1,00217,India
694385,2023-07-30,208,sprite,75,100,25,1,00031,India
316631,2023-07-30,210,mountain dew,75,100,25,1,00107,India
657273,2023-07-30,209,pepsi,75,100,25,1,00372,India
885356,2023-07-30,202,milk,12,27,15,1,00224,India
602639,2023-07-30,210,mountain dew,75,100,25,1,00343,India
602639,2023-07-30,205,classic yogurt,45,60,15,1,00343,India
602639,2023-07-30,207,coca cola,75,100,25,1,00343,India
602639,2023-07-30,202,milk,12,27,15,1,00343,India
277565,2023-07-30,213,bisleri,6,15,9,1,00455,India
277565,2023-07-30,211,red bull,90,125,35,1,00455,India
277565,2023-07-30,209,pepsi,75,100,25,1,00455,India
983580,2023-07-30,203,mango yogurt,50,60,10,1,00254,India
983580,2023-07-30,211,red bull,90,125,35,1,00254,India
983580,2023-07-30,207,coca cola,75,100,25,1,00254,India
288778,2023-07-30,202,milk,12,27,15,1,00480,India
288778,2023-07-30,205,classic yogurt,45,60,15,1,00480,India
288778,2023-07-30,211,red bull,90,125,35,1,00480,India
288778,2023-07-30,208,sprite,75,100,25,1,00480,India
288778,2023-07-30,207,coca cola,75,100,25,1,00480,India
242174,2023-07-30,212,amul cheese,250,315,65,1,00298,India
242174,2023-07-30,210,mountain dew,75,100,25,1,00298,India
651612,2023-07-30,211,red bull,90,125,35,1,00500,India
651612,2023-07-30,204,strawberry yogurt,50,60,10,1,00500,India
651612,2023-07-30,203,mango yogurt,50,60,10,1,00500,India
651612,2023-07-30,202,milk,12,27,15,1,00500,India
685748,2023-07-30,204,strawberry yogurt,50,60,10,1,00181,India
685748,2023-07-30,203,mango yogurt,50,60,10,1,00181,India
685748,2023-07-30,211,red bull,90,125,35,1,00181,India
685748,2023-07-30,209,pepsi,75,100,25,1,00181,India
370721,2023-07-30,210,mountain dew,75,100,25,1,00183,India
370721,2023-07-30,209,pepsi,75,100,25,1,00183,India
370721,2023-07-30,207,coca cola,75,100,25,1,00183,India
321521,2023-07-30,208,sprite,75,100,25,1,00061,India
321521,2023-07-30,207,coca cola,75,100,25,1,00061,India
321521,2023-07-30,201,paneer,210,340,130,1,00061,India
321521,2023-07-30,210,mountain dew,75,100,25,1,00061,India
658291,2023-07-30,208,sprite,75,100,25,1,00142,India
658291,2023-07-30,204,strawberry yogurt,50,60,10,1,00142,India
658291,2023-07-30,206,yakult,360,400,40,1,00142,India
622038,2023-07-30,203,mango yogurt,50,60,10,1,00239,India
622038,2023-07-30,209,pepsi,75,100,25,1,00239,India
622038,2023-07-30,206,yakult,360,400,40,1,00239,India
622038,2023-07-30,213,bisleri,6,15,9,1,00239,India
547369,2023-07-30,209,pepsi,75,100,25,1,00237,India
547369,2023-07-30,208,sprite,75,100,25,1,00237,India
547369,2023-07-30,203,mango yogurt,50,60,10,1,00237,India
315159,2023-07-30,212,amul cheese,250,315,65,1,00263,India
345671,2023-07-30,211,red bull,90,125,35,1,00424,India
345671,2023-07-30,203,mango yogurt,50,60,10,1,00424,India
345671,2023-07-30,201,paneer,210,340,130,1,00424,India
968757,2023-07-30,202,milk,12,27,15,1,00019,India
968757,2023-07-30,203,mango yogurt,50,60,10,1,00019,India
968757,2023-07-30,213,bisleri,6,15,9,1,00019,India
968757,2023-07-30,207,coca cola,75,100,25,1,00019,India
968757,2023-07-30,206,yakult,360,400,40,1,00019,India
555056,2023-07-30,206,yakult,360,400,40,1,00366,India
215864,2023-07-30,209,pepsi,75,100,25,1,00116,India
215864,2023-07-30,204,strawberry yogurt,50,60,10,1,00116,India
215864,2023-07-30,205,classic yogurt,45,60,15,1,00116,India
215864,2023-07-30,207,coca cola,75,100,25,1,00116,India
215864,2023-07-30,203,mango yogurt,50,60,10,1,00116,India
895321,2023-07-30,203,mango yogurt,50,60,10,1,00363,India
895321,2023-07-30,208,sprite,75,100,25,1,00363,India
862337,2023-07-30,202,milk,12,27,15,1,00440,India
862337,2023-07-30,210,mountain dew,75,100,25,1,00440,India
862337,2023-07-30,208,sprite,75,100,25,1,00440,India
588946,2023-07-30,204,strawberry yogurt,50,60,10,1,00137,India
519877,2023-07-30,212,amul cheese,250,315,65,1,00415,India
519877,2023-07-30,206,yakult,360,400,40,1,00415,India
868525,2023-07-30,210,mountain dew,75,100,25,1,00093,India
868525,2023-07-30,206,yakult,360,400,40,1,00093,India
266696,2023-07-30,211,red bull,90,125,35,1,00071,India
266696,2023-07-30,212,amul cheese,250,315,65,1,00071,India
266696,2023-07-30,205,classic yogurt,45,60,15,1,00071,India
266696,2023-07-30,213,bisleri,6,15,9,1,00071,India
122414,2023-07-30,213,bisleri,6,15,9,1,00331,India
122414,2023-07-30,210,mountain dew,75,100,25,1,00331,India
122414,2023-07-30,209,pepsi,75,100,25,1,00331,India
970192,2023-07-30,201,paneer,210,340,130,1,00424,India
970192,2023-07-30,205,classic yogurt,45,60,15,1,00424,India
970192,2023-07-30,212,amul cheese,250,315,65,1,00424,India
578621,2023-07-30,208,sprite,75,100,25,1,00417,India
578621,2023-07-30,210,mountain dew,75,100,25,1,00417,India
578621,2023-07-30,204,strawberry yogurt,50,60,10,1,00417,India
578621,2023-07-30,202,milk,12,27,15,1,00417,India
487515,2023-07-30,207,coca cola,75,100,25,1,00083,India
487515,2023-07-30,210,mountain dew,75,100,25,1,00083,India
487515,2023-07-30,201,paneer,210,340,130,1,00083,India
945468,2023-07-30,204,strawberry yogurt,50,60,10,1,00429,India
945468,2023-07-30,206,yakult,360,400,40,1,00429,India
818305,2023-07-30,212,amul cheese,250,315,65,1,00310,India
818305,2023-07-30,208,sprite,75,100,25,1,00310,India
945611,2023-07-30,201,paneer,210,340,130,1,00072,India
945611,2023-07-30,206,yakult,360,400,40,1,00072,India
945611,2023-07-30,213,bisleri,6,15,9,1,00072,India
945611,2023-07-30,210,mountain dew,75,100,25,1,00072,India
896730,2023-07-30,210,mountain dew,75,100,25,1,00034,India
161389,2023-07-30,206,yakult,360,400,40,1,00457,India
161389,2023-07-30,205,classic yogurt,45,60,15,1,00457,India
161389,2023-07-30,212,amul cheese,250,315,65,1,00457,India
753998,2023-07-30,207,coca cola,75,100,25,1,00498,India
363662,2023-07-30,207,coca cola,75,100,25,1,00037,India
363662,2023-07-30,201,paneer,210,340,130,1,00037,India
194078,2023-07-30,206,yakult,360,400,40,1,00219,India
208179,2023-07-30,206,yakult,360,400,40,1,00143,India
208179,2023-07-30,202,milk,12,27,15,1,00143,India
104873,2023-07-30,213,bisleri,6,15,9,1,00292,India
104873,2023-07-30,210,mountain dew,75,100,25,1,00292,India
104873,2023-07-30,205,classic yogurt,45,60,15,1,00292,India
709389,2023-07-30,203,mango yogurt,50,60,10,1,00076,India
709389,2023-07-30,213,bisleri,6,15,9,1,00076,India
709389,2023-07-30,208,sprite,75,100,25,1,00076,India
426499,2023-07-30,205,classic yogurt,45,60,15,1,00272,India
426499,2023-07-30,204,strawberry yogurt,50,60,10,1,00272,India
947562,2023-07-31,207,coca cola,75,100,25,1,00217,India
947562,2023-07-31,211,red bull,90,125,35,1,00217,India
947562,2023-07-31,208,sprite,75,100,25,1,00217,India
386995,2023-07-31,209,pepsi,75,100,25,1,00303,India
386995,2023-07-31,204,strawberry yogurt,50,60,10,1,00303,India
673595,2023-07-31,205,classic yogurt,45,60,15,1,00065,India
673595,2023-07-31,201,paneer,210,340,130,1,00065,India
673595,2023-07-31,203,mango yogurt,50,60,10,1,00065,India
332298,2023-07-31,202,milk,12,27,15,1,00422,India
727486,2023-07-31,202,milk,12,27,15,1,00486,India
727486,2023-07-31,205,classic yogurt,45,60,15,1,00486,India
307414,2023-07-31,211,red bull,90,125,35,1,00496,India
307414,2023-07-31,210,mountain dew,75,100,25,1,00496,India
307414,2023-07-31,207,coca cola,75,100,25,1,00496,India
307414,2023-07-31,205,classic yogurt,45,60,15,1,00496,India
819093,2023-07-31,210,mountain dew,75,100,25,1,00422,India
819093,2023-07-31,201,paneer,210,340,130,1,00422,India
819093,2023-07-31,202,milk,12,27,15,1,00422,India
819093,2023-07-31,208,sprite,75,100,25,1,00422,India
160208,2023-07-31,206,yakult,360,400,40,1,00130,India
160208,2023-07-31,212,amul cheese,250,315,65,1,00130,India
160208,2023-07-31,210,mountain dew,75,100,25,1,00130,India
160208,2023-07-31,208,sprite,75,100,25,1,00130,India
160208,2023-07-31,202,milk,12,27,15,1,00130,India
959641,2023-07-31,203,mango yogurt,50,60,10,1,00453,India
661443,2023-07-31,207,coca cola,75,100,25,1,00367,India
297062,2023-07-31,212,amul cheese,250,315,65,1,00382,India
297062,2023-07-31,202,milk,12,27,15,1,00382,India
297062,2023-07-31,204,strawberry yogurt,50,60,10,1,00382,India
242208,2023-07-31,205,classic yogurt,45,60,15,1,00429,India
242208,2023-07-31,204,strawberry yogurt,50,60,10,1,00429,India
242208,2023-07-31,203,mango yogurt,50,60,10,1,00429,India
242208,2023-07-31,209,pepsi,75,100,25,1,00429,India
242208,2023-07-31,206,yakult,360,400,40,1,00429,India
318283,2023-07-31,201,paneer,210,340,130,1,00211,India
273555,2023-07-31,204,strawberry yogurt,50,60,10,1,00026,India
273555,2023-07-31,208,sprite,75,100,25,1,00026,India
273555,2023-07-31,201,paneer,210,340,130,1,00026,India
273555,2023-07-31,205,classic yogurt,45,60,15,1,00026,India
992690,2023-07-31,201,paneer,210,340,130,1,00204,India
992690,2023-07-31,206,yakult,360,400,40,1,00204,India
992690,2023-07-31,212,amul cheese,250,315,65,1,00204,India
992690,2023-07-31,202,milk,12,27,15,1,00204,India
198337,2023-07-31,206,yakult,360,400,40,1,00221,India
601308,2023-07-31,211,red bull,90,125,35,1,00083,India
648792,2023-07-31,204,strawberry yogurt,50,60,10,1,00457,India
648792,2023-07-31,211,red bull,90,125,35,1,00457,India
648792,2023-07-31,206,yakult,360,400,40,1,00457,India
761524,2023-07-31,204,strawberry yogurt,50,60,10,1,00147,India
761524,2023-07-31,205,classic yogurt,45,60,15,1,00147,India
761524,2023-07-31,203,mango yogurt,50,60,10,1,00147,India
792445,2023-07-31,201,paneer,210,340,130,1,00449,India
792445,2023-07-31,204,strawberry yogurt,50,60,10,1,00449,India
792445,2023-07-31,209,pepsi,75,100,25,1,00449,India
675310,2023-07-31,208,sprite,75,100,25,1,00389,India
675310,2023-07-31,211,red bull,90,125,35,1,00389,India
841639,2023-07-31,212,amul cheese,250,315,65,1,00226,India
841639,2023-07-31,206,yakult,360,400,40,1,00226,India
841639,2023-07-31,204,strawberry yogurt,50,60,10,1,00226,India
685196,2023-07-31,212,amul cheese,250,315,65,1,00184,India
685196,2023-07-31,208,sprite,75,100,25,1,00184,India
443303,2023-07-31,203,mango yogurt,50,60,10,1,00382,India
443303,2023-07-31,201,paneer,210,340,130,1,00382,India
443303,2023-07-31,207,coca cola,75,100,25,1,00382,India
220651,2023-07-31,211,red bull,90,125,35,1,00200,India
220651,2023-07-31,201,paneer,210,340,130,1,00200,India
220651,2023-07-31,206,yakult,360,400,40,1,00200,India
220651,2023-07-31,213,bisleri,6,15,9,1,00200,India
700127,2023-07-31,213,bisleri,6,15,9,1,00001,India
700127,2023-07-31,202,milk,12,27,15,1,00001,India
367265,2023-07-31,210,mountain dew,75,100,25,1,00427,India
367265,2023-07-31,208,sprite,75,100,25,1,00427,India
286588,2023-07-31,211,red bull,90,125,35,1,00141,India
483135,2023-07-31,202,milk,12,27,15,1,00269,India
483135,2023-07-31,209,pepsi,75,100,25,1,00269,India
483135,2023-07-31,206,yakult,360,400,40,1,00269,India
483135,2023-07-31,205,classic yogurt,45,60,15,1,00269,India
217953,2023-07-31,208,sprite,75,100,25,1,00374,India
896116,2023-07-31,206,yakult,360,400,40,1,00471,India
896116,2023-07-31,212,amul cheese,250,315,65,1,00471,India
896116,2023-07-31,204,strawberry yogurt,50,60,10,1,00471,India
896116,2023-07-31,205,classic yogurt,45,60,15,1,00471,India
570377,2023-07-31,202,milk,12,27,15,1,00110,India
570377,2023-07-31,207,coca cola,75,100,25,1,00110,India
368252,2023-07-31,201,paneer,210,340,130,1,00288,India
541852,2023-07-31,204,strawberry yogurt,50,60,10,1,00284,India
541852,2023-07-31,210,mountain dew,75,100,25,1,00284,India
541852,2023-07-31,213,bisleri,6,15,9,1,00284,India
541852,2023-07-31,212,amul cheese,250,315,65,1,00284,India
232724,2023-07-31,213,bisleri,6,15,9,1,00139,India
232724,2023-07-31,210,mountain dew,75,100,25,1,00139,India
851301,2023-07-31,204,strawberry yogurt,50,60,10,1,00038,India
851301,2023-07-31,211,red bull,90,125,35,1,00038,India
851301,2023-07-31,209,pepsi,75,100,25,1,00038,India
772850,2023-07-31,202,milk,12,27,15,1,00383,India
280778,2023-07-31,204,strawberry yogurt,50,60,10,1,00040,India
280778,2023-07-31,201,paneer,210,340,130,1,00040,India
280778,2023-07-31,209,pepsi,75,100,25,1,00040,India
460713,2023-07-31,209,pepsi,75,100,25,1,00252,India
460713,2023-07-31,201,paneer,210,340,130,1,00252,India
460713,2023-07-31,207,coca cola,75,100,25,1,00252,India
460713,2023-07-31,211,red bull,90,125,35,1,00252,India
329917,2023-07-31,201,paneer,210,340,130,1,00336,India
329917,2023-07-31,207,coca cola,75,100,25,1,00336,India
329917,2023-07-31,211,red bull,90,125,35,1,00336,India
329917,2023-07-31,204,strawberry yogurt,50,60,10,1,00336,India
124842,2023-07-31,213,bisleri,6,15,9,1,00213,India
124842,2023-07-31,203,mango yogurt,50,60,10,1,00213,India
124842,2023-07-31,211,red bull,90,125,35,1,00213,India
580853,2023-07-31,205,classic yogurt,45,60,15,1,00300,India
580853,2023-07-31,203,mango yogurt,50,60,10,1,00300,India
580853,2023-07-31,212,amul cheese,250,315,65,1,00300,India
585711,2023-07-31,205,classic yogurt,45,60,15,1,00158,India
515270,2023-07-31,201,paneer,210,340,130,1,00481,India
515270,2023-07-31,205,classic yogurt,45,60,15,1,00481,India
498037,2023-07-31,211,red bull,90,125,35,1,00121,India
688488,2023-07-31,202,milk,12,27,15,1,00054,India
466800,2023-07-31,211,red bull,90,125,35,1,00295,India
502006,2023-07-31,208,sprite,75,100,25,1,00375,India
502006,2023-07-31,204,strawberry yogurt,50,60,10,1,00375,India
502006,2023-07-31,203,mango yogurt,50,60,10,1,00375,India
502006,2023-07-31,210,mountain dew,75,100,25,1,00375,India
502006,2023-07-31,212,amul cheese,250,315,65,1,00375,India
283750,2023-07-31,209,pepsi,75,100,25,1,00482,India
902785,2023-07-31,210,mountain dew,75,100,25,1,00475,India
902785,2023-07-31,202,milk,12,27,15,1,00475,India
790652,2023-07-31,206,yakult,360,400,40,1,00127,India
432126,2023-07-31,210,mountain dew,75,100,25,1,00386,India
432126,2023-07-31,211,red bull,90,125,35,1,00386,India
432126,2023-07-31,206,yakult,360,400,40,1,00386,India
703455,2023-07-31,205,classic yogurt,45,60,15,1,00255,India
703455,2023-07-31,206,yakult,360,400,40,1,00255,India
703455,2023-07-31,202,milk,12,27,15,1,00255,India
454861,2023-07-31,209,pepsi,75,100,25,1,00246,India
454861,2023-07-31,202,milk,12,27,15,1,00246,India
454861,2023-07-31,213,bisleri,6,15,9,1,00246,India
454861,2023-07-31,207,coca cola,75,100,25,1,00246,India
906547,2023-07-31,212,amul cheese,250,315,65,1,00094,India
906547,2023-07-31,205,classic yogurt,45,60,15,1,00094,India
480509,2023-07-31,204,strawberry yogurt,50,60,10,1,00266,India
886063,2023-07-31,206,yakult,360,400,40,1,00067,India
886063,2023-07-31,204,strawberry yogurt,50,60,10,1,00067,India
886063,2023-07-31,210,mountain dew,75,100,25,1,00067,India
886063,2023-07-31,211,red bull,90,125,35,1,00067,India
822151,2023-07-31,205,classic yogurt,45,60,15,1,00402,India
822151,2023-07-31,206,yakult,360,400,40,1,00402,India
801143,2023-07-31,208,sprite,75,100,25,1,00357,India
801143,2023-07-31,202,milk,12,27,15,1,00357,India
801143,2023-07-31,210,mountain dew,75,100,25,1,00357,India
228468,2023-07-31,204,strawberry yogurt,50,60,10,1,00377,India
228468,2023-07-31,202,milk,12,27,15,1,00377,India
228468,2023-07-31,210,mountain dew,75,100,25,1,00377,India
456793,2023-07-31,203,mango yogurt,50,60,10,1,00040,India
456793,2023-07-31,211,red bull,90,125,35,1,00040,India
456793,2023-07-31,207,coca cola,75,100,25,1,00040,India
456793,2023-07-31,204,strawberry yogurt,50,60,10,1,00040,India
187006,2023-07-31,212,amul cheese,250,315,65,1,00487,India
187006,2023-07-31,213,bisleri,6,15,9,1,00487,India
187006,2023-07-31,209,pepsi,75,100,25,1,00487,India
187006,2023-07-31,208,sprite,75,100,25,1,00487,India
837904,2023-07-31,213,bisleri,6,15,9,1,00211,India
837904,2023-07-31,208,sprite,75,100,25,1,00211,India
837904,2023-07-31,209,pepsi,75,100,25,1,00211,India
451385,2023-07-31,211,red bull,90,125,35,1,00289,India
451385,2023-07-31,208,sprite,75,100,25,1,00289,India
429716,2023-07-31,207,coca cola,75,100,25,1,00237,India
429716,2023-07-31,209,pepsi,75,100,25,1,00237,India
429716,2023-07-31,212,amul cheese,250,315,65,1,00237,India
247639,2023-07-31,203,mango yogurt,50,60,10,1,00018,India
247639,2023-07-31,208,sprite,75,100,25,1,00018,India
632119,2023-07-31,206,yakult,360,400,40,1,00488,India
632119,2023-07-31,211,red bull,90,125,35,1,00488,India
632119,2023-07-31,204,strawberry yogurt,50,60,10,1,00488,India
841459,2023-07-31,201,paneer,210,340,130,1,00472,India
841459,2023-07-31,209,pepsi,75,100,25,1,00472,India
394545,2023-07-31,202,milk,12,27,15,1,00010,India
394545,2023-07-31,207,coca cola,75,100,25,1,00010,India
779770,2023-07-31,201,paneer,210,340,130,1,00430,India
779770,2023-07-31,210,mountain dew,75,100,25,1,00430,India
785891,2023-07-31,213,bisleri,6,15,9,1,00092,India
785891,2023-07-31,209,pepsi,75,100,25,1,00092,India
785891,2023-07-31,206,yakult,360,400,40,1,00092,India
785891,2023-07-31,212,amul cheese,250,315,65,1,00092,India
785891,2023-07-31,207,coca cola,75,100,25,1,00092,India
483778,2023-07-31,201,paneer,210,340,130,1,00059,India
483778,2023-07-31,203,mango yogurt,50,60,10,1,00059,India
483778,2023-07-31,202,milk,12,27,15,1,00059,India
191754,2023-07-31,208,sprite,75,100,25,1,00001,India
191754,2023-07-31,213,bisleri,6,15,9,1,00001,India
448126,2023-07-31,211,red bull,90,125,35,1,00286,India
448126,2023-07-31,213,bisleri,6,15,9,1,00286,India
883202,2023-07-31,212,amul cheese,250,315,65,1,00185,India
569563,2023-07-31,210,mountain dew,75,100,25,1,00369,India
569563,2023-07-31,202,milk,12,27,15,1,00369,India
941500,2023-07-31,206,yakult,360,400,40,1,00105,India
941500,2023-07-31,211,red bull,90,125,35,1,00105,India
941500,2023-07-31,212,amul cheese,250,315,65,1,00105,India
941500,2023-07-31,202,milk,12,27,15,1,00105,India
941500,2023-07-31,213,bisleri,6,15,9,1,00105,India
889363,2023-07-31,206,yakult,360,400,40,1,00305,India
889363,2023-07-31,213,bisleri,6,15,9,1,00305,India
889363,2023-07-31,208,sprite,75,100,25,1,00305,India
889363,2023-07-31,211,red bull,90,125,35,1,00305,India
988179,2023-07-31,206,yakult,360,400,40,1,00027,India
988179,2023-07-31,213,bisleri,6,15,9,1,00027,India
988179,2023-07-31,203,mango yogurt,50,60,10,1,00027,India
446208,2023-07-31,202,milk,12,27,15,1,00109,India
446208,2023-07-31,212,amul cheese,250,315,65,1,00109,India
446208,2023-07-31,213,bisleri,6,15,9,1,00109,India
220309,2023-07-31,202,milk,12,27,15,1,00075,India
220309,2023-07-31,207,coca cola,75,100,25,1,00075,India
846808,2023-07-31,206,yakult,360,400,40,1,00368,India
846808,2023-07-31,208,sprite,75,100,25,1,00368,India
846808,2023-07-31,204,strawberry yogurt,50,60,10,1,00368,India
131004,2023-07-31,203,mango yogurt,50,60,10,1,00308,India
131004,2023-07-31,204,strawberry yogurt,50,60,10,1,00308,India
841705,2023-07-31,207,coca cola,75,100,25,1,00309,India
841705,2023-07-31,209,pepsi,75,100,25,1,00309,India
748107,2023-07-31,205,classic yogurt,45,60,15,1,00493,India
132297,2023-07-31,211,red bull,90,125,35,1,00485,India
132297,2023-07-31,201,paneer,210,340,130,1,00485,India
132297,2023-07-31,202,milk,12,27,15,1,00485,India
569663,2023-07-31,205,classic yogurt,45,60,15,1,00003,India
569663,2023-07-31,212,amul cheese,250,315,65,1,00003,India
569663,2023-07-31,211,red bull,90,125,35,1,00003,India
579830,2023-07-31,203,mango yogurt,50,60,10,1,00475,India
579830,2023-07-31,206,yakult,360,400,40,1,00475,India
579830,2023-07-31,207,coca cola,75,100,25,1,00475,India
579830,2023-07-31,201,paneer,210,340,130,1,00475,India
579830,2023-07-31,213,bisleri,6,15,9,1,00475,India
652613,2023-07-31,207,coca cola,75,100,25,1,00480,India
123696,2023-07-31,205,classic yogurt,45,60,15,1,00056,India
123696,2023-07-31,212,amul cheese,250,315,65,1,00056,India
936813,2023-07-31,213,bisleri,6,15,9,1,00387,India
936813,2023-07-31,201,paneer,210,340,130,1,00387,India
936813,2023-07-31,205,classic yogurt,45,60,15,1,00387,India
936813,2023-07-31,203,mango yogurt,50,60,10,1,00387,India
244544,2023-07-31,203,mango yogurt,50,60,10,1,00234,India
244544,2023-07-31,205,classic yogurt,45,60,15,1,00234,India
244544,2023-07-31,204,strawberry yogurt,50,60,10,1,00234,India
244544,2023-07-31,212,amul cheese,250,315,65,1,00234,India
133863,2023-07-31,202,milk,12,27,15,1,00393,India
133863,2023-07-31,207,coca cola,75,100,25,1,00393,India
133863,2023-07-31,205,classic yogurt,45,60,15,1,00393,India
284546,2023-07-31,206,yakult,360,400,40,1,00269,India
284546,2023-07-31,208,sprite,75,100,25,1,00269,India
697423,2023-07-31,205,classic yogurt,45,60,15,1,00424,India
697423,2023-07-31,207,coca cola,75,100,25,1,00424,India
697423,2023-07-31,210,mountain dew,75,100,25,1,00424,India
697423,2023-07-31,203,mango yogurt,50,60,10,1,00424,India
357646,2023-07-31,201,paneer,210,340,130,1,00129,India
357646,2023-07-31,207,coca cola,75,100,25,1,00129,India
357646,2023-07-31,204,strawberry yogurt,50,60,10,1,00129,India
364776,2023-07-31,211,red bull,90,125,35,1,00263,India
364776,2023-07-31,201,paneer,210,340,130,1,00263,India
364776,2023-07-31,213,bisleri,6,15,9,1,00263,India
105518,2023-07-31,213,bisleri,6,15,9,1,00047,India
471461,2023-07-31,201,paneer,210,340,130,1,00479,India
471461,2023-07-31,208,sprite,75,100,25,1,00479,India
117435,2023-08-01,203,mango yogurt,50,60,10,1,00010,India
117435,2023-08-01,210,mountain dew,75,100,25,1,00010,India
117435,2023-08-01,204,strawberry yogurt,50,60,10,1,00010,India
117435,2023-08-01,212,amul cheese,250,315,65,1,00010,India
875324,2023-08-01,202,milk,12,27,15,1,00275,India
115850,2023-08-01,201,paneer,210,340,130,1,00128,India
162690,2023-08-01,204,strawberry yogurt,50,60,10,1,00470,India
721884,2023-08-01,211,red bull,90,125,35,1,00145,India
990847,2023-08-01,210,mountain dew,75,100,25,1,00039,India
990847,2023-08-01,203,mango yogurt,50,60,10,1,00039,India
990847,2023-08-01,209,pepsi,75,100,25,1,00039,India
990847,2023-08-01,204,strawberry yogurt,50,60,10,1,00039,India
951219,2023-08-01,212,amul cheese,250,315,65,1,00199,India
951219,2023-08-01,205,classic yogurt,45,60,15,1,00199,India
951219,2023-08-01,211,red bull,90,125,35,1,00199,India
536919,2023-08-01,208,sprite,75,100,25,1,00210,India
536919,2023-08-01,212,amul cheese,250,315,65,1,00210,India
536919,2023-08-01,206,yakult,360,400,40,1,00210,India
631048,2023-08-01,208,sprite,75,100,25,1,00320,India
631048,2023-08-01,207,coca cola,75,100,25,1,00320,India
848042,2023-08-01,208,sprite,75,100,25,1,00239,India
848042,2023-08-01,205,classic yogurt,45,60,15,1,00239,India
264243,2023-08-01,203,mango yogurt,50,60,10,1,00194,India
264243,2023-08-01,211,red bull,90,125,35,1,00194,India
264243,2023-08-01,212,amul cheese,250,315,65,1,00194,India
264243,2023-08-01,201,paneer,210,340,130,1,00194,India
264243,2023-08-01,210,mountain dew,75,100,25,1,00194,India
654652,2023-08-01,207,coca cola,75,100,25,1,00391,India
654652,2023-08-01,213,bisleri,6,15,9,1,00391,India
654652,2023-08-01,208,sprite,75,100,25,1,00391,India
654652,2023-08-01,209,pepsi,75,100,25,1,00391,India
862623,2023-08-01,210,mountain dew,75,100,25,1,00449,India
671907,2023-08-01,209,pepsi,75,100,25,1,00012,India
532467,2023-08-01,205,classic yogurt,45,60,15,1,00269,India
634120,2023-08-01,207,coca cola,75,100,25,1,00422,India
634120,2023-08-01,211,red bull,90,125,35,1,00422,India
924376,2023-08-01,213,bisleri,6,15,9,1,00435,India
924376,2023-08-01,206,yakult,360,400,40,1,00435,India
924376,2023-08-01,208,sprite,75,100,25,1,00435,India
315096,2023-08-01,206,yakult,360,400,40,1,00101,India
315096,2023-08-01,209,pepsi,75,100,25,1,00101,India
315096,2023-08-01,207,coca cola,75,100,25,1,00101,India
315096,2023-08-01,203,mango yogurt,50,60,10,1,00101,India
590727,2023-08-01,206,yakult,360,400,40,1,00259,India
590727,2023-08-01,207,coca cola,75,100,25,1,00259,India
590727,2023-08-01,205,classic yogurt,45,60,15,1,00259,India
956197,2023-08-01,207,coca cola,75,100,25,1,00279,India
956197,2023-08-01,205,classic yogurt,45,60,15,1,00279,India
100738,2023-08-01,201,paneer,210,340,130,1,00438,India
100738,2023-08-01,208,sprite,75,100,25,1,00438,India
100738,2023-08-01,204,strawberry yogurt,50,60,10,1,00438,India
100738,2023-08-01,213,bisleri,6,15,9,1,00438,India
781724,2023-08-01,211,red bull,90,125,35,1,00271,India
781724,2023-08-01,213,bisleri,6,15,9,1,00271,India
781724,2023-08-01,208,sprite,75,100,25,1,00271,India
781724,2023-08-01,205,classic yogurt,45,60,15,1,00271,India
564203,2023-08-01,205,classic yogurt,45,60,15,1,00264,India
506146,2023-08-01,213,bisleri,6,15,9,1,00389,India
721616,2023-08-01,205,classic yogurt,45,60,15,1,00043,India
721616,2023-08-01,204,strawberry yogurt,50,60,10,1,00043,India
721616,2023-08-01,212,amul cheese,250,315,65,1,00043,India
721616,2023-08-01,213,bisleri,6,15,9,1,00043,India
883085,2023-08-01,210,mountain dew,75,100,25,1,00413,India
184219,2023-08-01,206,yakult,360,400,40,1,00036,India
412993,2023-08-01,205,classic yogurt,45,60,15,1,00067,India
874929,2023-08-01,210,mountain dew,75,100,25,1,00033,India
874929,2023-08-01,203,mango yogurt,50,60,10,1,00033,India
463364,2023-08-01,209,pepsi,75,100,25,1,00002,India
463364,2023-08-01,213,bisleri,6,15,9,1,00002,India
330265,2023-08-01,209,pepsi,75,100,25,1,00282,India
330265,2023-08-01,212,amul cheese,250,315,65,1,00282,India
313299,2023-08-01,207,coca cola,75,100,25,1,00124,India
313299,2023-08-01,211,red bull,90,125,35,1,00124,India
313299,2023-08-01,213,bisleri,6,15,9,1,00124,India
313299,2023-08-01,202,milk,12,27,15,1,00124,India
852777,2023-08-01,211,red bull,90,125,35,1,00115,India
852777,2023-08-01,202,milk,12,27,15,1,00115,India
523928,2023-08-01,206,yakult,360,400,40,1,00362,India
523928,2023-08-01,201,paneer,210,340,130,1,00362,India
523928,2023-08-01,202,milk,12,27,15,1,00362,India
586198,2023-08-01,205,classic yogurt,45,60,15,1,00313,India
194802,2023-08-01,209,pepsi,75,100,25,1,00312,India
194802,2023-08-01,203,mango yogurt,50,60,10,1,00312,India
202480,2023-08-01,205,classic yogurt,45,60,15,1,00227,India
290641,2023-08-01,206,yakult,360,400,40,1,00052,India
290641,2023-08-01,204,strawberry yogurt,50,60,10,1,00052,India
290641,2023-08-01,213,bisleri,6,15,9,1,00052,India
290641,2023-08-01,205,classic yogurt,45,60,15,1,00052,India
449372,2023-08-01,209,pepsi,75,100,25,1,00404,India
316738,2023-08-01,212,amul cheese,250,315,65,1,00478,India
316738,2023-08-01,201,paneer,210,340,130,1,00478,India
316738,2023-08-01,202,milk,12,27,15,1,00478,India
316738,2023-08-01,213,bisleri,6,15,9,1,00478,India
495447,2023-08-01,204,strawberry yogurt,50,60,10,1,00337,India
495447,2023-08-01,209,pepsi,75,100,25,1,00337,India
495447,2023-08-01,203,mango yogurt,50,60,10,1,00337,India
495447,2023-08-01,211,red bull,90,125,35,1,00337,India
645178,2023-08-01,208,sprite,75,100,25,1,00083,India
645178,2023-08-01,205,classic yogurt,45,60,15,1,00083,India
645178,2023-08-01,206,yakult,360,400,40,1,00083,India
645178,2023-08-01,210,mountain dew,75,100,25,1,00083,India
645178,2023-08-01,203,mango yogurt,50,60,10,1,00083,India
835599,2023-08-01,203,mango yogurt,50,60,10,1,00344,India
835599,2023-08-01,210,mountain dew,75,100,25,1,00344,India
853610,2023-08-01,203,mango yogurt,50,60,10,1,00324,India
853610,2023-08-01,211,red bull,90,125,35,1,00324,India
235314,2023-08-01,201,paneer,210,340,130,1,00214,India
235314,2023-08-01,207,coca cola,75,100,25,1,00214,India
235314,2023-08-01,205,classic yogurt,45,60,15,1,00214,India
235314,2023-08-01,209,pepsi,75,100,25,1,00214,India
914523,2023-08-01,211,red bull,90,125,35,1,00493,India
914523,2023-08-01,206,yakult,360,400,40,1,00493,India
914523,2023-08-01,209,pepsi,75,100,25,1,00493,India
914523,2023-08-01,204,strawberry yogurt,50,60,10,1,00493,India
914523,2023-08-01,201,paneer,210,340,130,1,00493,India
933741,2023-08-01,213,bisleri,6,15,9,1,00182,India
933741,2023-08-01,206,yakult,360,400,40,1,00182,India
933741,2023-08-01,204,strawberry yogurt,50,60,10,1,00182,India
777477,2023-08-01,202,milk,12,27,15,1,00201,India
927905,2023-08-01,211,red bull,90,125,35,1,00063,India
927905,2023-08-01,212,amul cheese,250,315,65,1,00063,India
927905,2023-08-01,206,yakult,360,400,40,1,00063,India
127318,2023-08-01,206,yakult,360,400,40,1,00390,India
387471,2023-08-01,208,sprite,75,100,25,1,00467,India
500330,2023-08-01,213,bisleri,6,15,9,1,00032,India
500330,2023-08-01,201,paneer,210,340,130,1,00032,India
500330,2023-08-01,203,mango yogurt,50,60,10,1,00032,India
500330,2023-08-01,204,strawberry yogurt,50,60,10,1,00032,India
772624,2023-08-01,205,classic yogurt,45,60,15,1,00446,India
772624,2023-08-01,201,paneer,210,340,130,1,00446,India
772624,2023-08-01,213,bisleri,6,15,9,1,00446,India
772624,2023-08-01,209,pepsi,75,100,25,1,00446,India
184856,2023-08-01,206,yakult,360,400,40,1,00242,India
449365,2023-08-01,213,bisleri,6,15,9,1,00440,India
449365,2023-08-01,210,mountain dew,75,100,25,1,00440,India
449365,2023-08-01,209,pepsi,75,100,25,1,00440,India
392981,2023-08-01,208,sprite,75,100,25,1,00356,India
392981,2023-08-01,212,amul cheese,250,315,65,1,00356,India
392981,2023-08-01,201,paneer,210,340,130,1,00356,India
392981,2023-08-01,203,mango yogurt,50,60,10,1,00356,India
530437,2023-08-01,209,pepsi,75,100,25,1,00430,India
530437,2023-08-01,212,amul cheese,250,315,65,1,00430,India
530437,2023-08-01,213,bisleri,6,15,9,1,00430,India
530437,2023-08-01,201,paneer,210,340,130,1,00430,India
530437,2023-08-01,203,mango yogurt,50,60,10,1,00430,India
958196,2023-08-01,203,mango yogurt,50,60,10,1,00230,India
958196,2023-08-01,210,mountain dew,75,100,25,1,00230,India
958196,2023-08-01,212,amul cheese,250,315,65,1,00230,India
676983,2023-08-01,213,bisleri,6,15,9,1,00401,India
676983,2023-08-01,207,coca cola,75,100,25,1,00401,India
676983,2023-08-01,204,strawberry yogurt,50,60,10,1,00401,India
826905,2023-08-01,211,red bull,90,125,35,1,00358,India
277162,2023-08-01,213,bisleri,6,15,9,1,00294,India
277162,2023-08-01,206,yakult,360,400,40,1,00294,India
277162,2023-08-01,204,strawberry yogurt,50,60,10,1,00294,India
277162,2023-08-01,201,paneer,210,340,130,1,00294,India
304502,2023-08-01,209,pepsi,75,100,25,1,00312,India
304502,2023-08-01,211,red bull,90,125,35,1,00312,India
864492,2023-08-01,210,mountain dew,75,100,25,1,00063,India
932931,2023-08-01,210,mountain dew,75,100,25,1,00286,India
932931,2023-08-01,211,red bull,90,125,35,1,00286,India
932931,2023-08-01,201,paneer,210,340,130,1,00286,India
932931,2023-08-01,208,sprite,75,100,25,1,00286,India
932931,2023-08-01,206,yakult,360,400,40,1,00286,India
964357,2023-08-01,203,mango yogurt,50,60,10,1,00294,India
964357,2023-08-01,205,classic yogurt,45,60,15,1,00294,India
964357,2023-08-01,207,coca cola,75,100,25,1,00294,India
964357,2023-08-01,212,amul cheese,250,315,65,1,00294,India
964357,2023-08-01,204,strawberry yogurt,50,60,10,1,00294,India
165422,2023-08-01,206,yakult,360,400,40,1,00199,India
560524,2023-08-01,207,coca cola,75,100,25,1,00297,India
560524,2023-08-01,205,classic yogurt,45,60,15,1,00297,India
560524,2023-08-01,202,milk,12,27,15,1,00297,India
560524,2023-08-01,212,amul cheese,250,315,65,1,00297,India
830978,2023-08-01,202,milk,12,27,15,1,00400,India
830978,2023-08-01,204,strawberry yogurt,50,60,10,1,00400,India
830978,2023-08-01,211,red bull,90,125,35,1,00400,India
830978,2023-08-01,207,coca cola,75,100,25,1,00400,India
882477,2023-08-01,212,amul cheese,250,315,65,1,00357,India
882477,2023-08-01,202,milk,12,27,15,1,00357,India
882477,2023-08-01,210,mountain dew,75,100,25,1,00357,India
882477,2023-08-01,213,bisleri,6,15,9,1,00357,India
882477,2023-08-01,211,red bull,90,125,35,1,00357,India
435530,2023-08-01,213,bisleri,6,15,9,1,00322,India
435530,2023-08-01,212,amul cheese,250,315,65,1,00322,India
435530,2023-08-01,202,milk,12,27,15,1,00322,India
868883,2023-08-01,213,bisleri,6,15,9,1,00294,India
868883,2023-08-01,211,red bull,90,125,35,1,00294,India
868883,2023-08-01,206,yakult,360,400,40,1,00294,India
228401,2023-08-01,209,pepsi,75,100,25,1,00240,India
228401,2023-08-01,205,classic yogurt,45,60,15,1,00240,India
228401,2023-08-01,204,strawberry yogurt,50,60,10,1,00240,India
228401,2023-08-01,206,yakult,360,400,40,1,00240,India
900324,2023-08-01,212,amul cheese,250,315,65,1,00454,India
340885,2023-08-01,213,bisleri,6,15,9,1,00155,India
340885,2023-08-01,209,pepsi,75,100,25,1,00155,India
269537,2023-08-01,207,coca cola,75,100,25,1,00476,India
269537,2023-08-01,202,milk,12,27,15,1,00476,India
269537,2023-08-01,204,strawberry yogurt,50,60,10,1,00476,India
269537,2023-08-01,213,bisleri,6,15,9,1,00476,India
269537,2023-08-01,201,paneer,210,340,130,1,00476,India
808299,2023-08-01,208,sprite,75,100,25,1,00360,India
808299,2023-08-01,202,milk,12,27,15,1,00360,India
808299,2023-08-01,210,mountain dew,75,100,25,1,00360,India
808299,2023-08-01,212,amul cheese,250,315,65,1,00360,India
614049,2023-08-01,201,paneer,210,340,130,1,00289,India
614049,2023-08-01,206,yakult,360,400,40,1,00289,India
614049,2023-08-01,207,coca cola,75,100,25,1,00289,India
614049,2023-08-01,205,classic yogurt,45,60,15,1,00289,India
614049,2023-08-01,212,amul cheese,250,315,65,1,00289,India
664151,2023-08-01,207,coca cola,75,100,25,1,00367,India
664151,2023-08-01,203,mango yogurt,50,60,10,1,00367,India
701472,2023-08-01,201,paneer,210,340,130,1,00284,India
701472,2023-08-01,207,coca cola,75,100,25,1,00284,India
701472,2023-08-01,211,red bull,90,125,35,1,00284,India
701472,2023-08-01,203,mango yogurt,50,60,10,1,00284,India
266701,2023-08-01,207,coca cola,75,100,25,1,00446,India
266701,2023-08-01,211,red bull,90,125,35,1,00446,India
266701,2023-08-01,210,mountain dew,75,100,25,1,00446,India
266701,2023-08-01,209,pepsi,75,100,25,1,00446,India
266701,2023-08-01,205,classic yogurt,45,60,15,1,00446,India
538866,2023-08-01,201,paneer,210,340,130,1,00161,India
538866,2023-08-01,203,mango yogurt,50,60,10,1,00161,India
321151,2023-08-01,204,strawberry yogurt,50,60,10,1,00163,India
449458,2023-08-01,202,milk,12,27,15,1,00060,India
449458,2023-08-01,211,red bull,90,125,35,1,00060,India
449458,2023-08-01,206,yakult,360,400,40,1,00060,India
377978,2023-08-01,202,milk,12,27,15,1,00186,India
909193,2023-08-01,213,bisleri,6,15,9,1,00395,India
891434,2023-08-01,210,mountain dew,75,100,25,1,00161,India
891434,2023-08-01,204,strawberry yogurt,50,60,10,1,00161,India
392748,2023-08-01,212,amul cheese,250,315,65,1,00244,India
392748,2023-08-01,208,sprite,75,100,25,1,00244,India
392748,2023-08-01,202,milk,12,27,15,1,00244,India
392748,2023-08-01,206,yakult,360,400,40,1,00244,India
783870,2023-08-01,204,strawberry yogurt,50,60,10,1,00287,India
783870,2023-08-01,213,bisleri,6,15,9,1,00287,India
783870,2023-08-01,207,coca cola,75,100,25,1,00287,India
783870,2023-08-01,212,amul cheese,250,315,65,1,00287,India
783870,2023-08-01,205,classic yogurt,45,60,15,1,00287,India
528254,2023-08-01,213,bisleri,6,15,9,1,00452,India
528254,2023-08-01,209,pepsi,75,100,25,1,00452,India
443784,2023-08-01,206,yakult,360,400,40,1,00049,India
443784,2023-08-01,210,mountain dew,75,100,25,1,00049,India
443784,2023-08-01,204,strawberry yogurt,50,60,10,1,00049,India
443784,2023-08-01,203,mango yogurt,50,60,10,1,00049,India
622616,2023-08-01,204,strawberry yogurt,50,60,10,1,00354,India
622616,2023-08-01,213,bisleri,6,15,9,1,00354,India
622616,2023-08-01,210,mountain dew,75,100,25,1,00354,India
117723,2023-08-01,208,sprite,75,100,25,1,00463,India
117723,2023-08-01,210,mountain dew,75,100,25,1,00463,India
117723,2023-08-01,207,coca cola,75,100,25,1,00463,India
128811,2023-08-01,206,yakult,360,400,40,1,00342,India
128811,2023-08-01,209,pepsi,75,100,25,1,00342,India
471707,2023-08-02,207,coca cola,75,100,25,1,00018,India
914893,2023-08-02,208,sprite,75,100,25,1,00339,India
693528,2023-08-02,213,bisleri,6,15,9,1,00149,India
693528,2023-08-02,210,mountain dew,75,100,25,1,00149,India
693528,2023-08-02,209,pepsi,75,100,25,1,00149,India
157952,2023-08-02,211,red bull,90,125,35,1,00301,India
157952,2023-08-02,209,pepsi,75,100,25,1,00301,India
997924,2023-08-02,203,mango yogurt,50,60,10,1,00457,India
997924,2023-08-02,206,yakult,360,400,40,1,00457,India
997924,2023-08-02,205,classic yogurt,45,60,15,1,00457,India
997924,2023-08-02,211,red bull,90,125,35,1,00457,India
148822,2023-08-02,202,milk,12,27,15,1,00427,India
148822,2023-08-02,207,coca cola,75,100,25,1,00427,India
779430,2023-08-02,205,classic yogurt,45,60,15,1,00174,India
305980,2023-08-02,203,mango yogurt,50,60,10,1,00077,India
305980,2023-08-02,213,bisleri,6,15,9,1,00077,India
541639,2023-08-02,211,red bull,90,125,35,1,00046,India
541639,2023-08-02,203,mango yogurt,50,60,10,1,00046,India
541639,2023-08-02,202,milk,12,27,15,1,00046,India
330342,2023-08-02,202,milk,12,27,15,1,00389,India
330342,2023-08-02,207,coca cola,75,100,25,1,00389,India
330342,2023-08-02,206,yakult,360,400,40,1,00389,India
330342,2023-08-02,210,mountain dew,75,100,25,1,00389,India
958181,2023-08-02,207,coca cola,75,100,25,1,00046,India
958181,2023-08-02,210,mountain dew,75,100,25,1,00046,India
958181,2023-08-02,202,milk,12,27,15,1,00046,India
958181,2023-08-02,203,mango yogurt,50,60,10,1,00046,India
235564,2023-08-02,203,mango yogurt,50,60,10,1,00467,India
235564,2023-08-02,210,mountain dew,75,100,25,1,00467,India
235564,2023-08-02,205,classic yogurt,45,60,15,1,00467,India
235564,2023-08-02,208,sprite,75,100,25,1,00467,India
235564,2023-08-02,204,strawberry yogurt,50,60,10,1,00467,India
485401,2023-08-02,204,strawberry yogurt,50,60,10,1,00355,India
485401,2023-08-02,211,red bull,90,125,35,1,00355,India
485401,2023-08-02,205,classic yogurt,45,60,15,1,00355,India
244001,2023-08-02,203,mango yogurt,50,60,10,1,00187,India
244001,2023-08-02,213,bisleri,6,15,9,1,00187,India
244001,2023-08-02,202,milk,12,27,15,1,00187,India
244001,2023-08-02,205,classic yogurt,45,60,15,1,00187,India
449805,2023-08-02,211,red bull,90,125,35,1,00343,India
449805,2023-08-02,210,mountain dew,75,100,25,1,00343,India
449805,2023-08-02,202,milk,12,27,15,1,00343,India
449805,2023-08-02,206,yakult,360,400,40,1,00343,India
683283,2023-08-02,212,amul cheese,250,315,65,1,00484,India
683283,2023-08-02,211,red bull,90,125,35,1,00484,India
368038,2023-08-02,207,coca cola,75,100,25,1,00489,India
368038,2023-08-02,203,mango yogurt,50,60,10,1,00489,India
368038,2023-08-02,202,milk,12,27,15,1,00489,India
368038,2023-08-02,208,sprite,75,100,25,1,00489,India
576102,2023-08-02,209,pepsi,75,100,25,1,00415,India
240901,2023-08-02,213,bisleri,6,15,9,1,00317,India
393370,2023-08-02,207,coca cola,75,100,25,1,00123,India
393370,2023-08-02,212,amul cheese,250,315,65,1,00123,India
100015,2023-08-02,205,classic yogurt,45,60,15,1,00187,India
100015,2023-08-02,204,strawberry yogurt,50,60,10,1,00187,India
100564,2023-08-02,209,pepsi,75,100,25,1,00352,India
985381,2023-08-02,209,pepsi,75,100,25,1,00147,India
985381,2023-08-02,201,paneer,210,340,130,1,00147,India
471586,2023-08-02,205,classic yogurt,45,60,15,1,00428,India
627515,2023-08-02,212,amul cheese,250,315,65,1,00454,India
456757,2023-08-02,201,paneer,210,340,130,1,00285,India
155109,2023-08-02,212,amul cheese,250,315,65,1,00269,India
523817,2023-08-02,205,classic yogurt,45,60,15,1,00027,India
523817,2023-08-02,209,pepsi,75,100,25,1,00027,India
523817,2023-08-02,207,coca cola,75,100,25,1,00027,India
523817,2023-08-02,212,amul cheese,250,315,65,1,00027,India
523817,2023-08-02,204,strawberry yogurt,50,60,10,1,00027,India
609631,2023-08-02,208,sprite,75,100,25,1,00194,India
609631,2023-08-02,210,mountain dew,75,100,25,1,00194,India
609631,2023-08-02,207,coca cola,75,100,25,1,00194,India
438560,2023-08-02,209,pepsi,75,100,25,1,00289,India
438560,2023-08-02,205,classic yogurt,45,60,15,1,00289,India
438560,2023-08-02,207,coca cola,75,100,25,1,00289,India
438560,2023-08-02,212,amul cheese,250,315,65,1,00289,India
105635,2023-08-02,209,pepsi,75,100,25,1,00270,India
105635,2023-08-02,208,sprite,75,100,25,1,00270,India
105635,2023-08-02,211,red bull,90,125,35,1,00270,India
105635,2023-08-02,212,amul cheese,250,315,65,1,00270,India
847283,2023-08-02,213,bisleri,6,15,9,1,00482,India
847283,2023-08-02,209,pepsi,75,100,25,1,00482,India
847283,2023-08-02,212,amul cheese,250,315,65,1,00482,India
847283,2023-08-02,204,strawberry yogurt,50,60,10,1,00482,India
851795,2023-08-02,209,pepsi,75,100,25,1,00473,India
851795,2023-08-02,206,yakult,360,400,40,1,00473,India
851795,2023-08-02,202,milk,12,27,15,1,00473,India
851795,2023-08-02,201,paneer,210,340,130,1,00473,India
851795,2023-08-02,204,strawberry yogurt,50,60,10,1,00473,India
263509,2023-08-02,210,mountain dew,75,100,25,1,00351,India
263509,2023-08-02,201,paneer,210,340,130,1,00351,India
795959,2023-08-02,211,red bull,90,125,35,1,00237,India
795959,2023-08-02,205,classic yogurt,45,60,15,1,00237,India
795959,2023-08-02,208,sprite,75,100,25,1,00237,India
819328,2023-08-02,213,bisleri,6,15,9,1,00446,India
819328,2023-08-02,211,red bull,90,125,35,1,00446,India
819328,2023-08-02,205,classic yogurt,45,60,15,1,00446,India
819328,2023-08-02,209,pepsi,75,100,25,1,00446,India
819328,2023-08-02,201,paneer,210,340,130,1,00446,India
689238,2023-08-02,207,coca cola,75,100,25,1,00168,India
689238,2023-08-02,206,yakult,360,400,40,1,00168,India
629018,2023-08-02,202,milk,12,27,15,1,00383,India
629018,2023-08-02,204,strawberry yogurt,50,60,10,1,00383,India
629018,2023-08-02,212,amul cheese,250,315,65,1,00383,India
629018,2023-08-02,209,pepsi,75,100,25,1,00383,India
583052,2023-08-02,210,mountain dew,75,100,25,1,00126,India
583052,2023-08-02,204,strawberry yogurt,50,60,10,1,00126,India
583052,2023-08-02,205,classic yogurt,45,60,15,1,00126,India
583052,2023-08-02,201,paneer,210,340,130,1,00126,India
522809,2023-08-02,204,strawberry yogurt,50,60,10,1,00277,India
522809,2023-08-02,201,paneer,210,340,130,1,00277,India
522809,2023-08-02,211,red bull,90,125,35,1,00277,India
541331,2023-08-02,210,mountain dew,75,100,25,1,00094,India
541331,2023-08-02,208,sprite,75,100,25,1,00094,India
541331,2023-08-02,212,amul cheese,250,315,65,1,00094,India
439235,2023-08-02,213,bisleri,6,15,9,1,00062,India
439235,2023-08-02,201,paneer,210,340,130,1,00062,India
439235,2023-08-02,209,pepsi,75,100,25,1,00062,India
106278,2023-08-02,211,red bull,90,125,35,1,00099,India
747540,2023-08-02,202,milk,12,27,15,1,00161,India
747540,2023-08-02,203,mango yogurt,50,60,10,1,00161,India
747540,2023-08-02,210,mountain dew,75,100,25,1,00161,India
747540,2023-08-02,209,pepsi,75,100,25,1,00161,India
518991,2023-08-02,203,mango yogurt,50,60,10,1,00477,India
518991,2023-08-02,210,mountain dew,75,100,25,1,00477,India
607331,2023-08-02,212,amul cheese,250,315,65,1,00375,India
941027,2023-08-02,205,classic yogurt,45,60,15,1,00404,India
941027,2023-08-02,202,milk,12,27,15,1,00404,India
941027,2023-08-02,208,sprite,75,100,25,1,00404,India
793204,2023-08-02,209,pepsi,75,100,25,1,00333,India
793204,2023-08-02,202,milk,12,27,15,1,00333,India
793204,2023-08-02,201,paneer,210,340,130,1,00333,India
364886,2023-08-02,207,coca cola,75,100,25,1,00490,India
231292,2023-08-02,213,bisleri,6,15,9,1,00136,India
231292,2023-08-02,208,sprite,75,100,25,1,00136,India
231292,2023-08-02,203,mango yogurt,50,60,10,1,00136,India
233183,2023-08-02,203,mango yogurt,50,60,10,1,00048,India
233183,2023-08-02,201,paneer,210,340,130,1,00048,India
233183,2023-08-02,209,pepsi,75,100,25,1,00048,India
520728,2023-08-02,212,amul cheese,250,315,65,1,00265,India
520132,2023-08-03,204,strawberry yogurt,50,60,10,1,00223,India
520132,2023-08-03,212,amul cheese,250,315,65,1,00223,India
520132,2023-08-03,213,bisleri,6,15,9,1,00223,India
520132,2023-08-03,208,sprite,75,100,25,1,00223,India
672623,2023-08-03,212,amul cheese,250,315,65,1,00374,India
672623,2023-08-03,207,coca cola,75,100,25,1,00374,India
959641,2023-08-03,206,yakult,360,400,40,1,00453,India
156839,2023-08-03,203,mango yogurt,50,60,10,1,00205,India
156839,2023-08-03,206,yakult,360,400,40,1,00205,India
156839,2023-08-03,208,sprite,75,100,25,1,00205,India
156839,2023-08-03,202,milk,12,27,15,1,00205,India
479874,2023-08-03,211,red bull,90,125,35,1,00443,India
479874,2023-08-03,207,coca cola,75,100,25,1,00443,India
479874,2023-08-03,201,paneer,210,340,130,1,00443,India
479874,2023-08-03,213,bisleri,6,15,9,1,00443,India
587250,2023-08-03,212,amul cheese,250,315,65,1,00421,India
587250,2023-08-03,204,strawberry yogurt,50,60,10,1,00421,India
587250,2023-08-03,201,paneer,210,340,130,1,00421,India
587250,2023-08-03,211,red bull,90,125,35,1,00421,India
587250,2023-08-03,205,classic yogurt,45,60,15,1,00421,India
420770,2023-08-03,205,classic yogurt,45,60,15,1,00050,India
420770,2023-08-03,206,yakult,360,400,40,1,00050,India
239763,2023-08-03,206,yakult,360,400,40,1,00134,India
239763,2023-08-03,213,bisleri,6,15,9,1,00134,India
239763,2023-08-03,203,mango yogurt,50,60,10,1,00134,India
303022,2023-08-03,208,sprite,75,100,25,1,00419,India
303022,2023-08-03,207,coca cola,75,100,25,1,00419,India
999063,2023-08-03,207,coca cola,75,100,25,1,00304,India
999063,2023-08-03,213,bisleri,6,15,9,1,00304,India
632527,2023-08-03,201,paneer,210,340,130,1,00370,India
632527,2023-08-03,207,coca cola,75,100,25,1,00370,India
632527,2023-08-03,213,bisleri,6,15,9,1,00370,India
632527,2023-08-03,203,mango yogurt,50,60,10,1,00370,India
106816,2023-08-03,207,coca cola,75,100,25,1,00167,India
106816,2023-08-03,202,milk,12,27,15,1,00167,India
106816,2023-08-03,209,pepsi,75,100,25,1,00167,India
141226,2023-08-03,201,paneer,210,340,130,1,00290,India
674380,2023-08-03,210,mountain dew,75,100,25,1,00287,India
674380,2023-08-03,211,red bull,90,125,35,1,00287,India
674380,2023-08-03,213,bisleri,6,15,9,1,00287,India
674380,2023-08-03,209,pepsi,75,100,25,1,00287,India
940072,2023-08-03,201,paneer,210,340,130,1,00160,India
940072,2023-08-03,209,pepsi,75,100,25,1,00160,India
940072,2023-08-03,210,mountain dew,75,100,25,1,00160,India
994190,2023-08-03,203,mango yogurt,50,60,10,1,00430,India
994190,2023-08-03,211,red bull,90,125,35,1,00430,India
994190,2023-08-03,208,sprite,75,100,25,1,00430,India
225421,2023-08-03,201,paneer,210,340,130,1,00283,India
775910,2023-08-03,203,mango yogurt,50,60,10,1,00251,India
775910,2023-08-03,207,coca cola,75,100,25,1,00251,India
420102,2023-08-03,207,coca cola,75,100,25,1,00012,India
420102,2023-08-03,211,red bull,90,125,35,1,00012,India
924296,2023-08-03,204,strawberry yogurt,50,60,10,1,00467,India
924296,2023-08-03,212,amul cheese,250,315,65,1,00467,India
924296,2023-08-03,210,mountain dew,75,100,25,1,00467,India
924296,2023-08-03,208,sprite,75,100,25,1,00467,India
973761,2023-08-03,213,bisleri,6,15,9,1,00270,India
973761,2023-08-03,209,pepsi,75,100,25,1,00270,India
123594,2023-08-03,202,milk,12,27,15,1,00407,India
642454,2023-08-03,211,red bull,90,125,35,1,00019,India
673345,2023-08-03,205,classic yogurt,45,60,15,1,00041,India
673345,2023-08-03,212,amul cheese,250,315,65,1,00041,India
673345,2023-08-03,208,sprite,75,100,25,1,00041,India
805907,2023-08-03,205,classic yogurt,45,60,15,1,00029,India
805907,2023-08-03,206,yakult,360,400,40,1,00029,India
805907,2023-08-03,208,sprite,75,100,25,1,00029,India
649835,2023-08-03,213,bisleri,6,15,9,1,00398,India
649835,2023-08-03,210,mountain dew,75,100,25,1,00398,India
649835,2023-08-03,207,coca cola,75,100,25,1,00398,India
110043,2023-08-03,208,sprite,75,100,25,1,00471,India
110043,2023-08-03,203,mango yogurt,50,60,10,1,00471,India
110043,2023-08-03,209,pepsi,75,100,25,1,00471,India
187989,2023-08-03,207,coca cola,75,100,25,1,00463,India
187989,2023-08-03,208,sprite,75,100,25,1,00463,India
187989,2023-08-03,209,pepsi,75,100,25,1,00463,India
187989,2023-08-03,212,amul cheese,250,315,65,1,00463,India
766223,2023-08-03,202,milk,12,27,15,1,00354,India
766223,2023-08-03,209,pepsi,75,100,25,1,00354,India
766223,2023-08-03,212,amul cheese,250,315,65,1,00354,India
766223,2023-08-03,204,strawberry yogurt,50,60,10,1,00354,India
766223,2023-08-03,206,yakult,360,400,40,1,00354,India
332081,2023-08-03,202,milk,12,27,15,1,00293,India
837212,2023-08-03,209,pepsi,75,100,25,1,00146,India
837212,2023-08-03,202,milk,12,27,15,1,00146,India
837212,2023-08-03,213,bisleri,6,15,9,1,00146,India
360638,2023-08-03,212,amul cheese,250,315,65,1,00453,India
360638,2023-08-03,203,mango yogurt,50,60,10,1,00453,India
557016,2023-08-03,211,red bull,90,125,35,1,00226,India
557016,2023-08-03,203,mango yogurt,50,60,10,1,00226,India
557016,2023-08-03,213,bisleri,6,15,9,1,00226,India
115541,2023-08-03,205,classic yogurt,45,60,15,1,00231,India
115541,2023-08-03,204,strawberry yogurt,50,60,10,1,00231,India
115541,2023-08-03,213,bisleri,6,15,9,1,00231,India
527817,2023-08-03,209,pepsi,75,100,25,1,00380,India
527817,2023-08-03,202,milk,12,27,15,1,00380,India
527817,2023-08-03,211,red bull,90,125,35,1,00380,India
654524,2023-08-03,205,classic yogurt,45,60,15,1,00475,India
654524,2023-08-03,207,coca cola,75,100,25,1,00475,India
873460,2023-08-03,201,paneer,210,340,130,1,00249,India
873460,2023-08-03,211,red bull,90,125,35,1,00249,India
650776,2023-08-03,208,sprite,75,100,25,1,00490,India
112027,2023-08-03,207,coca cola,75,100,25,1,00472,India
112027,2023-08-03,201,paneer,210,340,130,1,00472,India
112027,2023-08-03,202,milk,12,27,15,1,00472,India
422423,2023-08-03,211,red bull,90,125,35,1,00043,India
627520,2023-08-03,207,coca cola,75,100,25,1,00061,India
627520,2023-08-03,211,red bull,90,125,35,1,00061,India
627520,2023-08-03,201,paneer,210,340,130,1,00061,India
627520,2023-08-03,210,mountain dew,75,100,25,1,00061,India
815607,2023-08-03,208,sprite,75,100,25,1,00263,India
268926,2023-08-03,210,mountain dew,75,100,25,1,00100,India
268926,2023-08-03,209,pepsi,75,100,25,1,00100,India
268926,2023-08-03,202,milk,12,27,15,1,00100,India
417500,2023-08-03,210,mountain dew,75,100,25,1,00091,India
417500,2023-08-03,204,strawberry yogurt,50,60,10,1,00091,India
417500,2023-08-03,201,paneer,210,340,130,1,00091,India
417500,2023-08-03,207,coca cola,75,100,25,1,00091,India
417500,2023-08-03,202,milk,12,27,15,1,00091,India
236514,2023-08-03,210,mountain dew,75,100,25,1,00127,India
236514,2023-08-03,207,coca cola,75,100,25,1,00127,India
236514,2023-08-03,204,strawberry yogurt,50,60,10,1,00127,India
472476,2023-08-03,210,mountain dew,75,100,25,1,00491,India
472476,2023-08-03,202,milk,12,27,15,1,00491,India
349961,2023-08-03,208,sprite,75,100,25,1,00234,India
980814,2023-08-03,205,classic yogurt,45,60,15,1,00158,India
980814,2023-08-03,210,mountain dew,75,100,25,1,00158,India
980814,2023-08-03,213,bisleri,6,15,9,1,00158,India
788209,2023-08-03,211,red bull,90,125,35,1,00200,India
788209,2023-08-03,209,pepsi,75,100,25,1,00200,India
788209,2023-08-03,204,strawberry yogurt,50,60,10,1,00200,India
107350,2023-08-03,205,classic yogurt,45,60,15,1,00313,India
832469,2023-08-03,203,mango yogurt,50,60,10,1,00100,India
832469,2023-08-03,207,coca cola,75,100,25,1,00100,India
467933,2023-08-03,209,pepsi,75,100,25,1,00466,India
467933,2023-08-03,210,mountain dew,75,100,25,1,00466,India
467933,2023-08-03,208,sprite,75,100,25,1,00466,India
467933,2023-08-03,205,classic yogurt,45,60,15,1,00466,India
467933,2023-08-03,201,paneer,210,340,130,1,00466,India
500080,2023-08-03,212,amul cheese,250,315,65,1,00279,India
500080,2023-08-03,201,paneer,210,340,130,1,00279,India
500080,2023-08-03,203,mango yogurt,50,60,10,1,00279,India
500080,2023-08-03,210,mountain dew,75,100,25,1,00279,India
534940,2023-08-03,207,coca cola,75,100,25,1,00233,India
117592,2023-08-03,208,sprite,75,100,25,1,00335,India
486255,2023-08-03,202,milk,12,27,15,1,00092,India
486255,2023-08-03,201,paneer,210,340,130,1,00092,India
946796,2023-08-03,205,classic yogurt,45,60,15,1,00309,India
121909,2023-08-03,206,yakult,360,400,40,1,00392,India
121909,2023-08-03,207,coca cola,75,100,25,1,00392,India
455510,2023-08-03,201,paneer,210,340,130,1,00234,India
455510,2023-08-03,204,strawberry yogurt,50,60,10,1,00234,India
531048,2023-08-03,213,bisleri,6,15,9,1,00219,India
531048,2023-08-03,208,sprite,75,100,25,1,00219,India
531048,2023-08-03,209,pepsi,75,100,25,1,00219,India
531048,2023-08-03,210,mountain dew,75,100,25,1,00219,India
538887,2023-08-03,205,classic yogurt,45,60,15,1,00437,India
710963,2023-08-03,204,strawberry yogurt,50,60,10,1,00494,India
521955,2023-08-03,213,bisleri,6,15,9,1,00193,India
521955,2023-08-03,208,sprite,75,100,25,1,00193,India
335293,2023-08-03,208,sprite,75,100,25,1,00097,India
335293,2023-08-03,212,amul cheese,250,315,65,1,00097,India
335293,2023-08-03,209,pepsi,75,100,25,1,00097,India
335293,2023-08-03,210,mountain dew,75,100,25,1,00097,India
335293,2023-08-03,213,bisleri,6,15,9,1,00097,India
406898,2023-08-03,201,paneer,210,340,130,1,00317,India
406898,2023-08-03,207,coca cola,75,100,25,1,00317,India
406898,2023-08-03,209,pepsi,75,100,25,1,00317,India
406898,2023-08-03,206,yakult,360,400,40,1,00317,India
406898,2023-08-03,210,mountain dew,75,100,25,1,00317,India
704106,2023-08-03,202,milk,12,27,15,1,00202,India
854809,2023-08-03,213,bisleri,6,15,9,1,00315,India
854809,2023-08-03,205,classic yogurt,45,60,15,1,00315,India
854809,2023-08-03,202,milk,12,27,15,1,00315,India
463122,2023-08-03,203,mango yogurt,50,60,10,1,00151,India
463122,2023-08-03,201,paneer,210,340,130,1,00151,India
463122,2023-08-03,204,strawberry yogurt,50,60,10,1,00151,India
463122,2023-08-03,212,amul cheese,250,315,65,1,00151,India
723472,2023-08-03,204,strawberry yogurt,50,60,10,1,00334,India
723472,2023-08-03,210,mountain dew,75,100,25,1,00334,India
160271,2023-08-03,205,classic yogurt,45,60,15,1,00187,India
160271,2023-08-03,213,bisleri,6,15,9,1,00187,India
707481,2023-08-03,202,milk,12,27,15,1,00151,India
707481,2023-08-03,210,mountain dew,75,100,25,1,00151,India
707481,2023-08-03,212,amul cheese,250,315,65,1,00151,India
714884,2023-08-04,202,milk,12,27,15,1,00441,India
714884,2023-08-04,206,yakult,360,400,40,1,00441,India
670732,2023-08-04,207,coca cola,75,100,25,1,00303,India
670732,2023-08-04,201,paneer,210,340,130,1,00303,India
692236,2023-08-04,208,sprite,75,100,25,1,00210,India
692236,2023-08-04,213,bisleri,6,15,9,1,00210,India
470416,2023-08-04,206,yakult,360,400,40,1,00329,India
470416,2023-08-04,210,mountain dew,75,100,25,1,00329,India
470416,2023-08-04,209,pepsi,75,100,25,1,00329,India
406677,2023-08-04,207,coca cola,75,100,25,1,00042,India
406677,2023-08-04,202,milk,12,27,15,1,00042,India
406677,2023-08-04,206,yakult,360,400,40,1,00042,India
406677,2023-08-04,212,amul cheese,250,315,65,1,00042,India
738323,2023-08-04,207,coca cola,75,100,25,1,00167,India
124685,2023-08-04,209,pepsi,75,100,25,1,00466,India
124685,2023-08-04,203,mango yogurt,50,60,10,1,00466,India
692994,2023-08-04,213,bisleri,6,15,9,1,00096,India
692994,2023-08-04,211,red bull,90,125,35,1,00096,India
692994,2023-08-04,208,sprite,75,100,25,1,00096,India
692994,2023-08-04,210,mountain dew,75,100,25,1,00096,India
704687,2023-08-04,209,pepsi,75,100,25,1,00106,India
856066,2023-08-04,202,milk,12,27,15,1,00382,India
856066,2023-08-04,213,bisleri,6,15,9,1,00382,India
856066,2023-08-04,212,amul cheese,250,315,65,1,00382,India
109332,2023-08-04,208,sprite,75,100,25,1,00448,India
109332,2023-08-04,211,red bull,90,125,35,1,00448,India
109332,2023-08-04,204,strawberry yogurt,50,60,10,1,00448,India
753516,2023-08-04,210,mountain dew,75,100,25,1,00349,India
753516,2023-08-04,204,strawberry yogurt,50,60,10,1,00349,India
753516,2023-08-04,213,bisleri,6,15,9,1,00349,India
441433,2023-08-04,201,paneer,210,340,130,1,00464,India
441433,2023-08-04,203,mango yogurt,50,60,10,1,00464,India
847378,2023-08-04,212,amul cheese,250,315,65,1,00047,India
847378,2023-08-04,208,sprite,75,100,25,1,00047,India
847378,2023-08-04,211,red bull,90,125,35,1,00047,India
764800,2023-08-04,206,yakult,360,400,40,1,00396,India
764800,2023-08-04,213,bisleri,6,15,9,1,00396,India
580268,2023-08-04,212,amul cheese,250,315,65,1,00145,India
580268,2023-08-04,211,red bull,90,125,35,1,00145,India
580268,2023-08-04,206,yakult,360,400,40,1,00145,India
580268,2023-08-04,204,strawberry yogurt,50,60,10,1,00145,India
965564,2023-08-04,205,classic yogurt,45,60,15,1,00338,India
965564,2023-08-04,210,mountain dew,75,100,25,1,00338,India
965564,2023-08-04,208,sprite,75,100,25,1,00338,India
283112,2023-08-04,213,bisleri,6,15,9,1,00264,India
283112,2023-08-04,208,sprite,75,100,25,1,00264,India
283112,2023-08-04,210,mountain dew,75,100,25,1,00264,India
819790,2023-08-04,212,amul cheese,250,315,65,1,00476,India
819790,2023-08-04,207,coca cola,75,100,25,1,00476,India
819790,2023-08-04,204,strawberry yogurt,50,60,10,1,00476,India
819790,2023-08-04,203,mango yogurt,50,60,10,1,00476,India
819790,2023-08-04,201,paneer,210,340,130,1,00476,India
976097,2023-08-04,201,paneer,210,340,130,1,00192,India
976097,2023-08-04,207,coca cola,75,100,25,1,00192,India
299609,2023-08-04,205,classic yogurt,45,60,15,1,00002,India
299609,2023-08-04,206,yakult,360,400,40,1,00002,India
299609,2023-08-04,211,red bull,90,125,35,1,00002,India
271713,2023-08-04,211,red bull,90,125,35,1,00132,India
271713,2023-08-04,207,coca cola,75,100,25,1,00132,India
271713,2023-08-04,209,pepsi,75,100,25,1,00132,India
893554,2023-08-04,208,sprite,75,100,25,1,00209,India
893554,2023-08-04,202,milk,12,27,15,1,00209,India
945195,2023-08-04,212,amul cheese,250,315,65,1,00048,India
662128,2023-08-04,206,yakult,360,400,40,1,00188,India
662128,2023-08-04,204,strawberry yogurt,50,60,10,1,00188,India
662128,2023-08-04,212,amul cheese,250,315,65,1,00188,India
662128,2023-08-04,201,paneer,210,340,130,1,00188,India
601896,2023-08-04,208,sprite,75,100,25,1,00135,India
285790,2023-08-04,202,milk,12,27,15,1,00377,India
285790,2023-08-04,210,mountain dew,75,100,25,1,00377,India
285790,2023-08-04,204,strawberry yogurt,50,60,10,1,00377,India
285790,2023-08-04,203,mango yogurt,50,60,10,1,00377,India
711784,2023-08-04,204,strawberry yogurt,50,60,10,1,00136,India
711784,2023-08-04,212,amul cheese,250,315,65,1,00136,India
733349,2023-08-04,206,yakult,360,400,40,1,00259,India
733349,2023-08-04,204,strawberry yogurt,50,60,10,1,00259,India
156970,2023-08-04,201,paneer,210,340,130,1,00352,India
156970,2023-08-04,202,milk,12,27,15,1,00352,India
156970,2023-08-04,203,mango yogurt,50,60,10,1,00352,India
156970,2023-08-04,205,classic yogurt,45,60,15,1,00352,India
635725,2023-08-04,201,paneer,210,340,130,1,00164,India
635725,2023-08-04,213,bisleri,6,15,9,1,00164,India
150591,2023-08-04,203,mango yogurt,50,60,10,1,00473,India
150591,2023-08-04,207,coca cola,75,100,25,1,00473,India
150591,2023-08-04,208,sprite,75,100,25,1,00473,India
728101,2023-08-04,202,milk,12,27,15,1,00022,India
728101,2023-08-04,207,coca cola,75,100,25,1,00022,India
728101,2023-08-04,212,amul cheese,250,315,65,1,00022,India
728101,2023-08-04,201,paneer,210,340,130,1,00022,India
728101,2023-08-04,213,bisleri,6,15,9,1,00022,India
789467,2023-08-04,213,bisleri,6,15,9,1,00240,India
789467,2023-08-04,211,red bull,90,125,35,1,00240,India
789467,2023-08-04,207,coca cola,75,100,25,1,00240,India
789467,2023-08-04,212,amul cheese,250,315,65,1,00240,India
784303,2023-08-04,206,yakult,360,400,40,1,00328,India
784303,2023-08-04,205,classic yogurt,45,60,15,1,00328,India
784303,2023-08-04,202,milk,12,27,15,1,00328,India
784303,2023-08-04,201,paneer,210,340,130,1,00328,India
224414,2023-08-04,209,pepsi,75,100,25,1,00235,India
821987,2023-08-04,205,classic yogurt,45,60,15,1,00049,India
821987,2023-08-04,203,mango yogurt,50,60,10,1,00049,India
821987,2023-08-04,209,pepsi,75,100,25,1,00049,India
327193,2023-08-04,205,classic yogurt,45,60,15,1,00042,India
853559,2023-08-04,205,classic yogurt,45,60,15,1,00230,India
853559,2023-08-04,212,amul cheese,250,315,65,1,00230,India
853559,2023-08-04,206,yakult,360,400,40,1,00230,India
853559,2023-08-04,210,mountain dew,75,100,25,1,00230,India
454114,2023-08-04,206,yakult,360,400,40,1,00230,India
454114,2023-08-04,211,red bull,90,125,35,1,00230,India
798777,2023-08-04,207,coca cola,75,100,25,1,00279,India
798777,2023-08-04,205,classic yogurt,45,60,15,1,00279,India
235596,2023-08-04,207,coca cola,75,100,25,1,00459,India
235596,2023-08-04,204,strawberry yogurt,50,60,10,1,00459,India
235596,2023-08-04,209,pepsi,75,100,25,1,00459,India
235596,2023-08-04,205,classic yogurt,45,60,15,1,00459,India
854845,2023-08-04,209,pepsi,75,100,25,1,00017,India
854845,2023-08-04,201,paneer,210,340,130,1,00017,India
104043,2023-08-04,207,coca cola,75,100,25,1,00222,India
104043,2023-08-04,211,red bull,90,125,35,1,00222,India
104043,2023-08-04,206,yakult,360,400,40,1,00222,India
976079,2023-08-04,202,milk,12,27,15,1,00261,India
976079,2023-08-04,206,yakult,360,400,40,1,00261,India
928840,2023-08-04,210,mountain dew,75,100,25,1,00211,India
928840,2023-08-04,211,red bull,90,125,35,1,00211,India
928840,2023-08-04,203,mango yogurt,50,60,10,1,00211,India
928840,2023-08-04,207,coca cola,75,100,25,1,00211,India
735837,2023-08-04,207,coca cola,75,100,25,1,00384,India
735837,2023-08-04,210,mountain dew,75,100,25,1,00384,India
735837,2023-08-04,208,sprite,75,100,25,1,00384,India
735837,2023-08-04,211,red bull,90,125,35,1,00384,India
735837,2023-08-04,203,mango yogurt,50,60,10,1,00384,India
554448,2023-08-04,211,red bull,90,125,35,1,00306,India
670050,2023-08-04,213,bisleri,6,15,9,1,00401,India
670050,2023-08-04,209,pepsi,75,100,25,1,00401,India
670050,2023-08-04,204,strawberry yogurt,50,60,10,1,00401,India
670050,2023-08-04,208,sprite,75,100,25,1,00401,India
229664,2023-08-04,202,milk,12,27,15,1,00151,India
469127,2023-08-04,202,milk,12,27,15,1,00023,India
469127,2023-08-04,210,mountain dew,75,100,25,1,00023,India
393653,2023-08-04,213,bisleri,6,15,9,1,00178,India
393653,2023-08-04,211,red bull,90,125,35,1,00178,India
393653,2023-08-04,207,coca cola,75,100,25,1,00178,India
929964,2023-08-04,213,bisleri,6,15,9,1,00390,India
486435,2023-08-04,208,sprite,75,100,25,1,00288,India
486435,2023-08-04,204,strawberry yogurt,50,60,10,1,00288,India
486435,2023-08-04,210,mountain dew,75,100,25,1,00288,India
486435,2023-08-04,206,yakult,360,400,40,1,00288,India
486435,2023-08-04,213,bisleri,6,15,9,1,00288,India
226131,2023-08-04,202,milk,12,27,15,1,00325,India
226131,2023-08-04,205,classic yogurt,45,60,15,1,00325,India
226131,2023-08-04,206,yakult,360,400,40,1,00325,India
226131,2023-08-04,208,sprite,75,100,25,1,00325,India
226131,2023-08-04,203,mango yogurt,50,60,10,1,00325,India
266192,2023-08-04,204,strawberry yogurt,50,60,10,1,00299,India
266192,2023-08-04,212,amul cheese,250,315,65,1,00299,India
266192,2023-08-04,203,mango yogurt,50,60,10,1,00299,India
266192,2023-08-04,207,coca cola,75,100,25,1,00299,India
266192,2023-08-04,209,pepsi,75,100,25,1,00299,India
306882,2023-08-04,204,strawberry yogurt,50,60,10,1,00175,India
450227,2023-08-04,206,yakult,360,400,40,1,00099,India
450227,2023-08-04,212,amul cheese,250,315,65,1,00099,India
450227,2023-08-04,210,mountain dew,75,100,25,1,00099,India
450227,2023-08-04,211,red bull,90,125,35,1,00099,India
454178,2023-08-04,202,milk,12,27,15,1,00169,India
454178,2023-08-04,203,mango yogurt,50,60,10,1,00169,India
473644,2023-08-04,205,classic yogurt,45,60,15,1,00324,India
473644,2023-08-04,209,pepsi,75,100,25,1,00324,India
473644,2023-08-04,203,mango yogurt,50,60,10,1,00324,India
473644,2023-08-04,212,amul cheese,250,315,65,1,00324,India
473644,2023-08-04,211,red bull,90,125,35,1,00324,India
213340,2023-08-04,205,classic yogurt,45,60,15,1,00388,India
599986,2023-08-04,202,milk,12,27,15,1,00112,India
599986,2023-08-04,207,coca cola,75,100,25,1,00112,India
599986,2023-08-04,213,bisleri,6,15,9,1,00112,India
780236,2023-08-04,211,red bull,90,125,35,1,00010,India
780236,2023-08-04,202,milk,12,27,15,1,00010,India
560169,2023-08-04,208,sprite,75,100,25,1,00213,India
560169,2023-08-04,209,pepsi,75,100,25,1,00213,India
523666,2023-08-04,213,bisleri,6,15,9,1,00421,India
694922,2023-08-04,210,mountain dew,75,100,25,1,00134,India
694922,2023-08-04,213,bisleri,6,15,9,1,00134,India
694922,2023-08-04,204,strawberry yogurt,50,60,10,1,00134,India
694922,2023-08-04,211,red bull,90,125,35,1,00134,India
694922,2023-08-04,208,sprite,75,100,25,1,00134,India
646343,2023-08-04,211,red bull,90,125,35,1,00232,India
646343,2023-08-04,202,milk,12,27,15,1,00232,India
646343,2023-08-04,201,paneer,210,340,130,1,00232,India
571816,2023-08-04,206,yakult,360,400,40,1,00424,India
571816,2023-08-04,203,mango yogurt,50,60,10,1,00424,India
571816,2023-08-04,209,pepsi,75,100,25,1,00424,India
571816,2023-08-04,213,bisleri,6,15,9,1,00424,India
571816,2023-08-04,210,mountain dew,75,100,25,1,00424,India
328377,2023-08-05,207,coca cola,75,100,25,1,00408,India
328377,2023-08-05,213,bisleri,6,15,9,1,00408,India
328377,2023-08-05,206,yakult,360,400,40,1,00408,India
328377,2023-08-05,205,classic yogurt,45,60,15,1,00408,India
328377,2023-08-05,211,red bull,90,125,35,1,00408,India
764597,2023-08-05,210,mountain dew,75,100,25,1,00035,India
313199,2023-08-05,202,milk,12,27,15,1,00194,India
313199,2023-08-05,209,pepsi,75,100,25,1,00194,India
399768,2023-08-05,212,amul cheese,250,315,65,1,00250,India
399768,2023-08-05,203,mango yogurt,50,60,10,1,00250,India
598531,2023-08-05,204,strawberry yogurt,50,60,10,1,00233,India
598531,2023-08-05,205,classic yogurt,45,60,15,1,00233,India
598531,2023-08-05,201,paneer,210,340,130,1,00233,India
598531,2023-08-05,209,pepsi,75,100,25,1,00233,India
262776,2023-08-05,206,yakult,360,400,40,1,00358,India
262776,2023-08-05,205,classic yogurt,45,60,15,1,00358,India
879610,2023-08-05,206,yakult,360,400,40,1,00104,India
879610,2023-08-05,204,strawberry yogurt,50,60,10,1,00104,India
879610,2023-08-05,205,classic yogurt,45,60,15,1,00104,India
853128,2023-08-05,209,pepsi,75,100,25,1,00045,India
853128,2023-08-05,207,coca cola,75,100,25,1,00045,India
853128,2023-08-05,208,sprite,75,100,25,1,00045,India
130615,2023-08-05,204,strawberry yogurt,50,60,10,1,00343,India
130615,2023-08-05,203,mango yogurt,50,60,10,1,00343,India
130615,2023-08-05,205,classic yogurt,45,60,15,1,00343,India
212521,2023-08-05,208,sprite,75,100,25,1,00325,India
212521,2023-08-05,207,coca cola,75,100,25,1,00325,India
212521,2023-08-05,202,milk,12,27,15,1,00325,India
279640,2023-08-05,202,milk,12,27,15,1,00264,India
279640,2023-08-05,209,pepsi,75,100,25,1,00264,India
279640,2023-08-05,205,classic yogurt,45,60,15,1,00264,India
279640,2023-08-05,212,amul cheese,250,315,65,1,00264,India
439416,2023-08-05,208,sprite,75,100,25,1,00352,India
617780,2023-08-05,212,amul cheese,250,315,65,1,00435,India
617780,2023-08-05,211,red bull,90,125,35,1,00435,India
617780,2023-08-05,210,mountain dew,75,100,25,1,00435,India
617780,2023-08-05,209,pepsi,75,100,25,1,00435,India
617780,2023-08-05,213,bisleri,6,15,9,1,00435,India
105278,2023-08-05,209,pepsi,75,100,25,1,00327,India
177815,2023-08-05,208,sprite,75,100,25,1,00341,India
177815,2023-08-05,213,bisleri,6,15,9,1,00341,India
177815,2023-08-05,212,amul cheese,250,315,65,1,00341,India
269395,2023-08-05,212,amul cheese,250,315,65,1,00028,India
269395,2023-08-05,207,coca cola,75,100,25,1,00028,India
422693,2023-08-05,213,bisleri,6,15,9,1,00419,India
422693,2023-08-05,202,milk,12,27,15,1,00419,India
422693,2023-08-05,206,yakult,360,400,40,1,00419,India
422693,2023-08-05,207,coca cola,75,100,25,1,00419,India
422693,2023-08-05,210,mountain dew,75,100,25,1,00419,India
529003,2023-08-05,205,classic yogurt,45,60,15,1,00324,India
529003,2023-08-05,204,strawberry yogurt,50,60,10,1,00324,India
529003,2023-08-05,210,mountain dew,75,100,25,1,00324,India
529003,2023-08-05,206,yakult,360,400,40,1,00324,India
529003,2023-08-05,208,sprite,75,100,25,1,00324,India
155681,2023-08-05,207,coca cola,75,100,25,1,00011,India
902672,2023-08-05,211,red bull,90,125,35,1,00277,India
902672,2023-08-05,204,strawberry yogurt,50,60,10,1,00277,India
759422,2023-08-05,207,coca cola,75,100,25,1,00461,India
481140,2023-08-05,201,paneer,210,340,130,1,00114,India
444386,2023-08-05,211,red bull,90,125,35,1,00061,India
444386,2023-08-05,208,sprite,75,100,25,1,00061,India
786767,2023-08-05,202,milk,12,27,15,1,00280,India
786767,2023-08-05,211,red bull,90,125,35,1,00280,India
786767,2023-08-05,201,paneer,210,340,130,1,00280,India
786767,2023-08-05,213,bisleri,6,15,9,1,00280,India
786767,2023-08-05,210,mountain dew,75,100,25,1,00280,India
452284,2023-08-05,211,red bull,90,125,35,1,00166,India
452284,2023-08-05,201,paneer,210,340,130,1,00166,India
452284,2023-08-05,207,coca cola,75,100,25,1,00166,India
452284,2023-08-05,212,amul cheese,250,315,65,1,00166,India
519001,2023-08-05,206,yakult,360,400,40,1,00412,India
331507,2023-08-05,207,coca cola,75,100,25,1,00063,India
331507,2023-08-05,204,strawberry yogurt,50,60,10,1,00063,India
331507,2023-08-05,213,bisleri,6,15,9,1,00063,India
331507,2023-08-05,201,paneer,210,340,130,1,00063,India
103812,2023-08-05,209,pepsi,75,100,25,1,00485,India
103812,2023-08-05,213,bisleri,6,15,9,1,00485,India
103812,2023-08-05,204,strawberry yogurt,50,60,10,1,00485,India
548509,2023-08-05,208,sprite,75,100,25,1,00073,India
548509,2023-08-05,213,bisleri,6,15,9,1,00073,India
548509,2023-08-05,205,classic yogurt,45,60,15,1,00073,India
548509,2023-08-05,209,pepsi,75,100,25,1,00073,India
400434,2023-08-05,212,amul cheese,250,315,65,1,00156,India
400434,2023-08-05,208,sprite,75,100,25,1,00156,India
677456,2023-08-05,203,mango yogurt,50,60,10,1,00210,India
677456,2023-08-05,202,milk,12,27,15,1,00210,India
677456,2023-08-05,213,bisleri,6,15,9,1,00210,India
443730,2023-08-05,206,yakult,360,400,40,1,00156,India
443730,2023-08-05,201,paneer,210,340,130,1,00156,India
443730,2023-08-05,204,strawberry yogurt,50,60,10,1,00156,India
681325,2023-08-05,203,mango yogurt,50,60,10,1,00321,India
776815,2023-08-05,201,paneer,210,340,130,1,00159,India
776815,2023-08-05,208,sprite,75,100,25,1,00159,India
776815,2023-08-05,210,mountain dew,75,100,25,1,00159,India
132520,2023-08-05,208,sprite,75,100,25,1,00208,India
132520,2023-08-05,207,coca cola,75,100,25,1,00208,India
132520,2023-08-05,205,classic yogurt,45,60,15,1,00208,India
132520,2023-08-05,209,pepsi,75,100,25,1,00208,India
906051,2023-08-05,204,strawberry yogurt,50,60,10,1,00471,India
906051,2023-08-05,202,milk,12,27,15,1,00471,India
761570,2023-08-05,206,yakult,360,400,40,1,00270,India
761570,2023-08-05,210,mountain dew,75,100,25,1,00270,India
761570,2023-08-05,213,bisleri,6,15,9,1,00270,India
761570,2023-08-05,208,sprite,75,100,25,1,00270,India
653756,2023-08-05,209,pepsi,75,100,25,1,00232,India
653756,2023-08-05,213,bisleri,6,15,9,1,00232,India
653756,2023-08-05,202,milk,12,27,15,1,00232,India
653756,2023-08-05,205,classic yogurt,45,60,15,1,00232,India
779106,2023-08-05,212,amul cheese,250,315,65,1,00193,India
779106,2023-08-05,203,mango yogurt,50,60,10,1,00193,India
297470,2023-08-05,206,yakult,360,400,40,1,00035,India
297470,2023-08-05,203,mango yogurt,50,60,10,1,00035,India
297470,2023-08-05,212,amul cheese,250,315,65,1,00035,India
291619,2023-08-05,206,yakult,360,400,40,1,00301,India
291619,2023-08-05,201,paneer,210,340,130,1,00301,India
291619,2023-08-05,211,red bull,90,125,35,1,00301,India
291619,2023-08-05,205,classic yogurt,45,60,15,1,00301,India
291619,2023-08-05,203,mango yogurt,50,60,10,1,00301,India
244405,2023-08-05,212,amul cheese,250,315,65,1,00213,India
244405,2023-08-05,206,yakult,360,400,40,1,00213,India
867215,2023-08-05,206,yakult,360,400,40,1,00310,India
867215,2023-08-05,207,coca cola,75,100,25,1,00310,India
867215,2023-08-05,208,sprite,75,100,25,1,00310,India
867215,2023-08-05,202,milk,12,27,15,1,00310,India
601635,2023-08-05,211,red bull,90,125,35,1,00480,India
601635,2023-08-05,208,sprite,75,100,25,1,00480,India
516429,2023-08-05,208,sprite,75,100,25,1,00394,India
516429,2023-08-05,210,mountain dew,75,100,25,1,00394,India
516429,2023-08-05,211,red bull,90,125,35,1,00394,India
516429,2023-08-05,206,yakult,360,400,40,1,00394,India
516429,2023-08-05,201,paneer,210,340,130,1,00394,India
306772,2023-08-05,207,coca cola,75,100,25,1,00428,India
306772,2023-08-05,209,pepsi,75,100,25,1,00428,India
306772,2023-08-05,210,mountain dew,75,100,25,1,00428,India
306772,2023-08-05,201,paneer,210,340,130,1,00428,India
306772,2023-08-05,213,bisleri,6,15,9,1,00428,India
263600,2023-08-05,209,pepsi,75,100,25,1,00044,India
263600,2023-08-05,210,mountain dew,75,100,25,1,00044,India
227844,2023-08-05,209,pepsi,75,100,25,1,00420,India
227844,2023-08-05,205,classic yogurt,45,60,15,1,00420,India
276045,2023-08-05,202,milk,12,27,15,1,00437,India
276045,2023-08-05,211,red bull,90,125,35,1,00437,India
276045,2023-08-05,207,coca cola,75,100,25,1,00437,India
276045,2023-08-05,206,yakult,360,400,40,1,00437,India
530721,2023-08-05,207,coca cola,75,100,25,1,00137,India
530721,2023-08-05,205,classic yogurt,45,60,15,1,00137,India
530721,2023-08-05,204,strawberry yogurt,50,60,10,1,00137,India
920326,2023-08-05,207,coca cola,75,100,25,1,00235,India
920326,2023-08-05,205,classic yogurt,45,60,15,1,00235,India
920326,2023-08-05,209,pepsi,75,100,25,1,00235,India
638983,2023-08-05,213,bisleri,6,15,9,1,00470,India
638983,2023-08-05,209,pepsi,75,100,25,1,00470,India
624003,2023-08-05,209,pepsi,75,100,25,1,00277,India
624003,2023-08-05,208,sprite,75,100,25,1,00277,India
624003,2023-08-05,203,mango yogurt,50,60,10,1,00277,India
624003,2023-08-05,201,paneer,210,340,130,1,00277,India
113476,2023-08-05,206,yakult,360,400,40,1,00365,India
113476,2023-08-05,212,amul cheese,250,315,65,1,00365,India
113476,2023-08-05,209,pepsi,75,100,25,1,00365,India
113476,2023-08-05,203,mango yogurt,50,60,10,1,00365,India
113476,2023-08-05,210,mountain dew,75,100,25,1,00365,India
633581,2023-08-05,203,mango yogurt,50,60,10,1,00172,India
633581,2023-08-05,208,sprite,75,100,25,1,00172,India
633581,2023-08-05,210,mountain dew,75,100,25,1,00172,India
633581,2023-08-05,211,red bull,90,125,35,1,00172,India
633581,2023-08-05,213,bisleri,6,15,9,1,00172,India
124675,2023-08-05,211,red bull,90,125,35,1,00068,India
124675,2023-08-05,201,paneer,210,340,130,1,00068,India
674705,2023-08-05,212,amul cheese,250,315,65,1,00359,India
674705,2023-08-05,206,yakult,360,400,40,1,00359,India
658362,2023-08-05,204,strawberry yogurt,50,60,10,1,00060,India
658362,2023-08-05,213,bisleri,6,15,9,1,00060,India
675893,2023-08-05,208,sprite,75,100,25,1,00238,India
675893,2023-08-05,212,amul cheese,250,315,65,1,00238,India
675893,2023-08-05,205,classic yogurt,45,60,15,1,00238,India
912701,2023-08-05,208,sprite,75,100,25,1,00496,India
855146,2023-08-05,207,coca cola,75,100,25,1,00212,India
555358,2023-08-05,205,classic yogurt,45,60,15,1,00102,India
555358,2023-08-05,207,coca cola,75,100,25,1,00102,India
555358,2023-08-05,211,red bull,90,125,35,1,00102,India
527302,2023-08-05,201,paneer,210,340,130,1,00374,India
527302,2023-08-05,210,mountain dew,75,100,25,1,00374,India
527302,2023-08-05,204,strawberry yogurt,50,60,10,1,00374,India
982436,2023-08-05,206,yakult,360,400,40,1,00128,India
982436,2023-08-05,212,amul cheese,250,315,65,1,00128,India
644681,2023-08-05,207,coca cola,75,100,25,1,00420,India
948022,2023-08-05,213,bisleri,6,15,9,1,00186,India
330283,2023-08-05,212,amul cheese,250,315,65,1,00151,India
330283,2023-08-05,201,paneer,210,340,130,1,00151,India
330283,2023-08-05,205,classic yogurt,45,60,15,1,00151,India
547570,2023-08-05,206,yakult,360,400,40,1,00409,India
547570,2023-08-05,212,amul cheese,250,315,65,1,00409,India
547570,2023-08-05,204,strawberry yogurt,50,60,10,1,00409,India
547570,2023-08-05,211,red bull,90,125,35,1,00409,India
350692,2023-08-05,202,milk,12,27,15,1,00130,India
297416,2023-08-05,206,yakult,360,400,40,1,00462,India
195283,2023-08-05,203,mango yogurt,50,60,10,1,00240,India
195283,2023-08-05,207,coca cola,75,100,25,1,00240,India
195283,2023-08-05,210,mountain dew,75,100,25,1,00240,India
195283,2023-08-05,201,paneer,210,340,130,1,00240,India
115863,2023-08-06,202,milk,12,27,15,1,00267,India
115863,2023-08-06,209,pepsi,75,100,25,1,00267,India
115863,2023-08-06,207,coca cola,75,100,25,1,00267,India
391468,2023-08-06,207,coca cola,75,100,25,1,00384,India
391468,2023-08-06,206,yakult,360,400,40,1,00384,India
391468,2023-08-06,213,bisleri,6,15,9,1,00384,India
219419,2023-08-06,204,strawberry yogurt,50,60,10,1,00218,India
219419,2023-08-06,207,coca cola,75,100,25,1,00218,India
219419,2023-08-06,210,mountain dew,75,100,25,1,00218,India
219419,2023-08-06,206,yakult,360,400,40,1,00218,India
967498,2023-08-06,201,paneer,210,340,130,1,00193,India
967498,2023-08-06,206,yakult,360,400,40,1,00193,India
967498,2023-08-06,203,mango yogurt,50,60,10,1,00193,India
885592,2023-08-06,213,bisleri,6,15,9,1,00124,India
885592,2023-08-06,204,strawberry yogurt,50,60,10,1,00124,India
885592,2023-08-06,205,classic yogurt,45,60,15,1,00124,India
180587,2023-08-06,211,red bull,90,125,35,1,00209,India
180587,2023-08-06,210,mountain dew,75,100,25,1,00209,India
250570,2023-08-06,203,mango yogurt,50,60,10,1,00222,India
931887,2023-08-06,206,yakult,360,400,40,1,00001,India
931887,2023-08-06,203,mango yogurt,50,60,10,1,00001,India
931887,2023-08-06,207,coca cola,75,100,25,1,00001,India
965008,2023-08-06,208,sprite,75,100,25,1,00143,India
965008,2023-08-06,212,amul cheese,250,315,65,1,00143,India
965008,2023-08-06,205,classic yogurt,45,60,15,1,00143,India
810073,2023-08-06,203,mango yogurt,50,60,10,1,00461,India
810073,2023-08-06,212,amul cheese,250,315,65,1,00461,India
736853,2023-08-06,208,sprite,75,100,25,1,00317,India
736853,2023-08-06,204,strawberry yogurt,50,60,10,1,00317,India
736853,2023-08-06,209,pepsi,75,100,25,1,00317,India
736853,2023-08-06,212,amul cheese,250,315,65,1,00317,India
738042,2023-08-06,213,bisleri,6,15,9,1,00120,India
738042,2023-08-06,203,mango yogurt,50,60,10,1,00120,India
738042,2023-08-06,202,milk,12,27,15,1,00120,India
315360,2023-08-06,212,amul cheese,250,315,65,1,00347,India
315360,2023-08-06,213,bisleri,6,15,9,1,00347,India
925347,2023-08-06,213,bisleri,6,15,9,1,00313,India
925347,2023-08-06,201,paneer,210,340,130,1,00313,India
925347,2023-08-06,209,pepsi,75,100,25,1,00313,India
925347,2023-08-06,204,strawberry yogurt,50,60,10,1,00313,India
248959,2023-08-06,209,pepsi,75,100,25,1,00369,India
248959,2023-08-06,212,amul cheese,250,315,65,1,00369,India
941512,2023-08-06,207,coca cola,75,100,25,1,00378,India
941512,2023-08-06,211,red bull,90,125,35,1,00378,India
291665,2023-08-06,209,pepsi,75,100,25,1,00325,India
291665,2023-08-06,213,bisleri,6,15,9,1,00325,India
291665,2023-08-06,205,classic yogurt,45,60,15,1,00325,India
624085,2023-08-06,209,pepsi,75,100,25,1,00379,India
624085,2023-08-06,208,sprite,75,100,25,1,00379,India
624085,2023-08-06,201,paneer,210,340,130,1,00379,India
624085,2023-08-06,205,classic yogurt,45,60,15,1,00379,India
264969,2023-08-06,208,sprite,75,100,25,1,00396,India
320253,2023-08-06,203,mango yogurt,50,60,10,1,00034,India
320253,2023-08-06,205,classic yogurt,45,60,15,1,00034,India
231515,2023-08-06,202,milk,12,27,15,1,00143,India
596801,2023-08-06,202,milk,12,27,15,1,00256,India
596801,2023-08-06,204,strawberry yogurt,50,60,10,1,00256,India
596801,2023-08-06,211,red bull,90,125,35,1,00256,India
596801,2023-08-06,212,amul cheese,250,315,65,1,00256,India
149430,2023-08-06,211,red bull,90,125,35,1,00089,India
119429,2023-08-06,203,mango yogurt,50,60,10,1,00320,India
119429,2023-08-06,207,coca cola,75,100,25,1,00320,India
119429,2023-08-06,211,red bull,90,125,35,1,00320,India
119429,2023-08-06,213,bisleri,6,15,9,1,00320,India
805559,2023-08-06,211,red bull,90,125,35,1,00201,India
366118,2023-08-06,210,mountain dew,75,100,25,1,00093,India
366118,2023-08-06,208,sprite,75,100,25,1,00093,India
366118,2023-08-06,206,yakult,360,400,40,1,00093,India
979027,2023-08-06,212,amul cheese,250,315,65,1,00359,India
979027,2023-08-06,210,mountain dew,75,100,25,1,00359,India
979027,2023-08-06,205,classic yogurt,45,60,15,1,00359,India
422046,2023-08-06,204,strawberry yogurt,50,60,10,1,00475,India
422046,2023-08-06,203,mango yogurt,50,60,10,1,00475,India
124190,2023-08-06,208,sprite,75,100,25,1,00177,India
124190,2023-08-06,202,milk,12,27,15,1,00177,India
124190,2023-08-06,207,coca cola,75,100,25,1,00177,India
129027,2023-08-06,212,amul cheese,250,315,65,1,00235,India
129027,2023-08-06,205,classic yogurt,45,60,15,1,00235,India
963222,2023-08-06,202,milk,12,27,15,1,00220,India
963222,2023-08-06,207,coca cola,75,100,25,1,00220,India
963222,2023-08-06,213,bisleri,6,15,9,1,00220,India
963222,2023-08-06,210,mountain dew,75,100,25,1,00220,India
245458,2023-08-06,201,paneer,210,340,130,1,00427,India
245458,2023-08-06,207,coca cola,75,100,25,1,00427,India
245458,2023-08-06,213,bisleri,6,15,9,1,00427,India
141346,2023-08-06,205,classic yogurt,45,60,15,1,00259,India
141346,2023-08-06,202,milk,12,27,15,1,00259,India
141346,2023-08-06,206,yakult,360,400,40,1,00259,India
141346,2023-08-06,209,pepsi,75,100,25,1,00259,India
312786,2023-08-06,208,sprite,75,100,25,1,00407,India
312786,2023-08-06,213,bisleri,6,15,9,1,00407,India
289858,2023-08-06,207,coca cola,75,100,25,1,00444,India
289858,2023-08-06,202,milk,12,27,15,1,00444,India
289858,2023-08-06,212,amul cheese,250,315,65,1,00444,India
447419,2023-08-06,202,milk,12,27,15,1,00277,India
447419,2023-08-06,211,red bull,90,125,35,1,00277,India
447419,2023-08-06,207,coca cola,75,100,25,1,00277,India
447419,2023-08-06,205,classic yogurt,45,60,15,1,00277,India
222863,2023-08-06,201,paneer,210,340,130,1,00362,India
222863,2023-08-06,211,red bull,90,125,35,1,00362,India
352076,2023-08-06,201,paneer,210,340,130,1,00070,India
352076,2023-08-06,211,red bull,90,125,35,1,00070,India
352076,2023-08-06,206,yakult,360,400,40,1,00070,India
352076,2023-08-06,207,coca cola,75,100,25,1,00070,India
639195,2023-08-06,207,coca cola,75,100,25,1,00432,India
212971,2023-08-06,203,mango yogurt,50,60,10,1,00391,India
212971,2023-08-06,207,coca cola,75,100,25,1,00391,India
212971,2023-08-06,208,sprite,75,100,25,1,00391,India
681396,2023-08-06,213,bisleri,6,15,9,1,00120,India
171671,2023-08-06,208,sprite,75,100,25,1,00381,India
171671,2023-08-06,213,bisleri,6,15,9,1,00381,India
171671,2023-08-06,210,mountain dew,75,100,25,1,00381,India
171671,2023-08-06,211,red bull,90,125,35,1,00381,India
919390,2023-08-06,201,paneer,210,340,130,1,00230,India
919390,2023-08-06,206,yakult,360,400,40,1,00230,India
727218,2023-08-06,213,bisleri,6,15,9,1,00149,India
727218,2023-08-06,201,paneer,210,340,130,1,00149,India
727218,2023-08-06,212,amul cheese,250,315,65,1,00149,India
494321,2023-08-06,203,mango yogurt,50,60,10,1,00206,India
494321,2023-08-06,205,classic yogurt,45,60,15,1,00206,India
494321,2023-08-06,206,yakult,360,400,40,1,00206,India
807375,2023-08-06,204,strawberry yogurt,50,60,10,1,00263,India
807375,2023-08-06,209,pepsi,75,100,25,1,00263,India
807375,2023-08-06,203,mango yogurt,50,60,10,1,00263,India
134504,2023-08-06,203,mango yogurt,50,60,10,1,00095,India
134504,2023-08-06,202,milk,12,27,15,1,00095,India
134504,2023-08-06,211,red bull,90,125,35,1,00095,India
134504,2023-08-06,206,yakult,360,400,40,1,00095,India
134504,2023-08-06,209,pepsi,75,100,25,1,00095,India
677585,2023-08-06,213,bisleri,6,15,9,1,00463,India
677585,2023-08-06,202,milk,12,27,15,1,00463,India
677585,2023-08-06,204,strawberry yogurt,50,60,10,1,00463,India
342998,2023-08-06,211,red bull,90,125,35,1,00356,India
342998,2023-08-06,207,coca cola,75,100,25,1,00356,India
342998,2023-08-06,206,yakult,360,400,40,1,00356,India
342998,2023-08-06,203,mango yogurt,50,60,10,1,00356,India
342998,2023-08-06,212,amul cheese,250,315,65,1,00356,India
398795,2023-08-06,207,coca cola,75,100,25,1,00187,India
398795,2023-08-06,211,red bull,90,125,35,1,00187,India
398795,2023-08-06,210,mountain dew,75,100,25,1,00187,India
398795,2023-08-06,201,paneer,210,340,130,1,00187,India
466946,2023-08-06,203,mango yogurt,50,60,10,1,00469,India
466946,2023-08-06,213,bisleri,6,15,9,1,00469,India
466946,2023-08-06,207,coca cola,75,100,25,1,00469,India
466946,2023-08-06,201,paneer,210,340,130,1,00469,India
679437,2023-08-06,212,amul cheese,250,315,65,1,00476,India
679437,2023-08-06,213,bisleri,6,15,9,1,00476,India
679437,2023-08-06,204,strawberry yogurt,50,60,10,1,00476,India
679437,2023-08-06,202,milk,12,27,15,1,00476,India
699613,2023-08-06,213,bisleri,6,15,9,1,00215,India
699613,2023-08-06,203,mango yogurt,50,60,10,1,00215,India
699613,2023-08-06,212,amul cheese,250,315,65,1,00215,India
699613,2023-08-06,201,paneer,210,340,130,1,00215,India
699613,2023-08-06,211,red bull,90,125,35,1,00215,India
258516,2023-08-06,204,strawberry yogurt,50,60,10,1,00456,India
258516,2023-08-06,203,mango yogurt,50,60,10,1,00456,India
114058,2023-08-06,209,pepsi,75,100,25,1,00212,India
580079,2023-08-06,212,amul cheese,250,315,65,1,00297,India
148317,2023-08-06,203,mango yogurt,50,60,10,1,00185,India
205581,2023-08-06,204,strawberry yogurt,50,60,10,1,00201,India
205581,2023-08-06,209,pepsi,75,100,25,1,00201,India
205581,2023-08-06,207,coca cola,75,100,25,1,00201,India
205581,2023-08-06,210,mountain dew,75,100,25,1,00201,India
609376,2023-08-06,208,sprite,75,100,25,1,00232,India
609376,2023-08-06,213,bisleri,6,15,9,1,00232,India
609376,2023-08-06,204,strawberry yogurt,50,60,10,1,00232,India
914750,2023-08-06,206,yakult,360,400,40,1,00442,India
914750,2023-08-06,208,sprite,75,100,25,1,00442,India
914750,2023-08-06,212,amul cheese,250,315,65,1,00442,India
914750,2023-08-06,213,bisleri,6,15,9,1,00442,India
895226,2023-08-06,205,classic yogurt,45,60,15,1,00287,India
895226,2023-08-06,203,mango yogurt,50,60,10,1,00287,India
895226,2023-08-06,209,pepsi,75,100,25,1,00287,India
125021,2023-08-06,208,sprite,75,100,25,1,00043,India
125021,2023-08-06,206,yakult,360,400,40,1,00043,India
125021,2023-08-06,201,paneer,210,340,130,1,00043,India
298445,2023-08-06,204,strawberry yogurt,50,60,10,1,00071,India
298445,2023-08-06,209,pepsi,75,100,25,1,00071,India
298445,2023-08-06,206,yakult,360,400,40,1,00071,India
298445,2023-08-06,212,amul cheese,250,315,65,1,00071,India
986911,2023-08-06,203,mango yogurt,50,60,10,1,00483,India
650978,2023-08-06,209,pepsi,75,100,25,1,00024,India
650978,2023-08-06,202,milk,12,27,15,1,00024,India
589378,2023-08-07,201,paneer,210,340,130,1,00223,India
589378,2023-08-07,206,yakult,360,400,40,1,00223,India
589378,2023-08-07,208,sprite,75,100,25,1,00223,India
759369,2023-08-07,203,mango yogurt,50,60,10,1,00420,India
759369,2023-08-07,204,strawberry yogurt,50,60,10,1,00420,India
759369,2023-08-07,202,milk,12,27,15,1,00420,India
759369,2023-08-07,210,mountain dew,75,100,25,1,00420,India
945383,2023-08-07,212,amul cheese,250,315,65,1,00176,India
945383,2023-08-07,211,red bull,90,125,35,1,00176,India
945383,2023-08-07,204,strawberry yogurt,50,60,10,1,00176,India
945383,2023-08-07,209,pepsi,75,100,25,1,00176,India
149783,2023-08-07,204,strawberry yogurt,50,60,10,1,00030,India
149783,2023-08-07,203,mango yogurt,50,60,10,1,00030,India
149783,2023-08-07,209,pepsi,75,100,25,1,00030,India
444561,2023-08-07,209,pepsi,75,100,25,1,00275,India
444561,2023-08-07,207,coca cola,75,100,25,1,00275,India
829366,2023-08-07,213,bisleri,6,15,9,1,00375,India
829366,2023-08-07,208,sprite,75,100,25,1,00375,India
829366,2023-08-07,209,pepsi,75,100,25,1,00375,India
829366,2023-08-07,210,mountain dew,75,100,25,1,00375,India
829366,2023-08-07,203,mango yogurt,50,60,10,1,00375,India
838536,2023-08-07,204,strawberry yogurt,50,60,10,1,00395,India
838536,2023-08-07,206,yakult,360,400,40,1,00395,India
838536,2023-08-07,213,bisleri,6,15,9,1,00395,India
964670,2023-08-07,207,coca cola,75,100,25,1,00487,India
964670,2023-08-07,202,milk,12,27,15,1,00487,India
964670,2023-08-07,201,paneer,210,340,130,1,00487,India
964670,2023-08-07,210,mountain dew,75,100,25,1,00487,India
808822,2023-08-07,213,bisleri,6,15,9,1,00249,India
808822,2023-08-07,207,coca cola,75,100,25,1,00249,India
808822,2023-08-07,201,paneer,210,340,130,1,00249,India
261602,2023-08-07,208,sprite,75,100,25,1,00164,India
261602,2023-08-07,206,yakult,360,400,40,1,00164,India
261602,2023-08-07,210,mountain dew,75,100,25,1,00164,India
261602,2023-08-07,205,classic yogurt,45,60,15,1,00164,India
390044,2023-08-07,205,classic yogurt,45,60,15,1,00241,India
171160,2023-08-07,213,bisleri,6,15,9,1,00395,India
171160,2023-08-07,202,milk,12,27,15,1,00395,India
171160,2023-08-07,203,mango yogurt,50,60,10,1,00395,India
171160,2023-08-07,211,red bull,90,125,35,1,00395,India
979685,2023-08-07,203,mango yogurt,50,60,10,1,00494,India
979685,2023-08-07,207,coca cola,75,100,25,1,00494,India
979685,2023-08-07,212,amul cheese,250,315,65,1,00494,India
805633,2023-08-07,208,sprite,75,100,25,1,00474,India
805633,2023-08-07,205,classic yogurt,45,60,15,1,00474,India
805633,2023-08-07,202,milk,12,27,15,1,00474,India
754300,2023-08-07,210,mountain dew,75,100,25,1,00239,India
754300,2023-08-07,206,yakult,360,400,40,1,00239,India
754300,2023-08-07,213,bisleri,6,15,9,1,00239,India
754300,2023-08-07,203,mango yogurt,50,60,10,1,00239,India
664295,2023-08-07,212,amul cheese,250,315,65,1,00236,India
664295,2023-08-07,201,paneer,210,340,130,1,00236,India
664295,2023-08-07,208,sprite,75,100,25,1,00236,India
664295,2023-08-07,203,mango yogurt,50,60,10,1,00236,India
664295,2023-08-07,211,red bull,90,125,35,1,00236,India
899083,2023-08-07,213,bisleri,6,15,9,1,00438,India
899083,2023-08-07,206,yakult,360,400,40,1,00438,India
863415,2023-08-07,211,red bull,90,125,35,1,00368,India
760017,2023-08-07,207,coca cola,75,100,25,1,00320,India
760017,2023-08-07,212,amul cheese,250,315,65,1,00320,India
760017,2023-08-07,204,strawberry yogurt,50,60,10,1,00320,India
760017,2023-08-07,213,bisleri,6,15,9,1,00320,India
368930,2023-08-07,207,coca cola,75,100,25,1,00005,India
368930,2023-08-07,203,mango yogurt,50,60,10,1,00005,India
368930,2023-08-07,209,pepsi,75,100,25,1,00005,India
406602,2023-08-07,211,red bull,90,125,35,1,00359,India
406602,2023-08-07,202,milk,12,27,15,1,00359,India
406602,2023-08-07,208,sprite,75,100,25,1,00359,India
193588,2023-08-07,208,sprite,75,100,25,1,00093,India
193588,2023-08-07,205,classic yogurt,45,60,15,1,00093,India
651088,2023-08-07,213,bisleri,6,15,9,1,00335,India
651088,2023-08-07,202,milk,12,27,15,1,00335,India
651088,2023-08-07,205,classic yogurt,45,60,15,1,00335,India
108297,2023-08-07,202,milk,12,27,15,1,00232,India
108297,2023-08-07,204,strawberry yogurt,50,60,10,1,00232,India
316510,2023-08-07,209,pepsi,75,100,25,1,00225,India
316510,2023-08-07,205,classic yogurt,45,60,15,1,00225,India
316510,2023-08-07,212,amul cheese,250,315,65,1,00225,India
648133,2023-08-07,206,yakult,360,400,40,1,00271,India
648133,2023-08-07,205,classic yogurt,45,60,15,1,00271,India
648133,2023-08-07,208,sprite,75,100,25,1,00271,India
437703,2023-08-07,208,sprite,75,100,25,1,00151,India
437703,2023-08-07,203,mango yogurt,50,60,10,1,00151,India
437703,2023-08-07,209,pepsi,75,100,25,1,00151,India
437703,2023-08-07,201,paneer,210,340,130,1,00151,India
954294,2023-08-07,209,pepsi,75,100,25,1,00367,India
449561,2023-08-07,210,mountain dew,75,100,25,1,00270,India
449561,2023-08-07,212,amul cheese,250,315,65,1,00270,India
449561,2023-08-07,213,bisleri,6,15,9,1,00270,India
449561,2023-08-07,209,pepsi,75,100,25,1,00270,India
449561,2023-08-07,201,paneer,210,340,130,1,00270,India
965187,2023-08-07,201,paneer,210,340,130,1,00329,India
965187,2023-08-07,205,classic yogurt,45,60,15,1,00329,India
965187,2023-08-07,210,mountain dew,75,100,25,1,00329,India
965187,2023-08-07,213,bisleri,6,15,9,1,00329,India
194916,2023-08-07,208,sprite,75,100,25,1,00415,India
194916,2023-08-07,206,yakult,360,400,40,1,00415,India
194916,2023-08-07,204,strawberry yogurt,50,60,10,1,00415,India
194916,2023-08-07,207,coca cola,75,100,25,1,00415,India
633109,2023-08-07,212,amul cheese,250,315,65,1,00058,India
633109,2023-08-07,208,sprite,75,100,25,1,00058,India
633109,2023-08-07,209,pepsi,75,100,25,1,00058,India
838417,2023-08-07,202,milk,12,27,15,1,00314,India
838417,2023-08-07,210,mountain dew,75,100,25,1,00314,India
838417,2023-08-07,206,yakult,360,400,40,1,00314,India
778776,2023-08-07,212,amul cheese,250,315,65,1,00039,India
461348,2023-08-07,205,classic yogurt,45,60,15,1,00488,India
461348,2023-08-07,207,coca cola,75,100,25,1,00488,India
780746,2023-08-07,208,sprite,75,100,25,1,00085,India
780746,2023-08-07,213,bisleri,6,15,9,1,00085,India
780746,2023-08-07,202,milk,12,27,15,1,00085,India
780746,2023-08-07,201,paneer,210,340,130,1,00085,India
780746,2023-08-07,204,strawberry yogurt,50,60,10,1,00085,India
834819,2023-08-07,211,red bull,90,125,35,1,00034,India
834819,2023-08-07,201,paneer,210,340,130,1,00034,India
834819,2023-08-07,207,coca cola,75,100,25,1,00034,India
834819,2023-08-07,206,yakult,360,400,40,1,00034,India
672698,2023-08-07,204,strawberry yogurt,50,60,10,1,00069,India
672698,2023-08-07,213,bisleri,6,15,9,1,00069,India
672698,2023-08-07,211,red bull,90,125,35,1,00069,India
774929,2023-08-07,209,pepsi,75,100,25,1,00086,India
774929,2023-08-07,202,milk,12,27,15,1,00086,India
774929,2023-08-07,208,sprite,75,100,25,1,00086,India
335354,2023-08-07,213,bisleri,6,15,9,1,00041,India
335354,2023-08-07,209,pepsi,75,100,25,1,00041,India
335354,2023-08-07,210,mountain dew,75,100,25,1,00041,India
919042,2023-08-07,201,paneer,210,340,130,1,00250,India
919042,2023-08-07,202,milk,12,27,15,1,00250,India
919042,2023-08-07,211,red bull,90,125,35,1,00250,India
742261,2023-08-07,207,coca cola,75,100,25,1,00084,India
742261,2023-08-07,208,sprite,75,100,25,1,00084,India
742261,2023-08-07,205,classic yogurt,45,60,15,1,00084,India
742261,2023-08-07,212,amul cheese,250,315,65,1,00084,India
991201,2023-08-07,213,bisleri,6,15,9,1,00261,India
991201,2023-08-07,203,mango yogurt,50,60,10,1,00261,India
991201,2023-08-07,211,red bull,90,125,35,1,00261,India
991201,2023-08-07,201,paneer,210,340,130,1,00261,India
872743,2023-08-07,203,mango yogurt,50,60,10,1,00245,India
872743,2023-08-07,209,pepsi,75,100,25,1,00245,India
872743,2023-08-07,206,yakult,360,400,40,1,00245,India
872743,2023-08-07,207,coca cola,75,100,25,1,00245,India
872743,2023-08-07,208,sprite,75,100,25,1,00245,India
346776,2023-08-07,206,yakult,360,400,40,1,00497,India
346776,2023-08-07,212,amul cheese,250,315,65,1,00497,India
346776,2023-08-07,203,mango yogurt,50,60,10,1,00497,India
278241,2023-08-07,207,coca cola,75,100,25,1,00487,India
278241,2023-08-07,201,paneer,210,340,130,1,00487,India
278241,2023-08-07,202,milk,12,27,15,1,00487,India
353230,2023-08-07,201,paneer,210,340,130,1,00321,India
353230,2023-08-07,208,sprite,75,100,25,1,00321,India
779601,2023-08-07,211,red bull,90,125,35,1,00449,India
520991,2023-08-07,211,red bull,90,125,35,1,00094,India
274032,2023-08-07,211,red bull,90,125,35,1,00451,India
274032,2023-08-07,203,mango yogurt,50,60,10,1,00451,India
274032,2023-08-07,207,coca cola,75,100,25,1,00451,India
638793,2023-08-07,203,mango yogurt,50,60,10,1,00350,India
638793,2023-08-07,201,paneer,210,340,130,1,00350,India
638793,2023-08-07,207,coca cola,75,100,25,1,00350,India
638793,2023-08-07,204,strawberry yogurt,50,60,10,1,00350,India
638263,2023-08-07,206,yakult,360,400,40,1,00472,India
642689,2023-08-07,212,amul cheese,250,315,65,1,00233,India
642689,2023-08-07,203,mango yogurt,50,60,10,1,00233,India
642689,2023-08-07,210,mountain dew,75,100,25,1,00233,India
642689,2023-08-07,209,pepsi,75,100,25,1,00233,India
908928,2023-08-07,209,pepsi,75,100,25,1,00257,India
264564,2023-08-07,206,yakult,360,400,40,1,00261,India
130537,2023-08-07,203,mango yogurt,50,60,10,1,00445,India
130537,2023-08-07,211,red bull,90,125,35,1,00445,India
130537,2023-08-07,202,milk,12,27,15,1,00445,India
130537,2023-08-07,204,strawberry yogurt,50,60,10,1,00445,India
130537,2023-08-07,205,classic yogurt,45,60,15,1,00445,India
670948,2023-08-07,209,pepsi,75,100,25,1,00312,India
125780,2023-08-07,203,mango yogurt,50,60,10,1,00404,India
125780,2023-08-07,212,amul cheese,250,315,65,1,00404,India
125780,2023-08-07,206,yakult,360,400,40,1,00404,India
172024,2023-08-07,206,yakult,360,400,40,1,00335,India
172024,2023-08-07,208,sprite,75,100,25,1,00335,India
172024,2023-08-07,213,bisleri,6,15,9,1,00335,India
127194,2023-08-07,203,mango yogurt,50,60,10,1,00141,India
127194,2023-08-07,208,sprite,75,100,25,1,00141,India
127194,2023-08-07,202,milk,12,27,15,1,00141,India
127194,2023-08-07,207,coca cola,75,100,25,1,00141,India
127194,2023-08-07,204,strawberry yogurt,50,60,10,1,00141,India
894692,2023-08-07,209,pepsi,75,100,25,1,00231,India
894692,2023-08-07,201,paneer,210,340,130,1,00231,India
894692,2023-08-07,207,coca cola,75,100,25,1,00231,India
894692,2023-08-07,205,classic yogurt,45,60,15,1,00231,India
894692,2023-08-07,208,sprite,75,100,25,1,00231,India
210743,2023-08-07,203,mango yogurt,50,60,10,1,00073,India
210743,2023-08-07,205,classic yogurt,45,60,15,1,00073,India
210743,2023-08-07,209,pepsi,75,100,25,1,00073,India
668928,2023-08-07,210,mountain dew,75,100,25,1,00324,India
668928,2023-08-07,208,sprite,75,100,25,1,00324,India
368420,2023-08-07,201,paneer,210,340,130,1,00129,India
368420,2023-08-07,210,mountain dew,75,100,25,1,00129,India
368420,2023-08-07,212,amul cheese,250,315,65,1,00129,India
368420,2023-08-07,203,mango yogurt,50,60,10,1,00129,India
102455,2023-08-07,202,milk,12,27,15,1,00282,India
102455,2023-08-07,210,mountain dew,75,100,25,1,00282,India
968360,2023-08-07,201,paneer,210,340,130,1,00066,India
968360,2023-08-07,202,milk,12,27,15,1,00066,India
663580,2023-08-07,209,pepsi,75,100,25,1,00124,India
663580,2023-08-07,210,mountain dew,75,100,25,1,00124,India
170681,2023-08-07,203,mango yogurt,50,60,10,1,00066,India
969171,2023-08-07,205,classic yogurt,45,60,15,1,00231,India
224133,2023-08-07,203,mango yogurt,50,60,10,1,00228,India
118235,2023-08-08,202,milk,12,27,15,1,00411,India
118235,2023-08-08,208,sprite,75,100,25,1,00411,India
118235,2023-08-08,212,amul cheese,250,315,65,1,00411,India
118235,2023-08-08,210,mountain dew,75,100,25,1,00411,India
775274,2023-08-08,211,red bull,90,125,35,1,00074,India
318939,2023-08-08,210,mountain dew,75,100,25,1,00176,India
318939,2023-08-08,212,amul cheese,250,315,65,1,00176,India
318939,2023-08-08,211,red bull,90,125,35,1,00176,India
409847,2023-08-08,203,mango yogurt,50,60,10,1,00368,India
409847,2023-08-08,206,yakult,360,400,40,1,00368,India
200640,2023-08-08,209,pepsi,75,100,25,1,00145,India
200640,2023-08-08,204,strawberry yogurt,50,60,10,1,00145,India
200640,2023-08-08,210,mountain dew,75,100,25,1,00145,India
535715,2023-08-08,212,amul cheese,250,315,65,1,00127,India
106378,2023-08-08,207,coca cola,75,100,25,1,00451,India
106378,2023-08-08,205,classic yogurt,45,60,15,1,00451,India
539416,2023-08-08,209,pepsi,75,100,25,1,00444,India
539416,2023-08-08,201,paneer,210,340,130,1,00444,India
539416,2023-08-08,208,sprite,75,100,25,1,00444,India
485989,2023-08-08,213,bisleri,6,15,9,1,00358,India
485989,2023-08-08,209,pepsi,75,100,25,1,00358,India
932265,2023-08-08,203,mango yogurt,50,60,10,1,00414,India
200705,2023-08-08,209,pepsi,75,100,25,1,00123,India
200705,2023-08-08,207,coca cola,75,100,25,1,00123,India
200705,2023-08-08,208,sprite,75,100,25,1,00123,India
200705,2023-08-08,213,bisleri,6,15,9,1,00123,India
830071,2023-08-08,203,mango yogurt,50,60,10,1,00254,India
830071,2023-08-08,207,coca cola,75,100,25,1,00254,India
830071,2023-08-08,213,bisleri,6,15,9,1,00254,India
263334,2023-08-08,211,red bull,90,125,35,1,00258,India
263334,2023-08-08,207,coca cola,75,100,25,1,00258,India
326339,2023-08-08,204,strawberry yogurt,50,60,10,1,00050,India
588303,2023-08-08,211,red bull,90,125,35,1,00052,India
588303,2023-08-08,213,bisleri,6,15,9,1,00052,India
467200,2023-08-08,201,paneer,210,340,130,1,00058,India
467200,2023-08-08,209,pepsi,75,100,25,1,00058,India
805162,2023-08-08,207,coca cola,75,100,25,1,00290,India
805162,2023-08-08,213,bisleri,6,15,9,1,00290,India
805162,2023-08-08,203,mango yogurt,50,60,10,1,00290,India
805162,2023-08-08,209,pepsi,75,100,25,1,00290,India
358594,2023-08-08,211,red bull,90,125,35,1,00188,India
358594,2023-08-08,202,milk,12,27,15,1,00188,India
758058,2023-08-08,210,mountain dew,75,100,25,1,00150,India
758058,2023-08-08,205,classic yogurt,45,60,15,1,00150,India
758058,2023-08-08,213,bisleri,6,15,9,1,00150,India
758058,2023-08-08,206,yakult,360,400,40,1,00150,India
758058,2023-08-08,204,strawberry yogurt,50,60,10,1,00150,India
503933,2023-08-08,209,pepsi,75,100,25,1,00049,India
503933,2023-08-08,202,milk,12,27,15,1,00049,India
423440,2023-08-08,209,pepsi,75,100,25,1,00396,India
423440,2023-08-08,206,yakult,360,400,40,1,00396,India
721772,2023-08-08,202,milk,12,27,15,1,00276,India
721772,2023-08-08,203,mango yogurt,50,60,10,1,00276,India
721772,2023-08-08,204,strawberry yogurt,50,60,10,1,00276,India
990841,2023-08-08,213,bisleri,6,15,9,1,00101,India
990841,2023-08-08,202,milk,12,27,15,1,00101,India
990841,2023-08-08,203,mango yogurt,50,60,10,1,00101,India
703376,2023-08-08,207,coca cola,75,100,25,1,00305,India
703376,2023-08-08,210,mountain dew,75,100,25,1,00305,India
258602,2023-08-08,212,amul cheese,250,315,65,1,00449,India
258602,2023-08-08,203,mango yogurt,50,60,10,1,00449,India
258602,2023-08-08,208,sprite,75,100,25,1,00449,India
258602,2023-08-08,206,yakult,360,400,40,1,00449,India
258602,2023-08-08,204,strawberry yogurt,50,60,10,1,00449,India
309033,2023-08-08,206,yakult,360,400,40,1,00207,India
309033,2023-08-08,207,coca cola,75,100,25,1,00207,India
309033,2023-08-08,211,red bull,90,125,35,1,00207,India
521132,2023-08-08,212,amul cheese,250,315,65,1,00174,India
521132,2023-08-08,205,classic yogurt,45,60,15,1,00174,India
521132,2023-08-08,201,paneer,210,340,130,1,00174,India
521132,2023-08-08,207,coca cola,75,100,25,1,00174,India
168440,2023-08-08,213,bisleri,6,15,9,1,00401,India
168440,2023-08-08,207,coca cola,75,100,25,1,00401,India
168440,2023-08-08,206,yakult,360,400,40,1,00401,India
956769,2023-08-08,208,sprite,75,100,25,1,00141,India
956769,2023-08-08,205,classic yogurt,45,60,15,1,00141,India
221434,2023-08-08,207,coca cola,75,100,25,1,00363,India
221434,2023-08-08,208,sprite,75,100,25,1,00363,India
221434,2023-08-08,202,milk,12,27,15,1,00363,India
221434,2023-08-08,204,strawberry yogurt,50,60,10,1,00363,India
695173,2023-08-08,201,paneer,210,340,130,1,00484,India
695173,2023-08-08,211,red bull,90,125,35,1,00484,India
701240,2023-08-08,206,yakult,360,400,40,1,00165,India
701240,2023-08-08,203,mango yogurt,50,60,10,1,00165,India
701240,2023-08-08,205,classic yogurt,45,60,15,1,00165,India
909463,2023-08-08,208,sprite,75,100,25,1,00436,India
909463,2023-08-08,213,bisleri,6,15,9,1,00436,India
909463,2023-08-08,207,coca cola,75,100,25,1,00436,India
909463,2023-08-08,209,pepsi,75,100,25,1,00436,India
492390,2023-08-08,206,yakult,360,400,40,1,00161,India
492390,2023-08-08,205,classic yogurt,45,60,15,1,00161,India
492390,2023-08-08,204,strawberry yogurt,50,60,10,1,00161,India
467926,2023-08-08,208,sprite,75,100,25,1,00333,India
250421,2023-08-08,207,coca cola,75,100,25,1,00481,India
250421,2023-08-08,213,bisleri,6,15,9,1,00481,India
542874,2023-08-08,204,strawberry yogurt,50,60,10,1,00183,India
141509,2023-08-08,203,mango yogurt,50,60,10,1,00446,India
141509,2023-08-08,206,yakult,360,400,40,1,00446,India
141509,2023-08-08,202,milk,12,27,15,1,00446,India
141509,2023-08-08,201,paneer,210,340,130,1,00446,India
343746,2023-08-08,204,strawberry yogurt,50,60,10,1,00380,India
343746,2023-08-08,205,classic yogurt,45,60,15,1,00380,India
343746,2023-08-08,212,amul cheese,250,315,65,1,00380,India
394410,2023-08-08,206,yakult,360,400,40,1,00384,India
394410,2023-08-08,201,paneer,210,340,130,1,00384,India
394410,2023-08-08,208,sprite,75,100,25,1,00384,India
394410,2023-08-08,205,classic yogurt,45,60,15,1,00384,India
394410,2023-08-08,202,milk,12,27,15,1,00384,India
425894,2023-08-08,208,sprite,75,100,25,1,00036,India
425894,2023-08-08,209,pepsi,75,100,25,1,00036,India
425894,2023-08-08,205,classic yogurt,45,60,15,1,00036,India
425894,2023-08-08,212,amul cheese,250,315,65,1,00036,India
425894,2023-08-08,203,mango yogurt,50,60,10,1,00036,India
755499,2023-08-08,202,milk,12,27,15,1,00242,India
755499,2023-08-08,212,amul cheese,250,315,65,1,00242,India
681371,2023-08-08,211,red bull,90,125,35,1,00331,India
681371,2023-08-08,206,yakult,360,400,40,1,00331,India
681371,2023-08-08,205,classic yogurt,45,60,15,1,00331,India
681371,2023-08-08,212,amul cheese,250,315,65,1,00331,India
755813,2023-08-08,204,strawberry yogurt,50,60,10,1,00161,India
755813,2023-08-08,203,mango yogurt,50,60,10,1,00161,India
755813,2023-08-08,208,sprite,75,100,25,1,00161,India
755813,2023-08-08,211,red bull,90,125,35,1,00161,India
836731,2023-08-08,207,coca cola,75,100,25,1,00327,India
836731,2023-08-08,203,mango yogurt,50,60,10,1,00327,India
836731,2023-08-08,204,strawberry yogurt,50,60,10,1,00327,India
908503,2023-08-08,207,coca cola,75,100,25,1,00359,India
908503,2023-08-08,211,red bull,90,125,35,1,00359,India
908503,2023-08-08,202,milk,12,27,15,1,00359,India
235501,2023-08-08,211,red bull,90,125,35,1,00318,India
163221,2023-08-08,212,amul cheese,250,315,65,1,00129,India
975181,2023-08-08,202,milk,12,27,15,1,00136,India
975181,2023-08-08,208,sprite,75,100,25,1,00136,India
174176,2023-08-08,203,mango yogurt,50,60,10,1,00076,India
174176,2023-08-08,207,coca cola,75,100,25,1,00076,India
174176,2023-08-08,204,strawberry yogurt,50,60,10,1,00076,India
174176,2023-08-08,212,amul cheese,250,315,65,1,00076,India
174176,2023-08-08,202,milk,12,27,15,1,00076,India
635021,2023-08-08,206,yakult,360,400,40,1,00413,India
635021,2023-08-08,213,bisleri,6,15,9,1,00413,India
421454,2023-08-08,205,classic yogurt,45,60,15,1,00305,India
421454,2023-08-08,211,red bull,90,125,35,1,00305,India
421454,2023-08-08,201,paneer,210,340,130,1,00305,India
232065,2023-08-08,212,amul cheese,250,315,65,1,00042,India
232065,2023-08-08,211,red bull,90,125,35,1,00042,India
535246,2023-08-08,201,paneer,210,340,130,1,00222,India
535246,2023-08-08,202,milk,12,27,15,1,00222,India
535246,2023-08-08,205,classic yogurt,45,60,15,1,00222,India
535246,2023-08-08,213,bisleri,6,15,9,1,00222,India
289516,2023-08-08,206,yakult,360,400,40,1,00297,India
289516,2023-08-08,205,classic yogurt,45,60,15,1,00297,India
289516,2023-08-08,207,coca cola,75,100,25,1,00297,India
289516,2023-08-08,212,amul cheese,250,315,65,1,00297,India
289516,2023-08-08,203,mango yogurt,50,60,10,1,00297,India
807442,2023-08-08,213,bisleri,6,15,9,1,00029,India
807442,2023-08-08,205,classic yogurt,45,60,15,1,00029,India
807442,2023-08-08,203,mango yogurt,50,60,10,1,00029,India
807442,2023-08-08,208,sprite,75,100,25,1,00029,India
749434,2023-08-08,203,mango yogurt,50,60,10,1,00416,India
749434,2023-08-08,210,mountain dew,75,100,25,1,00416,India
930312,2023-08-08,203,mango yogurt,50,60,10,1,00018,India
930312,2023-08-08,210,mountain dew,75,100,25,1,00018,India
760402,2023-08-08,207,coca cola,75,100,25,1,00422,India
760402,2023-08-08,206,yakult,360,400,40,1,00422,India
654532,2023-08-08,208,sprite,75,100,25,1,00338,India
654532,2023-08-08,207,coca cola,75,100,25,1,00338,India
654532,2023-08-08,201,paneer,210,340,130,1,00338,India
654532,2023-08-08,212,amul cheese,250,315,65,1,00338,India
313913,2023-08-08,210,mountain dew,75,100,25,1,00236,India
313913,2023-08-08,202,milk,12,27,15,1,00236,India
313913,2023-08-08,211,red bull,90,125,35,1,00236,India
313913,2023-08-08,204,strawberry yogurt,50,60,10,1,00236,India
674635,2023-08-08,211,red bull,90,125,35,1,00497,India
674635,2023-08-08,208,sprite,75,100,25,1,00497,India
674635,2023-08-08,205,classic yogurt,45,60,15,1,00497,India
674635,2023-08-08,212,amul cheese,250,315,65,1,00497,India
669002,2023-08-08,206,yakult,360,400,40,1,00178,India
669002,2023-08-08,207,coca cola,75,100,25,1,00178,India
669002,2023-08-08,204,strawberry yogurt,50,60,10,1,00178,India
604604,2023-08-08,204,strawberry yogurt,50,60,10,1,00438,India
309040,2023-08-08,206,yakult,360,400,40,1,00099,India
309040,2023-08-08,207,coca cola,75,100,25,1,00099,India
309040,2023-08-08,209,pepsi,75,100,25,1,00099,India
606589,2023-08-08,206,yakult,360,400,40,1,00425,India
606589,2023-08-08,204,strawberry yogurt,50,60,10,1,00425,India
606589,2023-08-08,213,bisleri,6,15,9,1,00425,India
606589,2023-08-08,211,red bull,90,125,35,1,00425,India
408662,2023-08-08,204,strawberry yogurt,50,60,10,1,00200,India
408662,2023-08-08,207,coca cola,75,100,25,1,00200,India
408662,2023-08-08,210,mountain dew,75,100,25,1,00200,India
459628,2023-08-08,205,classic yogurt,45,60,15,1,00437,India
459628,2023-08-08,202,milk,12,27,15,1,00437,India
459628,2023-08-08,213,bisleri,6,15,9,1,00437,India
446598,2023-08-08,206,yakult,360,400,40,1,00425,India
446598,2023-08-08,201,paneer,210,340,130,1,00425,India
446598,2023-08-08,204,strawberry yogurt,50,60,10,1,00425,India
904201,2023-08-08,203,mango yogurt,50,60,10,1,00312,India
904201,2023-08-08,209,pepsi,75,100,25,1,00312,India
904201,2023-08-08,202,milk,12,27,15,1,00312,India
912818,2023-08-08,203,mango yogurt,50,60,10,1,00478,India
912818,2023-08-08,208,sprite,75,100,25,1,00478,India
912818,2023-08-08,204,strawberry yogurt,50,60,10,1,00478,India
912818,2023-08-08,212,amul cheese,250,315,65,1,00478,India
227964,2023-08-08,204,strawberry yogurt,50,60,10,1,00402,India
227964,2023-08-08,206,yakult,360,400,40,1,00402,India
672111,2023-08-08,205,classic yogurt,45,60,15,1,00155,India
672111,2023-08-08,208,sprite,75,100,25,1,00155,India
377193,2023-08-08,201,paneer,210,340,130,1,00429,India
377193,2023-08-08,203,mango yogurt,50,60,10,1,00429,India
377193,2023-08-08,202,milk,12,27,15,1,00429,India
377193,2023-08-08,212,amul cheese,250,315,65,1,00429,India
612157,2023-08-08,210,mountain dew,75,100,25,1,00077,India
612157,2023-08-08,204,strawberry yogurt,50,60,10,1,00077,India
612157,2023-08-08,203,mango yogurt,50,60,10,1,00077,India
612157,2023-08-08,212,amul cheese,250,315,65,1,00077,India
844351,2023-08-08,213,bisleri,6,15,9,1,00318,India
844351,2023-08-08,210,mountain dew,75,100,25,1,00318,India
486344,2023-08-08,209,pepsi,75,100,25,1,00388,India
486344,2023-08-08,211,red bull,90,125,35,1,00388,India
486344,2023-08-08,202,milk,12,27,15,1,00388,India
629229,2023-08-09,206,yakult,360,400,40,1,00360,India
750324,2023-08-09,205,classic yogurt,45,60,15,1,00404,India
750324,2023-08-09,209,pepsi,75,100,25,1,00404,India
750324,2023-08-09,206,yakult,360,400,40,1,00404,India
750324,2023-08-09,211,red bull,90,125,35,1,00404,India
936595,2023-08-09,211,red bull,90,125,35,1,00037,India
128926,2023-08-09,208,sprite,75,100,25,1,00394,India
972764,2023-08-09,208,sprite,75,100,25,1,00463,India
688278,2023-08-09,206,yakult,360,400,40,1,00450,India
688278,2023-08-09,213,bisleri,6,15,9,1,00450,India
688278,2023-08-09,203,mango yogurt,50,60,10,1,00450,India
975028,2023-08-09,201,paneer,210,340,130,1,00280,India
975028,2023-08-09,209,pepsi,75,100,25,1,00280,India
975028,2023-08-09,210,mountain dew,75,100,25,1,00280,India
975028,2023-08-09,204,strawberry yogurt,50,60,10,1,00280,India
655422,2023-08-09,207,coca cola,75,100,25,1,00199,India
655422,2023-08-09,206,yakult,360,400,40,1,00199,India
655422,2023-08-09,205,classic yogurt,45,60,15,1,00199,India
361214,2023-08-09,208,sprite,75,100,25,1,00028,India
361214,2023-08-09,213,bisleri,6,15,9,1,00028,India
239063,2023-08-09,212,amul cheese,250,315,65,1,00354,India
239063,2023-08-09,211,red bull,90,125,35,1,00354,India
239063,2023-08-09,207,coca cola,75,100,25,1,00354,India
291663,2023-08-09,206,yakult,360,400,40,1,00072,India
291663,2023-08-09,201,paneer,210,340,130,1,00072,India
536532,2023-08-09,201,paneer,210,340,130,1,00274,India
536532,2023-08-09,213,bisleri,6,15,9,1,00274,India
536532,2023-08-09,209,pepsi,75,100,25,1,00274,India
536532,2023-08-09,206,yakult,360,400,40,1,00274,India
692511,2023-08-09,204,strawberry yogurt,50,60,10,1,00410,India
692511,2023-08-09,206,yakult,360,400,40,1,00410,India
530029,2023-08-09,212,amul cheese,250,315,65,1,00376,India
530029,2023-08-09,206,yakult,360,400,40,1,00376,India
530029,2023-08-09,210,mountain dew,75,100,25,1,00376,India
530029,2023-08-09,204,strawberry yogurt,50,60,10,1,00376,India
530029,2023-08-09,207,coca cola,75,100,25,1,00376,India
910290,2023-08-09,209,pepsi,75,100,25,1,00030,India
910290,2023-08-09,205,classic yogurt,45,60,15,1,00030,India
559489,2023-08-09,213,bisleri,6,15,9,1,00187,India
559489,2023-08-09,202,milk,12,27,15,1,00187,India
959092,2023-08-09,202,milk,12,27,15,1,00457,India
959092,2023-08-09,212,amul cheese,250,315,65,1,00457,India
959092,2023-08-09,213,bisleri,6,15,9,1,00457,India
527685,2023-08-09,210,mountain dew,75,100,25,1,00005,India
527685,2023-08-09,203,mango yogurt,50,60,10,1,00005,India
527685,2023-08-09,202,milk,12,27,15,1,00005,India
527685,2023-08-09,205,classic yogurt,45,60,15,1,00005,India
778938,2023-08-09,204,strawberry yogurt,50,60,10,1,00461,India
229467,2023-08-09,206,yakult,360,400,40,1,00410,India
229467,2023-08-09,213,bisleri,6,15,9,1,00410,India
229467,2023-08-09,212,amul cheese,250,315,65,1,00410,India
197455,2023-08-09,205,classic yogurt,45,60,15,1,00421,India
197455,2023-08-09,203,mango yogurt,50,60,10,1,00421,India
519024,2023-08-09,201,paneer,210,340,130,1,00154,India
519024,2023-08-09,213,bisleri,6,15,9,1,00154,India
519024,2023-08-09,204,strawberry yogurt,50,60,10,1,00154,India
362118,2023-08-09,201,paneer,210,340,130,1,00276,India
139456,2023-08-09,209,pepsi,75,100,25,1,00382,India
139456,2023-08-09,212,amul cheese,250,315,65,1,00382,India
139456,2023-08-09,205,classic yogurt,45,60,15,1,00382,India
139456,2023-08-09,206,yakult,360,400,40,1,00382,India
821161,2023-08-09,210,mountain dew,75,100,25,1,00139,India
821161,2023-08-09,207,coca cola,75,100,25,1,00139,India
821161,2023-08-09,201,paneer,210,340,130,1,00139,India
821161,2023-08-09,211,red bull,90,125,35,1,00139,India
267707,2023-08-09,213,bisleri,6,15,9,1,00154,India
267707,2023-08-09,210,mountain dew,75,100,25,1,00154,India
267707,2023-08-09,211,red bull,90,125,35,1,00154,India
933727,2023-08-09,209,pepsi,75,100,25,1,00376,India
933727,2023-08-09,201,paneer,210,340,130,1,00376,India
933727,2023-08-09,213,bisleri,6,15,9,1,00376,India
877983,2023-08-09,213,bisleri,6,15,9,1,00139,India
877983,2023-08-09,201,paneer,210,340,130,1,00139,India
877983,2023-08-09,212,amul cheese,250,315,65,1,00139,India
877983,2023-08-09,205,classic yogurt,45,60,15,1,00139,India
877983,2023-08-09,209,pepsi,75,100,25,1,00139,India
500123,2023-08-09,213,bisleri,6,15,9,1,00021,India
500123,2023-08-09,202,milk,12,27,15,1,00021,India
500123,2023-08-09,210,mountain dew,75,100,25,1,00021,India
886794,2023-08-09,202,milk,12,27,15,1,00341,India
886794,2023-08-09,208,sprite,75,100,25,1,00341,India
644660,2023-08-09,203,mango yogurt,50,60,10,1,00370,India
644660,2023-08-09,208,sprite,75,100,25,1,00370,India
374215,2023-08-09,213,bisleri,6,15,9,1,00359,India
374215,2023-08-09,208,sprite,75,100,25,1,00359,India
329182,2023-08-09,209,pepsi,75,100,25,1,00416,India
329182,2023-08-09,205,classic yogurt,45,60,15,1,00416,India
329182,2023-08-09,212,amul cheese,250,315,65,1,00416,India
329182,2023-08-09,207,coca cola,75,100,25,1,00416,India
573227,2023-08-09,207,coca cola,75,100,25,1,00379,India
573227,2023-08-09,206,yakult,360,400,40,1,00379,India
573227,2023-08-09,205,classic yogurt,45,60,15,1,00379,India
573227,2023-08-09,212,amul cheese,250,315,65,1,00379,India
573227,2023-08-09,210,mountain dew,75,100,25,1,00379,India
386632,2023-08-09,203,mango yogurt,50,60,10,1,00161,India
386632,2023-08-09,202,milk,12,27,15,1,00161,India
822201,2023-08-09,201,paneer,210,340,130,1,00351,India
822201,2023-08-09,211,red bull,90,125,35,1,00351,India
822201,2023-08-09,208,sprite,75,100,25,1,00351,India
267281,2023-08-09,207,coca cola,75,100,25,1,00193,India
267281,2023-08-09,212,amul cheese,250,315,65,1,00193,India
395946,2023-08-09,204,strawberry yogurt,50,60,10,1,00206,India
395946,2023-08-09,207,coca cola,75,100,25,1,00206,India
395946,2023-08-09,209,pepsi,75,100,25,1,00206,India
395946,2023-08-09,213,bisleri,6,15,9,1,00206,India
608485,2023-08-09,201,paneer,210,340,130,1,00445,India
608485,2023-08-09,203,mango yogurt,50,60,10,1,00445,India
608485,2023-08-09,208,sprite,75,100,25,1,00445,India
608485,2023-08-09,213,bisleri,6,15,9,1,00445,India
608485,2023-08-09,207,coca cola,75,100,25,1,00445,India
973267,2023-08-09,207,coca cola,75,100,25,1,00045,India
973267,2023-08-09,206,yakult,360,400,40,1,00045,India
464322,2023-08-09,211,red bull,90,125,35,1,00067,India
464322,2023-08-09,213,bisleri,6,15,9,1,00067,India
464322,2023-08-09,203,mango yogurt,50,60,10,1,00067,India
531774,2023-08-09,205,classic yogurt,45,60,15,1,00477,India
728153,2023-08-09,210,mountain dew,75,100,25,1,00397,India
962274,2023-08-09,208,sprite,75,100,25,1,00300,India
962274,2023-08-09,206,yakult,360,400,40,1,00300,India
962274,2023-08-09,212,amul cheese,250,315,65,1,00300,India
962274,2023-08-09,201,paneer,210,340,130,1,00300,India
962274,2023-08-09,213,bisleri,6,15,9,1,00300,India
193475,2023-08-09,203,mango yogurt,50,60,10,1,00028,India
193475,2023-08-09,202,milk,12,27,15,1,00028,India
193475,2023-08-09,206,yakult,360,400,40,1,00028,India
670411,2023-08-09,202,milk,12,27,15,1,00387,India
670411,2023-08-09,207,coca cola,75,100,25,1,00387,India
229438,2023-08-09,213,bisleri,6,15,9,1,00264,India
229438,2023-08-09,210,mountain dew,75,100,25,1,00264,India
229438,2023-08-09,208,sprite,75,100,25,1,00264,India
229438,2023-08-09,203,mango yogurt,50,60,10,1,00264,India
411155,2023-08-09,213,bisleri,6,15,9,1,00227,India
411155,2023-08-09,204,strawberry yogurt,50,60,10,1,00227,India
411155,2023-08-09,205,classic yogurt,45,60,15,1,00227,India
411155,2023-08-09,209,pepsi,75,100,25,1,00227,India
230583,2023-08-09,213,bisleri,6,15,9,1,00380,India
230583,2023-08-09,207,coca cola,75,100,25,1,00380,India
579527,2023-08-09,209,pepsi,75,100,25,1,00463,India
477469,2023-08-09,213,bisleri,6,15,9,1,00290,India
477469,2023-08-09,210,mountain dew,75,100,25,1,00290,India
477469,2023-08-09,206,yakult,360,400,40,1,00290,India
537576,2023-08-09,210,mountain dew,75,100,25,1,00489,India
537576,2023-08-09,209,pepsi,75,100,25,1,00489,India
537576,2023-08-09,208,sprite,75,100,25,1,00489,India
537576,2023-08-09,211,red bull,90,125,35,1,00489,India
417578,2023-08-09,210,mountain dew,75,100,25,1,00155,India
417578,2023-08-09,207,coca cola,75,100,25,1,00155,India
417578,2023-08-09,206,yakult,360,400,40,1,00155,India
816464,2023-08-09,211,red bull,90,125,35,1,00450,India
816464,2023-08-09,205,classic yogurt,45,60,15,1,00450,India
816464,2023-08-09,213,bisleri,6,15,9,1,00450,India
725560,2023-08-09,201,paneer,210,340,130,1,00370,India
725560,2023-08-09,213,bisleri,6,15,9,1,00370,India
725560,2023-08-09,203,mango yogurt,50,60,10,1,00370,India
725560,2023-08-09,206,yakult,360,400,40,1,00370,India
473765,2023-08-09,205,classic yogurt,45,60,15,1,00258,India
473765,2023-08-09,202,milk,12,27,15,1,00258,India
260082,2023-08-09,204,strawberry yogurt,50,60,10,1,00104,India
260082,2023-08-09,209,pepsi,75,100,25,1,00104,India
260082,2023-08-09,202,milk,12,27,15,1,00104,India
629126,2023-08-09,212,amul cheese,250,315,65,1,00446,India
629126,2023-08-09,201,paneer,210,340,130,1,00446,India
629126,2023-08-09,203,mango yogurt,50,60,10,1,00446,India
629126,2023-08-09,206,yakult,360,400,40,1,00446,India
493155,2023-08-09,201,paneer,210,340,130,1,00442,India
493155,2023-08-09,202,milk,12,27,15,1,00442,India
493155,2023-08-09,209,pepsi,75,100,25,1,00442,India
493155,2023-08-09,203,mango yogurt,50,60,10,1,00442,India
493155,2023-08-09,208,sprite,75,100,25,1,00442,India
799578,2023-08-09,206,yakult,360,400,40,1,00384,India
799578,2023-08-09,203,mango yogurt,50,60,10,1,00384,India
799578,2023-08-09,205,classic yogurt,45,60,15,1,00384,India
519186,2023-08-09,205,classic yogurt,45,60,15,1,00137,India
519186,2023-08-09,213,bisleri,6,15,9,1,00137,India
588166,2023-08-09,205,classic yogurt,45,60,15,1,00063,India
588166,2023-08-09,201,paneer,210,340,130,1,00063,India
588166,2023-08-09,213,bisleri,6,15,9,1,00063,India
588166,2023-08-09,206,yakult,360,400,40,1,00063,India
588166,2023-08-09,208,sprite,75,100,25,1,00063,India
676069,2023-08-09,213,bisleri,6,15,9,1,00392,India
676069,2023-08-09,207,coca cola,75,100,25,1,00392,India
676069,2023-08-09,204,strawberry yogurt,50,60,10,1,00392,India
976240,2023-08-09,203,mango yogurt,50,60,10,1,00352,India
976240,2023-08-09,211,red bull,90,125,35,1,00352,India
976240,2023-08-09,212,amul cheese,250,315,65,1,00352,India
976240,2023-08-09,205,classic yogurt,45,60,15,1,00352,India
976240,2023-08-09,201,paneer,210,340,130,1,00352,India
105274,2023-08-09,202,milk,12,27,15,1,00318,India
105274,2023-08-09,207,coca cola,75,100,25,1,00318,India
105274,2023-08-09,209,pepsi,75,100,25,1,00318,India
105274,2023-08-09,210,mountain dew,75,100,25,1,00318,India
341252,2023-08-09,213,bisleri,6,15,9,1,00196,India
341252,2023-08-09,207,coca cola,75,100,25,1,00196,India
273330,2023-08-09,202,milk,12,27,15,1,00161,India
273330,2023-08-09,212,amul cheese,250,315,65,1,00161,India
273330,2023-08-09,207,coca cola,75,100,25,1,00161,India
371980,2023-08-09,203,mango yogurt,50,60,10,1,00046,India
371980,2023-08-09,212,amul cheese,250,315,65,1,00046,India
354519,2023-08-09,203,mango yogurt,50,60,10,1,00271,India
354519,2023-08-09,212,amul cheese,250,315,65,1,00271,India
354519,2023-08-09,206,yakult,360,400,40,1,00271,India
354519,2023-08-09,205,classic yogurt,45,60,15,1,00271,India
437338,2023-08-09,210,mountain dew,75,100,25,1,00407,India
116981,2023-08-09,203,mango yogurt,50,60,10,1,00283,India
116981,2023-08-09,213,bisleri,6,15,9,1,00283,India
116981,2023-08-09,204,strawberry yogurt,50,60,10,1,00283,India
232995,2023-08-09,211,red bull,90,125,35,1,00193,India
232995,2023-08-09,212,amul cheese,250,315,65,1,00193,India
232995,2023-08-09,210,mountain dew,75,100,25,1,00193,India
715160,2023-08-09,212,amul cheese,250,315,65,1,00223,India
715160,2023-08-09,203,mango yogurt,50,60,10,1,00223,India
715160,2023-08-09,210,mountain dew,75,100,25,1,00223,India
887784,2023-08-09,204,strawberry yogurt,50,60,10,1,00300,India
887784,2023-08-09,202,milk,12,27,15,1,00300,India
887784,2023-08-09,212,amul cheese,250,315,65,1,00300,India
887784,2023-08-09,213,bisleri,6,15,9,1,00300,India
317196,2023-08-09,204,strawberry yogurt,50,60,10,1,00498,India
317196,2023-08-09,206,yakult,360,400,40,1,00498,India
317196,2023-08-09,210,mountain dew,75,100,25,1,00498,India
317196,2023-08-09,209,pepsi,75,100,25,1,00498,India
667179,2023-08-09,205,classic yogurt,45,60,15,1,00440,India
667179,2023-08-09,209,pepsi,75,100,25,1,00440,India
667179,2023-08-09,211,red bull,90,125,35,1,00440,India
667179,2023-08-09,210,mountain dew,75,100,25,1,00440,India
708254,2023-08-09,204,strawberry yogurt,50,60,10,1,00140,India
445337,2023-08-09,209,pepsi,75,100,25,1,00274,India
445337,2023-08-09,201,paneer,210,340,130,1,00274,India
445337,2023-08-09,207,coca cola,75,100,25,1,00274,India
241046,2023-08-09,208,sprite,75,100,25,1,00194,India
241046,2023-08-09,209,pepsi,75,100,25,1,00194,India
241046,2023-08-09,203,mango yogurt,50,60,10,1,00194,India
241046,2023-08-09,211,red bull,90,125,35,1,00194,India
812214,2023-08-09,208,sprite,75,100,25,1,00277,India
119091,2023-08-09,206,yakult,360,400,40,1,00085,India
119091,2023-08-09,209,pepsi,75,100,25,1,00085,India
119091,2023-08-09,210,mountain dew,75,100,25,1,00085,India
299061,2023-08-09,207,coca cola,75,100,25,1,00078,India
299061,2023-08-09,208,sprite,75,100,25,1,00078,India
299061,2023-08-09,211,red bull,90,125,35,1,00078,India
431009,2023-08-10,203,mango yogurt,50,60,10,1,00065,India
431009,2023-08-10,207,coca cola,75,100,25,1,00065,India
968311,2023-08-10,204,strawberry yogurt,50,60,10,1,00477,India
968311,2023-08-10,213,bisleri,6,15,9,1,00477,India
968311,2023-08-10,203,mango yogurt,50,60,10,1,00477,India
732633,2023-08-10,206,yakult,360,400,40,1,00249,India
648713,2023-08-10,202,milk,12,27,15,1,00296,India
648713,2023-08-10,205,classic yogurt,45,60,15,1,00296,India
648713,2023-08-10,213,bisleri,6,15,9,1,00296,India
558917,2023-08-10,209,pepsi,75,100,25,1,00166,India
558917,2023-08-10,202,milk,12,27,15,1,00166,India
558917,2023-08-10,201,paneer,210,340,130,1,00166,India
588678,2023-08-10,207,coca cola,75,100,25,1,00394,India
588678,2023-08-10,209,pepsi,75,100,25,1,00394,India
674179,2023-08-10,203,mango yogurt,50,60,10,1,00171,India
674179,2023-08-10,206,yakult,360,400,40,1,00171,India
674179,2023-08-10,211,red bull,90,125,35,1,00171,India
674179,2023-08-10,207,coca cola,75,100,25,1,00171,India
674179,2023-08-10,212,amul cheese,250,315,65,1,00171,India
435614,2023-08-10,206,yakult,360,400,40,1,00222,India
261402,2023-08-10,213,bisleri,6,15,9,1,00489,India
261402,2023-08-10,201,paneer,210,340,130,1,00489,India
261402,2023-08-10,212,amul cheese,250,315,65,1,00489,India
261402,2023-08-10,208,sprite,75,100,25,1,00489,India
647953,2023-08-10,207,coca cola,75,100,25,1,00365,India
647953,2023-08-10,212,amul cheese,250,315,65,1,00365,India
647953,2023-08-10,213,bisleri,6,15,9,1,00365,India
647953,2023-08-10,204,strawberry yogurt,50,60,10,1,00365,India
647953,2023-08-10,208,sprite,75,100,25,1,00365,India
909739,2023-08-10,213,bisleri,6,15,9,1,00258,India
909739,2023-08-10,206,yakult,360,400,40,1,00258,India
909739,2023-08-10,202,milk,12,27,15,1,00258,India
139145,2023-08-10,204,strawberry yogurt,50,60,10,1,00370,India
139145,2023-08-10,209,pepsi,75,100,25,1,00370,India
622710,2023-08-10,207,coca cola,75,100,25,1,00440,India
622710,2023-08-10,201,paneer,210,340,130,1,00440,India
622710,2023-08-10,209,pepsi,75,100,25,1,00440,India
622710,2023-08-10,204,strawberry yogurt,50,60,10,1,00440,India
622710,2023-08-10,210,mountain dew,75,100,25,1,00440,India
201669,2023-08-10,201,paneer,210,340,130,1,00291,India
201669,2023-08-10,204,strawberry yogurt,50,60,10,1,00291,India
201669,2023-08-10,208,sprite,75,100,25,1,00291,India
201669,2023-08-10,210,mountain dew,75,100,25,1,00291,India
201669,2023-08-10,202,milk,12,27,15,1,00291,India
356099,2023-08-10,207,coca cola,75,100,25,1,00291,India
356099,2023-08-10,205,classic yogurt,45,60,15,1,00291,India
356099,2023-08-10,208,sprite,75,100,25,1,00291,India
428291,2023-08-10,210,mountain dew,75,100,25,1,00012,India
428291,2023-08-10,209,pepsi,75,100,25,1,00012,India
982889,2023-08-10,210,mountain dew,75,100,25,1,00060,India
982889,2023-08-10,206,yakult,360,400,40,1,00060,India
982889,2023-08-10,212,amul cheese,250,315,65,1,00060,India
982889,2023-08-10,209,pepsi,75,100,25,1,00060,India
370684,2023-08-10,212,amul cheese,250,315,65,1,00194,India
370684,2023-08-10,204,strawberry yogurt,50,60,10,1,00194,India
370684,2023-08-10,206,yakult,360,400,40,1,00194,India
370684,2023-08-10,209,pepsi,75,100,25,1,00194,India
370684,2023-08-10,203,mango yogurt,50,60,10,1,00194,India
281923,2023-08-10,213,bisleri,6,15,9,1,00138,India
281923,2023-08-10,209,pepsi,75,100,25,1,00138,India
281923,2023-08-10,207,coca cola,75,100,25,1,00138,India
991503,2023-08-10,201,paneer,210,340,130,1,00430,India
991503,2023-08-10,212,amul cheese,250,315,65,1,00430,India
991503,2023-08-10,209,pepsi,75,100,25,1,00430,India
991503,2023-08-10,211,red bull,90,125,35,1,00430,India
458829,2023-08-10,210,mountain dew,75,100,25,1,00109,India
458829,2023-08-10,207,coca cola,75,100,25,1,00109,India
458829,2023-08-10,208,sprite,75,100,25,1,00109,India
458829,2023-08-10,206,yakult,360,400,40,1,00109,India
508135,2023-08-10,204,strawberry yogurt,50,60,10,1,00113,India
692126,2023-08-10,208,sprite,75,100,25,1,00126,India
692126,2023-08-10,204,strawberry yogurt,50,60,10,1,00126,India
692126,2023-08-10,201,paneer,210,340,130,1,00126,India
692126,2023-08-10,212,amul cheese,250,315,65,1,00126,India
692126,2023-08-10,203,mango yogurt,50,60,10,1,00126,India
987594,2023-08-10,203,mango yogurt,50,60,10,1,00424,India
987594,2023-08-10,210,mountain dew,75,100,25,1,00424,India
987594,2023-08-10,204,strawberry yogurt,50,60,10,1,00424,India
987594,2023-08-10,213,bisleri,6,15,9,1,00424,India
987594,2023-08-10,202,milk,12,27,15,1,00424,India
436278,2023-08-10,205,classic yogurt,45,60,15,1,00265,India
436278,2023-08-10,213,bisleri,6,15,9,1,00265,India
436278,2023-08-10,210,mountain dew,75,100,25,1,00265,India
436278,2023-08-10,212,amul cheese,250,315,65,1,00265,India
436278,2023-08-10,201,paneer,210,340,130,1,00265,India
783161,2023-08-10,211,red bull,90,125,35,1,00350,India
933038,2023-08-10,210,mountain dew,75,100,25,1,00192,India
933038,2023-08-10,202,milk,12,27,15,1,00192,India
933038,2023-08-10,203,mango yogurt,50,60,10,1,00192,India
484320,2023-08-10,208,sprite,75,100,25,1,00447,India
484320,2023-08-10,202,milk,12,27,15,1,00447,India
556544,2023-08-10,206,yakult,360,400,40,1,00327,India
556544,2023-08-10,201,paneer,210,340,130,1,00327,India
556544,2023-08-10,203,mango yogurt,50,60,10,1,00327,India
328028,2023-08-10,208,sprite,75,100,25,1,00301,India
156483,2023-08-10,202,milk,12,27,15,1,00114,India
156483,2023-08-10,211,red bull,90,125,35,1,00114,India
156483,2023-08-10,209,pepsi,75,100,25,1,00114,India
141681,2023-08-10,202,milk,12,27,15,1,00095,India
495642,2023-08-10,208,sprite,75,100,25,1,00017,India
495642,2023-08-10,210,mountain dew,75,100,25,1,00017,India
574051,2023-08-10,201,paneer,210,340,130,1,00287,India
408733,2023-08-10,212,amul cheese,250,315,65,1,00421,India
408733,2023-08-10,203,mango yogurt,50,60,10,1,00421,India
408733,2023-08-10,213,bisleri,6,15,9,1,00421,India
408733,2023-08-10,204,strawberry yogurt,50,60,10,1,00421,India
199475,2023-08-10,201,paneer,210,340,130,1,00299,India
199475,2023-08-10,209,pepsi,75,100,25,1,00299,India
199475,2023-08-10,211,red bull,90,125,35,1,00299,India
892488,2023-08-10,213,bisleri,6,15,9,1,00466,India
892488,2023-08-10,207,coca cola,75,100,25,1,00466,India
892488,2023-08-10,204,strawberry yogurt,50,60,10,1,00466,India
694877,2023-08-10,204,strawberry yogurt,50,60,10,1,00221,India
694877,2023-08-10,212,amul cheese,250,315,65,1,00221,India
694877,2023-08-10,209,pepsi,75,100,25,1,00221,India
694877,2023-08-10,210,mountain dew,75,100,25,1,00221,India
908464,2023-08-10,206,yakult,360,400,40,1,00411,India
570671,2023-08-10,206,yakult,360,400,40,1,00152,India
570671,2023-08-10,205,classic yogurt,45,60,15,1,00152,India
129701,2023-08-10,206,yakult,360,400,40,1,00009,India
129701,2023-08-10,211,red bull,90,125,35,1,00009,India
129701,2023-08-10,203,mango yogurt,50,60,10,1,00009,India
816680,2023-08-10,211,red bull,90,125,35,1,00067,India
816680,2023-08-10,208,sprite,75,100,25,1,00067,India
816680,2023-08-10,213,bisleri,6,15,9,1,00067,India
816680,2023-08-10,201,paneer,210,340,130,1,00067,India
235372,2023-08-10,213,bisleri,6,15,9,1,00338,India
235372,2023-08-10,206,yakult,360,400,40,1,00338,India
993497,2023-08-10,202,milk,12,27,15,1,00349,India
993497,2023-08-10,204,strawberry yogurt,50,60,10,1,00349,India
930608,2023-08-10,208,sprite,75,100,25,1,00393,India
190629,2023-08-10,205,classic yogurt,45,60,15,1,00231,India
190629,2023-08-10,211,red bull,90,125,35,1,00231,India
190629,2023-08-10,210,mountain dew,75,100,25,1,00231,India
587005,2023-08-10,211,red bull,90,125,35,1,00494,India
587005,2023-08-10,213,bisleri,6,15,9,1,00494,India
587005,2023-08-10,204,strawberry yogurt,50,60,10,1,00494,India
587005,2023-08-10,207,coca cola,75,100,25,1,00494,India
862036,2023-08-10,205,classic yogurt,45,60,15,1,00265,India
862036,2023-08-10,211,red bull,90,125,35,1,00265,India
862036,2023-08-10,213,bisleri,6,15,9,1,00265,India
862036,2023-08-10,208,sprite,75,100,25,1,00265,India
862036,2023-08-10,201,paneer,210,340,130,1,00265,India
698542,2023-08-10,206,yakult,360,400,40,1,00063,India
698542,2023-08-10,207,coca cola,75,100,25,1,00063,India
698542,2023-08-10,211,red bull,90,125,35,1,00063,India
338084,2023-08-10,206,yakult,360,400,40,1,00274,India
338084,2023-08-10,213,bisleri,6,15,9,1,00274,India
716210,2023-08-10,205,classic yogurt,45,60,15,1,00182,India
716210,2023-08-10,204,strawberry yogurt,50,60,10,1,00182,India
598063,2023-08-10,205,classic yogurt,45,60,15,1,00206,India
598063,2023-08-10,209,pepsi,75,100,25,1,00206,India
598063,2023-08-10,211,red bull,90,125,35,1,00206,India
241752,2023-08-10,206,yakult,360,400,40,1,00339,India
241752,2023-08-10,207,coca cola,75,100,25,1,00339,India
782210,2023-08-10,202,milk,12,27,15,1,00146,India
782210,2023-08-10,207,coca cola,75,100,25,1,00146,India
782210,2023-08-10,213,bisleri,6,15,9,1,00146,India
782210,2023-08-10,209,pepsi,75,100,25,1,00146,India
778676,2023-08-10,208,sprite,75,100,25,1,00323,India
778676,2023-08-10,213,bisleri,6,15,9,1,00323,India
778676,2023-08-10,204,strawberry yogurt,50,60,10,1,00323,India
778676,2023-08-10,210,mountain dew,75,100,25,1,00323,India
674495,2023-08-10,211,red bull,90,125,35,1,00083,India
631335,2023-08-10,207,coca cola,75,100,25,1,00006,India
631335,2023-08-10,211,red bull,90,125,35,1,00006,India
985939,2023-08-10,204,strawberry yogurt,50,60,10,1,00369,India
985939,2023-08-10,203,mango yogurt,50,60,10,1,00369,India
985939,2023-08-10,209,pepsi,75,100,25,1,00369,India
985939,2023-08-10,201,paneer,210,340,130,1,00369,India
786375,2023-08-10,212,amul cheese,250,315,65,1,00190,India
786375,2023-08-10,210,mountain dew,75,100,25,1,00190,India
786375,2023-08-10,206,yakult,360,400,40,1,00190,India
786375,2023-08-10,211,red bull,90,125,35,1,00190,India
831065,2023-08-10,210,mountain dew,75,100,25,1,00471,India
831065,2023-08-10,209,pepsi,75,100,25,1,00471,India
831065,2023-08-10,203,mango yogurt,50,60,10,1,00471,India
835011,2023-08-10,204,strawberry yogurt,50,60,10,1,00114,India
835011,2023-08-10,213,bisleri,6,15,9,1,00114,India
835011,2023-08-10,210,mountain dew,75,100,25,1,00114,India
835011,2023-08-10,209,pepsi,75,100,25,1,00114,India
443414,2023-08-10,212,amul cheese,250,315,65,1,00178,India
443414,2023-08-10,210,mountain dew,75,100,25,1,00178,India
443414,2023-08-10,204,strawberry yogurt,50,60,10,1,00178,India
443414,2023-08-10,206,yakult,360,400,40,1,00178,India
443414,2023-08-10,203,mango yogurt,50,60,10,1,00178,India
970427,2023-08-10,202,milk,12,27,15,1,00433,India
970427,2023-08-10,212,amul cheese,250,315,65,1,00433,India
245971,2023-08-10,202,milk,12,27,15,1,00275,India
245971,2023-08-10,211,red bull,90,125,35,1,00275,India
245971,2023-08-10,208,sprite,75,100,25,1,00275,India
245971,2023-08-10,210,mountain dew,75,100,25,1,00275,India
586411,2023-08-10,212,amul cheese,250,315,65,1,00121,India
586411,2023-08-10,213,bisleri,6,15,9,1,00121,India
851001,2023-08-11,204,strawberry yogurt,50,60,10,1,00206,India
137208,2023-08-11,210,mountain dew,75,100,25,1,00202,India
137208,2023-08-11,208,sprite,75,100,25,1,00202,India
137208,2023-08-11,202,milk,12,27,15,1,00202,India
137208,2023-08-11,205,classic yogurt,45,60,15,1,00202,India
137208,2023-08-11,212,amul cheese,250,315,65,1,00202,India
605389,2023-08-11,213,bisleri,6,15,9,1,00147,India
605389,2023-08-11,209,pepsi,75,100,25,1,00147,India
744769,2023-08-11,205,classic yogurt,45,60,15,1,00445,India
487833,2023-08-11,212,amul cheese,250,315,65,1,00453,India
487833,2023-08-11,204,strawberry yogurt,50,60,10,1,00453,India
487833,2023-08-11,205,classic yogurt,45,60,15,1,00453,India
487833,2023-08-11,209,pepsi,75,100,25,1,00453,India
597208,2023-08-11,213,bisleri,6,15,9,1,00415,India
597208,2023-08-11,209,pepsi,75,100,25,1,00415,India
597208,2023-08-11,204,strawberry yogurt,50,60,10,1,00415,India
138749,2023-08-11,208,sprite,75,100,25,1,00434,India
617739,2023-08-11,213,bisleri,6,15,9,1,00276,India
617739,2023-08-11,209,pepsi,75,100,25,1,00276,India
617739,2023-08-11,203,mango yogurt,50,60,10,1,00276,India
568867,2023-08-11,202,milk,12,27,15,1,00457,India
483282,2023-08-11,206,yakult,360,400,40,1,00038,India
483282,2023-08-11,210,mountain dew,75,100,25,1,00038,India
207800,2023-08-11,212,amul cheese,250,315,65,1,00494,India
207800,2023-08-11,201,paneer,210,340,130,1,00494,India
207800,2023-08-11,203,mango yogurt,50,60,10,1,00494,India
425841,2023-08-11,203,mango yogurt,50,60,10,1,00282,India
909755,2023-08-11,208,sprite,75,100,25,1,00099,India
493208,2023-08-11,206,yakult,360,400,40,1,00150,India
493208,2023-08-11,203,mango yogurt,50,60,10,1,00150,India
493208,2023-08-11,205,classic yogurt,45,60,15,1,00150,India
122212,2023-08-11,205,classic yogurt,45,60,15,1,00308,India
874212,2023-08-11,211,red bull,90,125,35,1,00268,India
874212,2023-08-11,201,paneer,210,340,130,1,00268,India
874212,2023-08-11,210,mountain dew,75,100,25,1,00268,India
874212,2023-08-11,209,pepsi,75,100,25,1,00268,India
362460,2023-08-11,205,classic yogurt,45,60,15,1,00123,India
899242,2023-08-11,204,strawberry yogurt,50,60,10,1,00085,India
899242,2023-08-11,202,milk,12,27,15,1,00085,India
899242,2023-08-11,206,yakult,360,400,40,1,00085,India
899242,2023-08-11,210,mountain dew,75,100,25,1,00085,India
152211,2023-08-11,211,red bull,90,125,35,1,00407,India
152211,2023-08-11,207,coca cola,75,100,25,1,00407,India
152211,2023-08-11,210,mountain dew,75,100,25,1,00407,India
152211,2023-08-11,206,yakult,360,400,40,1,00407,India
152211,2023-08-11,209,pepsi,75,100,25,1,00407,India
990907,2023-08-11,212,amul cheese,250,315,65,1,00025,India
494024,2023-08-11,208,sprite,75,100,25,1,00405,India
925211,2023-08-11,204,strawberry yogurt,50,60,10,1,00143,India
925211,2023-08-11,211,red bull,90,125,35,1,00143,India
925211,2023-08-11,206,yakult,360,400,40,1,00143,India
109482,2023-08-11,210,mountain dew,75,100,25,1,00009,India
109482,2023-08-11,213,bisleri,6,15,9,1,00009,India
565918,2023-08-11,210,mountain dew,75,100,25,1,00144,India
565918,2023-08-11,207,coca cola,75,100,25,1,00144,India
565918,2023-08-11,212,amul cheese,250,315,65,1,00144,India
565918,2023-08-11,209,pepsi,75,100,25,1,00144,India
565918,2023-08-11,205,classic yogurt,45,60,15,1,00144,India
837037,2023-08-11,210,mountain dew,75,100,25,1,00323,India
837037,2023-08-11,202,milk,12,27,15,1,00323,India
837037,2023-08-11,207,coca cola,75,100,25,1,00323,India
678519,2023-08-11,209,pepsi,75,100,25,1,00383,India
678519,2023-08-11,208,sprite,75,100,25,1,00383,India
835006,2023-08-11,213,bisleri,6,15,9,1,00205,India
835006,2023-08-11,210,mountain dew,75,100,25,1,00205,India
835006,2023-08-11,208,sprite,75,100,25,1,00205,India
835006,2023-08-11,202,milk,12,27,15,1,00205,India
231268,2023-08-11,212,amul cheese,250,315,65,1,00299,India
231268,2023-08-11,210,mountain dew,75,100,25,1,00299,India
231268,2023-08-11,206,yakult,360,400,40,1,00299,India
231268,2023-08-11,204,strawberry yogurt,50,60,10,1,00299,India
930392,2023-08-11,208,sprite,75,100,25,1,00221,India
930392,2023-08-11,202,milk,12,27,15,1,00221,India
930392,2023-08-11,209,pepsi,75,100,25,1,00221,India
108176,2023-08-11,206,yakult,360,400,40,1,00042,India
108176,2023-08-11,213,bisleri,6,15,9,1,00042,India
195423,2023-08-11,202,milk,12,27,15,1,00493,India
646366,2023-08-11,204,strawberry yogurt,50,60,10,1,00072,India
646366,2023-08-11,205,classic yogurt,45,60,15,1,00072,India
254724,2023-08-11,211,red bull,90,125,35,1,00411,India
953141,2023-08-11,202,milk,12,27,15,1,00284,India
953141,2023-08-11,207,coca cola,75,100,25,1,00284,India
953141,2023-08-11,210,mountain dew,75,100,25,1,00284,India
124854,2023-08-11,209,pepsi,75,100,25,1,00126,India
195298,2023-08-11,212,amul cheese,250,315,65,1,00427,India
195298,2023-08-11,213,bisleri,6,15,9,1,00427,India
195298,2023-08-11,209,pepsi,75,100,25,1,00427,India
359741,2023-08-11,206,yakult,360,400,40,1,00396,India
359741,2023-08-11,213,bisleri,6,15,9,1,00396,India
836042,2023-08-11,211,red bull,90,125,35,1,00076,India
863337,2023-08-11,213,bisleri,6,15,9,1,00033,India
863337,2023-08-11,210,mountain dew,75,100,25,1,00033,India
863337,2023-08-11,207,coca cola,75,100,25,1,00033,India
863337,2023-08-11,203,mango yogurt,50,60,10,1,00033,India
863337,2023-08-11,201,paneer,210,340,130,1,00033,India
250380,2023-08-11,206,yakult,360,400,40,1,00064,India
821089,2023-08-11,207,coca cola,75,100,25,1,00204,India
821089,2023-08-11,208,sprite,75,100,25,1,00204,India
143143,2023-08-11,206,yakult,360,400,40,1,00444,India
143143,2023-08-11,202,milk,12,27,15,1,00444,India
612597,2023-08-11,204,strawberry yogurt,50,60,10,1,00315,India
612597,2023-08-11,210,mountain dew,75,100,25,1,00315,India
358559,2023-08-11,211,red bull,90,125,35,1,00479,India
579460,2023-08-11,207,coca cola,75,100,25,1,00464,India
579460,2023-08-11,209,pepsi,75,100,25,1,00464,India
579460,2023-08-11,202,milk,12,27,15,1,00464,India
985599,2023-08-11,201,paneer,210,340,130,1,00497,India
724859,2023-08-11,210,mountain dew,75,100,25,1,00179,India
724859,2023-08-11,211,red bull,90,125,35,1,00179,India
724859,2023-08-11,204,strawberry yogurt,50,60,10,1,00179,India
479193,2023-08-11,212,amul cheese,250,315,65,1,00340,India
479193,2023-08-11,213,bisleri,6,15,9,1,00340,India
479193,2023-08-11,209,pepsi,75,100,25,1,00340,India
395928,2023-08-11,202,milk,12,27,15,1,00456,India
228071,2023-08-11,208,sprite,75,100,25,1,00449,India
228071,2023-08-11,207,coca cola,75,100,25,1,00449,India
228071,2023-08-11,213,bisleri,6,15,9,1,00449,India
303473,2023-08-11,202,milk,12,27,15,1,00088,India
303473,2023-08-11,210,mountain dew,75,100,25,1,00088,India
833115,2023-08-11,206,yakult,360,400,40,1,00457,India
732980,2023-08-11,206,yakult,360,400,40,1,00211,India
732980,2023-08-11,204,strawberry yogurt,50,60,10,1,00211,India
732980,2023-08-11,210,mountain dew,75,100,25,1,00211,India
732980,2023-08-11,205,classic yogurt,45,60,15,1,00211,India
695379,2023-08-11,201,paneer,210,340,130,1,00199,India
695379,2023-08-11,202,milk,12,27,15,1,00199,India
695379,2023-08-11,212,amul cheese,250,315,65,1,00199,India
987502,2023-08-11,201,paneer,210,340,130,1,00158,India
987502,2023-08-11,206,yakult,360,400,40,1,00158,India
963151,2023-08-11,210,mountain dew,75,100,25,1,00405,India
963151,2023-08-11,213,bisleri,6,15,9,1,00405,India
234635,2023-08-11,206,yakult,360,400,40,1,00285,India
234635,2023-08-11,211,red bull,90,125,35,1,00285,India
234635,2023-08-11,203,mango yogurt,50,60,10,1,00285,India
566861,2023-08-11,206,yakult,360,400,40,1,00391,India
566861,2023-08-11,201,paneer,210,340,130,1,00391,India
566861,2023-08-11,203,mango yogurt,50,60,10,1,00391,India
819941,2023-08-11,203,mango yogurt,50,60,10,1,00360,India
819941,2023-08-11,212,amul cheese,250,315,65,1,00360,India
819941,2023-08-11,209,pepsi,75,100,25,1,00360,India
819941,2023-08-11,202,milk,12,27,15,1,00360,India
819941,2023-08-11,204,strawberry yogurt,50,60,10,1,00360,India
661473,2023-08-11,210,mountain dew,75,100,25,1,00105,India
661473,2023-08-11,202,milk,12,27,15,1,00105,India
118033,2023-08-11,205,classic yogurt,45,60,15,1,00052,India
501179,2023-08-11,213,bisleri,6,15,9,1,00238,India
501179,2023-08-11,207,coca cola,75,100,25,1,00238,India
361345,2023-08-11,201,paneer,210,340,130,1,00459,India
879469,2023-08-11,201,paneer,210,340,130,1,00376,India
879469,2023-08-11,212,amul cheese,250,315,65,1,00376,India
339267,2023-08-11,204,strawberry yogurt,50,60,10,1,00345,India
339267,2023-08-11,211,red bull,90,125,35,1,00345,India
339267,2023-08-11,210,mountain dew,75,100,25,1,00345,India
219207,2023-08-11,211,red bull,90,125,35,1,00482,India
219207,2023-08-11,202,milk,12,27,15,1,00482,India
219207,2023-08-11,208,sprite,75,100,25,1,00482,India
219207,2023-08-11,207,coca cola,75,100,25,1,00482,India
994719,2023-08-11,211,red bull,90,125,35,1,00302,India
994719,2023-08-11,205,classic yogurt,45,60,15,1,00302,India
994719,2023-08-11,204,strawberry yogurt,50,60,10,1,00302,India
994719,2023-08-11,202,milk,12,27,15,1,00302,India
721772,2023-08-11,208,sprite,75,100,25,1,00276,India
721772,2023-08-11,206,yakult,360,400,40,1,00276,India
288125,2023-08-11,204,strawberry yogurt,50,60,10,1,00326,India
823067,2023-08-11,202,milk,12,27,15,1,00088,India
823067,2023-08-11,201,paneer,210,340,130,1,00088,India
823067,2023-08-11,213,bisleri,6,15,9,1,00088,India
234617,2023-08-11,204,strawberry yogurt,50,60,10,1,00103,India
234617,2023-08-11,202,milk,12,27,15,1,00103,India
234617,2023-08-11,201,paneer,210,340,130,1,00103,India
917617,2023-08-11,204,strawberry yogurt,50,60,10,1,00498,India
560454,2023-08-11,206,yakult,360,400,40,1,00311,India
711469,2023-08-11,204,strawberry yogurt,50,60,10,1,00148,India
711469,2023-08-11,201,paneer,210,340,130,1,00148,India
711469,2023-08-11,203,mango yogurt,50,60,10,1,00148,India
128218,2023-08-11,207,coca cola,75,100,25,1,00036,India
456545,2023-08-11,205,classic yogurt,45,60,15,1,00232,India
456545,2023-08-11,206,yakult,360,400,40,1,00232,India
429154,2023-08-11,206,yakult,360,400,40,1,00384,India
429154,2023-08-11,211,red bull,90,125,35,1,00384,India
429154,2023-08-11,212,amul cheese,250,315,65,1,00384,India
765927,2023-08-11,208,sprite,75,100,25,1,00305,India
765927,2023-08-11,207,coca cola,75,100,25,1,00305,India
765927,2023-08-11,211,red bull,90,125,35,1,00305,India
486567,2023-08-11,204,strawberry yogurt,50,60,10,1,00460,India
307448,2023-08-11,206,yakult,360,400,40,1,00393,India
319439,2023-08-11,207,coca cola,75,100,25,1,00030,India
319439,2023-08-11,202,milk,12,27,15,1,00030,India
319439,2023-08-11,208,sprite,75,100,25,1,00030,India
405753,2023-08-11,212,amul cheese,250,315,65,1,00007,India
283115,2023-08-11,205,classic yogurt,45,60,15,1,00460,India
283115,2023-08-11,206,yakult,360,400,40,1,00460,India
177885,2023-08-11,213,bisleri,6,15,9,1,00106,India
133939,2023-08-11,203,mango yogurt,50,60,10,1,00141,India
565529,2023-08-11,211,red bull,90,125,35,1,00391,India
565529,2023-08-11,205,classic yogurt,45,60,15,1,00391,India
565529,2023-08-11,204,strawberry yogurt,50,60,10,1,00391,India
988212,2023-08-11,206,yakult,360,400,40,1,00171,India
988212,2023-08-11,204,strawberry yogurt,50,60,10,1,00171,India
988212,2023-08-11,211,red bull,90,125,35,1,00171,India
988212,2023-08-11,208,sprite,75,100,25,1,00171,India
988212,2023-08-11,202,milk,12,27,15,1,00171,India
223821,2023-08-12,201,paneer,210,340,130,1,00264,India
223821,2023-08-12,208,sprite,75,100,25,1,00264,India
222361,2023-08-12,212,amul cheese,250,315,65,1,00047,India
848921,2023-08-12,207,coca cola,75,100,25,1,00321,India
848921,2023-08-12,206,yakult,360,400,40,1,00321,India
864883,2023-08-12,213,bisleri,6,15,9,1,00096,India
864883,2023-08-12,204,strawberry yogurt,50,60,10,1,00096,India
148768,2023-08-12,207,coca cola,75,100,25,1,00269,India
927590,2023-08-12,202,milk,12,27,15,1,00091,India
927590,2023-08-12,213,bisleri,6,15,9,1,00091,India
927590,2023-08-12,211,red bull,90,125,35,1,00091,India
610007,2023-08-12,213,bisleri,6,15,9,1,00102,India
610007,2023-08-12,206,yakult,360,400,40,1,00102,India
352639,2023-08-12,211,red bull,90,125,35,1,00166,India
352639,2023-08-12,212,amul cheese,250,315,65,1,00166,India
352639,2023-08-12,205,classic yogurt,45,60,15,1,00166,India
352639,2023-08-12,204,strawberry yogurt,50,60,10,1,00166,India
815526,2023-08-12,212,amul cheese,250,315,65,1,00230,India
815526,2023-08-12,205,classic yogurt,45,60,15,1,00230,India
273610,2023-08-12,205,classic yogurt,45,60,15,1,00178,India
273610,2023-08-12,208,sprite,75,100,25,1,00178,India
841978,2023-08-12,210,mountain dew,75,100,25,1,00211,India
841978,2023-08-12,202,milk,12,27,15,1,00211,India
706555,2023-08-12,212,amul cheese,250,315,65,1,00239,India
706555,2023-08-12,203,mango yogurt,50,60,10,1,00239,India
706555,2023-08-12,202,milk,12,27,15,1,00239,India
334986,2023-08-12,208,sprite,75,100,25,1,00004,India
334986,2023-08-12,201,paneer,210,340,130,1,00004,India
397206,2023-08-12,210,mountain dew,75,100,25,1,00312,India
397206,2023-08-12,213,bisleri,6,15,9,1,00312,India
397206,2023-08-12,203,mango yogurt,50,60,10,1,00312,India
114592,2023-08-12,212,amul cheese,250,315,65,1,00251,India
114592,2023-08-12,213,bisleri,6,15,9,1,00251,India
114592,2023-08-12,203,mango yogurt,50,60,10,1,00251,India
507939,2023-08-12,213,bisleri,6,15,9,1,00338,India
170902,2023-08-12,210,mountain dew,75,100,25,1,00441,India
170902,2023-08-12,207,coca cola,75,100,25,1,00441,India
950445,2023-08-12,205,classic yogurt,45,60,15,1,00165,India
999814,2023-08-12,204,strawberry yogurt,50,60,10,1,00342,India
324288,2023-08-12,205,classic yogurt,45,60,15,1,00192,India
324288,2023-08-12,204,strawberry yogurt,50,60,10,1,00192,India
324288,2023-08-12,212,amul cheese,250,315,65,1,00192,India
753272,2023-08-12,210,mountain dew,75,100,25,1,00356,India
753272,2023-08-12,213,bisleri,6,15,9,1,00356,India
753272,2023-08-12,209,pepsi,75,100,25,1,00356,India
753272,2023-08-12,204,strawberry yogurt,50,60,10,1,00356,India
753272,2023-08-12,211,red bull,90,125,35,1,00356,India
369420,2023-08-12,201,paneer,210,340,130,1,00087,India
369420,2023-08-12,205,classic yogurt,45,60,15,1,00087,India
369420,2023-08-12,209,pepsi,75,100,25,1,00087,India
583825,2023-08-12,210,mountain dew,75,100,25,1,00341,India
583825,2023-08-12,201,paneer,210,340,130,1,00341,India
583825,2023-08-12,211,red bull,90,125,35,1,00341,India
493362,2023-08-12,212,amul cheese,250,315,65,1,00122,India
493362,2023-08-12,203,mango yogurt,50,60,10,1,00122,India
493362,2023-08-12,211,red bull,90,125,35,1,00122,India
493362,2023-08-12,205,classic yogurt,45,60,15,1,00122,India
269415,2023-08-12,203,mango yogurt,50,60,10,1,00412,India
269415,2023-08-12,208,sprite,75,100,25,1,00412,India
269415,2023-08-12,210,mountain dew,75,100,25,1,00412,India
269415,2023-08-12,201,paneer,210,340,130,1,00412,India
307196,2023-08-12,213,bisleri,6,15,9,1,00030,India
307196,2023-08-12,207,coca cola,75,100,25,1,00030,India
307196,2023-08-12,210,mountain dew,75,100,25,1,00030,India
307196,2023-08-12,201,paneer,210,340,130,1,00030,India
102302,2023-08-12,213,bisleri,6,15,9,1,00409,India
102302,2023-08-12,206,yakult,360,400,40,1,00409,India
102302,2023-08-12,202,milk,12,27,15,1,00409,India
102302,2023-08-12,203,mango yogurt,50,60,10,1,00409,India
969502,2023-08-12,213,bisleri,6,15,9,1,00217,India
969502,2023-08-12,203,mango yogurt,50,60,10,1,00217,India
969502,2023-08-12,208,sprite,75,100,25,1,00217,India
119107,2023-08-12,204,strawberry yogurt,50,60,10,1,00448,India
119107,2023-08-12,209,pepsi,75,100,25,1,00448,India
119107,2023-08-12,206,yakult,360,400,40,1,00448,India
119107,2023-08-12,211,red bull,90,125,35,1,00448,India
613754,2023-08-12,208,sprite,75,100,25,1,00337,India
193286,2023-08-12,203,mango yogurt,50,60,10,1,00223,India
193286,2023-08-12,210,mountain dew,75,100,25,1,00223,India
193286,2023-08-12,211,red bull,90,125,35,1,00223,India
509032,2023-08-12,208,sprite,75,100,25,1,00298,India
509032,2023-08-12,207,coca cola,75,100,25,1,00298,India
509032,2023-08-12,203,mango yogurt,50,60,10,1,00298,India
535392,2023-08-12,206,yakult,360,400,40,1,00171,India
535392,2023-08-12,213,bisleri,6,15,9,1,00171,India
535392,2023-08-12,210,mountain dew,75,100,25,1,00171,India
264142,2023-08-12,212,amul cheese,250,315,65,1,00167,India
264142,2023-08-12,213,bisleri,6,15,9,1,00167,India
264142,2023-08-12,207,coca cola,75,100,25,1,00167,India
264142,2023-08-12,204,strawberry yogurt,50,60,10,1,00167,India
264142,2023-08-12,210,mountain dew,75,100,25,1,00167,India
418890,2023-08-12,205,classic yogurt,45,60,15,1,00172,India
382543,2023-08-12,211,red bull,90,125,35,1,00326,India
382543,2023-08-12,209,pepsi,75,100,25,1,00326,India
382543,2023-08-12,210,mountain dew,75,100,25,1,00326,India
947206,2023-08-12,203,mango yogurt,50,60,10,1,00122,India
947206,2023-08-12,212,amul cheese,250,315,65,1,00122,India
947206,2023-08-12,210,mountain dew,75,100,25,1,00122,India
947206,2023-08-12,211,red bull,90,125,35,1,00122,India
947206,2023-08-12,205,classic yogurt,45,60,15,1,00122,India
858517,2023-08-12,210,mountain dew,75,100,25,1,00237,India
858517,2023-08-12,213,bisleri,6,15,9,1,00237,India
858517,2023-08-12,212,amul cheese,250,315,65,1,00237,India
654986,2023-08-12,208,sprite,75,100,25,1,00096,India
654986,2023-08-12,207,coca cola,75,100,25,1,00096,India
654986,2023-08-12,203,mango yogurt,50,60,10,1,00096,India
654986,2023-08-12,210,mountain dew,75,100,25,1,00096,India
970289,2023-08-12,213,bisleri,6,15,9,1,00493,India
970289,2023-08-12,209,pepsi,75,100,25,1,00493,India
970289,2023-08-12,208,sprite,75,100,25,1,00493,India
970289,2023-08-12,203,mango yogurt,50,60,10,1,00493,India
970289,2023-08-12,206,yakult,360,400,40,1,00493,India
379515,2023-08-12,207,coca cola,75,100,25,1,00307,India
379515,2023-08-12,210,mountain dew,75,100,25,1,00307,India
379515,2023-08-12,212,amul cheese,250,315,65,1,00307,India
736285,2023-08-12,202,milk,12,27,15,1,00116,India
736285,2023-08-12,209,pepsi,75,100,25,1,00116,India
736285,2023-08-12,210,mountain dew,75,100,25,1,00116,India
736285,2023-08-12,207,coca cola,75,100,25,1,00116,India
693041,2023-08-12,210,mountain dew,75,100,25,1,00418,India
515641,2023-08-12,206,yakult,360,400,40,1,00216,India
627634,2023-08-12,205,classic yogurt,45,60,15,1,00434,India
627634,2023-08-12,213,bisleri,6,15,9,1,00434,India
995715,2023-08-12,204,strawberry yogurt,50,60,10,1,00037,India
995715,2023-08-12,205,classic yogurt,45,60,15,1,00037,India
881174,2023-08-12,209,pepsi,75,100,25,1,00376,India
881174,2023-08-12,202,milk,12,27,15,1,00376,India
881174,2023-08-12,207,coca cola,75,100,25,1,00376,India
312680,2023-08-12,212,amul cheese,250,315,65,1,00487,India
312680,2023-08-12,209,pepsi,75,100,25,1,00487,India
312680,2023-08-12,206,yakult,360,400,40,1,00487,India
312680,2023-08-12,213,bisleri,6,15,9,1,00487,India
810756,2023-08-12,205,classic yogurt,45,60,15,1,00395,India
810756,2023-08-12,213,bisleri,6,15,9,1,00395,India
810756,2023-08-12,206,yakult,360,400,40,1,00395,India
810756,2023-08-12,201,paneer,210,340,130,1,00395,India
279397,2023-08-12,211,red bull,90,125,35,1,00223,India
471845,2023-08-12,208,sprite,75,100,25,1,00061,India
471845,2023-08-12,209,pepsi,75,100,25,1,00061,India
150926,2023-08-12,211,red bull,90,125,35,1,00147,India
150926,2023-08-12,208,sprite,75,100,25,1,00147,India
150926,2023-08-12,205,classic yogurt,45,60,15,1,00147,India
150926,2023-08-12,202,milk,12,27,15,1,00147,India
292857,2023-08-12,213,bisleri,6,15,9,1,00340,India
292857,2023-08-12,201,paneer,210,340,130,1,00340,India
292857,2023-08-12,204,strawberry yogurt,50,60,10,1,00340,India
292857,2023-08-12,210,mountain dew,75,100,25,1,00340,India
292857,2023-08-12,208,sprite,75,100,25,1,00340,India
283326,2023-08-12,205,classic yogurt,45,60,15,1,00144,India
455648,2023-08-12,204,strawberry yogurt,50,60,10,1,00471,India
455648,2023-08-12,202,milk,12,27,15,1,00471,India
455648,2023-08-12,209,pepsi,75,100,25,1,00471,India
523472,2023-08-12,208,sprite,75,100,25,1,00099,India
523472,2023-08-12,202,milk,12,27,15,1,00099,India
325124,2023-08-12,202,milk,12,27,15,1,00152,India
325124,2023-08-12,203,mango yogurt,50,60,10,1,00152,India
325124,2023-08-12,213,bisleri,6,15,9,1,00152,India
325124,2023-08-12,210,mountain dew,75,100,25,1,00152,India
325124,2023-08-12,211,red bull,90,125,35,1,00152,India
925918,2023-08-12,212,amul cheese,250,315,65,1,00038,India
925918,2023-08-12,207,coca cola,75,100,25,1,00038,India
925918,2023-08-12,211,red bull,90,125,35,1,00038,India
925918,2023-08-12,208,sprite,75,100,25,1,00038,India
925918,2023-08-12,202,milk,12,27,15,1,00038,India
668499,2023-08-12,202,milk,12,27,15,1,00239,India
668499,2023-08-12,208,sprite,75,100,25,1,00239,India
668499,2023-08-12,203,mango yogurt,50,60,10,1,00239,India
337825,2023-08-12,209,pepsi,75,100,25,1,00396,India
337825,2023-08-12,207,coca cola,75,100,25,1,00396,India
337825,2023-08-12,204,strawberry yogurt,50,60,10,1,00396,India
337825,2023-08-12,201,paneer,210,340,130,1,00396,India
817607,2023-08-12,210,mountain dew,75,100,25,1,00002,India
817607,2023-08-12,211,red bull,90,125,35,1,00002,India
817607,2023-08-12,203,mango yogurt,50,60,10,1,00002,India
817607,2023-08-12,206,yakult,360,400,40,1,00002,India
290166,2023-08-12,209,pepsi,75,100,25,1,00272,India
290166,2023-08-12,205,classic yogurt,45,60,15,1,00272,India
515863,2023-08-12,213,bisleri,6,15,9,1,00434,India
515863,2023-08-12,205,classic yogurt,45,60,15,1,00434,India
875417,2023-08-12,202,milk,12,27,15,1,00454,India
732032,2023-08-12,208,sprite,75,100,25,1,00296,India
732032,2023-08-12,211,red bull,90,125,35,1,00296,India
732032,2023-08-12,203,mango yogurt,50,60,10,1,00296,India
973310,2023-08-12,209,pepsi,75,100,25,1,00028,India
973310,2023-08-12,210,mountain dew,75,100,25,1,00028,India
973310,2023-08-12,201,paneer,210,340,130,1,00028,India
617973,2023-08-12,207,coca cola,75,100,25,1,00287,India
617973,2023-08-12,212,amul cheese,250,315,65,1,00287,India
617973,2023-08-12,203,mango yogurt,50,60,10,1,00287,India
617973,2023-08-12,210,mountain dew,75,100,25,1,00287,India
135995,2023-08-12,205,classic yogurt,45,60,15,1,00022,India
135995,2023-08-12,211,red bull,90,125,35,1,00022,India
647280,2023-08-12,207,coca cola,75,100,25,1,00495,India
647280,2023-08-12,202,milk,12,27,15,1,00495,India
457332,2023-08-12,210,mountain dew,75,100,25,1,00269,India
457332,2023-08-12,204,strawberry yogurt,50,60,10,1,00269,India
457332,2023-08-12,206,yakult,360,400,40,1,00269,India
261543,2023-08-12,213,bisleri,6,15,9,1,00051,India
261543,2023-08-12,202,milk,12,27,15,1,00051,India
844933,2023-08-12,212,amul cheese,250,315,65,1,00100,India
844933,2023-08-12,209,pepsi,75,100,25,1,00100,India
844933,2023-08-12,201,paneer,210,340,130,1,00100,India
844933,2023-08-12,211,red bull,90,125,35,1,00100,India
895645,2023-08-12,203,mango yogurt,50,60,10,1,00389,India
895645,2023-08-12,204,strawberry yogurt,50,60,10,1,00389,India
895645,2023-08-12,207,coca cola,75,100,25,1,00389,India
895645,2023-08-12,211,red bull,90,125,35,1,00389,India
895645,2023-08-12,202,milk,12,27,15,1,00389,India
334726,2023-08-13,212,amul cheese,250,315,65,1,00095,India
334726,2023-08-13,211,red bull,90,125,35,1,00095,India
334726,2023-08-13,203,mango yogurt,50,60,10,1,00095,India
223827,2023-08-13,202,milk,12,27,15,1,00396,India
853745,2023-08-13,206,yakult,360,400,40,1,00031,India
972392,2023-08-13,201,paneer,210,340,130,1,00381,India
972392,2023-08-13,205,classic yogurt,45,60,15,1,00381,India
972392,2023-08-13,212,amul cheese,250,315,65,1,00381,India
801140,2023-08-13,201,paneer,210,340,130,1,00084,India
801140,2023-08-13,208,sprite,75,100,25,1,00084,India
801140,2023-08-13,213,bisleri,6,15,9,1,00084,India
801140,2023-08-13,206,yakult,360,400,40,1,00084,India
465068,2023-08-13,204,strawberry yogurt,50,60,10,1,00055,India
465068,2023-08-13,213,bisleri,6,15,9,1,00055,India
727459,2023-08-13,204,strawberry yogurt,50,60,10,1,00150,India
727459,2023-08-13,213,bisleri,6,15,9,1,00150,India
203208,2023-08-13,206,yakult,360,400,40,1,00138,India
670670,2023-08-13,210,mountain dew,75,100,25,1,00203,India
670670,2023-08-13,202,milk,12,27,15,1,00203,India
181999,2023-08-13,209,pepsi,75,100,25,1,00167,India
679096,2023-08-13,205,classic yogurt,45,60,15,1,00215,India
679096,2023-08-13,212,amul cheese,250,315,65,1,00215,India
679096,2023-08-13,208,sprite,75,100,25,1,00215,India
243416,2023-08-13,204,strawberry yogurt,50,60,10,1,00168,India
493080,2023-08-13,207,coca cola,75,100,25,1,00292,India
493080,2023-08-13,212,amul cheese,250,315,65,1,00292,India
248991,2023-08-13,207,coca cola,75,100,25,1,00495,India
592630,2023-08-13,202,milk,12,27,15,1,00371,India
592630,2023-08-13,206,yakult,360,400,40,1,00371,India
592630,2023-08-13,201,paneer,210,340,130,1,00371,India
592630,2023-08-13,211,red bull,90,125,35,1,00371,India
614216,2023-08-13,209,pepsi,75,100,25,1,00037,India
614216,2023-08-13,212,amul cheese,250,315,65,1,00037,India
230781,2023-08-13,213,bisleri,6,15,9,1,00392,India
230781,2023-08-13,211,red bull,90,125,35,1,00392,India
230781,2023-08-13,207,coca cola,75,100,25,1,00392,India
927046,2023-08-13,210,mountain dew,75,100,25,1,00388,India
927046,2023-08-13,213,bisleri,6,15,9,1,00388,India
927046,2023-08-13,207,coca cola,75,100,25,1,00388,India
927046,2023-08-13,202,milk,12,27,15,1,00388,India
687262,2023-08-13,208,sprite,75,100,25,1,00051,India
687262,2023-08-13,209,pepsi,75,100,25,1,00051,India
687262,2023-08-13,207,coca cola,75,100,25,1,00051,India
576727,2023-08-13,211,red bull,90,125,35,1,00014,India
576727,2023-08-13,213,bisleri,6,15,9,1,00014,India
576727,2023-08-13,208,sprite,75,100,25,1,00014,India
994916,2023-08-13,208,sprite,75,100,25,1,00261,India
133655,2023-08-13,211,red bull,90,125,35,1,00175,India
133655,2023-08-13,208,sprite,75,100,25,1,00175,India
947126,2023-08-13,213,bisleri,6,15,9,1,00318,India
947126,2023-08-13,203,mango yogurt,50,60,10,1,00318,India
947126,2023-08-13,208,sprite,75,100,25,1,00318,India
947126,2023-08-13,212,amul cheese,250,315,65,1,00318,India
180733,2023-08-13,210,mountain dew,75,100,25,1,00134,India
180733,2023-08-13,203,mango yogurt,50,60,10,1,00134,India
180733,2023-08-13,202,milk,12,27,15,1,00134,India
180733,2023-08-13,213,bisleri,6,15,9,1,00134,India
180733,2023-08-13,201,paneer,210,340,130,1,00134,India
813033,2023-08-13,208,sprite,75,100,25,1,00133,India
813033,2023-08-13,213,bisleri,6,15,9,1,00133,India
813033,2023-08-13,207,coca cola,75,100,25,1,00133,India
495868,2023-08-13,209,pepsi,75,100,25,1,00145,India
495868,2023-08-13,201,paneer,210,340,130,1,00145,India
495868,2023-08-13,208,sprite,75,100,25,1,00145,India
495868,2023-08-13,202,milk,12,27,15,1,00145,India
830764,2023-08-13,208,sprite,75,100,25,1,00183,India
830764,2023-08-13,207,coca cola,75,100,25,1,00183,India
347710,2023-08-13,211,red bull,90,125,35,1,00004,India
347710,2023-08-13,207,coca cola,75,100,25,1,00004,India
804483,2023-08-13,210,mountain dew,75,100,25,1,00023,India
804483,2023-08-13,207,coca cola,75,100,25,1,00023,India
804483,2023-08-13,204,strawberry yogurt,50,60,10,1,00023,India
804483,2023-08-13,213,bisleri,6,15,9,1,00023,India
703945,2023-08-13,213,bisleri,6,15,9,1,00161,India
703945,2023-08-13,206,yakult,360,400,40,1,00161,India
703945,2023-08-13,211,red bull,90,125,35,1,00161,India
292260,2023-08-13,213,bisleri,6,15,9,1,00200,India
292260,2023-08-13,211,red bull,90,125,35,1,00200,India
292260,2023-08-13,212,amul cheese,250,315,65,1,00200,India
650230,2023-08-13,207,coca cola,75,100,25,1,00383,India
650230,2023-08-13,209,pepsi,75,100,25,1,00383,India
650230,2023-08-13,212,amul cheese,250,315,65,1,00383,India
232328,2023-08-13,209,pepsi,75,100,25,1,00065,India
232328,2023-08-13,203,mango yogurt,50,60,10,1,00065,India
232328,2023-08-13,201,paneer,210,340,130,1,00065,India
884720,2023-08-13,212,amul cheese,250,315,65,1,00225,India
884720,2023-08-13,211,red bull,90,125,35,1,00225,India
884720,2023-08-13,204,strawberry yogurt,50,60,10,1,00225,India
990582,2023-08-13,201,paneer,210,340,130,1,00255,India
990582,2023-08-13,210,mountain dew,75,100,25,1,00255,India
511195,2023-08-13,204,strawberry yogurt,50,60,10,1,00040,India
511195,2023-08-13,211,red bull,90,125,35,1,00040,India
511195,2023-08-13,209,pepsi,75,100,25,1,00040,India
983440,2023-08-13,203,mango yogurt,50,60,10,1,00251,India
486709,2023-08-13,206,yakult,360,400,40,1,00039,India
486709,2023-08-13,207,coca cola,75,100,25,1,00039,India
486709,2023-08-13,212,amul cheese,250,315,65,1,00039,India
503377,2023-08-13,211,red bull,90,125,35,1,00484,India
503377,2023-08-13,206,yakult,360,400,40,1,00484,India
503377,2023-08-13,201,paneer,210,340,130,1,00484,India
503377,2023-08-13,209,pepsi,75,100,25,1,00484,India
813639,2023-08-13,211,red bull,90,125,35,1,00333,India
813639,2023-08-13,202,milk,12,27,15,1,00333,India
813639,2023-08-13,206,yakult,360,400,40,1,00333,India
208952,2023-08-13,201,paneer,210,340,130,1,00037,India
293006,2023-08-13,201,paneer,210,340,130,1,00239,India
976217,2023-08-13,212,amul cheese,250,315,65,1,00219,India
976217,2023-08-13,210,mountain dew,75,100,25,1,00219,India
640000,2023-08-13,203,mango yogurt,50,60,10,1,00399,India
640000,2023-08-13,204,strawberry yogurt,50,60,10,1,00399,India
367540,2023-08-13,207,coca cola,75,100,25,1,00332,India
367540,2023-08-13,205,classic yogurt,45,60,15,1,00332,India
367540,2023-08-13,202,milk,12,27,15,1,00332,India
367540,2023-08-13,210,mountain dew,75,100,25,1,00332,India
297085,2023-08-13,208,sprite,75,100,25,1,00382,India
297085,2023-08-13,203,mango yogurt,50,60,10,1,00382,India
297085,2023-08-13,202,milk,12,27,15,1,00382,India
145919,2023-08-13,203,mango yogurt,50,60,10,1,00026,India
145919,2023-08-13,206,yakult,360,400,40,1,00026,India
145919,2023-08-13,207,coca cola,75,100,25,1,00026,India
145919,2023-08-13,205,classic yogurt,45,60,15,1,00026,India
145919,2023-08-13,210,mountain dew,75,100,25,1,00026,India
527843,2023-08-13,206,yakult,360,400,40,1,00269,India
527843,2023-08-13,207,coca cola,75,100,25,1,00269,India
527843,2023-08-13,213,bisleri,6,15,9,1,00269,India
527843,2023-08-13,211,red bull,90,125,35,1,00269,India
813769,2023-08-13,202,milk,12,27,15,1,00306,India
638468,2023-08-13,202,milk,12,27,15,1,00176,India
638468,2023-08-13,201,paneer,210,340,130,1,00176,India
638468,2023-08-13,207,coca cola,75,100,25,1,00176,India
638468,2023-08-13,208,sprite,75,100,25,1,00176,India
410909,2023-08-13,201,paneer,210,340,130,1,00090,India
410909,2023-08-13,210,mountain dew,75,100,25,1,00090,India
410909,2023-08-13,208,sprite,75,100,25,1,00090,India
933477,2023-08-13,211,red bull,90,125,35,1,00333,India
933477,2023-08-13,205,classic yogurt,45,60,15,1,00333,India
933477,2023-08-13,208,sprite,75,100,25,1,00333,India
933477,2023-08-13,210,mountain dew,75,100,25,1,00333,India
933477,2023-08-13,201,paneer,210,340,130,1,00333,India
449410,2023-08-13,210,mountain dew,75,100,25,1,00472,India
449410,2023-08-13,205,classic yogurt,45,60,15,1,00472,India
449410,2023-08-13,209,pepsi,75,100,25,1,00472,India
385752,2023-08-13,207,coca cola,75,100,25,1,00240,India
385752,2023-08-13,202,milk,12,27,15,1,00240,India
385752,2023-08-13,212,amul cheese,250,315,65,1,00240,India
385752,2023-08-13,201,paneer,210,340,130,1,00240,India
654037,2023-08-13,208,sprite,75,100,25,1,00493,India
654037,2023-08-13,209,pepsi,75,100,25,1,00493,India
654037,2023-08-13,213,bisleri,6,15,9,1,00493,India
654037,2023-08-13,201,paneer,210,340,130,1,00493,India
897146,2023-08-13,212,amul cheese,250,315,65,1,00458,India
897146,2023-08-13,206,yakult,360,400,40,1,00458,India
897146,2023-08-13,204,strawberry yogurt,50,60,10,1,00458,India
897146,2023-08-13,211,red bull,90,125,35,1,00458,India
923820,2023-08-13,207,coca cola,75,100,25,1,00471,India
923820,2023-08-13,203,mango yogurt,50,60,10,1,00471,India
923820,2023-08-13,204,strawberry yogurt,50,60,10,1,00471,India
438971,2023-08-13,211,red bull,90,125,35,1,00323,India
438971,2023-08-13,207,coca cola,75,100,25,1,00323,India
443776,2023-08-13,213,bisleri,6,15,9,1,00451,India
443776,2023-08-13,204,strawberry yogurt,50,60,10,1,00451,India
443776,2023-08-13,212,amul cheese,250,315,65,1,00451,India
725614,2023-08-13,204,strawberry yogurt,50,60,10,1,00044,India
725614,2023-08-13,206,yakult,360,400,40,1,00044,India
725614,2023-08-13,209,pepsi,75,100,25,1,00044,India
960571,2023-08-13,207,coca cola,75,100,25,1,00183,India
960571,2023-08-13,205,classic yogurt,45,60,15,1,00183,India
960571,2023-08-13,209,pepsi,75,100,25,1,00183,India
786783,2023-08-13,208,sprite,75,100,25,1,00349,India
786783,2023-08-13,204,strawberry yogurt,50,60,10,1,00349,India
557253,2023-08-13,203,mango yogurt,50,60,10,1,00225,India
557253,2023-08-13,207,coca cola,75,100,25,1,00225,India
723938,2023-08-13,206,yakult,360,400,40,1,00365,India
723938,2023-08-13,211,red bull,90,125,35,1,00365,India
723938,2023-08-13,212,amul cheese,250,315,65,1,00365,India
524548,2023-08-13,203,mango yogurt,50,60,10,1,00266,India
524548,2023-08-13,206,yakult,360,400,40,1,00266,India
524548,2023-08-13,207,coca cola,75,100,25,1,00266,India
524548,2023-08-13,204,strawberry yogurt,50,60,10,1,00266,India
743448,2023-08-13,205,classic yogurt,45,60,15,1,00497,India
743448,2023-08-13,211,red bull,90,125,35,1,00497,India
743448,2023-08-13,210,mountain dew,75,100,25,1,00497,India
159582,2023-08-13,209,pepsi,75,100,25,1,00226,India
159582,2023-08-13,210,mountain dew,75,100,25,1,00226,India
159582,2023-08-13,202,milk,12,27,15,1,00226,India
348779,2023-08-13,207,coca cola,75,100,25,1,00144,India
348779,2023-08-13,211,red bull,90,125,35,1,00144,India
348779,2023-08-13,204,strawberry yogurt,50,60,10,1,00144,India
348779,2023-08-13,206,yakult,360,400,40,1,00144,India
576817,2023-08-13,202,milk,12,27,15,1,00170,India
375281,2023-08-14,210,mountain dew,75,100,25,1,00071,India
375281,2023-08-14,204,strawberry yogurt,50,60,10,1,00071,India
375281,2023-08-14,202,milk,12,27,15,1,00071,India
375281,2023-08-14,203,mango yogurt,50,60,10,1,00071,India
677329,2023-08-14,211,red bull,90,125,35,1,00152,India
677329,2023-08-14,213,bisleri,6,15,9,1,00152,India
877986,2023-08-14,207,coca cola,75,100,25,1,00097,India
877986,2023-08-14,212,amul cheese,250,315,65,1,00097,India
877986,2023-08-14,204,strawberry yogurt,50,60,10,1,00097,India
948935,2023-08-14,208,sprite,75,100,25,1,00460,India
948935,2023-08-14,210,mountain dew,75,100,25,1,00460,India
948935,2023-08-14,205,classic yogurt,45,60,15,1,00460,India
948935,2023-08-14,212,amul cheese,250,315,65,1,00460,India
948935,2023-08-14,202,milk,12,27,15,1,00460,India
921534,2023-08-14,211,red bull,90,125,35,1,00230,India
921534,2023-08-14,205,classic yogurt,45,60,15,1,00230,India
921534,2023-08-14,209,pepsi,75,100,25,1,00230,India
687607,2023-08-14,211,red bull,90,125,35,1,00392,India
825880,2023-08-14,204,strawberry yogurt,50,60,10,1,00374,India
816628,2023-08-14,205,classic yogurt,45,60,15,1,00277,India
816628,2023-08-14,204,strawberry yogurt,50,60,10,1,00277,India
816628,2023-08-14,206,yakult,360,400,40,1,00277,India
816628,2023-08-14,213,bisleri,6,15,9,1,00277,India
226839,2023-08-14,204,strawberry yogurt,50,60,10,1,00207,India
226839,2023-08-14,210,mountain dew,75,100,25,1,00207,India
648899,2023-08-14,203,mango yogurt,50,60,10,1,00286,India
648899,2023-08-14,204,strawberry yogurt,50,60,10,1,00286,India
590762,2023-08-14,212,amul cheese,250,315,65,1,00091,India
590762,2023-08-14,202,milk,12,27,15,1,00091,India
590762,2023-08-14,209,pepsi,75,100,25,1,00091,India
590762,2023-08-14,208,sprite,75,100,25,1,00091,India
590762,2023-08-14,211,red bull,90,125,35,1,00091,India
786091,2023-08-14,207,coca cola,75,100,25,1,00427,India
786091,2023-08-14,204,strawberry yogurt,50,60,10,1,00427,India
786091,2023-08-14,209,pepsi,75,100,25,1,00427,India
786091,2023-08-14,206,yakult,360,400,40,1,00427,India
786091,2023-08-14,203,mango yogurt,50,60,10,1,00427,India
645270,2023-08-14,203,mango yogurt,50,60,10,1,00329,India
645270,2023-08-14,206,yakult,360,400,40,1,00329,India
645270,2023-08-14,201,paneer,210,340,130,1,00329,India
703641,2023-08-14,210,mountain dew,75,100,25,1,00364,India
533905,2023-08-14,211,red bull,90,125,35,1,00080,India
533905,2023-08-14,208,sprite,75,100,25,1,00080,India
533905,2023-08-14,213,bisleri,6,15,9,1,00080,India
533905,2023-08-14,204,strawberry yogurt,50,60,10,1,00080,India
533905,2023-08-14,202,milk,12,27,15,1,00080,India
973330,2023-08-14,210,mountain dew,75,100,25,1,00082,India
973330,2023-08-14,201,paneer,210,340,130,1,00082,India
347886,2023-08-14,204,strawberry yogurt,50,60,10,1,00084,India
347886,2023-08-14,213,bisleri,6,15,9,1,00084,India
347886,2023-08-14,209,pepsi,75,100,25,1,00084,India
347886,2023-08-14,212,amul cheese,250,315,65,1,00084,India
417376,2023-08-14,213,bisleri,6,15,9,1,00118,India
417376,2023-08-14,208,sprite,75,100,25,1,00118,India
417376,2023-08-14,209,pepsi,75,100,25,1,00118,India
417376,2023-08-14,205,classic yogurt,45,60,15,1,00118,India
116334,2023-08-14,213,bisleri,6,15,9,1,00126,India
321894,2023-08-14,205,classic yogurt,45,60,15,1,00116,India
321894,2023-08-14,211,red bull,90,125,35,1,00116,India
978350,2023-08-14,204,strawberry yogurt,50,60,10,1,00158,India
978350,2023-08-14,213,bisleri,6,15,9,1,00158,India
978350,2023-08-14,208,sprite,75,100,25,1,00158,India
291294,2023-08-14,211,red bull,90,125,35,1,00192,India
291294,2023-08-14,205,classic yogurt,45,60,15,1,00192,India
682611,2023-08-14,212,amul cheese,250,315,65,1,00427,India
682611,2023-08-14,205,classic yogurt,45,60,15,1,00427,India
682611,2023-08-14,209,pepsi,75,100,25,1,00427,India
501890,2023-08-14,213,bisleri,6,15,9,1,00303,India
501890,2023-08-14,201,paneer,210,340,130,1,00303,India
793811,2023-08-14,209,pepsi,75,100,25,1,00056,India
793811,2023-08-14,203,mango yogurt,50,60,10,1,00056,India
198785,2023-08-14,213,bisleri,6,15,9,1,00497,India
198785,2023-08-14,202,milk,12,27,15,1,00497,India
198785,2023-08-14,203,mango yogurt,50,60,10,1,00497,India
198785,2023-08-14,205,classic yogurt,45,60,15,1,00497,India
198785,2023-08-14,209,pepsi,75,100,25,1,00497,India
976817,2023-08-14,206,yakult,360,400,40,1,00071,India
976817,2023-08-14,204,strawberry yogurt,50,60,10,1,00071,India
976817,2023-08-14,213,bisleri,6,15,9,1,00071,India
976817,2023-08-14,201,paneer,210,340,130,1,00071,India
771501,2023-08-14,208,sprite,75,100,25,1,00016,India
771501,2023-08-14,209,pepsi,75,100,25,1,00016,India
771501,2023-08-14,212,amul cheese,250,315,65,1,00016,India
771501,2023-08-14,211,red bull,90,125,35,1,00016,India
714653,2023-08-14,210,mountain dew,75,100,25,1,00433,India
714653,2023-08-14,213,bisleri,6,15,9,1,00433,India
714653,2023-08-14,204,strawberry yogurt,50,60,10,1,00433,India
714653,2023-08-14,203,mango yogurt,50,60,10,1,00433,India
589931,2023-08-14,203,mango yogurt,50,60,10,1,00483,India
589931,2023-08-14,208,sprite,75,100,25,1,00483,India
589931,2023-08-14,209,pepsi,75,100,25,1,00483,India
589931,2023-08-14,207,coca cola,75,100,25,1,00483,India
589931,2023-08-14,206,yakult,360,400,40,1,00483,India
460007,2023-08-14,206,yakult,360,400,40,1,00092,India
460007,2023-08-14,212,amul cheese,250,315,65,1,00092,India
452360,2023-08-14,202,milk,12,27,15,1,00247,India
452360,2023-08-14,211,red bull,90,125,35,1,00247,India
452360,2023-08-14,210,mountain dew,75,100,25,1,00247,India
452360,2023-08-14,212,amul cheese,250,315,65,1,00247,India
837141,2023-08-14,210,mountain dew,75,100,25,1,00426,India
837141,2023-08-14,209,pepsi,75,100,25,1,00426,India
837141,2023-08-14,206,yakult,360,400,40,1,00426,India
837141,2023-08-14,212,amul cheese,250,315,65,1,00426,India
859990,2023-08-14,212,amul cheese,250,315,65,1,00320,India
859990,2023-08-14,204,strawberry yogurt,50,60,10,1,00320,India
859990,2023-08-14,209,pepsi,75,100,25,1,00320,India
859990,2023-08-14,213,bisleri,6,15,9,1,00320,India
328752,2023-08-14,201,paneer,210,340,130,1,00348,India
410926,2023-08-14,207,coca cola,75,100,25,1,00230,India
725473,2023-08-14,208,sprite,75,100,25,1,00396,India
266856,2023-08-14,208,sprite,75,100,25,1,00218,India
266856,2023-08-14,201,paneer,210,340,130,1,00218,India
950789,2023-08-14,204,strawberry yogurt,50,60,10,1,00165,India
950789,2023-08-14,211,red bull,90,125,35,1,00165,India
138868,2023-08-14,209,pepsi,75,100,25,1,00195,India
138868,2023-08-14,205,classic yogurt,45,60,15,1,00195,India
138868,2023-08-14,212,amul cheese,250,315,65,1,00195,India
138868,2023-08-14,203,mango yogurt,50,60,10,1,00195,India
741840,2023-08-14,211,red bull,90,125,35,1,00270,India
741840,2023-08-14,202,milk,12,27,15,1,00270,India
741840,2023-08-14,209,pepsi,75,100,25,1,00270,India
484853,2023-08-14,205,classic yogurt,45,60,15,1,00489,India
484853,2023-08-14,206,yakult,360,400,40,1,00489,India
346868,2023-08-14,210,mountain dew,75,100,25,1,00400,India
346868,2023-08-14,204,strawberry yogurt,50,60,10,1,00400,India
346868,2023-08-14,208,sprite,75,100,25,1,00400,India
145820,2023-08-14,210,mountain dew,75,100,25,1,00069,India
145820,2023-08-14,203,mango yogurt,50,60,10,1,00069,India
993865,2023-08-14,204,strawberry yogurt,50,60,10,1,00428,India
993865,2023-08-14,202,milk,12,27,15,1,00428,India
993865,2023-08-14,209,pepsi,75,100,25,1,00428,India
993865,2023-08-14,208,sprite,75,100,25,1,00428,India
306123,2023-08-14,205,classic yogurt,45,60,15,1,00380,India
775299,2023-08-14,202,milk,12,27,15,1,00031,India
775299,2023-08-14,201,paneer,210,340,130,1,00031,India
775299,2023-08-14,208,sprite,75,100,25,1,00031,India
775299,2023-08-14,212,amul cheese,250,315,65,1,00031,India
508018,2023-08-14,201,paneer,210,340,130,1,00296,India
508018,2023-08-14,206,yakult,360,400,40,1,00296,India
508018,2023-08-14,211,red bull,90,125,35,1,00296,India
685107,2023-08-14,204,strawberry yogurt,50,60,10,1,00217,India
685107,2023-08-14,209,pepsi,75,100,25,1,00217,India
685107,2023-08-14,205,classic yogurt,45,60,15,1,00217,India
759083,2023-08-14,213,bisleri,6,15,9,1,00072,India
759083,2023-08-14,209,pepsi,75,100,25,1,00072,India
935157,2023-08-14,206,yakult,360,400,40,1,00039,India
935157,2023-08-14,204,strawberry yogurt,50,60,10,1,00039,India
935157,2023-08-14,207,coca cola,75,100,25,1,00039,India
430664,2023-08-14,204,strawberry yogurt,50,60,10,1,00325,India
430664,2023-08-14,201,paneer,210,340,130,1,00325,India
430664,2023-08-14,209,pepsi,75,100,25,1,00325,India
837859,2023-08-14,206,yakult,360,400,40,1,00033,India
837859,2023-08-14,204,strawberry yogurt,50,60,10,1,00033,India
837859,2023-08-14,208,sprite,75,100,25,1,00033,India
837859,2023-08-14,201,paneer,210,340,130,1,00033,India
164611,2023-08-14,203,mango yogurt,50,60,10,1,00177,India
933857,2023-08-14,204,strawberry yogurt,50,60,10,1,00259,India
933857,2023-08-14,201,paneer,210,340,130,1,00259,India
933857,2023-08-14,208,sprite,75,100,25,1,00259,India
933857,2023-08-14,211,red bull,90,125,35,1,00259,India
933857,2023-08-14,205,classic yogurt,45,60,15,1,00259,India
126926,2023-08-14,210,mountain dew,75,100,25,1,00186,India
884484,2023-08-14,205,classic yogurt,45,60,15,1,00246,India
884484,2023-08-14,202,milk,12,27,15,1,00246,India
685796,2023-08-14,211,red bull,90,125,35,1,00125,India
685796,2023-08-14,205,classic yogurt,45,60,15,1,00125,India
685796,2023-08-14,210,mountain dew,75,100,25,1,00125,India
685796,2023-08-14,209,pepsi,75,100,25,1,00125,India
250800,2023-08-14,210,mountain dew,75,100,25,1,00016,India
250800,2023-08-14,203,mango yogurt,50,60,10,1,00016,India
250800,2023-08-14,205,classic yogurt,45,60,15,1,00016,India
250800,2023-08-14,209,pepsi,75,100,25,1,00016,India
190680,2023-08-14,201,paneer,210,340,130,1,00260,India
190680,2023-08-14,207,coca cola,75,100,25,1,00260,India
190680,2023-08-14,205,classic yogurt,45,60,15,1,00260,India
190680,2023-08-14,208,sprite,75,100,25,1,00260,India
955780,2023-08-14,206,yakult,360,400,40,1,00009,India
955780,2023-08-14,208,sprite,75,100,25,1,00009,India
370362,2023-08-14,208,sprite,75,100,25,1,00280,India
370362,2023-08-14,211,red bull,90,125,35,1,00280,India
370362,2023-08-14,202,milk,12,27,15,1,00280,India
370362,2023-08-14,209,pepsi,75,100,25,1,00280,India
830344,2023-08-14,213,bisleri,6,15,9,1,00165,India
830344,2023-08-14,211,red bull,90,125,35,1,00165,India
830344,2023-08-14,212,amul cheese,250,315,65,1,00165,India
830344,2023-08-14,205,classic yogurt,45,60,15,1,00165,India
637411,2023-08-14,201,paneer,210,340,130,1,00135,India
637411,2023-08-14,205,classic yogurt,45,60,15,1,00135,India
137913,2023-08-14,202,milk,12,27,15,1,00273,India
137913,2023-08-14,204,strawberry yogurt,50,60,10,1,00273,India
137913,2023-08-14,209,pepsi,75,100,25,1,00273,India
137913,2023-08-14,211,red bull,90,125,35,1,00273,India
137913,2023-08-14,212,amul cheese,250,315,65,1,00273,India
240787,2023-08-14,205,classic yogurt,45,60,15,1,00276,India
845113,2023-08-14,211,red bull,90,125,35,1,00029,India
845113,2023-08-14,213,bisleri,6,15,9,1,00029,India
489910,2023-08-14,206,yakult,360,400,40,1,00128,India
267885,2023-08-14,202,milk,12,27,15,1,00299,India
267885,2023-08-14,204,strawberry yogurt,50,60,10,1,00299,India
267885,2023-08-14,208,sprite,75,100,25,1,00299,India
267885,2023-08-14,206,yakult,360,400,40,1,00299,India
293934,2023-08-14,208,sprite,75,100,25,1,00288,India
293934,2023-08-14,210,mountain dew,75,100,25,1,00288,India
293934,2023-08-14,201,paneer,210,340,130,1,00288,India
293934,2023-08-14,202,milk,12,27,15,1,00288,India
293934,2023-08-14,203,mango yogurt,50,60,10,1,00288,India
773524,2023-08-14,212,amul cheese,250,315,65,1,00478,India
773524,2023-08-14,201,paneer,210,340,130,1,00478,India
773524,2023-08-14,206,yakult,360,400,40,1,00478,India
773524,2023-08-14,210,mountain dew,75,100,25,1,00478,India
941256,2023-08-14,213,bisleri,6,15,9,1,00334,India
585184,2023-08-14,205,classic yogurt,45,60,15,1,00291,India
585184,2023-08-14,207,coca cola,75,100,25,1,00291,India
585184,2023-08-14,204,strawberry yogurt,50,60,10,1,00291,India
585184,2023-08-14,208,sprite,75,100,25,1,00291,India
585184,2023-08-14,202,milk,12,27,15,1,00291,India
827322,2023-08-14,202,milk,12,27,15,1,00296,India
827322,2023-08-14,205,classic yogurt,45,60,15,1,00296,India
827322,2023-08-14,203,mango yogurt,50,60,10,1,00296,India
827322,2023-08-14,208,sprite,75,100,25,1,00296,India
827322,2023-08-14,209,pepsi,75,100,25,1,00296,India
749554,2023-08-14,205,classic yogurt,45,60,15,1,00348,India
749554,2023-08-14,202,milk,12,27,15,1,00348,India
749554,2023-08-14,204,strawberry yogurt,50,60,10,1,00348,India
593934,2023-08-14,208,sprite,75,100,25,1,00217,India
593934,2023-08-14,203,mango yogurt,50,60,10,1,00217,India
593934,2023-08-14,209,pepsi,75,100,25,1,00217,India
593934,2023-08-14,201,paneer,210,340,130,1,00217,India
477986,2023-08-14,205,classic yogurt,45,60,15,1,00494,India
477986,2023-08-14,211,red bull,90,125,35,1,00494,India
840481,2023-08-14,212,amul cheese,250,315,65,1,00261,India
840481,2023-08-14,208,sprite,75,100,25,1,00261,India
840481,2023-08-14,203,mango yogurt,50,60,10,1,00261,India
840481,2023-08-14,210,mountain dew,75,100,25,1,00261,India
992864,2023-08-14,205,classic yogurt,45,60,15,1,00376,India
992864,2023-08-14,208,sprite,75,100,25,1,00376,India
992864,2023-08-14,201,paneer,210,340,130,1,00376,India
992864,2023-08-14,210,mountain dew,75,100,25,1,00376,India
740121,2023-08-14,204,strawberry yogurt,50,60,10,1,00025,India
220065,2023-08-14,208,sprite,75,100,25,1,00261,India
220065,2023-08-14,205,classic yogurt,45,60,15,1,00261,India
486964,2023-08-14,206,yakult,360,400,40,1,00031,India
486964,2023-08-14,212,amul cheese,250,315,65,1,00031,India
435183,2023-08-14,208,sprite,75,100,25,1,00120,India
435183,2023-08-14,210,mountain dew,75,100,25,1,00120,India
104493,2023-08-14,202,milk,12,27,15,1,00103,India
104493,2023-08-14,201,paneer,210,340,130,1,00103,India
520261,2023-08-14,201,paneer,210,340,130,1,00231,India
469483,2023-08-14,203,mango yogurt,50,60,10,1,00174,India
469483,2023-08-14,213,bisleri,6,15,9,1,00174,India
469483,2023-08-14,205,classic yogurt,45,60,15,1,00174,India
469483,2023-08-14,210,mountain dew,75,100,25,1,00174,India
584051,2023-08-14,213,bisleri,6,15,9,1,00330,India
584051,2023-08-14,204,strawberry yogurt,50,60,10,1,00330,India
584051,2023-08-14,211,red bull,90,125,35,1,00330,India
244070,2023-08-14,213,bisleri,6,15,9,1,00412,India
244070,2023-08-14,201,paneer,210,340,130,1,00412,India
244070,2023-08-14,202,milk,12,27,15,1,00412,India
328097,2023-08-15,213,bisleri,6,15,9,1,00222,India
760557,2023-08-15,202,milk,12,27,15,1,00469,India
760557,2023-08-15,207,coca cola,75,100,25,1,00469,India
760557,2023-08-15,201,paneer,210,340,130,1,00469,India
760557,2023-08-15,211,red bull,90,125,35,1,00469,India
500881,2023-08-15,210,mountain dew,75,100,25,1,00078,India
500881,2023-08-15,212,amul cheese,250,315,65,1,00078,India
500881,2023-08-15,202,milk,12,27,15,1,00078,India
500881,2023-08-15,203,mango yogurt,50,60,10,1,00078,India
500881,2023-08-15,213,bisleri,6,15,9,1,00078,India
914306,2023-08-15,202,milk,12,27,15,1,00136,India
914306,2023-08-15,204,strawberry yogurt,50,60,10,1,00136,India
914306,2023-08-15,209,pepsi,75,100,25,1,00136,India
130874,2023-08-15,212,amul cheese,250,315,65,1,00157,India
130874,2023-08-15,207,coca cola,75,100,25,1,00157,India
895824,2023-08-15,208,sprite,75,100,25,1,00480,India
895824,2023-08-15,205,classic yogurt,45,60,15,1,00480,India
895824,2023-08-15,204,strawberry yogurt,50,60,10,1,00480,India
993813,2023-08-15,208,sprite,75,100,25,1,00073,India
852516,2023-08-15,202,milk,12,27,15,1,00450,India
852516,2023-08-15,213,bisleri,6,15,9,1,00450,India
852516,2023-08-15,205,classic yogurt,45,60,15,1,00450,India
662425,2023-08-15,202,milk,12,27,15,1,00320,India
662425,2023-08-15,206,yakult,360,400,40,1,00320,India
791721,2023-08-15,208,sprite,75,100,25,1,00267,India
791721,2023-08-15,205,classic yogurt,45,60,15,1,00267,India
791721,2023-08-15,211,red bull,90,125,35,1,00267,India
934723,2023-08-15,209,pepsi,75,100,25,1,00343,India
934723,2023-08-15,208,sprite,75,100,25,1,00343,India
331900,2023-08-15,203,mango yogurt,50,60,10,1,00300,India
197316,2023-08-15,209,pepsi,75,100,25,1,00314,India
197316,2023-08-15,206,yakult,360,400,40,1,00314,India
154244,2023-08-15,202,milk,12,27,15,1,00373,India
630741,2023-08-15,209,pepsi,75,100,25,1,00291,India
630741,2023-08-15,212,amul cheese,250,315,65,1,00291,India
630741,2023-08-15,203,mango yogurt,50,60,10,1,00291,India
630741,2023-08-15,202,milk,12,27,15,1,00291,India
630741,2023-08-15,204,strawberry yogurt,50,60,10,1,00291,India
809318,2023-08-15,209,pepsi,75,100,25,1,00444,India
270417,2023-08-15,204,strawberry yogurt,50,60,10,1,00286,India
270417,2023-08-15,207,coca cola,75,100,25,1,00286,India
270417,2023-08-15,208,sprite,75,100,25,1,00286,India
270417,2023-08-15,210,mountain dew,75,100,25,1,00286,India
916418,2023-08-15,210,mountain dew,75,100,25,1,00202,India
916418,2023-08-15,204,strawberry yogurt,50,60,10,1,00202,India
916418,2023-08-15,211,red bull,90,125,35,1,00202,India
916418,2023-08-15,203,mango yogurt,50,60,10,1,00202,India
565934,2023-08-15,208,sprite,75,100,25,1,00389,India
565934,2023-08-15,210,mountain dew,75,100,25,1,00389,India
565934,2023-08-15,202,milk,12,27,15,1,00389,India
565934,2023-08-15,211,red bull,90,125,35,1,00389,India
660572,2023-08-15,208,sprite,75,100,25,1,00229,India
660572,2023-08-15,209,pepsi,75,100,25,1,00229,India
660572,2023-08-15,201,paneer,210,340,130,1,00229,India
660572,2023-08-15,211,red bull,90,125,35,1,00229,India
497358,2023-08-15,212,amul cheese,250,315,65,1,00209,India
891302,2023-08-15,201,paneer,210,340,130,1,00093,India
443569,2023-08-15,213,bisleri,6,15,9,1,00433,India
443569,2023-08-15,206,yakult,360,400,40,1,00433,India
443569,2023-08-15,207,coca cola,75,100,25,1,00433,India
926581,2023-08-15,206,yakult,360,400,40,1,00367,India
926581,2023-08-15,212,amul cheese,250,315,65,1,00367,India
694484,2023-08-15,210,mountain dew,75,100,25,1,00316,India
301144,2023-08-15,204,strawberry yogurt,50,60,10,1,00257,India
301144,2023-08-15,201,paneer,210,340,130,1,00257,India
713656,2023-08-15,205,classic yogurt,45,60,15,1,00365,India
713656,2023-08-15,208,sprite,75,100,25,1,00365,India
713656,2023-08-15,209,pepsi,75,100,25,1,00365,India
661608,2023-08-15,212,amul cheese,250,315,65,1,00220,India
661608,2023-08-15,203,mango yogurt,50,60,10,1,00220,India
661608,2023-08-15,213,bisleri,6,15,9,1,00220,India
654079,2023-08-15,204,strawberry yogurt,50,60,10,1,00499,India
654079,2023-08-15,213,bisleri,6,15,9,1,00499,India
654079,2023-08-15,202,milk,12,27,15,1,00499,India
440331,2023-08-15,205,classic yogurt,45,60,15,1,00495,India
394043,2023-08-15,209,pepsi,75,100,25,1,00372,India
394043,2023-08-15,201,paneer,210,340,130,1,00372,India
614599,2023-08-15,210,mountain dew,75,100,25,1,00078,India
614599,2023-08-15,208,sprite,75,100,25,1,00078,India
614599,2023-08-15,212,amul cheese,250,315,65,1,00078,India
614599,2023-08-15,205,classic yogurt,45,60,15,1,00078,India
614599,2023-08-15,213,bisleri,6,15,9,1,00078,India
224947,2023-08-15,208,sprite,75,100,25,1,00198,India
224947,2023-08-15,201,paneer,210,340,130,1,00198,India
224947,2023-08-15,209,pepsi,75,100,25,1,00198,India
666621,2023-08-15,209,pepsi,75,100,25,1,00027,India
666621,2023-08-15,212,amul cheese,250,315,65,1,00027,India
666621,2023-08-15,208,sprite,75,100,25,1,00027,India
397278,2023-08-15,210,mountain dew,75,100,25,1,00066,India
344436,2023-08-15,212,amul cheese,250,315,65,1,00006,India
344436,2023-08-15,203,mango yogurt,50,60,10,1,00006,India
344436,2023-08-15,205,classic yogurt,45,60,15,1,00006,India
147836,2023-08-15,201,paneer,210,340,130,1,00039,India
147836,2023-08-15,203,mango yogurt,50,60,10,1,00039,India
946910,2023-08-15,202,milk,12,27,15,1,00181,India
946910,2023-08-15,204,strawberry yogurt,50,60,10,1,00181,India
801390,2023-08-15,206,yakult,360,400,40,1,00221,India
738175,2023-08-15,212,amul cheese,250,315,65,1,00076,India
738175,2023-08-15,213,bisleri,6,15,9,1,00076,India
593355,2023-08-15,210,mountain dew,75,100,25,1,00467,India
389693,2023-08-15,201,paneer,210,340,130,1,00365,India
389693,2023-08-15,212,amul cheese,250,315,65,1,00365,India
389693,2023-08-15,205,classic yogurt,45,60,15,1,00365,India
389693,2023-08-15,203,mango yogurt,50,60,10,1,00365,India
906712,2023-08-15,201,paneer,210,340,130,1,00320,India
906712,2023-08-15,211,red bull,90,125,35,1,00320,India
906712,2023-08-15,209,pepsi,75,100,25,1,00320,India
906712,2023-08-15,208,sprite,75,100,25,1,00320,India
481577,2023-08-15,208,sprite,75,100,25,1,00020,India
301220,2023-08-15,203,mango yogurt,50,60,10,1,00004,India
301220,2023-08-15,205,classic yogurt,45,60,15,1,00004,India
183861,2023-08-15,211,red bull,90,125,35,1,00074,India
998726,2023-08-15,207,coca cola,75,100,25,1,00373,India
998726,2023-08-15,203,mango yogurt,50,60,10,1,00373,India
636067,2023-08-15,207,coca cola,75,100,25,1,00387,India
636067,2023-08-15,202,milk,12,27,15,1,00387,India
636067,2023-08-15,211,red bull,90,125,35,1,00387,India
636067,2023-08-15,208,sprite,75,100,25,1,00387,India
185030,2023-08-15,203,mango yogurt,50,60,10,1,00451,India
185030,2023-08-15,209,pepsi,75,100,25,1,00451,India
960437,2023-08-15,201,paneer,210,340,130,1,00431,India
960437,2023-08-15,212,amul cheese,250,315,65,1,00431,India
960437,2023-08-15,210,mountain dew,75,100,25,1,00431,India
429106,2023-08-15,203,mango yogurt,50,60,10,1,00077,India
429106,2023-08-15,205,classic yogurt,45,60,15,1,00077,India
927755,2023-08-15,213,bisleri,6,15,9,1,00364,India
927755,2023-08-15,204,strawberry yogurt,50,60,10,1,00364,India
927755,2023-08-15,206,yakult,360,400,40,1,00364,India
771844,2023-08-15,212,amul cheese,250,315,65,1,00175,India
623891,2023-08-15,202,milk,12,27,15,1,00286,India
214357,2023-08-15,203,mango yogurt,50,60,10,1,00468,India
214357,2023-08-15,205,classic yogurt,45,60,15,1,00468,India
214357,2023-08-15,210,mountain dew,75,100,25,1,00468,India
704280,2023-08-15,202,milk,12,27,15,1,00300,India
704280,2023-08-15,205,classic yogurt,45,60,15,1,00300,India
704280,2023-08-15,212,amul cheese,250,315,65,1,00300,India
704280,2023-08-15,206,yakult,360,400,40,1,00300,India
704280,2023-08-15,209,pepsi,75,100,25,1,00300,India
309318,2023-08-16,213,bisleri,6,15,9,1,00300,India
690516,2023-08-16,208,sprite,75,100,25,1,00347,India
690516,2023-08-16,211,red bull,90,125,35,1,00347,India
690516,2023-08-16,202,milk,12,27,15,1,00347,India
895751,2023-08-16,201,paneer,210,340,130,1,00420,India
895751,2023-08-16,204,strawberry yogurt,50,60,10,1,00420,India
895751,2023-08-16,210,mountain dew,75,100,25,1,00420,India
631233,2023-08-16,209,pepsi,75,100,25,1,00422,India
631233,2023-08-16,213,bisleri,6,15,9,1,00422,India
631233,2023-08-16,201,paneer,210,340,130,1,00422,India
631233,2023-08-16,202,milk,12,27,15,1,00422,India
912203,2023-08-16,202,milk,12,27,15,1,00021,India
912203,2023-08-16,206,yakult,360,400,40,1,00021,India
868768,2023-08-16,208,sprite,75,100,25,1,00003,India
868768,2023-08-16,204,strawberry yogurt,50,60,10,1,00003,India
166082,2023-08-16,206,yakult,360,400,40,1,00035,India
166082,2023-08-16,207,coca cola,75,100,25,1,00035,India
166082,2023-08-16,209,pepsi,75,100,25,1,00035,India
166082,2023-08-16,208,sprite,75,100,25,1,00035,India
166082,2023-08-16,204,strawberry yogurt,50,60,10,1,00035,India
937135,2023-08-16,203,mango yogurt,50,60,10,1,00305,India
937135,2023-08-16,204,strawberry yogurt,50,60,10,1,00305,India
937135,2023-08-16,201,paneer,210,340,130,1,00305,India
961905,2023-08-16,211,red bull,90,125,35,1,00094,India
961905,2023-08-16,209,pepsi,75,100,25,1,00094,India
961905,2023-08-16,207,coca cola,75,100,25,1,00094,India
961905,2023-08-16,201,paneer,210,340,130,1,00094,India
329827,2023-08-16,207,coca cola,75,100,25,1,00387,India
329827,2023-08-16,208,sprite,75,100,25,1,00387,India
329827,2023-08-16,206,yakult,360,400,40,1,00387,India
637154,2023-08-16,201,paneer,210,340,130,1,00314,India
637154,2023-08-16,203,mango yogurt,50,60,10,1,00314,India
593946,2023-08-16,201,paneer,210,340,130,1,00036,India
593946,2023-08-16,204,strawberry yogurt,50,60,10,1,00036,India
265431,2023-08-16,205,classic yogurt,45,60,15,1,00132,India
265431,2023-08-16,203,mango yogurt,50,60,10,1,00132,India
966918,2023-08-16,204,strawberry yogurt,50,60,10,1,00320,India
651081,2023-08-16,206,yakult,360,400,40,1,00326,India
651081,2023-08-16,211,red bull,90,125,35,1,00326,India
651081,2023-08-16,209,pepsi,75,100,25,1,00326,India
651081,2023-08-16,212,amul cheese,250,315,65,1,00326,India
651081,2023-08-16,203,mango yogurt,50,60,10,1,00326,India
339417,2023-08-16,202,milk,12,27,15,1,00407,India
339417,2023-08-16,204,strawberry yogurt,50,60,10,1,00407,India
339417,2023-08-16,205,classic yogurt,45,60,15,1,00407,India
339417,2023-08-16,203,mango yogurt,50,60,10,1,00407,India
339417,2023-08-16,213,bisleri,6,15,9,1,00407,India
472197,2023-08-16,212,amul cheese,250,315,65,1,00182,India
347890,2023-08-16,213,bisleri,6,15,9,1,00198,India
347890,2023-08-16,209,pepsi,75,100,25,1,00198,India
347890,2023-08-16,210,mountain dew,75,100,25,1,00198,India
347890,2023-08-16,204,strawberry yogurt,50,60,10,1,00198,India
693507,2023-08-16,208,sprite,75,100,25,1,00412,India
693507,2023-08-16,206,yakult,360,400,40,1,00412,India
693507,2023-08-16,207,coca cola,75,100,25,1,00412,India
306939,2023-08-16,201,paneer,210,340,130,1,00267,India
306939,2023-08-16,209,pepsi,75,100,25,1,00267,India
306939,2023-08-16,206,yakult,360,400,40,1,00267,India
684733,2023-08-16,211,red bull,90,125,35,1,00050,India
684733,2023-08-16,204,strawberry yogurt,50,60,10,1,00050,India
684733,2023-08-16,203,mango yogurt,50,60,10,1,00050,India
467969,2023-08-16,211,red bull,90,125,35,1,00170,India
467969,2023-08-16,202,milk,12,27,15,1,00170,India
249250,2023-08-16,211,red bull,90,125,35,1,00328,India
249250,2023-08-16,208,sprite,75,100,25,1,00328,India
848878,2023-08-16,207,coca cola,75,100,25,1,00297,India
848878,2023-08-16,202,milk,12,27,15,1,00297,India
820573,2023-08-16,209,pepsi,75,100,25,1,00500,India
820573,2023-08-16,208,sprite,75,100,25,1,00500,India
820573,2023-08-16,206,yakult,360,400,40,1,00500,India
820573,2023-08-16,202,milk,12,27,15,1,00500,India
592160,2023-08-16,212,amul cheese,250,315,65,1,00388,India
592160,2023-08-16,207,coca cola,75,100,25,1,00388,India
221599,2023-08-16,213,bisleri,6,15,9,1,00324,India
221599,2023-08-16,212,amul cheese,250,315,65,1,00324,India
215463,2023-08-16,204,strawberry yogurt,50,60,10,1,00477,India
215463,2023-08-16,212,amul cheese,250,315,65,1,00477,India
215463,2023-08-16,203,mango yogurt,50,60,10,1,00477,India
215463,2023-08-16,206,yakult,360,400,40,1,00477,India
838519,2023-08-16,213,bisleri,6,15,9,1,00178,India
838519,2023-08-16,204,strawberry yogurt,50,60,10,1,00178,India
473759,2023-08-16,204,strawberry yogurt,50,60,10,1,00006,India
934307,2023-08-16,203,mango yogurt,50,60,10,1,00284,India
514839,2023-08-16,205,classic yogurt,45,60,15,1,00087,India
514839,2023-08-16,207,coca cola,75,100,25,1,00087,India
731569,2023-08-16,205,classic yogurt,45,60,15,1,00447,India
731569,2023-08-16,204,strawberry yogurt,50,60,10,1,00447,India
583252,2023-08-16,212,amul cheese,250,315,65,1,00362,India
583252,2023-08-16,213,bisleri,6,15,9,1,00362,India
996451,2023-08-16,213,bisleri,6,15,9,1,00301,India
996451,2023-08-16,203,mango yogurt,50,60,10,1,00301,India
859456,2023-08-16,201,paneer,210,340,130,1,00414,India
511965,2023-08-16,212,amul cheese,250,315,65,1,00060,India
511965,2023-08-16,210,mountain dew,75,100,25,1,00060,India
511965,2023-08-16,209,pepsi,75,100,25,1,00060,India
723918,2023-08-16,208,sprite,75,100,25,1,00244,India
723918,2023-08-16,202,milk,12,27,15,1,00244,India
682969,2023-08-16,205,classic yogurt,45,60,15,1,00275,India
682969,2023-08-16,202,milk,12,27,15,1,00275,India
682969,2023-08-16,213,bisleri,6,15,9,1,00275,India
398009,2023-08-16,201,paneer,210,340,130,1,00430,India
102237,2023-08-16,204,strawberry yogurt,50,60,10,1,00237,India
102237,2023-08-16,211,red bull,90,125,35,1,00237,India
102237,2023-08-16,213,bisleri,6,15,9,1,00237,India
102237,2023-08-16,212,amul cheese,250,315,65,1,00237,India
102237,2023-08-16,207,coca cola,75,100,25,1,00237,India
362271,2023-08-16,207,coca cola,75,100,25,1,00216,India
362271,2023-08-16,206,yakult,360,400,40,1,00216,India
362271,2023-08-16,212,amul cheese,250,315,65,1,00216,India
222859,2023-08-16,202,milk,12,27,15,1,00403,India
222859,2023-08-16,207,coca cola,75,100,25,1,00403,India
222859,2023-08-16,212,amul cheese,250,315,65,1,00403,India
350594,2023-08-16,203,mango yogurt,50,60,10,1,00472,India
350594,2023-08-16,211,red bull,90,125,35,1,00472,India
350594,2023-08-16,210,mountain dew,75,100,25,1,00472,India
350594,2023-08-16,205,classic yogurt,45,60,15,1,00472,India
618573,2023-08-16,210,mountain dew,75,100,25,1,00317,India
843922,2023-08-16,202,milk,12,27,15,1,00314,India
843922,2023-08-16,208,sprite,75,100,25,1,00314,India
843922,2023-08-16,213,bisleri,6,15,9,1,00314,India
306989,2023-08-16,212,amul cheese,250,315,65,1,00077,India
306989,2023-08-16,207,coca cola,75,100,25,1,00077,India
306989,2023-08-16,202,milk,12,27,15,1,00077,India
520703,2023-08-16,207,coca cola,75,100,25,1,00449,India
520703,2023-08-16,202,milk,12,27,15,1,00449,India
520703,2023-08-16,204,strawberry yogurt,50,60,10,1,00449,India
520703,2023-08-16,208,sprite,75,100,25,1,00449,India
520703,2023-08-16,201,paneer,210,340,130,1,00449,India
807558,2023-08-16,201,paneer,210,340,130,1,00106,India
807558,2023-08-16,208,sprite,75,100,25,1,00106,India
807558,2023-08-16,202,milk,12,27,15,1,00106,India
807558,2023-08-16,203,mango yogurt,50,60,10,1,00106,India
807558,2023-08-16,209,pepsi,75,100,25,1,00106,India
985565,2023-08-16,208,sprite,75,100,25,1,00478,India
985565,2023-08-16,210,mountain dew,75,100,25,1,00478,India
985565,2023-08-16,211,red bull,90,125,35,1,00478,India
887365,2023-08-16,208,sprite,75,100,25,1,00078,India
440373,2023-08-16,209,pepsi,75,100,25,1,00488,India
440373,2023-08-16,203,mango yogurt,50,60,10,1,00488,India
440373,2023-08-16,212,amul cheese,250,315,65,1,00488,India
440373,2023-08-16,201,paneer,210,340,130,1,00488,India
440373,2023-08-16,213,bisleri,6,15,9,1,00488,India
380651,2023-08-16,204,strawberry yogurt,50,60,10,1,00322,India
380651,2023-08-16,205,classic yogurt,45,60,15,1,00322,India
380651,2023-08-16,213,bisleri,6,15,9,1,00322,India
784129,2023-08-16,205,classic yogurt,45,60,15,1,00441,India
913018,2023-08-16,201,paneer,210,340,130,1,00288,India
913018,2023-08-16,209,pepsi,75,100,25,1,00288,India
522648,2023-08-16,212,amul cheese,250,315,65,1,00376,India
290583,2023-08-16,201,paneer,210,340,130,1,00356,India
290583,2023-08-16,207,coca cola,75,100,25,1,00356,India
290583,2023-08-16,202,milk,12,27,15,1,00356,India
408045,2023-08-16,212,amul cheese,250,315,65,1,00204,India
408045,2023-08-16,211,red bull,90,125,35,1,00204,India
408045,2023-08-16,209,pepsi,75,100,25,1,00204,India
408045,2023-08-16,205,classic yogurt,45,60,15,1,00204,India
409885,2023-08-16,201,paneer,210,340,130,1,00476,India
409885,2023-08-16,206,yakult,360,400,40,1,00476,India
409885,2023-08-16,211,red bull,90,125,35,1,00476,India
409885,2023-08-16,203,mango yogurt,50,60,10,1,00476,India
196612,2023-08-16,210,mountain dew,75,100,25,1,00335,India
196612,2023-08-16,207,coca cola,75,100,25,1,00335,India
196612,2023-08-16,201,paneer,210,340,130,1,00335,India
442499,2023-08-16,211,red bull,90,125,35,1,00287,India
710168,2023-08-16,205,classic yogurt,45,60,15,1,00450,India
710168,2023-08-16,210,mountain dew,75,100,25,1,00450,India
710168,2023-08-16,212,amul cheese,250,315,65,1,00450,India
710168,2023-08-16,207,coca cola,75,100,25,1,00450,India
165484,2023-08-16,208,sprite,75,100,25,1,00083,India
165484,2023-08-16,205,classic yogurt,45,60,15,1,00083,India
408428,2023-08-16,207,coca cola,75,100,25,1,00275,India
821490,2023-08-16,210,mountain dew,75,100,25,1,00027,India
821490,2023-08-16,207,coca cola,75,100,25,1,00027,India
176591,2023-08-16,208,sprite,75,100,25,1,00015,India
176591,2023-08-16,206,yakult,360,400,40,1,00015,India
176591,2023-08-16,210,mountain dew,75,100,25,1,00015,India
176591,2023-08-16,205,classic yogurt,45,60,15,1,00015,India
176591,2023-08-16,203,mango yogurt,50,60,10,1,00015,India
907671,2023-08-16,211,red bull,90,125,35,1,00463,India
534798,2023-08-16,210,mountain dew,75,100,25,1,00117,India
534798,2023-08-16,205,classic yogurt,45,60,15,1,00117,India
534798,2023-08-16,206,yakult,360,400,40,1,00117,India
973566,2023-08-16,201,paneer,210,340,130,1,00135,India
973566,2023-08-16,208,sprite,75,100,25,1,00135,India
932647,2023-08-16,201,paneer,210,340,130,1,00325,India
932647,2023-08-16,208,sprite,75,100,25,1,00325,India
145872,2023-08-16,208,sprite,75,100,25,1,00121,India
145872,2023-08-16,210,mountain dew,75,100,25,1,00121,India
145872,2023-08-16,207,coca cola,75,100,25,1,00121,India
322410,2023-08-16,201,paneer,210,340,130,1,00078,India
322410,2023-08-16,210,mountain dew,75,100,25,1,00078,India
322410,2023-08-16,209,pepsi,75,100,25,1,00078,India
322410,2023-08-16,203,mango yogurt,50,60,10,1,00078,India
646064,2023-08-16,207,coca cola,75,100,25,1,00122,India
646064,2023-08-16,202,milk,12,27,15,1,00122,India
540752,2023-08-16,209,pepsi,75,100,25,1,00134,India
540752,2023-08-16,207,coca cola,75,100,25,1,00134,India
540752,2023-08-16,210,mountain dew,75,100,25,1,00134,India
417224,2023-08-17,201,paneer,210,340,130,1,00441,India
417224,2023-08-17,202,milk,12,27,15,1,00441,India
417224,2023-08-17,211,red bull,90,125,35,1,00441,India
417224,2023-08-17,207,coca cola,75,100,25,1,00441,India
251138,2023-08-17,206,yakult,360,400,40,1,00062,India
251138,2023-08-17,201,paneer,210,340,130,1,00062,India
251138,2023-08-17,203,mango yogurt,50,60,10,1,00062,India
251138,2023-08-17,209,pepsi,75,100,25,1,00062,India
634274,2023-08-17,210,mountain dew,75,100,25,1,00259,India
634274,2023-08-17,207,coca cola,75,100,25,1,00259,India
634274,2023-08-17,212,amul cheese,250,315,65,1,00259,India
634274,2023-08-17,205,classic yogurt,45,60,15,1,00259,India
655282,2023-08-17,213,bisleri,6,15,9,1,00125,India
655282,2023-08-17,212,amul cheese,250,315,65,1,00125,India
545475,2023-08-17,201,paneer,210,340,130,1,00312,India
545475,2023-08-17,202,milk,12,27,15,1,00312,India
329993,2023-08-17,201,paneer,210,340,130,1,00413,India
207039,2023-08-17,202,milk,12,27,15,1,00219,India
207039,2023-08-17,213,bisleri,6,15,9,1,00219,India
207039,2023-08-17,212,amul cheese,250,315,65,1,00219,India
207039,2023-08-17,211,red bull,90,125,35,1,00219,India
924834,2023-08-17,210,mountain dew,75,100,25,1,00173,India
757034,2023-08-17,201,paneer,210,340,130,1,00175,India
757034,2023-08-17,206,yakult,360,400,40,1,00175,India
481073,2023-08-17,201,paneer,210,340,130,1,00410,India
481073,2023-08-17,208,sprite,75,100,25,1,00410,India
481073,2023-08-17,202,milk,12,27,15,1,00410,India
335295,2023-08-17,203,mango yogurt,50,60,10,1,00023,India
335295,2023-08-17,206,yakult,360,400,40,1,00023,India
335295,2023-08-17,207,coca cola,75,100,25,1,00023,India
335295,2023-08-17,208,sprite,75,100,25,1,00023,India
417919,2023-08-17,202,milk,12,27,15,1,00399,India
417919,2023-08-17,213,bisleri,6,15,9,1,00399,India
417919,2023-08-17,205,classic yogurt,45,60,15,1,00399,India
417919,2023-08-17,206,yakult,360,400,40,1,00399,India
641346,2023-08-17,209,pepsi,75,100,25,1,00277,India
641346,2023-08-17,210,mountain dew,75,100,25,1,00277,India
641346,2023-08-17,204,strawberry yogurt,50,60,10,1,00277,India
182150,2023-08-17,211,red bull,90,125,35,1,00017,India
182150,2023-08-17,208,sprite,75,100,25,1,00017,India
663669,2023-08-17,204,strawberry yogurt,50,60,10,1,00261,India
663669,2023-08-17,203,mango yogurt,50,60,10,1,00261,India
683137,2023-08-17,205,classic yogurt,45,60,15,1,00450,India
683137,2023-08-17,201,paneer,210,340,130,1,00450,India
683137,2023-08-17,208,sprite,75,100,25,1,00450,India
683137,2023-08-17,210,mountain dew,75,100,25,1,00450,India
683137,2023-08-17,202,milk,12,27,15,1,00450,India
107085,2023-08-17,206,yakult,360,400,40,1,00171,India
107085,2023-08-17,201,paneer,210,340,130,1,00171,India
107085,2023-08-17,207,coca cola,75,100,25,1,00171,India
107085,2023-08-17,208,sprite,75,100,25,1,00171,India
233830,2023-08-17,202,milk,12,27,15,1,00191,India
233830,2023-08-17,201,paneer,210,340,130,1,00191,India
748387,2023-08-17,211,red bull,90,125,35,1,00304,India
748387,2023-08-17,209,pepsi,75,100,25,1,00304,India
613390,2023-08-17,211,red bull,90,125,35,1,00438,India
613390,2023-08-17,205,classic yogurt,45,60,15,1,00438,India
613390,2023-08-17,202,milk,12,27,15,1,00438,India
651246,2023-08-17,205,classic yogurt,45,60,15,1,00194,India
518261,2023-08-17,208,sprite,75,100,25,1,00347,India
518261,2023-08-17,213,bisleri,6,15,9,1,00347,India
518261,2023-08-17,205,classic yogurt,45,60,15,1,00347,India
518261,2023-08-17,207,coca cola,75,100,25,1,00347,India
518261,2023-08-17,204,strawberry yogurt,50,60,10,1,00347,India
214242,2023-08-17,210,mountain dew,75,100,25,1,00084,India
214242,2023-08-17,204,strawberry yogurt,50,60,10,1,00084,India
834792,2023-08-17,208,sprite,75,100,25,1,00392,India
834792,2023-08-17,205,classic yogurt,45,60,15,1,00392,India
728627,2023-08-17,207,coca cola,75,100,25,1,00282,India
728627,2023-08-17,204,strawberry yogurt,50,60,10,1,00282,India
728627,2023-08-17,209,pepsi,75,100,25,1,00282,India
728627,2023-08-17,203,mango yogurt,50,60,10,1,00282,India
355182,2023-08-17,204,strawberry yogurt,50,60,10,1,00389,India
355182,2023-08-17,208,sprite,75,100,25,1,00389,India
994431,2023-08-17,211,red bull,90,125,35,1,00055,India
994431,2023-08-17,204,strawberry yogurt,50,60,10,1,00055,India
994431,2023-08-17,202,milk,12,27,15,1,00055,India
373080,2023-08-17,207,coca cola,75,100,25,1,00276,India
373080,2023-08-17,201,paneer,210,340,130,1,00276,India
373080,2023-08-17,203,mango yogurt,50,60,10,1,00276,India
373080,2023-08-17,206,yakult,360,400,40,1,00276,India
373080,2023-08-17,213,bisleri,6,15,9,1,00276,India
494333,2023-08-17,210,mountain dew,75,100,25,1,00174,India
494333,2023-08-17,211,red bull,90,125,35,1,00174,India
494333,2023-08-17,203,mango yogurt,50,60,10,1,00174,India
380347,2023-08-17,206,yakult,360,400,40,1,00399,India
380347,2023-08-17,207,coca cola,75,100,25,1,00399,India
645571,2023-08-17,213,bisleri,6,15,9,1,00200,India
925628,2023-08-17,210,mountain dew,75,100,25,1,00096,India
925628,2023-08-17,203,mango yogurt,50,60,10,1,00096,India
925628,2023-08-17,208,sprite,75,100,25,1,00096,India
925628,2023-08-17,206,yakult,360,400,40,1,00096,India
383248,2023-08-17,206,yakult,360,400,40,1,00423,India
561283,2023-08-17,208,sprite,75,100,25,1,00077,India
561283,2023-08-17,204,strawberry yogurt,50,60,10,1,00077,India
561283,2023-08-17,209,pepsi,75,100,25,1,00077,India
787394,2023-08-17,213,bisleri,6,15,9,1,00428,India
787394,2023-08-17,210,mountain dew,75,100,25,1,00428,India
182281,2023-08-17,209,pepsi,75,100,25,1,00078,India
182281,2023-08-17,213,bisleri,6,15,9,1,00078,India
929584,2023-08-17,207,coca cola,75,100,25,1,00012,India
929584,2023-08-17,210,mountain dew,75,100,25,1,00012,India
929584,2023-08-17,212,amul cheese,250,315,65,1,00012,India
929584,2023-08-17,213,bisleri,6,15,9,1,00012,India
929584,2023-08-17,209,pepsi,75,100,25,1,00012,India
716131,2023-08-17,209,pepsi,75,100,25,1,00129,India
716131,2023-08-17,206,yakult,360,400,40,1,00129,India
175353,2023-08-17,213,bisleri,6,15,9,1,00236,India
175353,2023-08-17,202,milk,12,27,15,1,00236,India
112119,2023-08-17,208,sprite,75,100,25,1,00427,India
112119,2023-08-17,210,mountain dew,75,100,25,1,00427,India
112119,2023-08-17,202,milk,12,27,15,1,00427,India
435472,2023-08-17,213,bisleri,6,15,9,1,00241,India
359880,2023-08-17,207,coca cola,75,100,25,1,00266,India
723889,2023-08-17,201,paneer,210,340,130,1,00160,India
723889,2023-08-17,206,yakult,360,400,40,1,00160,India
723889,2023-08-17,203,mango yogurt,50,60,10,1,00160,India
723889,2023-08-17,212,amul cheese,250,315,65,1,00160,India
504402,2023-08-17,208,sprite,75,100,25,1,00293,India
504402,2023-08-17,212,amul cheese,250,315,65,1,00293,India
504402,2023-08-17,206,yakult,360,400,40,1,00293,India
504402,2023-08-17,202,milk,12,27,15,1,00293,India
294559,2023-08-17,208,sprite,75,100,25,1,00147,India
522946,2023-08-17,205,classic yogurt,45,60,15,1,00400,India
522946,2023-08-17,212,amul cheese,250,315,65,1,00400,India
522946,2023-08-17,207,coca cola,75,100,25,1,00400,India
388884,2023-08-17,211,red bull,90,125,35,1,00078,India
388884,2023-08-17,202,milk,12,27,15,1,00078,India
388884,2023-08-17,205,classic yogurt,45,60,15,1,00078,India
644027,2023-08-17,213,bisleri,6,15,9,1,00085,India
353622,2023-08-17,208,sprite,75,100,25,1,00457,India
353622,2023-08-17,202,milk,12,27,15,1,00457,India
491468,2023-08-17,204,strawberry yogurt,50,60,10,1,00132,India
491468,2023-08-17,213,bisleri,6,15,9,1,00132,India
491468,2023-08-17,210,mountain dew,75,100,25,1,00132,India
491468,2023-08-17,205,classic yogurt,45,60,15,1,00132,India
443510,2023-08-17,204,strawberry yogurt,50,60,10,1,00212,India
714623,2023-08-17,209,pepsi,75,100,25,1,00452,India
714623,2023-08-17,208,sprite,75,100,25,1,00452,India
714623,2023-08-17,205,classic yogurt,45,60,15,1,00452,India
714623,2023-08-17,202,milk,12,27,15,1,00452,India
714623,2023-08-17,211,red bull,90,125,35,1,00452,India
591436,2023-08-18,203,mango yogurt,50,60,10,1,00447,India
591436,2023-08-18,206,yakult,360,400,40,1,00447,India
591436,2023-08-18,201,paneer,210,340,130,1,00447,India
979987,2023-08-18,212,amul cheese,250,315,65,1,00191,India
979987,2023-08-18,213,bisleri,6,15,9,1,00191,India
979987,2023-08-18,211,red bull,90,125,35,1,00191,India
979987,2023-08-18,209,pepsi,75,100,25,1,00191,India
450042,2023-08-18,207,coca cola,75,100,25,1,00351,India
450042,2023-08-18,203,mango yogurt,50,60,10,1,00351,India
450042,2023-08-18,209,pepsi,75,100,25,1,00351,India
450042,2023-08-18,204,strawberry yogurt,50,60,10,1,00351,India
145639,2023-08-18,211,red bull,90,125,35,1,00204,India
145639,2023-08-18,203,mango yogurt,50,60,10,1,00204,India
841413,2023-08-18,205,classic yogurt,45,60,15,1,00070,India
841413,2023-08-18,204,strawberry yogurt,50,60,10,1,00070,India
841413,2023-08-18,201,paneer,210,340,130,1,00070,India
841413,2023-08-18,211,red bull,90,125,35,1,00070,India
221063,2023-08-18,209,pepsi,75,100,25,1,00067,India
221063,2023-08-18,208,sprite,75,100,25,1,00067,India
221063,2023-08-18,205,classic yogurt,45,60,15,1,00067,India
856348,2023-08-18,201,paneer,210,340,130,1,00431,India
856348,2023-08-18,204,strawberry yogurt,50,60,10,1,00431,India
856348,2023-08-18,212,amul cheese,250,315,65,1,00431,India
832676,2023-08-18,201,paneer,210,340,130,1,00466,India
142399,2023-08-18,205,classic yogurt,45,60,15,1,00409,India
142399,2023-08-18,211,red bull,90,125,35,1,00409,India
142399,2023-08-18,206,yakult,360,400,40,1,00409,India
484312,2023-08-18,207,coca cola,75,100,25,1,00406,India
484312,2023-08-18,212,amul cheese,250,315,65,1,00406,India
524504,2023-08-18,206,yakult,360,400,40,1,00318,India
524504,2023-08-18,204,strawberry yogurt,50,60,10,1,00318,India
524504,2023-08-18,201,paneer,210,340,130,1,00318,India
314255,2023-08-18,209,pepsi,75,100,25,1,00112,India
632897,2023-08-18,211,red bull,90,125,35,1,00176,India
632897,2023-08-18,204,strawberry yogurt,50,60,10,1,00176,India
632897,2023-08-18,210,mountain dew,75,100,25,1,00176,India
632897,2023-08-18,209,pepsi,75,100,25,1,00176,India
948572,2023-08-18,205,classic yogurt,45,60,15,1,00325,India
948572,2023-08-18,209,pepsi,75,100,25,1,00325,India
500332,2023-08-18,206,yakult,360,400,40,1,00231,India
749117,2023-08-18,212,amul cheese,250,315,65,1,00077,India
749117,2023-08-18,213,bisleri,6,15,9,1,00077,India
749117,2023-08-18,210,mountain dew,75,100,25,1,00077,India
749117,2023-08-18,204,strawberry yogurt,50,60,10,1,00077,India
749117,2023-08-18,207,coca cola,75,100,25,1,00077,India
657852,2023-08-18,209,pepsi,75,100,25,1,00251,India
657852,2023-08-18,205,classic yogurt,45,60,15,1,00251,India
657852,2023-08-18,213,bisleri,6,15,9,1,00251,India
657852,2023-08-18,202,milk,12,27,15,1,00251,India
635315,2023-08-18,203,mango yogurt,50,60,10,1,00199,India
635315,2023-08-18,209,pepsi,75,100,25,1,00199,India
635315,2023-08-18,213,bisleri,6,15,9,1,00199,India
955505,2023-08-18,211,red bull,90,125,35,1,00437,India
955505,2023-08-18,204,strawberry yogurt,50,60,10,1,00437,India
123898,2023-08-18,213,bisleri,6,15,9,1,00206,India
123898,2023-08-18,208,sprite,75,100,25,1,00206,India
344823,2023-08-18,210,mountain dew,75,100,25,1,00078,India
344823,2023-08-18,205,classic yogurt,45,60,15,1,00078,India
344823,2023-08-18,203,mango yogurt,50,60,10,1,00078,India
344823,2023-08-18,207,coca cola,75,100,25,1,00078,India
344823,2023-08-18,208,sprite,75,100,25,1,00078,India
525575,2023-08-18,204,strawberry yogurt,50,60,10,1,00021,India
388296,2023-08-18,204,strawberry yogurt,50,60,10,1,00312,India
905151,2023-08-18,208,sprite,75,100,25,1,00186,India
905151,2023-08-18,206,yakult,360,400,40,1,00186,India
905151,2023-08-18,204,strawberry yogurt,50,60,10,1,00186,India
797200,2023-08-18,203,mango yogurt,50,60,10,1,00284,India
797200,2023-08-18,212,amul cheese,250,315,65,1,00284,India
305140,2023-08-18,202,milk,12,27,15,1,00333,India
305140,2023-08-18,203,mango yogurt,50,60,10,1,00333,India
305140,2023-08-18,207,coca cola,75,100,25,1,00333,India
305140,2023-08-18,213,bisleri,6,15,9,1,00333,India
174885,2023-08-18,204,strawberry yogurt,50,60,10,1,00046,India
174885,2023-08-18,212,amul cheese,250,315,65,1,00046,India
174885,2023-08-18,210,mountain dew,75,100,25,1,00046,India
943596,2023-08-18,202,milk,12,27,15,1,00106,India
313895,2023-08-18,201,paneer,210,340,130,1,00369,India
313895,2023-08-18,208,sprite,75,100,25,1,00369,India
337949,2023-08-18,210,mountain dew,75,100,25,1,00308,India
337949,2023-08-18,204,strawberry yogurt,50,60,10,1,00308,India
868776,2023-08-18,212,amul cheese,250,315,65,1,00218,India
868776,2023-08-18,209,pepsi,75,100,25,1,00218,India
868776,2023-08-18,213,bisleri,6,15,9,1,00218,India
868776,2023-08-18,211,red bull,90,125,35,1,00218,India
128706,2023-08-18,206,yakult,360,400,40,1,00044,India
128706,2023-08-18,203,mango yogurt,50,60,10,1,00044,India
128706,2023-08-18,210,mountain dew,75,100,25,1,00044,India
128706,2023-08-18,202,milk,12,27,15,1,00044,India
841906,2023-08-18,203,mango yogurt,50,60,10,1,00222,India
990059,2023-08-18,210,mountain dew,75,100,25,1,00421,India
990059,2023-08-18,202,milk,12,27,15,1,00421,India
845966,2023-08-18,205,classic yogurt,45,60,15,1,00402,India
773433,2023-08-18,213,bisleri,6,15,9,1,00203,India
773433,2023-08-18,205,classic yogurt,45,60,15,1,00203,India
773433,2023-08-18,209,pepsi,75,100,25,1,00203,India
773433,2023-08-18,204,strawberry yogurt,50,60,10,1,00203,India
773433,2023-08-18,211,red bull,90,125,35,1,00203,India
576328,2023-08-18,204,strawberry yogurt,50,60,10,1,00257,India
726555,2023-08-18,205,classic yogurt,45,60,15,1,00469,India
726555,2023-08-18,213,bisleri,6,15,9,1,00469,India
726555,2023-08-18,212,amul cheese,250,315,65,1,00469,India
726555,2023-08-18,208,sprite,75,100,25,1,00469,India
104646,2023-08-18,204,strawberry yogurt,50,60,10,1,00435,India
506572,2023-08-18,210,mountain dew,75,100,25,1,00197,India
506572,2023-08-18,201,paneer,210,340,130,1,00197,India
858328,2023-08-18,208,sprite,75,100,25,1,00255,India
362650,2023-08-18,213,bisleri,6,15,9,1,00447,India
424613,2023-08-18,204,strawberry yogurt,50,60,10,1,00061,India
851403,2023-08-18,204,strawberry yogurt,50,60,10,1,00266,India
851403,2023-08-18,206,yakult,360,400,40,1,00266,India
968864,2023-08-18,202,milk,12,27,15,1,00133,India
968864,2023-08-18,210,mountain dew,75,100,25,1,00133,India
968864,2023-08-18,208,sprite,75,100,25,1,00133,India
968864,2023-08-18,203,mango yogurt,50,60,10,1,00133,India
491430,2023-08-18,213,bisleri,6,15,9,1,00095,India
491430,2023-08-18,211,red bull,90,125,35,1,00095,India
964282,2023-08-18,211,red bull,90,125,35,1,00316,India
964282,2023-08-18,201,paneer,210,340,130,1,00316,India
964282,2023-08-18,210,mountain dew,75,100,25,1,00316,India
964282,2023-08-18,202,milk,12,27,15,1,00316,India
985842,2023-08-18,207,coca cola,75,100,25,1,00022,India
985842,2023-08-18,211,red bull,90,125,35,1,00022,India
985842,2023-08-18,208,sprite,75,100,25,1,00022,India
985842,2023-08-18,203,mango yogurt,50,60,10,1,00022,India
985842,2023-08-18,209,pepsi,75,100,25,1,00022,India
623357,2023-08-18,205,classic yogurt,45,60,15,1,00228,India
623357,2023-08-18,213,bisleri,6,15,9,1,00228,India
623357,2023-08-18,210,mountain dew,75,100,25,1,00228,India
623357,2023-08-18,203,mango yogurt,50,60,10,1,00228,India
258501,2023-08-18,203,mango yogurt,50,60,10,1,00156,India
258501,2023-08-18,209,pepsi,75,100,25,1,00156,India
401858,2023-08-18,208,sprite,75,100,25,1,00308,India
401858,2023-08-18,206,yakult,360,400,40,1,00308,India
401858,2023-08-18,212,amul cheese,250,315,65,1,00308,India
401858,2023-08-18,213,bisleri,6,15,9,1,00308,India
807807,2023-08-18,211,red bull,90,125,35,1,00135,India
210963,2023-08-18,202,milk,12,27,15,1,00410,India
210963,2023-08-18,209,pepsi,75,100,25,1,00410,India
210963,2023-08-18,213,bisleri,6,15,9,1,00410,India
210963,2023-08-18,207,coca cola,75,100,25,1,00410,India
498520,2023-08-18,202,milk,12,27,15,1,00080,India
498520,2023-08-18,212,amul cheese,250,315,65,1,00080,India
426325,2023-08-18,202,milk,12,27,15,1,00434,India
426325,2023-08-18,201,paneer,210,340,130,1,00434,India
426325,2023-08-18,208,sprite,75,100,25,1,00434,India
486600,2023-08-18,213,bisleri,6,15,9,1,00253,India
486600,2023-08-18,212,amul cheese,250,315,65,1,00253,India
486600,2023-08-18,203,mango yogurt,50,60,10,1,00253,India
358428,2023-08-18,201,paneer,210,340,130,1,00060,India
358428,2023-08-18,209,pepsi,75,100,25,1,00060,India
358428,2023-08-18,210,mountain dew,75,100,25,1,00060,India
279103,2023-08-18,204,strawberry yogurt,50,60,10,1,00344,India
762951,2023-08-18,204,strawberry yogurt,50,60,10,1,00103,India
762951,2023-08-18,205,classic yogurt,45,60,15,1,00103,India
616811,2023-08-18,212,amul cheese,250,315,65,1,00319,India
616811,2023-08-18,202,milk,12,27,15,1,00319,India
597961,2023-08-18,207,coca cola,75,100,25,1,00437,India
597961,2023-08-18,204,strawberry yogurt,50,60,10,1,00437,India
597961,2023-08-18,203,mango yogurt,50,60,10,1,00437,India
196765,2023-08-18,213,bisleri,6,15,9,1,00417,India
196765,2023-08-18,204,strawberry yogurt,50,60,10,1,00417,India
196765,2023-08-18,212,amul cheese,250,315,65,1,00417,India
861121,2023-08-18,201,paneer,210,340,130,1,00200,India
861121,2023-08-18,204,strawberry yogurt,50,60,10,1,00200,India
424499,2023-08-18,210,mountain dew,75,100,25,1,00195,India
424499,2023-08-18,204,strawberry yogurt,50,60,10,1,00195,India
424499,2023-08-18,203,mango yogurt,50,60,10,1,00195,India
188848,2023-08-18,206,yakult,360,400,40,1,00281,India
442008,2023-08-18,208,sprite,75,100,25,1,00057,India
639910,2023-08-18,212,amul cheese,250,315,65,1,00091,India
395693,2023-08-18,212,amul cheese,250,315,65,1,00350,India
395693,2023-08-18,207,coca cola,75,100,25,1,00350,India
677488,2023-08-18,213,bisleri,6,15,9,1,00246,India
677488,2023-08-18,204,strawberry yogurt,50,60,10,1,00246,India
677488,2023-08-18,211,red bull,90,125,35,1,00246,India
677488,2023-08-18,209,pepsi,75,100,25,1,00246,India
470862,2023-08-19,209,pepsi,75,100,25,1,00403,India
470862,2023-08-19,206,yakult,360,400,40,1,00403,India
405700,2023-08-19,204,strawberry yogurt,50,60,10,1,00471,India
405700,2023-08-19,201,paneer,210,340,130,1,00471,India
405700,2023-08-19,213,bisleri,6,15,9,1,00471,India
653957,2023-08-19,212,amul cheese,250,315,65,1,00489,India
653957,2023-08-19,201,paneer,210,340,130,1,00489,India
653957,2023-08-19,213,bisleri,6,15,9,1,00489,India
720706,2023-08-19,206,yakult,360,400,40,1,00071,India
720706,2023-08-19,208,sprite,75,100,25,1,00071,India
720706,2023-08-19,210,mountain dew,75,100,25,1,00071,India
422048,2023-08-19,202,milk,12,27,15,1,00118,India
321093,2023-08-19,212,amul cheese,250,315,65,1,00242,India
321093,2023-08-19,204,strawberry yogurt,50,60,10,1,00242,India
321093,2023-08-19,210,mountain dew,75,100,25,1,00242,India
321093,2023-08-19,203,mango yogurt,50,60,10,1,00242,India
321093,2023-08-19,209,pepsi,75,100,25,1,00242,India
307698,2023-08-19,205,classic yogurt,45,60,15,1,00242,India
307698,2023-08-19,208,sprite,75,100,25,1,00242,India
307698,2023-08-19,204,strawberry yogurt,50,60,10,1,00242,India
307698,2023-08-19,209,pepsi,75,100,25,1,00242,India
425324,2023-08-19,202,milk,12,27,15,1,00470,India
861385,2023-08-19,212,amul cheese,250,315,65,1,00210,India
861385,2023-08-19,211,red bull,90,125,35,1,00210,India
861385,2023-08-19,207,coca cola,75,100,25,1,00210,India
861385,2023-08-19,202,milk,12,27,15,1,00210,India
861385,2023-08-19,204,strawberry yogurt,50,60,10,1,00210,India
764076,2023-08-19,212,amul cheese,250,315,65,1,00286,India
764076,2023-08-19,209,pepsi,75,100,25,1,00286,India
764076,2023-08-19,205,classic yogurt,45,60,15,1,00286,India
794731,2023-08-19,202,milk,12,27,15,1,00143,India
110600,2023-08-19,211,red bull,90,125,35,1,00241,India
110600,2023-08-19,205,classic yogurt,45,60,15,1,00241,India
110600,2023-08-19,202,milk,12,27,15,1,00241,India
807355,2023-08-19,207,coca cola,75,100,25,1,00283,India
117925,2023-08-19,210,mountain dew,75,100,25,1,00318,India
117925,2023-08-19,206,yakult,360,400,40,1,00318,India
117925,2023-08-19,208,sprite,75,100,25,1,00318,India
117925,2023-08-19,211,red bull,90,125,35,1,00318,India
117925,2023-08-19,213,bisleri,6,15,9,1,00318,India
500800,2023-08-19,201,paneer,210,340,130,1,00082,India
500800,2023-08-19,206,yakult,360,400,40,1,00082,India
500800,2023-08-19,211,red bull,90,125,35,1,00082,India
500800,2023-08-19,203,mango yogurt,50,60,10,1,00082,India
823395,2023-08-19,209,pepsi,75,100,25,1,00159,India
823395,2023-08-19,213,bisleri,6,15,9,1,00159,India
375003,2023-08-19,201,paneer,210,340,130,1,00349,India
503110,2023-08-19,209,pepsi,75,100,25,1,00425,India
668103,2023-08-19,205,classic yogurt,45,60,15,1,00134,India
668103,2023-08-19,206,yakult,360,400,40,1,00134,India
801355,2023-08-19,205,classic yogurt,45,60,15,1,00042,India
801355,2023-08-19,206,yakult,360,400,40,1,00042,India
801355,2023-08-19,208,sprite,75,100,25,1,00042,India
801355,2023-08-19,209,pepsi,75,100,25,1,00042,India
801355,2023-08-19,210,mountain dew,75,100,25,1,00042,India
156758,2023-08-19,213,bisleri,6,15,9,1,00496,India
156758,2023-08-19,212,amul cheese,250,315,65,1,00496,India
681256,2023-08-19,209,pepsi,75,100,25,1,00159,India
681256,2023-08-19,203,mango yogurt,50,60,10,1,00159,India
681256,2023-08-19,212,amul cheese,250,315,65,1,00159,India
384109,2023-08-19,205,classic yogurt,45,60,15,1,00464,India
384109,2023-08-19,210,mountain dew,75,100,25,1,00464,India
267386,2023-08-19,210,mountain dew,75,100,25,1,00031,India
267386,2023-08-19,208,sprite,75,100,25,1,00031,India
267386,2023-08-19,207,coca cola,75,100,25,1,00031,India
770425,2023-08-19,211,red bull,90,125,35,1,00016,India
770425,2023-08-19,213,bisleri,6,15,9,1,00016,India
419998,2023-08-19,201,paneer,210,340,130,1,00415,India
419998,2023-08-19,206,yakult,360,400,40,1,00415,India
419998,2023-08-19,212,amul cheese,250,315,65,1,00415,India
540716,2023-08-19,202,milk,12,27,15,1,00187,India
540716,2023-08-19,210,mountain dew,75,100,25,1,00187,India
540716,2023-08-19,204,strawberry yogurt,50,60,10,1,00187,India
540716,2023-08-19,213,bisleri,6,15,9,1,00187,India
561624,2023-08-19,205,classic yogurt,45,60,15,1,00461,India
561624,2023-08-19,201,paneer,210,340,130,1,00461,India
539404,2023-08-19,209,pepsi,75,100,25,1,00308,India
539404,2023-08-19,201,paneer,210,340,130,1,00308,India
495111,2023-08-19,207,coca cola,75,100,25,1,00007,India
906375,2023-08-19,208,sprite,75,100,25,1,00396,India
906375,2023-08-19,212,amul cheese,250,315,65,1,00396,India
906375,2023-08-19,211,red bull,90,125,35,1,00396,India
906375,2023-08-19,206,yakult,360,400,40,1,00396,India
896390,2023-08-19,201,paneer,210,340,130,1,00172,India
896390,2023-08-19,210,mountain dew,75,100,25,1,00172,India
156409,2023-08-19,211,red bull,90,125,35,1,00224,India
156409,2023-08-19,212,amul cheese,250,315,65,1,00224,India
156409,2023-08-19,208,sprite,75,100,25,1,00224,India
361825,2023-08-19,210,mountain dew,75,100,25,1,00388,India
361825,2023-08-19,209,pepsi,75,100,25,1,00388,India
361825,2023-08-19,202,milk,12,27,15,1,00388,India
672039,2023-08-19,205,classic yogurt,45,60,15,1,00347,India
672039,2023-08-19,209,pepsi,75,100,25,1,00347,India
674988,2023-08-19,212,amul cheese,250,315,65,1,00003,India
674988,2023-08-19,201,paneer,210,340,130,1,00003,India
674988,2023-08-19,213,bisleri,6,15,9,1,00003,India
674988,2023-08-19,211,red bull,90,125,35,1,00003,India
578619,2023-08-19,202,milk,12,27,15,1,00283,India
578619,2023-08-19,201,paneer,210,340,130,1,00283,India
578619,2023-08-19,211,red bull,90,125,35,1,00283,India
160936,2023-08-19,205,classic yogurt,45,60,15,1,00494,India
160936,2023-08-19,211,red bull,90,125,35,1,00494,India
393284,2023-08-19,206,yakult,360,400,40,1,00064,India
393284,2023-08-19,212,amul cheese,250,315,65,1,00064,India
387825,2023-08-19,202,milk,12,27,15,1,00274,India
387825,2023-08-19,212,amul cheese,250,315,65,1,00274,India
574733,2023-08-19,204,strawberry yogurt,50,60,10,1,00329,India
573422,2023-08-19,210,mountain dew,75,100,25,1,00155,India
573422,2023-08-19,203,mango yogurt,50,60,10,1,00155,India
573422,2023-08-19,208,sprite,75,100,25,1,00155,India
514227,2023-08-19,207,coca cola,75,100,25,1,00242,India
854727,2023-08-19,201,paneer,210,340,130,1,00204,India
854727,2023-08-19,202,milk,12,27,15,1,00204,India
854727,2023-08-19,207,coca cola,75,100,25,1,00204,India
854727,2023-08-19,203,mango yogurt,50,60,10,1,00204,India
293905,2023-08-19,212,amul cheese,250,315,65,1,00452,India
293905,2023-08-19,211,red bull,90,125,35,1,00452,India
293905,2023-08-19,207,coca cola,75,100,25,1,00452,India
726747,2023-08-19,207,coca cola,75,100,25,1,00377,India
726747,2023-08-19,204,strawberry yogurt,50,60,10,1,00377,India
726747,2023-08-19,206,yakult,360,400,40,1,00377,India
548141,2023-08-19,205,classic yogurt,45,60,15,1,00058,India
548141,2023-08-19,207,coca cola,75,100,25,1,00058,India
548141,2023-08-19,203,mango yogurt,50,60,10,1,00058,India
804535,2023-08-19,206,yakult,360,400,40,1,00061,India
804535,2023-08-19,204,strawberry yogurt,50,60,10,1,00061,India
804535,2023-08-19,207,coca cola,75,100,25,1,00061,India
804535,2023-08-19,210,mountain dew,75,100,25,1,00061,India
496113,2023-08-19,202,milk,12,27,15,1,00347,India
496113,2023-08-19,206,yakult,360,400,40,1,00347,India
496113,2023-08-19,208,sprite,75,100,25,1,00347,India
496113,2023-08-19,201,paneer,210,340,130,1,00347,India
496113,2023-08-19,204,strawberry yogurt,50,60,10,1,00347,India
815927,2023-08-19,211,red bull,90,125,35,1,00330,India
815927,2023-08-19,210,mountain dew,75,100,25,1,00330,India
815927,2023-08-19,205,classic yogurt,45,60,15,1,00330,India
815927,2023-08-19,208,sprite,75,100,25,1,00330,India
815927,2023-08-19,201,paneer,210,340,130,1,00330,India
212428,2023-08-19,201,paneer,210,340,130,1,00500,India
212428,2023-08-19,202,milk,12,27,15,1,00500,India
212428,2023-08-19,208,sprite,75,100,25,1,00500,India
212428,2023-08-19,203,mango yogurt,50,60,10,1,00500,India
212428,2023-08-19,212,amul cheese,250,315,65,1,00500,India
995422,2023-08-19,212,amul cheese,250,315,65,1,00157,India
995422,2023-08-19,203,mango yogurt,50,60,10,1,00157,India
995422,2023-08-19,208,sprite,75,100,25,1,00157,India
665806,2023-08-19,206,yakult,360,400,40,1,00027,India
813800,2023-08-19,202,milk,12,27,15,1,00097,India
813800,2023-08-19,209,pepsi,75,100,25,1,00097,India
813800,2023-08-19,212,amul cheese,250,315,65,1,00097,India
496907,2023-08-19,206,yakult,360,400,40,1,00285,India
496907,2023-08-19,210,mountain dew,75,100,25,1,00285,India
966632,2023-08-20,210,mountain dew,75,100,25,1,00076,India
966632,2023-08-20,209,pepsi,75,100,25,1,00076,India
966632,2023-08-20,212,amul cheese,250,315,65,1,00076,India
966632,2023-08-20,213,bisleri,6,15,9,1,00076,India
943462,2023-08-20,208,sprite,75,100,25,1,00057,India
943462,2023-08-20,203,mango yogurt,50,60,10,1,00057,India
880661,2023-08-20,209,pepsi,75,100,25,1,00001,India
606348,2023-08-20,211,red bull,90,125,35,1,00024,India
606348,2023-08-20,206,yakult,360,400,40,1,00024,India
606348,2023-08-20,203,mango yogurt,50,60,10,1,00024,India
606348,2023-08-20,209,pepsi,75,100,25,1,00024,India
606348,2023-08-20,202,milk,12,27,15,1,00024,India
474737,2023-08-20,203,mango yogurt,50,60,10,1,00162,India
973024,2023-08-20,202,milk,12,27,15,1,00220,India
973024,2023-08-20,201,paneer,210,340,130,1,00220,India
827550,2023-08-20,201,paneer,210,340,130,1,00034,India
422436,2023-08-20,204,strawberry yogurt,50,60,10,1,00311,India
422436,2023-08-20,211,red bull,90,125,35,1,00311,India
422436,2023-08-20,212,amul cheese,250,315,65,1,00311,India
599071,2023-08-20,209,pepsi,75,100,25,1,00026,India
599071,2023-08-20,210,mountain dew,75,100,25,1,00026,India
599071,2023-08-20,201,paneer,210,340,130,1,00026,India
599071,2023-08-20,212,amul cheese,250,315,65,1,00026,India
334615,2023-08-20,202,milk,12,27,15,1,00329,India
334615,2023-08-20,212,amul cheese,250,315,65,1,00329,India
334615,2023-08-20,208,sprite,75,100,25,1,00329,India
307252,2023-08-20,210,mountain dew,75,100,25,1,00154,India
307252,2023-08-20,201,paneer,210,340,130,1,00154,India
307252,2023-08-20,209,pepsi,75,100,25,1,00154,India
307252,2023-08-20,211,red bull,90,125,35,1,00154,India
377426,2023-08-20,210,mountain dew,75,100,25,1,00110,India
377426,2023-08-20,211,red bull,90,125,35,1,00110,India
304037,2023-08-20,210,mountain dew,75,100,25,1,00089,India
595859,2023-08-20,203,mango yogurt,50,60,10,1,00106,India
595859,2023-08-20,201,paneer,210,340,130,1,00106,India
256232,2023-08-20,203,mango yogurt,50,60,10,1,00323,India
443299,2023-08-20,208,sprite,75,100,25,1,00060,India
443299,2023-08-20,209,pepsi,75,100,25,1,00060,India
443299,2023-08-20,212,amul cheese,250,315,65,1,00060,India
163135,2023-08-20,202,milk,12,27,15,1,00286,India
163135,2023-08-20,204,strawberry yogurt,50,60,10,1,00286,India
529289,2023-08-20,212,amul cheese,250,315,65,1,00159,India
529289,2023-08-20,208,sprite,75,100,25,1,00159,India
529289,2023-08-20,211,red bull,90,125,35,1,00159,India
529289,2023-08-20,203,mango yogurt,50,60,10,1,00159,India
529289,2023-08-20,201,paneer,210,340,130,1,00159,India
707447,2023-08-20,207,coca cola,75,100,25,1,00275,India
969935,2023-08-20,202,milk,12,27,15,1,00368,India
162176,2023-08-20,206,yakult,360,400,40,1,00333,India
648325,2023-08-20,209,pepsi,75,100,25,1,00147,India
648325,2023-08-20,204,strawberry yogurt,50,60,10,1,00147,India
648325,2023-08-20,208,sprite,75,100,25,1,00147,India
648325,2023-08-20,210,mountain dew,75,100,25,1,00147,India
400868,2023-08-20,212,amul cheese,250,315,65,1,00081,India
400868,2023-08-20,209,pepsi,75,100,25,1,00081,India
400868,2023-08-20,205,classic yogurt,45,60,15,1,00081,India
400868,2023-08-20,204,strawberry yogurt,50,60,10,1,00081,India
400868,2023-08-20,210,mountain dew,75,100,25,1,00081,India
123867,2023-08-20,207,coca cola,75,100,25,1,00164,India
386481,2023-08-20,201,paneer,210,340,130,1,00150,India
128152,2023-08-20,208,sprite,75,100,25,1,00239,India
128152,2023-08-20,213,bisleri,6,15,9,1,00239,India
128152,2023-08-20,212,amul cheese,250,315,65,1,00239,India
128152,2023-08-20,202,milk,12,27,15,1,00239,India
929286,2023-08-20,203,mango yogurt,50,60,10,1,00190,India
541445,2023-08-20,205,classic yogurt,45,60,15,1,00456,India
541445,2023-08-20,203,mango yogurt,50,60,10,1,00456,India
541445,2023-08-20,212,amul cheese,250,315,65,1,00456,India
541445,2023-08-20,201,paneer,210,340,130,1,00456,India
843920,2023-08-20,209,pepsi,75,100,25,1,00231,India
843920,2023-08-20,202,milk,12,27,15,1,00231,India
843920,2023-08-20,205,classic yogurt,45,60,15,1,00231,India
843920,2023-08-20,213,bisleri,6,15,9,1,00231,India
843920,2023-08-20,203,mango yogurt,50,60,10,1,00231,India
249069,2023-08-20,212,amul cheese,250,315,65,1,00351,India
249069,2023-08-20,202,milk,12,27,15,1,00351,India
249069,2023-08-20,205,classic yogurt,45,60,15,1,00351,India
867198,2023-08-20,212,amul cheese,250,315,65,1,00196,India
867198,2023-08-20,201,paneer,210,340,130,1,00196,India
867198,2023-08-20,208,sprite,75,100,25,1,00196,India
973808,2023-08-20,205,classic yogurt,45,60,15,1,00110,India
964468,2023-08-20,206,yakult,360,400,40,1,00382,India
241152,2023-08-20,202,milk,12,27,15,1,00450,India
241152,2023-08-20,212,amul cheese,250,315,65,1,00450,India
849339,2023-08-20,207,coca cola,75,100,25,1,00304,India
849339,2023-08-20,211,red bull,90,125,35,1,00304,India
886734,2023-08-20,202,milk,12,27,15,1,00407,India
886734,2023-08-20,203,mango yogurt,50,60,10,1,00407,India
886734,2023-08-20,212,amul cheese,250,315,65,1,00407,India
886734,2023-08-20,208,sprite,75,100,25,1,00407,India
833267,2023-08-20,203,mango yogurt,50,60,10,1,00078,India
308206,2023-08-20,211,red bull,90,125,35,1,00123,India
920268,2023-08-20,209,pepsi,75,100,25,1,00278,India
920268,2023-08-20,211,red bull,90,125,35,1,00278,India
503195,2023-08-20,212,amul cheese,250,315,65,1,00052,India
503195,2023-08-20,213,bisleri,6,15,9,1,00052,India
503195,2023-08-20,208,sprite,75,100,25,1,00052,India
756055,2023-08-20,209,pepsi,75,100,25,1,00401,India
756055,2023-08-20,201,paneer,210,340,130,1,00401,India
176106,2023-08-20,208,sprite,75,100,25,1,00326,India
176106,2023-08-20,207,coca cola,75,100,25,1,00326,India
176106,2023-08-20,210,mountain dew,75,100,25,1,00326,India
176106,2023-08-20,206,yakult,360,400,40,1,00326,India
234000,2023-08-20,209,pepsi,75,100,25,1,00234,India
829328,2023-08-20,204,strawberry yogurt,50,60,10,1,00291,India
829328,2023-08-20,209,pepsi,75,100,25,1,00291,India
478740,2023-08-20,207,coca cola,75,100,25,1,00076,India
973762,2023-08-20,213,bisleri,6,15,9,1,00378,India
811251,2023-08-20,211,red bull,90,125,35,1,00106,India
811251,2023-08-20,212,amul cheese,250,315,65,1,00106,India
839943,2023-08-20,208,sprite,75,100,25,1,00217,India
839943,2023-08-20,209,pepsi,75,100,25,1,00217,India
193158,2023-08-20,204,strawberry yogurt,50,60,10,1,00045,India
325570,2023-08-20,213,bisleri,6,15,9,1,00058,India
325570,2023-08-20,201,paneer,210,340,130,1,00058,India
325570,2023-08-20,202,milk,12,27,15,1,00058,India
325570,2023-08-20,209,pepsi,75,100,25,1,00058,India
992702,2023-08-20,202,milk,12,27,15,1,00175,India
138405,2023-08-20,201,paneer,210,340,130,1,00103,India
138405,2023-08-20,213,bisleri,6,15,9,1,00103,India
138405,2023-08-20,212,amul cheese,250,315,65,1,00103,India
473198,2023-08-20,211,red bull,90,125,35,1,00349,India
473198,2023-08-20,212,amul cheese,250,315,65,1,00349,India
473198,2023-08-20,202,milk,12,27,15,1,00349,India
473198,2023-08-20,213,bisleri,6,15,9,1,00349,India
942518,2023-08-20,202,milk,12,27,15,1,00163,India
942518,2023-08-20,211,red bull,90,125,35,1,00163,India
262413,2023-08-20,203,mango yogurt,50,60,10,1,00368,India
262413,2023-08-20,213,bisleri,6,15,9,1,00368,India
262413,2023-08-20,208,sprite,75,100,25,1,00368,India
419494,2023-08-20,209,pepsi,75,100,25,1,00266,India
874571,2023-08-20,210,mountain dew,75,100,25,1,00231,India
874571,2023-08-20,208,sprite,75,100,25,1,00231,India
874571,2023-08-20,202,milk,12,27,15,1,00231,India
694758,2023-08-20,211,red bull,90,125,35,1,00075,India
694758,2023-08-20,201,paneer,210,340,130,1,00075,India
215024,2023-08-20,212,amul cheese,250,315,65,1,00346,India
215024,2023-08-20,206,yakult,360,400,40,1,00346,India
215024,2023-08-20,205,classic yogurt,45,60,15,1,00346,India
215024,2023-08-20,207,coca cola,75,100,25,1,00346,India
215024,2023-08-20,201,paneer,210,340,130,1,00346,India
464032,2023-08-20,207,coca cola,75,100,25,1,00131,India
464032,2023-08-20,208,sprite,75,100,25,1,00131,India
464032,2023-08-20,213,bisleri,6,15,9,1,00131,India
847199,2023-08-20,213,bisleri,6,15,9,1,00147,India
847199,2023-08-20,209,pepsi,75,100,25,1,00147,India
847199,2023-08-20,207,coca cola,75,100,25,1,00147,India
847199,2023-08-20,211,red bull,90,125,35,1,00147,India
100740,2023-08-20,213,bisleri,6,15,9,1,00036,India
100740,2023-08-20,209,pepsi,75,100,25,1,00036,India
100740,2023-08-20,210,mountain dew,75,100,25,1,00036,India
664017,2023-08-20,209,pepsi,75,100,25,1,00069,India
664017,2023-08-20,211,red bull,90,125,35,1,00069,India
118977,2023-08-20,202,milk,12,27,15,1,00191,India
118977,2023-08-20,208,sprite,75,100,25,1,00191,India
785824,2023-08-20,212,amul cheese,250,315,65,1,00067,India
666142,2023-08-20,204,strawberry yogurt,50,60,10,1,00036,India
666142,2023-08-20,201,paneer,210,340,130,1,00036,India
666142,2023-08-20,211,red bull,90,125,35,1,00036,India
796173,2023-08-20,201,paneer,210,340,130,1,00476,India
796173,2023-08-20,211,red bull,90,125,35,1,00476,India
796173,2023-08-20,209,pepsi,75,100,25,1,00476,India
796173,2023-08-20,213,bisleri,6,15,9,1,00476,India
796173,2023-08-20,212,amul cheese,250,315,65,1,00476,India
892429,2023-08-20,207,coca cola,75,100,25,1,00312,India
892429,2023-08-20,211,red bull,90,125,35,1,00312,India
797699,2023-08-20,213,bisleri,6,15,9,1,00243,India
446919,2023-08-20,204,strawberry yogurt,50,60,10,1,00398,India
446919,2023-08-20,203,mango yogurt,50,60,10,1,00398,India
446919,2023-08-20,212,amul cheese,250,315,65,1,00398,India
446919,2023-08-20,210,mountain dew,75,100,25,1,00398,India
178930,2023-08-20,209,pepsi,75,100,25,1,00404,India
178930,2023-08-20,202,milk,12,27,15,1,00404,India
985841,2023-08-21,206,yakult,360,400,40,1,00274,India
985841,2023-08-21,211,red bull,90,125,35,1,00274,India
123534,2023-08-21,210,mountain dew,75,100,25,1,00040,India
123534,2023-08-21,204,strawberry yogurt,50,60,10,1,00040,India
123534,2023-08-21,208,sprite,75,100,25,1,00040,India
123534,2023-08-21,213,bisleri,6,15,9,1,00040,India
481071,2023-08-21,201,paneer,210,340,130,1,00495,India
481071,2023-08-21,204,strawberry yogurt,50,60,10,1,00495,India
481071,2023-08-21,205,classic yogurt,45,60,15,1,00495,India
950061,2023-08-21,209,pepsi,75,100,25,1,00189,India
950061,2023-08-21,213,bisleri,6,15,9,1,00189,India
611174,2023-08-21,202,milk,12,27,15,1,00363,India
611174,2023-08-21,205,classic yogurt,45,60,15,1,00363,India
611174,2023-08-21,207,coca cola,75,100,25,1,00363,India
611174,2023-08-21,213,bisleri,6,15,9,1,00363,India
611174,2023-08-21,201,paneer,210,340,130,1,00363,India
868585,2023-08-21,208,sprite,75,100,25,1,00158,India
684829,2023-08-21,207,coca cola,75,100,25,1,00112,India
684829,2023-08-21,202,milk,12,27,15,1,00112,India
684829,2023-08-21,203,mango yogurt,50,60,10,1,00112,India
684829,2023-08-21,201,paneer,210,340,130,1,00112,India
175511,2023-08-21,210,mountain dew,75,100,25,1,00317,India
175511,2023-08-21,211,red bull,90,125,35,1,00317,India
175511,2023-08-21,205,classic yogurt,45,60,15,1,00317,India
614122,2023-08-21,207,coca cola,75,100,25,1,00339,India
614122,2023-08-21,201,paneer,210,340,130,1,00339,India
614122,2023-08-21,209,pepsi,75,100,25,1,00339,India
467305,2023-08-21,210,mountain dew,75,100,25,1,00102,India
467305,2023-08-21,206,yakult,360,400,40,1,00102,India
467305,2023-08-21,202,milk,12,27,15,1,00102,India
967219,2023-08-21,202,milk,12,27,15,1,00074,India
967219,2023-08-21,203,mango yogurt,50,60,10,1,00074,India
967219,2023-08-21,205,classic yogurt,45,60,15,1,00074,India
967219,2023-08-21,208,sprite,75,100,25,1,00074,India
967219,2023-08-21,211,red bull,90,125,35,1,00074,India
570278,2023-08-21,210,mountain dew,75,100,25,1,00022,India
570278,2023-08-21,211,red bull,90,125,35,1,00022,India
570278,2023-08-21,202,milk,12,27,15,1,00022,India
457976,2023-08-21,206,yakult,360,400,40,1,00438,India
457976,2023-08-21,213,bisleri,6,15,9,1,00438,India
457976,2023-08-21,204,strawberry yogurt,50,60,10,1,00438,India
522139,2023-08-21,206,yakult,360,400,40,1,00034,India
522139,2023-08-21,209,pepsi,75,100,25,1,00034,India
522139,2023-08-21,203,mango yogurt,50,60,10,1,00034,India
431865,2023-08-21,203,mango yogurt,50,60,10,1,00402,India
431865,2023-08-21,213,bisleri,6,15,9,1,00402,India
512495,2023-08-21,213,bisleri,6,15,9,1,00077,India
512495,2023-08-21,204,strawberry yogurt,50,60,10,1,00077,India
512495,2023-08-21,212,amul cheese,250,315,65,1,00077,India
194945,2023-08-21,205,classic yogurt,45,60,15,1,00377,India
194945,2023-08-21,208,sprite,75,100,25,1,00377,India
194945,2023-08-21,211,red bull,90,125,35,1,00377,India
194945,2023-08-21,212,amul cheese,250,315,65,1,00377,India
815378,2023-08-21,204,strawberry yogurt,50,60,10,1,00442,India
815378,2023-08-21,210,mountain dew,75,100,25,1,00442,India
606494,2023-08-21,202,milk,12,27,15,1,00126,India
606494,2023-08-21,206,yakult,360,400,40,1,00126,India
606494,2023-08-21,204,strawberry yogurt,50,60,10,1,00126,India
606494,2023-08-21,205,classic yogurt,45,60,15,1,00126,India
606494,2023-08-21,213,bisleri,6,15,9,1,00126,India
759991,2023-08-21,211,red bull,90,125,35,1,00094,India
628358,2023-08-21,204,strawberry yogurt,50,60,10,1,00227,India
628358,2023-08-21,202,milk,12,27,15,1,00227,India
628358,2023-08-21,211,red bull,90,125,35,1,00227,India
628358,2023-08-21,209,pepsi,75,100,25,1,00227,India
815575,2023-08-21,209,pepsi,75,100,25,1,00090,India
880919,2023-08-21,202,milk,12,27,15,1,00022,India
803745,2023-08-21,212,amul cheese,250,315,65,1,00135,India
803745,2023-08-21,210,mountain dew,75,100,25,1,00135,India
803745,2023-08-21,211,red bull,90,125,35,1,00135,India
803745,2023-08-21,205,classic yogurt,45,60,15,1,00135,India
249477,2023-08-21,213,bisleri,6,15,9,1,00453,India
249477,2023-08-21,206,yakult,360,400,40,1,00453,India
249477,2023-08-21,209,pepsi,75,100,25,1,00453,India
249477,2023-08-21,207,coca cola,75,100,25,1,00453,India
820285,2023-08-21,213,bisleri,6,15,9,1,00405,India
820285,2023-08-21,206,yakult,360,400,40,1,00405,India
820285,2023-08-21,205,classic yogurt,45,60,15,1,00405,India
636449,2023-08-21,204,strawberry yogurt,50,60,10,1,00163,India
636449,2023-08-21,210,mountain dew,75,100,25,1,00163,India
636449,2023-08-21,213,bisleri,6,15,9,1,00163,India
489826,2023-08-21,208,sprite,75,100,25,1,00462,India
489826,2023-08-21,207,coca cola,75,100,25,1,00462,India
640677,2023-08-21,203,mango yogurt,50,60,10,1,00454,India
640677,2023-08-21,211,red bull,90,125,35,1,00454,India
640677,2023-08-21,205,classic yogurt,45,60,15,1,00454,India
564028,2023-08-21,213,bisleri,6,15,9,1,00478,India
564028,2023-08-21,204,strawberry yogurt,50,60,10,1,00478,India
564028,2023-08-21,209,pepsi,75,100,25,1,00478,India
564028,2023-08-21,205,classic yogurt,45,60,15,1,00478,India
564028,2023-08-21,207,coca cola,75,100,25,1,00478,India
835277,2023-08-21,209,pepsi,75,100,25,1,00222,India
835277,2023-08-21,213,bisleri,6,15,9,1,00222,India
835277,2023-08-21,204,strawberry yogurt,50,60,10,1,00222,India
898722,2023-08-21,213,bisleri,6,15,9,1,00343,India
898722,2023-08-21,202,milk,12,27,15,1,00343,India
898722,2023-08-21,209,pepsi,75,100,25,1,00343,India
534447,2023-08-21,208,sprite,75,100,25,1,00207,India
534447,2023-08-21,212,amul cheese,250,315,65,1,00207,India
534447,2023-08-21,211,red bull,90,125,35,1,00207,India
534447,2023-08-21,209,pepsi,75,100,25,1,00207,India
534447,2023-08-21,213,bisleri,6,15,9,1,00207,India
943400,2023-08-21,205,classic yogurt,45,60,15,1,00370,India
943400,2023-08-21,212,amul cheese,250,315,65,1,00370,India
943400,2023-08-21,206,yakult,360,400,40,1,00370,India
943400,2023-08-21,210,mountain dew,75,100,25,1,00370,India
317218,2023-08-21,204,strawberry yogurt,50,60,10,1,00166,India
317218,2023-08-21,211,red bull,90,125,35,1,00166,India
317218,2023-08-21,206,yakult,360,400,40,1,00166,India
317218,2023-08-21,209,pepsi,75,100,25,1,00166,India
189255,2023-08-21,204,strawberry yogurt,50,60,10,1,00222,India
189255,2023-08-21,202,milk,12,27,15,1,00222,India
189255,2023-08-21,205,classic yogurt,45,60,15,1,00222,India
442645,2023-08-21,207,coca cola,75,100,25,1,00055,India
442645,2023-08-21,203,mango yogurt,50,60,10,1,00055,India
442645,2023-08-21,206,yakult,360,400,40,1,00055,India
442645,2023-08-21,212,amul cheese,250,315,65,1,00055,India
284501,2023-08-21,203,mango yogurt,50,60,10,1,00176,India
284501,2023-08-21,201,paneer,210,340,130,1,00176,India
284501,2023-08-21,205,classic yogurt,45,60,15,1,00176,India
542254,2023-08-21,210,mountain dew,75,100,25,1,00217,India
542254,2023-08-21,202,milk,12,27,15,1,00217,India
542254,2023-08-21,211,red bull,90,125,35,1,00217,India
154954,2023-08-21,203,mango yogurt,50,60,10,1,00007,India
851394,2023-08-21,202,milk,12,27,15,1,00136,India
851394,2023-08-21,208,sprite,75,100,25,1,00136,India
559163,2023-08-21,210,mountain dew,75,100,25,1,00461,India
559163,2023-08-21,213,bisleri,6,15,9,1,00461,India
886724,2023-08-21,212,amul cheese,250,315,65,1,00330,India
886724,2023-08-21,213,bisleri,6,15,9,1,00330,India
886724,2023-08-21,209,pepsi,75,100,25,1,00330,India
886724,2023-08-21,208,sprite,75,100,25,1,00330,India
554057,2023-08-21,208,sprite,75,100,25,1,00238,India
554057,2023-08-21,211,red bull,90,125,35,1,00238,India
554057,2023-08-21,205,classic yogurt,45,60,15,1,00238,India
634858,2023-08-21,212,amul cheese,250,315,65,1,00105,India
751411,2023-08-21,201,paneer,210,340,130,1,00343,India
751411,2023-08-21,203,mango yogurt,50,60,10,1,00343,India
751411,2023-08-21,206,yakult,360,400,40,1,00343,India
751411,2023-08-21,204,strawberry yogurt,50,60,10,1,00343,India
781512,2023-08-21,213,bisleri,6,15,9,1,00135,India
385521,2023-08-21,209,pepsi,75,100,25,1,00046,India
385521,2023-08-21,203,mango yogurt,50,60,10,1,00046,India
385521,2023-08-21,210,mountain dew,75,100,25,1,00046,India
135392,2023-08-21,211,red bull,90,125,35,1,00346,India
125156,2023-08-21,203,mango yogurt,50,60,10,1,00467,India
125156,2023-08-21,210,mountain dew,75,100,25,1,00467,India
125156,2023-08-21,213,bisleri,6,15,9,1,00467,India
470355,2023-08-22,212,amul cheese,250,315,65,1,00301,India
725470,2023-08-22,206,yakult,360,400,40,1,00431,India
725470,2023-08-22,203,mango yogurt,50,60,10,1,00431,India
725470,2023-08-22,213,bisleri,6,15,9,1,00431,India
514751,2023-08-22,212,amul cheese,250,315,65,1,00407,India
436283,2023-08-22,205,classic yogurt,45,60,15,1,00061,India
436283,2023-08-22,212,amul cheese,250,315,65,1,00061,India
436283,2023-08-22,213,bisleri,6,15,9,1,00061,India
434439,2023-08-22,212,amul cheese,250,315,65,1,00463,India
434439,2023-08-22,203,mango yogurt,50,60,10,1,00463,India
676224,2023-08-22,208,sprite,75,100,25,1,00066,India
676224,2023-08-22,202,milk,12,27,15,1,00066,India
671224,2023-08-22,203,mango yogurt,50,60,10,1,00107,India
671224,2023-08-22,209,pepsi,75,100,25,1,00107,India
671224,2023-08-22,206,yakult,360,400,40,1,00107,India
416393,2023-08-22,212,amul cheese,250,315,65,1,00258,India
416393,2023-08-22,201,paneer,210,340,130,1,00258,India
416393,2023-08-22,203,mango yogurt,50,60,10,1,00258,India
416393,2023-08-22,202,milk,12,27,15,1,00258,India
466062,2023-08-22,213,bisleri,6,15,9,1,00098,India
466062,2023-08-22,206,yakult,360,400,40,1,00098,India
466062,2023-08-22,208,sprite,75,100,25,1,00098,India
466062,2023-08-22,202,milk,12,27,15,1,00098,India
212614,2023-08-22,209,pepsi,75,100,25,1,00025,India
212614,2023-08-22,202,milk,12,27,15,1,00025,India
212614,2023-08-22,210,mountain dew,75,100,25,1,00025,India
212614,2023-08-22,201,paneer,210,340,130,1,00025,India
545872,2023-08-22,204,strawberry yogurt,50,60,10,1,00414,India
793809,2023-08-22,203,mango yogurt,50,60,10,1,00200,India
793809,2023-08-22,210,mountain dew,75,100,25,1,00200,India
793809,2023-08-22,207,coca cola,75,100,25,1,00200,India
793809,2023-08-22,212,amul cheese,250,315,65,1,00200,India
510525,2023-08-22,203,mango yogurt,50,60,10,1,00180,India
510525,2023-08-22,206,yakult,360,400,40,1,00180,India
510525,2023-08-22,207,coca cola,75,100,25,1,00180,India
510525,2023-08-22,201,paneer,210,340,130,1,00180,India
510525,2023-08-22,205,classic yogurt,45,60,15,1,00180,India
693527,2023-08-22,206,yakult,360,400,40,1,00074,India
693527,2023-08-22,208,sprite,75,100,25,1,00074,India
693527,2023-08-22,213,bisleri,6,15,9,1,00074,India
836938,2023-08-22,212,amul cheese,250,315,65,1,00021,India
836938,2023-08-22,211,red bull,90,125,35,1,00021,India
836938,2023-08-22,201,paneer,210,340,130,1,00021,India
836938,2023-08-22,202,milk,12,27,15,1,00021,India
479173,2023-08-22,212,amul cheese,250,315,65,1,00473,India
846160,2023-08-22,201,paneer,210,340,130,1,00447,India
846160,2023-08-22,204,strawberry yogurt,50,60,10,1,00447,India
846160,2023-08-22,210,mountain dew,75,100,25,1,00447,India
846160,2023-08-22,207,coca cola,75,100,25,1,00447,India
846160,2023-08-22,203,mango yogurt,50,60,10,1,00447,India
506495,2023-08-22,210,mountain dew,75,100,25,1,00221,India
506495,2023-08-22,202,milk,12,27,15,1,00221,India
720276,2023-08-22,204,strawberry yogurt,50,60,10,1,00225,India
720276,2023-08-22,210,mountain dew,75,100,25,1,00225,India
720276,2023-08-22,211,red bull,90,125,35,1,00225,India
720276,2023-08-22,206,yakult,360,400,40,1,00225,India
217534,2023-08-22,207,coca cola,75,100,25,1,00227,India
217534,2023-08-22,203,mango yogurt,50,60,10,1,00227,India
713604,2023-08-22,209,pepsi,75,100,25,1,00115,India
713604,2023-08-22,210,mountain dew,75,100,25,1,00115,India
713604,2023-08-22,212,amul cheese,250,315,65,1,00115,India
956917,2023-08-22,210,mountain dew,75,100,25,1,00196,India
956917,2023-08-22,204,strawberry yogurt,50,60,10,1,00196,India
956917,2023-08-22,213,bisleri,6,15,9,1,00196,India
956917,2023-08-22,208,sprite,75,100,25,1,00196,India
956917,2023-08-22,202,milk,12,27,15,1,00196,India
488399,2023-08-22,213,bisleri,6,15,9,1,00102,India
488399,2023-08-22,209,pepsi,75,100,25,1,00102,India
488399,2023-08-22,201,paneer,210,340,130,1,00102,India
488399,2023-08-22,210,mountain dew,75,100,25,1,00102,India
164449,2023-08-22,205,classic yogurt,45,60,15,1,00152,India
164449,2023-08-22,210,mountain dew,75,100,25,1,00152,India
105901,2023-08-22,201,paneer,210,340,130,1,00352,India
105901,2023-08-22,207,coca cola,75,100,25,1,00352,India
105901,2023-08-22,203,mango yogurt,50,60,10,1,00352,India
338235,2023-08-22,211,red bull,90,125,35,1,00088,India
338235,2023-08-22,206,yakult,360,400,40,1,00088,India
338235,2023-08-22,213,bisleri,6,15,9,1,00088,India
244959,2023-08-22,207,coca cola,75,100,25,1,00385,India
244959,2023-08-22,201,paneer,210,340,130,1,00385,India
407865,2023-08-22,210,mountain dew,75,100,25,1,00305,India
908224,2023-08-22,201,paneer,210,340,130,1,00266,India
908224,2023-08-22,205,classic yogurt,45,60,15,1,00266,India
908224,2023-08-22,202,milk,12,27,15,1,00266,India
388400,2023-08-22,204,strawberry yogurt,50,60,10,1,00193,India
388400,2023-08-22,206,yakult,360,400,40,1,00193,India
811418,2023-08-22,206,yakult,360,400,40,1,00495,India
811418,2023-08-22,201,paneer,210,340,130,1,00495,India
811418,2023-08-22,207,coca cola,75,100,25,1,00495,India
811418,2023-08-22,211,red bull,90,125,35,1,00495,India
667175,2023-08-22,208,sprite,75,100,25,1,00317,India
978575,2023-08-22,207,coca cola,75,100,25,1,00066,India
978575,2023-08-22,201,paneer,210,340,130,1,00066,India
978575,2023-08-22,209,pepsi,75,100,25,1,00066,India
978575,2023-08-22,211,red bull,90,125,35,1,00066,India
373937,2023-08-22,207,coca cola,75,100,25,1,00431,India
373937,2023-08-22,205,classic yogurt,45,60,15,1,00431,India
343679,2023-08-22,203,mango yogurt,50,60,10,1,00310,India
343679,2023-08-22,202,milk,12,27,15,1,00310,India
343679,2023-08-22,207,coca cola,75,100,25,1,00310,India
236183,2023-08-22,212,amul cheese,250,315,65,1,00102,India
901189,2023-08-22,201,paneer,210,340,130,1,00069,India
901189,2023-08-22,202,milk,12,27,15,1,00069,India
901189,2023-08-22,209,pepsi,75,100,25,1,00069,India
875980,2023-08-22,204,strawberry yogurt,50,60,10,1,00015,India
875980,2023-08-22,207,coca cola,75,100,25,1,00015,India
405590,2023-08-22,201,paneer,210,340,130,1,00465,India
405590,2023-08-22,205,classic yogurt,45,60,15,1,00465,India
405590,2023-08-22,204,strawberry yogurt,50,60,10,1,00465,India
405590,2023-08-22,213,bisleri,6,15,9,1,00465,India
662553,2023-08-22,209,pepsi,75,100,25,1,00482,India
554306,2023-08-22,202,milk,12,27,15,1,00410,India
554306,2023-08-22,204,strawberry yogurt,50,60,10,1,00410,India
554306,2023-08-22,201,paneer,210,340,130,1,00410,India
958487,2023-08-22,208,sprite,75,100,25,1,00085,India
958487,2023-08-22,206,yakult,360,400,40,1,00085,India
958487,2023-08-22,204,strawberry yogurt,50,60,10,1,00085,India
432150,2023-08-22,212,amul cheese,250,315,65,1,00149,India
432150,2023-08-22,206,yakult,360,400,40,1,00149,India
432150,2023-08-22,208,sprite,75,100,25,1,00149,India
834187,2023-08-22,210,mountain dew,75,100,25,1,00020,India
834187,2023-08-22,209,pepsi,75,100,25,1,00020,India
834187,2023-08-22,205,classic yogurt,45,60,15,1,00020,India
667851,2023-08-22,204,strawberry yogurt,50,60,10,1,00350,India
532909,2023-08-22,212,amul cheese,250,315,65,1,00234,India
924473,2023-08-22,205,classic yogurt,45,60,15,1,00360,India
924473,2023-08-22,210,mountain dew,75,100,25,1,00360,India
924473,2023-08-22,207,coca cola,75,100,25,1,00360,India
924473,2023-08-22,201,paneer,210,340,130,1,00360,India
924473,2023-08-22,211,red bull,90,125,35,1,00360,India
294972,2023-08-22,211,red bull,90,125,35,1,00429,India
294972,2023-08-22,201,paneer,210,340,130,1,00429,India
294972,2023-08-22,206,yakult,360,400,40,1,00429,India
294972,2023-08-22,209,pepsi,75,100,25,1,00429,India
294972,2023-08-22,212,amul cheese,250,315,65,1,00429,India
386716,2023-08-22,211,red bull,90,125,35,1,00390,India
588252,2023-08-22,203,mango yogurt,50,60,10,1,00403,India
588252,2023-08-22,210,mountain dew,75,100,25,1,00403,India
588252,2023-08-22,213,bisleri,6,15,9,1,00403,India
588252,2023-08-22,201,paneer,210,340,130,1,00403,India
910632,2023-08-22,212,amul cheese,250,315,65,1,00105,India
910632,2023-08-22,205,classic yogurt,45,60,15,1,00105,India
910632,2023-08-22,213,bisleri,6,15,9,1,00105,India
431753,2023-08-22,211,red bull,90,125,35,1,00197,India
431753,2023-08-22,209,pepsi,75,100,25,1,00197,India
431753,2023-08-22,213,bisleri,6,15,9,1,00197,India
431753,2023-08-22,202,milk,12,27,15,1,00197,India
265676,2023-08-22,206,yakult,360,400,40,1,00384,India
265676,2023-08-22,213,bisleri,6,15,9,1,00384,India
265676,2023-08-22,210,mountain dew,75,100,25,1,00384,India
265676,2023-08-22,211,red bull,90,125,35,1,00384,India
260338,2023-08-22,205,classic yogurt,45,60,15,1,00048,India
260338,2023-08-22,210,mountain dew,75,100,25,1,00048,India
456283,2023-08-22,201,paneer,210,340,130,1,00058,India
456283,2023-08-22,211,red bull,90,125,35,1,00058,India
456283,2023-08-22,212,amul cheese,250,315,65,1,00058,India
456283,2023-08-22,203,mango yogurt,50,60,10,1,00058,India
465663,2023-08-22,207,coca cola,75,100,25,1,00261,India
904046,2023-08-22,201,paneer,210,340,130,1,00016,India
931103,2023-08-22,202,milk,12,27,15,1,00263,India
931103,2023-08-22,210,mountain dew,75,100,25,1,00263,India
931103,2023-08-22,203,mango yogurt,50,60,10,1,00263,India
931103,2023-08-22,212,amul cheese,250,315,65,1,00263,India
926135,2023-08-22,209,pepsi,75,100,25,1,00350,India
906556,2023-08-22,204,strawberry yogurt,50,60,10,1,00414,India
906556,2023-08-22,202,milk,12,27,15,1,00414,India
906556,2023-08-22,207,coca cola,75,100,25,1,00414,India
132983,2023-08-22,208,sprite,75,100,25,1,00301,India
955007,2023-08-22,203,mango yogurt,50,60,10,1,00499,India
955007,2023-08-22,213,bisleri,6,15,9,1,00499,India
242935,2023-08-22,205,classic yogurt,45,60,15,1,00421,India
242935,2023-08-22,213,bisleri,6,15,9,1,00421,India
522974,2023-08-22,205,classic yogurt,45,60,15,1,00270,India
910088,2023-08-22,212,amul cheese,250,315,65,1,00293,India
910088,2023-08-22,202,milk,12,27,15,1,00293,India
910088,2023-08-22,211,red bull,90,125,35,1,00293,India
903771,2023-08-22,205,classic yogurt,45,60,15,1,00364,India
903771,2023-08-22,201,paneer,210,340,130,1,00364,India
572276,2023-08-22,209,pepsi,75,100,25,1,00175,India
572276,2023-08-22,205,classic yogurt,45,60,15,1,00175,India
572276,2023-08-22,213,bisleri,6,15,9,1,00175,India
975879,2023-08-22,203,mango yogurt,50,60,10,1,00019,India
975879,2023-08-22,207,coca cola,75,100,25,1,00019,India
975879,2023-08-22,211,red bull,90,125,35,1,00019,India
975879,2023-08-22,208,sprite,75,100,25,1,00019,India
330455,2023-08-22,205,classic yogurt,45,60,15,1,00370,India
330455,2023-08-22,207,coca cola,75,100,25,1,00370,India
330455,2023-08-22,210,mountain dew,75,100,25,1,00370,India
363004,2023-08-22,209,pepsi,75,100,25,1,00482,India
363004,2023-08-22,202,milk,12,27,15,1,00482,India
645993,2023-08-22,206,yakult,360,400,40,1,00426,India
645993,2023-08-22,208,sprite,75,100,25,1,00426,India
645993,2023-08-22,209,pepsi,75,100,25,1,00426,India
333466,2023-08-22,205,classic yogurt,45,60,15,1,00108,India
333466,2023-08-22,212,amul cheese,250,315,65,1,00108,India
333466,2023-08-22,210,mountain dew,75,100,25,1,00108,India
333466,2023-08-22,209,pepsi,75,100,25,1,00108,India
201868,2023-08-22,206,yakult,360,400,40,1,00166,India
201868,2023-08-22,213,bisleri,6,15,9,1,00166,India
201868,2023-08-22,203,mango yogurt,50,60,10,1,00166,India
980997,2023-08-23,212,amul cheese,250,315,65,1,00009,India
980997,2023-08-23,205,classic yogurt,45,60,15,1,00009,India
980997,2023-08-23,209,pepsi,75,100,25,1,00009,India
195476,2023-08-23,206,yakult,360,400,40,1,00192,India
195476,2023-08-23,213,bisleri,6,15,9,1,00192,India
787873,2023-08-23,204,strawberry yogurt,50,60,10,1,00064,India
787873,2023-08-23,211,red bull,90,125,35,1,00064,India
615316,2023-08-23,203,mango yogurt,50,60,10,1,00387,India
410079,2023-08-23,207,coca cola,75,100,25,1,00405,India
410079,2023-08-23,203,mango yogurt,50,60,10,1,00405,India
410079,2023-08-23,206,yakult,360,400,40,1,00405,India
905666,2023-08-23,212,amul cheese,250,315,65,1,00415,India
905666,2023-08-23,201,paneer,210,340,130,1,00415,India
914670,2023-08-23,205,classic yogurt,45,60,15,1,00185,India
914670,2023-08-23,209,pepsi,75,100,25,1,00185,India
914670,2023-08-23,204,strawberry yogurt,50,60,10,1,00185,India
914670,2023-08-23,202,milk,12,27,15,1,00185,India
477080,2023-08-23,209,pepsi,75,100,25,1,00130,India
477080,2023-08-23,202,milk,12,27,15,1,00130,India
477080,2023-08-23,206,yakult,360,400,40,1,00130,India
856879,2023-08-23,206,yakult,360,400,40,1,00349,India
856879,2023-08-23,202,milk,12,27,15,1,00349,India
856879,2023-08-23,207,coca cola,75,100,25,1,00349,India
856879,2023-08-23,210,mountain dew,75,100,25,1,00349,India
856879,2023-08-23,212,amul cheese,250,315,65,1,00349,India
486376,2023-08-23,209,pepsi,75,100,25,1,00136,India
486376,2023-08-23,204,strawberry yogurt,50,60,10,1,00136,India
486376,2023-08-23,211,red bull,90,125,35,1,00136,India
239827,2023-08-23,204,strawberry yogurt,50,60,10,1,00249,India
859300,2023-08-23,201,paneer,210,340,130,1,00438,India
859300,2023-08-23,204,strawberry yogurt,50,60,10,1,00438,India
859300,2023-08-23,208,sprite,75,100,25,1,00438,India
973691,2023-08-23,206,yakult,360,400,40,1,00443,India
973691,2023-08-23,202,milk,12,27,15,1,00443,India
967477,2023-08-23,211,red bull,90,125,35,1,00407,India
974794,2023-08-23,206,yakult,360,400,40,1,00286,India
949169,2023-08-23,205,classic yogurt,45,60,15,1,00416,India
949169,2023-08-23,210,mountain dew,75,100,25,1,00416,India
949169,2023-08-23,204,strawberry yogurt,50,60,10,1,00416,India
862981,2023-08-23,206,yakult,360,400,40,1,00393,India
862981,2023-08-23,213,bisleri,6,15,9,1,00393,India
862981,2023-08-23,208,sprite,75,100,25,1,00393,India
136803,2023-08-23,206,yakult,360,400,40,1,00259,India
136803,2023-08-23,205,classic yogurt,45,60,15,1,00259,India
136803,2023-08-23,207,coca cola,75,100,25,1,00259,India
136803,2023-08-23,213,bisleri,6,15,9,1,00259,India
419264,2023-08-23,204,strawberry yogurt,50,60,10,1,00055,India
419264,2023-08-23,208,sprite,75,100,25,1,00055,India
419264,2023-08-23,202,milk,12,27,15,1,00055,India
419264,2023-08-23,210,mountain dew,75,100,25,1,00055,India
485839,2023-08-23,201,paneer,210,340,130,1,00340,India
848668,2023-08-23,206,yakult,360,400,40,1,00024,India
848668,2023-08-23,203,mango yogurt,50,60,10,1,00024,India
452851,2023-08-23,205,classic yogurt,45,60,15,1,00499,India
452851,2023-08-23,204,strawberry yogurt,50,60,10,1,00499,India
452851,2023-08-23,208,sprite,75,100,25,1,00499,India
506961,2023-08-23,205,classic yogurt,45,60,15,1,00165,India
506961,2023-08-23,207,coca cola,75,100,25,1,00165,India
506961,2023-08-23,206,yakult,360,400,40,1,00165,India
506961,2023-08-23,203,mango yogurt,50,60,10,1,00165,India
585398,2023-08-23,212,amul cheese,250,315,65,1,00272,India
585398,2023-08-23,209,pepsi,75,100,25,1,00272,India
585398,2023-08-23,205,classic yogurt,45,60,15,1,00272,India
585398,2023-08-23,206,yakult,360,400,40,1,00272,India
609698,2023-08-23,210,mountain dew,75,100,25,1,00307,India
609698,2023-08-23,211,red bull,90,125,35,1,00307,India
609698,2023-08-23,204,strawberry yogurt,50,60,10,1,00307,India
165842,2023-08-23,203,mango yogurt,50,60,10,1,00015,India
360492,2023-08-23,202,milk,12,27,15,1,00303,India
360492,2023-08-23,207,coca cola,75,100,25,1,00303,India
360492,2023-08-23,201,paneer,210,340,130,1,00303,India
277769,2023-08-23,201,paneer,210,340,130,1,00400,India
616316,2023-08-23,210,mountain dew,75,100,25,1,00406,India
616316,2023-08-23,201,paneer,210,340,130,1,00406,India
616316,2023-08-23,208,sprite,75,100,25,1,00406,India
393647,2023-08-23,201,paneer,210,340,130,1,00293,India
393647,2023-08-23,205,classic yogurt,45,60,15,1,00293,India
393647,2023-08-23,212,amul cheese,250,315,65,1,00293,India
393647,2023-08-23,206,yakult,360,400,40,1,00293,India
551800,2023-08-23,203,mango yogurt,50,60,10,1,00191,India
551800,2023-08-23,213,bisleri,6,15,9,1,00191,India
196512,2023-08-23,211,red bull,90,125,35,1,00274,India
196512,2023-08-23,207,coca cola,75,100,25,1,00274,India
830159,2023-08-23,209,pepsi,75,100,25,1,00441,India
830159,2023-08-23,205,classic yogurt,45,60,15,1,00441,India
830159,2023-08-23,213,bisleri,6,15,9,1,00441,India
830159,2023-08-23,203,mango yogurt,50,60,10,1,00441,India
187800,2023-08-23,206,yakult,360,400,40,1,00446,India
187800,2023-08-23,210,mountain dew,75,100,25,1,00446,India
187800,2023-08-23,203,mango yogurt,50,60,10,1,00446,India
712701,2023-08-23,205,classic yogurt,45,60,15,1,00016,India
712701,2023-08-23,204,strawberry yogurt,50,60,10,1,00016,India
712701,2023-08-23,207,coca cola,75,100,25,1,00016,India
712701,2023-08-23,201,paneer,210,340,130,1,00016,India
102681,2023-08-23,206,yakult,360,400,40,1,00120,India
102681,2023-08-23,201,paneer,210,340,130,1,00120,India
102681,2023-08-23,213,bisleri,6,15,9,1,00120,India
118940,2023-08-23,210,mountain dew,75,100,25,1,00116,India
118940,2023-08-23,202,milk,12,27,15,1,00116,India
995286,2023-08-23,205,classic yogurt,45,60,15,1,00392,India
995286,2023-08-23,202,milk,12,27,15,1,00392,India
302882,2023-08-23,207,coca cola,75,100,25,1,00201,India
302882,2023-08-23,203,mango yogurt,50,60,10,1,00201,India
302882,2023-08-23,202,milk,12,27,15,1,00201,India
302882,2023-08-23,204,strawberry yogurt,50,60,10,1,00201,India
983344,2023-08-23,210,mountain dew,75,100,25,1,00201,India
983344,2023-08-23,202,milk,12,27,15,1,00201,India
983344,2023-08-23,209,pepsi,75,100,25,1,00201,India
718797,2023-08-23,206,yakult,360,400,40,1,00341,India
718797,2023-08-23,207,coca cola,75,100,25,1,00341,India
718797,2023-08-23,203,mango yogurt,50,60,10,1,00341,India
335793,2023-08-23,201,paneer,210,340,130,1,00260,India
335793,2023-08-23,210,mountain dew,75,100,25,1,00260,India
580569,2023-08-23,205,classic yogurt,45,60,15,1,00292,India
580569,2023-08-23,209,pepsi,75,100,25,1,00292,India
580569,2023-08-23,201,paneer,210,340,130,1,00292,India
247416,2023-08-23,208,sprite,75,100,25,1,00038,India
247416,2023-08-23,201,paneer,210,340,130,1,00038,India
847179,2023-08-23,208,sprite,75,100,25,1,00449,India
916692,2023-08-23,212,amul cheese,250,315,65,1,00235,India
279888,2023-08-23,207,coca cola,75,100,25,1,00354,India
279888,2023-08-23,213,bisleri,6,15,9,1,00354,India
279888,2023-08-23,202,milk,12,27,15,1,00354,India
279888,2023-08-23,206,yakult,360,400,40,1,00354,India
279888,2023-08-23,212,amul cheese,250,315,65,1,00354,India
207222,2023-08-23,211,red bull,90,125,35,1,00236,India
379940,2023-08-23,204,strawberry yogurt,50,60,10,1,00191,India
379940,2023-08-23,213,bisleri,6,15,9,1,00191,India
379940,2023-08-23,201,paneer,210,340,130,1,00191,India
391969,2023-08-23,203,mango yogurt,50,60,10,1,00035,India
456472,2023-08-23,211,red bull,90,125,35,1,00153,India
456472,2023-08-23,207,coca cola,75,100,25,1,00153,India
456472,2023-08-23,201,paneer,210,340,130,1,00153,India
238977,2023-08-23,211,red bull,90,125,35,1,00274,India
238977,2023-08-23,207,coca cola,75,100,25,1,00274,India
238977,2023-08-23,201,paneer,210,340,130,1,00274,India
373906,2023-08-23,213,bisleri,6,15,9,1,00054,India
763063,2023-08-23,206,yakult,360,400,40,1,00133,India
763063,2023-08-23,205,classic yogurt,45,60,15,1,00133,India
763063,2023-08-23,202,milk,12,27,15,1,00133,India
209918,2023-08-23,203,mango yogurt,50,60,10,1,00025,India
209918,2023-08-23,209,pepsi,75,100,25,1,00025,India
209918,2023-08-23,206,yakult,360,400,40,1,00025,India
209918,2023-08-23,201,paneer,210,340,130,1,00025,India
209918,2023-08-23,205,classic yogurt,45,60,15,1,00025,India
595514,2023-08-23,210,mountain dew,75,100,25,1,00469,India
869536,2023-08-23,209,pepsi,75,100,25,1,00377,India
869536,2023-08-23,208,sprite,75,100,25,1,00377,India
819753,2023-08-23,213,bisleri,6,15,9,1,00233,India
819753,2023-08-23,201,paneer,210,340,130,1,00233,India
819753,2023-08-23,206,yakult,360,400,40,1,00233,India
819753,2023-08-23,204,strawberry yogurt,50,60,10,1,00233,India
227652,2023-08-23,213,bisleri,6,15,9,1,00167,India
227652,2023-08-23,206,yakult,360,400,40,1,00167,India
227652,2023-08-23,205,classic yogurt,45,60,15,1,00167,India
596229,2023-08-23,212,amul cheese,250,315,65,1,00004,India
596229,2023-08-23,201,paneer,210,340,130,1,00004,India
596229,2023-08-23,203,mango yogurt,50,60,10,1,00004,India
174109,2023-08-23,204,strawberry yogurt,50,60,10,1,00301,India
398685,2023-08-23,206,yakult,360,400,40,1,00363,India
398685,2023-08-23,202,milk,12,27,15,1,00363,India
398685,2023-08-23,203,mango yogurt,50,60,10,1,00363,India
398685,2023-08-23,207,coca cola,75,100,25,1,00363,India
408696,2023-08-23,206,yakult,360,400,40,1,00447,India
408696,2023-08-23,203,mango yogurt,50,60,10,1,00447,India
274718,2023-08-23,212,amul cheese,250,315,65,1,00373,India
274718,2023-08-23,208,sprite,75,100,25,1,00373,India
274718,2023-08-23,207,coca cola,75,100,25,1,00373,India
420704,2023-08-23,209,pepsi,75,100,25,1,00319,India
420704,2023-08-23,208,sprite,75,100,25,1,00319,India
483931,2023-08-23,201,paneer,210,340,130,1,00051,India
483931,2023-08-23,211,red bull,90,125,35,1,00051,India
483931,2023-08-23,207,coca cola,75,100,25,1,00051,India
483931,2023-08-23,202,milk,12,27,15,1,00051,India
304885,2023-08-23,204,strawberry yogurt,50,60,10,1,00074,India
304885,2023-08-23,211,red bull,90,125,35,1,00074,India
304885,2023-08-23,203,mango yogurt,50,60,10,1,00074,India
760978,2023-08-23,210,mountain dew,75,100,25,1,00335,India
760978,2023-08-23,208,sprite,75,100,25,1,00335,India
760978,2023-08-23,203,mango yogurt,50,60,10,1,00335,India
760978,2023-08-23,201,paneer,210,340,130,1,00335,India
760978,2023-08-23,209,pepsi,75,100,25,1,00335,India
794554,2023-08-23,212,amul cheese,250,315,65,1,00177,India
794554,2023-08-23,213,bisleri,6,15,9,1,00177,India
794554,2023-08-23,202,milk,12,27,15,1,00177,India
880213,2023-08-23,203,mango yogurt,50,60,10,1,00380,India
880213,2023-08-23,210,mountain dew,75,100,25,1,00380,India
870733,2023-08-23,202,milk,12,27,15,1,00020,India
870733,2023-08-23,212,amul cheese,250,315,65,1,00020,India
870733,2023-08-23,210,mountain dew,75,100,25,1,00020,India
870733,2023-08-23,208,sprite,75,100,25,1,00020,India
718262,2023-08-23,208,sprite,75,100,25,1,00191,India
718262,2023-08-23,203,mango yogurt,50,60,10,1,00191,India
718262,2023-08-23,206,yakult,360,400,40,1,00191,India
718262,2023-08-23,211,red bull,90,125,35,1,00191,India
559034,2023-08-23,208,sprite,75,100,25,1,00185,India
559034,2023-08-23,212,amul cheese,250,315,65,1,00185,India
559034,2023-08-23,203,mango yogurt,50,60,10,1,00185,India
560878,2023-08-23,201,paneer,210,340,130,1,00488,India
560878,2023-08-23,202,milk,12,27,15,1,00488,India
929992,2023-08-23,209,pepsi,75,100,25,1,00400,India
929992,2023-08-23,212,amul cheese,250,315,65,1,00400,India
929992,2023-08-23,206,yakult,360,400,40,1,00400,India
973587,2023-08-23,201,paneer,210,340,130,1,00371,India
973587,2023-08-23,213,bisleri,6,15,9,1,00371,India
825973,2023-08-23,207,coca cola,75,100,25,1,00082,India
825973,2023-08-23,208,sprite,75,100,25,1,00082,India
825973,2023-08-23,201,paneer,210,340,130,1,00082,India
825973,2023-08-23,210,mountain dew,75,100,25,1,00082,India
352354,2023-08-23,208,sprite,75,100,25,1,00080,India
352354,2023-08-23,204,strawberry yogurt,50,60,10,1,00080,India
692330,2023-08-23,209,pepsi,75,100,25,1,00209,India
692330,2023-08-23,208,sprite,75,100,25,1,00209,India
692330,2023-08-23,210,mountain dew,75,100,25,1,00209,India
416326,2023-08-23,202,milk,12,27,15,1,00179,India
416326,2023-08-23,201,paneer,210,340,130,1,00179,India
416326,2023-08-23,213,bisleri,6,15,9,1,00179,India
750063,2023-08-23,208,sprite,75,100,25,1,00313,India
750063,2023-08-23,210,mountain dew,75,100,25,1,00313,India
750063,2023-08-23,202,milk,12,27,15,1,00313,India
750063,2023-08-23,213,bisleri,6,15,9,1,00313,India
750063,2023-08-23,209,pepsi,75,100,25,1,00313,India
618909,2023-08-23,212,amul cheese,250,315,65,1,00490,India
618909,2023-08-23,213,bisleri,6,15,9,1,00490,India
618909,2023-08-23,201,paneer,210,340,130,1,00490,India
709114,2023-08-23,206,yakult,360,400,40,1,00494,India
709114,2023-08-23,205,classic yogurt,45,60,15,1,00494,India
709114,2023-08-23,201,paneer,210,340,130,1,00494,India
709114,2023-08-23,210,mountain dew,75,100,25,1,00494,India
557830,2023-08-23,207,coca cola,75,100,25,1,00005,India
557830,2023-08-23,210,mountain dew,75,100,25,1,00005,India
557830,2023-08-23,212,amul cheese,250,315,65,1,00005,India
903492,2023-08-23,204,strawberry yogurt,50,60,10,1,00112,India
903492,2023-08-23,210,mountain dew,75,100,25,1,00112,India
903492,2023-08-23,206,yakult,360,400,40,1,00112,India
903492,2023-08-23,213,bisleri,6,15,9,1,00112,India
889997,2023-08-23,204,strawberry yogurt,50,60,10,1,00250,India
248346,2023-08-23,203,mango yogurt,50,60,10,1,00290,India
248346,2023-08-23,212,amul cheese,250,315,65,1,00290,India
248346,2023-08-23,213,bisleri,6,15,9,1,00290,India
248346,2023-08-23,205,classic yogurt,45,60,15,1,00290,India
726819,2023-08-23,201,paneer,210,340,130,1,00448,India
726819,2023-08-23,202,milk,12,27,15,1,00448,India
726819,2023-08-23,213,bisleri,6,15,9,1,00448,India
394043,2023-08-23,210,mountain dew,75,100,25,1,00372,India
291032,2023-08-23,203,mango yogurt,50,60,10,1,00062,India
291032,2023-08-23,204,strawberry yogurt,50,60,10,1,00062,India
291032,2023-08-23,209,pepsi,75,100,25,1,00062,India
398302,2023-08-23,211,red bull,90,125,35,1,00335,India
383005,2023-08-23,213,bisleri,6,15,9,1,00383,India
383005,2023-08-23,202,milk,12,27,15,1,00383,India
383005,2023-08-23,211,red bull,90,125,35,1,00383,India
354679,2023-08-23,201,paneer,210,340,130,1,00214,India
354679,2023-08-23,202,milk,12,27,15,1,00214,India
354679,2023-08-23,212,amul cheese,250,315,65,1,00214,India
616314,2023-08-23,204,strawberry yogurt,50,60,10,1,00040,India
616314,2023-08-23,201,paneer,210,340,130,1,00040,India
616314,2023-08-23,203,mango yogurt,50,60,10,1,00040,India
616314,2023-08-23,208,sprite,75,100,25,1,00040,India
616314,2023-08-23,213,bisleri,6,15,9,1,00040,India
672019,2023-08-23,213,bisleri,6,15,9,1,00098,India
672019,2023-08-23,201,paneer,210,340,130,1,00098,India
205520,2023-08-23,207,coca cola,75,100,25,1,00436,India
205520,2023-08-23,203,mango yogurt,50,60,10,1,00436,India
205520,2023-08-23,204,strawberry yogurt,50,60,10,1,00436,India
760577,2023-08-23,204,strawberry yogurt,50,60,10,1,00428,India
760577,2023-08-23,201,paneer,210,340,130,1,00428,India
570375,2023-08-23,204,strawberry yogurt,50,60,10,1,00002,India
570375,2023-08-23,201,paneer,210,340,130,1,00002,India
252561,2023-08-24,212,amul cheese,250,315,65,1,00042,India
252561,2023-08-24,206,yakult,360,400,40,1,00042,India
252561,2023-08-24,208,sprite,75,100,25,1,00042,India
252561,2023-08-24,211,red bull,90,125,35,1,00042,India
884705,2023-08-24,212,amul cheese,250,315,65,1,00195,India
884705,2023-08-24,204,strawberry yogurt,50,60,10,1,00195,India
884705,2023-08-24,208,sprite,75,100,25,1,00195,India
884705,2023-08-24,210,mountain dew,75,100,25,1,00195,India
884705,2023-08-24,207,coca cola,75,100,25,1,00195,India
258117,2023-08-24,206,yakult,360,400,40,1,00178,India
258117,2023-08-24,203,mango yogurt,50,60,10,1,00178,India
258117,2023-08-24,210,mountain dew,75,100,25,1,00178,India
258117,2023-08-24,209,pepsi,75,100,25,1,00178,India
258117,2023-08-24,205,classic yogurt,45,60,15,1,00178,India
502347,2023-08-24,202,milk,12,27,15,1,00074,India
335218,2023-08-24,213,bisleri,6,15,9,1,00288,India
335218,2023-08-24,206,yakult,360,400,40,1,00288,India
692550,2023-08-24,211,red bull,90,125,35,1,00257,India
692550,2023-08-24,206,yakult,360,400,40,1,00257,India
692550,2023-08-24,207,coca cola,75,100,25,1,00257,India
692550,2023-08-24,203,mango yogurt,50,60,10,1,00257,India
692550,2023-08-24,205,classic yogurt,45,60,15,1,00257,India
989406,2023-08-24,213,bisleri,6,15,9,1,00352,India
989406,2023-08-24,201,paneer,210,340,130,1,00352,India
963501,2023-08-24,205,classic yogurt,45,60,15,1,00054,India
755912,2023-08-24,209,pepsi,75,100,25,1,00145,India
755912,2023-08-24,204,strawberry yogurt,50,60,10,1,00145,India
755912,2023-08-24,201,paneer,210,340,130,1,00145,India
755912,2023-08-24,205,classic yogurt,45,60,15,1,00145,India
303899,2023-08-24,204,strawberry yogurt,50,60,10,1,00255,India
303899,2023-08-24,212,amul cheese,250,315,65,1,00255,India
303899,2023-08-24,205,classic yogurt,45,60,15,1,00255,India
303899,2023-08-24,213,bisleri,6,15,9,1,00255,India
313482,2023-08-24,212,amul cheese,250,315,65,1,00278,India
313482,2023-08-24,204,strawberry yogurt,50,60,10,1,00278,India
739291,2023-08-24,213,bisleri,6,15,9,1,00170,India
807241,2023-08-24,202,milk,12,27,15,1,00251,India
807241,2023-08-24,205,classic yogurt,45,60,15,1,00251,India
389737,2023-08-24,210,mountain dew,75,100,25,1,00315,India
389737,2023-08-24,211,red bull,90,125,35,1,00315,India
389737,2023-08-24,201,paneer,210,340,130,1,00315,India
389737,2023-08-24,206,yakult,360,400,40,1,00315,India
639748,2023-08-24,207,coca cola,75,100,25,1,00211,India
332290,2023-08-24,201,paneer,210,340,130,1,00361,India
370045,2023-08-24,208,sprite,75,100,25,1,00013,India
370045,2023-08-24,211,red bull,90,125,35,1,00013,India
370045,2023-08-24,213,bisleri,6,15,9,1,00013,India
370045,2023-08-24,209,pepsi,75,100,25,1,00013,India
517184,2023-08-24,201,paneer,210,340,130,1,00019,India
517184,2023-08-24,203,mango yogurt,50,60,10,1,00019,India
517184,2023-08-24,205,classic yogurt,45,60,15,1,00019,India
517184,2023-08-24,213,bisleri,6,15,9,1,00019,India
532642,2023-08-24,203,mango yogurt,50,60,10,1,00474,India
532642,2023-08-24,213,bisleri,6,15,9,1,00474,India
532642,2023-08-24,208,sprite,75,100,25,1,00474,India
532642,2023-08-24,210,mountain dew,75,100,25,1,00474,India
701729,2023-08-24,205,classic yogurt,45,60,15,1,00132,India
701729,2023-08-24,210,mountain dew,75,100,25,1,00132,India
997437,2023-08-24,204,strawberry yogurt,50,60,10,1,00395,India
997437,2023-08-24,206,yakult,360,400,40,1,00395,India
893417,2023-08-24,213,bisleri,6,15,9,1,00139,India
893417,2023-08-24,205,classic yogurt,45,60,15,1,00139,India
893417,2023-08-24,210,mountain dew,75,100,25,1,00139,India
893417,2023-08-24,201,paneer,210,340,130,1,00139,India
627128,2023-08-24,209,pepsi,75,100,25,1,00175,India
214335,2023-08-24,205,classic yogurt,45,60,15,1,00202,India
214335,2023-08-24,202,milk,12,27,15,1,00202,India
214335,2023-08-24,213,bisleri,6,15,9,1,00202,India
214335,2023-08-24,206,yakult,360,400,40,1,00202,India
876644,2023-08-24,206,yakult,360,400,40,1,00074,India
876644,2023-08-24,212,amul cheese,250,315,65,1,00074,India
876644,2023-08-24,201,paneer,210,340,130,1,00074,India
897562,2023-08-24,212,amul cheese,250,315,65,1,00174,India
897562,2023-08-24,201,paneer,210,340,130,1,00174,India
503478,2023-08-24,204,strawberry yogurt,50,60,10,1,00141,India
503478,2023-08-24,203,mango yogurt,50,60,10,1,00141,India
503478,2023-08-24,211,red bull,90,125,35,1,00141,India
503478,2023-08-24,209,pepsi,75,100,25,1,00141,India
503478,2023-08-24,210,mountain dew,75,100,25,1,00141,India
793363,2023-08-24,206,yakult,360,400,40,1,00027,India
793363,2023-08-24,209,pepsi,75,100,25,1,00027,India
793363,2023-08-24,212,amul cheese,250,315,65,1,00027,India
793363,2023-08-24,201,paneer,210,340,130,1,00027,India
904559,2023-08-24,211,red bull,90,125,35,1,00377,India
904559,2023-08-24,202,milk,12,27,15,1,00377,India
904559,2023-08-24,210,mountain dew,75,100,25,1,00377,India
517859,2023-08-24,210,mountain dew,75,100,25,1,00291,India
517859,2023-08-24,211,red bull,90,125,35,1,00291,India
517859,2023-08-24,205,classic yogurt,45,60,15,1,00291,India
517859,2023-08-24,204,strawberry yogurt,50,60,10,1,00291,India
945085,2023-08-24,213,bisleri,6,15,9,1,00487,India
945085,2023-08-24,203,mango yogurt,50,60,10,1,00487,India
945085,2023-08-24,212,amul cheese,250,315,65,1,00487,India
590616,2023-08-24,209,pepsi,75,100,25,1,00208,India
590616,2023-08-24,206,yakult,360,400,40,1,00208,India
590616,2023-08-24,213,bisleri,6,15,9,1,00208,India
590616,2023-08-24,208,sprite,75,100,25,1,00208,India
590616,2023-08-24,204,strawberry yogurt,50,60,10,1,00208,India
417904,2023-08-24,210,mountain dew,75,100,25,1,00099,India
417904,2023-08-24,207,coca cola,75,100,25,1,00099,India
250345,2023-08-24,212,amul cheese,250,315,65,1,00095,India
250345,2023-08-24,202,milk,12,27,15,1,00095,India
250345,2023-08-24,213,bisleri,6,15,9,1,00095,India
250345,2023-08-24,205,classic yogurt,45,60,15,1,00095,India
424181,2023-08-24,202,milk,12,27,15,1,00370,India
424181,2023-08-24,204,strawberry yogurt,50,60,10,1,00370,India
424181,2023-08-24,209,pepsi,75,100,25,1,00370,India
424181,2023-08-24,208,sprite,75,100,25,1,00370,India
315160,2023-08-24,207,coca cola,75,100,25,1,00125,India
315160,2023-08-24,206,yakult,360,400,40,1,00125,India
315160,2023-08-24,205,classic yogurt,45,60,15,1,00125,India
492144,2023-08-24,211,red bull,90,125,35,1,00383,India
492144,2023-08-24,209,pepsi,75,100,25,1,00383,India
317325,2023-08-24,213,bisleri,6,15,9,1,00413,India
141563,2023-08-24,212,amul cheese,250,315,65,1,00126,India
888266,2023-08-24,206,yakult,360,400,40,1,00372,India
888266,2023-08-24,207,coca cola,75,100,25,1,00372,India
785123,2023-08-24,212,amul cheese,250,315,65,1,00198,India
785123,2023-08-24,201,paneer,210,340,130,1,00198,India
785123,2023-08-24,213,bisleri,6,15,9,1,00198,India
785123,2023-08-24,207,coca cola,75,100,25,1,00198,India
900906,2023-08-24,201,paneer,210,340,130,1,00006,India
900906,2023-08-24,209,pepsi,75,100,25,1,00006,India
900906,2023-08-24,204,strawberry yogurt,50,60,10,1,00006,India
433939,2023-08-24,210,mountain dew,75,100,25,1,00089,India
433939,2023-08-24,202,milk,12,27,15,1,00089,India
433939,2023-08-24,205,classic yogurt,45,60,15,1,00089,India
495332,2023-08-24,205,classic yogurt,45,60,15,1,00300,India
304086,2023-08-24,211,red bull,90,125,35,1,00432,India
304086,2023-08-24,202,milk,12,27,15,1,00432,India
304086,2023-08-24,205,classic yogurt,45,60,15,1,00432,India
870146,2023-08-24,204,strawberry yogurt,50,60,10,1,00257,India
870146,2023-08-24,210,mountain dew,75,100,25,1,00257,India
870146,2023-08-24,209,pepsi,75,100,25,1,00257,India
502088,2023-08-24,213,bisleri,6,15,9,1,00472,India
876006,2023-08-24,204,strawberry yogurt,50,60,10,1,00358,India
876006,2023-08-24,212,amul cheese,250,315,65,1,00358,India
876006,2023-08-24,205,classic yogurt,45,60,15,1,00358,India
876006,2023-08-24,202,milk,12,27,15,1,00358,India
165728,2023-08-24,204,strawberry yogurt,50,60,10,1,00077,India
165728,2023-08-24,202,milk,12,27,15,1,00077,India
165728,2023-08-24,207,coca cola,75,100,25,1,00077,India
165728,2023-08-24,206,yakult,360,400,40,1,00077,India
151404,2023-08-24,211,red bull,90,125,35,1,00288,India
151404,2023-08-24,206,yakult,360,400,40,1,00288,India
151404,2023-08-24,201,paneer,210,340,130,1,00288,India
641505,2023-08-24,201,paneer,210,340,130,1,00243,India
641505,2023-08-24,204,strawberry yogurt,50,60,10,1,00243,India
641505,2023-08-24,202,milk,12,27,15,1,00243,India
496462,2023-08-25,205,classic yogurt,45,60,15,1,00133,India
138621,2023-08-25,206,yakult,360,400,40,1,00470,India
138621,2023-08-25,208,sprite,75,100,25,1,00470,India
138621,2023-08-25,211,red bull,90,125,35,1,00470,India
831303,2023-08-25,204,strawberry yogurt,50,60,10,1,00156,India
831303,2023-08-25,209,pepsi,75,100,25,1,00156,India
831303,2023-08-25,201,paneer,210,340,130,1,00156,India
863034,2023-08-25,213,bisleri,6,15,9,1,00317,India
863034,2023-08-25,201,paneer,210,340,130,1,00317,India
863034,2023-08-25,206,yakult,360,400,40,1,00317,India
744985,2023-08-25,210,mountain dew,75,100,25,1,00412,India
744985,2023-08-25,211,red bull,90,125,35,1,00412,India
744985,2023-08-25,209,pepsi,75,100,25,1,00412,India
849567,2023-08-25,207,coca cola,75,100,25,1,00127,India
849567,2023-08-25,206,yakult,360,400,40,1,00127,India
849567,2023-08-25,203,mango yogurt,50,60,10,1,00127,India
849567,2023-08-25,204,strawberry yogurt,50,60,10,1,00127,India
849567,2023-08-25,205,classic yogurt,45,60,15,1,00127,India
596870,2023-08-25,204,strawberry yogurt,50,60,10,1,00171,India
596870,2023-08-25,203,mango yogurt,50,60,10,1,00171,India
596870,2023-08-25,208,sprite,75,100,25,1,00171,India
956146,2023-08-25,201,paneer,210,340,130,1,00129,India
956146,2023-08-25,202,milk,12,27,15,1,00129,India
916126,2023-08-25,209,pepsi,75,100,25,1,00401,India
916126,2023-08-25,208,sprite,75,100,25,1,00401,India
916126,2023-08-25,211,red bull,90,125,35,1,00401,India
887645,2023-08-25,207,coca cola,75,100,25,1,00484,India
679930,2023-08-25,203,mango yogurt,50,60,10,1,00083,India
679930,2023-08-25,210,mountain dew,75,100,25,1,00083,India
679930,2023-08-25,207,coca cola,75,100,25,1,00083,India
351910,2023-08-25,206,yakult,360,400,40,1,00389,India
351910,2023-08-25,204,strawberry yogurt,50,60,10,1,00389,India
351910,2023-08-25,205,classic yogurt,45,60,15,1,00389,India
351910,2023-08-25,207,coca cola,75,100,25,1,00389,India
351910,2023-08-25,213,bisleri,6,15,9,1,00389,India
830440,2023-08-25,209,pepsi,75,100,25,1,00295,India
415897,2023-08-25,202,milk,12,27,15,1,00011,India
415897,2023-08-25,201,paneer,210,340,130,1,00011,India
415897,2023-08-25,205,classic yogurt,45,60,15,1,00011,India
415897,2023-08-25,212,amul cheese,250,315,65,1,00011,India
415897,2023-08-25,211,red bull,90,125,35,1,00011,India
418135,2023-08-25,204,strawberry yogurt,50,60,10,1,00052,India
253262,2023-08-25,213,bisleri,6,15,9,1,00130,India
253262,2023-08-25,201,paneer,210,340,130,1,00130,India
901441,2023-08-25,209,pepsi,75,100,25,1,00186,India
901441,2023-08-25,204,strawberry yogurt,50,60,10,1,00186,India
901441,2023-08-25,210,mountain dew,75,100,25,1,00186,India
901441,2023-08-25,208,sprite,75,100,25,1,00186,India
901441,2023-08-25,203,mango yogurt,50,60,10,1,00186,India
997172,2023-08-25,206,yakult,360,400,40,1,00366,India
997172,2023-08-25,210,mountain dew,75,100,25,1,00366,India
997172,2023-08-25,203,mango yogurt,50,60,10,1,00366,India
905872,2023-08-25,205,classic yogurt,45,60,15,1,00236,India
502649,2023-08-25,208,sprite,75,100,25,1,00442,India
502649,2023-08-25,201,paneer,210,340,130,1,00442,India
502649,2023-08-25,211,red bull,90,125,35,1,00442,India
502649,2023-08-25,207,coca cola,75,100,25,1,00442,India
723929,2023-08-25,207,coca cola,75,100,25,1,00269,India
723929,2023-08-25,213,bisleri,6,15,9,1,00269,India
723929,2023-08-25,204,strawberry yogurt,50,60,10,1,00269,India
723929,2023-08-25,201,paneer,210,340,130,1,00269,India
206418,2023-08-25,207,coca cola,75,100,25,1,00386,India
206418,2023-08-25,213,bisleri,6,15,9,1,00386,India
206418,2023-08-25,206,yakult,360,400,40,1,00386,India
778106,2023-08-25,205,classic yogurt,45,60,15,1,00434,India
778106,2023-08-25,203,mango yogurt,50,60,10,1,00434,India
778106,2023-08-25,207,coca cola,75,100,25,1,00434,India
671141,2023-08-25,208,sprite,75,100,25,1,00348,India
671141,2023-08-25,206,yakult,360,400,40,1,00348,India
512930,2023-08-25,209,pepsi,75,100,25,1,00211,India
512930,2023-08-25,211,red bull,90,125,35,1,00211,India
831472,2023-08-25,205,classic yogurt,45,60,15,1,00376,India
579075,2023-08-25,202,milk,12,27,15,1,00249,India
579075,2023-08-25,205,classic yogurt,45,60,15,1,00249,India
579075,2023-08-25,208,sprite,75,100,25,1,00249,India
526161,2023-08-25,204,strawberry yogurt,50,60,10,1,00205,India
478797,2023-08-25,206,yakult,360,400,40,1,00295,India
478797,2023-08-25,210,mountain dew,75,100,25,1,00295,India
478797,2023-08-25,203,mango yogurt,50,60,10,1,00295,India
153127,2023-08-25,201,paneer,210,340,130,1,00225,India
153127,2023-08-25,208,sprite,75,100,25,1,00225,India
439602,2023-08-25,204,strawberry yogurt,50,60,10,1,00020,India
439602,2023-08-25,213,bisleri,6,15,9,1,00020,India
439602,2023-08-25,201,paneer,210,340,130,1,00020,India
748155,2023-08-25,204,strawberry yogurt,50,60,10,1,00375,India
834785,2023-08-25,211,red bull,90,125,35,1,00394,India
834785,2023-08-25,212,amul cheese,250,315,65,1,00394,India
834785,2023-08-25,208,sprite,75,100,25,1,00394,India
422006,2023-08-25,211,red bull,90,125,35,1,00405,India
262399,2023-08-25,204,strawberry yogurt,50,60,10,1,00362,India
262399,2023-08-25,201,paneer,210,340,130,1,00362,India
262399,2023-08-25,212,amul cheese,250,315,65,1,00362,India
257148,2023-08-25,209,pepsi,75,100,25,1,00120,India
257148,2023-08-25,208,sprite,75,100,25,1,00120,India
257148,2023-08-25,212,amul cheese,250,315,65,1,00120,India
257148,2023-08-25,202,milk,12,27,15,1,00120,India
455793,2023-08-25,207,coca cola,75,100,25,1,00151,India
455793,2023-08-25,203,mango yogurt,50,60,10,1,00151,India
455793,2023-08-25,201,paneer,210,340,130,1,00151,India
687841,2023-08-25,208,sprite,75,100,25,1,00392,India
687841,2023-08-25,205,classic yogurt,45,60,15,1,00392,India
687841,2023-08-25,202,milk,12,27,15,1,00392,India
687841,2023-08-25,207,coca cola,75,100,25,1,00392,India
801315,2023-08-25,205,classic yogurt,45,60,15,1,00463,India
801315,2023-08-25,204,strawberry yogurt,50,60,10,1,00463,India
806818,2023-08-25,213,bisleri,6,15,9,1,00056,India
981075,2023-08-25,211,red bull,90,125,35,1,00316,India
981075,2023-08-25,209,pepsi,75,100,25,1,00316,India
754579,2023-08-25,209,pepsi,75,100,25,1,00168,India
754579,2023-08-25,208,sprite,75,100,25,1,00168,India
952968,2023-08-25,205,classic yogurt,45,60,15,1,00206,India
952968,2023-08-25,201,paneer,210,340,130,1,00206,India
952968,2023-08-25,211,red bull,90,125,35,1,00206,India
194869,2023-08-25,202,milk,12,27,15,1,00158,India
194869,2023-08-25,211,red bull,90,125,35,1,00158,India
194869,2023-08-25,208,sprite,75,100,25,1,00158,India
984047,2023-08-25,204,strawberry yogurt,50,60,10,1,00252,India
984047,2023-08-25,201,paneer,210,340,130,1,00252,India
984047,2023-08-25,213,bisleri,6,15,9,1,00252,India
609004,2023-08-25,212,amul cheese,250,315,65,1,00278,India
666981,2023-08-25,209,pepsi,75,100,25,1,00233,India
666981,2023-08-25,204,strawberry yogurt,50,60,10,1,00233,India
666981,2023-08-25,208,sprite,75,100,25,1,00233,India
666981,2023-08-25,202,milk,12,27,15,1,00233,India
438803,2023-08-25,206,yakult,360,400,40,1,00123,India
438803,2023-08-25,203,mango yogurt,50,60,10,1,00123,India
497710,2023-08-25,202,milk,12,27,15,1,00176,India
497710,2023-08-25,210,mountain dew,75,100,25,1,00176,India
865433,2023-08-25,204,strawberry yogurt,50,60,10,1,00239,India
865433,2023-08-25,202,milk,12,27,15,1,00239,India
719859,2023-08-25,201,paneer,210,340,130,1,00399,India
719859,2023-08-25,213,bisleri,6,15,9,1,00399,India
719859,2023-08-25,212,amul cheese,250,315,65,1,00399,India
909011,2023-08-25,206,yakult,360,400,40,1,00045,India
909011,2023-08-25,202,milk,12,27,15,1,00045,India
909011,2023-08-25,203,mango yogurt,50,60,10,1,00045,India
965302,2023-08-25,208,sprite,75,100,25,1,00063,India
965302,2023-08-25,203,mango yogurt,50,60,10,1,00063,India
965302,2023-08-25,207,coca cola,75,100,25,1,00063,India
965302,2023-08-25,210,mountain dew,75,100,25,1,00063,India
965302,2023-08-25,201,paneer,210,340,130,1,00063,India
789624,2023-08-25,208,sprite,75,100,25,1,00445,India
604862,2023-08-25,208,sprite,75,100,25,1,00224,India
604862,2023-08-25,210,mountain dew,75,100,25,1,00224,India
344645,2023-08-25,210,mountain dew,75,100,25,1,00380,India
331286,2023-08-25,201,paneer,210,340,130,1,00436,India
483269,2023-08-25,201,paneer,210,340,130,1,00179,India
483269,2023-08-25,211,red bull,90,125,35,1,00179,India
811920,2023-08-25,206,yakult,360,400,40,1,00327,India
811920,2023-08-25,202,milk,12,27,15,1,00327,India
811920,2023-08-25,208,sprite,75,100,25,1,00327,India
811920,2023-08-25,205,classic yogurt,45,60,15,1,00327,India
350221,2023-08-25,209,pepsi,75,100,25,1,00361,India
350221,2023-08-25,204,strawberry yogurt,50,60,10,1,00361,India
508729,2023-08-25,206,yakult,360,400,40,1,00330,India
436113,2023-08-25,208,sprite,75,100,25,1,00015,India
436113,2023-08-25,202,milk,12,27,15,1,00015,India
436113,2023-08-25,211,red bull,90,125,35,1,00015,India
436113,2023-08-25,204,strawberry yogurt,50,60,10,1,00015,India
452388,2023-08-25,211,red bull,90,125,35,1,00225,India
334347,2023-08-25,207,coca cola,75,100,25,1,00303,India
550136,2023-08-26,211,red bull,90,125,35,1,00032,India
550136,2023-08-26,209,pepsi,75,100,25,1,00032,India
550136,2023-08-26,212,amul cheese,250,315,65,1,00032,India
118500,2023-08-26,211,red bull,90,125,35,1,00265,India
979921,2023-08-26,210,mountain dew,75,100,25,1,00117,India
979921,2023-08-26,209,pepsi,75,100,25,1,00117,India
589243,2023-08-26,211,red bull,90,125,35,1,00015,India
589243,2023-08-26,209,pepsi,75,100,25,1,00015,India
589243,2023-08-26,202,milk,12,27,15,1,00015,India
589243,2023-08-26,205,classic yogurt,45,60,15,1,00015,India
170431,2023-08-26,209,pepsi,75,100,25,1,00268,India
170431,2023-08-26,205,classic yogurt,45,60,15,1,00268,India
170431,2023-08-26,212,amul cheese,250,315,65,1,00268,India
170431,2023-08-26,206,yakult,360,400,40,1,00268,India
947990,2023-08-26,204,strawberry yogurt,50,60,10,1,00433,India
947990,2023-08-26,213,bisleri,6,15,9,1,00433,India
947990,2023-08-26,202,milk,12,27,15,1,00433,India
947990,2023-08-26,201,paneer,210,340,130,1,00433,India
214059,2023-08-26,203,mango yogurt,50,60,10,1,00010,India
214059,2023-08-26,205,classic yogurt,45,60,15,1,00010,India
214059,2023-08-26,212,amul cheese,250,315,65,1,00010,India
855014,2023-08-26,209,pepsi,75,100,25,1,00071,India
845330,2023-08-26,210,mountain dew,75,100,25,1,00040,India
845330,2023-08-26,212,amul cheese,250,315,65,1,00040,India
845330,2023-08-26,202,milk,12,27,15,1,00040,India
845330,2023-08-26,213,bisleri,6,15,9,1,00040,India
182891,2023-08-26,207,coca cola,75,100,25,1,00420,India
182891,2023-08-26,201,paneer,210,340,130,1,00420,India
182891,2023-08-26,209,pepsi,75,100,25,1,00420,India
112857,2023-08-26,211,red bull,90,125,35,1,00197,India
112857,2023-08-26,203,mango yogurt,50,60,10,1,00197,India
248946,2023-08-26,207,coca cola,75,100,25,1,00042,India
248946,2023-08-26,213,bisleri,6,15,9,1,00042,India
248946,2023-08-26,209,pepsi,75,100,25,1,00042,India
248946,2023-08-26,212,amul cheese,250,315,65,1,00042,India
249350,2023-08-26,213,bisleri,6,15,9,1,00034,India
249350,2023-08-26,211,red bull,90,125,35,1,00034,India
249350,2023-08-26,204,strawberry yogurt,50,60,10,1,00034,India
249350,2023-08-26,207,coca cola,75,100,25,1,00034,India
437398,2023-08-26,211,red bull,90,125,35,1,00391,India
782481,2023-08-26,212,amul cheese,250,315,65,1,00399,India
782481,2023-08-26,204,strawberry yogurt,50,60,10,1,00399,India
782481,2023-08-26,213,bisleri,6,15,9,1,00399,India
782481,2023-08-26,208,sprite,75,100,25,1,00399,India
115626,2023-08-26,203,mango yogurt,50,60,10,1,00158,India
942871,2023-08-26,205,classic yogurt,45,60,15,1,00188,India
942871,2023-08-26,209,pepsi,75,100,25,1,00188,India
942871,2023-08-26,201,paneer,210,340,130,1,00188,India
688588,2023-08-26,205,classic yogurt,45,60,15,1,00456,India
688588,2023-08-26,213,bisleri,6,15,9,1,00456,India
721290,2023-08-26,206,yakult,360,400,40,1,00241,India
721290,2023-08-26,212,amul cheese,250,315,65,1,00241,India
721290,2023-08-26,204,strawberry yogurt,50,60,10,1,00241,India
156545,2023-08-26,210,mountain dew,75,100,25,1,00191,India
156545,2023-08-26,206,yakult,360,400,40,1,00191,India
255237,2023-08-26,211,red bull,90,125,35,1,00314,India
930263,2023-08-26,212,amul cheese,250,315,65,1,00380,India
930263,2023-08-26,206,yakult,360,400,40,1,00380,India
951621,2023-08-26,201,paneer,210,340,130,1,00484,India
951621,2023-08-26,204,strawberry yogurt,50,60,10,1,00484,India
207966,2023-08-26,210,mountain dew,75,100,25,1,00170,India
207966,2023-08-26,202,milk,12,27,15,1,00170,India
921503,2023-08-26,208,sprite,75,100,25,1,00078,India
921503,2023-08-26,213,bisleri,6,15,9,1,00078,India
921503,2023-08-26,212,amul cheese,250,315,65,1,00078,India
921503,2023-08-26,209,pepsi,75,100,25,1,00078,India
921503,2023-08-26,205,classic yogurt,45,60,15,1,00078,India
860129,2023-08-26,213,bisleri,6,15,9,1,00399,India
989211,2023-08-26,213,bisleri,6,15,9,1,00087,India
989211,2023-08-26,211,red bull,90,125,35,1,00087,India
989211,2023-08-26,207,coca cola,75,100,25,1,00087,India
989211,2023-08-26,209,pepsi,75,100,25,1,00087,India
349994,2023-08-26,204,strawberry yogurt,50,60,10,1,00077,India
349994,2023-08-26,203,mango yogurt,50,60,10,1,00077,India
229677,2023-08-26,204,strawberry yogurt,50,60,10,1,00167,India
229677,2023-08-26,211,red bull,90,125,35,1,00167,India
229677,2023-08-26,208,sprite,75,100,25,1,00167,India
229677,2023-08-26,201,paneer,210,340,130,1,00167,India
569196,2023-08-26,209,pepsi,75,100,25,1,00390,India
569196,2023-08-26,203,mango yogurt,50,60,10,1,00390,India
569196,2023-08-26,205,classic yogurt,45,60,15,1,00390,India
569196,2023-08-26,202,milk,12,27,15,1,00390,India
840947,2023-08-26,209,pepsi,75,100,25,1,00014,India
840947,2023-08-26,210,mountain dew,75,100,25,1,00014,India
840947,2023-08-26,213,bisleri,6,15,9,1,00014,India
425172,2023-08-26,205,classic yogurt,45,60,15,1,00182,India
616092,2023-08-26,213,bisleri,6,15,9,1,00452,India
616092,2023-08-26,209,pepsi,75,100,25,1,00452,India
616092,2023-08-26,207,coca cola,75,100,25,1,00452,India
616092,2023-08-26,203,mango yogurt,50,60,10,1,00452,India
779606,2023-08-26,212,amul cheese,250,315,65,1,00154,India
851044,2023-08-26,206,yakult,360,400,40,1,00496,India
851044,2023-08-26,208,sprite,75,100,25,1,00496,India
116901,2023-08-26,210,mountain dew,75,100,25,1,00209,India
116901,2023-08-26,207,coca cola,75,100,25,1,00209,India
116901,2023-08-26,202,milk,12,27,15,1,00209,India
116901,2023-08-26,211,red bull,90,125,35,1,00209,India
116901,2023-08-26,213,bisleri,6,15,9,1,00209,India
468439,2023-08-26,203,mango yogurt,50,60,10,1,00205,India
468439,2023-08-26,209,pepsi,75,100,25,1,00205,India
468439,2023-08-26,210,mountain dew,75,100,25,1,00205,India
468439,2023-08-26,212,amul cheese,250,315,65,1,00205,India
468439,2023-08-26,208,sprite,75,100,25,1,00205,India
384729,2023-08-26,206,yakult,360,400,40,1,00323,India
243038,2023-08-26,203,mango yogurt,50,60,10,1,00403,India
243038,2023-08-26,207,coca cola,75,100,25,1,00403,India
243038,2023-08-26,202,milk,12,27,15,1,00403,India
243038,2023-08-26,208,sprite,75,100,25,1,00403,India
243038,2023-08-26,212,amul cheese,250,315,65,1,00403,India
171766,2023-08-26,208,sprite,75,100,25,1,00017,India
171766,2023-08-26,213,bisleri,6,15,9,1,00017,India
712895,2023-08-26,207,coca cola,75,100,25,1,00246,India
712895,2023-08-26,206,yakult,360,400,40,1,00246,India
712895,2023-08-26,210,mountain dew,75,100,25,1,00246,India
712895,2023-08-26,212,amul cheese,250,315,65,1,00246,India
970592,2023-08-26,212,amul cheese,250,315,65,1,00070,India
970592,2023-08-26,205,classic yogurt,45,60,15,1,00070,India
293648,2023-08-26,206,yakult,360,400,40,1,00480,India
293648,2023-08-26,207,coca cola,75,100,25,1,00480,India
293648,2023-08-26,210,mountain dew,75,100,25,1,00480,India
148394,2023-08-26,206,yakult,360,400,40,1,00221,India
148394,2023-08-26,205,classic yogurt,45,60,15,1,00221,India
148394,2023-08-26,212,amul cheese,250,315,65,1,00221,India
148394,2023-08-26,201,paneer,210,340,130,1,00221,India
410180,2023-08-26,206,yakult,360,400,40,1,00233,India
262484,2023-08-26,207,coca cola,75,100,25,1,00204,India
262484,2023-08-26,206,yakult,360,400,40,1,00204,India
930535,2023-08-26,206,yakult,360,400,40,1,00168,India
572524,2023-08-26,201,paneer,210,340,130,1,00436,India
620719,2023-08-26,211,red bull,90,125,35,1,00406,India
620719,2023-08-26,201,paneer,210,340,130,1,00406,India
620719,2023-08-26,204,strawberry yogurt,50,60,10,1,00406,India
620719,2023-08-26,206,yakult,360,400,40,1,00406,India
620719,2023-08-26,202,milk,12,27,15,1,00406,India
504561,2023-08-26,211,red bull,90,125,35,1,00293,India
504561,2023-08-26,212,amul cheese,250,315,65,1,00293,India
504561,2023-08-26,203,mango yogurt,50,60,10,1,00293,India
504561,2023-08-26,204,strawberry yogurt,50,60,10,1,00293,India
864378,2023-08-26,213,bisleri,6,15,9,1,00120,India
864378,2023-08-26,212,amul cheese,250,315,65,1,00120,India
864378,2023-08-26,202,milk,12,27,15,1,00120,India
457822,2023-08-26,208,sprite,75,100,25,1,00269,India
457822,2023-08-26,203,mango yogurt,50,60,10,1,00269,India
457822,2023-08-26,211,red bull,90,125,35,1,00269,India
773573,2023-08-26,205,classic yogurt,45,60,15,1,00368,India
773573,2023-08-26,212,amul cheese,250,315,65,1,00368,India
401676,2023-08-26,203,mango yogurt,50,60,10,1,00109,India
401676,2023-08-26,213,bisleri,6,15,9,1,00109,India
401676,2023-08-26,208,sprite,75,100,25,1,00109,India
401676,2023-08-26,212,amul cheese,250,315,65,1,00109,India
401676,2023-08-26,204,strawberry yogurt,50,60,10,1,00109,India
319140,2023-08-26,210,mountain dew,75,100,25,1,00320,India
319140,2023-08-26,211,red bull,90,125,35,1,00320,India
319140,2023-08-26,209,pepsi,75,100,25,1,00320,India
319140,2023-08-26,212,amul cheese,250,315,65,1,00320,India
319140,2023-08-26,201,paneer,210,340,130,1,00320,India
781723,2023-08-26,204,strawberry yogurt,50,60,10,1,00103,India
442557,2023-08-26,204,strawberry yogurt,50,60,10,1,00177,India
442557,2023-08-26,212,amul cheese,250,315,65,1,00177,India
442557,2023-08-26,206,yakult,360,400,40,1,00177,India
442557,2023-08-26,202,milk,12,27,15,1,00177,India
806881,2023-08-26,201,paneer,210,340,130,1,00360,India
806881,2023-08-26,210,mountain dew,75,100,25,1,00360,India
806881,2023-08-26,203,mango yogurt,50,60,10,1,00360,India
968475,2023-08-26,210,mountain dew,75,100,25,1,00249,India
968475,2023-08-26,213,bisleri,6,15,9,1,00249,India
968475,2023-08-26,201,paneer,210,340,130,1,00249,India
968475,2023-08-26,203,mango yogurt,50,60,10,1,00249,India
968475,2023-08-26,206,yakult,360,400,40,1,00249,India
391317,2023-08-26,204,strawberry yogurt,50,60,10,1,00424,India
625949,2023-08-26,210,mountain dew,75,100,25,1,00175,India
625949,2023-08-26,201,paneer,210,340,130,1,00175,India
934193,2023-08-26,201,paneer,210,340,130,1,00268,India
934193,2023-08-26,208,sprite,75,100,25,1,00268,India
551759,2023-08-26,213,bisleri,6,15,9,1,00245,India
551759,2023-08-26,212,amul cheese,250,315,65,1,00245,India
551759,2023-08-26,202,milk,12,27,15,1,00245,India
551759,2023-08-26,203,mango yogurt,50,60,10,1,00245,India
551759,2023-08-26,210,mountain dew,75,100,25,1,00245,India
364602,2023-08-26,211,red bull,90,125,35,1,00140,India
364602,2023-08-26,212,amul cheese,250,315,65,1,00140,India
364602,2023-08-26,213,bisleri,6,15,9,1,00140,India
775723,2023-08-26,203,mango yogurt,50,60,10,1,00479,India
775723,2023-08-26,209,pepsi,75,100,25,1,00479,India
775723,2023-08-26,205,classic yogurt,45,60,15,1,00479,India
775723,2023-08-26,207,coca cola,75,100,25,1,00479,India
956524,2023-08-26,206,yakult,360,400,40,1,00166,India
956524,2023-08-26,213,bisleri,6,15,9,1,00166,India
956524,2023-08-26,209,pepsi,75,100,25,1,00166,India
956524,2023-08-26,201,paneer,210,340,130,1,00166,India
994629,2023-08-26,201,paneer,210,340,130,1,00089,India
737380,2023-08-26,202,milk,12,27,15,1,00245,India
737380,2023-08-26,212,amul cheese,250,315,65,1,00245,India
737380,2023-08-26,203,mango yogurt,50,60,10,1,00245,India
711072,2023-08-26,208,sprite,75,100,25,1,00255,India
629657,2023-08-26,205,classic yogurt,45,60,15,1,00178,India
629657,2023-08-26,204,strawberry yogurt,50,60,10,1,00178,India
629657,2023-08-26,202,milk,12,27,15,1,00178,India
629657,2023-08-26,201,paneer,210,340,130,1,00178,India
565238,2023-08-26,205,classic yogurt,45,60,15,1,00408,India
565238,2023-08-26,211,red bull,90,125,35,1,00408,India
565238,2023-08-26,209,pepsi,75,100,25,1,00408,India
565238,2023-08-26,206,yakult,360,400,40,1,00408,India
110717,2023-08-26,205,classic yogurt,45,60,15,1,00091,India
110717,2023-08-26,204,strawberry yogurt,50,60,10,1,00091,India
193342,2023-08-26,207,coca cola,75,100,25,1,00481,India
193342,2023-08-26,210,mountain dew,75,100,25,1,00481,India
193342,2023-08-26,201,paneer,210,340,130,1,00481,India
193342,2023-08-26,211,red bull,90,125,35,1,00481,India
866163,2023-08-26,205,classic yogurt,45,60,15,1,00150,India
866163,2023-08-26,202,milk,12,27,15,1,00150,India
866163,2023-08-26,209,pepsi,75,100,25,1,00150,India
299215,2023-08-26,201,paneer,210,340,130,1,00148,India
299215,2023-08-26,204,strawberry yogurt,50,60,10,1,00148,India
840631,2023-08-26,204,strawberry yogurt,50,60,10,1,00327,India
840631,2023-08-26,201,paneer,210,340,130,1,00327,India
692596,2023-08-26,201,paneer,210,340,130,1,00187,India
692596,2023-08-26,213,bisleri,6,15,9,1,00187,India
692596,2023-08-26,212,amul cheese,250,315,65,1,00187,India
471744,2023-08-26,206,yakult,360,400,40,1,00014,India
900293,2023-08-26,209,pepsi,75,100,25,1,00459,India
900293,2023-08-26,208,sprite,75,100,25,1,00459,India
566695,2023-08-26,205,classic yogurt,45,60,15,1,00147,India
566695,2023-08-26,203,mango yogurt,50,60,10,1,00147,India
566695,2023-08-26,209,pepsi,75,100,25,1,00147,India
566695,2023-08-26,207,coca cola,75,100,25,1,00147,India
124482,2023-08-26,210,mountain dew,75,100,25,1,00034,India
124482,2023-08-26,202,milk,12,27,15,1,00034,India
124482,2023-08-26,203,mango yogurt,50,60,10,1,00034,India
124482,2023-08-26,212,amul cheese,250,315,65,1,00034,India
940893,2023-08-26,208,sprite,75,100,25,1,00215,India
940893,2023-08-26,207,coca cola,75,100,25,1,00215,India
271073,2023-08-26,204,strawberry yogurt,50,60,10,1,00209,India
271073,2023-08-26,205,classic yogurt,45,60,15,1,00209,India
397343,2023-08-26,209,pepsi,75,100,25,1,00487,India
397343,2023-08-26,212,amul cheese,250,315,65,1,00487,India
397343,2023-08-26,211,red bull,90,125,35,1,00487,India
397343,2023-08-26,206,yakult,360,400,40,1,00487,India
813247,2023-08-26,208,sprite,75,100,25,1,00240,India
813247,2023-08-26,202,milk,12,27,15,1,00240,India
813247,2023-08-26,206,yakult,360,400,40,1,00240,India
142271,2023-08-26,204,strawberry yogurt,50,60,10,1,00377,India
142271,2023-08-26,206,yakult,360,400,40,1,00377,India
379667,2023-08-26,203,mango yogurt,50,60,10,1,00393,India
379667,2023-08-26,212,amul cheese,250,315,65,1,00393,India
106909,2023-08-26,209,pepsi,75,100,25,1,00412,India
106909,2023-08-26,202,milk,12,27,15,1,00412,India
106909,2023-08-26,206,yakult,360,400,40,1,00412,India
752172,2023-08-26,203,mango yogurt,50,60,10,1,00465,India
635697,2023-08-26,210,mountain dew,75,100,25,1,00232,India
635697,2023-08-26,212,amul cheese,250,315,65,1,00232,India
635697,2023-08-26,211,red bull,90,125,35,1,00232,India
635697,2023-08-26,205,classic yogurt,45,60,15,1,00232,India
635697,2023-08-26,201,paneer,210,340,130,1,00232,India
669804,2023-08-26,201,paneer,210,340,130,1,00331,India
669804,2023-08-26,209,pepsi,75,100,25,1,00331,India
387712,2023-08-26,201,paneer,210,340,130,1,00428,India
753863,2023-08-26,209,pepsi,75,100,25,1,00353,India
753863,2023-08-26,201,paneer,210,340,130,1,00353,India
981565,2023-08-26,213,bisleri,6,15,9,1,00125,India
981565,2023-08-26,211,red bull,90,125,35,1,00125,India
953770,2023-08-26,211,red bull,90,125,35,1,00423,India
953770,2023-08-26,206,yakult,360,400,40,1,00423,India
953770,2023-08-26,208,sprite,75,100,25,1,00423,India
953770,2023-08-26,213,bisleri,6,15,9,1,00423,India
189260,2023-08-26,205,classic yogurt,45,60,15,1,00249,India
189260,2023-08-26,201,paneer,210,340,130,1,00249,India
229291,2023-08-26,201,paneer,210,340,130,1,00472,India
229291,2023-08-26,206,yakult,360,400,40,1,00472,India
229291,2023-08-26,212,amul cheese,250,315,65,1,00472,India
229291,2023-08-26,207,coca cola,75,100,25,1,00472,India
229291,2023-08-26,202,milk,12,27,15,1,00472,India
716840,2023-08-26,211,red bull,90,125,35,1,00423,India
716840,2023-08-26,209,pepsi,75,100,25,1,00423,India
716840,2023-08-26,208,sprite,75,100,25,1,00423,India
716840,2023-08-26,205,classic yogurt,45,60,15,1,00423,India
688787,2023-08-26,209,pepsi,75,100,25,1,00374,India
688787,2023-08-26,207,coca cola,75,100,25,1,00374,India
932405,2023-08-27,207,coca cola,75,100,25,1,00343,India
932405,2023-08-27,205,classic yogurt,45,60,15,1,00343,India
739207,2023-08-27,201,paneer,210,340,130,1,00417,India
952004,2023-08-27,202,milk,12,27,15,1,00012,India
952004,2023-08-27,201,paneer,210,340,130,1,00012,India
952004,2023-08-27,205,classic yogurt,45,60,15,1,00012,India
276484,2023-08-27,208,sprite,75,100,25,1,00421,India
518502,2023-08-27,206,yakult,360,400,40,1,00080,India
518502,2023-08-27,209,pepsi,75,100,25,1,00080,India
518502,2023-08-27,208,sprite,75,100,25,1,00080,India
518502,2023-08-27,212,amul cheese,250,315,65,1,00080,India
518502,2023-08-27,207,coca cola,75,100,25,1,00080,India
744201,2023-08-27,207,coca cola,75,100,25,1,00142,India
255347,2023-08-27,213,bisleri,6,15,9,1,00049,India
255347,2023-08-27,210,mountain dew,75,100,25,1,00049,India
255347,2023-08-27,208,sprite,75,100,25,1,00049,India
255347,2023-08-27,206,yakult,360,400,40,1,00049,India
346996,2023-08-27,201,paneer,210,340,130,1,00258,India
346996,2023-08-27,213,bisleri,6,15,9,1,00258,India
346996,2023-08-27,203,mango yogurt,50,60,10,1,00258,India
346996,2023-08-27,210,mountain dew,75,100,25,1,00258,India
894205,2023-08-27,205,classic yogurt,45,60,15,1,00254,India
894205,2023-08-27,209,pepsi,75,100,25,1,00254,India
894205,2023-08-27,210,mountain dew,75,100,25,1,00254,India
894205,2023-08-27,212,amul cheese,250,315,65,1,00254,India
894205,2023-08-27,202,milk,12,27,15,1,00254,India
515554,2023-08-27,209,pepsi,75,100,25,1,00405,India
576039,2023-08-27,205,classic yogurt,45,60,15,1,00303,India
576039,2023-08-27,202,milk,12,27,15,1,00303,India
576039,2023-08-27,213,bisleri,6,15,9,1,00303,India
576039,2023-08-27,204,strawberry yogurt,50,60,10,1,00303,India
371853,2023-08-27,201,paneer,210,340,130,1,00133,India
371853,2023-08-27,207,coca cola,75,100,25,1,00133,India
371853,2023-08-27,202,milk,12,27,15,1,00133,India
371853,2023-08-27,210,mountain dew,75,100,25,1,00133,India
961794,2023-08-27,210,mountain dew,75,100,25,1,00433,India
961794,2023-08-27,207,coca cola,75,100,25,1,00433,India
141802,2023-08-27,212,amul cheese,250,315,65,1,00114,India
141802,2023-08-27,211,red bull,90,125,35,1,00114,India
141802,2023-08-27,207,coca cola,75,100,25,1,00114,India
141802,2023-08-27,201,paneer,210,340,130,1,00114,India
766673,2023-08-27,207,coca cola,75,100,25,1,00345,India
766673,2023-08-27,212,amul cheese,250,315,65,1,00345,India
766673,2023-08-27,211,red bull,90,125,35,1,00345,India
189049,2023-08-27,205,classic yogurt,45,60,15,1,00439,India
189049,2023-08-27,212,amul cheese,250,315,65,1,00439,India
189049,2023-08-27,207,coca cola,75,100,25,1,00439,India
915795,2023-08-27,212,amul cheese,250,315,65,1,00208,India
800745,2023-08-27,211,red bull,90,125,35,1,00037,India
800745,2023-08-27,201,paneer,210,340,130,1,00037,India
800745,2023-08-27,205,classic yogurt,45,60,15,1,00037,India
800745,2023-08-27,207,coca cola,75,100,25,1,00037,India
272264,2023-08-27,211,red bull,90,125,35,1,00475,India
272264,2023-08-27,204,strawberry yogurt,50,60,10,1,00475,India
272264,2023-08-27,212,amul cheese,250,315,65,1,00475,India
281978,2023-08-27,205,classic yogurt,45,60,15,1,00189,India
281978,2023-08-27,210,mountain dew,75,100,25,1,00189,India
281978,2023-08-27,208,sprite,75,100,25,1,00189,India
817947,2023-08-27,212,amul cheese,250,315,65,1,00288,India
817947,2023-08-27,208,sprite,75,100,25,1,00288,India
817947,2023-08-27,211,red bull,90,125,35,1,00288,India
817947,2023-08-27,210,mountain dew,75,100,25,1,00288,India
590055,2023-08-27,204,strawberry yogurt,50,60,10,1,00489,India
590055,2023-08-27,213,bisleri,6,15,9,1,00489,India
590055,2023-08-27,210,mountain dew,75,100,25,1,00489,India
590055,2023-08-27,205,classic yogurt,45,60,15,1,00489,India
236111,2023-08-27,206,yakult,360,400,40,1,00059,India
236111,2023-08-27,205,classic yogurt,45,60,15,1,00059,India
552794,2023-08-27,206,yakult,360,400,40,1,00147,India
552794,2023-08-27,213,bisleri,6,15,9,1,00147,India
552794,2023-08-27,210,mountain dew,75,100,25,1,00147,India
552794,2023-08-27,202,milk,12,27,15,1,00147,India
804353,2023-08-27,210,mountain dew,75,100,25,1,00058,India
182615,2023-08-27,209,pepsi,75,100,25,1,00072,India
182615,2023-08-27,213,bisleri,6,15,9,1,00072,India
269957,2023-08-27,211,red bull,90,125,35,1,00168,India
269957,2023-08-27,209,pepsi,75,100,25,1,00168,India
269957,2023-08-27,208,sprite,75,100,25,1,00168,India
269957,2023-08-27,212,amul cheese,250,315,65,1,00168,India
269957,2023-08-27,201,paneer,210,340,130,1,00168,India
153535,2023-08-27,213,bisleri,6,15,9,1,00344,India
153535,2023-08-27,206,yakult,360,400,40,1,00344,India
153535,2023-08-27,203,mango yogurt,50,60,10,1,00344,India
153535,2023-08-27,207,coca cola,75,100,25,1,00344,India
153535,2023-08-27,212,amul cheese,250,315,65,1,00344,India
661936,2023-08-27,211,red bull,90,125,35,1,00187,India
144116,2023-08-27,210,mountain dew,75,100,25,1,00376,India
144116,2023-08-27,213,bisleri,6,15,9,1,00376,India
144116,2023-08-27,207,coca cola,75,100,25,1,00376,India
894940,2023-08-27,213,bisleri,6,15,9,1,00159,India
894940,2023-08-27,202,milk,12,27,15,1,00159,India
894940,2023-08-27,201,paneer,210,340,130,1,00159,India
894940,2023-08-27,211,red bull,90,125,35,1,00159,India
894940,2023-08-27,207,coca cola,75,100,25,1,00159,India
819942,2023-08-27,213,bisleri,6,15,9,1,00400,India
819942,2023-08-27,207,coca cola,75,100,25,1,00400,India
819942,2023-08-27,201,paneer,210,340,130,1,00400,India
819942,2023-08-27,212,amul cheese,250,315,65,1,00400,India
283604,2023-08-27,207,coca cola,75,100,25,1,00289,India
135444,2023-08-27,209,pepsi,75,100,25,1,00277,India
135444,2023-08-27,208,sprite,75,100,25,1,00277,India
135444,2023-08-27,206,yakult,360,400,40,1,00277,India
135444,2023-08-27,211,red bull,90,125,35,1,00277,India
730904,2023-08-27,208,sprite,75,100,25,1,00296,India
370857,2023-08-27,206,yakult,360,400,40,1,00400,India
370857,2023-08-27,208,sprite,75,100,25,1,00400,India
370857,2023-08-27,211,red bull,90,125,35,1,00400,India
201934,2023-08-27,208,sprite,75,100,25,1,00120,India
201934,2023-08-27,213,bisleri,6,15,9,1,00120,India
174355,2023-08-27,207,coca cola,75,100,25,1,00033,India
174355,2023-08-27,210,mountain dew,75,100,25,1,00033,India
174355,2023-08-27,203,mango yogurt,50,60,10,1,00033,India
711517,2023-08-27,208,sprite,75,100,25,1,00405,India
711517,2023-08-27,205,classic yogurt,45,60,15,1,00405,India
711517,2023-08-27,212,amul cheese,250,315,65,1,00405,India
152633,2023-08-27,201,paneer,210,340,130,1,00027,India
152633,2023-08-27,207,coca cola,75,100,25,1,00027,India
152633,2023-08-27,204,strawberry yogurt,50,60,10,1,00027,India
152633,2023-08-27,209,pepsi,75,100,25,1,00027,India
152633,2023-08-27,212,amul cheese,250,315,65,1,00027,India
166891,2023-08-27,201,paneer,210,340,130,1,00003,India
166891,2023-08-27,213,bisleri,6,15,9,1,00003,India
166891,2023-08-27,207,coca cola,75,100,25,1,00003,India
166891,2023-08-27,212,amul cheese,250,315,65,1,00003,India
939189,2023-08-27,208,sprite,75,100,25,1,00458,India
939189,2023-08-27,203,mango yogurt,50,60,10,1,00458,India
939189,2023-08-27,205,classic yogurt,45,60,15,1,00458,India
939189,2023-08-27,202,milk,12,27,15,1,00458,India
154607,2023-08-27,206,yakult,360,400,40,1,00438,India
154607,2023-08-27,202,milk,12,27,15,1,00438,India
154607,2023-08-27,213,bisleri,6,15,9,1,00438,India
154607,2023-08-27,203,mango yogurt,50,60,10,1,00438,India
695294,2023-08-27,204,strawberry yogurt,50,60,10,1,00343,India
695294,2023-08-27,202,milk,12,27,15,1,00343,India
695294,2023-08-27,207,coca cola,75,100,25,1,00343,India
759890,2023-08-27,210,mountain dew,75,100,25,1,00003,India
759890,2023-08-27,208,sprite,75,100,25,1,00003,India
759890,2023-08-27,209,pepsi,75,100,25,1,00003,India
759890,2023-08-27,207,coca cola,75,100,25,1,00003,India
687714,2023-08-27,206,yakult,360,400,40,1,00154,India
687714,2023-08-27,210,mountain dew,75,100,25,1,00154,India
687714,2023-08-27,209,pepsi,75,100,25,1,00154,India
686411,2023-08-27,212,amul cheese,250,315,65,1,00456,India
686411,2023-08-27,203,mango yogurt,50,60,10,1,00456,India
686411,2023-08-27,207,coca cola,75,100,25,1,00456,India
645224,2023-08-27,212,amul cheese,250,315,65,1,00128,India
645224,2023-08-27,207,coca cola,75,100,25,1,00128,India
645224,2023-08-27,203,mango yogurt,50,60,10,1,00128,India
645224,2023-08-27,205,classic yogurt,45,60,15,1,00128,India
391220,2023-08-27,204,strawberry yogurt,50,60,10,1,00013,India
391220,2023-08-27,207,coca cola,75,100,25,1,00013,India
391220,2023-08-27,203,mango yogurt,50,60,10,1,00013,India
391220,2023-08-27,208,sprite,75,100,25,1,00013,India
204915,2023-08-27,204,strawberry yogurt,50,60,10,1,00312,India
204915,2023-08-27,213,bisleri,6,15,9,1,00312,India
169858,2023-08-27,208,sprite,75,100,25,1,00413,India
169858,2023-08-27,205,classic yogurt,45,60,15,1,00413,India
169858,2023-08-27,211,red bull,90,125,35,1,00413,India
169858,2023-08-27,202,milk,12,27,15,1,00413,India
407935,2023-08-27,211,red bull,90,125,35,1,00106,India
407935,2023-08-27,205,classic yogurt,45,60,15,1,00106,India
664856,2023-08-27,201,paneer,210,340,130,1,00187,India
664856,2023-08-27,212,amul cheese,250,315,65,1,00187,India
811830,2023-08-27,208,sprite,75,100,25,1,00170,India
811830,2023-08-27,203,mango yogurt,50,60,10,1,00170,India
832090,2023-08-27,209,pepsi,75,100,25,1,00126,India
832090,2023-08-27,212,amul cheese,250,315,65,1,00126,India
832090,2023-08-27,201,paneer,210,340,130,1,00126,India
832090,2023-08-27,204,strawberry yogurt,50,60,10,1,00126,India
832090,2023-08-27,205,classic yogurt,45,60,15,1,00126,India
414960,2023-08-27,204,strawberry yogurt,50,60,10,1,00267,India
414960,2023-08-27,205,classic yogurt,45,60,15,1,00267,India
590012,2023-08-27,208,sprite,75,100,25,1,00152,India
590012,2023-08-27,201,paneer,210,340,130,1,00152,India
210722,2023-08-27,204,strawberry yogurt,50,60,10,1,00231,India
210722,2023-08-27,212,amul cheese,250,315,65,1,00231,India
210722,2023-08-27,210,mountain dew,75,100,25,1,00231,India
210722,2023-08-27,207,coca cola,75,100,25,1,00231,India
210722,2023-08-27,203,mango yogurt,50,60,10,1,00231,India
581938,2023-08-27,208,sprite,75,100,25,1,00256,India
581938,2023-08-27,207,coca cola,75,100,25,1,00256,India
581938,2023-08-27,213,bisleri,6,15,9,1,00256,India
581938,2023-08-27,209,pepsi,75,100,25,1,00256,India
553888,2023-08-27,203,mango yogurt,50,60,10,1,00440,India
426112,2023-08-27,213,bisleri,6,15,9,1,00155,India
426112,2023-08-27,212,amul cheese,250,315,65,1,00155,India
426112,2023-08-27,205,classic yogurt,45,60,15,1,00155,India
426112,2023-08-27,208,sprite,75,100,25,1,00155,India
426112,2023-08-27,201,paneer,210,340,130,1,00155,India
582798,2023-08-27,211,red bull,90,125,35,1,00093,India
582798,2023-08-27,204,strawberry yogurt,50,60,10,1,00093,India
582798,2023-08-27,203,mango yogurt,50,60,10,1,00093,India
582798,2023-08-27,210,mountain dew,75,100,25,1,00093,India
414406,2023-08-27,205,classic yogurt,45,60,15,1,00022,India
414406,2023-08-27,202,milk,12,27,15,1,00022,India
414406,2023-08-27,211,red bull,90,125,35,1,00022,India
412494,2023-08-27,206,yakult,360,400,40,1,00005,India
412494,2023-08-27,208,sprite,75,100,25,1,00005,India
412494,2023-08-27,203,mango yogurt,50,60,10,1,00005,India
445355,2023-08-27,212,amul cheese,250,315,65,1,00448,India
445355,2023-08-27,208,sprite,75,100,25,1,00448,India
445355,2023-08-27,201,paneer,210,340,130,1,00448,India
445355,2023-08-27,209,pepsi,75,100,25,1,00448,India
131305,2023-08-27,203,mango yogurt,50,60,10,1,00219,India
131305,2023-08-27,211,red bull,90,125,35,1,00219,India
131305,2023-08-27,202,milk,12,27,15,1,00219,India
131305,2023-08-27,210,mountain dew,75,100,25,1,00219,India
131305,2023-08-27,213,bisleri,6,15,9,1,00219,India
668134,2023-08-27,207,coca cola,75,100,25,1,00134,India
668134,2023-08-27,212,amul cheese,250,315,65,1,00134,India
668134,2023-08-27,202,milk,12,27,15,1,00134,India
668134,2023-08-27,208,sprite,75,100,25,1,00134,India
668134,2023-08-27,203,mango yogurt,50,60,10,1,00134,India
566709,2023-08-27,210,mountain dew,75,100,25,1,00225,India
764270,2023-08-27,203,mango yogurt,50,60,10,1,00220,India
764270,2023-08-27,204,strawberry yogurt,50,60,10,1,00220,India
764270,2023-08-27,213,bisleri,6,15,9,1,00220,India
764270,2023-08-27,211,red bull,90,125,35,1,00220,India
764270,2023-08-27,207,coca cola,75,100,25,1,00220,India
466006,2023-08-28,211,red bull,90,125,35,1,00268,India
591637,2023-08-28,204,strawberry yogurt,50,60,10,1,00455,India
591637,2023-08-28,208,sprite,75,100,25,1,00455,India
687137,2023-08-28,204,strawberry yogurt,50,60,10,1,00010,India
687137,2023-08-28,209,pepsi,75,100,25,1,00010,India
687137,2023-08-28,207,coca cola,75,100,25,1,00010,India
541872,2023-08-28,210,mountain dew,75,100,25,1,00370,India
541872,2023-08-28,207,coca cola,75,100,25,1,00370,India
541872,2023-08-28,206,yakult,360,400,40,1,00370,India
541872,2023-08-28,205,classic yogurt,45,60,15,1,00370,India
193275,2023-08-28,213,bisleri,6,15,9,1,00126,India
193275,2023-08-28,203,mango yogurt,50,60,10,1,00126,India
275250,2023-08-28,204,strawberry yogurt,50,60,10,1,00287,India
275250,2023-08-28,209,pepsi,75,100,25,1,00287,India
324337,2023-08-28,209,pepsi,75,100,25,1,00310,India
468863,2023-08-28,213,bisleri,6,15,9,1,00455,India
986122,2023-08-28,206,yakult,360,400,40,1,00261,India
986122,2023-08-28,213,bisleri,6,15,9,1,00261,India
987779,2023-08-28,206,yakult,360,400,40,1,00333,India
987779,2023-08-28,203,mango yogurt,50,60,10,1,00333,India
987779,2023-08-28,205,classic yogurt,45,60,15,1,00333,India
416411,2023-08-28,211,red bull,90,125,35,1,00013,India
416411,2023-08-28,205,classic yogurt,45,60,15,1,00013,India
416411,2023-08-28,201,paneer,210,340,130,1,00013,India
416411,2023-08-28,213,bisleri,6,15,9,1,00013,India
409685,2023-08-28,211,red bull,90,125,35,1,00474,India
409685,2023-08-28,207,coca cola,75,100,25,1,00474,India
409685,2023-08-28,201,paneer,210,340,130,1,00474,India
409685,2023-08-28,204,strawberry yogurt,50,60,10,1,00474,India
662298,2023-08-28,210,mountain dew,75,100,25,1,00002,India
396414,2023-08-28,206,yakult,360,400,40,1,00312,India
396414,2023-08-28,211,red bull,90,125,35,1,00312,India
396414,2023-08-28,207,coca cola,75,100,25,1,00312,India
626391,2023-08-28,213,bisleri,6,15,9,1,00009,India
626391,2023-08-28,209,pepsi,75,100,25,1,00009,India
626391,2023-08-28,201,paneer,210,340,130,1,00009,India
876864,2023-08-28,201,paneer,210,340,130,1,00010,India
876864,2023-08-28,205,classic yogurt,45,60,15,1,00010,India
876864,2023-08-28,212,amul cheese,250,315,65,1,00010,India
876864,2023-08-28,208,sprite,75,100,25,1,00010,India
876864,2023-08-28,213,bisleri,6,15,9,1,00010,India
771564,2023-08-28,213,bisleri,6,15,9,1,00398,India
771564,2023-08-28,208,sprite,75,100,25,1,00398,India
771564,2023-08-28,206,yakult,360,400,40,1,00398,India
771564,2023-08-28,201,paneer,210,340,130,1,00398,India
771564,2023-08-28,202,milk,12,27,15,1,00398,India
300098,2023-08-28,211,red bull,90,125,35,1,00241,India
719892,2023-08-28,211,red bull,90,125,35,1,00086,India
186673,2023-08-28,209,pepsi,75,100,25,1,00414,India
186673,2023-08-28,206,yakult,360,400,40,1,00414,India
186673,2023-08-28,205,classic yogurt,45,60,15,1,00414,India
880945,2023-08-28,207,coca cola,75,100,25,1,00013,India
880945,2023-08-28,213,bisleri,6,15,9,1,00013,India
346870,2023-08-28,213,bisleri,6,15,9,1,00442,India
346870,2023-08-28,204,strawberry yogurt,50,60,10,1,00442,India
346870,2023-08-28,205,classic yogurt,45,60,15,1,00442,India
773053,2023-08-28,207,coca cola,75,100,25,1,00225,India
306723,2023-08-28,207,coca cola,75,100,25,1,00439,India
306723,2023-08-28,211,red bull,90,125,35,1,00439,India
306723,2023-08-28,209,pepsi,75,100,25,1,00439,India
306723,2023-08-28,205,classic yogurt,45,60,15,1,00439,India
438818,2023-08-28,202,milk,12,27,15,1,00179,India
438818,2023-08-28,207,coca cola,75,100,25,1,00179,India
438818,2023-08-28,209,pepsi,75,100,25,1,00179,India
438818,2023-08-28,205,classic yogurt,45,60,15,1,00179,India
438818,2023-08-28,208,sprite,75,100,25,1,00179,India
705464,2023-08-28,202,milk,12,27,15,1,00025,India
705464,2023-08-28,201,paneer,210,340,130,1,00025,India
705464,2023-08-28,211,red bull,90,125,35,1,00025,India
437934,2023-08-28,211,red bull,90,125,35,1,00455,India
437934,2023-08-28,209,pepsi,75,100,25,1,00455,India
437934,2023-08-28,202,milk,12,27,15,1,00455,India
841390,2023-08-28,206,yakult,360,400,40,1,00101,India
700410,2023-08-28,206,yakult,360,400,40,1,00308,India
700410,2023-08-28,205,classic yogurt,45,60,15,1,00308,India
700410,2023-08-28,202,milk,12,27,15,1,00308,India
700410,2023-08-28,213,bisleri,6,15,9,1,00308,India
288940,2023-08-28,207,coca cola,75,100,25,1,00009,India
288940,2023-08-28,209,pepsi,75,100,25,1,00009,India
779593,2023-08-28,207,coca cola,75,100,25,1,00466,India
755477,2023-08-28,208,sprite,75,100,25,1,00420,India
823284,2023-08-28,213,bisleri,6,15,9,1,00305,India
823284,2023-08-28,204,strawberry yogurt,50,60,10,1,00305,India
823284,2023-08-28,205,classic yogurt,45,60,15,1,00305,India
823284,2023-08-28,212,amul cheese,250,315,65,1,00305,India
441555,2023-08-28,209,pepsi,75,100,25,1,00005,India
441507,2023-08-28,206,yakult,360,400,40,1,00357,India
441507,2023-08-28,211,red bull,90,125,35,1,00357,India
441507,2023-08-28,204,strawberry yogurt,50,60,10,1,00357,India
826186,2023-08-28,210,mountain dew,75,100,25,1,00181,India
826186,2023-08-28,207,coca cola,75,100,25,1,00181,India
512319,2023-08-28,208,sprite,75,100,25,1,00362,India
512319,2023-08-28,210,mountain dew,75,100,25,1,00362,India
219297,2023-08-28,213,bisleri,6,15,9,1,00010,India
219297,2023-08-28,209,pepsi,75,100,25,1,00010,India
634053,2023-08-28,201,paneer,210,340,130,1,00126,India
634053,2023-08-28,203,mango yogurt,50,60,10,1,00126,India
329795,2023-08-28,202,milk,12,27,15,1,00268,India
329795,2023-08-28,210,mountain dew,75,100,25,1,00268,India
329795,2023-08-28,213,bisleri,6,15,9,1,00268,India
329795,2023-08-28,212,amul cheese,250,315,65,1,00268,India
329795,2023-08-28,206,yakult,360,400,40,1,00268,India
636682,2023-08-28,203,mango yogurt,50,60,10,1,00162,India
636682,2023-08-28,204,strawberry yogurt,50,60,10,1,00162,India
702849,2023-08-28,213,bisleri,6,15,9,1,00001,India
702849,2023-08-28,205,classic yogurt,45,60,15,1,00001,India
702849,2023-08-28,212,amul cheese,250,315,65,1,00001,India
780288,2023-08-28,201,paneer,210,340,130,1,00230,India
780288,2023-08-28,212,amul cheese,250,315,65,1,00230,India
780288,2023-08-28,210,mountain dew,75,100,25,1,00230,India
780288,2023-08-28,209,pepsi,75,100,25,1,00230,India
807497,2023-08-28,201,paneer,210,340,130,1,00089,India
807497,2023-08-28,205,classic yogurt,45,60,15,1,00089,India
807497,2023-08-28,213,bisleri,6,15,9,1,00089,India
807497,2023-08-28,209,pepsi,75,100,25,1,00089,India
350689,2023-08-28,203,mango yogurt,50,60,10,1,00468,India
350689,2023-08-28,207,coca cola,75,100,25,1,00468,India
280877,2023-08-28,211,red bull,90,125,35,1,00096,India
500605,2023-08-28,209,pepsi,75,100,25,1,00334,India
147422,2023-08-28,202,milk,12,27,15,1,00120,India
147422,2023-08-28,204,strawberry yogurt,50,60,10,1,00120,India
147422,2023-08-28,207,coca cola,75,100,25,1,00120,India
964476,2023-08-28,210,mountain dew,75,100,25,1,00135,India
964476,2023-08-28,201,paneer,210,340,130,1,00135,India
964476,2023-08-28,204,strawberry yogurt,50,60,10,1,00135,India
232735,2023-08-28,211,red bull,90,125,35,1,00103,India
232735,2023-08-28,213,bisleri,6,15,9,1,00103,India
661222,2023-08-28,202,milk,12,27,15,1,00410,India
661222,2023-08-28,203,mango yogurt,50,60,10,1,00410,India
661222,2023-08-28,208,sprite,75,100,25,1,00410,India
661222,2023-08-28,207,coca cola,75,100,25,1,00410,India
661222,2023-08-28,205,classic yogurt,45,60,15,1,00410,India
287104,2023-08-28,201,paneer,210,340,130,1,00148,India
287104,2023-08-28,210,mountain dew,75,100,25,1,00148,India
287104,2023-08-28,212,amul cheese,250,315,65,1,00148,India
827337,2023-08-28,213,bisleri,6,15,9,1,00379,India
827337,2023-08-28,207,coca cola,75,100,25,1,00379,India
827337,2023-08-28,201,paneer,210,340,130,1,00379,India
981321,2023-08-28,208,sprite,75,100,25,1,00471,India
282431,2023-08-28,212,amul cheese,250,315,65,1,00188,India
282431,2023-08-28,206,yakult,360,400,40,1,00188,India
282431,2023-08-28,208,sprite,75,100,25,1,00188,India
282431,2023-08-28,203,mango yogurt,50,60,10,1,00188,India
824350,2023-08-28,207,coca cola,75,100,25,1,00495,India
824350,2023-08-28,213,bisleri,6,15,9,1,00495,India
824350,2023-08-28,210,mountain dew,75,100,25,1,00495,India
379124,2023-08-28,202,milk,12,27,15,1,00356,India
379124,2023-08-28,210,mountain dew,75,100,25,1,00356,India
389531,2023-08-28,212,amul cheese,250,315,65,1,00053,India
389531,2023-08-28,211,red bull,90,125,35,1,00053,India
389531,2023-08-28,205,classic yogurt,45,60,15,1,00053,India
389531,2023-08-28,203,mango yogurt,50,60,10,1,00053,India
389531,2023-08-28,202,milk,12,27,15,1,00053,India
224948,2023-08-28,209,pepsi,75,100,25,1,00290,India
229707,2023-08-28,205,classic yogurt,45,60,15,1,00263,India
229707,2023-08-28,212,amul cheese,250,315,65,1,00263,India
714115,2023-08-28,209,pepsi,75,100,25,1,00224,India
714115,2023-08-28,206,yakult,360,400,40,1,00224,India
694850,2023-08-28,202,milk,12,27,15,1,00160,India
694850,2023-08-28,212,amul cheese,250,315,65,1,00160,India
694850,2023-08-28,209,pepsi,75,100,25,1,00160,India
849413,2023-08-28,208,sprite,75,100,25,1,00216,India
849413,2023-08-28,210,mountain dew,75,100,25,1,00216,India
120997,2023-08-28,206,yakult,360,400,40,1,00301,India
120997,2023-08-28,202,milk,12,27,15,1,00301,India
120997,2023-08-28,204,strawberry yogurt,50,60,10,1,00301,India
237590,2023-08-28,207,coca cola,75,100,25,1,00225,India
815593,2023-08-28,208,sprite,75,100,25,1,00455,India
815593,2023-08-28,207,coca cola,75,100,25,1,00455,India
815593,2023-08-28,210,mountain dew,75,100,25,1,00455,India
126697,2023-08-28,202,milk,12,27,15,1,00393,India
126697,2023-08-28,213,bisleri,6,15,9,1,00393,India
253298,2023-08-28,205,classic yogurt,45,60,15,1,00490,India
253298,2023-08-28,208,sprite,75,100,25,1,00490,India
522445,2023-08-28,208,sprite,75,100,25,1,00355,India
257154,2023-08-28,205,classic yogurt,45,60,15,1,00139,India
257154,2023-08-28,207,coca cola,75,100,25,1,00139,India
257154,2023-08-28,212,amul cheese,250,315,65,1,00139,India
854171,2023-08-28,207,coca cola,75,100,25,1,00325,India
854171,2023-08-28,213,bisleri,6,15,9,1,00325,India
854171,2023-08-28,206,yakult,360,400,40,1,00325,India
662491,2023-08-28,208,sprite,75,100,25,1,00326,India
662491,2023-08-28,213,bisleri,6,15,9,1,00326,India
662491,2023-08-28,202,milk,12,27,15,1,00326,India
662491,2023-08-28,201,paneer,210,340,130,1,00326,India
662491,2023-08-28,209,pepsi,75,100,25,1,00326,India
950128,2023-08-28,203,mango yogurt,50,60,10,1,00280,India
603822,2023-08-28,208,sprite,75,100,25,1,00345,India
603822,2023-08-28,212,amul cheese,250,315,65,1,00345,India
149285,2023-08-28,207,coca cola,75,100,25,1,00351,India
149285,2023-08-28,201,paneer,210,340,130,1,00351,India
149285,2023-08-28,202,milk,12,27,15,1,00351,India
149285,2023-08-28,213,bisleri,6,15,9,1,00351,India
530810,2023-08-28,207,coca cola,75,100,25,1,00042,India
530810,2023-08-28,206,yakult,360,400,40,1,00042,India
530810,2023-08-28,203,mango yogurt,50,60,10,1,00042,India
361572,2023-08-28,211,red bull,90,125,35,1,00346,India
862940,2023-08-28,213,bisleri,6,15,9,1,00338,India
482617,2023-08-28,211,red bull,90,125,35,1,00189,India
756957,2023-08-28,207,coca cola,75,100,25,1,00473,India
756957,2023-08-28,210,mountain dew,75,100,25,1,00473,India
756957,2023-08-28,203,mango yogurt,50,60,10,1,00473,India
756957,2023-08-28,206,yakult,360,400,40,1,00473,India
888764,2023-08-28,203,mango yogurt,50,60,10,1,00028,India
888764,2023-08-28,209,pepsi,75,100,25,1,00028,India
468954,2023-08-28,211,red bull,90,125,35,1,00463,India
385998,2023-08-28,207,coca cola,75,100,25,1,00347,India
385998,2023-08-28,211,red bull,90,125,35,1,00347,India
385998,2023-08-28,209,pepsi,75,100,25,1,00347,India
385998,2023-08-28,205,classic yogurt,45,60,15,1,00347,India
385998,2023-08-28,204,strawberry yogurt,50,60,10,1,00347,India
748508,2023-08-28,209,pepsi,75,100,25,1,00325,India
748508,2023-08-28,208,sprite,75,100,25,1,00325,India
748508,2023-08-28,213,bisleri,6,15,9,1,00325,India
748508,2023-08-28,202,milk,12,27,15,1,00325,India
862297,2023-08-28,208,sprite,75,100,25,1,00272,India
862297,2023-08-28,213,bisleri,6,15,9,1,00272,India
862297,2023-08-28,204,strawberry yogurt,50,60,10,1,00272,India
862297,2023-08-28,211,red bull,90,125,35,1,00272,India
862297,2023-08-28,205,classic yogurt,45,60,15,1,00272,India
526867,2023-08-28,212,amul cheese,250,315,65,1,00398,India
526867,2023-08-28,205,classic yogurt,45,60,15,1,00398,India
526867,2023-08-28,207,coca cola,75,100,25,1,00398,India
526867,2023-08-28,201,paneer,210,340,130,1,00398,India
707974,2023-08-28,213,bisleri,6,15,9,1,00126,India
219213,2023-08-28,207,coca cola,75,100,25,1,00036,India
219213,2023-08-28,203,mango yogurt,50,60,10,1,00036,India
219213,2023-08-28,206,yakult,360,400,40,1,00036,India
219213,2023-08-28,208,sprite,75,100,25,1,00036,India
791747,2023-08-28,211,red bull,90,125,35,1,00404,India
700337,2023-08-28,203,mango yogurt,50,60,10,1,00252,India
700337,2023-08-28,207,coca cola,75,100,25,1,00252,India
700337,2023-08-28,211,red bull,90,125,35,1,00252,India
700337,2023-08-28,212,amul cheese,250,315,65,1,00252,India
301404,2023-08-28,213,bisleri,6,15,9,1,00269,India
301404,2023-08-28,202,milk,12,27,15,1,00269,India
301404,2023-08-28,212,amul cheese,250,315,65,1,00269,India
972970,2023-08-29,211,red bull,90,125,35,1,00395,India
862547,2023-08-29,208,sprite,75,100,25,1,00262,India
636498,2023-08-29,202,milk,12,27,15,1,00340,India
636498,2023-08-29,204,strawberry yogurt,50,60,10,1,00340,India
168198,2023-08-29,207,coca cola,75,100,25,1,00255,India
168198,2023-08-29,211,red bull,90,125,35,1,00255,India
687636,2023-08-29,207,coca cola,75,100,25,1,00310,India
687636,2023-08-29,213,bisleri,6,15,9,1,00310,India
687636,2023-08-29,208,sprite,75,100,25,1,00310,India
139224,2023-08-29,203,mango yogurt,50,60,10,1,00205,India
397556,2023-08-29,202,milk,12,27,15,1,00418,India
397556,2023-08-29,212,amul cheese,250,315,65,1,00418,India
284605,2023-08-29,201,paneer,210,340,130,1,00200,India
284605,2023-08-29,210,mountain dew,75,100,25,1,00200,India
284605,2023-08-29,208,sprite,75,100,25,1,00200,India
538154,2023-08-29,207,coca cola,75,100,25,1,00112,India
538154,2023-08-29,204,strawberry yogurt,50,60,10,1,00112,India
317645,2023-08-29,207,coca cola,75,100,25,1,00334,India
317645,2023-08-29,205,classic yogurt,45,60,15,1,00334,India
317645,2023-08-29,213,bisleri,6,15,9,1,00334,India
317645,2023-08-29,210,mountain dew,75,100,25,1,00334,India
614538,2023-08-29,211,red bull,90,125,35,1,00094,India
614538,2023-08-29,208,sprite,75,100,25,1,00094,India
123870,2023-08-29,203,mango yogurt,50,60,10,1,00281,India
123870,2023-08-29,204,strawberry yogurt,50,60,10,1,00281,India
123870,2023-08-29,213,bisleri,6,15,9,1,00281,India
746276,2023-08-29,205,classic yogurt,45,60,15,1,00480,India
746276,2023-08-29,207,coca cola,75,100,25,1,00480,India
746276,2023-08-29,212,amul cheese,250,315,65,1,00480,India
318159,2023-08-29,213,bisleri,6,15,9,1,00180,India
318159,2023-08-29,209,pepsi,75,100,25,1,00180,India
460202,2023-08-29,205,classic yogurt,45,60,15,1,00024,India
460202,2023-08-29,206,yakult,360,400,40,1,00024,India
999501,2023-08-29,210,mountain dew,75,100,25,1,00355,India
644433,2023-08-29,204,strawberry yogurt,50,60,10,1,00066,India
644433,2023-08-29,212,amul cheese,250,315,65,1,00066,India
644433,2023-08-29,208,sprite,75,100,25,1,00066,India
511054,2023-08-29,211,red bull,90,125,35,1,00294,India
511054,2023-08-29,205,classic yogurt,45,60,15,1,00294,India
456086,2023-08-29,207,coca cola,75,100,25,1,00130,India
456086,2023-08-29,210,mountain dew,75,100,25,1,00130,India
456086,2023-08-29,209,pepsi,75,100,25,1,00130,India
129888,2023-08-29,203,mango yogurt,50,60,10,1,00359,India
129888,2023-08-29,210,mountain dew,75,100,25,1,00359,India
129888,2023-08-29,206,yakult,360,400,40,1,00359,India
274809,2023-08-29,207,coca cola,75,100,25,1,00162,India
970650,2023-08-29,211,red bull,90,125,35,1,00213,India
970650,2023-08-29,207,coca cola,75,100,25,1,00213,India
970650,2023-08-29,208,sprite,75,100,25,1,00213,India
970650,2023-08-29,210,mountain dew,75,100,25,1,00213,India
970650,2023-08-29,204,strawberry yogurt,50,60,10,1,00213,India
864189,2023-08-29,204,strawberry yogurt,50,60,10,1,00415,India
864189,2023-08-29,211,red bull,90,125,35,1,00415,India
864189,2023-08-29,209,pepsi,75,100,25,1,00415,India
601433,2023-08-29,213,bisleri,6,15,9,1,00205,India
601433,2023-08-29,203,mango yogurt,50,60,10,1,00205,India
601433,2023-08-29,210,mountain dew,75,100,25,1,00205,India
601433,2023-08-29,209,pepsi,75,100,25,1,00205,India
601433,2023-08-29,206,yakult,360,400,40,1,00205,India
952333,2023-08-29,204,strawberry yogurt,50,60,10,1,00018,India
952333,2023-08-29,213,bisleri,6,15,9,1,00018,India
952333,2023-08-29,202,milk,12,27,15,1,00018,India
952333,2023-08-29,208,sprite,75,100,25,1,00018,India
505438,2023-08-29,211,red bull,90,125,35,1,00235,India
505438,2023-08-29,201,paneer,210,340,130,1,00235,India
505438,2023-08-29,209,pepsi,75,100,25,1,00235,India
505438,2023-08-29,207,coca cola,75,100,25,1,00235,India
505438,2023-08-29,205,classic yogurt,45,60,15,1,00235,India
118147,2023-08-29,206,yakult,360,400,40,1,00086,India
118147,2023-08-29,212,amul cheese,250,315,65,1,00086,India
118147,2023-08-29,210,mountain dew,75,100,25,1,00086,India
118147,2023-08-29,213,bisleri,6,15,9,1,00086,India
157922,2023-08-29,208,sprite,75,100,25,1,00393,India
157922,2023-08-29,202,milk,12,27,15,1,00393,India
746303,2023-08-29,212,amul cheese,250,315,65,1,00210,India
746303,2023-08-29,202,milk,12,27,15,1,00210,India
392802,2023-08-29,209,pepsi,75,100,25,1,00356,India
392802,2023-08-29,210,mountain dew,75,100,25,1,00356,India
888003,2023-08-29,210,mountain dew,75,100,25,1,00273,India
888003,2023-08-29,204,strawberry yogurt,50,60,10,1,00273,India
746949,2023-08-29,204,strawberry yogurt,50,60,10,1,00326,India
175485,2023-08-29,201,paneer,210,340,130,1,00131,India
175485,2023-08-29,203,mango yogurt,50,60,10,1,00131,India
175485,2023-08-29,212,amul cheese,250,315,65,1,00131,India
873530,2023-08-29,211,red bull,90,125,35,1,00041,India
873530,2023-08-29,204,strawberry yogurt,50,60,10,1,00041,India
873530,2023-08-29,201,paneer,210,340,130,1,00041,India
415245,2023-08-29,211,red bull,90,125,35,1,00344,India
415245,2023-08-29,213,bisleri,6,15,9,1,00344,India
636561,2023-08-29,210,mountain dew,75,100,25,1,00119,India
636561,2023-08-29,204,strawberry yogurt,50,60,10,1,00119,India
636561,2023-08-29,208,sprite,75,100,25,1,00119,India
636561,2023-08-29,203,mango yogurt,50,60,10,1,00119,India
636561,2023-08-29,205,classic yogurt,45,60,15,1,00119,India
831769,2023-08-29,204,strawberry yogurt,50,60,10,1,00093,India
726272,2023-08-29,211,red bull,90,125,35,1,00126,India
726272,2023-08-29,212,amul cheese,250,315,65,1,00126,India
876531,2023-08-29,208,sprite,75,100,25,1,00224,India
880334,2023-08-29,208,sprite,75,100,25,1,00463,India
880334,2023-08-29,209,pepsi,75,100,25,1,00463,India
545123,2023-08-29,212,amul cheese,250,315,65,1,00161,India
545123,2023-08-29,206,yakult,360,400,40,1,00161,India
545123,2023-08-29,207,coca cola,75,100,25,1,00161,India
545123,2023-08-29,210,mountain dew,75,100,25,1,00161,India
837507,2023-08-29,213,bisleri,6,15,9,1,00292,India
143864,2023-08-29,212,amul cheese,250,315,65,1,00083,India
143864,2023-08-29,213,bisleri,6,15,9,1,00083,India
143864,2023-08-29,201,paneer,210,340,130,1,00083,India
260732,2023-08-29,208,sprite,75,100,25,1,00054,India
260732,2023-08-29,203,mango yogurt,50,60,10,1,00054,India
853035,2023-08-29,208,sprite,75,100,25,1,00401,India
186969,2023-08-29,208,sprite,75,100,25,1,00016,India
277086,2023-08-29,205,classic yogurt,45,60,15,1,00490,India
332504,2023-08-29,213,bisleri,6,15,9,1,00321,India
332504,2023-08-29,205,classic yogurt,45,60,15,1,00321,India
332504,2023-08-29,206,yakult,360,400,40,1,00321,India
390949,2023-08-29,202,milk,12,27,15,1,00273,India
390949,2023-08-29,212,amul cheese,250,315,65,1,00273,India
390949,2023-08-29,203,mango yogurt,50,60,10,1,00273,India
418432,2023-08-29,211,red bull,90,125,35,1,00454,India
571750,2023-08-29,201,paneer,210,340,130,1,00130,India
300325,2023-08-29,209,pepsi,75,100,25,1,00236,India
815580,2023-08-29,204,strawberry yogurt,50,60,10,1,00086,India
815580,2023-08-29,210,mountain dew,75,100,25,1,00086,India
815580,2023-08-29,208,sprite,75,100,25,1,00086,India
368775,2023-08-29,211,red bull,90,125,35,1,00328,India
368775,2023-08-29,209,pepsi,75,100,25,1,00328,India
368775,2023-08-29,201,paneer,210,340,130,1,00328,India
368775,2023-08-29,204,strawberry yogurt,50,60,10,1,00328,India
104158,2023-08-29,207,coca cola,75,100,25,1,00286,India
104158,2023-08-29,212,amul cheese,250,315,65,1,00286,India
104158,2023-08-29,208,sprite,75,100,25,1,00286,India
464463,2023-08-29,206,yakult,360,400,40,1,00408,India
464463,2023-08-29,207,coca cola,75,100,25,1,00408,India
464463,2023-08-29,213,bisleri,6,15,9,1,00408,India
464463,2023-08-29,211,red bull,90,125,35,1,00408,India
690970,2023-08-29,201,paneer,210,340,130,1,00477,India
690970,2023-08-29,209,pepsi,75,100,25,1,00477,India
690970,2023-08-29,202,milk,12,27,15,1,00477,India
387975,2023-08-29,211,red bull,90,125,35,1,00196,India
387975,2023-08-29,206,yakult,360,400,40,1,00196,India
387975,2023-08-29,204,strawberry yogurt,50,60,10,1,00196,India
179749,2023-08-29,207,coca cola,75,100,25,1,00381,India
179749,2023-08-29,210,mountain dew,75,100,25,1,00381,India
303590,2023-08-29,201,paneer,210,340,130,1,00274,India
455149,2023-08-29,210,mountain dew,75,100,25,1,00366,India
455149,2023-08-29,212,amul cheese,250,315,65,1,00366,India
455149,2023-08-29,202,milk,12,27,15,1,00366,India
455149,2023-08-29,204,strawberry yogurt,50,60,10,1,00366,India
878682,2023-08-29,207,coca cola,75,100,25,1,00034,India
878682,2023-08-29,204,strawberry yogurt,50,60,10,1,00034,India
123241,2023-08-29,211,red bull,90,125,35,1,00328,India
123241,2023-08-29,203,mango yogurt,50,60,10,1,00328,India
123241,2023-08-29,202,milk,12,27,15,1,00328,India
123241,2023-08-29,210,mountain dew,75,100,25,1,00328,India
344004,2023-08-29,207,coca cola,75,100,25,1,00282,India
344004,2023-08-29,210,mountain dew,75,100,25,1,00282,India
344004,2023-08-29,205,classic yogurt,45,60,15,1,00282,India
896356,2023-08-29,209,pepsi,75,100,25,1,00451,India
896356,2023-08-29,212,amul cheese,250,315,65,1,00451,India
159297,2023-08-29,209,pepsi,75,100,25,1,00097,India
159297,2023-08-29,212,amul cheese,250,315,65,1,00097,India
159297,2023-08-29,205,classic yogurt,45,60,15,1,00097,India
159297,2023-08-29,201,paneer,210,340,130,1,00097,India
856421,2023-08-29,202,milk,12,27,15,1,00195,India
856421,2023-08-29,201,paneer,210,340,130,1,00195,India
856421,2023-08-29,205,classic yogurt,45,60,15,1,00195,India
790300,2023-08-29,204,strawberry yogurt,50,60,10,1,00310,India
790300,2023-08-29,202,milk,12,27,15,1,00310,India
790300,2023-08-29,211,red bull,90,125,35,1,00310,India
790300,2023-08-29,208,sprite,75,100,25,1,00310,India
610739,2023-08-29,201,paneer,210,340,130,1,00279,India
610739,2023-08-29,209,pepsi,75,100,25,1,00279,India
610739,2023-08-29,212,amul cheese,250,315,65,1,00279,India
574459,2023-08-29,210,mountain dew,75,100,25,1,00236,India
574459,2023-08-29,204,strawberry yogurt,50,60,10,1,00236,India
574459,2023-08-29,205,classic yogurt,45,60,15,1,00236,India
574459,2023-08-29,208,sprite,75,100,25,1,00236,India
604346,2023-08-29,209,pepsi,75,100,25,1,00389,India
604346,2023-08-29,207,coca cola,75,100,25,1,00389,India
151165,2023-08-29,207,coca cola,75,100,25,1,00301,India
151165,2023-08-29,205,classic yogurt,45,60,15,1,00301,India
151165,2023-08-29,210,mountain dew,75,100,25,1,00301,India
261221,2023-08-29,204,strawberry yogurt,50,60,10,1,00153,India
789363,2023-08-29,209,pepsi,75,100,25,1,00045,India
789363,2023-08-29,212,amul cheese,250,315,65,1,00045,India
789363,2023-08-29,202,milk,12,27,15,1,00045,India
802023,2023-08-29,207,coca cola,75,100,25,1,00062,India
802023,2023-08-29,208,sprite,75,100,25,1,00062,India
802023,2023-08-29,213,bisleri,6,15,9,1,00062,India
802023,2023-08-29,202,milk,12,27,15,1,00062,India
485628,2023-08-29,206,yakult,360,400,40,1,00088,India
485628,2023-08-29,212,amul cheese,250,315,65,1,00088,India
485628,2023-08-29,205,classic yogurt,45,60,15,1,00088,India
485628,2023-08-29,207,coca cola,75,100,25,1,00088,India
428639,2023-08-29,213,bisleri,6,15,9,1,00381,India
677312,2023-08-29,206,yakult,360,400,40,1,00491,India
677312,2023-08-29,201,paneer,210,340,130,1,00491,India
677312,2023-08-29,207,coca cola,75,100,25,1,00491,India
677312,2023-08-29,212,amul cheese,250,315,65,1,00491,India
677312,2023-08-29,205,classic yogurt,45,60,15,1,00491,India
543214,2023-08-29,212,amul cheese,250,315,65,1,00216,India
543214,2023-08-29,213,bisleri,6,15,9,1,00216,India
543214,2023-08-29,205,classic yogurt,45,60,15,1,00216,India
543214,2023-08-29,211,red bull,90,125,35,1,00216,India
968102,2023-08-29,202,milk,12,27,15,1,00132,India
968102,2023-08-29,207,coca cola,75,100,25,1,00132,India
291247,2023-08-29,208,sprite,75,100,25,1,00350,India
291247,2023-08-29,213,bisleri,6,15,9,1,00350,India
225430,2023-08-29,201,paneer,210,340,130,1,00419,India
225430,2023-08-29,208,sprite,75,100,25,1,00419,India
673954,2023-08-29,210,mountain dew,75,100,25,1,00301,India
673954,2023-08-29,201,paneer,210,340,130,1,00301,India
673954,2023-08-29,211,red bull,90,125,35,1,00301,India
800610,2023-08-29,206,yakult,360,400,40,1,00019,India
800610,2023-08-29,204,strawberry yogurt,50,60,10,1,00019,India
800610,2023-08-29,210,mountain dew,75,100,25,1,00019,India
800610,2023-08-29,213,bisleri,6,15,9,1,00019,India
276446,2023-08-29,201,paneer,210,340,130,1,00159,India
276446,2023-08-29,206,yakult,360,400,40,1,00159,India
276446,2023-08-29,208,sprite,75,100,25,1,00159,India
532611,2023-08-29,203,mango yogurt,50,60,10,1,00309,India
532611,2023-08-29,212,amul cheese,250,315,65,1,00309,India
297981,2023-08-29,202,milk,12,27,15,1,00320,India
297981,2023-08-29,208,sprite,75,100,25,1,00320,India
297981,2023-08-29,210,mountain dew,75,100,25,1,00320,India
297981,2023-08-29,212,amul cheese,250,315,65,1,00320,India
297981,2023-08-29,206,yakult,360,400,40,1,00320,India
394758,2023-08-29,202,milk,12,27,15,1,00130,India
394758,2023-08-29,203,mango yogurt,50,60,10,1,00130,India
217921,2023-08-29,207,coca cola,75,100,25,1,00169,India
217921,2023-08-29,203,mango yogurt,50,60,10,1,00169,India
217921,2023-08-29,212,amul cheese,250,315,65,1,00169,India
217921,2023-08-29,213,bisleri,6,15,9,1,00169,India
217921,2023-08-29,208,sprite,75,100,25,1,00169,India
356535,2023-08-29,209,pepsi,75,100,25,1,00132,India
356535,2023-08-29,212,amul cheese,250,315,65,1,00132,India
356535,2023-08-29,204,strawberry yogurt,50,60,10,1,00132,India
382869,2023-08-29,203,mango yogurt,50,60,10,1,00212,India
382869,2023-08-29,204,strawberry yogurt,50,60,10,1,00212,India
142958,2023-08-29,208,sprite,75,100,25,1,00112,India
583073,2023-08-29,205,classic yogurt,45,60,15,1,00383,India
583073,2023-08-29,202,milk,12,27,15,1,00383,India
583073,2023-08-29,201,paneer,210,340,130,1,00383,India
583073,2023-08-29,208,sprite,75,100,25,1,00383,India
639374,2023-08-29,201,paneer,210,340,130,1,00200,India
639374,2023-08-29,208,sprite,75,100,25,1,00200,India
467727,2023-08-29,208,sprite,75,100,25,1,00488,India
467727,2023-08-29,210,mountain dew,75,100,25,1,00488,India
467727,2023-08-29,213,bisleri,6,15,9,1,00488,India
467727,2023-08-29,202,milk,12,27,15,1,00488,India
422427,2023-08-30,213,bisleri,6,15,9,1,00267,India
422427,2023-08-30,205,classic yogurt,45,60,15,1,00267,India
422427,2023-08-30,208,sprite,75,100,25,1,00267,India
442553,2023-08-30,213,bisleri,6,15,9,1,00142,India
442553,2023-08-30,204,strawberry yogurt,50,60,10,1,00142,India
442553,2023-08-30,202,milk,12,27,15,1,00142,India
442553,2023-08-30,210,mountain dew,75,100,25,1,00142,India
849543,2023-08-30,202,milk,12,27,15,1,00239,India
849543,2023-08-30,205,classic yogurt,45,60,15,1,00239,India
849543,2023-08-30,204,strawberry yogurt,50,60,10,1,00239,India
849543,2023-08-30,201,paneer,210,340,130,1,00239,India
849543,2023-08-30,209,pepsi,75,100,25,1,00239,India
460564,2023-08-30,211,red bull,90,125,35,1,00158,India
168511,2023-08-30,210,mountain dew,75,100,25,1,00420,India
168511,2023-08-30,208,sprite,75,100,25,1,00420,India
168511,2023-08-30,209,pepsi,75,100,25,1,00420,India
168511,2023-08-30,202,milk,12,27,15,1,00420,India
168511,2023-08-30,211,red bull,90,125,35,1,00420,India
228080,2023-08-30,207,coca cola,75,100,25,1,00361,India
228080,2023-08-30,213,bisleri,6,15,9,1,00361,India
228080,2023-08-30,211,red bull,90,125,35,1,00361,India
228080,2023-08-30,209,pepsi,75,100,25,1,00361,India
228080,2023-08-30,212,amul cheese,250,315,65,1,00361,India
395548,2023-08-30,211,red bull,90,125,35,1,00150,India
395548,2023-08-30,213,bisleri,6,15,9,1,00150,India
395548,2023-08-30,209,pepsi,75,100,25,1,00150,India
476908,2023-08-30,202,milk,12,27,15,1,00361,India
476908,2023-08-30,213,bisleri,6,15,9,1,00361,India
476908,2023-08-30,209,pepsi,75,100,25,1,00361,India
476908,2023-08-30,207,coca cola,75,100,25,1,00361,India
266493,2023-08-30,204,strawberry yogurt,50,60,10,1,00340,India
266493,2023-08-30,203,mango yogurt,50,60,10,1,00340,India
794368,2023-08-30,207,coca cola,75,100,25,1,00110,India
794368,2023-08-30,213,bisleri,6,15,9,1,00110,India
379201,2023-08-30,205,classic yogurt,45,60,15,1,00154,India
379201,2023-08-30,202,milk,12,27,15,1,00154,India
379201,2023-08-30,204,strawberry yogurt,50,60,10,1,00154,India
945400,2023-08-30,211,red bull,90,125,35,1,00493,India
975196,2023-08-30,207,coca cola,75,100,25,1,00208,India
412489,2023-08-30,204,strawberry yogurt,50,60,10,1,00095,India
412489,2023-08-30,205,classic yogurt,45,60,15,1,00095,India
412489,2023-08-30,212,amul cheese,250,315,65,1,00095,India
412489,2023-08-30,201,paneer,210,340,130,1,00095,India
412489,2023-08-30,206,yakult,360,400,40,1,00095,India
927346,2023-08-30,209,pepsi,75,100,25,1,00438,India
102701,2023-08-30,208,sprite,75,100,25,1,00382,India
102701,2023-08-30,211,red bull,90,125,35,1,00382,India
102701,2023-08-30,209,pepsi,75,100,25,1,00382,India
102701,2023-08-30,202,milk,12,27,15,1,00382,India
102701,2023-08-30,212,amul cheese,250,315,65,1,00382,India
982860,2023-08-30,210,mountain dew,75,100,25,1,00100,India
705412,2023-08-30,208,sprite,75,100,25,1,00426,India
705412,2023-08-30,210,mountain dew,75,100,25,1,00426,India
705412,2023-08-30,207,coca cola,75,100,25,1,00426,India
700744,2023-08-30,212,amul cheese,250,315,65,1,00444,India
700744,2023-08-30,206,yakult,360,400,40,1,00444,India
446463,2023-08-30,201,paneer,210,340,130,1,00147,India
446463,2023-08-30,207,coca cola,75,100,25,1,00147,India
386160,2023-08-30,208,sprite,75,100,25,1,00081,India
386160,2023-08-30,203,mango yogurt,50,60,10,1,00081,India
944788,2023-08-30,204,strawberry yogurt,50,60,10,1,00311,India
944788,2023-08-30,209,pepsi,75,100,25,1,00311,India
944788,2023-08-30,212,amul cheese,250,315,65,1,00311,India
375954,2023-08-30,210,mountain dew,75,100,25,1,00425,India
375954,2023-08-30,204,strawberry yogurt,50,60,10,1,00425,India
375954,2023-08-30,211,red bull,90,125,35,1,00425,India
441368,2023-08-30,205,classic yogurt,45,60,15,1,00016,India
714530,2023-08-30,213,bisleri,6,15,9,1,00444,India
714530,2023-08-30,205,classic yogurt,45,60,15,1,00444,India
606919,2023-08-30,201,paneer,210,340,130,1,00128,India
115284,2023-08-30,202,milk,12,27,15,1,00254,India
115284,2023-08-30,210,mountain dew,75,100,25,1,00254,India
115284,2023-08-30,204,strawberry yogurt,50,60,10,1,00254,India
115284,2023-08-30,203,mango yogurt,50,60,10,1,00254,India
109359,2023-08-30,211,red bull,90,125,35,1,00167,India
602127,2023-08-30,205,classic yogurt,45,60,15,1,00066,India
602127,2023-08-30,213,bisleri,6,15,9,1,00066,India
602127,2023-08-30,201,paneer,210,340,130,1,00066,India
602127,2023-08-30,204,strawberry yogurt,50,60,10,1,00066,India
134582,2023-08-30,201,paneer,210,340,130,1,00089,India
715835,2023-08-30,205,classic yogurt,45,60,15,1,00223,India
109487,2023-08-30,206,yakult,360,400,40,1,00168,India
109487,2023-08-30,204,strawberry yogurt,50,60,10,1,00168,India
109487,2023-08-30,212,amul cheese,250,315,65,1,00168,India
109487,2023-08-30,210,mountain dew,75,100,25,1,00168,India
448250,2023-08-30,210,mountain dew,75,100,25,1,00205,India
448250,2023-08-30,212,amul cheese,250,315,65,1,00205,India
448250,2023-08-30,213,bisleri,6,15,9,1,00205,India
448250,2023-08-30,201,paneer,210,340,130,1,00205,India
631044,2023-08-30,213,bisleri,6,15,9,1,00143,India
631044,2023-08-30,208,sprite,75,100,25,1,00143,India
787577,2023-08-30,204,strawberry yogurt,50,60,10,1,00017,India
573330,2023-08-30,207,coca cola,75,100,25,1,00394,India
573330,2023-08-30,203,mango yogurt,50,60,10,1,00394,India
573330,2023-08-30,211,red bull,90,125,35,1,00394,India
573330,2023-08-30,210,mountain dew,75,100,25,1,00394,India
609103,2023-08-30,209,pepsi,75,100,25,1,00489,India
311316,2023-08-30,201,paneer,210,340,130,1,00159,India
311316,2023-08-30,203,mango yogurt,50,60,10,1,00159,India
311316,2023-08-30,204,strawberry yogurt,50,60,10,1,00159,India
456134,2023-08-30,201,paneer,210,340,130,1,00119,India
456134,2023-08-30,207,coca cola,75,100,25,1,00119,India
456134,2023-08-30,212,amul cheese,250,315,65,1,00119,India
234810,2023-08-30,212,amul cheese,250,315,65,1,00297,India
234810,2023-08-30,203,mango yogurt,50,60,10,1,00297,India
623556,2023-08-30,211,red bull,90,125,35,1,00315,India
623556,2023-08-30,201,paneer,210,340,130,1,00315,India
623556,2023-08-30,213,bisleri,6,15,9,1,00315,India
623556,2023-08-30,203,mango yogurt,50,60,10,1,00315,India
240316,2023-08-30,211,red bull,90,125,35,1,00062,India
268690,2023-08-30,207,coca cola,75,100,25,1,00026,India
833562,2023-08-30,209,pepsi,75,100,25,1,00435,India
969797,2023-08-30,204,strawberry yogurt,50,60,10,1,00368,India
969797,2023-08-30,210,mountain dew,75,100,25,1,00368,India
969797,2023-08-30,208,sprite,75,100,25,1,00368,India
969797,2023-08-30,206,yakult,360,400,40,1,00368,India
969797,2023-08-30,203,mango yogurt,50,60,10,1,00368,India
285857,2023-08-30,212,amul cheese,250,315,65,1,00216,India
285857,2023-08-30,203,mango yogurt,50,60,10,1,00216,India
285857,2023-08-30,206,yakult,360,400,40,1,00216,India
877643,2023-08-30,205,classic yogurt,45,60,15,1,00054,India
877643,2023-08-30,207,coca cola,75,100,25,1,00054,India
877643,2023-08-30,206,yakult,360,400,40,1,00054,India
877643,2023-08-30,201,paneer,210,340,130,1,00054,India
488673,2023-08-30,201,paneer,210,340,130,1,00108,India
488673,2023-08-30,206,yakult,360,400,40,1,00108,India
488673,2023-08-30,204,strawberry yogurt,50,60,10,1,00108,India
730719,2023-08-30,209,pepsi,75,100,25,1,00249,India
730719,2023-08-30,204,strawberry yogurt,50,60,10,1,00249,India
548990,2023-08-30,205,classic yogurt,45,60,15,1,00102,India
616239,2023-08-30,208,sprite,75,100,25,1,00443,India
688421,2023-08-30,211,red bull,90,125,35,1,00027,India
688421,2023-08-30,204,strawberry yogurt,50,60,10,1,00027,India
688421,2023-08-30,206,yakult,360,400,40,1,00027,India
420899,2023-08-30,202,milk,12,27,15,1,00284,India
420899,2023-08-30,203,mango yogurt,50,60,10,1,00284,India
420899,2023-08-30,208,sprite,75,100,25,1,00284,India
420899,2023-08-30,205,classic yogurt,45,60,15,1,00284,India
705661,2023-08-30,203,mango yogurt,50,60,10,1,00001,India
142803,2023-08-30,201,paneer,210,340,130,1,00327,India
142803,2023-08-30,208,sprite,75,100,25,1,00327,India
142803,2023-08-30,202,milk,12,27,15,1,00327,India
696163,2023-08-30,208,sprite,75,100,25,1,00486,India
696163,2023-08-30,202,milk,12,27,15,1,00486,India
696163,2023-08-30,201,paneer,210,340,130,1,00486,India
696163,2023-08-30,209,pepsi,75,100,25,1,00486,India
159096,2023-08-31,206,yakult,360,400,40,1,00189,India
245481,2023-08-31,210,mountain dew,75,100,25,1,00014,India
245481,2023-08-31,204,strawberry yogurt,50,60,10,1,00014,India
245481,2023-08-31,202,milk,12,27,15,1,00014,India
245481,2023-08-31,206,yakult,360,400,40,1,00014,India
566069,2023-08-31,207,coca cola,75,100,25,1,00025,India
566069,2023-08-31,208,sprite,75,100,25,1,00025,India
566069,2023-08-31,203,mango yogurt,50,60,10,1,00025,India
566069,2023-08-31,212,amul cheese,250,315,65,1,00025,India
574751,2023-08-31,201,paneer,210,340,130,1,00457,India
574751,2023-08-31,212,amul cheese,250,315,65,1,00457,India
324756,2023-08-31,209,pepsi,75,100,25,1,00168,India
330407,2023-08-31,208,sprite,75,100,25,1,00469,India
330407,2023-08-31,209,pepsi,75,100,25,1,00469,India
330407,2023-08-31,212,amul cheese,250,315,65,1,00469,India
632746,2023-08-31,205,classic yogurt,45,60,15,1,00140,India
828828,2023-08-31,201,paneer,210,340,130,1,00267,India
776884,2023-08-31,207,coca cola,75,100,25,1,00180,India
476520,2023-08-31,211,red bull,90,125,35,1,00346,India
476520,2023-08-31,204,strawberry yogurt,50,60,10,1,00346,India
476520,2023-08-31,210,mountain dew,75,100,25,1,00346,India
476520,2023-08-31,205,classic yogurt,45,60,15,1,00346,India
377787,2023-08-31,204,strawberry yogurt,50,60,10,1,00204,India
377787,2023-08-31,207,coca cola,75,100,25,1,00204,India
377787,2023-08-31,206,yakult,360,400,40,1,00204,India
377787,2023-08-31,209,pepsi,75,100,25,1,00204,India
125900,2023-08-31,208,sprite,75,100,25,1,00228,India
125900,2023-08-31,211,red bull,90,125,35,1,00228,India
125900,2023-08-31,204,strawberry yogurt,50,60,10,1,00228,India
125900,2023-08-31,206,yakult,360,400,40,1,00228,India
125900,2023-08-31,203,mango yogurt,50,60,10,1,00228,India
350218,2023-08-31,209,pepsi,75,100,25,1,00137,India
350218,2023-08-31,206,yakult,360,400,40,1,00137,India
350218,2023-08-31,213,bisleri,6,15,9,1,00137,India
350218,2023-08-31,203,mango yogurt,50,60,10,1,00137,India
350218,2023-08-31,212,amul cheese,250,315,65,1,00137,India
716203,2023-08-31,207,coca cola,75,100,25,1,00133,India
716203,2023-08-31,203,mango yogurt,50,60,10,1,00133,India
716203,2023-08-31,204,strawberry yogurt,50,60,10,1,00133,India
716203,2023-08-31,206,yakult,360,400,40,1,00133,India
963267,2023-08-31,205,classic yogurt,45,60,15,1,00402,India
963267,2023-08-31,208,sprite,75,100,25,1,00402,India
963267,2023-08-31,210,mountain dew,75,100,25,1,00402,India
963267,2023-08-31,213,bisleri,6,15,9,1,00402,India
963267,2023-08-31,212,amul cheese,250,315,65,1,00402,India
462795,2023-08-31,207,coca cola,75,100,25,1,00210,India
462795,2023-08-31,212,amul cheese,250,315,65,1,00210,India
462795,2023-08-31,208,sprite,75,100,25,1,00210,India
334508,2023-08-31,201,paneer,210,340,130,1,00035,India
334508,2023-08-31,211,red bull,90,125,35,1,00035,India
959683,2023-08-31,210,mountain dew,75,100,25,1,00144,India
959683,2023-08-31,202,milk,12,27,15,1,00144,India
959683,2023-08-31,206,yakult,360,400,40,1,00144,India
959683,2023-08-31,204,strawberry yogurt,50,60,10,1,00144,India
790412,2023-08-31,207,coca cola,75,100,25,1,00302,India
790412,2023-08-31,212,amul cheese,250,315,65,1,00302,India
790412,2023-08-31,206,yakult,360,400,40,1,00302,India
908153,2023-08-31,205,classic yogurt,45,60,15,1,00458,India
908153,2023-08-31,207,coca cola,75,100,25,1,00458,India
908153,2023-08-31,213,bisleri,6,15,9,1,00458,India
710085,2023-08-31,203,mango yogurt,50,60,10,1,00260,India
710085,2023-08-31,205,classic yogurt,45,60,15,1,00260,India
710085,2023-08-31,204,strawberry yogurt,50,60,10,1,00260,India
710085,2023-08-31,213,bisleri,6,15,9,1,00260,India
907338,2023-08-31,206,yakult,360,400,40,1,00318,India
907338,2023-08-31,203,mango yogurt,50,60,10,1,00318,India
907338,2023-08-31,205,classic yogurt,45,60,15,1,00318,India
631294,2023-08-31,206,yakult,360,400,40,1,00009,India
631294,2023-08-31,208,sprite,75,100,25,1,00009,India
631294,2023-08-31,201,paneer,210,340,130,1,00009,India
631294,2023-08-31,205,classic yogurt,45,60,15,1,00009,India
631294,2023-08-31,203,mango yogurt,50,60,10,1,00009,India
481245,2023-08-31,213,bisleri,6,15,9,1,00399,India
711234,2023-08-31,206,yakult,360,400,40,1,00279,India
711234,2023-08-31,201,paneer,210,340,130,1,00279,India
904855,2023-08-31,209,pepsi,75,100,25,1,00033,India
904855,2023-08-31,208,sprite,75,100,25,1,00033,India
904855,2023-08-31,213,bisleri,6,15,9,1,00033,India
211607,2023-08-31,203,mango yogurt,50,60,10,1,00375,India
211607,2023-08-31,204,strawberry yogurt,50,60,10,1,00375,India
690831,2023-08-31,211,red bull,90,125,35,1,00439,India
690831,2023-08-31,213,bisleri,6,15,9,1,00439,India
690831,2023-08-31,206,yakult,360,400,40,1,00439,India
690831,2023-08-31,208,sprite,75,100,25,1,00439,India
720600,2023-08-31,213,bisleri,6,15,9,1,00351,India
720600,2023-08-31,204,strawberry yogurt,50,60,10,1,00351,India
720600,2023-08-31,206,yakult,360,400,40,1,00351,India
104491,2023-08-31,213,bisleri,6,15,9,1,00326,India
104491,2023-08-31,204,strawberry yogurt,50,60,10,1,00326,India
755702,2023-08-31,203,mango yogurt,50,60,10,1,00465,India
755702,2023-08-31,207,coca cola,75,100,25,1,00465,India
755702,2023-08-31,213,bisleri,6,15,9,1,00465,India
755702,2023-08-31,208,sprite,75,100,25,1,00465,India
755702,2023-08-31,202,milk,12,27,15,1,00465,India
843412,2023-08-31,207,coca cola,75,100,25,1,00436,India
843412,2023-08-31,204,strawberry yogurt,50,60,10,1,00436,India
843412,2023-08-31,206,yakult,360,400,40,1,00436,India
843412,2023-08-31,211,red bull,90,125,35,1,00436,India
361492,2023-08-31,207,coca cola,75,100,25,1,00025,India
361492,2023-08-31,201,paneer,210,340,130,1,00025,India
699412,2023-08-31,212,amul cheese,250,315,65,1,00183,India
699412,2023-08-31,203,mango yogurt,50,60,10,1,00183,India
699412,2023-08-31,201,paneer,210,340,130,1,00183,India
699412,2023-08-31,213,bisleri,6,15,9,1,00183,India
699412,2023-08-31,209,pepsi,75,100,25,1,00183,India
808504,2023-08-31,208,sprite,75,100,25,1,00410,India
808504,2023-08-31,202,milk,12,27,15,1,00410,India
808504,2023-08-31,204,strawberry yogurt,50,60,10,1,00410,India
808504,2023-08-31,207,coca cola,75,100,25,1,00410,India
967521,2023-08-31,202,milk,12,27,15,1,00386,India
967521,2023-08-31,206,yakult,360,400,40,1,00386,India
967521,2023-08-31,207,coca cola,75,100,25,1,00386,India
908002,2023-08-31,203,mango yogurt,50,60,10,1,00281,India
908002,2023-08-31,202,milk,12,27,15,1,00281,India
908002,2023-08-31,212,amul cheese,250,315,65,1,00281,India
908002,2023-08-31,205,classic yogurt,45,60,15,1,00281,India
639060,2023-08-31,209,pepsi,75,100,25,1,00119,India
639060,2023-08-31,203,mango yogurt,50,60,10,1,00119,India
719639,2023-08-31,210,mountain dew,75,100,25,1,00310,India
719639,2023-08-31,211,red bull,90,125,35,1,00310,India
719639,2023-08-31,201,paneer,210,340,130,1,00310,India
331855,2023-08-31,207,coca cola,75,100,25,1,00072,India
331855,2023-08-31,204,strawberry yogurt,50,60,10,1,00072,India
527545,2023-08-31,201,paneer,210,340,130,1,00206,India
527545,2023-08-31,206,yakult,360,400,40,1,00206,India
527545,2023-08-31,210,mountain dew,75,100,25,1,00206,India
530508,2023-08-31,204,strawberry yogurt,50,60,10,1,00315,India
530508,2023-08-31,206,yakult,360,400,40,1,00315,India
125146,2023-08-31,202,milk,12,27,15,1,00335,India
125146,2023-08-31,206,yakult,360,400,40,1,00335,India
125146,2023-08-31,210,mountain dew,75,100,25,1,00335,India
508220,2023-08-31,212,amul cheese,250,315,65,1,00398,India
508220,2023-08-31,204,strawberry yogurt,50,60,10,1,00398,India
508220,2023-08-31,205,classic yogurt,45,60,15,1,00398,India
569524,2023-08-31,209,pepsi,75,100,25,1,00193,India
569524,2023-08-31,208,sprite,75,100,25,1,00193,India
569524,2023-08-31,203,mango yogurt,50,60,10,1,00193,India
395370,2023-08-31,212,amul cheese,250,315,65,1,00156,India
395370,2023-08-31,213,bisleri,6,15,9,1,00156,India
395370,2023-08-31,209,pepsi,75,100,25,1,00156,India
221693,2023-08-31,213,bisleri,6,15,9,1,00380,India
664786,2023-08-31,201,paneer,210,340,130,1,00079,India
561524,2023-08-31,207,coca cola,75,100,25,1,00428,India
561524,2023-08-31,204,strawberry yogurt,50,60,10,1,00428,India
554217,2023-08-31,203,mango yogurt,50,60,10,1,00021,India
554217,2023-08-31,209,pepsi,75,100,25,1,00021,India
725665,2023-08-31,203,mango yogurt,50,60,10,1,00376,India
725665,2023-08-31,205,classic yogurt,45,60,15,1,00376,India
725665,2023-08-31,213,bisleri,6,15,9,1,00376,India
725665,2023-08-31,211,red bull,90,125,35,1,00376,India
725665,2023-08-31,204,strawberry yogurt,50,60,10,1,00376,India
843091,2023-08-31,202,milk,12,27,15,1,00300,India
829171,2023-08-31,208,sprite,75,100,25,1,00029,India
829171,2023-08-31,209,pepsi,75,100,25,1,00029,India
829171,2023-08-31,210,mountain dew,75,100,25,1,00029,India
829171,2023-08-31,207,coca cola,75,100,25,1,00029,India
613592,2023-08-31,210,mountain dew,75,100,25,1,00356,India
613592,2023-08-31,211,red bull,90,125,35,1,00356,India
994439,2023-08-31,205,classic yogurt,45,60,15,1,00460,India
581422,2023-08-31,201,paneer,210,340,130,1,00343,India
581422,2023-08-31,210,mountain dew,75,100,25,1,00343,India
555502,2023-08-31,213,bisleri,6,15,9,1,00223,India
555502,2023-08-31,203,mango yogurt,50,60,10,1,00223,India
594286,2023-08-31,213,bisleri,6,15,9,1,00076,India
741770,2023-08-31,212,amul cheese,250,315,65,1,00268,India
741770,2023-08-31,205,classic yogurt,45,60,15,1,00268,India
741770,2023-08-31,202,milk,12,27,15,1,00268,India
200835,2023-08-31,201,paneer,210,340,130,1,00101,India
200835,2023-08-31,210,mountain dew,75,100,25,1,00101,India
200835,2023-08-31,203,mango yogurt,50,60,10,1,00101,India
286334,2023-08-31,203,mango yogurt,50,60,10,1,00417,India
286334,2023-08-31,202,milk,12,27,15,1,00417,India
286334,2023-08-31,212,amul cheese,250,315,65,1,00417,India
286334,2023-08-31,206,yakult,360,400,40,1,00417,India
922876,2023-08-31,207,coca cola,75,100,25,1,00392,India
922876,2023-08-31,213,bisleri,6,15,9,1,00392,India
922876,2023-08-31,211,red bull,90,125,35,1,00392,India
539809,2023-08-31,211,red bull,90,125,35,1,00131,India
539809,2023-08-31,202,milk,12,27,15,1,00131,India
703727,2023-08-31,212,amul cheese,250,315,65,1,00379,India
568822,2023-08-31,206,yakult,360,400,40,1,00154,India
568822,2023-08-31,201,paneer,210,340,130,1,00154,India
352695,2023-08-31,202,milk,12,27,15,1,00394,India
858659,2023-08-31,201,paneer,210,340,130,1,00030,India
858659,2023-08-31,204,strawberry yogurt,50,60,10,1,00030,India
858659,2023-08-31,205,classic yogurt,45,60,15,1,00030,India
858659,2023-08-31,213,bisleri,6,15,9,1,00030,India
795718,2023-08-31,208,sprite,75,100,25,1,00087,India
795718,2023-08-31,212,amul cheese,250,315,65,1,00087,India
410231,2023-08-31,213,bisleri,6,15,9,1,00488,India
410231,2023-08-31,208,sprite,75,100,25,1,00488,India
686439,2023-08-31,213,bisleri,6,15,9,1,00066,India
686439,2023-08-31,211,red bull,90,125,35,1,00066,India
686439,2023-08-31,204,strawberry yogurt,50,60,10,1,00066,India
686439,2023-08-31,205,classic yogurt,45,60,15,1,00066,India
686439,2023-08-31,203,mango yogurt,50,60,10,1,00066,India
385159,2023-08-31,211,red bull,90,125,35,1,00434,India
310979,2023-08-31,204,strawberry yogurt,50,60,10,1,00096,India
465284,2023-08-31,204,strawberry yogurt,50,60,10,1,00286,India
465284,2023-08-31,212,amul cheese,250,315,65,1,00286,India
409866,2023-08-31,210,mountain dew,75,100,25,1,00081,India
409866,2023-08-31,204,strawberry yogurt,50,60,10,1,00081,India
409866,2023-08-31,211,red bull,90,125,35,1,00081,India
536048,2023-08-31,205,classic yogurt,45,60,15,1,00083,India
536048,2023-08-31,204,strawberry yogurt,50,60,10,1,00083,India
536048,2023-08-31,213,bisleri,6,15,9,1,00083,India
467257,2023-08-31,211,red bull,90,125,35,1,00149,India
507361,2023-08-31,206,yakult,360,400,40,1,00266,India
507361,2023-08-31,212,amul cheese,250,315,65,1,00266,India
507361,2023-08-31,205,classic yogurt,45,60,15,1,00266,India
171712,2023-08-31,204,strawberry yogurt,50,60,10,1,00483,India
960581,2023-08-31,207,coca cola,75,100,25,1,00164,India
960581,2023-08-31,211,red bull,90,125,35,1,00164,India
960581,2023-08-31,209,pepsi,75,100,25,1,00164,India
960581,2023-08-31,206,yakult,360,400,40,1,00164,India
960581,2023-08-31,205,classic yogurt,45,60,15,1,00164,India
344350,2023-08-31,211,red bull,90,125,35,1,00323,India
344350,2023-08-31,213,bisleri,6,15,9,1,00323,India
344350,2023-08-31,207,coca cola,75,100,25,1,00323,India
956406,2023-08-31,209,pepsi,75,100,25,1,00064,India
956406,2023-08-31,208,sprite,75,100,25,1,00064,India
956406,2023-08-31,201,paneer,210,340,130,1,00064,India
956406,2023-08-31,207,coca cola,75,100,25,1,00064,India
241194,2023-08-31,208,sprite,75,100,25,1,00239,India
241194,2023-08-31,201,paneer,210,340,130,1,00239,India
241194,2023-08-31,206,yakult,360,400,40,1,00239,India
241194,2023-08-31,205,classic yogurt,45,60,15,1,00239,India
158328,2023-08-31,203,mango yogurt,50,60,10,1,00497,India
708404,2023-08-31,213,bisleri,6,15,9,1,00025,India
708404,2023-08-31,202,milk,12,27,15,1,00025,India
106717,2023-08-31,201,paneer,210,340,130,1,00489,India
106717,2023-08-31,211,red bull,90,125,35,1,00489,India
106717,2023-08-31,207,coca cola,75,100,25,1,00489,India
106717,2023-08-31,210,mountain dew,75,100,25,1,00489,India
141113,2023-08-31,202,milk,12,27,15,1,00099,India
141113,2023-08-31,212,amul cheese,250,315,65,1,00099,India
156528,2023-08-31,204,strawberry yogurt,50,60,10,1,00222,India
156528,2023-08-31,207,coca cola,75,100,25,1,00222,India
156528,2023-08-31,210,mountain dew,75,100,25,1,00222,India
156528,2023-08-31,212,amul cheese,250,315,65,1,00222,India
578257,2023-08-31,213,bisleri,6,15,9,1,00381,India
578257,2023-08-31,207,coca cola,75,100,25,1,00381,India
906144,2023-09-01,210,mountain dew,75,100,25,1,00222,India
672027,2023-09-01,208,sprite,75,100,25,1,00032,India
672027,2023-09-01,209,pepsi,75,100,25,1,00032,India
672027,2023-09-01,206,yakult,360,400,40,1,00032,India
420229,2023-09-01,209,pepsi,75,100,25,1,00316,India
420229,2023-09-01,201,paneer,210,340,130,1,00316,India
420229,2023-09-01,210,mountain dew,75,100,25,1,00316,India
390348,2023-09-01,213,bisleri,6,15,9,1,00321,India
390348,2023-09-01,202,milk,12,27,15,1,00321,India
390348,2023-09-01,204,strawberry yogurt,50,60,10,1,00321,India
390348,2023-09-01,208,sprite,75,100,25,1,00321,India
114662,2023-09-01,202,milk,12,27,15,1,00349,India
114662,2023-09-01,208,sprite,75,100,25,1,00349,India
114662,2023-09-01,211,red bull,90,125,35,1,00349,India
114662,2023-09-01,201,paneer,210,340,130,1,00349,India
114662,2023-09-01,209,pepsi,75,100,25,1,00349,India
582470,2023-09-01,205,classic yogurt,45,60,15,1,00200,India
582470,2023-09-01,206,yakult,360,400,40,1,00200,India
817767,2023-09-01,202,milk,12,27,15,1,00120,India
817767,2023-09-01,210,mountain dew,75,100,25,1,00120,India
192973,2023-09-01,213,bisleri,6,15,9,1,00239,India
192973,2023-09-01,206,yakult,360,400,40,1,00239,India
192973,2023-09-01,204,strawberry yogurt,50,60,10,1,00239,India
192973,2023-09-01,203,mango yogurt,50,60,10,1,00239,India
786711,2023-09-01,204,strawberry yogurt,50,60,10,1,00475,India
786711,2023-09-01,211,red bull,90,125,35,1,00475,India
786711,2023-09-01,207,coca cola,75,100,25,1,00475,India
786711,2023-09-01,201,paneer,210,340,130,1,00475,India
300423,2023-09-01,209,pepsi,75,100,25,1,00298,India
462566,2023-09-01,210,mountain dew,75,100,25,1,00376,India
462566,2023-09-01,209,pepsi,75,100,25,1,00376,India
462566,2023-09-01,201,paneer,210,340,130,1,00376,India
322744,2023-09-01,213,bisleri,6,15,9,1,00168,India
322744,2023-09-01,209,pepsi,75,100,25,1,00168,India
322744,2023-09-01,204,strawberry yogurt,50,60,10,1,00168,India
322744,2023-09-01,211,red bull,90,125,35,1,00168,India
266510,2023-09-01,209,pepsi,75,100,25,1,00384,India
983326,2023-09-01,213,bisleri,6,15,9,1,00378,India
983326,2023-09-01,203,mango yogurt,50,60,10,1,00378,India
983326,2023-09-01,209,pepsi,75,100,25,1,00378,India
983326,2023-09-01,206,yakult,360,400,40,1,00378,India
452045,2023-09-01,210,mountain dew,75,100,25,1,00237,India
452045,2023-09-01,202,milk,12,27,15,1,00237,India
452045,2023-09-01,205,classic yogurt,45,60,15,1,00237,India
452045,2023-09-01,209,pepsi,75,100,25,1,00237,India
965069,2023-09-01,207,coca cola,75,100,25,1,00325,India
965069,2023-09-01,202,milk,12,27,15,1,00325,India
965069,2023-09-01,201,paneer,210,340,130,1,00325,India
495725,2023-09-01,213,bisleri,6,15,9,1,00309,India
495725,2023-09-01,203,mango yogurt,50,60,10,1,00309,India
495725,2023-09-01,212,amul cheese,250,315,65,1,00309,India
163951,2023-09-01,201,paneer,210,340,130,1,00400,India
734788,2023-09-01,206,yakult,360,400,40,1,00248,India
528019,2023-09-01,205,classic yogurt,45,60,15,1,00338,India
528019,2023-09-01,207,coca cola,75,100,25,1,00338,India
528019,2023-09-01,206,yakult,360,400,40,1,00338,India
528019,2023-09-01,202,milk,12,27,15,1,00338,India
362745,2023-09-01,203,mango yogurt,50,60,10,1,00041,India
362745,2023-09-01,207,coca cola,75,100,25,1,00041,India
767268,2023-09-01,209,pepsi,75,100,25,1,00305,India
767268,2023-09-01,211,red bull,90,125,35,1,00305,India
767268,2023-09-01,208,sprite,75,100,25,1,00305,India
767268,2023-09-01,206,yakult,360,400,40,1,00305,India
767268,2023-09-01,210,mountain dew,75,100,25,1,00305,India
553450,2023-09-01,213,bisleri,6,15,9,1,00054,India
553450,2023-09-01,209,pepsi,75,100,25,1,00054,India
553450,2023-09-01,211,red bull,90,125,35,1,00054,India
553450,2023-09-01,208,sprite,75,100,25,1,00054,India
123037,2023-09-01,207,coca cola,75,100,25,1,00022,India
741369,2023-09-01,205,classic yogurt,45,60,15,1,00371,India
966716,2023-09-01,202,milk,12,27,15,1,00420,India
966716,2023-09-01,209,pepsi,75,100,25,1,00420,India
299660,2023-09-01,204,strawberry yogurt,50,60,10,1,00197,India
299660,2023-09-01,208,sprite,75,100,25,1,00197,India
299660,2023-09-01,206,yakult,360,400,40,1,00197,India
737248,2023-09-01,203,mango yogurt,50,60,10,1,00143,India
456340,2023-09-01,209,pepsi,75,100,25,1,00480,India
456340,2023-09-01,204,strawberry yogurt,50,60,10,1,00480,India
442396,2023-09-01,203,mango yogurt,50,60,10,1,00420,India
442396,2023-09-01,202,milk,12,27,15,1,00420,India
995639,2023-09-01,209,pepsi,75,100,25,1,00354,India
254240,2023-09-01,202,milk,12,27,15,1,00348,India
457717,2023-09-01,209,pepsi,75,100,25,1,00299,India
457717,2023-09-01,213,bisleri,6,15,9,1,00299,India
457717,2023-09-01,212,amul cheese,250,315,65,1,00299,India
457717,2023-09-01,201,paneer,210,340,130,1,00299,India
451269,2023-09-01,206,yakult,360,400,40,1,00187,India
451269,2023-09-01,211,red bull,90,125,35,1,00187,India
451269,2023-09-01,207,coca cola,75,100,25,1,00187,India
451269,2023-09-01,202,milk,12,27,15,1,00187,India
451269,2023-09-01,209,pepsi,75,100,25,1,00187,India
281809,2023-09-01,212,amul cheese,250,315,65,1,00288,India
281809,2023-09-01,213,bisleri,6,15,9,1,00288,India
281809,2023-09-01,203,mango yogurt,50,60,10,1,00288,India
266648,2023-09-01,206,yakult,360,400,40,1,00211,India
266648,2023-09-01,201,paneer,210,340,130,1,00211,India
266648,2023-09-01,208,sprite,75,100,25,1,00211,India
266648,2023-09-01,202,milk,12,27,15,1,00211,India
266648,2023-09-01,207,coca cola,75,100,25,1,00211,India
838521,2023-09-01,201,paneer,210,340,130,1,00134,India
782736,2023-09-01,206,yakult,360,400,40,1,00229,India
374110,2023-09-01,201,paneer,210,340,130,1,00448,India
374110,2023-09-01,210,mountain dew,75,100,25,1,00448,India
225661,2023-09-01,204,strawberry yogurt,50,60,10,1,00053,India
225661,2023-09-01,209,pepsi,75,100,25,1,00053,India
225661,2023-09-01,212,amul cheese,250,315,65,1,00053,India
536662,2023-09-01,210,mountain dew,75,100,25,1,00226,India
536662,2023-09-01,209,pepsi,75,100,25,1,00226,India
536662,2023-09-01,207,coca cola,75,100,25,1,00226,India
536662,2023-09-01,204,strawberry yogurt,50,60,10,1,00226,India
324601,2023-09-01,205,classic yogurt,45,60,15,1,00281,India
324601,2023-09-01,204,strawberry yogurt,50,60,10,1,00281,India
656200,2023-09-01,211,red bull,90,125,35,1,00003,India
307312,2023-09-01,208,sprite,75,100,25,1,00256,India
307312,2023-09-01,205,classic yogurt,45,60,15,1,00256,India
307312,2023-09-01,202,milk,12,27,15,1,00256,India
352233,2023-09-01,208,sprite,75,100,25,1,00492,India
679216,2023-09-01,202,milk,12,27,15,1,00244,India
679216,2023-09-01,211,red bull,90,125,35,1,00244,India
816597,2023-09-01,203,mango yogurt,50,60,10,1,00038,India
816597,2023-09-01,211,red bull,90,125,35,1,00038,India
816597,2023-09-01,212,amul cheese,250,315,65,1,00038,India
816597,2023-09-01,202,milk,12,27,15,1,00038,India
465916,2023-09-01,202,milk,12,27,15,1,00270,India
465916,2023-09-01,212,amul cheese,250,315,65,1,00270,India
465916,2023-09-01,208,sprite,75,100,25,1,00270,India
465916,2023-09-01,203,mango yogurt,50,60,10,1,00270,India
965170,2023-09-01,206,yakult,360,400,40,1,00194,India
462989,2023-09-01,212,amul cheese,250,315,65,1,00496,India
462989,2023-09-01,204,strawberry yogurt,50,60,10,1,00496,India
161498,2023-09-02,211,red bull,90,125,35,1,00429,India
798216,2023-09-02,201,paneer,210,340,130,1,00339,India
798216,2023-09-02,205,classic yogurt,45,60,15,1,00339,India
798216,2023-09-02,206,yakult,360,400,40,1,00339,India
798216,2023-09-02,211,red bull,90,125,35,1,00339,India
634093,2023-09-02,209,pepsi,75,100,25,1,00286,India
753748,2023-09-02,201,paneer,210,340,130,1,00376,India
753748,2023-09-02,204,strawberry yogurt,50,60,10,1,00376,India
753748,2023-09-02,206,yakult,360,400,40,1,00376,India
338135,2023-09-02,203,mango yogurt,50,60,10,1,00469,India
338135,2023-09-02,206,yakult,360,400,40,1,00469,India
338135,2023-09-02,202,milk,12,27,15,1,00469,India
589941,2023-09-02,213,bisleri,6,15,9,1,00307,India
589941,2023-09-02,211,red bull,90,125,35,1,00307,India
589941,2023-09-02,210,mountain dew,75,100,25,1,00307,India
589941,2023-09-02,202,milk,12,27,15,1,00307,India
282861,2023-09-02,213,bisleri,6,15,9,1,00066,India
282861,2023-09-02,210,mountain dew,75,100,25,1,00066,India
282861,2023-09-02,203,mango yogurt,50,60,10,1,00066,India
282861,2023-09-02,209,pepsi,75,100,25,1,00066,India
282861,2023-09-02,202,milk,12,27,15,1,00066,India
771334,2023-09-02,209,pepsi,75,100,25,1,00138,India
771334,2023-09-02,210,mountain dew,75,100,25,1,00138,India
771334,2023-09-02,203,mango yogurt,50,60,10,1,00138,India
877743,2023-09-02,213,bisleri,6,15,9,1,00201,India
877743,2023-09-02,203,mango yogurt,50,60,10,1,00201,India
877743,2023-09-02,212,amul cheese,250,315,65,1,00201,India
877743,2023-09-02,204,strawberry yogurt,50,60,10,1,00201,India
877743,2023-09-02,206,yakult,360,400,40,1,00201,India
322280,2023-09-02,203,mango yogurt,50,60,10,1,00359,India
322280,2023-09-02,212,amul cheese,250,315,65,1,00359,India
322280,2023-09-02,207,coca cola,75,100,25,1,00359,India
322280,2023-09-02,204,strawberry yogurt,50,60,10,1,00359,India
322280,2023-09-02,211,red bull,90,125,35,1,00359,India
586835,2023-09-02,205,classic yogurt,45,60,15,1,00473,India
299823,2023-09-02,212,amul cheese,250,315,65,1,00259,India
299823,2023-09-02,204,strawberry yogurt,50,60,10,1,00259,India
299823,2023-09-02,210,mountain dew,75,100,25,1,00259,India
667871,2023-09-02,209,pepsi,75,100,25,1,00448,India
667871,2023-09-02,212,amul cheese,250,315,65,1,00448,India
667871,2023-09-02,202,milk,12,27,15,1,00448,India
511190,2023-09-02,207,coca cola,75,100,25,1,00405,India
511190,2023-09-02,208,sprite,75,100,25,1,00405,India
511190,2023-09-02,209,pepsi,75,100,25,1,00405,India
863273,2023-09-02,213,bisleri,6,15,9,1,00251,India
863273,2023-09-02,204,strawberry yogurt,50,60,10,1,00251,India
799640,2023-09-02,209,pepsi,75,100,25,1,00424,India
799640,2023-09-02,213,bisleri,6,15,9,1,00424,India
799640,2023-09-02,204,strawberry yogurt,50,60,10,1,00424,India
780032,2023-09-02,204,strawberry yogurt,50,60,10,1,00022,India
780032,2023-09-02,202,milk,12,27,15,1,00022,India
780032,2023-09-02,205,classic yogurt,45,60,15,1,00022,India
538052,2023-09-02,213,bisleri,6,15,9,1,00266,India
538052,2023-09-02,201,paneer,210,340,130,1,00266,India
538052,2023-09-02,207,coca cola,75,100,25,1,00266,India
538052,2023-09-02,212,amul cheese,250,315,65,1,00266,India
210588,2023-09-02,205,classic yogurt,45,60,15,1,00046,India
774752,2023-09-02,202,milk,12,27,15,1,00031,India
774752,2023-09-02,209,pepsi,75,100,25,1,00031,India
774752,2023-09-02,211,red bull,90,125,35,1,00031,India
969956,2023-09-02,210,mountain dew,75,100,25,1,00451,India
969956,2023-09-02,209,pepsi,75,100,25,1,00451,India
969956,2023-09-02,208,sprite,75,100,25,1,00451,India
520030,2023-09-02,204,strawberry yogurt,50,60,10,1,00206,India
520030,2023-09-02,207,coca cola,75,100,25,1,00206,India
520030,2023-09-02,212,amul cheese,250,315,65,1,00206,India
410828,2023-09-02,212,amul cheese,250,315,65,1,00019,India
410828,2023-09-02,202,milk,12,27,15,1,00019,India
410828,2023-09-02,205,classic yogurt,45,60,15,1,00019,India
471312,2023-09-02,211,red bull,90,125,35,1,00083,India
471312,2023-09-02,213,bisleri,6,15,9,1,00083,India
647783,2023-09-02,202,milk,12,27,15,1,00090,India
647783,2023-09-02,211,red bull,90,125,35,1,00090,India
647783,2023-09-02,201,paneer,210,340,130,1,00090,India
673312,2023-09-02,212,amul cheese,250,315,65,1,00156,India
673312,2023-09-02,201,paneer,210,340,130,1,00156,India
673312,2023-09-02,207,coca cola,75,100,25,1,00156,India
334767,2023-09-02,206,yakult,360,400,40,1,00139,India
334767,2023-09-02,210,mountain dew,75,100,25,1,00139,India
334767,2023-09-02,212,amul cheese,250,315,65,1,00139,India
334767,2023-09-02,207,coca cola,75,100,25,1,00139,India
744561,2023-09-02,211,red bull,90,125,35,1,00007,India
744561,2023-09-02,210,mountain dew,75,100,25,1,00007,India
744561,2023-09-02,213,bisleri,6,15,9,1,00007,India
744561,2023-09-02,212,amul cheese,250,315,65,1,00007,India
137921,2023-09-02,205,classic yogurt,45,60,15,1,00460,India
137921,2023-09-02,202,milk,12,27,15,1,00460,India
137921,2023-09-02,212,amul cheese,250,315,65,1,00460,India
137921,2023-09-02,213,bisleri,6,15,9,1,00460,India
759639,2023-09-02,205,classic yogurt,45,60,15,1,00060,India
759639,2023-09-02,207,coca cola,75,100,25,1,00060,India
759639,2023-09-02,201,paneer,210,340,130,1,00060,India
759639,2023-09-02,209,pepsi,75,100,25,1,00060,India
767147,2023-09-02,210,mountain dew,75,100,25,1,00168,India
767147,2023-09-02,202,milk,12,27,15,1,00168,India
767147,2023-09-02,205,classic yogurt,45,60,15,1,00168,India
767147,2023-09-02,213,bisleri,6,15,9,1,00168,India
214929,2023-09-02,211,red bull,90,125,35,1,00481,India
214929,2023-09-02,209,pepsi,75,100,25,1,00481,India
214929,2023-09-02,208,sprite,75,100,25,1,00481,India
684484,2023-09-02,203,mango yogurt,50,60,10,1,00064,India
684484,2023-09-02,205,classic yogurt,45,60,15,1,00064,India
684484,2023-09-02,206,yakult,360,400,40,1,00064,India
684484,2023-09-02,213,bisleri,6,15,9,1,00064,India
684484,2023-09-02,208,sprite,75,100,25,1,00064,India
902087,2023-09-02,201,paneer,210,340,130,1,00496,India
902087,2023-09-02,205,classic yogurt,45,60,15,1,00496,India
902087,2023-09-02,202,milk,12,27,15,1,00496,India
902087,2023-09-02,212,amul cheese,250,315,65,1,00496,India
827907,2023-09-02,204,strawberry yogurt,50,60,10,1,00186,India
827907,2023-09-02,211,red bull,90,125,35,1,00186,India
234369,2023-09-02,210,mountain dew,75,100,25,1,00286,India
234369,2023-09-02,202,milk,12,27,15,1,00286,India
234369,2023-09-02,204,strawberry yogurt,50,60,10,1,00286,India
887674,2023-09-02,209,pepsi,75,100,25,1,00404,India
887674,2023-09-02,201,paneer,210,340,130,1,00404,India
887674,2023-09-02,213,bisleri,6,15,9,1,00404,India
864851,2023-09-02,203,mango yogurt,50,60,10,1,00458,India
864851,2023-09-02,210,mountain dew,75,100,25,1,00458,India
460017,2023-09-02,213,bisleri,6,15,9,1,00176,India
460017,2023-09-02,202,milk,12,27,15,1,00176,India
460017,2023-09-02,206,yakult,360,400,40,1,00176,India
483801,2023-09-02,211,red bull,90,125,35,1,00205,India
483801,2023-09-02,201,paneer,210,340,130,1,00205,India
350263,2023-09-02,204,strawberry yogurt,50,60,10,1,00199,India
350263,2023-09-02,207,coca cola,75,100,25,1,00199,India
805751,2023-09-02,203,mango yogurt,50,60,10,1,00322,India
805751,2023-09-02,212,amul cheese,250,315,65,1,00322,India
805751,2023-09-02,204,strawberry yogurt,50,60,10,1,00322,India
805751,2023-09-02,205,classic yogurt,45,60,15,1,00322,India
129512,2023-09-02,202,milk,12,27,15,1,00135,India
122208,2023-09-02,205,classic yogurt,45,60,15,1,00433,India
122208,2023-09-02,204,strawberry yogurt,50,60,10,1,00433,India
122208,2023-09-02,208,sprite,75,100,25,1,00433,India
122208,2023-09-02,212,amul cheese,250,315,65,1,00433,India
122208,2023-09-02,203,mango yogurt,50,60,10,1,00433,India
368924,2023-09-02,208,sprite,75,100,25,1,00384,India
875426,2023-09-02,205,classic yogurt,45,60,15,1,00346,India
517144,2023-09-02,213,bisleri,6,15,9,1,00291,India
517144,2023-09-02,201,paneer,210,340,130,1,00291,India
517144,2023-09-02,205,classic yogurt,45,60,15,1,00291,India
517144,2023-09-02,212,amul cheese,250,315,65,1,00291,India
651479,2023-09-02,211,red bull,90,125,35,1,00121,India
651479,2023-09-02,204,strawberry yogurt,50,60,10,1,00121,India
651479,2023-09-02,212,amul cheese,250,315,65,1,00121,India
651479,2023-09-02,203,mango yogurt,50,60,10,1,00121,India
739851,2023-09-02,208,sprite,75,100,25,1,00254,India
739851,2023-09-02,207,coca cola,75,100,25,1,00254,India
616284,2023-09-02,204,strawberry yogurt,50,60,10,1,00222,India
494058,2023-09-02,208,sprite,75,100,25,1,00190,India
494058,2023-09-02,205,classic yogurt,45,60,15,1,00190,India
494058,2023-09-02,211,red bull,90,125,35,1,00190,India
494058,2023-09-02,202,milk,12,27,15,1,00190,India
494058,2023-09-02,201,paneer,210,340,130,1,00190,India
183117,2023-09-02,205,classic yogurt,45,60,15,1,00363,India
183117,2023-09-02,211,red bull,90,125,35,1,00363,India
474036,2023-09-02,206,yakult,360,400,40,1,00364,India
474036,2023-09-02,208,sprite,75,100,25,1,00364,India
474036,2023-09-02,207,coca cola,75,100,25,1,00364,India
474036,2023-09-02,202,milk,12,27,15,1,00364,India
491641,2023-09-02,201,paneer,210,340,130,1,00326,India
101085,2023-09-02,201,paneer,210,340,130,1,00490,India
101085,2023-09-02,211,red bull,90,125,35,1,00490,India
227346,2023-09-02,205,classic yogurt,45,60,15,1,00007,India
227346,2023-09-02,211,red bull,90,125,35,1,00007,India
227346,2023-09-02,208,sprite,75,100,25,1,00007,India
227346,2023-09-02,210,mountain dew,75,100,25,1,00007,India
227346,2023-09-02,203,mango yogurt,50,60,10,1,00007,India
490417,2023-09-02,207,coca cola,75,100,25,1,00178,India
490417,2023-09-02,205,classic yogurt,45,60,15,1,00178,India
288696,2023-09-02,204,strawberry yogurt,50,60,10,1,00200,India
576746,2023-09-02,210,mountain dew,75,100,25,1,00097,India
576746,2023-09-02,211,red bull,90,125,35,1,00097,India
576746,2023-09-02,201,paneer,210,340,130,1,00097,India
482010,2023-09-02,202,milk,12,27,15,1,00042,India
605630,2023-09-02,201,paneer,210,340,130,1,00204,India
605630,2023-09-02,203,mango yogurt,50,60,10,1,00204,India
605630,2023-09-02,204,strawberry yogurt,50,60,10,1,00204,India
801785,2023-09-02,208,sprite,75,100,25,1,00041,India
801785,2023-09-02,205,classic yogurt,45,60,15,1,00041,India
801785,2023-09-02,209,pepsi,75,100,25,1,00041,India
794062,2023-09-02,204,strawberry yogurt,50,60,10,1,00345,India
842932,2023-09-02,202,milk,12,27,15,1,00303,India
339090,2023-09-02,209,pepsi,75,100,25,1,00221,India
339090,2023-09-02,205,classic yogurt,45,60,15,1,00221,India
337460,2023-09-02,207,coca cola,75,100,25,1,00489,India
337460,2023-09-02,210,mountain dew,75,100,25,1,00489,India
337460,2023-09-02,205,classic yogurt,45,60,15,1,00489,India
928709,2023-09-02,201,paneer,210,340,130,1,00318,India
928709,2023-09-02,213,bisleri,6,15,9,1,00318,India
928709,2023-09-02,209,pepsi,75,100,25,1,00318,India
891227,2023-09-02,202,milk,12,27,15,1,00019,India
891227,2023-09-02,210,mountain dew,75,100,25,1,00019,India
891227,2023-09-02,211,red bull,90,125,35,1,00019,India
357035,2023-09-02,204,strawberry yogurt,50,60,10,1,00122,India
357035,2023-09-02,212,amul cheese,250,315,65,1,00122,India
314300,2023-09-02,206,yakult,360,400,40,1,00305,India
314300,2023-09-02,212,amul cheese,250,315,65,1,00305,India
580971,2023-09-02,203,mango yogurt,50,60,10,1,00205,India
580971,2023-09-02,202,milk,12,27,15,1,00205,India
580971,2023-09-02,213,bisleri,6,15,9,1,00205,India
632165,2023-09-02,204,strawberry yogurt,50,60,10,1,00409,India
632165,2023-09-02,213,bisleri,6,15,9,1,00409,India
632165,2023-09-02,212,amul cheese,250,315,65,1,00409,India
632165,2023-09-02,208,sprite,75,100,25,1,00409,India
626271,2023-09-02,205,classic yogurt,45,60,15,1,00186,India
626271,2023-09-02,203,mango yogurt,50,60,10,1,00186,India
626271,2023-09-02,212,amul cheese,250,315,65,1,00186,India
626271,2023-09-02,206,yakult,360,400,40,1,00186,India
626271,2023-09-02,202,milk,12,27,15,1,00186,India
136423,2023-09-02,207,coca cola,75,100,25,1,00365,India
136423,2023-09-02,204,strawberry yogurt,50,60,10,1,00365,India
136423,2023-09-02,202,milk,12,27,15,1,00365,India
898436,2023-09-02,204,strawberry yogurt,50,60,10,1,00045,India
898436,2023-09-02,209,pepsi,75,100,25,1,00045,India
914731,2023-09-02,209,pepsi,75,100,25,1,00488,India
914731,2023-09-02,213,bisleri,6,15,9,1,00488,India
914731,2023-09-02,202,milk,12,27,15,1,00488,India
100558,2023-09-02,202,milk,12,27,15,1,00314,India
100558,2023-09-02,209,pepsi,75,100,25,1,00314,India
100558,2023-09-02,206,yakult,360,400,40,1,00314,India
100558,2023-09-02,210,mountain dew,75,100,25,1,00314,India
100558,2023-09-02,201,paneer,210,340,130,1,00314,India
496791,2023-09-02,205,classic yogurt,45,60,15,1,00370,India
496791,2023-09-02,213,bisleri,6,15,9,1,00370,India
711106,2023-09-02,203,mango yogurt,50,60,10,1,00406,India
631607,2023-09-02,212,amul cheese,250,315,65,1,00007,India
631607,2023-09-02,201,paneer,210,340,130,1,00007,India
244338,2023-09-02,208,sprite,75,100,25,1,00084,India
244338,2023-09-02,209,pepsi,75,100,25,1,00084,India
244338,2023-09-02,201,paneer,210,340,130,1,00084,India
244338,2023-09-02,212,amul cheese,250,315,65,1,00084,India
170331,2023-09-02,205,classic yogurt,45,60,15,1,00001,India
170331,2023-09-02,212,amul cheese,250,315,65,1,00001,India
170331,2023-09-02,206,yakult,360,400,40,1,00001,India
987346,2023-09-02,203,mango yogurt,50,60,10,1,00094,India
987346,2023-09-02,208,sprite,75,100,25,1,00094,India
987346,2023-09-02,205,classic yogurt,45,60,15,1,00094,India
987346,2023-09-02,206,yakult,360,400,40,1,00094,India
614423,2023-09-02,202,milk,12,27,15,1,00127,India
614423,2023-09-02,205,classic yogurt,45,60,15,1,00127,India
614423,2023-09-02,211,red bull,90,125,35,1,00127,India
614423,2023-09-02,203,mango yogurt,50,60,10,1,00127,India
337359,2023-09-02,207,coca cola,75,100,25,1,00489,India
337359,2023-09-02,201,paneer,210,340,130,1,00489,India
337359,2023-09-02,206,yakult,360,400,40,1,00489,India
337359,2023-09-02,212,amul cheese,250,315,65,1,00489,India
454007,2023-09-02,211,red bull,90,125,35,1,00340,India
454007,2023-09-02,206,yakult,360,400,40,1,00340,India
454007,2023-09-02,204,strawberry yogurt,50,60,10,1,00340,India
454007,2023-09-02,203,mango yogurt,50,60,10,1,00340,India
754059,2023-09-02,206,yakult,360,400,40,1,00269,India
754059,2023-09-02,201,paneer,210,340,130,1,00269,India
754059,2023-09-02,211,red bull,90,125,35,1,00269,India
754059,2023-09-02,208,sprite,75,100,25,1,00269,India
846764,2023-09-02,212,amul cheese,250,315,65,1,00107,India
846764,2023-09-02,205,classic yogurt,45,60,15,1,00107,India
846764,2023-09-02,203,mango yogurt,50,60,10,1,00107,India
479476,2023-09-03,211,red bull,90,125,35,1,00129,India
479476,2023-09-03,203,mango yogurt,50,60,10,1,00129,India
479476,2023-09-03,206,yakult,360,400,40,1,00129,India
865934,2023-09-03,205,classic yogurt,45,60,15,1,00143,India
865934,2023-09-03,209,pepsi,75,100,25,1,00143,India
865934,2023-09-03,203,mango yogurt,50,60,10,1,00143,India
223852,2023-09-03,207,coca cola,75,100,25,1,00115,India
230703,2023-09-03,206,yakult,360,400,40,1,00348,India
230703,2023-09-03,209,pepsi,75,100,25,1,00348,India
507649,2023-09-03,212,amul cheese,250,315,65,1,00366,India
507649,2023-09-03,206,yakult,360,400,40,1,00366,India
507649,2023-09-03,210,mountain dew,75,100,25,1,00366,India
445644,2023-09-03,211,red bull,90,125,35,1,00366,India
445644,2023-09-03,206,yakult,360,400,40,1,00366,India
445644,2023-09-03,213,bisleri,6,15,9,1,00366,India
445644,2023-09-03,212,amul cheese,250,315,65,1,00366,India
344960,2023-09-03,213,bisleri,6,15,9,1,00492,India
344960,2023-09-03,208,sprite,75,100,25,1,00492,India
344960,2023-09-03,203,mango yogurt,50,60,10,1,00492,India
344960,2023-09-03,209,pepsi,75,100,25,1,00492,India
820610,2023-09-03,205,classic yogurt,45,60,15,1,00173,India
820610,2023-09-03,206,yakult,360,400,40,1,00173,India
820610,2023-09-03,209,pepsi,75,100,25,1,00173,India
880364,2023-09-03,208,sprite,75,100,25,1,00074,India
880364,2023-09-03,209,pepsi,75,100,25,1,00074,India
880364,2023-09-03,211,red bull,90,125,35,1,00074,India
328772,2023-09-03,206,yakult,360,400,40,1,00032,India
328772,2023-09-03,211,red bull,90,125,35,1,00032,India
743727,2023-09-03,206,yakult,360,400,40,1,00172,India
743727,2023-09-03,213,bisleri,6,15,9,1,00172,India
743727,2023-09-03,209,pepsi,75,100,25,1,00172,India
227828,2023-09-03,212,amul cheese,250,315,65,1,00329,India
227828,2023-09-03,210,mountain dew,75,100,25,1,00329,India
894671,2023-09-03,213,bisleri,6,15,9,1,00496,India
894671,2023-09-03,208,sprite,75,100,25,1,00496,India
894671,2023-09-03,209,pepsi,75,100,25,1,00496,India
894671,2023-09-03,207,coca cola,75,100,25,1,00496,India
894671,2023-09-03,212,amul cheese,250,315,65,1,00496,India
649518,2023-09-03,205,classic yogurt,45,60,15,1,00210,India
649518,2023-09-03,211,red bull,90,125,35,1,00210,India
649518,2023-09-03,202,milk,12,27,15,1,00210,India
649518,2023-09-03,207,coca cola,75,100,25,1,00210,India
649518,2023-09-03,210,mountain dew,75,100,25,1,00210,India
568591,2023-09-03,212,amul cheese,250,315,65,1,00372,India
568591,2023-09-03,201,paneer,210,340,130,1,00372,India
568591,2023-09-03,213,bisleri,6,15,9,1,00372,India
568591,2023-09-03,208,sprite,75,100,25,1,00372,India
167206,2023-09-03,207,coca cola,75,100,25,1,00268,India
374695,2023-09-03,201,paneer,210,340,130,1,00261,India
374695,2023-09-03,204,strawberry yogurt,50,60,10,1,00261,India
374695,2023-09-03,203,mango yogurt,50,60,10,1,00261,India
374695,2023-09-03,208,sprite,75,100,25,1,00261,India
782229,2023-09-03,202,milk,12,27,15,1,00386,India
445523,2023-09-03,206,yakult,360,400,40,1,00426,India
207659,2023-09-03,207,coca cola,75,100,25,1,00024,India
207659,2023-09-03,213,bisleri,6,15,9,1,00024,India
585398,2023-09-03,204,strawberry yogurt,50,60,10,1,00272,India
585398,2023-09-03,203,mango yogurt,50,60,10,1,00272,India
585398,2023-09-03,202,milk,12,27,15,1,00272,India
890792,2023-09-03,203,mango yogurt,50,60,10,1,00140,India
890792,2023-09-03,202,milk,12,27,15,1,00140,India
890792,2023-09-03,208,sprite,75,100,25,1,00140,India
339197,2023-09-03,210,mountain dew,75,100,25,1,00219,India
339197,2023-09-03,207,coca cola,75,100,25,1,00219,India
339197,2023-09-03,213,bisleri,6,15,9,1,00219,India
339197,2023-09-03,203,mango yogurt,50,60,10,1,00219,India
339197,2023-09-03,202,milk,12,27,15,1,00219,India
779587,2023-09-03,213,bisleri,6,15,9,1,00180,India
286316,2023-09-03,202,milk,12,27,15,1,00400,India
286316,2023-09-03,201,paneer,210,340,130,1,00400,India
286999,2023-09-03,202,milk,12,27,15,1,00069,India
286999,2023-09-03,207,coca cola,75,100,25,1,00069,India
286999,2023-09-03,204,strawberry yogurt,50,60,10,1,00069,India
286999,2023-09-03,210,mountain dew,75,100,25,1,00069,India
286999,2023-09-03,203,mango yogurt,50,60,10,1,00069,India
425096,2023-09-03,205,classic yogurt,45,60,15,1,00220,India
425096,2023-09-03,201,paneer,210,340,130,1,00220,India
425096,2023-09-03,213,bisleri,6,15,9,1,00220,India
425096,2023-09-03,207,coca cola,75,100,25,1,00220,India
425096,2023-09-03,203,mango yogurt,50,60,10,1,00220,India
127223,2023-09-03,213,bisleri,6,15,9,1,00248,India
127223,2023-09-03,210,mountain dew,75,100,25,1,00248,India
127223,2023-09-03,203,mango yogurt,50,60,10,1,00248,India
323557,2023-09-03,201,paneer,210,340,130,1,00380,India
269100,2023-09-03,207,coca cola,75,100,25,1,00067,India
269100,2023-09-03,211,red bull,90,125,35,1,00067,India
934986,2023-09-03,211,red bull,90,125,35,1,00160,India
934986,2023-09-03,202,milk,12,27,15,1,00160,India
113878,2023-09-03,201,paneer,210,340,130,1,00046,India
591950,2023-09-03,208,sprite,75,100,25,1,00039,India
432092,2023-09-03,202,milk,12,27,15,1,00091,India
432092,2023-09-03,209,pepsi,75,100,25,1,00091,India
432092,2023-09-03,211,red bull,90,125,35,1,00091,India
432092,2023-09-03,201,paneer,210,340,130,1,00091,India
432092,2023-09-03,210,mountain dew,75,100,25,1,00091,India
428228,2023-09-03,213,bisleri,6,15,9,1,00245,India
428228,2023-09-03,203,mango yogurt,50,60,10,1,00245,India
305837,2023-09-03,205,classic yogurt,45,60,15,1,00287,India
818761,2023-09-03,212,amul cheese,250,315,65,1,00061,India
818761,2023-09-03,206,yakult,360,400,40,1,00061,India
818761,2023-09-03,210,mountain dew,75,100,25,1,00061,India
818761,2023-09-03,208,sprite,75,100,25,1,00061,India
231160,2023-09-03,203,mango yogurt,50,60,10,1,00407,India
231160,2023-09-03,208,sprite,75,100,25,1,00407,India
300724,2023-09-03,208,sprite,75,100,25,1,00482,India
300724,2023-09-03,207,coca cola,75,100,25,1,00482,India
300724,2023-09-03,209,pepsi,75,100,25,1,00482,India
971211,2023-09-03,207,coca cola,75,100,25,1,00237,India
590237,2023-09-03,201,paneer,210,340,130,1,00264,India
394333,2023-09-03,212,amul cheese,250,315,65,1,00212,India
394333,2023-09-03,204,strawberry yogurt,50,60,10,1,00212,India
394333,2023-09-03,213,bisleri,6,15,9,1,00212,India
394333,2023-09-03,207,coca cola,75,100,25,1,00212,India
394333,2023-09-03,211,red bull,90,125,35,1,00212,India
984774,2023-09-03,205,classic yogurt,45,60,15,1,00481,India
984774,2023-09-03,206,yakult,360,400,40,1,00481,India
984774,2023-09-03,210,mountain dew,75,100,25,1,00481,India
984774,2023-09-03,201,paneer,210,340,130,1,00481,India
503713,2023-09-03,207,coca cola,75,100,25,1,00266,India
503713,2023-09-03,210,mountain dew,75,100,25,1,00266,India
503713,2023-09-03,205,classic yogurt,45,60,15,1,00266,India
649780,2023-09-03,206,yakult,360,400,40,1,00023,India
649780,2023-09-03,201,paneer,210,340,130,1,00023,India
446854,2023-09-03,206,yakult,360,400,40,1,00254,India
446854,2023-09-03,202,milk,12,27,15,1,00254,India
446854,2023-09-03,204,strawberry yogurt,50,60,10,1,00254,India
160769,2023-09-03,204,strawberry yogurt,50,60,10,1,00345,India
160769,2023-09-03,202,milk,12,27,15,1,00345,India
430407,2023-09-03,206,yakult,360,400,40,1,00329,India
430407,2023-09-03,202,milk,12,27,15,1,00329,India
430407,2023-09-03,213,bisleri,6,15,9,1,00329,India
964106,2023-09-03,203,mango yogurt,50,60,10,1,00118,India
964106,2023-09-03,212,amul cheese,250,315,65,1,00118,India
709961,2023-09-03,213,bisleri,6,15,9,1,00113,India
709961,2023-09-03,204,strawberry yogurt,50,60,10,1,00113,India
334817,2023-09-03,206,yakult,360,400,40,1,00064,India
334817,2023-09-03,208,sprite,75,100,25,1,00064,India
334817,2023-09-03,201,paneer,210,340,130,1,00064,India
334817,2023-09-03,212,amul cheese,250,315,65,1,00064,India
675035,2023-09-03,206,yakult,360,400,40,1,00384,India
675035,2023-09-03,213,bisleri,6,15,9,1,00384,India
675035,2023-09-03,203,mango yogurt,50,60,10,1,00384,India
675035,2023-09-03,204,strawberry yogurt,50,60,10,1,00384,India
451834,2023-09-03,211,red bull,90,125,35,1,00239,India
451834,2023-09-03,210,mountain dew,75,100,25,1,00239,India
451834,2023-09-03,203,mango yogurt,50,60,10,1,00239,India
451834,2023-09-03,213,bisleri,6,15,9,1,00239,India
451834,2023-09-03,208,sprite,75,100,25,1,00239,India
329135,2023-09-03,209,pepsi,75,100,25,1,00181,India
329135,2023-09-03,212,amul cheese,250,315,65,1,00181,India
329135,2023-09-03,211,red bull,90,125,35,1,00181,India
386723,2023-09-03,211,red bull,90,125,35,1,00108,India
517716,2023-09-03,207,coca cola,75,100,25,1,00090,India
517716,2023-09-03,210,mountain dew,75,100,25,1,00090,India
717429,2023-09-03,202,milk,12,27,15,1,00257,India
717429,2023-09-03,206,yakult,360,400,40,1,00257,India
204142,2023-09-03,202,milk,12,27,15,1,00080,India
492400,2023-09-03,206,yakult,360,400,40,1,00291,India
492400,2023-09-03,212,amul cheese,250,315,65,1,00291,India
492400,2023-09-03,208,sprite,75,100,25,1,00291,India
360448,2023-09-03,213,bisleri,6,15,9,1,00226,India
360448,2023-09-03,209,pepsi,75,100,25,1,00226,India
360448,2023-09-03,211,red bull,90,125,35,1,00226,India
360448,2023-09-03,206,yakult,360,400,40,1,00226,India
799922,2023-09-03,205,classic yogurt,45,60,15,1,00183,India
799922,2023-09-03,213,bisleri,6,15,9,1,00183,India
799922,2023-09-03,210,mountain dew,75,100,25,1,00183,India
799922,2023-09-03,204,strawberry yogurt,50,60,10,1,00183,India
219172,2023-09-03,203,mango yogurt,50,60,10,1,00379,India
219172,2023-09-03,204,strawberry yogurt,50,60,10,1,00379,India
430947,2023-09-03,212,amul cheese,250,315,65,1,00202,India
430947,2023-09-03,205,classic yogurt,45,60,15,1,00202,India
430947,2023-09-03,210,mountain dew,75,100,25,1,00202,India
761223,2023-09-03,202,milk,12,27,15,1,00364,India
761223,2023-09-03,210,mountain dew,75,100,25,1,00364,India
765420,2023-09-03,211,red bull,90,125,35,1,00074,India
765420,2023-09-03,209,pepsi,75,100,25,1,00074,India
752717,2023-09-03,211,red bull,90,125,35,1,00415,India
752717,2023-09-03,202,milk,12,27,15,1,00415,India
916467,2023-09-03,207,coca cola,75,100,25,1,00498,India
164407,2023-09-03,207,coca cola,75,100,25,1,00081,India
999943,2023-09-03,205,classic yogurt,45,60,15,1,00016,India
332294,2023-09-03,209,pepsi,75,100,25,1,00318,India
359694,2023-09-03,205,classic yogurt,45,60,15,1,00180,India
359694,2023-09-03,203,mango yogurt,50,60,10,1,00180,India
975103,2023-09-03,210,mountain dew,75,100,25,1,00163,India
975103,2023-09-03,206,yakult,360,400,40,1,00163,India
582007,2023-09-03,204,strawberry yogurt,50,60,10,1,00109,India
730575,2023-09-03,212,amul cheese,250,315,65,1,00463,India
247883,2023-09-03,206,yakult,360,400,40,1,00143,India
247883,2023-09-03,209,pepsi,75,100,25,1,00143,India
483530,2023-09-03,203,mango yogurt,50,60,10,1,00140,India
685662,2023-09-03,212,amul cheese,250,315,65,1,00449,India
685662,2023-09-03,205,classic yogurt,45,60,15,1,00449,India
685662,2023-09-03,207,coca cola,75,100,25,1,00449,India
685662,2023-09-03,213,bisleri,6,15,9,1,00449,India
703910,2023-09-03,201,paneer,210,340,130,1,00064,India
703910,2023-09-03,203,mango yogurt,50,60,10,1,00064,India
703910,2023-09-03,210,mountain dew,75,100,25,1,00064,India
382287,2023-09-03,213,bisleri,6,15,9,1,00411,India
382287,2023-09-03,203,mango yogurt,50,60,10,1,00411,India
382287,2023-09-03,205,classic yogurt,45,60,15,1,00411,India
261401,2023-09-03,205,classic yogurt,45,60,15,1,00477,India
261401,2023-09-03,208,sprite,75,100,25,1,00477,India
261401,2023-09-03,201,paneer,210,340,130,1,00477,India
261401,2023-09-03,211,red bull,90,125,35,1,00477,India
116178,2023-09-03,211,red bull,90,125,35,1,00464,India
116178,2023-09-03,205,classic yogurt,45,60,15,1,00464,India
116178,2023-09-03,210,mountain dew,75,100,25,1,00464,India
116178,2023-09-03,204,strawberry yogurt,50,60,10,1,00464,India
591827,2023-09-03,207,coca cola,75,100,25,1,00342,India
591827,2023-09-03,211,red bull,90,125,35,1,00342,India
591827,2023-09-03,202,milk,12,27,15,1,00342,India
149093,2023-09-03,203,mango yogurt,50,60,10,1,00424,India
527787,2023-09-03,207,coca cola,75,100,25,1,00465,India
527787,2023-09-03,205,classic yogurt,45,60,15,1,00465,India
527787,2023-09-03,202,milk,12,27,15,1,00465,India
527787,2023-09-03,204,strawberry yogurt,50,60,10,1,00465,India
130054,2023-09-03,210,mountain dew,75,100,25,1,00490,India
197051,2023-09-03,207,coca cola,75,100,25,1,00348,India
197051,2023-09-03,206,yakult,360,400,40,1,00348,India
197051,2023-09-03,204,strawberry yogurt,50,60,10,1,00348,India
197051,2023-09-03,212,amul cheese,250,315,65,1,00348,India
947160,2023-09-03,207,coca cola,75,100,25,1,00126,India
947160,2023-09-03,206,yakult,360,400,40,1,00126,India
947160,2023-09-03,208,sprite,75,100,25,1,00126,India
318124,2023-09-03,205,classic yogurt,45,60,15,1,00173,India
318124,2023-09-03,206,yakult,360,400,40,1,00173,India
318124,2023-09-03,212,amul cheese,250,315,65,1,00173,India
318124,2023-09-03,209,pepsi,75,100,25,1,00173,India
293098,2023-09-03,208,sprite,75,100,25,1,00408,India
293098,2023-09-03,203,mango yogurt,50,60,10,1,00408,India
293098,2023-09-03,211,red bull,90,125,35,1,00408,India
293098,2023-09-03,209,pepsi,75,100,25,1,00408,India
569660,2023-09-03,201,paneer,210,340,130,1,00213,India
569660,2023-09-03,209,pepsi,75,100,25,1,00213,India
232029,2023-09-03,204,strawberry yogurt,50,60,10,1,00455,India
232029,2023-09-03,201,paneer,210,340,130,1,00455,India
232029,2023-09-03,203,mango yogurt,50,60,10,1,00455,India
541138,2023-09-03,205,classic yogurt,45,60,15,1,00496,India
131016,2023-09-03,205,classic yogurt,45,60,15,1,00024,India
131016,2023-09-03,209,pepsi,75,100,25,1,00024,India
131016,2023-09-03,208,sprite,75,100,25,1,00024,India
131016,2023-09-03,212,amul cheese,250,315,65,1,00024,India
282244,2023-09-03,207,coca cola,75,100,25,1,00173,India
282244,2023-09-03,210,mountain dew,75,100,25,1,00173,India
613981,2023-09-03,202,milk,12,27,15,1,00156,India
613981,2023-09-03,205,classic yogurt,45,60,15,1,00156,India
613981,2023-09-03,213,bisleri,6,15,9,1,00156,India
613981,2023-09-03,203,mango yogurt,50,60,10,1,00156,India
983540,2023-09-03,204,strawberry yogurt,50,60,10,1,00425,India
983540,2023-09-03,213,bisleri,6,15,9,1,00425,India
658511,2023-09-03,203,mango yogurt,50,60,10,1,00355,India
658511,2023-09-03,211,red bull,90,125,35,1,00355,India
777709,2023-09-03,205,classic yogurt,45,60,15,1,00488,India
777709,2023-09-03,211,red bull,90,125,35,1,00488,India
916092,2023-09-03,206,yakult,360,400,40,1,00320,India
916092,2023-09-03,204,strawberry yogurt,50,60,10,1,00320,India
415204,2023-09-04,209,pepsi,75,100,25,1,00434,India
415204,2023-09-04,201,paneer,210,340,130,1,00434,India
415204,2023-09-04,208,sprite,75,100,25,1,00434,India
153059,2023-09-04,206,yakult,360,400,40,1,00092,India
153059,2023-09-04,201,paneer,210,340,130,1,00092,India
153059,2023-09-04,207,coca cola,75,100,25,1,00092,India
786535,2023-09-04,209,pepsi,75,100,25,1,00092,India
786535,2023-09-04,205,classic yogurt,45,60,15,1,00092,India
786535,2023-09-04,201,paneer,210,340,130,1,00092,India
615458,2023-09-04,208,sprite,75,100,25,1,00437,India
615458,2023-09-04,212,amul cheese,250,315,65,1,00437,India
615458,2023-09-04,201,paneer,210,340,130,1,00437,India
615458,2023-09-04,211,red bull,90,125,35,1,00437,India
904881,2023-09-04,210,mountain dew,75,100,25,1,00341,India
904881,2023-09-04,208,sprite,75,100,25,1,00341,India
904881,2023-09-04,212,amul cheese,250,315,65,1,00341,India
402172,2023-09-04,206,yakult,360,400,40,1,00167,India
402172,2023-09-04,212,amul cheese,250,315,65,1,00167,India
987328,2023-09-04,213,bisleri,6,15,9,1,00110,India
987328,2023-09-04,211,red bull,90,125,35,1,00110,India
987328,2023-09-04,204,strawberry yogurt,50,60,10,1,00110,India
987328,2023-09-04,206,yakult,360,400,40,1,00110,India
154214,2023-09-04,203,mango yogurt,50,60,10,1,00239,India
416444,2023-09-04,209,pepsi,75,100,25,1,00177,India
416444,2023-09-04,208,sprite,75,100,25,1,00177,India
416444,2023-09-04,212,amul cheese,250,315,65,1,00177,India
416444,2023-09-04,207,coca cola,75,100,25,1,00177,India
897124,2023-09-04,202,milk,12,27,15,1,00386,India
592268,2023-09-04,202,milk,12,27,15,1,00328,India
592268,2023-09-04,212,amul cheese,250,315,65,1,00328,India
592268,2023-09-04,206,yakult,360,400,40,1,00328,India
592268,2023-09-04,207,coca cola,75,100,25,1,00328,India
849186,2023-09-04,205,classic yogurt,45,60,15,1,00165,India
849186,2023-09-04,209,pepsi,75,100,25,1,00165,India
849186,2023-09-04,206,yakult,360,400,40,1,00165,India
849186,2023-09-04,213,bisleri,6,15,9,1,00165,India
648996,2023-09-04,211,red bull,90,125,35,1,00369,India
648996,2023-09-04,205,classic yogurt,45,60,15,1,00369,India
676313,2023-09-04,213,bisleri,6,15,9,1,00012,India
676313,2023-09-04,210,mountain dew,75,100,25,1,00012,India
676313,2023-09-04,201,paneer,210,340,130,1,00012,India
676313,2023-09-04,211,red bull,90,125,35,1,00012,India
676313,2023-09-04,204,strawberry yogurt,50,60,10,1,00012,India
940171,2023-09-04,203,mango yogurt,50,60,10,1,00210,India
940171,2023-09-04,205,classic yogurt,45,60,15,1,00210,India
940171,2023-09-04,210,mountain dew,75,100,25,1,00210,India
813889,2023-09-04,204,strawberry yogurt,50,60,10,1,00050,India
813889,2023-09-04,208,sprite,75,100,25,1,00050,India
813889,2023-09-04,209,pepsi,75,100,25,1,00050,India
813889,2023-09-04,205,classic yogurt,45,60,15,1,00050,India
735389,2023-09-04,203,mango yogurt,50,60,10,1,00099,India
735389,2023-09-04,209,pepsi,75,100,25,1,00099,India
735389,2023-09-04,210,mountain dew,75,100,25,1,00099,India
735389,2023-09-04,207,coca cola,75,100,25,1,00099,India
245651,2023-09-04,201,paneer,210,340,130,1,00019,India
245651,2023-09-04,210,mountain dew,75,100,25,1,00019,India
245651,2023-09-04,205,classic yogurt,45,60,15,1,00019,India
245651,2023-09-04,204,strawberry yogurt,50,60,10,1,00019,India
686260,2023-09-04,203,mango yogurt,50,60,10,1,00397,India
372677,2023-09-04,204,strawberry yogurt,50,60,10,1,00240,India
372677,2023-09-04,202,milk,12,27,15,1,00240,India
857183,2023-09-04,213,bisleri,6,15,9,1,00093,India
857183,2023-09-04,210,mountain dew,75,100,25,1,00093,India
857183,2023-09-04,209,pepsi,75,100,25,1,00093,India
887478,2023-09-04,205,classic yogurt,45,60,15,1,00247,India
887478,2023-09-04,210,mountain dew,75,100,25,1,00247,India
887478,2023-09-04,204,strawberry yogurt,50,60,10,1,00247,India
406958,2023-09-04,213,bisleri,6,15,9,1,00400,India
119617,2023-09-04,213,bisleri,6,15,9,1,00395,India
119617,2023-09-04,210,mountain dew,75,100,25,1,00395,India
119617,2023-09-04,209,pepsi,75,100,25,1,00395,India
870411,2023-09-04,207,coca cola,75,100,25,1,00189,India
870411,2023-09-04,211,red bull,90,125,35,1,00189,India
870411,2023-09-04,210,mountain dew,75,100,25,1,00189,India
870411,2023-09-04,208,sprite,75,100,25,1,00189,India
782965,2023-09-04,210,mountain dew,75,100,25,1,00247,India
860723,2023-09-04,207,coca cola,75,100,25,1,00001,India
860723,2023-09-04,202,milk,12,27,15,1,00001,India
196752,2023-09-04,212,amul cheese,250,315,65,1,00435,India
471078,2023-09-04,212,amul cheese,250,315,65,1,00219,India
471078,2023-09-04,203,mango yogurt,50,60,10,1,00219,India
471078,2023-09-04,211,red bull,90,125,35,1,00219,India
696072,2023-09-04,204,strawberry yogurt,50,60,10,1,00407,India
696072,2023-09-04,209,pepsi,75,100,25,1,00407,India
138807,2023-09-04,203,mango yogurt,50,60,10,1,00244,India
138807,2023-09-04,210,mountain dew,75,100,25,1,00244,India
138807,2023-09-04,212,amul cheese,250,315,65,1,00244,India
138807,2023-09-04,201,paneer,210,340,130,1,00244,India
893680,2023-09-04,210,mountain dew,75,100,25,1,00228,India
893680,2023-09-04,212,amul cheese,250,315,65,1,00228,India
893680,2023-09-04,205,classic yogurt,45,60,15,1,00228,India
893680,2023-09-04,213,bisleri,6,15,9,1,00228,India
909565,2023-09-04,207,coca cola,75,100,25,1,00393,India
909565,2023-09-04,212,amul cheese,250,315,65,1,00393,India
909565,2023-09-04,206,yakult,360,400,40,1,00393,India
909565,2023-09-04,203,mango yogurt,50,60,10,1,00393,India
509227,2023-09-04,204,strawberry yogurt,50,60,10,1,00012,India
509227,2023-09-04,211,red bull,90,125,35,1,00012,India
756611,2023-09-04,204,strawberry yogurt,50,60,10,1,00464,India
756611,2023-09-04,208,sprite,75,100,25,1,00464,India
626185,2023-09-04,213,bisleri,6,15,9,1,00019,India
626185,2023-09-04,209,pepsi,75,100,25,1,00019,India
952935,2023-09-04,210,mountain dew,75,100,25,1,00125,India
412216,2023-09-04,205,classic yogurt,45,60,15,1,00209,India
899603,2023-09-04,213,bisleri,6,15,9,1,00099,India
372209,2023-09-04,202,milk,12,27,15,1,00440,India
372209,2023-09-04,208,sprite,75,100,25,1,00440,India
372209,2023-09-04,210,mountain dew,75,100,25,1,00440,India
447369,2023-09-04,208,sprite,75,100,25,1,00003,India
447369,2023-09-04,213,bisleri,6,15,9,1,00003,India
989110,2023-09-04,208,sprite,75,100,25,1,00484,India
989110,2023-09-04,210,mountain dew,75,100,25,1,00484,India
989110,2023-09-04,204,strawberry yogurt,50,60,10,1,00484,India
989110,2023-09-04,207,coca cola,75,100,25,1,00484,India
793746,2023-09-04,207,coca cola,75,100,25,1,00149,India
793746,2023-09-04,205,classic yogurt,45,60,15,1,00149,India
793746,2023-09-04,209,pepsi,75,100,25,1,00149,India
372384,2023-09-04,213,bisleri,6,15,9,1,00212,India
372384,2023-09-04,203,mango yogurt,50,60,10,1,00212,India
101924,2023-09-04,213,bisleri,6,15,9,1,00188,India
101924,2023-09-04,212,amul cheese,250,315,65,1,00188,India
101924,2023-09-04,201,paneer,210,340,130,1,00188,India
101924,2023-09-04,210,mountain dew,75,100,25,1,00188,India
815352,2023-09-04,211,red bull,90,125,35,1,00442,India
815352,2023-09-04,213,bisleri,6,15,9,1,00442,India
815352,2023-09-04,205,classic yogurt,45,60,15,1,00442,India
815352,2023-09-04,212,amul cheese,250,315,65,1,00442,India
815352,2023-09-04,206,yakult,360,400,40,1,00442,India
705749,2023-09-04,209,pepsi,75,100,25,1,00410,India
885172,2023-09-04,202,milk,12,27,15,1,00492,India
679239,2023-09-04,204,strawberry yogurt,50,60,10,1,00379,India
679239,2023-09-04,201,paneer,210,340,130,1,00379,India
679239,2023-09-04,203,mango yogurt,50,60,10,1,00379,India
679239,2023-09-04,208,sprite,75,100,25,1,00379,India
855345,2023-09-04,205,classic yogurt,45,60,15,1,00411,India
855345,2023-09-04,213,bisleri,6,15,9,1,00411,India
522157,2023-09-04,205,classic yogurt,45,60,15,1,00386,India
262285,2023-09-04,205,classic yogurt,45,60,15,1,00154,India
262285,2023-09-04,201,paneer,210,340,130,1,00154,India
262285,2023-09-04,211,red bull,90,125,35,1,00154,India
592533,2023-09-04,211,red bull,90,125,35,1,00182,India
592533,2023-09-04,205,classic yogurt,45,60,15,1,00182,India
592533,2023-09-04,213,bisleri,6,15,9,1,00182,India
581839,2023-09-04,201,paneer,210,340,130,1,00089,India
581839,2023-09-04,212,amul cheese,250,315,65,1,00089,India
581839,2023-09-04,213,bisleri,6,15,9,1,00089,India
581839,2023-09-04,211,red bull,90,125,35,1,00089,India
449252,2023-09-04,204,strawberry yogurt,50,60,10,1,00465,India
449252,2023-09-04,201,paneer,210,340,130,1,00465,India
487465,2023-09-04,206,yakult,360,400,40,1,00471,India
487465,2023-09-04,208,sprite,75,100,25,1,00471,India
487465,2023-09-04,201,paneer,210,340,130,1,00471,India
654357,2023-09-04,201,paneer,210,340,130,1,00132,India
654357,2023-09-04,204,strawberry yogurt,50,60,10,1,00132,India
664460,2023-09-04,207,coca cola,75,100,25,1,00330,India
664460,2023-09-04,208,sprite,75,100,25,1,00330,India
664460,2023-09-04,206,yakult,360,400,40,1,00330,India
982977,2023-09-04,209,pepsi,75,100,25,1,00040,India
982977,2023-09-04,212,amul cheese,250,315,65,1,00040,India
354388,2023-09-04,203,mango yogurt,50,60,10,1,00450,India
354388,2023-09-04,207,coca cola,75,100,25,1,00450,India
354388,2023-09-04,210,mountain dew,75,100,25,1,00450,India
354388,2023-09-04,206,yakult,360,400,40,1,00450,India
354388,2023-09-04,204,strawberry yogurt,50,60,10,1,00450,India
571976,2023-09-04,207,coca cola,75,100,25,1,00042,India
571976,2023-09-04,205,classic yogurt,45,60,15,1,00042,India
170846,2023-09-04,205,classic yogurt,45,60,15,1,00369,India
170846,2023-09-04,209,pepsi,75,100,25,1,00369,India
273360,2023-09-04,207,coca cola,75,100,25,1,00070,India
273360,2023-09-04,205,classic yogurt,45,60,15,1,00070,India
171113,2023-09-04,210,mountain dew,75,100,25,1,00225,India
273108,2023-09-04,206,yakult,360,400,40,1,00280,India
273108,2023-09-04,210,mountain dew,75,100,25,1,00280,India
273108,2023-09-04,203,mango yogurt,50,60,10,1,00280,India
455013,2023-09-04,206,yakult,360,400,40,1,00165,India
455013,2023-09-04,212,amul cheese,250,315,65,1,00165,India
826052,2023-09-04,207,coca cola,75,100,25,1,00480,India
826052,2023-09-04,211,red bull,90,125,35,1,00480,India
826052,2023-09-04,203,mango yogurt,50,60,10,1,00480,India
826052,2023-09-04,205,classic yogurt,45,60,15,1,00480,India
591587,2023-09-04,211,red bull,90,125,35,1,00164,India
824184,2023-09-04,210,mountain dew,75,100,25,1,00376,India
824184,2023-09-04,203,mango yogurt,50,60,10,1,00376,India
824184,2023-09-04,212,amul cheese,250,315,65,1,00376,India
363127,2023-09-04,213,bisleri,6,15,9,1,00092,India
363127,2023-09-04,206,yakult,360,400,40,1,00092,India
363127,2023-09-04,208,sprite,75,100,25,1,00092,India
605049,2023-09-04,204,strawberry yogurt,50,60,10,1,00042,India
605049,2023-09-04,212,amul cheese,250,315,65,1,00042,India
605049,2023-09-04,205,classic yogurt,45,60,15,1,00042,India
605049,2023-09-04,203,mango yogurt,50,60,10,1,00042,India
665605,2023-09-04,203,mango yogurt,50,60,10,1,00032,India
665605,2023-09-04,202,milk,12,27,15,1,00032,India
665605,2023-09-04,213,bisleri,6,15,9,1,00032,India
577280,2023-09-04,210,mountain dew,75,100,25,1,00051,India
577280,2023-09-04,209,pepsi,75,100,25,1,00051,India
577280,2023-09-04,205,classic yogurt,45,60,15,1,00051,India
577280,2023-09-04,204,strawberry yogurt,50,60,10,1,00051,India
577280,2023-09-04,202,milk,12,27,15,1,00051,India
128574,2023-09-04,206,yakult,360,400,40,1,00237,India
258029,2023-09-04,201,paneer,210,340,130,1,00088,India
258029,2023-09-04,202,milk,12,27,15,1,00088,India
258029,2023-09-04,211,red bull,90,125,35,1,00088,India
258029,2023-09-04,205,classic yogurt,45,60,15,1,00088,India
500859,2023-09-04,204,strawberry yogurt,50,60,10,1,00165,India
500859,2023-09-04,205,classic yogurt,45,60,15,1,00165,India
500859,2023-09-04,206,yakult,360,400,40,1,00165,India
454357,2023-09-04,201,paneer,210,340,130,1,00077,India
454357,2023-09-04,206,yakult,360,400,40,1,00077,India
591403,2023-09-04,202,milk,12,27,15,1,00312,India
591403,2023-09-04,212,amul cheese,250,315,65,1,00312,India
591403,2023-09-04,205,classic yogurt,45,60,15,1,00312,India
832934,2023-09-04,209,pepsi,75,100,25,1,00426,India
900757,2023-09-04,208,sprite,75,100,25,1,00071,India
900757,2023-09-04,209,pepsi,75,100,25,1,00071,India
900757,2023-09-04,211,red bull,90,125,35,1,00071,India
900757,2023-09-04,213,bisleri,6,15,9,1,00071,India
704834,2023-09-04,203,mango yogurt,50,60,10,1,00391,India
824690,2023-09-04,212,amul cheese,250,315,65,1,00477,India
824690,2023-09-04,202,milk,12,27,15,1,00477,India
824690,2023-09-04,211,red bull,90,125,35,1,00477,India
326471,2023-09-04,210,mountain dew,75,100,25,1,00421,India
326471,2023-09-04,205,classic yogurt,45,60,15,1,00421,India
326471,2023-09-04,204,strawberry yogurt,50,60,10,1,00421,India
326471,2023-09-04,202,milk,12,27,15,1,00421,India
388441,2023-09-04,204,strawberry yogurt,50,60,10,1,00071,India
388441,2023-09-04,205,classic yogurt,45,60,15,1,00071,India
108728,2023-09-04,204,strawberry yogurt,50,60,10,1,00040,India
108728,2023-09-04,207,coca cola,75,100,25,1,00040,India
108728,2023-09-04,210,mountain dew,75,100,25,1,00040,India
108728,2023-09-04,209,pepsi,75,100,25,1,00040,India
108728,2023-09-04,206,yakult,360,400,40,1,00040,India
892098,2023-09-04,207,coca cola,75,100,25,1,00269,India
892098,2023-09-04,210,mountain dew,75,100,25,1,00269,India
892098,2023-09-04,209,pepsi,75,100,25,1,00269,India
221418,2023-09-04,211,red bull,90,125,35,1,00065,India
493363,2023-09-04,203,mango yogurt,50,60,10,1,00316,India
493363,2023-09-04,212,amul cheese,250,315,65,1,00316,India
493363,2023-09-04,209,pepsi,75,100,25,1,00316,India
659505,2023-09-04,205,classic yogurt,45,60,15,1,00454,India
659505,2023-09-04,206,yakult,360,400,40,1,00454,India
659505,2023-09-04,204,strawberry yogurt,50,60,10,1,00454,India
582118,2023-09-05,213,bisleri,6,15,9,1,00305,India
582118,2023-09-05,201,paneer,210,340,130,1,00305,India
562143,2023-09-05,202,milk,12,27,15,1,00364,India
104021,2023-09-05,211,red bull,90,125,35,1,00266,India
104021,2023-09-05,205,classic yogurt,45,60,15,1,00266,India
104021,2023-09-05,203,mango yogurt,50,60,10,1,00266,India
708074,2023-09-05,213,bisleri,6,15,9,1,00002,India
708074,2023-09-05,203,mango yogurt,50,60,10,1,00002,India
170358,2023-09-05,212,amul cheese,250,315,65,1,00441,India
170358,2023-09-05,201,paneer,210,340,130,1,00441,India
148569,2023-09-05,209,pepsi,75,100,25,1,00013,India
148569,2023-09-05,210,mountain dew,75,100,25,1,00013,India
148569,2023-09-05,202,milk,12,27,15,1,00013,India
572730,2023-09-05,209,pepsi,75,100,25,1,00424,India
572730,2023-09-05,210,mountain dew,75,100,25,1,00424,India
572730,2023-09-05,205,classic yogurt,45,60,15,1,00424,India
290175,2023-09-05,210,mountain dew,75,100,25,1,00061,India
290175,2023-09-05,213,bisleri,6,15,9,1,00061,India
401682,2023-09-05,203,mango yogurt,50,60,10,1,00299,India
401682,2023-09-05,212,amul cheese,250,315,65,1,00299,India
688792,2023-09-05,203,mango yogurt,50,60,10,1,00386,India
688792,2023-09-05,212,amul cheese,250,315,65,1,00386,India
688792,2023-09-05,205,classic yogurt,45,60,15,1,00386,India
865141,2023-09-05,206,yakult,360,400,40,1,00003,India
206631,2023-09-05,203,mango yogurt,50,60,10,1,00336,India
206631,2023-09-05,213,bisleri,6,15,9,1,00336,India
206631,2023-09-05,207,coca cola,75,100,25,1,00336,India
379365,2023-09-05,205,classic yogurt,45,60,15,1,00171,India
379365,2023-09-05,206,yakult,360,400,40,1,00171,India
379365,2023-09-05,212,amul cheese,250,315,65,1,00171,India
379365,2023-09-05,207,coca cola,75,100,25,1,00171,India
889978,2023-09-05,207,coca cola,75,100,25,1,00285,India
889978,2023-09-05,210,mountain dew,75,100,25,1,00285,India
889978,2023-09-05,208,sprite,75,100,25,1,00285,India
889978,2023-09-05,201,paneer,210,340,130,1,00285,India
479810,2023-09-05,207,coca cola,75,100,25,1,00210,India
725739,2023-09-05,213,bisleri,6,15,9,1,00330,India
725739,2023-09-05,210,mountain dew,75,100,25,1,00330,India
725739,2023-09-05,209,pepsi,75,100,25,1,00330,India
725739,2023-09-05,204,strawberry yogurt,50,60,10,1,00330,India
591879,2023-09-05,204,strawberry yogurt,50,60,10,1,00310,India
591879,2023-09-05,212,amul cheese,250,315,65,1,00310,India
591879,2023-09-05,211,red bull,90,125,35,1,00310,India
591879,2023-09-05,205,classic yogurt,45,60,15,1,00310,India
830509,2023-09-05,209,pepsi,75,100,25,1,00324,India
830509,2023-09-05,203,mango yogurt,50,60,10,1,00324,India
138758,2023-09-05,211,red bull,90,125,35,1,00074,India
138758,2023-09-05,201,paneer,210,340,130,1,00074,India
138758,2023-09-05,212,amul cheese,250,315,65,1,00074,India
878802,2023-09-05,208,sprite,75,100,25,1,00103,India
626430,2023-09-05,213,bisleri,6,15,9,1,00260,India
626430,2023-09-05,206,yakult,360,400,40,1,00260,India
626430,2023-09-05,209,pepsi,75,100,25,1,00260,India
122403,2023-09-05,211,red bull,90,125,35,1,00278,India
900237,2023-09-05,211,red bull,90,125,35,1,00116,India
900237,2023-09-05,201,paneer,210,340,130,1,00116,India
900237,2023-09-05,208,sprite,75,100,25,1,00116,India
900237,2023-09-05,205,classic yogurt,45,60,15,1,00116,India
898434,2023-09-05,204,strawberry yogurt,50,60,10,1,00015,India
898434,2023-09-05,210,mountain dew,75,100,25,1,00015,India
898434,2023-09-05,207,coca cola,75,100,25,1,00015,India
529090,2023-09-05,210,mountain dew,75,100,25,1,00367,India
529090,2023-09-05,202,milk,12,27,15,1,00367,India
802285,2023-09-05,211,red bull,90,125,35,1,00489,India
802285,2023-09-05,208,sprite,75,100,25,1,00489,India
802285,2023-09-05,202,milk,12,27,15,1,00489,India
113931,2023-09-05,203,mango yogurt,50,60,10,1,00367,India
798769,2023-09-05,208,sprite,75,100,25,1,00373,India
798769,2023-09-05,202,milk,12,27,15,1,00373,India
798769,2023-09-05,204,strawberry yogurt,50,60,10,1,00373,India
594110,2023-09-05,203,mango yogurt,50,60,10,1,00080,India
802700,2023-09-05,204,strawberry yogurt,50,60,10,1,00025,India
802700,2023-09-05,209,pepsi,75,100,25,1,00025,India
322257,2023-09-05,213,bisleri,6,15,9,1,00241,India
386182,2023-09-05,204,strawberry yogurt,50,60,10,1,00079,India
386182,2023-09-05,201,paneer,210,340,130,1,00079,India
386182,2023-09-05,203,mango yogurt,50,60,10,1,00079,India
325223,2023-09-05,203,mango yogurt,50,60,10,1,00011,India
325223,2023-09-05,211,red bull,90,125,35,1,00011,India
325223,2023-09-05,202,milk,12,27,15,1,00011,India
325223,2023-09-05,209,pepsi,75,100,25,1,00011,India
140650,2023-09-05,202,milk,12,27,15,1,00277,India
140650,2023-09-05,201,paneer,210,340,130,1,00277,India
140650,2023-09-05,209,pepsi,75,100,25,1,00277,India
140650,2023-09-05,208,sprite,75,100,25,1,00277,India
218704,2023-09-05,201,paneer,210,340,130,1,00354,India
151600,2023-09-05,202,milk,12,27,15,1,00187,India
417156,2023-09-05,203,mango yogurt,50,60,10,1,00215,India
417156,2023-09-05,210,mountain dew,75,100,25,1,00215,India
417156,2023-09-05,208,sprite,75,100,25,1,00215,India
417156,2023-09-05,206,yakult,360,400,40,1,00215,India
869350,2023-09-05,208,sprite,75,100,25,1,00179,India
869350,2023-09-05,206,yakult,360,400,40,1,00179,India
869350,2023-09-05,210,mountain dew,75,100,25,1,00179,India
869350,2023-09-05,201,paneer,210,340,130,1,00179,India
130287,2023-09-05,211,red bull,90,125,35,1,00181,India
130287,2023-09-05,208,sprite,75,100,25,1,00181,India
130287,2023-09-05,210,mountain dew,75,100,25,1,00181,India
130287,2023-09-05,202,milk,12,27,15,1,00181,India
712891,2023-09-05,202,milk,12,27,15,1,00319,India
712891,2023-09-05,209,pepsi,75,100,25,1,00319,India
732402,2023-09-05,213,bisleri,6,15,9,1,00080,India
296592,2023-09-05,208,sprite,75,100,25,1,00077,India
296592,2023-09-05,206,yakult,360,400,40,1,00077,India
296592,2023-09-05,202,milk,12,27,15,1,00077,India
296592,2023-09-05,211,red bull,90,125,35,1,00077,India
607136,2023-09-05,213,bisleri,6,15,9,1,00014,India
183326,2023-09-05,213,bisleri,6,15,9,1,00212,India
183326,2023-09-05,210,mountain dew,75,100,25,1,00212,India
183326,2023-09-05,204,strawberry yogurt,50,60,10,1,00212,India
183326,2023-09-05,205,classic yogurt,45,60,15,1,00212,India
981231,2023-09-05,212,amul cheese,250,315,65,1,00216,India
981231,2023-09-05,207,coca cola,75,100,25,1,00216,India
919546,2023-09-05,210,mountain dew,75,100,25,1,00391,India
919546,2023-09-05,211,red bull,90,125,35,1,00391,India
919546,2023-09-05,206,yakult,360,400,40,1,00391,India
713196,2023-09-05,212,amul cheese,250,315,65,1,00042,India
713196,2023-09-05,213,bisleri,6,15,9,1,00042,India
713196,2023-09-05,207,coca cola,75,100,25,1,00042,India
577178,2023-09-05,211,red bull,90,125,35,1,00113,India
577178,2023-09-05,208,sprite,75,100,25,1,00113,India
670460,2023-09-05,206,yakult,360,400,40,1,00066,India
670460,2023-09-05,202,milk,12,27,15,1,00066,India
670460,2023-09-05,211,red bull,90,125,35,1,00066,India
670460,2023-09-05,203,mango yogurt,50,60,10,1,00066,India
736213,2023-09-05,205,classic yogurt,45,60,15,1,00287,India
736213,2023-09-05,212,amul cheese,250,315,65,1,00287,India
501228,2023-09-05,206,yakult,360,400,40,1,00224,India
501228,2023-09-05,203,mango yogurt,50,60,10,1,00224,India
145199,2023-09-05,207,coca cola,75,100,25,1,00447,India
145199,2023-09-05,211,red bull,90,125,35,1,00447,India
145199,2023-09-05,208,sprite,75,100,25,1,00447,India
288194,2023-09-05,209,pepsi,75,100,25,1,00190,India
288194,2023-09-05,213,bisleri,6,15,9,1,00190,India
288194,2023-09-05,210,mountain dew,75,100,25,1,00190,India
974597,2023-09-05,211,red bull,90,125,35,1,00305,India
974597,2023-09-05,213,bisleri,6,15,9,1,00305,India
974597,2023-09-05,202,milk,12,27,15,1,00305,India
974597,2023-09-05,206,yakult,360,400,40,1,00305,India
974597,2023-09-05,203,mango yogurt,50,60,10,1,00305,India
192112,2023-09-05,212,amul cheese,250,315,65,1,00340,India
192112,2023-09-05,213,bisleri,6,15,9,1,00340,India
491773,2023-09-05,210,mountain dew,75,100,25,1,00332,India
767042,2023-09-05,208,sprite,75,100,25,1,00276,India
767042,2023-09-05,204,strawberry yogurt,50,60,10,1,00276,India
924591,2023-09-05,212,amul cheese,250,315,65,1,00329,India
705018,2023-09-05,201,paneer,210,340,130,1,00228,India
609485,2023-09-05,201,paneer,210,340,130,1,00119,India
609485,2023-09-05,202,milk,12,27,15,1,00119,India
609485,2023-09-05,213,bisleri,6,15,9,1,00119,India
609485,2023-09-05,206,yakult,360,400,40,1,00119,India
788288,2023-09-05,213,bisleri,6,15,9,1,00145,India
812424,2023-09-05,208,sprite,75,100,25,1,00027,India
772194,2023-09-05,208,sprite,75,100,25,1,00490,India
772194,2023-09-05,203,mango yogurt,50,60,10,1,00490,India
772194,2023-09-05,201,paneer,210,340,130,1,00490,India
772194,2023-09-05,206,yakult,360,400,40,1,00490,India
129387,2023-09-05,201,paneer,210,340,130,1,00415,India
496398,2023-09-05,206,yakult,360,400,40,1,00471,India
496398,2023-09-05,207,coca cola,75,100,25,1,00471,India
496398,2023-09-05,209,pepsi,75,100,25,1,00471,India
496398,2023-09-05,203,mango yogurt,50,60,10,1,00471,India
626946,2023-09-05,202,milk,12,27,15,1,00392,India
626946,2023-09-05,213,bisleri,6,15,9,1,00392,India
626946,2023-09-05,208,sprite,75,100,25,1,00392,India
626946,2023-09-05,204,strawberry yogurt,50,60,10,1,00392,India
749729,2023-09-05,209,pepsi,75,100,25,1,00494,India
749729,2023-09-05,213,bisleri,6,15,9,1,00494,India
749729,2023-09-05,207,coca cola,75,100,25,1,00494,India
749729,2023-09-05,205,classic yogurt,45,60,15,1,00494,India
275495,2023-09-05,202,milk,12,27,15,1,00129,India
275495,2023-09-05,211,red bull,90,125,35,1,00129,India
373130,2023-09-05,208,sprite,75,100,25,1,00026,India
373130,2023-09-05,211,red bull,90,125,35,1,00026,India
521901,2023-09-05,201,paneer,210,340,130,1,00476,India
521901,2023-09-05,212,amul cheese,250,315,65,1,00476,India
965732,2023-09-05,209,pepsi,75,100,25,1,00339,India
965732,2023-09-05,212,amul cheese,250,315,65,1,00339,India
119893,2023-09-06,202,milk,12,27,15,1,00491,India
115502,2023-09-06,201,paneer,210,340,130,1,00370,India
623380,2023-09-06,213,bisleri,6,15,9,1,00431,India
623380,2023-09-06,204,strawberry yogurt,50,60,10,1,00431,India
623380,2023-09-06,203,mango yogurt,50,60,10,1,00431,India
623380,2023-09-06,202,milk,12,27,15,1,00431,India
623380,2023-09-06,208,sprite,75,100,25,1,00431,India
928215,2023-09-06,203,mango yogurt,50,60,10,1,00494,India
928215,2023-09-06,212,amul cheese,250,315,65,1,00494,India
928215,2023-09-06,205,classic yogurt,45,60,15,1,00494,India
946164,2023-09-06,204,strawberry yogurt,50,60,10,1,00222,India
946164,2023-09-06,201,paneer,210,340,130,1,00222,India
946164,2023-09-06,207,coca cola,75,100,25,1,00222,India
946164,2023-09-06,211,red bull,90,125,35,1,00222,India
114409,2023-09-06,210,mountain dew,75,100,25,1,00257,India
114409,2023-09-06,207,coca cola,75,100,25,1,00257,India
360696,2023-09-06,205,classic yogurt,45,60,15,1,00345,India
360696,2023-09-06,204,strawberry yogurt,50,60,10,1,00345,India
360696,2023-09-06,212,amul cheese,250,315,65,1,00345,India
831830,2023-09-06,210,mountain dew,75,100,25,1,00368,India
831830,2023-09-06,213,bisleri,6,15,9,1,00368,India
533993,2023-09-06,206,yakult,360,400,40,1,00294,India
728137,2023-09-06,204,strawberry yogurt,50,60,10,1,00497,India
766961,2023-09-06,212,amul cheese,250,315,65,1,00467,India
766961,2023-09-06,207,coca cola,75,100,25,1,00467,India
766961,2023-09-06,213,bisleri,6,15,9,1,00467,India
689299,2023-09-06,206,yakult,360,400,40,1,00386,India
689299,2023-09-06,210,mountain dew,75,100,25,1,00386,India
689299,2023-09-06,209,pepsi,75,100,25,1,00386,India
689299,2023-09-06,201,paneer,210,340,130,1,00386,India
770937,2023-09-06,205,classic yogurt,45,60,15,1,00466,India
770937,2023-09-06,203,mango yogurt,50,60,10,1,00466,India
770937,2023-09-06,213,bisleri,6,15,9,1,00466,India
602089,2023-09-06,205,classic yogurt,45,60,15,1,00023,India
278367,2023-09-06,210,mountain dew,75,100,25,1,00032,India
278367,2023-09-06,211,red bull,90,125,35,1,00032,India
278367,2023-09-06,206,yakult,360,400,40,1,00032,India
224057,2023-09-06,213,bisleri,6,15,9,1,00280,India
224057,2023-09-06,211,red bull,90,125,35,1,00280,India
224057,2023-09-06,209,pepsi,75,100,25,1,00280,India
224057,2023-09-06,203,mango yogurt,50,60,10,1,00280,India
789750,2023-09-06,204,strawberry yogurt,50,60,10,1,00135,India
789750,2023-09-06,207,coca cola,75,100,25,1,00135,India
789750,2023-09-06,212,amul cheese,250,315,65,1,00135,India
699008,2023-09-06,206,yakult,360,400,40,1,00126,India
699008,2023-09-06,212,amul cheese,250,315,65,1,00126,India
699008,2023-09-06,202,milk,12,27,15,1,00126,India
699008,2023-09-06,208,sprite,75,100,25,1,00126,India
703825,2023-09-06,207,coca cola,75,100,25,1,00023,India
703825,2023-09-06,213,bisleri,6,15,9,1,00023,India
703825,2023-09-06,211,red bull,90,125,35,1,00023,India
703825,2023-09-06,209,pepsi,75,100,25,1,00023,India
256799,2023-09-06,211,red bull,90,125,35,1,00384,India
256799,2023-09-06,203,mango yogurt,50,60,10,1,00384,India
256799,2023-09-06,210,mountain dew,75,100,25,1,00384,India
387532,2023-09-06,208,sprite,75,100,25,1,00023,India
387532,2023-09-06,205,classic yogurt,45,60,15,1,00023,India
884804,2023-09-06,207,coca cola,75,100,25,1,00230,India
884804,2023-09-06,203,mango yogurt,50,60,10,1,00230,India
774534,2023-09-06,213,bisleri,6,15,9,1,00045,India
774534,2023-09-06,208,sprite,75,100,25,1,00045,India
962277,2023-09-06,213,bisleri,6,15,9,1,00436,India
962277,2023-09-06,204,strawberry yogurt,50,60,10,1,00436,India
962277,2023-09-06,211,red bull,90,125,35,1,00436,India
962277,2023-09-06,202,milk,12,27,15,1,00436,India
839444,2023-09-06,205,classic yogurt,45,60,15,1,00162,India
839444,2023-09-06,206,yakult,360,400,40,1,00162,India
946920,2023-09-06,203,mango yogurt,50,60,10,1,00148,India
946920,2023-09-06,204,strawberry yogurt,50,60,10,1,00148,India
862885,2023-09-06,213,bisleri,6,15,9,1,00290,India
150117,2023-09-06,201,paneer,210,340,130,1,00443,India
395100,2023-09-06,213,bisleri,6,15,9,1,00023,India
395100,2023-09-06,204,strawberry yogurt,50,60,10,1,00023,India
534179,2023-09-06,211,red bull,90,125,35,1,00248,India
534179,2023-09-06,208,sprite,75,100,25,1,00248,India
534179,2023-09-06,210,mountain dew,75,100,25,1,00248,India
720935,2023-09-06,208,sprite,75,100,25,1,00441,India
720935,2023-09-06,201,paneer,210,340,130,1,00441,India
720935,2023-09-06,207,coca cola,75,100,25,1,00441,India
720935,2023-09-06,212,amul cheese,250,315,65,1,00441,India
296227,2023-09-06,201,paneer,210,340,130,1,00449,India
296227,2023-09-06,208,sprite,75,100,25,1,00449,India
236220,2023-09-06,207,coca cola,75,100,25,1,00207,India
236220,2023-09-06,208,sprite,75,100,25,1,00207,India
236220,2023-09-06,213,bisleri,6,15,9,1,00207,India
896334,2023-09-06,208,sprite,75,100,25,1,00284,India
896334,2023-09-06,206,yakult,360,400,40,1,00284,India
544654,2023-09-06,204,strawberry yogurt,50,60,10,1,00099,India
512043,2023-09-06,208,sprite,75,100,25,1,00426,India
512043,2023-09-06,203,mango yogurt,50,60,10,1,00426,India
512043,2023-09-06,206,yakult,360,400,40,1,00426,India
512043,2023-09-06,204,strawberry yogurt,50,60,10,1,00426,India
594182,2023-09-06,204,strawberry yogurt,50,60,10,1,00254,India
594182,2023-09-06,206,yakult,360,400,40,1,00254,India
594182,2023-09-06,203,mango yogurt,50,60,10,1,00254,India
594182,2023-09-06,211,red bull,90,125,35,1,00254,India
528530,2023-09-06,202,milk,12,27,15,1,00392,India
528530,2023-09-06,207,coca cola,75,100,25,1,00392,India
528530,2023-09-06,206,yakult,360,400,40,1,00392,India
963547,2023-09-06,212,amul cheese,250,315,65,1,00282,India
226685,2023-09-06,211,red bull,90,125,35,1,00365,India
226685,2023-09-06,202,milk,12,27,15,1,00365,India
226685,2023-09-06,203,mango yogurt,50,60,10,1,00365,India
808967,2023-09-06,209,pepsi,75,100,25,1,00409,India
808967,2023-09-06,208,sprite,75,100,25,1,00409,India
808967,2023-09-06,213,bisleri,6,15,9,1,00409,India
259960,2023-09-06,207,coca cola,75,100,25,1,00090,India
259960,2023-09-06,204,strawberry yogurt,50,60,10,1,00090,India
259960,2023-09-06,205,classic yogurt,45,60,15,1,00090,India
227785,2023-09-06,201,paneer,210,340,130,1,00365,India
227785,2023-09-06,209,pepsi,75,100,25,1,00365,India
201497,2023-09-06,209,pepsi,75,100,25,1,00183,India
925952,2023-09-06,205,classic yogurt,45,60,15,1,00181,India
925952,2023-09-06,208,sprite,75,100,25,1,00181,India
925952,2023-09-06,201,paneer,210,340,130,1,00181,India
925952,2023-09-06,211,red bull,90,125,35,1,00181,India
371596,2023-09-06,209,pepsi,75,100,25,1,00001,India
371596,2023-09-06,206,yakult,360,400,40,1,00001,India
101552,2023-09-06,202,milk,12,27,15,1,00192,India
101552,2023-09-06,213,bisleri,6,15,9,1,00192,India
101552,2023-09-06,205,classic yogurt,45,60,15,1,00192,India
101552,2023-09-06,210,mountain dew,75,100,25,1,00192,India
724931,2023-09-06,210,mountain dew,75,100,25,1,00416,India
724931,2023-09-06,212,amul cheese,250,315,65,1,00416,India
673279,2023-09-06,211,red bull,90,125,35,1,00339,India
673279,2023-09-06,213,bisleri,6,15,9,1,00339,India
673279,2023-09-06,202,milk,12,27,15,1,00339,India
673279,2023-09-06,210,mountain dew,75,100,25,1,00339,India
476601,2023-09-06,209,pepsi,75,100,25,1,00422,India
476601,2023-09-06,213,bisleri,6,15,9,1,00422,India
476601,2023-09-06,203,mango yogurt,50,60,10,1,00422,India
898129,2023-09-06,207,coca cola,75,100,25,1,00033,India
898129,2023-09-06,203,mango yogurt,50,60,10,1,00033,India
888565,2023-09-06,209,pepsi,75,100,25,1,00309,India
888565,2023-09-06,213,bisleri,6,15,9,1,00309,India
888565,2023-09-06,211,red bull,90,125,35,1,00309,India
888565,2023-09-06,205,classic yogurt,45,60,15,1,00309,India
888565,2023-09-06,201,paneer,210,340,130,1,00309,India
708127,2023-09-06,212,amul cheese,250,315,65,1,00245,India
602942,2023-09-06,206,yakult,360,400,40,1,00101,India
602942,2023-09-06,207,coca cola,75,100,25,1,00101,India
602942,2023-09-06,213,bisleri,6,15,9,1,00101,India
602942,2023-09-06,208,sprite,75,100,25,1,00101,India
306138,2023-09-06,211,red bull,90,125,35,1,00396,India
622829,2023-09-06,203,mango yogurt,50,60,10,1,00065,India
622829,2023-09-06,201,paneer,210,340,130,1,00065,India
622829,2023-09-06,210,mountain dew,75,100,25,1,00065,India
570721,2023-09-06,213,bisleri,6,15,9,1,00104,India
570721,2023-09-06,210,mountain dew,75,100,25,1,00104,India
477799,2023-09-06,208,sprite,75,100,25,1,00317,India
477799,2023-09-06,212,amul cheese,250,315,65,1,00317,India
540763,2023-09-06,209,pepsi,75,100,25,1,00366,India
540763,2023-09-06,208,sprite,75,100,25,1,00366,India
540763,2023-09-06,211,red bull,90,125,35,1,00366,India
276656,2023-09-06,211,red bull,90,125,35,1,00208,India
276656,2023-09-06,207,coca cola,75,100,25,1,00208,India
276656,2023-09-06,206,yakult,360,400,40,1,00208,India
276656,2023-09-06,212,amul cheese,250,315,65,1,00208,India
479348,2023-09-06,201,paneer,210,340,130,1,00320,India
479348,2023-09-06,202,milk,12,27,15,1,00320,India
677807,2023-09-06,212,amul cheese,250,315,65,1,00032,India
507713,2023-09-07,208,sprite,75,100,25,1,00003,India
507713,2023-09-07,202,milk,12,27,15,1,00003,India
507713,2023-09-07,210,mountain dew,75,100,25,1,00003,India
507713,2023-09-07,207,coca cola,75,100,25,1,00003,India
587077,2023-09-07,203,mango yogurt,50,60,10,1,00337,India
883761,2023-09-07,213,bisleri,6,15,9,1,00063,India
773071,2023-09-07,211,red bull,90,125,35,1,00262,India
773071,2023-09-07,209,pepsi,75,100,25,1,00262,India
773071,2023-09-07,210,mountain dew,75,100,25,1,00262,India
773071,2023-09-07,208,sprite,75,100,25,1,00262,India
396514,2023-09-07,202,milk,12,27,15,1,00130,India
396514,2023-09-07,208,sprite,75,100,25,1,00130,India
396514,2023-09-07,207,coca cola,75,100,25,1,00130,India
719799,2023-09-07,212,amul cheese,250,315,65,1,00480,India
719799,2023-09-07,213,bisleri,6,15,9,1,00480,India
916709,2023-09-07,205,classic yogurt,45,60,15,1,00043,India
131966,2023-09-07,206,yakult,360,400,40,1,00049,India
131966,2023-09-07,209,pepsi,75,100,25,1,00049,India
131966,2023-09-07,207,coca cola,75,100,25,1,00049,India
522018,2023-09-07,210,mountain dew,75,100,25,1,00262,India
522018,2023-09-07,205,classic yogurt,45,60,15,1,00262,India
522018,2023-09-07,208,sprite,75,100,25,1,00262,India
604490,2023-09-07,205,classic yogurt,45,60,15,1,00308,India
604490,2023-09-07,209,pepsi,75,100,25,1,00308,India
604490,2023-09-07,213,bisleri,6,15,9,1,00308,India
513681,2023-09-07,206,yakult,360,400,40,1,00099,India
513681,2023-09-07,202,milk,12,27,15,1,00099,India
513681,2023-09-07,211,red bull,90,125,35,1,00099,India
513681,2023-09-07,205,classic yogurt,45,60,15,1,00099,India
513681,2023-09-07,208,sprite,75,100,25,1,00099,India
754050,2023-09-07,208,sprite,75,100,25,1,00452,India
754050,2023-09-07,211,red bull,90,125,35,1,00452,India
754050,2023-09-07,203,mango yogurt,50,60,10,1,00452,India
645041,2023-09-07,204,strawberry yogurt,50,60,10,1,00333,India
645041,2023-09-07,213,bisleri,6,15,9,1,00333,India
645041,2023-09-07,202,milk,12,27,15,1,00333,India
645041,2023-09-07,206,yakult,360,400,40,1,00333,India
645041,2023-09-07,205,classic yogurt,45,60,15,1,00333,India
509022,2023-09-07,213,bisleri,6,15,9,1,00017,India
993598,2023-09-07,203,mango yogurt,50,60,10,1,00346,India
993598,2023-09-07,205,classic yogurt,45,60,15,1,00346,India
993598,2023-09-07,209,pepsi,75,100,25,1,00346,India
161121,2023-09-07,209,pepsi,75,100,25,1,00100,India
299795,2023-09-07,210,mountain dew,75,100,25,1,00199,India
299795,2023-09-07,207,coca cola,75,100,25,1,00199,India
299795,2023-09-07,206,yakult,360,400,40,1,00199,India
101595,2023-09-07,209,pepsi,75,100,25,1,00474,India
720921,2023-09-07,203,mango yogurt,50,60,10,1,00143,India
720921,2023-09-07,205,classic yogurt,45,60,15,1,00143,India
720921,2023-09-07,209,pepsi,75,100,25,1,00143,India
654692,2023-09-07,201,paneer,210,340,130,1,00348,India
654692,2023-09-07,203,mango yogurt,50,60,10,1,00348,India
654692,2023-09-07,208,sprite,75,100,25,1,00348,India
635767,2023-09-07,211,red bull,90,125,35,1,00155,India
635767,2023-09-07,202,milk,12,27,15,1,00155,India
361382,2023-09-07,208,sprite,75,100,25,1,00360,India
361382,2023-09-07,207,coca cola,75,100,25,1,00360,India
702747,2023-09-07,209,pepsi,75,100,25,1,00395,India
702747,2023-09-07,213,bisleri,6,15,9,1,00395,India
571815,2023-09-07,202,milk,12,27,15,1,00116,India
571815,2023-09-07,204,strawberry yogurt,50,60,10,1,00116,India
571815,2023-09-07,206,yakult,360,400,40,1,00116,India
571815,2023-09-07,203,mango yogurt,50,60,10,1,00116,India
686950,2023-09-07,201,paneer,210,340,130,1,00200,India
686950,2023-09-07,212,amul cheese,250,315,65,1,00200,India
686950,2023-09-07,202,milk,12,27,15,1,00200,India
273603,2023-09-07,211,red bull,90,125,35,1,00434,India
273603,2023-09-07,212,amul cheese,250,315,65,1,00434,India
273603,2023-09-07,208,sprite,75,100,25,1,00434,India
351373,2023-09-07,208,sprite,75,100,25,1,00185,India
351373,2023-09-07,205,classic yogurt,45,60,15,1,00185,India
351373,2023-09-07,206,yakult,360,400,40,1,00185,India
454261,2023-09-07,211,red bull,90,125,35,1,00374,India
412412,2023-09-07,210,mountain dew,75,100,25,1,00366,India
412412,2023-09-07,211,red bull,90,125,35,1,00366,India
183422,2023-09-07,212,amul cheese,250,315,65,1,00049,India
693904,2023-09-07,206,yakult,360,400,40,1,00460,India
693904,2023-09-07,209,pepsi,75,100,25,1,00460,India
693904,2023-09-07,208,sprite,75,100,25,1,00460,India
725948,2023-09-07,213,bisleri,6,15,9,1,00047,India
725948,2023-09-07,212,amul cheese,250,315,65,1,00047,India
725948,2023-09-07,204,strawberry yogurt,50,60,10,1,00047,India
725948,2023-09-07,209,pepsi,75,100,25,1,00047,India
128920,2023-09-07,212,amul cheese,250,315,65,1,00320,India
788767,2023-09-07,210,mountain dew,75,100,25,1,00210,India
748856,2023-09-07,204,strawberry yogurt,50,60,10,1,00411,India
748856,2023-09-07,206,yakult,360,400,40,1,00411,India
930270,2023-09-07,213,bisleri,6,15,9,1,00005,India
519874,2023-09-07,205,classic yogurt,45,60,15,1,00472,India
519874,2023-09-07,206,yakult,360,400,40,1,00472,India
776890,2023-09-07,204,strawberry yogurt,50,60,10,1,00230,India
265246,2023-09-07,204,strawberry yogurt,50,60,10,1,00452,India
265246,2023-09-07,201,paneer,210,340,130,1,00452,India
265246,2023-09-07,205,classic yogurt,45,60,15,1,00452,India
265246,2023-09-07,207,coca cola,75,100,25,1,00452,India
740800,2023-09-07,206,yakult,360,400,40,1,00047,India
159675,2023-09-07,203,mango yogurt,50,60,10,1,00419,India
159675,2023-09-07,205,classic yogurt,45,60,15,1,00419,India
159675,2023-09-07,202,milk,12,27,15,1,00419,India
159675,2023-09-07,210,mountain dew,75,100,25,1,00419,India
762237,2023-09-07,202,milk,12,27,15,1,00234,India
341553,2023-09-07,202,milk,12,27,15,1,00089,India
341553,2023-09-07,210,mountain dew,75,100,25,1,00089,India
341553,2023-09-07,209,pepsi,75,100,25,1,00089,India
299230,2023-09-07,213,bisleri,6,15,9,1,00118,India
299230,2023-09-07,204,strawberry yogurt,50,60,10,1,00118,India
533865,2023-09-07,202,milk,12,27,15,1,00375,India
533865,2023-09-07,203,mango yogurt,50,60,10,1,00375,India
533865,2023-09-07,213,bisleri,6,15,9,1,00375,India
533865,2023-09-07,204,strawberry yogurt,50,60,10,1,00375,India
290557,2023-09-07,205,classic yogurt,45,60,15,1,00313,India
290557,2023-09-07,201,paneer,210,340,130,1,00313,India
290557,2023-09-07,206,yakult,360,400,40,1,00313,India
290557,2023-09-07,204,strawberry yogurt,50,60,10,1,00313,India
968166,2023-09-07,205,classic yogurt,45,60,15,1,00409,India
968166,2023-09-07,213,bisleri,6,15,9,1,00409,India
968166,2023-09-07,208,sprite,75,100,25,1,00409,India
968166,2023-09-07,203,mango yogurt,50,60,10,1,00409,India
968166,2023-09-07,206,yakult,360,400,40,1,00409,India
271513,2023-09-07,209,pepsi,75,100,25,1,00207,India
271513,2023-09-07,201,paneer,210,340,130,1,00207,India
271513,2023-09-07,210,mountain dew,75,100,25,1,00207,India
953753,2023-09-07,210,mountain dew,75,100,25,1,00334,India
953753,2023-09-07,208,sprite,75,100,25,1,00334,India
278277,2023-09-07,208,sprite,75,100,25,1,00443,India
278277,2023-09-07,210,mountain dew,75,100,25,1,00443,India
626207,2023-09-07,205,classic yogurt,45,60,15,1,00055,India
626207,2023-09-07,204,strawberry yogurt,50,60,10,1,00055,India
626207,2023-09-07,201,paneer,210,340,130,1,00055,India
626207,2023-09-07,212,amul cheese,250,315,65,1,00055,India
926352,2023-09-07,205,classic yogurt,45,60,15,1,00214,India
926352,2023-09-07,207,coca cola,75,100,25,1,00214,India
926352,2023-09-07,209,pepsi,75,100,25,1,00214,India
926352,2023-09-07,203,mango yogurt,50,60,10,1,00214,India
924325,2023-09-07,212,amul cheese,250,315,65,1,00006,India
924325,2023-09-07,203,mango yogurt,50,60,10,1,00006,India
924325,2023-09-07,204,strawberry yogurt,50,60,10,1,00006,India
924325,2023-09-07,202,milk,12,27,15,1,00006,India
605298,2023-09-07,203,mango yogurt,50,60,10,1,00411,India
223517,2023-09-07,205,classic yogurt,45,60,15,1,00327,India
223517,2023-09-07,212,amul cheese,250,315,65,1,00327,India
223517,2023-09-07,201,paneer,210,340,130,1,00327,India
418981,2023-09-07,206,yakult,360,400,40,1,00213,India
418981,2023-09-07,207,coca cola,75,100,25,1,00213,India
418981,2023-09-07,205,classic yogurt,45,60,15,1,00213,India
418981,2023-09-07,210,mountain dew,75,100,25,1,00213,India
694543,2023-09-07,213,bisleri,6,15,9,1,00426,India
694543,2023-09-07,208,sprite,75,100,25,1,00426,India
703909,2023-09-07,207,coca cola,75,100,25,1,00039,India
703909,2023-09-07,212,amul cheese,250,315,65,1,00039,India
703909,2023-09-07,204,strawberry yogurt,50,60,10,1,00039,India
703909,2023-09-07,213,bisleri,6,15,9,1,00039,India
703909,2023-09-07,201,paneer,210,340,130,1,00039,India
886637,2023-09-07,208,sprite,75,100,25,1,00382,India
886637,2023-09-07,213,bisleri,6,15,9,1,00382,India
886637,2023-09-07,209,pepsi,75,100,25,1,00382,India
886637,2023-09-07,211,red bull,90,125,35,1,00382,India
239224,2023-09-07,213,bisleri,6,15,9,1,00222,India
239224,2023-09-07,209,pepsi,75,100,25,1,00222,India
667376,2023-09-07,205,classic yogurt,45,60,15,1,00409,India
667376,2023-09-07,211,red bull,90,125,35,1,00409,India
667376,2023-09-07,213,bisleri,6,15,9,1,00409,India
667376,2023-09-07,208,sprite,75,100,25,1,00409,India
729202,2023-09-07,213,bisleri,6,15,9,1,00429,India
729202,2023-09-07,212,amul cheese,250,315,65,1,00429,India
729202,2023-09-07,204,strawberry yogurt,50,60,10,1,00429,India
729202,2023-09-07,211,red bull,90,125,35,1,00429,India
150134,2023-09-07,202,milk,12,27,15,1,00057,India
150134,2023-09-07,213,bisleri,6,15,9,1,00057,India
252428,2023-09-07,212,amul cheese,250,315,65,1,00442,India
252428,2023-09-07,208,sprite,75,100,25,1,00442,India
924915,2023-09-07,202,milk,12,27,15,1,00211,India
125069,2023-09-07,207,coca cola,75,100,25,1,00211,India
125069,2023-09-07,208,sprite,75,100,25,1,00211,India
400637,2023-09-07,209,pepsi,75,100,25,1,00116,India
400637,2023-09-07,207,coca cola,75,100,25,1,00116,India
400637,2023-09-07,201,paneer,210,340,130,1,00116,India
427415,2023-09-07,205,classic yogurt,45,60,15,1,00151,India
427415,2023-09-07,202,milk,12,27,15,1,00151,India
427415,2023-09-07,213,bisleri,6,15,9,1,00151,India
427415,2023-09-07,211,red bull,90,125,35,1,00151,India
637460,2023-09-07,202,milk,12,27,15,1,00334,India
637460,2023-09-07,211,red bull,90,125,35,1,00334,India
637460,2023-09-07,209,pepsi,75,100,25,1,00334,India
637460,2023-09-07,205,classic yogurt,45,60,15,1,00334,India
637460,2023-09-07,210,mountain dew,75,100,25,1,00334,India
908365,2023-09-07,203,mango yogurt,50,60,10,1,00316,India
733373,2023-09-07,212,amul cheese,250,315,65,1,00404,India
733373,2023-09-07,207,coca cola,75,100,25,1,00404,India
733373,2023-09-07,203,mango yogurt,50,60,10,1,00404,India
476297,2023-09-07,208,sprite,75,100,25,1,00016,India
476297,2023-09-07,207,coca cola,75,100,25,1,00016,India
476297,2023-09-07,212,amul cheese,250,315,65,1,00016,India
476297,2023-09-07,210,mountain dew,75,100,25,1,00016,India
562884,2023-09-07,207,coca cola,75,100,25,1,00366,India
562884,2023-09-07,201,paneer,210,340,130,1,00366,India
562884,2023-09-07,205,classic yogurt,45,60,15,1,00366,India
934614,2023-09-07,211,red bull,90,125,35,1,00491,India
934614,2023-09-07,201,paneer,210,340,130,1,00491,India
934614,2023-09-07,202,milk,12,27,15,1,00491,India
934614,2023-09-07,208,sprite,75,100,25,1,00491,India
729417,2023-09-07,208,sprite,75,100,25,1,00477,India
729417,2023-09-07,201,paneer,210,340,130,1,00477,India
729417,2023-09-07,212,amul cheese,250,315,65,1,00477,India
729417,2023-09-07,203,mango yogurt,50,60,10,1,00477,India
244471,2023-09-07,208,sprite,75,100,25,1,00429,India
244471,2023-09-07,213,bisleri,6,15,9,1,00429,India
244471,2023-09-07,209,pepsi,75,100,25,1,00429,India
864490,2023-09-08,201,paneer,210,340,130,1,00227,India
602723,2023-09-08,202,milk,12,27,15,1,00384,India
602723,2023-09-08,201,paneer,210,340,130,1,00384,India
269912,2023-09-08,206,yakult,360,400,40,1,00436,India
269912,2023-09-08,201,paneer,210,340,130,1,00436,India
405670,2023-09-08,212,amul cheese,250,315,65,1,00489,India
405670,2023-09-08,203,mango yogurt,50,60,10,1,00489,India
405670,2023-09-08,208,sprite,75,100,25,1,00489,India
612991,2023-09-08,204,strawberry yogurt,50,60,10,1,00139,India
293034,2023-09-08,202,milk,12,27,15,1,00341,India
293034,2023-09-08,207,coca cola,75,100,25,1,00341,India
293034,2023-09-08,212,amul cheese,250,315,65,1,00341,India
845313,2023-09-08,208,sprite,75,100,25,1,00308,India
845313,2023-09-08,212,amul cheese,250,315,65,1,00308,India
845313,2023-09-08,210,mountain dew,75,100,25,1,00308,India
305438,2023-09-08,212,amul cheese,250,315,65,1,00199,India
305438,2023-09-08,207,coca cola,75,100,25,1,00199,India
305438,2023-09-08,204,strawberry yogurt,50,60,10,1,00199,India
305438,2023-09-08,206,yakult,360,400,40,1,00199,India
390979,2023-09-08,208,sprite,75,100,25,1,00138,India
390979,2023-09-08,204,strawberry yogurt,50,60,10,1,00138,India
564981,2023-09-08,201,paneer,210,340,130,1,00368,India
564981,2023-09-08,211,red bull,90,125,35,1,00368,India
564981,2023-09-08,213,bisleri,6,15,9,1,00368,India
564981,2023-09-08,206,yakult,360,400,40,1,00368,India
827913,2023-09-08,205,classic yogurt,45,60,15,1,00085,India
827913,2023-09-08,212,amul cheese,250,315,65,1,00085,India
852286,2023-09-08,202,milk,12,27,15,1,00358,India
852286,2023-09-08,201,paneer,210,340,130,1,00358,India
852286,2023-09-08,206,yakult,360,400,40,1,00358,India
852286,2023-09-08,207,coca cola,75,100,25,1,00358,India
852286,2023-09-08,210,mountain dew,75,100,25,1,00358,India
759339,2023-09-08,210,mountain dew,75,100,25,1,00145,India
759339,2023-09-08,204,strawberry yogurt,50,60,10,1,00145,India
759339,2023-09-08,213,bisleri,6,15,9,1,00145,India
279510,2023-09-08,212,amul cheese,250,315,65,1,00095,India
279510,2023-09-08,201,paneer,210,340,130,1,00095,India
279510,2023-09-08,207,coca cola,75,100,25,1,00095,India
203257,2023-09-08,206,yakult,360,400,40,1,00093,India
203257,2023-09-08,213,bisleri,6,15,9,1,00093,India
203257,2023-09-08,212,amul cheese,250,315,65,1,00093,India
345107,2023-09-08,209,pepsi,75,100,25,1,00338,India
345107,2023-09-08,207,coca cola,75,100,25,1,00338,India
207172,2023-09-08,212,amul cheese,250,315,65,1,00338,India
207172,2023-09-08,206,yakult,360,400,40,1,00338,India
207172,2023-09-08,201,paneer,210,340,130,1,00338,India
207172,2023-09-08,203,mango yogurt,50,60,10,1,00338,India
215756,2023-09-08,210,mountain dew,75,100,25,1,00399,India
215756,2023-09-08,203,mango yogurt,50,60,10,1,00399,India
215756,2023-09-08,208,sprite,75,100,25,1,00399,India
215756,2023-09-08,205,classic yogurt,45,60,15,1,00399,India
215756,2023-09-08,207,coca cola,75,100,25,1,00399,India
769610,2023-09-08,212,amul cheese,250,315,65,1,00165,India
769610,2023-09-08,210,mountain dew,75,100,25,1,00165,India
769610,2023-09-08,207,coca cola,75,100,25,1,00165,India
769610,2023-09-08,211,red bull,90,125,35,1,00165,India
400202,2023-09-08,211,red bull,90,125,35,1,00359,India
400202,2023-09-08,202,milk,12,27,15,1,00359,India
400202,2023-09-08,201,paneer,210,340,130,1,00359,India
653847,2023-09-08,209,pepsi,75,100,25,1,00288,India
653847,2023-09-08,211,red bull,90,125,35,1,00288,India
653847,2023-09-08,204,strawberry yogurt,50,60,10,1,00288,India
653847,2023-09-08,207,coca cola,75,100,25,1,00288,India
653847,2023-09-08,202,milk,12,27,15,1,00288,India
136285,2023-09-08,211,red bull,90,125,35,1,00446,India
136285,2023-09-08,208,sprite,75,100,25,1,00446,India
136285,2023-09-08,204,strawberry yogurt,50,60,10,1,00446,India
136285,2023-09-08,212,amul cheese,250,315,65,1,00446,India
688854,2023-09-08,211,red bull,90,125,35,1,00435,India
167183,2023-09-08,210,mountain dew,75,100,25,1,00341,India
167183,2023-09-08,206,yakult,360,400,40,1,00341,India
837690,2023-09-08,206,yakult,360,400,40,1,00349,India
837690,2023-09-08,202,milk,12,27,15,1,00349,India
837690,2023-09-08,210,mountain dew,75,100,25,1,00349,India
900904,2023-09-08,203,mango yogurt,50,60,10,1,00285,India
233224,2023-09-08,211,red bull,90,125,35,1,00459,India
233224,2023-09-08,213,bisleri,6,15,9,1,00459,India
233224,2023-09-08,201,paneer,210,340,130,1,00459,India
233224,2023-09-08,212,amul cheese,250,315,65,1,00459,India
723490,2023-09-08,205,classic yogurt,45,60,15,1,00045,India
723490,2023-09-08,209,pepsi,75,100,25,1,00045,India
723490,2023-09-08,211,red bull,90,125,35,1,00045,India
996115,2023-09-08,205,classic yogurt,45,60,15,1,00032,India
996115,2023-09-08,207,coca cola,75,100,25,1,00032,India
996115,2023-09-08,212,amul cheese,250,315,65,1,00032,India
996115,2023-09-08,204,strawberry yogurt,50,60,10,1,00032,India
972754,2023-09-08,210,mountain dew,75,100,25,1,00498,India
972754,2023-09-08,213,bisleri,6,15,9,1,00498,India
972754,2023-09-08,212,amul cheese,250,315,65,1,00498,India
732810,2023-09-08,201,paneer,210,340,130,1,00233,India
732810,2023-09-08,209,pepsi,75,100,25,1,00233,India
732810,2023-09-08,211,red bull,90,125,35,1,00233,India
732810,2023-09-08,210,mountain dew,75,100,25,1,00233,India
975152,2023-09-08,206,yakult,360,400,40,1,00153,India
975152,2023-09-08,212,amul cheese,250,315,65,1,00153,India
975152,2023-09-08,209,pepsi,75,100,25,1,00153,India
422213,2023-09-08,205,classic yogurt,45,60,15,1,00286,India
535643,2023-09-08,213,bisleri,6,15,9,1,00231,India
535643,2023-09-08,202,milk,12,27,15,1,00231,India
535643,2023-09-08,201,paneer,210,340,130,1,00231,India
544201,2023-09-08,213,bisleri,6,15,9,1,00257,India
544201,2023-09-08,211,red bull,90,125,35,1,00257,India
544201,2023-09-08,209,pepsi,75,100,25,1,00257,India
583719,2023-09-08,205,classic yogurt,45,60,15,1,00468,India
876118,2023-09-08,207,coca cola,75,100,25,1,00170,India
397478,2023-09-08,204,strawberry yogurt,50,60,10,1,00176,India
397478,2023-09-08,205,classic yogurt,45,60,15,1,00176,India
397478,2023-09-08,211,red bull,90,125,35,1,00176,India
196616,2023-09-08,202,milk,12,27,15,1,00368,India
196616,2023-09-08,211,red bull,90,125,35,1,00368,India
196616,2023-09-08,208,sprite,75,100,25,1,00368,India
276320,2023-09-08,203,mango yogurt,50,60,10,1,00473,India
276320,2023-09-08,209,pepsi,75,100,25,1,00473,India
276320,2023-09-08,208,sprite,75,100,25,1,00473,India
276320,2023-09-08,205,classic yogurt,45,60,15,1,00473,India
276320,2023-09-08,212,amul cheese,250,315,65,1,00473,India
898862,2023-09-08,213,bisleri,6,15,9,1,00327,India
153139,2023-09-08,206,yakult,360,400,40,1,00007,India
153139,2023-09-08,203,mango yogurt,50,60,10,1,00007,India
153139,2023-09-08,211,red bull,90,125,35,1,00007,India
842473,2023-09-08,201,paneer,210,340,130,1,00167,India
477866,2023-09-08,210,mountain dew,75,100,25,1,00341,India
477866,2023-09-08,205,classic yogurt,45,60,15,1,00341,India
477866,2023-09-08,204,strawberry yogurt,50,60,10,1,00341,India
210059,2023-09-08,205,classic yogurt,45,60,15,1,00116,India
210059,2023-09-08,211,red bull,90,125,35,1,00116,India
210059,2023-09-08,202,milk,12,27,15,1,00116,India
150688,2023-09-08,202,milk,12,27,15,1,00495,India
150688,2023-09-08,204,strawberry yogurt,50,60,10,1,00495,India
150688,2023-09-08,206,yakult,360,400,40,1,00495,India
150688,2023-09-08,211,red bull,90,125,35,1,00495,India
242359,2023-09-08,201,paneer,210,340,130,1,00016,India
242359,2023-09-08,206,yakult,360,400,40,1,00016,India
242359,2023-09-08,211,red bull,90,125,35,1,00016,India
264545,2023-09-08,208,sprite,75,100,25,1,00057,India
195229,2023-09-08,212,amul cheese,250,315,65,1,00294,India
195229,2023-09-08,206,yakult,360,400,40,1,00294,India
195229,2023-09-08,208,sprite,75,100,25,1,00294,India
195229,2023-09-08,207,coca cola,75,100,25,1,00294,India
195229,2023-09-08,209,pepsi,75,100,25,1,00294,India
639159,2023-09-08,210,mountain dew,75,100,25,1,00431,India
639159,2023-09-08,205,classic yogurt,45,60,15,1,00431,India
639159,2023-09-08,206,yakult,360,400,40,1,00431,India
508983,2023-09-08,205,classic yogurt,45,60,15,1,00492,India
508983,2023-09-08,213,bisleri,6,15,9,1,00492,India
508983,2023-09-08,204,strawberry yogurt,50,60,10,1,00492,India
508983,2023-09-08,202,milk,12,27,15,1,00492,India
508983,2023-09-08,206,yakult,360,400,40,1,00492,India
511608,2023-09-08,206,yakult,360,400,40,1,00001,India
511608,2023-09-08,204,strawberry yogurt,50,60,10,1,00001,India
511608,2023-09-08,212,amul cheese,250,315,65,1,00001,India
808639,2023-09-08,202,milk,12,27,15,1,00158,India
808639,2023-09-08,207,coca cola,75,100,25,1,00158,India
534967,2023-09-08,208,sprite,75,100,25,1,00336,India
534967,2023-09-08,213,bisleri,6,15,9,1,00336,India
534967,2023-09-08,203,mango yogurt,50,60,10,1,00336,India
534967,2023-09-08,202,milk,12,27,15,1,00336,India
534967,2023-09-08,209,pepsi,75,100,25,1,00336,India
558497,2023-09-08,211,red bull,90,125,35,1,00074,India
558497,2023-09-08,205,classic yogurt,45,60,15,1,00074,India
370089,2023-09-08,202,milk,12,27,15,1,00090,India
806175,2023-09-08,210,mountain dew,75,100,25,1,00247,India
806175,2023-09-08,213,bisleri,6,15,9,1,00247,India
806175,2023-09-08,209,pepsi,75,100,25,1,00247,India
584562,2023-09-08,206,yakult,360,400,40,1,00162,India
426349,2023-09-08,212,amul cheese,250,315,65,1,00484,India
624581,2023-09-08,208,sprite,75,100,25,1,00496,India
400771,2023-09-08,206,yakult,360,400,40,1,00313,India
400771,2023-09-08,204,strawberry yogurt,50,60,10,1,00313,India
400771,2023-09-08,211,red bull,90,125,35,1,00313,India
400771,2023-09-08,207,coca cola,75,100,25,1,00313,India
697662,2023-09-08,209,pepsi,75,100,25,1,00423,India
697662,2023-09-08,212,amul cheese,250,315,65,1,00423,India
697662,2023-09-08,205,classic yogurt,45,60,15,1,00423,India
697662,2023-09-08,201,paneer,210,340,130,1,00423,India
527025,2023-09-08,212,amul cheese,250,315,65,1,00114,India
527025,2023-09-08,202,milk,12,27,15,1,00114,India
527025,2023-09-08,206,yakult,360,400,40,1,00114,India
527025,2023-09-08,210,mountain dew,75,100,25,1,00114,India
527025,2023-09-08,208,sprite,75,100,25,1,00114,India
549148,2023-09-08,209,pepsi,75,100,25,1,00180,India
661647,2023-09-08,211,red bull,90,125,35,1,00278,India
661647,2023-09-08,210,mountain dew,75,100,25,1,00278,India
661647,2023-09-08,213,bisleri,6,15,9,1,00278,India
661647,2023-09-08,204,strawberry yogurt,50,60,10,1,00278,India
661647,2023-09-08,205,classic yogurt,45,60,15,1,00278,India
301198,2023-09-08,201,paneer,210,340,130,1,00378,India
301198,2023-09-08,206,yakult,360,400,40,1,00378,India
301198,2023-09-08,208,sprite,75,100,25,1,00378,India
905799,2023-09-08,206,yakult,360,400,40,1,00257,India
905799,2023-09-08,209,pepsi,75,100,25,1,00257,India
905799,2023-09-08,205,classic yogurt,45,60,15,1,00257,India
465655,2023-09-08,203,mango yogurt,50,60,10,1,00302,India
465655,2023-09-08,206,yakult,360,400,40,1,00302,India
465655,2023-09-08,209,pepsi,75,100,25,1,00302,India
465655,2023-09-08,212,amul cheese,250,315,65,1,00302,India
359381,2023-09-08,202,milk,12,27,15,1,00367,India
359381,2023-09-08,208,sprite,75,100,25,1,00367,India
359381,2023-09-08,213,bisleri,6,15,9,1,00367,India
799305,2023-09-08,211,red bull,90,125,35,1,00316,India
757371,2023-09-08,208,sprite,75,100,25,1,00243,India
757371,2023-09-08,201,paneer,210,340,130,1,00243,India
757371,2023-09-08,213,bisleri,6,15,9,1,00243,India
226392,2023-09-08,208,sprite,75,100,25,1,00249,India
226392,2023-09-08,209,pepsi,75,100,25,1,00249,India
226392,2023-09-08,204,strawberry yogurt,50,60,10,1,00249,India
921245,2023-09-08,207,coca cola,75,100,25,1,00476,India
921245,2023-09-08,204,strawberry yogurt,50,60,10,1,00476,India
921245,2023-09-08,211,red bull,90,125,35,1,00476,India
133215,2023-09-08,210,mountain dew,75,100,25,1,00373,India
299660,2023-09-08,204,strawberry yogurt,50,60,10,1,00197,India
299660,2023-09-08,207,coca cola,75,100,25,1,00197,India
846016,2023-09-08,209,pepsi,75,100,25,1,00293,India
103653,2023-09-08,209,pepsi,75,100,25,1,00008,India
103653,2023-09-08,206,yakult,360,400,40,1,00008,India
103653,2023-09-08,211,red bull,90,125,35,1,00008,India
103653,2023-09-08,204,strawberry yogurt,50,60,10,1,00008,India
103653,2023-09-08,210,mountain dew,75,100,25,1,00008,India
795540,2023-09-08,211,red bull,90,125,35,1,00450,India
795540,2023-09-08,208,sprite,75,100,25,1,00450,India
795540,2023-09-08,210,mountain dew,75,100,25,1,00450,India
227904,2023-09-08,212,amul cheese,250,315,65,1,00038,India
227904,2023-09-08,211,red bull,90,125,35,1,00038,India
227904,2023-09-08,213,bisleri,6,15,9,1,00038,India
139086,2023-09-08,212,amul cheese,250,315,65,1,00290,India
139086,2023-09-08,202,milk,12,27,15,1,00290,India
139086,2023-09-08,208,sprite,75,100,25,1,00290,India
139086,2023-09-08,204,strawberry yogurt,50,60,10,1,00290,India
139086,2023-09-08,203,mango yogurt,50,60,10,1,00290,India
998777,2023-09-09,207,coca cola,75,100,25,1,00206,India
998777,2023-09-09,206,yakult,360,400,40,1,00206,India
998777,2023-09-09,211,red bull,90,125,35,1,00206,India
998777,2023-09-09,201,paneer,210,340,130,1,00206,India
239970,2023-09-09,208,sprite,75,100,25,1,00493,India
661118,2023-09-09,209,pepsi,75,100,25,1,00287,India
350378,2023-09-09,213,bisleri,6,15,9,1,00321,India
350378,2023-09-09,209,pepsi,75,100,25,1,00321,India
350378,2023-09-09,202,milk,12,27,15,1,00321,India
673264,2023-09-09,211,red bull,90,125,35,1,00091,India
673264,2023-09-09,212,amul cheese,250,315,65,1,00091,India
839763,2023-09-09,204,strawberry yogurt,50,60,10,1,00042,India
839763,2023-09-09,203,mango yogurt,50,60,10,1,00042,India
839763,2023-09-09,206,yakult,360,400,40,1,00042,India
839763,2023-09-09,202,milk,12,27,15,1,00042,India
652651,2023-09-09,205,classic yogurt,45,60,15,1,00402,India
652651,2023-09-09,202,milk,12,27,15,1,00402,India
342268,2023-09-09,210,mountain dew,75,100,25,1,00183,India
342268,2023-09-09,209,pepsi,75,100,25,1,00183,India
342268,2023-09-09,205,classic yogurt,45,60,15,1,00183,India
342268,2023-09-09,206,yakult,360,400,40,1,00183,India
147993,2023-09-09,211,red bull,90,125,35,1,00071,India
147993,2023-09-09,209,pepsi,75,100,25,1,00071,India
147993,2023-09-09,213,bisleri,6,15,9,1,00071,India
147993,2023-09-09,201,paneer,210,340,130,1,00071,India
147993,2023-09-09,205,classic yogurt,45,60,15,1,00071,India
965720,2023-09-09,213,bisleri,6,15,9,1,00417,India
965720,2023-09-09,201,paneer,210,340,130,1,00417,India
965720,2023-09-09,205,classic yogurt,45,60,15,1,00417,India
965720,2023-09-09,204,strawberry yogurt,50,60,10,1,00417,India
119661,2023-09-09,204,strawberry yogurt,50,60,10,1,00405,India
119661,2023-09-09,209,pepsi,75,100,25,1,00405,India
381442,2023-09-09,213,bisleri,6,15,9,1,00218,India
381442,2023-09-09,201,paneer,210,340,130,1,00218,India
107276,2023-09-09,213,bisleri,6,15,9,1,00500,India
107276,2023-09-09,211,red bull,90,125,35,1,00500,India
107276,2023-09-09,202,milk,12,27,15,1,00500,India
107276,2023-09-09,208,sprite,75,100,25,1,00500,India
600075,2023-09-09,205,classic yogurt,45,60,15,1,00166,India
600075,2023-09-09,206,yakult,360,400,40,1,00166,India
600075,2023-09-09,204,strawberry yogurt,50,60,10,1,00166,India
806673,2023-09-09,201,paneer,210,340,130,1,00452,India
806673,2023-09-09,213,bisleri,6,15,9,1,00452,India
806673,2023-09-09,202,milk,12,27,15,1,00452,India
316978,2023-09-09,205,classic yogurt,45,60,15,1,00477,India
942518,2023-09-09,205,classic yogurt,45,60,15,1,00163,India
660493,2023-09-09,207,coca cola,75,100,25,1,00140,India
763944,2023-09-09,204,strawberry yogurt,50,60,10,1,00101,India
763944,2023-09-09,202,milk,12,27,15,1,00101,India
790715,2023-09-09,203,mango yogurt,50,60,10,1,00490,India
790715,2023-09-09,205,classic yogurt,45,60,15,1,00490,India
790715,2023-09-09,209,pepsi,75,100,25,1,00490,India
106044,2023-09-09,201,paneer,210,340,130,1,00067,India
106044,2023-09-09,206,yakult,360,400,40,1,00067,India
106044,2023-09-09,209,pepsi,75,100,25,1,00067,India
106044,2023-09-09,208,sprite,75,100,25,1,00067,India
106044,2023-09-09,203,mango yogurt,50,60,10,1,00067,India
259117,2023-09-09,213,bisleri,6,15,9,1,00471,India
259117,2023-09-09,212,amul cheese,250,315,65,1,00471,India
259117,2023-09-09,210,mountain dew,75,100,25,1,00471,India
259117,2023-09-09,203,mango yogurt,50,60,10,1,00471,India
862342,2023-09-09,204,strawberry yogurt,50,60,10,1,00342,India
287032,2023-09-09,201,paneer,210,340,130,1,00082,India
287032,2023-09-09,203,mango yogurt,50,60,10,1,00082,India
287032,2023-09-09,209,pepsi,75,100,25,1,00082,India
633455,2023-09-09,204,strawberry yogurt,50,60,10,1,00492,India
633455,2023-09-09,211,red bull,90,125,35,1,00492,India
405736,2023-09-09,202,milk,12,27,15,1,00296,India
405736,2023-09-09,203,mango yogurt,50,60,10,1,00296,India
762043,2023-09-09,206,yakult,360,400,40,1,00283,India
762043,2023-09-09,209,pepsi,75,100,25,1,00283,India
762043,2023-09-09,201,paneer,210,340,130,1,00283,India
762043,2023-09-09,212,amul cheese,250,315,65,1,00283,India
634896,2023-09-09,208,sprite,75,100,25,1,00497,India
319440,2023-09-09,204,strawberry yogurt,50,60,10,1,00203,India
319440,2023-09-09,203,mango yogurt,50,60,10,1,00203,India
319440,2023-09-09,208,sprite,75,100,25,1,00203,India
878092,2023-09-09,203,mango yogurt,50,60,10,1,00122,India
878092,2023-09-09,212,amul cheese,250,315,65,1,00122,India
878092,2023-09-09,210,mountain dew,75,100,25,1,00122,India
878092,2023-09-09,205,classic yogurt,45,60,15,1,00122,India
831769,2023-09-09,205,classic yogurt,45,60,15,1,00093,India
831769,2023-09-09,207,coca cola,75,100,25,1,00093,India
831769,2023-09-09,213,bisleri,6,15,9,1,00093,India
831769,2023-09-09,203,mango yogurt,50,60,10,1,00093,India
500329,2023-09-09,209,pepsi,75,100,25,1,00112,India
500329,2023-09-09,210,mountain dew,75,100,25,1,00112,India
500329,2023-09-09,203,mango yogurt,50,60,10,1,00112,India
500329,2023-09-09,205,classic yogurt,45,60,15,1,00112,India
500329,2023-09-09,208,sprite,75,100,25,1,00112,India
918978,2023-09-09,203,mango yogurt,50,60,10,1,00375,India
918978,2023-09-09,209,pepsi,75,100,25,1,00375,India
918978,2023-09-09,206,yakult,360,400,40,1,00375,India
918978,2023-09-09,205,classic yogurt,45,60,15,1,00375,India
404134,2023-09-09,206,yakult,360,400,40,1,00063,India
404134,2023-09-09,202,milk,12,27,15,1,00063,India
791969,2023-09-09,205,classic yogurt,45,60,15,1,00230,India
791969,2023-09-09,204,strawberry yogurt,50,60,10,1,00230,India
791969,2023-09-09,212,amul cheese,250,315,65,1,00230,India
633226,2023-09-09,203,mango yogurt,50,60,10,1,00052,India
405527,2023-09-09,202,milk,12,27,15,1,00427,India
405527,2023-09-09,210,mountain dew,75,100,25,1,00427,India
992809,2023-09-09,204,strawberry yogurt,50,60,10,1,00045,India
992809,2023-09-09,202,milk,12,27,15,1,00045,India
992809,2023-09-09,206,yakult,360,400,40,1,00045,India
456905,2023-09-09,201,paneer,210,340,130,1,00283,India
456905,2023-09-09,204,strawberry yogurt,50,60,10,1,00283,India
456905,2023-09-09,205,classic yogurt,45,60,15,1,00283,India
456905,2023-09-09,209,pepsi,75,100,25,1,00283,India
456905,2023-09-09,203,mango yogurt,50,60,10,1,00283,India
575435,2023-09-09,204,strawberry yogurt,50,60,10,1,00045,India
828372,2023-09-09,201,paneer,210,340,130,1,00326,India
828372,2023-09-09,203,mango yogurt,50,60,10,1,00326,India
828372,2023-09-09,211,red bull,90,125,35,1,00326,India
561786,2023-09-09,204,strawberry yogurt,50,60,10,1,00140,India
213712,2023-09-09,212,amul cheese,250,315,65,1,00366,India
213712,2023-09-09,213,bisleri,6,15,9,1,00366,India
213712,2023-09-09,205,classic yogurt,45,60,15,1,00366,India
213712,2023-09-09,211,red bull,90,125,35,1,00366,India
178546,2023-09-09,213,bisleri,6,15,9,1,00219,India
500977,2023-09-09,209,pepsi,75,100,25,1,00267,India
783959,2023-09-09,201,paneer,210,340,130,1,00292,India
783959,2023-09-09,206,yakult,360,400,40,1,00292,India
783959,2023-09-09,208,sprite,75,100,25,1,00292,India
783959,2023-09-09,205,classic yogurt,45,60,15,1,00292,India
609377,2023-09-09,204,strawberry yogurt,50,60,10,1,00181,India
609377,2023-09-09,211,red bull,90,125,35,1,00181,India
609377,2023-09-09,213,bisleri,6,15,9,1,00181,India
609377,2023-09-09,207,coca cola,75,100,25,1,00181,India
541735,2023-09-09,207,coca cola,75,100,25,1,00385,India
541735,2023-09-09,203,mango yogurt,50,60,10,1,00385,India
541735,2023-09-09,213,bisleri,6,15,9,1,00385,India
205118,2023-09-09,212,amul cheese,250,315,65,1,00293,India
205118,2023-09-09,211,red bull,90,125,35,1,00293,India
551951,2023-09-09,208,sprite,75,100,25,1,00209,India
551951,2023-09-09,211,red bull,90,125,35,1,00209,India
551951,2023-09-09,210,mountain dew,75,100,25,1,00209,India
548989,2023-09-09,210,mountain dew,75,100,25,1,00202,India
548989,2023-09-09,203,mango yogurt,50,60,10,1,00202,India
912029,2023-09-10,212,amul cheese,250,315,65,1,00461,India
912029,2023-09-10,206,yakult,360,400,40,1,00461,India
912029,2023-09-10,210,mountain dew,75,100,25,1,00461,India
499806,2023-09-10,213,bisleri,6,15,9,1,00307,India
499806,2023-09-10,202,milk,12,27,15,1,00307,India
499806,2023-09-10,209,pepsi,75,100,25,1,00307,India
298224,2023-09-10,211,red bull,90,125,35,1,00410,India
298224,2023-09-10,201,paneer,210,340,130,1,00410,India
298224,2023-09-10,207,coca cola,75,100,25,1,00410,India
298224,2023-09-10,204,strawberry yogurt,50,60,10,1,00410,India
443957,2023-09-10,203,mango yogurt,50,60,10,1,00153,India
443957,2023-09-10,202,milk,12,27,15,1,00153,India
168469,2023-09-10,211,red bull,90,125,35,1,00268,India
168469,2023-09-10,208,sprite,75,100,25,1,00268,India
168469,2023-09-10,202,milk,12,27,15,1,00268,India
168469,2023-09-10,207,coca cola,75,100,25,1,00268,India
168469,2023-09-10,209,pepsi,75,100,25,1,00268,India
747020,2023-09-10,211,red bull,90,125,35,1,00178,India
747020,2023-09-10,207,coca cola,75,100,25,1,00178,India
747020,2023-09-10,213,bisleri,6,15,9,1,00178,India
747020,2023-09-10,201,paneer,210,340,130,1,00178,India
359099,2023-09-10,206,yakult,360,400,40,1,00108,India
359099,2023-09-10,207,coca cola,75,100,25,1,00108,India
359099,2023-09-10,209,pepsi,75,100,25,1,00108,India
359099,2023-09-10,208,sprite,75,100,25,1,00108,India
883774,2023-09-10,210,mountain dew,75,100,25,1,00047,India
883774,2023-09-10,209,pepsi,75,100,25,1,00047,India
883774,2023-09-10,202,milk,12,27,15,1,00047,India
883774,2023-09-10,211,red bull,90,125,35,1,00047,India
149739,2023-09-10,210,mountain dew,75,100,25,1,00295,India
149739,2023-09-10,213,bisleri,6,15,9,1,00295,India
149739,2023-09-10,204,strawberry yogurt,50,60,10,1,00295,India
364188,2023-09-10,207,coca cola,75,100,25,1,00329,India
364188,2023-09-10,205,classic yogurt,45,60,15,1,00329,India
364188,2023-09-10,202,milk,12,27,15,1,00329,India
150649,2023-09-10,201,paneer,210,340,130,1,00498,India
150649,2023-09-10,204,strawberry yogurt,50,60,10,1,00498,India
150649,2023-09-10,212,amul cheese,250,315,65,1,00498,India
150649,2023-09-10,210,mountain dew,75,100,25,1,00498,India
857086,2023-09-10,211,red bull,90,125,35,1,00331,India
857086,2023-09-10,205,classic yogurt,45,60,15,1,00331,India
857086,2023-09-10,212,amul cheese,250,315,65,1,00331,India
703570,2023-09-10,202,milk,12,27,15,1,00230,India
703570,2023-09-10,201,paneer,210,340,130,1,00230,India
671048,2023-09-10,203,mango yogurt,50,60,10,1,00065,India
671048,2023-09-10,206,yakult,360,400,40,1,00065,India
671048,2023-09-10,211,red bull,90,125,35,1,00065,India
671048,2023-09-10,213,bisleri,6,15,9,1,00065,India
671048,2023-09-10,212,amul cheese,250,315,65,1,00065,India
371815,2023-09-10,206,yakult,360,400,40,1,00268,India
371815,2023-09-10,210,mountain dew,75,100,25,1,00268,India
371815,2023-09-10,208,sprite,75,100,25,1,00268,India
371815,2023-09-10,203,mango yogurt,50,60,10,1,00268,India
371815,2023-09-10,209,pepsi,75,100,25,1,00268,India
570228,2023-09-10,206,yakult,360,400,40,1,00453,India
245277,2023-09-10,206,yakult,360,400,40,1,00340,India
245277,2023-09-10,209,pepsi,75,100,25,1,00340,India
245277,2023-09-10,211,red bull,90,125,35,1,00340,India
388418,2023-09-10,209,pepsi,75,100,25,1,00024,India
388418,2023-09-10,206,yakult,360,400,40,1,00024,India
388418,2023-09-10,213,bisleri,6,15,9,1,00024,India
344968,2023-09-10,213,bisleri,6,15,9,1,00283,India
344968,2023-09-10,207,coca cola,75,100,25,1,00283,India
344968,2023-09-10,209,pepsi,75,100,25,1,00283,India
344968,2023-09-10,211,red bull,90,125,35,1,00283,India
293393,2023-09-10,204,strawberry yogurt,50,60,10,1,00167,India
293393,2023-09-10,203,mango yogurt,50,60,10,1,00167,India
293393,2023-09-10,206,yakult,360,400,40,1,00167,India
367203,2023-09-10,206,yakult,360,400,40,1,00144,India
367203,2023-09-10,213,bisleri,6,15,9,1,00144,India
554979,2023-09-10,204,strawberry yogurt,50,60,10,1,00071,India
554979,2023-09-10,201,paneer,210,340,130,1,00071,India
554979,2023-09-10,203,mango yogurt,50,60,10,1,00071,India
554979,2023-09-10,211,red bull,90,125,35,1,00071,India
924002,2023-09-10,206,yakult,360,400,40,1,00434,India
924002,2023-09-10,211,red bull,90,125,35,1,00434,India
924002,2023-09-10,203,mango yogurt,50,60,10,1,00434,India
924002,2023-09-10,208,sprite,75,100,25,1,00434,India
454868,2023-09-10,206,yakult,360,400,40,1,00489,India
454868,2023-09-10,202,milk,12,27,15,1,00489,India
693633,2023-09-10,206,yakult,360,400,40,1,00474,India
693633,2023-09-10,202,milk,12,27,15,1,00474,India
969514,2023-09-10,211,red bull,90,125,35,1,00192,India
969514,2023-09-10,210,mountain dew,75,100,25,1,00192,India
969514,2023-09-10,213,bisleri,6,15,9,1,00192,India
969514,2023-09-10,203,mango yogurt,50,60,10,1,00192,India
969514,2023-09-10,202,milk,12,27,15,1,00192,India
740127,2023-09-10,206,yakult,360,400,40,1,00123,India
740127,2023-09-10,207,coca cola,75,100,25,1,00123,India
740127,2023-09-10,201,paneer,210,340,130,1,00123,India
740127,2023-09-10,210,mountain dew,75,100,25,1,00123,India
762823,2023-09-10,209,pepsi,75,100,25,1,00475,India
466541,2023-09-10,205,classic yogurt,45,60,15,1,00197,India
466541,2023-09-10,212,amul cheese,250,315,65,1,00197,India
466541,2023-09-10,207,coca cola,75,100,25,1,00197,India
466541,2023-09-10,213,bisleri,6,15,9,1,00197,India
466541,2023-09-10,201,paneer,210,340,130,1,00197,India
228148,2023-09-10,204,strawberry yogurt,50,60,10,1,00416,India
228148,2023-09-10,201,paneer,210,340,130,1,00416,India
200735,2023-09-10,202,milk,12,27,15,1,00180,India
715406,2023-09-10,210,mountain dew,75,100,25,1,00355,India
715406,2023-09-10,208,sprite,75,100,25,1,00355,India
674912,2023-09-10,212,amul cheese,250,315,65,1,00193,India
352150,2023-09-10,207,coca cola,75,100,25,1,00424,India
157161,2023-09-10,201,paneer,210,340,130,1,00143,India
157161,2023-09-10,206,yakult,360,400,40,1,00143,India
157161,2023-09-10,209,pepsi,75,100,25,1,00143,India
143073,2023-09-10,208,sprite,75,100,25,1,00099,India
143073,2023-09-10,211,red bull,90,125,35,1,00099,India
143073,2023-09-10,209,pepsi,75,100,25,1,00099,India
867590,2023-09-10,207,coca cola,75,100,25,1,00409,India
867590,2023-09-10,203,mango yogurt,50,60,10,1,00409,India
475531,2023-09-10,208,sprite,75,100,25,1,00154,India
475531,2023-09-10,212,amul cheese,250,315,65,1,00154,India
250688,2023-09-10,204,strawberry yogurt,50,60,10,1,00464,India
250688,2023-09-10,210,mountain dew,75,100,25,1,00464,India
251251,2023-09-10,212,amul cheese,250,315,65,1,00285,India
251251,2023-09-10,201,paneer,210,340,130,1,00285,India
130443,2023-09-10,210,mountain dew,75,100,25,1,00231,India
130443,2023-09-10,212,amul cheese,250,315,65,1,00231,India
130443,2023-09-10,205,classic yogurt,45,60,15,1,00231,India
964360,2023-09-10,207,coca cola,75,100,25,1,00205,India
964360,2023-09-10,201,paneer,210,340,130,1,00205,India
744805,2023-09-10,201,paneer,210,340,130,1,00354,India
744805,2023-09-10,207,coca cola,75,100,25,1,00354,India
744805,2023-09-10,203,mango yogurt,50,60,10,1,00354,India
269610,2023-09-10,212,amul cheese,250,315,65,1,00070,India
269610,2023-09-10,207,coca cola,75,100,25,1,00070,India
269610,2023-09-10,203,mango yogurt,50,60,10,1,00070,India
269610,2023-09-10,206,yakult,360,400,40,1,00070,India
724832,2023-09-10,203,mango yogurt,50,60,10,1,00422,India
555983,2023-09-10,211,red bull,90,125,35,1,00173,India
555983,2023-09-10,210,mountain dew,75,100,25,1,00173,India
555983,2023-09-10,202,milk,12,27,15,1,00173,India
555983,2023-09-10,201,paneer,210,340,130,1,00173,India
913017,2023-09-10,212,amul cheese,250,315,65,1,00079,India
913017,2023-09-10,208,sprite,75,100,25,1,00079,India
913017,2023-09-10,213,bisleri,6,15,9,1,00079,India
842629,2023-09-10,212,amul cheese,250,315,65,1,00287,India
842629,2023-09-10,202,milk,12,27,15,1,00287,India
842629,2023-09-10,210,mountain dew,75,100,25,1,00287,India
842629,2023-09-10,203,mango yogurt,50,60,10,1,00287,India
842629,2023-09-10,205,classic yogurt,45,60,15,1,00287,India
544104,2023-09-10,204,strawberry yogurt,50,60,10,1,00105,India
544104,2023-09-10,213,bisleri,6,15,9,1,00105,India
544104,2023-09-10,205,classic yogurt,45,60,15,1,00105,India
544104,2023-09-10,211,red bull,90,125,35,1,00105,India
119348,2023-09-10,210,mountain dew,75,100,25,1,00480,India
119348,2023-09-10,211,red bull,90,125,35,1,00480,India
119348,2023-09-10,202,milk,12,27,15,1,00480,India
587037,2023-09-10,201,paneer,210,340,130,1,00210,India
587037,2023-09-10,204,strawberry yogurt,50,60,10,1,00210,India
587037,2023-09-10,202,milk,12,27,15,1,00210,India
587037,2023-09-10,207,coca cola,75,100,25,1,00210,India
587037,2023-09-10,203,mango yogurt,50,60,10,1,00210,India
601060,2023-09-10,207,coca cola,75,100,25,1,00488,India
601060,2023-09-10,205,classic yogurt,45,60,15,1,00488,India
601060,2023-09-10,210,mountain dew,75,100,25,1,00488,India
601060,2023-09-10,203,mango yogurt,50,60,10,1,00488,India
397841,2023-09-10,207,coca cola,75,100,25,1,00031,India
608001,2023-09-10,213,bisleri,6,15,9,1,00124,India
608001,2023-09-10,202,milk,12,27,15,1,00124,India
608001,2023-09-10,201,paneer,210,340,130,1,00124,India
608001,2023-09-10,203,mango yogurt,50,60,10,1,00124,India
175453,2023-09-10,201,paneer,210,340,130,1,00189,India
153831,2023-09-10,206,yakult,360,400,40,1,00375,India
153831,2023-09-10,210,mountain dew,75,100,25,1,00375,India
153831,2023-09-10,207,coca cola,75,100,25,1,00375,India
153831,2023-09-10,203,mango yogurt,50,60,10,1,00375,India
139357,2023-09-10,202,milk,12,27,15,1,00446,India
139357,2023-09-10,205,classic yogurt,45,60,15,1,00446,India
826301,2023-09-10,205,classic yogurt,45,60,15,1,00461,India
826301,2023-09-10,202,milk,12,27,15,1,00461,India
826301,2023-09-10,207,coca cola,75,100,25,1,00461,India
240311,2023-09-10,210,mountain dew,75,100,25,1,00014,India
240311,2023-09-10,213,bisleri,6,15,9,1,00014,India
260413,2023-09-10,211,red bull,90,125,35,1,00389,India
260413,2023-09-10,208,sprite,75,100,25,1,00389,India
260413,2023-09-10,213,bisleri,6,15,9,1,00389,India
260413,2023-09-10,209,pepsi,75,100,25,1,00389,India
101529,2023-09-10,206,yakult,360,400,40,1,00036,India
333002,2023-09-10,203,mango yogurt,50,60,10,1,00261,India
333002,2023-09-10,208,sprite,75,100,25,1,00261,India
333002,2023-09-10,205,classic yogurt,45,60,15,1,00261,India
333002,2023-09-10,201,paneer,210,340,130,1,00261,India
316289,2023-09-10,205,classic yogurt,45,60,15,1,00342,India
173719,2023-09-10,209,pepsi,75,100,25,1,00450,India
173719,2023-09-10,210,mountain dew,75,100,25,1,00450,India
173719,2023-09-10,201,paneer,210,340,130,1,00450,India
173719,2023-09-10,208,sprite,75,100,25,1,00450,India
115790,2023-09-10,206,yakult,360,400,40,1,00462,India
319515,2023-09-10,209,pepsi,75,100,25,1,00280,India
319515,2023-09-10,204,strawberry yogurt,50,60,10,1,00280,India
319515,2023-09-10,207,coca cola,75,100,25,1,00280,India
319515,2023-09-10,213,bisleri,6,15,9,1,00280,India
353892,2023-09-10,203,mango yogurt,50,60,10,1,00321,India
677610,2023-09-10,212,amul cheese,250,315,65,1,00284,India
677610,2023-09-10,203,mango yogurt,50,60,10,1,00284,India
677610,2023-09-10,208,sprite,75,100,25,1,00284,India
677610,2023-09-10,210,mountain dew,75,100,25,1,00284,India
677610,2023-09-10,207,coca cola,75,100,25,1,00284,India
741876,2023-09-10,209,pepsi,75,100,25,1,00045,India
658575,2023-09-10,212,amul cheese,250,315,65,1,00415,India
658575,2023-09-10,201,paneer,210,340,130,1,00415,India
658575,2023-09-10,202,milk,12,27,15,1,00415,India
532414,2023-09-11,201,paneer,210,340,130,1,00099,India
532414,2023-09-11,203,mango yogurt,50,60,10,1,00099,India
532414,2023-09-11,213,bisleri,6,15,9,1,00099,India
532414,2023-09-11,210,mountain dew,75,100,25,1,00099,India
476464,2023-09-11,201,paneer,210,340,130,1,00220,India
476464,2023-09-11,206,yakult,360,400,40,1,00220,India
476464,2023-09-11,205,classic yogurt,45,60,15,1,00220,India
109495,2023-09-11,202,milk,12,27,15,1,00462,India
743745,2023-09-11,208,sprite,75,100,25,1,00089,India
269097,2023-09-11,201,paneer,210,340,130,1,00327,India
269097,2023-09-11,211,red bull,90,125,35,1,00327,India
269097,2023-09-11,204,strawberry yogurt,50,60,10,1,00327,India
269097,2023-09-11,205,classic yogurt,45,60,15,1,00327,India
269097,2023-09-11,212,amul cheese,250,315,65,1,00327,India
375187,2023-09-11,202,milk,12,27,15,1,00403,India
375187,2023-09-11,204,strawberry yogurt,50,60,10,1,00403,India
375187,2023-09-11,212,amul cheese,250,315,65,1,00403,India
375187,2023-09-11,209,pepsi,75,100,25,1,00403,India
375187,2023-09-11,208,sprite,75,100,25,1,00403,India
147668,2023-09-11,205,classic yogurt,45,60,15,1,00306,India
147668,2023-09-11,207,coca cola,75,100,25,1,00306,India
504208,2023-09-11,208,sprite,75,100,25,1,00162,India
504208,2023-09-11,211,red bull,90,125,35,1,00162,India
257237,2023-09-11,211,red bull,90,125,35,1,00211,India
257237,2023-09-11,202,milk,12,27,15,1,00211,India
257237,2023-09-11,213,bisleri,6,15,9,1,00211,India
257237,2023-09-11,204,strawberry yogurt,50,60,10,1,00211,India
257237,2023-09-11,207,coca cola,75,100,25,1,00211,India
124771,2023-09-11,206,yakult,360,400,40,1,00313,India
124771,2023-09-11,211,red bull,90,125,35,1,00313,India
259787,2023-09-11,205,classic yogurt,45,60,15,1,00142,India
673698,2023-09-11,212,amul cheese,250,315,65,1,00498,India
673698,2023-09-11,209,pepsi,75,100,25,1,00498,India
805591,2023-09-11,208,sprite,75,100,25,1,00458,India
805591,2023-09-11,206,yakult,360,400,40,1,00458,India
805591,2023-09-11,211,red bull,90,125,35,1,00458,India
650450,2023-09-11,204,strawberry yogurt,50,60,10,1,00495,India
650450,2023-09-11,203,mango yogurt,50,60,10,1,00495,India
650450,2023-09-11,209,pepsi,75,100,25,1,00495,India
170275,2023-09-11,206,yakult,360,400,40,1,00282,India
332096,2023-09-11,209,pepsi,75,100,25,1,00300,India
332096,2023-09-11,212,amul cheese,250,315,65,1,00300,India
332096,2023-09-11,203,mango yogurt,50,60,10,1,00300,India
544779,2023-09-11,204,strawberry yogurt,50,60,10,1,00329,India
544779,2023-09-11,212,amul cheese,250,315,65,1,00329,India
544779,2023-09-11,207,coca cola,75,100,25,1,00329,India
587134,2023-09-11,206,yakult,360,400,40,1,00145,India
587134,2023-09-11,212,amul cheese,250,315,65,1,00145,India
491948,2023-09-11,205,classic yogurt,45,60,15,1,00056,India
491948,2023-09-11,201,paneer,210,340,130,1,00056,India
408234,2023-09-11,213,bisleri,6,15,9,1,00358,India
408234,2023-09-11,201,paneer,210,340,130,1,00358,India
357280,2023-09-11,212,amul cheese,250,315,65,1,00186,India
357280,2023-09-11,208,sprite,75,100,25,1,00186,India
357280,2023-09-11,211,red bull,90,125,35,1,00186,India
451523,2023-09-11,205,classic yogurt,45,60,15,1,00386,India
451523,2023-09-11,204,strawberry yogurt,50,60,10,1,00386,India
451523,2023-09-11,212,amul cheese,250,315,65,1,00386,India
451523,2023-09-11,208,sprite,75,100,25,1,00386,India
451523,2023-09-11,211,red bull,90,125,35,1,00386,India
255818,2023-09-11,212,amul cheese,250,315,65,1,00356,India
255818,2023-09-11,204,strawberry yogurt,50,60,10,1,00356,India
726424,2023-09-11,202,milk,12,27,15,1,00242,India
726424,2023-09-11,213,bisleri,6,15,9,1,00242,India
726424,2023-09-11,201,paneer,210,340,130,1,00242,India
370439,2023-09-11,206,yakult,360,400,40,1,00244,India
370439,2023-09-11,204,strawberry yogurt,50,60,10,1,00244,India
174117,2023-09-11,213,bisleri,6,15,9,1,00338,India
174117,2023-09-11,204,strawberry yogurt,50,60,10,1,00338,India
174117,2023-09-11,207,coca cola,75,100,25,1,00338,India
174117,2023-09-11,203,mango yogurt,50,60,10,1,00338,India
174117,2023-09-11,212,amul cheese,250,315,65,1,00338,India
220663,2023-09-11,202,milk,12,27,15,1,00176,India
220663,2023-09-11,210,mountain dew,75,100,25,1,00176,India
220663,2023-09-11,208,sprite,75,100,25,1,00176,India
220663,2023-09-11,209,pepsi,75,100,25,1,00176,India
588929,2023-09-11,205,classic yogurt,45,60,15,1,00316,India
588929,2023-09-11,201,paneer,210,340,130,1,00316,India
588929,2023-09-11,206,yakult,360,400,40,1,00316,India
306978,2023-09-11,202,milk,12,27,15,1,00235,India
306978,2023-09-11,211,red bull,90,125,35,1,00235,India
500890,2023-09-11,204,strawberry yogurt,50,60,10,1,00364,India
520324,2023-09-11,213,bisleri,6,15,9,1,00468,India
520324,2023-09-11,203,mango yogurt,50,60,10,1,00468,India
459252,2023-09-11,208,sprite,75,100,25,1,00485,India
459252,2023-09-11,209,pepsi,75,100,25,1,00485,India
459252,2023-09-11,212,amul cheese,250,315,65,1,00485,India
459252,2023-09-11,204,strawberry yogurt,50,60,10,1,00485,India
143731,2023-09-11,209,pepsi,75,100,25,1,00350,India
613667,2023-09-11,213,bisleri,6,15,9,1,00421,India
613667,2023-09-11,207,coca cola,75,100,25,1,00421,India
613667,2023-09-11,203,mango yogurt,50,60,10,1,00421,India
332267,2023-09-11,212,amul cheese,250,315,65,1,00363,India
332267,2023-09-11,203,mango yogurt,50,60,10,1,00363,India
296734,2023-09-11,210,mountain dew,75,100,25,1,00357,India
296734,2023-09-11,205,classic yogurt,45,60,15,1,00357,India
296734,2023-09-11,211,red bull,90,125,35,1,00357,India
682327,2023-09-11,212,amul cheese,250,315,65,1,00300,India
682327,2023-09-11,203,mango yogurt,50,60,10,1,00300,India
682327,2023-09-11,205,classic yogurt,45,60,15,1,00300,India
682327,2023-09-11,208,sprite,75,100,25,1,00300,India
682327,2023-09-11,206,yakult,360,400,40,1,00300,India
798981,2023-09-11,206,yakult,360,400,40,1,00259,India
798981,2023-09-11,207,coca cola,75,100,25,1,00259,India
798981,2023-09-11,211,red bull,90,125,35,1,00259,India
798981,2023-09-11,205,classic yogurt,45,60,15,1,00259,India
187625,2023-09-11,201,paneer,210,340,130,1,00107,India
187625,2023-09-11,210,mountain dew,75,100,25,1,00107,India
187625,2023-09-11,211,red bull,90,125,35,1,00107,India
187625,2023-09-11,202,milk,12,27,15,1,00107,India
790464,2023-09-11,207,coca cola,75,100,25,1,00398,India
790464,2023-09-11,212,amul cheese,250,315,65,1,00398,India
790464,2023-09-11,213,bisleri,6,15,9,1,00398,India
790464,2023-09-11,204,strawberry yogurt,50,60,10,1,00398,India
119373,2023-09-11,204,strawberry yogurt,50,60,10,1,00318,India
119373,2023-09-11,209,pepsi,75,100,25,1,00318,India
119373,2023-09-11,205,classic yogurt,45,60,15,1,00318,India
119373,2023-09-11,201,paneer,210,340,130,1,00318,India
119373,2023-09-11,208,sprite,75,100,25,1,00318,India
690249,2023-09-11,212,amul cheese,250,315,65,1,00316,India
690249,2023-09-11,201,paneer,210,340,130,1,00316,India
690249,2023-09-11,209,pepsi,75,100,25,1,00316,India
171090,2023-09-11,207,coca cola,75,100,25,1,00391,India
171090,2023-09-11,205,classic yogurt,45,60,15,1,00391,India
171090,2023-09-11,210,mountain dew,75,100,25,1,00391,India
279625,2023-09-11,205,classic yogurt,45,60,15,1,00116,India
279625,2023-09-11,203,mango yogurt,50,60,10,1,00116,India
279625,2023-09-11,212,amul cheese,250,315,65,1,00116,India
827723,2023-09-11,205,classic yogurt,45,60,15,1,00164,India
827723,2023-09-11,212,amul cheese,250,315,65,1,00164,India
827723,2023-09-11,201,paneer,210,340,130,1,00164,India
397543,2023-09-11,209,pepsi,75,100,25,1,00249,India
397543,2023-09-11,205,classic yogurt,45,60,15,1,00249,India
397543,2023-09-11,201,paneer,210,340,130,1,00249,India
397543,2023-09-11,202,milk,12,27,15,1,00249,India
516269,2023-09-11,204,strawberry yogurt,50,60,10,1,00093,India
516269,2023-09-11,203,mango yogurt,50,60,10,1,00093,India
353958,2023-09-11,209,pepsi,75,100,25,1,00385,India
353958,2023-09-11,201,paneer,210,340,130,1,00385,India
353958,2023-09-11,205,classic yogurt,45,60,15,1,00385,India
353958,2023-09-11,208,sprite,75,100,25,1,00385,India
357254,2023-09-11,213,bisleri,6,15,9,1,00065,India
357254,2023-09-11,204,strawberry yogurt,50,60,10,1,00065,India
422503,2023-09-11,208,sprite,75,100,25,1,00310,India
422503,2023-09-11,201,paneer,210,340,130,1,00310,India
422503,2023-09-11,204,strawberry yogurt,50,60,10,1,00310,India
422503,2023-09-11,209,pepsi,75,100,25,1,00310,India
422503,2023-09-11,213,bisleri,6,15,9,1,00310,India
684711,2023-09-11,201,paneer,210,340,130,1,00203,India
684711,2023-09-11,202,milk,12,27,15,1,00203,India
684711,2023-09-11,208,sprite,75,100,25,1,00203,India
684711,2023-09-11,209,pepsi,75,100,25,1,00203,India
858989,2023-09-11,206,yakult,360,400,40,1,00489,India
858989,2023-09-11,213,bisleri,6,15,9,1,00489,India
858989,2023-09-11,201,paneer,210,340,130,1,00489,India
858989,2023-09-11,204,strawberry yogurt,50,60,10,1,00489,India
750916,2023-09-11,203,mango yogurt,50,60,10,1,00342,India
750916,2023-09-11,210,mountain dew,75,100,25,1,00342,India
750916,2023-09-11,206,yakult,360,400,40,1,00342,India
750916,2023-09-11,208,sprite,75,100,25,1,00342,India
811808,2023-09-11,211,red bull,90,125,35,1,00222,India
811808,2023-09-11,209,pepsi,75,100,25,1,00222,India
811808,2023-09-11,201,paneer,210,340,130,1,00222,India
811808,2023-09-11,213,bisleri,6,15,9,1,00222,India
406062,2023-09-11,202,milk,12,27,15,1,00066,India
217355,2023-09-11,204,strawberry yogurt,50,60,10,1,00249,India
217355,2023-09-11,202,milk,12,27,15,1,00249,India
217355,2023-09-11,209,pepsi,75,100,25,1,00249,India
217355,2023-09-11,211,red bull,90,125,35,1,00249,India
163957,2023-09-11,209,pepsi,75,100,25,1,00164,India
125778,2023-09-11,209,pepsi,75,100,25,1,00194,India
125778,2023-09-11,205,classic yogurt,45,60,15,1,00194,India
125778,2023-09-11,212,amul cheese,250,315,65,1,00194,India
930476,2023-09-11,205,classic yogurt,45,60,15,1,00131,India
930476,2023-09-11,208,sprite,75,100,25,1,00131,India
930476,2023-09-11,209,pepsi,75,100,25,1,00131,India
615198,2023-09-11,203,mango yogurt,50,60,10,1,00164,India
615198,2023-09-11,209,pepsi,75,100,25,1,00164,India
615198,2023-09-11,211,red bull,90,125,35,1,00164,India
615198,2023-09-11,201,paneer,210,340,130,1,00164,India
338964,2023-09-11,206,yakult,360,400,40,1,00107,India
338964,2023-09-11,208,sprite,75,100,25,1,00107,India
338964,2023-09-11,207,coca cola,75,100,25,1,00107,India
338964,2023-09-11,201,paneer,210,340,130,1,00107,India
338964,2023-09-11,209,pepsi,75,100,25,1,00107,India
163416,2023-09-11,212,amul cheese,250,315,65,1,00072,India
163416,2023-09-11,203,mango yogurt,50,60,10,1,00072,India
163416,2023-09-11,201,paneer,210,340,130,1,00072,India
163416,2023-09-11,208,sprite,75,100,25,1,00072,India
414795,2023-09-11,213,bisleri,6,15,9,1,00379,India
414795,2023-09-11,201,paneer,210,340,130,1,00379,India
414795,2023-09-11,202,milk,12,27,15,1,00379,India
414795,2023-09-11,207,coca cola,75,100,25,1,00379,India
956377,2023-09-11,212,amul cheese,250,315,65,1,00250,India
956377,2023-09-11,209,pepsi,75,100,25,1,00250,India
956377,2023-09-11,208,sprite,75,100,25,1,00250,India
196922,2023-09-11,205,classic yogurt,45,60,15,1,00254,India
196922,2023-09-11,204,strawberry yogurt,50,60,10,1,00254,India
196922,2023-09-11,211,red bull,90,125,35,1,00254,India
196922,2023-09-11,201,paneer,210,340,130,1,00254,India
726372,2023-09-11,211,red bull,90,125,35,1,00335,India
726372,2023-09-11,210,mountain dew,75,100,25,1,00335,India
726372,2023-09-11,201,paneer,210,340,130,1,00335,India
726372,2023-09-11,205,classic yogurt,45,60,15,1,00335,India
790773,2023-09-11,201,paneer,210,340,130,1,00166,India
790773,2023-09-11,207,coca cola,75,100,25,1,00166,India
790773,2023-09-11,208,sprite,75,100,25,1,00166,India
790773,2023-09-11,211,red bull,90,125,35,1,00166,India
230568,2023-09-11,211,red bull,90,125,35,1,00099,India
230568,2023-09-11,201,paneer,210,340,130,1,00099,India
230568,2023-09-11,212,amul cheese,250,315,65,1,00099,India
230568,2023-09-11,208,sprite,75,100,25,1,00099,India
230568,2023-09-11,210,mountain dew,75,100,25,1,00099,India
944717,2023-09-11,211,red bull,90,125,35,1,00326,India
944717,2023-09-11,208,sprite,75,100,25,1,00326,India
944717,2023-09-11,201,paneer,210,340,130,1,00326,India
944717,2023-09-11,207,coca cola,75,100,25,1,00326,India
360841,2023-09-11,202,milk,12,27,15,1,00317,India
360841,2023-09-11,210,mountain dew,75,100,25,1,00317,India
360841,2023-09-11,213,bisleri,6,15,9,1,00317,India
463265,2023-09-11,213,bisleri,6,15,9,1,00065,India
463265,2023-09-11,212,amul cheese,250,315,65,1,00065,India
224478,2023-09-11,203,mango yogurt,50,60,10,1,00285,India
224478,2023-09-11,213,bisleri,6,15,9,1,00285,India
224478,2023-09-11,209,pepsi,75,100,25,1,00285,India
224478,2023-09-11,207,coca cola,75,100,25,1,00285,India
224478,2023-09-11,201,paneer,210,340,130,1,00285,India
811271,2023-09-11,201,paneer,210,340,130,1,00494,India
524505,2023-09-11,205,classic yogurt,45,60,15,1,00036,India
524505,2023-09-11,209,pepsi,75,100,25,1,00036,India
486302,2023-09-11,208,sprite,75,100,25,1,00168,India
486302,2023-09-11,210,mountain dew,75,100,25,1,00168,India
862798,2023-09-11,213,bisleri,6,15,9,1,00093,India
292635,2023-09-11,211,red bull,90,125,35,1,00224,India
292635,2023-09-11,203,mango yogurt,50,60,10,1,00224,India
292635,2023-09-11,205,classic yogurt,45,60,15,1,00224,India
777154,2023-09-11,210,mountain dew,75,100,25,1,00185,India
777154,2023-09-11,201,paneer,210,340,130,1,00185,India
777154,2023-09-11,213,bisleri,6,15,9,1,00185,India
777154,2023-09-11,206,yakult,360,400,40,1,00185,India
158766,2023-09-11,202,milk,12,27,15,1,00154,India
158766,2023-09-11,212,amul cheese,250,315,65,1,00154,India
414855,2023-09-11,204,strawberry yogurt,50,60,10,1,00104,India
222573,2023-09-11,204,strawberry yogurt,50,60,10,1,00325,India
313931,2023-09-11,212,amul cheese,250,315,65,1,00049,India
313931,2023-09-11,206,yakult,360,400,40,1,00049,India
313931,2023-09-11,205,classic yogurt,45,60,15,1,00049,India
313931,2023-09-11,207,coca cola,75,100,25,1,00049,India
829032,2023-09-11,213,bisleri,6,15,9,1,00010,India
829032,2023-09-11,212,amul cheese,250,315,65,1,00010,India
829032,2023-09-11,204,strawberry yogurt,50,60,10,1,00010,India
829032,2023-09-11,201,paneer,210,340,130,1,00010,India
829032,2023-09-11,210,mountain dew,75,100,25,1,00010,India
511446,2023-09-11,202,milk,12,27,15,1,00135,India
511446,2023-09-11,211,red bull,90,125,35,1,00135,India
438691,2023-09-11,209,pepsi,75,100,25,1,00029,India
330138,2023-09-11,208,sprite,75,100,25,1,00408,India
259853,2023-09-11,211,red bull,90,125,35,1,00378,India
247904,2023-09-11,207,coca cola,75,100,25,1,00237,India
247904,2023-09-11,206,yakult,360,400,40,1,00237,India
247904,2023-09-11,213,bisleri,6,15,9,1,00237,India
247904,2023-09-11,201,paneer,210,340,130,1,00237,India
518473,2023-09-12,211,red bull,90,125,35,1,00039,India
518473,2023-09-12,213,bisleri,6,15,9,1,00039,India
716299,2023-09-12,203,mango yogurt,50,60,10,1,00460,India
716299,2023-09-12,210,mountain dew,75,100,25,1,00460,India
122471,2023-09-12,205,classic yogurt,45,60,15,1,00315,India
122471,2023-09-12,211,red bull,90,125,35,1,00315,India
122471,2023-09-12,212,amul cheese,250,315,65,1,00315,India
527880,2023-09-12,211,red bull,90,125,35,1,00253,India
527880,2023-09-12,212,amul cheese,250,315,65,1,00253,India
527880,2023-09-12,207,coca cola,75,100,25,1,00253,India
527880,2023-09-12,206,yakult,360,400,40,1,00253,India
527880,2023-09-12,210,mountain dew,75,100,25,1,00253,India
817615,2023-09-12,201,paneer,210,340,130,1,00147,India
817615,2023-09-12,208,sprite,75,100,25,1,00147,India
135426,2023-09-12,201,paneer,210,340,130,1,00067,India
135426,2023-09-12,210,mountain dew,75,100,25,1,00067,India
135426,2023-09-12,208,sprite,75,100,25,1,00067,India
135426,2023-09-12,213,bisleri,6,15,9,1,00067,India
212781,2023-09-12,201,paneer,210,340,130,1,00193,India
528183,2023-09-12,209,pepsi,75,100,25,1,00335,India
528183,2023-09-12,205,classic yogurt,45,60,15,1,00335,India
528183,2023-09-12,203,mango yogurt,50,60,10,1,00335,India
528183,2023-09-12,212,amul cheese,250,315,65,1,00335,India
528183,2023-09-12,208,sprite,75,100,25,1,00335,India
437350,2023-09-12,211,red bull,90,125,35,1,00283,India
437350,2023-09-12,210,mountain dew,75,100,25,1,00283,India
113026,2023-09-12,203,mango yogurt,50,60,10,1,00043,India
141483,2023-09-12,209,pepsi,75,100,25,1,00189,India
141483,2023-09-12,203,mango yogurt,50,60,10,1,00189,India
745078,2023-09-12,210,mountain dew,75,100,25,1,00358,India
745078,2023-09-12,207,coca cola,75,100,25,1,00358,India
745078,2023-09-12,211,red bull,90,125,35,1,00358,India
141805,2023-09-12,206,yakult,360,400,40,1,00194,India
141805,2023-09-12,211,red bull,90,125,35,1,00194,India
141805,2023-09-12,209,pepsi,75,100,25,1,00194,India
328675,2023-09-12,202,milk,12,27,15,1,00232,India
328675,2023-09-12,212,amul cheese,250,315,65,1,00232,India
328675,2023-09-12,204,strawberry yogurt,50,60,10,1,00232,India
318004,2023-09-12,205,classic yogurt,45,60,15,1,00015,India
318004,2023-09-12,206,yakult,360,400,40,1,00015,India
852478,2023-09-12,212,amul cheese,250,315,65,1,00497,India
826697,2023-09-12,206,yakult,360,400,40,1,00124,India
505529,2023-09-12,204,strawberry yogurt,50,60,10,1,00271,India
505529,2023-09-12,206,yakult,360,400,40,1,00271,India
505529,2023-09-12,210,mountain dew,75,100,25,1,00271,India
227572,2023-09-12,207,coca cola,75,100,25,1,00314,India
227572,2023-09-12,203,mango yogurt,50,60,10,1,00314,India
227572,2023-09-12,211,red bull,90,125,35,1,00314,India
963091,2023-09-12,204,strawberry yogurt,50,60,10,1,00064,India
963091,2023-09-12,205,classic yogurt,45,60,15,1,00064,India
963091,2023-09-12,212,amul cheese,250,315,65,1,00064,India
683424,2023-09-12,203,mango yogurt,50,60,10,1,00103,India
683424,2023-09-12,210,mountain dew,75,100,25,1,00103,India
683424,2023-09-12,206,yakult,360,400,40,1,00103,India
683424,2023-09-12,207,coca cola,75,100,25,1,00103,India
127205,2023-09-12,203,mango yogurt,50,60,10,1,00256,India
127205,2023-09-12,209,pepsi,75,100,25,1,00256,India
127205,2023-09-12,213,bisleri,6,15,9,1,00256,India
460612,2023-09-12,210,mountain dew,75,100,25,1,00231,India
460612,2023-09-12,202,milk,12,27,15,1,00231,India
460612,2023-09-12,211,red bull,90,125,35,1,00231,India
550963,2023-09-12,205,classic yogurt,45,60,15,1,00327,India
550963,2023-09-12,203,mango yogurt,50,60,10,1,00327,India
550963,2023-09-12,201,paneer,210,340,130,1,00327,India
550963,2023-09-12,208,sprite,75,100,25,1,00327,India
654960,2023-09-12,205,classic yogurt,45,60,15,1,00253,India
654960,2023-09-12,210,mountain dew,75,100,25,1,00253,India
654960,2023-09-12,207,coca cola,75,100,25,1,00253,India
350078,2023-09-12,206,yakult,360,400,40,1,00173,India
147837,2023-09-12,206,yakult,360,400,40,1,00377,India
147837,2023-09-12,213,bisleri,6,15,9,1,00377,India
147837,2023-09-12,209,pepsi,75,100,25,1,00377,India
147837,2023-09-12,205,classic yogurt,45,60,15,1,00377,India
857614,2023-09-12,201,paneer,210,340,130,1,00403,India
857614,2023-09-12,210,mountain dew,75,100,25,1,00403,India
857614,2023-09-12,205,classic yogurt,45,60,15,1,00403,India
857614,2023-09-12,209,pepsi,75,100,25,1,00403,India
347231,2023-09-12,210,mountain dew,75,100,25,1,00255,India
347231,2023-09-12,203,mango yogurt,50,60,10,1,00255,India
347231,2023-09-12,207,coca cola,75,100,25,1,00255,India
347231,2023-09-12,208,sprite,75,100,25,1,00255,India
599897,2023-09-12,208,sprite,75,100,25,1,00278,India
599897,2023-09-12,202,milk,12,27,15,1,00278,India
599897,2023-09-12,205,classic yogurt,45,60,15,1,00278,India
599897,2023-09-12,204,strawberry yogurt,50,60,10,1,00278,India
599897,2023-09-12,203,mango yogurt,50,60,10,1,00278,India
328174,2023-09-12,206,yakult,360,400,40,1,00499,India
328174,2023-09-12,209,pepsi,75,100,25,1,00499,India
328174,2023-09-12,211,red bull,90,125,35,1,00499,India
167972,2023-09-12,211,red bull,90,125,35,1,00290,India
167972,2023-09-12,209,pepsi,75,100,25,1,00290,India
167972,2023-09-12,201,paneer,210,340,130,1,00290,India
533664,2023-09-12,212,amul cheese,250,315,65,1,00418,India
533664,2023-09-12,211,red bull,90,125,35,1,00418,India
533664,2023-09-12,205,classic yogurt,45,60,15,1,00418,India
138695,2023-09-12,203,mango yogurt,50,60,10,1,00262,India
138695,2023-09-12,212,amul cheese,250,315,65,1,00262,India
138695,2023-09-12,205,classic yogurt,45,60,15,1,00262,India
138695,2023-09-12,204,strawberry yogurt,50,60,10,1,00262,India
548600,2023-09-12,201,paneer,210,340,130,1,00394,India
548600,2023-09-12,202,milk,12,27,15,1,00394,India
548600,2023-09-12,204,strawberry yogurt,50,60,10,1,00394,India
151882,2023-09-12,201,paneer,210,340,130,1,00238,India
151882,2023-09-12,212,amul cheese,250,315,65,1,00238,India
151882,2023-09-12,204,strawberry yogurt,50,60,10,1,00238,India
528897,2023-09-12,201,paneer,210,340,130,1,00094,India
528897,2023-09-12,206,yakult,360,400,40,1,00094,India
528897,2023-09-12,213,bisleri,6,15,9,1,00094,India
528897,2023-09-12,208,sprite,75,100,25,1,00094,India
182306,2023-09-12,207,coca cola,75,100,25,1,00437,India
182306,2023-09-12,211,red bull,90,125,35,1,00437,India
182306,2023-09-12,213,bisleri,6,15,9,1,00437,India
270920,2023-09-12,201,paneer,210,340,130,1,00480,India
270920,2023-09-12,203,mango yogurt,50,60,10,1,00480,India
270920,2023-09-12,206,yakult,360,400,40,1,00480,India
154653,2023-09-12,205,classic yogurt,45,60,15,1,00464,India
154653,2023-09-12,202,milk,12,27,15,1,00464,India
154653,2023-09-12,209,pepsi,75,100,25,1,00464,India
891191,2023-09-12,207,coca cola,75,100,25,1,00127,India
891191,2023-09-12,201,paneer,210,340,130,1,00127,India
891191,2023-09-12,203,mango yogurt,50,60,10,1,00127,India
891191,2023-09-12,209,pepsi,75,100,25,1,00127,India
232802,2023-09-12,213,bisleri,6,15,9,1,00482,India
232802,2023-09-12,203,mango yogurt,50,60,10,1,00482,India
232802,2023-09-12,204,strawberry yogurt,50,60,10,1,00482,India
421723,2023-09-12,210,mountain dew,75,100,25,1,00301,India
421723,2023-09-12,207,coca cola,75,100,25,1,00301,India
165193,2023-09-12,203,mango yogurt,50,60,10,1,00388,India
165193,2023-09-12,210,mountain dew,75,100,25,1,00388,India
165193,2023-09-12,204,strawberry yogurt,50,60,10,1,00388,India
165193,2023-09-12,213,bisleri,6,15,9,1,00388,India
637869,2023-09-12,203,mango yogurt,50,60,10,1,00377,India
637869,2023-09-12,202,milk,12,27,15,1,00377,India
933459,2023-09-12,207,coca cola,75,100,25,1,00498,India
933459,2023-09-12,204,strawberry yogurt,50,60,10,1,00498,India
933459,2023-09-12,208,sprite,75,100,25,1,00498,India
933459,2023-09-12,213,bisleri,6,15,9,1,00498,India
450521,2023-09-12,204,strawberry yogurt,50,60,10,1,00171,India
450521,2023-09-12,211,red bull,90,125,35,1,00171,India
450521,2023-09-12,201,paneer,210,340,130,1,00171,India
450521,2023-09-12,203,mango yogurt,50,60,10,1,00171,India
450521,2023-09-12,213,bisleri,6,15,9,1,00171,India
483966,2023-09-12,212,amul cheese,250,315,65,1,00129,India
483966,2023-09-12,209,pepsi,75,100,25,1,00129,India
483966,2023-09-12,210,mountain dew,75,100,25,1,00129,India
140586,2023-09-12,211,red bull,90,125,35,1,00053,India
140586,2023-09-12,207,coca cola,75,100,25,1,00053,India
877284,2023-09-12,207,coca cola,75,100,25,1,00481,India
552947,2023-09-12,212,amul cheese,250,315,65,1,00163,India
552947,2023-09-12,206,yakult,360,400,40,1,00163,India
552947,2023-09-12,207,coca cola,75,100,25,1,00163,India
602180,2023-09-12,201,paneer,210,340,130,1,00070,India
602180,2023-09-12,202,milk,12,27,15,1,00070,India
602180,2023-09-12,210,mountain dew,75,100,25,1,00070,India
602180,2023-09-12,205,classic yogurt,45,60,15,1,00070,India
655760,2023-09-12,201,paneer,210,340,130,1,00155,India
655760,2023-09-12,204,strawberry yogurt,50,60,10,1,00155,India
350666,2023-09-12,204,strawberry yogurt,50,60,10,1,00482,India
350666,2023-09-12,201,paneer,210,340,130,1,00482,India
637769,2023-09-12,211,red bull,90,125,35,1,00467,India
637769,2023-09-12,206,yakult,360,400,40,1,00467,India
157965,2023-09-12,208,sprite,75,100,25,1,00481,India
664880,2023-09-12,206,yakult,360,400,40,1,00228,India
664880,2023-09-12,211,red bull,90,125,35,1,00228,India
565835,2023-09-12,213,bisleri,6,15,9,1,00103,India
565835,2023-09-12,205,classic yogurt,45,60,15,1,00103,India
565835,2023-09-12,206,yakult,360,400,40,1,00103,India
565835,2023-09-12,212,amul cheese,250,315,65,1,00103,India
565835,2023-09-12,208,sprite,75,100,25,1,00103,India
663037,2023-09-12,210,mountain dew,75,100,25,1,00272,India
663037,2023-09-12,203,mango yogurt,50,60,10,1,00272,India
663037,2023-09-12,205,classic yogurt,45,60,15,1,00272,India
433127,2023-09-12,204,strawberry yogurt,50,60,10,1,00148,India
265421,2023-09-12,201,paneer,210,340,130,1,00221,India
180631,2023-09-12,209,pepsi,75,100,25,1,00302,India
180631,2023-09-12,206,yakult,360,400,40,1,00302,India
180631,2023-09-12,205,classic yogurt,45,60,15,1,00302,India
180631,2023-09-12,201,paneer,210,340,130,1,00302,India
222557,2023-09-12,203,mango yogurt,50,60,10,1,00052,India
222557,2023-09-12,212,amul cheese,250,315,65,1,00052,India
222557,2023-09-12,201,paneer,210,340,130,1,00052,India
702330,2023-09-12,203,mango yogurt,50,60,10,1,00352,India
702330,2023-09-12,208,sprite,75,100,25,1,00352,India
702330,2023-09-12,204,strawberry yogurt,50,60,10,1,00352,India
702330,2023-09-12,206,yakult,360,400,40,1,00352,India
365927,2023-09-12,208,sprite,75,100,25,1,00150,India
365927,2023-09-12,207,coca cola,75,100,25,1,00150,India
365927,2023-09-12,206,yakult,360,400,40,1,00150,India
365927,2023-09-12,210,mountain dew,75,100,25,1,00150,India
737676,2023-09-12,209,pepsi,75,100,25,1,00327,India
999467,2023-09-12,203,mango yogurt,50,60,10,1,00277,India
999467,2023-09-12,204,strawberry yogurt,50,60,10,1,00277,India
999467,2023-09-12,202,milk,12,27,15,1,00277,India
999467,2023-09-12,201,paneer,210,340,130,1,00277,India
845408,2023-09-12,203,mango yogurt,50,60,10,1,00225,India
845408,2023-09-12,208,sprite,75,100,25,1,00225,India
138639,2023-09-12,201,paneer,210,340,130,1,00216,India
481814,2023-09-12,210,mountain dew,75,100,25,1,00007,India
481814,2023-09-12,208,sprite,75,100,25,1,00007,India
481814,2023-09-12,213,bisleri,6,15,9,1,00007,India
954297,2023-09-12,212,amul cheese,250,315,65,1,00106,India
954297,2023-09-12,203,mango yogurt,50,60,10,1,00106,India
954297,2023-09-12,204,strawberry yogurt,50,60,10,1,00106,India
874654,2023-09-12,209,pepsi,75,100,25,1,00213,India
874654,2023-09-12,203,mango yogurt,50,60,10,1,00213,India
874654,2023-09-12,208,sprite,75,100,25,1,00213,India
874654,2023-09-12,207,coca cola,75,100,25,1,00213,India
688374,2023-09-12,206,yakult,360,400,40,1,00443,India
688374,2023-09-12,202,milk,12,27,15,1,00443,India
688374,2023-09-12,207,coca cola,75,100,25,1,00443,India
688374,2023-09-12,205,classic yogurt,45,60,15,1,00443,India
688374,2023-09-12,209,pepsi,75,100,25,1,00443,India
612979,2023-09-12,207,coca cola,75,100,25,1,00184,India
612979,2023-09-12,206,yakult,360,400,40,1,00184,India
509619,2023-09-12,205,classic yogurt,45,60,15,1,00183,India
509619,2023-09-12,207,coca cola,75,100,25,1,00183,India
509619,2023-09-12,206,yakult,360,400,40,1,00183,India
509619,2023-09-12,204,strawberry yogurt,50,60,10,1,00183,India
509619,2023-09-12,202,milk,12,27,15,1,00183,India
708386,2023-09-12,210,mountain dew,75,100,25,1,00040,India
708386,2023-09-12,212,amul cheese,250,315,65,1,00040,India
708386,2023-09-12,205,classic yogurt,45,60,15,1,00040,India
708386,2023-09-12,207,coca cola,75,100,25,1,00040,India
143496,2023-09-12,207,coca cola,75,100,25,1,00396,India
609854,2023-09-12,205,classic yogurt,45,60,15,1,00089,India
609854,2023-09-12,206,yakult,360,400,40,1,00089,India
609854,2023-09-12,202,milk,12,27,15,1,00089,India
923023,2023-09-13,207,coca cola,75,100,25,1,00256,India
923023,2023-09-13,211,red bull,90,125,35,1,00256,India
923023,2023-09-13,203,mango yogurt,50,60,10,1,00256,India
661622,2023-09-13,211,red bull,90,125,35,1,00187,India
661622,2023-09-13,204,strawberry yogurt,50,60,10,1,00187,India
943958,2023-09-13,213,bisleri,6,15,9,1,00126,India
943958,2023-09-13,209,pepsi,75,100,25,1,00126,India
943958,2023-09-13,212,amul cheese,250,315,65,1,00126,India
723330,2023-09-13,202,milk,12,27,15,1,00030,India
333521,2023-09-13,210,mountain dew,75,100,25,1,00189,India
768949,2023-09-13,206,yakult,360,400,40,1,00256,India
455883,2023-09-13,204,strawberry yogurt,50,60,10,1,00359,India
455883,2023-09-13,206,yakult,360,400,40,1,00359,India
330069,2023-09-13,211,red bull,90,125,35,1,00037,India
330069,2023-09-13,209,pepsi,75,100,25,1,00037,India
330069,2023-09-13,206,yakult,360,400,40,1,00037,India
755854,2023-09-13,202,milk,12,27,15,1,00065,India
458376,2023-09-13,206,yakult,360,400,40,1,00230,India
223728,2023-09-13,207,coca cola,75,100,25,1,00104,India
223728,2023-09-13,212,amul cheese,250,315,65,1,00104,India
223728,2023-09-13,202,milk,12,27,15,1,00104,India
189479,2023-09-13,208,sprite,75,100,25,1,00148,India
189479,2023-09-13,205,classic yogurt,45,60,15,1,00148,India
600799,2023-09-13,213,bisleri,6,15,9,1,00253,India
600799,2023-09-13,208,sprite,75,100,25,1,00253,India
223103,2023-09-13,202,milk,12,27,15,1,00488,India
825889,2023-09-13,203,mango yogurt,50,60,10,1,00086,India
825889,2023-09-13,211,red bull,90,125,35,1,00086,India
825889,2023-09-13,213,bisleri,6,15,9,1,00086,India
825889,2023-09-13,204,strawberry yogurt,50,60,10,1,00086,India
825889,2023-09-13,210,mountain dew,75,100,25,1,00086,India
139270,2023-09-13,213,bisleri,6,15,9,1,00238,India
139270,2023-09-13,211,red bull,90,125,35,1,00238,India
139270,2023-09-13,209,pepsi,75,100,25,1,00238,India
139270,2023-09-13,203,mango yogurt,50,60,10,1,00238,India
464891,2023-09-13,213,bisleri,6,15,9,1,00498,India
464891,2023-09-13,207,coca cola,75,100,25,1,00498,India
982202,2023-09-13,203,mango yogurt,50,60,10,1,00205,India
982202,2023-09-13,208,sprite,75,100,25,1,00205,India
982202,2023-09-13,206,yakult,360,400,40,1,00205,India
897597,2023-09-13,213,bisleri,6,15,9,1,00450,India
897597,2023-09-13,201,paneer,210,340,130,1,00450,India
897597,2023-09-13,206,yakult,360,400,40,1,00450,India
624612,2023-09-13,204,strawberry yogurt,50,60,10,1,00284,India
624612,2023-09-13,209,pepsi,75,100,25,1,00284,India
957220,2023-09-13,202,milk,12,27,15,1,00466,India
957220,2023-09-13,203,mango yogurt,50,60,10,1,00466,India
957220,2023-09-13,212,amul cheese,250,315,65,1,00466,India
486934,2023-09-13,208,sprite,75,100,25,1,00029,India
486934,2023-09-13,210,mountain dew,75,100,25,1,00029,India
486934,2023-09-13,203,mango yogurt,50,60,10,1,00029,India
345796,2023-09-13,212,amul cheese,250,315,65,1,00329,India
345796,2023-09-13,206,yakult,360,400,40,1,00329,India
345796,2023-09-13,204,strawberry yogurt,50,60,10,1,00329,India
345796,2023-09-13,207,coca cola,75,100,25,1,00329,India
345796,2023-09-13,208,sprite,75,100,25,1,00329,India
815982,2023-09-13,209,pepsi,75,100,25,1,00484,India
143780,2023-09-13,207,coca cola,75,100,25,1,00203,India
915451,2023-09-13,203,mango yogurt,50,60,10,1,00302,India
915451,2023-09-13,207,coca cola,75,100,25,1,00302,India
915451,2023-09-13,206,yakult,360,400,40,1,00302,India
354022,2023-09-13,210,mountain dew,75,100,25,1,00045,India
628409,2023-09-13,204,strawberry yogurt,50,60,10,1,00216,India
628409,2023-09-13,205,classic yogurt,45,60,15,1,00216,India
461440,2023-09-13,203,mango yogurt,50,60,10,1,00226,India
461440,2023-09-13,208,sprite,75,100,25,1,00226,India
461440,2023-09-13,204,strawberry yogurt,50,60,10,1,00226,India
461440,2023-09-13,211,red bull,90,125,35,1,00226,India
992528,2023-09-13,206,yakult,360,400,40,1,00280,India
992528,2023-09-13,201,paneer,210,340,130,1,00280,India
992528,2023-09-13,203,mango yogurt,50,60,10,1,00280,India
956145,2023-09-13,211,red bull,90,125,35,1,00260,India
851257,2023-09-13,212,amul cheese,250,315,65,1,00141,India
851257,2023-09-13,204,strawberry yogurt,50,60,10,1,00141,India
851257,2023-09-13,205,classic yogurt,45,60,15,1,00141,India
683370,2023-09-13,213,bisleri,6,15,9,1,00312,India
683370,2023-09-13,203,mango yogurt,50,60,10,1,00312,India
683370,2023-09-13,207,coca cola,75,100,25,1,00312,India
666149,2023-09-13,201,paneer,210,340,130,1,00353,India
666149,2023-09-13,208,sprite,75,100,25,1,00353,India
666149,2023-09-13,207,coca cola,75,100,25,1,00353,India
602825,2023-09-13,204,strawberry yogurt,50,60,10,1,00253,India
933356,2023-09-13,204,strawberry yogurt,50,60,10,1,00379,India
933356,2023-09-13,211,red bull,90,125,35,1,00379,India
933356,2023-09-13,207,coca cola,75,100,25,1,00379,India
933356,2023-09-13,212,amul cheese,250,315,65,1,00379,India
177465,2023-09-13,205,classic yogurt,45,60,15,1,00351,India
177465,2023-09-13,203,mango yogurt,50,60,10,1,00351,India
177465,2023-09-13,208,sprite,75,100,25,1,00351,India
177465,2023-09-13,212,amul cheese,250,315,65,1,00351,India
650916,2023-09-13,212,amul cheese,250,315,65,1,00007,India
650916,2023-09-13,206,yakult,360,400,40,1,00007,India
650916,2023-09-13,201,paneer,210,340,130,1,00007,India
650916,2023-09-13,202,milk,12,27,15,1,00007,India
482562,2023-09-13,212,amul cheese,250,315,65,1,00093,India
482562,2023-09-13,201,paneer,210,340,130,1,00093,India
996047,2023-09-13,208,sprite,75,100,25,1,00467,India
996047,2023-09-13,203,mango yogurt,50,60,10,1,00467,India
996047,2023-09-13,209,pepsi,75,100,25,1,00467,India
365831,2023-09-13,211,red bull,90,125,35,1,00063,India
365831,2023-09-13,205,classic yogurt,45,60,15,1,00063,India
365831,2023-09-13,212,amul cheese,250,315,65,1,00063,India
365831,2023-09-13,209,pepsi,75,100,25,1,00063,India
368709,2023-09-13,207,coca cola,75,100,25,1,00190,India
368709,2023-09-13,213,bisleri,6,15,9,1,00190,India
389130,2023-09-13,209,pepsi,75,100,25,1,00420,India
389130,2023-09-13,202,milk,12,27,15,1,00420,India
389130,2023-09-13,204,strawberry yogurt,50,60,10,1,00420,India
796549,2023-09-13,209,pepsi,75,100,25,1,00253,India
796549,2023-09-13,210,mountain dew,75,100,25,1,00253,India
796549,2023-09-13,204,strawberry yogurt,50,60,10,1,00253,India
726828,2023-09-13,212,amul cheese,250,315,65,1,00052,India
726828,2023-09-13,208,sprite,75,100,25,1,00052,India
456605,2023-09-13,203,mango yogurt,50,60,10,1,00245,India
456605,2023-09-13,213,bisleri,6,15,9,1,00245,India
456605,2023-09-13,207,coca cola,75,100,25,1,00245,India
180333,2023-09-13,207,coca cola,75,100,25,1,00036,India
180333,2023-09-13,212,amul cheese,250,315,65,1,00036,India
180333,2023-09-13,208,sprite,75,100,25,1,00036,India
173662,2023-09-13,210,mountain dew,75,100,25,1,00122,India
173662,2023-09-13,213,bisleri,6,15,9,1,00122,India
173662,2023-09-13,206,yakult,360,400,40,1,00122,India
173662,2023-09-13,205,classic yogurt,45,60,15,1,00122,India
304764,2023-09-13,213,bisleri,6,15,9,1,00039,India
304764,2023-09-13,210,mountain dew,75,100,25,1,00039,India
304764,2023-09-13,201,paneer,210,340,130,1,00039,India
811622,2023-09-13,209,pepsi,75,100,25,1,00037,India
811622,2023-09-13,212,amul cheese,250,315,65,1,00037,India
811622,2023-09-13,206,yakult,360,400,40,1,00037,India
811622,2023-09-13,202,milk,12,27,15,1,00037,India
741942,2023-09-13,204,strawberry yogurt,50,60,10,1,00270,India
741942,2023-09-13,208,sprite,75,100,25,1,00270,India
691976,2023-09-13,204,strawberry yogurt,50,60,10,1,00063,India
691976,2023-09-13,210,mountain dew,75,100,25,1,00063,India
691976,2023-09-13,212,amul cheese,250,315,65,1,00063,India
691976,2023-09-13,213,bisleri,6,15,9,1,00063,India
691976,2023-09-13,209,pepsi,75,100,25,1,00063,India
613092,2023-09-13,202,milk,12,27,15,1,00288,India
613092,2023-09-13,201,paneer,210,340,130,1,00288,India
613092,2023-09-13,213,bisleri,6,15,9,1,00288,India
868890,2023-09-13,205,classic yogurt,45,60,15,1,00403,India
868890,2023-09-13,203,mango yogurt,50,60,10,1,00403,India
868890,2023-09-13,201,paneer,210,340,130,1,00403,India
868890,2023-09-13,213,bisleri,6,15,9,1,00403,India
174136,2023-09-13,204,strawberry yogurt,50,60,10,1,00445,India
174136,2023-09-13,208,sprite,75,100,25,1,00445,India
174136,2023-09-13,203,mango yogurt,50,60,10,1,00445,India
948162,2023-09-13,208,sprite,75,100,25,1,00296,India
948162,2023-09-13,205,classic yogurt,45,60,15,1,00296,India
948162,2023-09-13,211,red bull,90,125,35,1,00296,India
130401,2023-09-13,207,coca cola,75,100,25,1,00175,India
183308,2023-09-13,202,milk,12,27,15,1,00162,India
183308,2023-09-13,210,mountain dew,75,100,25,1,00162,India
708874,2023-09-13,210,mountain dew,75,100,25,1,00237,India
708874,2023-09-13,212,amul cheese,250,315,65,1,00237,India
708874,2023-09-13,206,yakult,360,400,40,1,00237,India
708874,2023-09-13,204,strawberry yogurt,50,60,10,1,00237,India
215560,2023-09-13,203,mango yogurt,50,60,10,1,00191,India
215560,2023-09-13,210,mountain dew,75,100,25,1,00191,India
314228,2023-09-13,201,paneer,210,340,130,1,00388,India
314228,2023-09-13,210,mountain dew,75,100,25,1,00388,India
314228,2023-09-13,209,pepsi,75,100,25,1,00388,India
755247,2023-09-13,210,mountain dew,75,100,25,1,00307,India
755247,2023-09-13,205,classic yogurt,45,60,15,1,00307,India
755247,2023-09-13,206,yakult,360,400,40,1,00307,India
755247,2023-09-13,209,pepsi,75,100,25,1,00307,India
652818,2023-09-13,201,paneer,210,340,130,1,00273,India
642675,2023-09-13,201,paneer,210,340,130,1,00124,India
642675,2023-09-13,207,coca cola,75,100,25,1,00124,India
642675,2023-09-13,208,sprite,75,100,25,1,00124,India
642675,2023-09-13,210,mountain dew,75,100,25,1,00124,India
872098,2023-09-13,204,strawberry yogurt,50,60,10,1,00047,India
872098,2023-09-13,202,milk,12,27,15,1,00047,India
872098,2023-09-13,207,coca cola,75,100,25,1,00047,India
261919,2023-09-13,209,pepsi,75,100,25,1,00444,India
261919,2023-09-13,208,sprite,75,100,25,1,00444,India
608015,2023-09-13,202,milk,12,27,15,1,00307,India
608015,2023-09-13,212,amul cheese,250,315,65,1,00307,India
608015,2023-09-13,210,mountain dew,75,100,25,1,00307,India
206924,2023-09-13,207,coca cola,75,100,25,1,00350,India
206924,2023-09-13,206,yakult,360,400,40,1,00350,India
206924,2023-09-13,213,bisleri,6,15,9,1,00350,India
206924,2023-09-13,212,amul cheese,250,315,65,1,00350,India
569898,2023-09-13,203,mango yogurt,50,60,10,1,00059,India
493530,2023-09-13,201,paneer,210,340,130,1,00152,India
493530,2023-09-13,210,mountain dew,75,100,25,1,00152,India
380498,2023-09-13,213,bisleri,6,15,9,1,00122,India
380498,2023-09-13,202,milk,12,27,15,1,00122,India
380498,2023-09-13,212,amul cheese,250,315,65,1,00122,India
395710,2023-09-13,212,amul cheese,250,315,65,1,00204,India
395710,2023-09-13,209,pepsi,75,100,25,1,00204,India
718437,2023-09-13,206,yakult,360,400,40,1,00190,India
349039,2023-09-13,203,mango yogurt,50,60,10,1,00379,India
349039,2023-09-13,204,strawberry yogurt,50,60,10,1,00379,India
349039,2023-09-13,207,coca cola,75,100,25,1,00379,India
349039,2023-09-13,208,sprite,75,100,25,1,00379,India
371206,2023-09-13,201,paneer,210,340,130,1,00480,India
371206,2023-09-13,202,milk,12,27,15,1,00480,India
371206,2023-09-13,206,yakult,360,400,40,1,00480,India
698676,2023-09-13,210,mountain dew,75,100,25,1,00260,India
698676,2023-09-13,213,bisleri,6,15,9,1,00260,India
698676,2023-09-13,211,red bull,90,125,35,1,00260,India
698676,2023-09-13,206,yakult,360,400,40,1,00260,India
300149,2023-09-13,206,yakult,360,400,40,1,00128,India
300149,2023-09-13,201,paneer,210,340,130,1,00128,India
433791,2023-09-13,210,mountain dew,75,100,25,1,00280,India
433791,2023-09-13,206,yakult,360,400,40,1,00280,India
473603,2023-09-13,206,yakult,360,400,40,1,00304,India
473603,2023-09-13,212,amul cheese,250,315,65,1,00304,India
473603,2023-09-13,201,paneer,210,340,130,1,00304,India
473603,2023-09-13,211,red bull,90,125,35,1,00304,India
124073,2023-09-13,213,bisleri,6,15,9,1,00326,India
124073,2023-09-13,211,red bull,90,125,35,1,00326,India
124073,2023-09-13,202,milk,12,27,15,1,00326,India
373069,2023-09-14,209,pepsi,75,100,25,1,00261,India
373069,2023-09-14,202,milk,12,27,15,1,00261,India
373069,2023-09-14,213,bisleri,6,15,9,1,00261,India
373069,2023-09-14,207,coca cola,75,100,25,1,00261,India
373069,2023-09-14,211,red bull,90,125,35,1,00261,India
215078,2023-09-14,209,pepsi,75,100,25,1,00444,India
215078,2023-09-14,213,bisleri,6,15,9,1,00444,India
215078,2023-09-14,212,amul cheese,250,315,65,1,00444,India
215078,2023-09-14,211,red bull,90,125,35,1,00444,India
760315,2023-09-14,210,mountain dew,75,100,25,1,00332,India
760315,2023-09-14,209,pepsi,75,100,25,1,00332,India
760315,2023-09-14,212,amul cheese,250,315,65,1,00332,India
414562,2023-09-14,207,coca cola,75,100,25,1,00177,India
414562,2023-09-14,212,amul cheese,250,315,65,1,00177,India
414562,2023-09-14,204,strawberry yogurt,50,60,10,1,00177,India
751301,2023-09-14,201,paneer,210,340,130,1,00421,India
751301,2023-09-14,206,yakult,360,400,40,1,00421,India
751301,2023-09-14,209,pepsi,75,100,25,1,00421,India
382474,2023-09-14,206,yakult,360,400,40,1,00182,India
382474,2023-09-14,204,strawberry yogurt,50,60,10,1,00182,India
741805,2023-09-14,208,sprite,75,100,25,1,00119,India
741805,2023-09-14,206,yakult,360,400,40,1,00119,India
593635,2023-09-14,204,strawberry yogurt,50,60,10,1,00491,India
834429,2023-09-14,201,paneer,210,340,130,1,00062,India
722229,2023-09-14,213,bisleri,6,15,9,1,00337,India
722229,2023-09-14,202,milk,12,27,15,1,00337,India
722229,2023-09-14,210,mountain dew,75,100,25,1,00337,India
722229,2023-09-14,208,sprite,75,100,25,1,00337,India
414531,2023-09-14,202,milk,12,27,15,1,00483,India
414531,2023-09-14,203,mango yogurt,50,60,10,1,00483,India
414531,2023-09-14,211,red bull,90,125,35,1,00483,India
414531,2023-09-14,204,strawberry yogurt,50,60,10,1,00483,India
852027,2023-09-14,209,pepsi,75,100,25,1,00224,India
852027,2023-09-14,211,red bull,90,125,35,1,00224,India
852027,2023-09-14,213,bisleri,6,15,9,1,00224,India
852027,2023-09-14,206,yakult,360,400,40,1,00224,India
852027,2023-09-14,212,amul cheese,250,315,65,1,00224,India
358921,2023-09-14,211,red bull,90,125,35,1,00275,India
173151,2023-09-14,208,sprite,75,100,25,1,00248,India
173151,2023-09-14,204,strawberry yogurt,50,60,10,1,00248,India
173151,2023-09-14,201,paneer,210,340,130,1,00248,India
173151,2023-09-14,203,mango yogurt,50,60,10,1,00248,India
708858,2023-09-14,205,classic yogurt,45,60,15,1,00089,India
708858,2023-09-14,202,milk,12,27,15,1,00089,India
708858,2023-09-14,208,sprite,75,100,25,1,00089,India
338141,2023-09-14,204,strawberry yogurt,50,60,10,1,00156,India
338141,2023-09-14,212,amul cheese,250,315,65,1,00156,India
338141,2023-09-14,208,sprite,75,100,25,1,00156,India
371915,2023-09-14,211,red bull,90,125,35,1,00212,India
371915,2023-09-14,201,paneer,210,340,130,1,00212,India
371915,2023-09-14,203,mango yogurt,50,60,10,1,00212,India
775233,2023-09-14,212,amul cheese,250,315,65,1,00393,India
775233,2023-09-14,202,milk,12,27,15,1,00393,India
775233,2023-09-14,210,mountain dew,75,100,25,1,00393,India
597976,2023-09-14,208,sprite,75,100,25,1,00236,India
597976,2023-09-14,210,mountain dew,75,100,25,1,00236,India
597976,2023-09-14,203,mango yogurt,50,60,10,1,00236,India
597976,2023-09-14,213,bisleri,6,15,9,1,00236,India
597976,2023-09-14,205,classic yogurt,45,60,15,1,00236,India
785890,2023-09-14,213,bisleri,6,15,9,1,00462,India
785890,2023-09-14,208,sprite,75,100,25,1,00462,India
785890,2023-09-14,206,yakult,360,400,40,1,00462,India
785890,2023-09-14,212,amul cheese,250,315,65,1,00462,India
951323,2023-09-14,205,classic yogurt,45,60,15,1,00080,India
951323,2023-09-14,208,sprite,75,100,25,1,00080,India
834040,2023-09-14,204,strawberry yogurt,50,60,10,1,00055,India
834040,2023-09-14,212,amul cheese,250,315,65,1,00055,India
834040,2023-09-14,205,classic yogurt,45,60,15,1,00055,India
834040,2023-09-14,210,mountain dew,75,100,25,1,00055,India
664120,2023-09-14,207,coca cola,75,100,25,1,00067,India
664120,2023-09-14,209,pepsi,75,100,25,1,00067,India
664120,2023-09-14,212,amul cheese,250,315,65,1,00067,India
383153,2023-09-14,213,bisleri,6,15,9,1,00117,India
383153,2023-09-14,208,sprite,75,100,25,1,00117,India
383153,2023-09-14,207,coca cola,75,100,25,1,00117,India
253097,2023-09-14,209,pepsi,75,100,25,1,00288,India
253097,2023-09-14,212,amul cheese,250,315,65,1,00288,India
175341,2023-09-14,202,milk,12,27,15,1,00256,India
175341,2023-09-14,212,amul cheese,250,315,65,1,00256,India
175341,2023-09-14,201,paneer,210,340,130,1,00256,India
175341,2023-09-14,208,sprite,75,100,25,1,00256,India
903322,2023-09-14,210,mountain dew,75,100,25,1,00252,India
369177,2023-09-14,201,paneer,210,340,130,1,00297,India
369177,2023-09-14,207,coca cola,75,100,25,1,00297,India
369177,2023-09-14,211,red bull,90,125,35,1,00297,India
458597,2023-09-14,205,classic yogurt,45,60,15,1,00430,India
458597,2023-09-14,209,pepsi,75,100,25,1,00430,India
458597,2023-09-14,202,milk,12,27,15,1,00430,India
458597,2023-09-14,211,red bull,90,125,35,1,00430,India
148650,2023-09-14,202,milk,12,27,15,1,00375,India
148650,2023-09-14,212,amul cheese,250,315,65,1,00375,India
252035,2023-09-14,208,sprite,75,100,25,1,00446,India
252035,2023-09-14,203,mango yogurt,50,60,10,1,00446,India
707188,2023-09-14,212,amul cheese,250,315,65,1,00040,India
707188,2023-09-14,210,mountain dew,75,100,25,1,00040,India
707188,2023-09-14,204,strawberry yogurt,50,60,10,1,00040,India
707188,2023-09-14,203,mango yogurt,50,60,10,1,00040,India
316591,2023-09-14,203,mango yogurt,50,60,10,1,00338,India
530770,2023-09-14,212,amul cheese,250,315,65,1,00193,India
530770,2023-09-14,203,mango yogurt,50,60,10,1,00193,India
530770,2023-09-14,210,mountain dew,75,100,25,1,00193,India
530770,2023-09-14,202,milk,12,27,15,1,00193,India
966934,2023-09-14,202,milk,12,27,15,1,00099,India
966934,2023-09-14,205,classic yogurt,45,60,15,1,00099,India
966934,2023-09-14,201,paneer,210,340,130,1,00099,India
966934,2023-09-14,212,amul cheese,250,315,65,1,00099,India
746121,2023-09-14,206,yakult,360,400,40,1,00269,India
746121,2023-09-14,201,paneer,210,340,130,1,00269,India
803904,2023-09-14,210,mountain dew,75,100,25,1,00336,India
803904,2023-09-14,206,yakult,360,400,40,1,00336,India
803904,2023-09-14,208,sprite,75,100,25,1,00336,India
959215,2023-09-14,208,sprite,75,100,25,1,00284,India
399632,2023-09-14,204,strawberry yogurt,50,60,10,1,00132,India
399632,2023-09-14,210,mountain dew,75,100,25,1,00132,India
399632,2023-09-14,202,milk,12,27,15,1,00132,India
167959,2023-09-14,202,milk,12,27,15,1,00045,India
737901,2023-09-14,206,yakult,360,400,40,1,00055,India
737901,2023-09-14,213,bisleri,6,15,9,1,00055,India
737901,2023-09-14,210,mountain dew,75,100,25,1,00055,India
414572,2023-09-14,202,milk,12,27,15,1,00460,India
414572,2023-09-14,210,mountain dew,75,100,25,1,00460,India
414572,2023-09-14,203,mango yogurt,50,60,10,1,00460,India
414572,2023-09-14,208,sprite,75,100,25,1,00460,India
371585,2023-09-14,208,sprite,75,100,25,1,00088,India
371585,2023-09-14,201,paneer,210,340,130,1,00088,India
843370,2023-09-14,203,mango yogurt,50,60,10,1,00474,India
843370,2023-09-14,202,milk,12,27,15,1,00474,India
843370,2023-09-14,208,sprite,75,100,25,1,00474,India
843370,2023-09-14,205,classic yogurt,45,60,15,1,00474,India
100744,2023-09-14,207,coca cola,75,100,25,1,00200,India
100744,2023-09-14,211,red bull,90,125,35,1,00200,India
949991,2023-09-14,204,strawberry yogurt,50,60,10,1,00191,India
949991,2023-09-14,211,red bull,90,125,35,1,00191,India
684534,2023-09-14,210,mountain dew,75,100,25,1,00132,India
659229,2023-09-14,204,strawberry yogurt,50,60,10,1,00194,India
659229,2023-09-14,202,milk,12,27,15,1,00194,India
659229,2023-09-14,206,yakult,360,400,40,1,00194,India
659229,2023-09-14,212,amul cheese,250,315,65,1,00194,India
849455,2023-09-14,209,pepsi,75,100,25,1,00172,India
801631,2023-09-14,205,classic yogurt,45,60,15,1,00414,India
801631,2023-09-14,208,sprite,75,100,25,1,00414,India
801631,2023-09-14,209,pepsi,75,100,25,1,00414,India
801631,2023-09-14,213,bisleri,6,15,9,1,00414,India
405969,2023-09-14,209,pepsi,75,100,25,1,00161,India
562601,2023-09-14,211,red bull,90,125,35,1,00467,India
562601,2023-09-14,207,coca cola,75,100,25,1,00467,India
562601,2023-09-14,203,mango yogurt,50,60,10,1,00467,India
562601,2023-09-14,201,paneer,210,340,130,1,00467,India
157530,2023-09-14,213,bisleri,6,15,9,1,00214,India
157530,2023-09-14,210,mountain dew,75,100,25,1,00214,India
157530,2023-09-14,212,amul cheese,250,315,65,1,00214,India
698564,2023-09-14,203,mango yogurt,50,60,10,1,00385,India
698564,2023-09-14,206,yakult,360,400,40,1,00385,India
698564,2023-09-14,201,paneer,210,340,130,1,00385,India
698564,2023-09-14,209,pepsi,75,100,25,1,00385,India
107594,2023-09-15,201,paneer,210,340,130,1,00006,India
107594,2023-09-15,213,bisleri,6,15,9,1,00006,India
107594,2023-09-15,207,coca cola,75,100,25,1,00006,India
107594,2023-09-15,210,mountain dew,75,100,25,1,00006,India
944940,2023-09-15,207,coca cola,75,100,25,1,00457,India
623661,2023-09-15,207,coca cola,75,100,25,1,00167,India
623661,2023-09-15,208,sprite,75,100,25,1,00167,India
600929,2023-09-15,202,milk,12,27,15,1,00436,India
520574,2023-09-15,208,sprite,75,100,25,1,00306,India
107271,2023-09-15,205,classic yogurt,45,60,15,1,00365,India
107271,2023-09-15,209,pepsi,75,100,25,1,00365,India
107271,2023-09-15,212,amul cheese,250,315,65,1,00365,India
107271,2023-09-15,203,mango yogurt,50,60,10,1,00365,India
655475,2023-09-15,208,sprite,75,100,25,1,00320,India
655475,2023-09-15,209,pepsi,75,100,25,1,00320,India
655475,2023-09-15,204,strawberry yogurt,50,60,10,1,00320,India
642783,2023-09-15,204,strawberry yogurt,50,60,10,1,00132,India
642783,2023-09-15,203,mango yogurt,50,60,10,1,00132,India
642783,2023-09-15,201,paneer,210,340,130,1,00132,India
578056,2023-09-15,213,bisleri,6,15,9,1,00099,India
578056,2023-09-15,205,classic yogurt,45,60,15,1,00099,India
197531,2023-09-15,202,milk,12,27,15,1,00487,India
197531,2023-09-15,210,mountain dew,75,100,25,1,00487,India
197531,2023-09-15,213,bisleri,6,15,9,1,00487,India
197531,2023-09-15,205,classic yogurt,45,60,15,1,00487,India
108895,2023-09-15,213,bisleri,6,15,9,1,00488,India
108895,2023-09-15,201,paneer,210,340,130,1,00488,India
245003,2023-09-15,204,strawberry yogurt,50,60,10,1,00341,India
245003,2023-09-15,208,sprite,75,100,25,1,00341,India
245003,2023-09-15,209,pepsi,75,100,25,1,00341,India
617899,2023-09-15,207,coca cola,75,100,25,1,00237,India
938265,2023-09-15,211,red bull,90,125,35,1,00475,India
938265,2023-09-15,202,milk,12,27,15,1,00475,India
721408,2023-09-15,213,bisleri,6,15,9,1,00309,India
721408,2023-09-15,211,red bull,90,125,35,1,00309,India
721408,2023-09-15,208,sprite,75,100,25,1,00309,India
721408,2023-09-15,210,mountain dew,75,100,25,1,00309,India
673826,2023-09-15,209,pepsi,75,100,25,1,00495,India
673826,2023-09-15,206,yakult,360,400,40,1,00495,India
673826,2023-09-15,208,sprite,75,100,25,1,00495,India
673826,2023-09-15,202,milk,12,27,15,1,00495,India
961709,2023-09-15,213,bisleri,6,15,9,1,00335,India
961709,2023-09-15,201,paneer,210,340,130,1,00335,India
689210,2023-09-15,205,classic yogurt,45,60,15,1,00282,India
689210,2023-09-15,211,red bull,90,125,35,1,00282,India
689210,2023-09-15,213,bisleri,6,15,9,1,00282,India
689210,2023-09-15,202,milk,12,27,15,1,00282,India
771061,2023-09-15,208,sprite,75,100,25,1,00390,India
771061,2023-09-15,202,milk,12,27,15,1,00390,India
771061,2023-09-15,204,strawberry yogurt,50,60,10,1,00390,India
771061,2023-09-15,210,mountain dew,75,100,25,1,00390,India
771061,2023-09-15,209,pepsi,75,100,25,1,00390,India
217188,2023-09-15,202,milk,12,27,15,1,00230,India
217188,2023-09-15,211,red bull,90,125,35,1,00230,India
217188,2023-09-15,205,classic yogurt,45,60,15,1,00230,India
217188,2023-09-15,207,coca cola,75,100,25,1,00230,India
539116,2023-09-15,213,bisleri,6,15,9,1,00398,India
539116,2023-09-15,212,amul cheese,250,315,65,1,00398,India
539116,2023-09-15,206,yakult,360,400,40,1,00398,India
539116,2023-09-15,207,coca cola,75,100,25,1,00398,India
369427,2023-09-15,201,paneer,210,340,130,1,00364,India
369427,2023-09-15,202,milk,12,27,15,1,00364,India
369427,2023-09-15,208,sprite,75,100,25,1,00364,India
369427,2023-09-15,204,strawberry yogurt,50,60,10,1,00364,India
376162,2023-09-15,206,yakult,360,400,40,1,00043,India
376162,2023-09-15,205,classic yogurt,45,60,15,1,00043,India
789608,2023-09-15,203,mango yogurt,50,60,10,1,00325,India
309246,2023-09-15,207,coca cola,75,100,25,1,00125,India
309246,2023-09-15,203,mango yogurt,50,60,10,1,00125,India
309246,2023-09-15,211,red bull,90,125,35,1,00125,India
309246,2023-09-15,205,classic yogurt,45,60,15,1,00125,India
484209,2023-09-15,201,paneer,210,340,130,1,00038,India
484209,2023-09-15,204,strawberry yogurt,50,60,10,1,00038,India
601974,2023-09-15,212,amul cheese,250,315,65,1,00415,India
601974,2023-09-15,210,mountain dew,75,100,25,1,00415,India
433007,2023-09-15,210,mountain dew,75,100,25,1,00109,India
433007,2023-09-15,203,mango yogurt,50,60,10,1,00109,India
433007,2023-09-15,207,coca cola,75,100,25,1,00109,India
466133,2023-09-15,205,classic yogurt,45,60,15,1,00418,India
466133,2023-09-15,203,mango yogurt,50,60,10,1,00418,India
466133,2023-09-15,208,sprite,75,100,25,1,00418,India
466133,2023-09-15,204,strawberry yogurt,50,60,10,1,00418,India
812041,2023-09-15,206,yakult,360,400,40,1,00382,India
812041,2023-09-15,211,red bull,90,125,35,1,00382,India
312700,2023-09-15,209,pepsi,75,100,25,1,00145,India
312700,2023-09-15,208,sprite,75,100,25,1,00145,India
312700,2023-09-15,206,yakult,360,400,40,1,00145,India
312700,2023-09-15,202,milk,12,27,15,1,00145,India
491476,2023-09-15,208,sprite,75,100,25,1,00334,India
491476,2023-09-15,203,mango yogurt,50,60,10,1,00334,India
491476,2023-09-15,212,amul cheese,250,315,65,1,00334,India
491476,2023-09-15,204,strawberry yogurt,50,60,10,1,00334,India
371382,2023-09-15,205,classic yogurt,45,60,15,1,00247,India
371382,2023-09-15,210,mountain dew,75,100,25,1,00247,India
371382,2023-09-15,211,red bull,90,125,35,1,00247,India
371382,2023-09-15,207,coca cola,75,100,25,1,00247,India
340385,2023-09-15,211,red bull,90,125,35,1,00320,India
340385,2023-09-15,213,bisleri,6,15,9,1,00320,India
340385,2023-09-15,209,pepsi,75,100,25,1,00320,India
863193,2023-09-15,213,bisleri,6,15,9,1,00167,India
863193,2023-09-15,204,strawberry yogurt,50,60,10,1,00167,India
863193,2023-09-15,207,coca cola,75,100,25,1,00167,India
863193,2023-09-15,210,mountain dew,75,100,25,1,00167,India
863193,2023-09-15,208,sprite,75,100,25,1,00167,India
528190,2023-09-15,210,mountain dew,75,100,25,1,00429,India
305323,2023-09-15,209,pepsi,75,100,25,1,00496,India
204864,2023-09-15,203,mango yogurt,50,60,10,1,00156,India
968449,2023-09-15,206,yakult,360,400,40,1,00231,India
968449,2023-09-15,208,sprite,75,100,25,1,00231,India
968449,2023-09-15,211,red bull,90,125,35,1,00231,India
968449,2023-09-15,210,mountain dew,75,100,25,1,00231,India
919467,2023-09-15,204,strawberry yogurt,50,60,10,1,00164,India
382136,2023-09-15,210,mountain dew,75,100,25,1,00126,India
382136,2023-09-15,206,yakult,360,400,40,1,00126,India
382136,2023-09-15,201,paneer,210,340,130,1,00126,India
382136,2023-09-15,205,classic yogurt,45,60,15,1,00126,India
106565,2023-09-15,202,milk,12,27,15,1,00422,India
106565,2023-09-15,203,mango yogurt,50,60,10,1,00422,India
106565,2023-09-15,207,coca cola,75,100,25,1,00422,India
106565,2023-09-15,213,bisleri,6,15,9,1,00422,India
106565,2023-09-15,206,yakult,360,400,40,1,00422,India
227919,2023-09-15,206,yakult,360,400,40,1,00224,India
227919,2023-09-15,208,sprite,75,100,25,1,00224,India
227919,2023-09-15,205,classic yogurt,45,60,15,1,00224,India
334508,2023-09-15,201,paneer,210,340,130,1,00035,India
493845,2023-09-15,201,paneer,210,340,130,1,00041,India
493845,2023-09-15,203,mango yogurt,50,60,10,1,00041,India
222767,2023-09-15,206,yakult,360,400,40,1,00483,India
222767,2023-09-15,209,pepsi,75,100,25,1,00483,India
833936,2023-09-15,204,strawberry yogurt,50,60,10,1,00054,India
833936,2023-09-15,203,mango yogurt,50,60,10,1,00054,India
291645,2023-09-15,208,sprite,75,100,25,1,00462,India
291645,2023-09-15,211,red bull,90,125,35,1,00462,India
291645,2023-09-15,204,strawberry yogurt,50,60,10,1,00462,India
396140,2023-09-15,206,yakult,360,400,40,1,00307,India
396140,2023-09-15,209,pepsi,75,100,25,1,00307,India
960837,2023-09-15,208,sprite,75,100,25,1,00172,India
270490,2023-09-15,211,red bull,90,125,35,1,00215,India
270490,2023-09-15,207,coca cola,75,100,25,1,00215,India
270490,2023-09-15,205,classic yogurt,45,60,15,1,00215,India
270490,2023-09-15,210,mountain dew,75,100,25,1,00215,India
270490,2023-09-15,213,bisleri,6,15,9,1,00215,India
905878,2023-09-15,209,pepsi,75,100,25,1,00366,India
905878,2023-09-15,201,paneer,210,340,130,1,00366,India
905878,2023-09-15,203,mango yogurt,50,60,10,1,00366,India
905878,2023-09-15,208,sprite,75,100,25,1,00366,India
905878,2023-09-15,205,classic yogurt,45,60,15,1,00366,India
337848,2023-09-15,204,strawberry yogurt,50,60,10,1,00331,India
172997,2023-09-15,202,milk,12,27,15,1,00278,India
172997,2023-09-15,209,pepsi,75,100,25,1,00278,India
377590,2023-09-15,202,milk,12,27,15,1,00464,India
377590,2023-09-15,204,strawberry yogurt,50,60,10,1,00464,India
377590,2023-09-15,207,coca cola,75,100,25,1,00464,India
377590,2023-09-15,208,sprite,75,100,25,1,00464,India
377590,2023-09-15,211,red bull,90,125,35,1,00464,India
135511,2023-09-15,207,coca cola,75,100,25,1,00445,India
135511,2023-09-15,209,pepsi,75,100,25,1,00445,India
135511,2023-09-15,206,yakult,360,400,40,1,00445,India
938716,2023-09-15,204,strawberry yogurt,50,60,10,1,00249,India
938716,2023-09-15,206,yakult,360,400,40,1,00249,India
938716,2023-09-15,207,coca cola,75,100,25,1,00249,India
938716,2023-09-15,213,bisleri,6,15,9,1,00249,India
583664,2023-09-15,201,paneer,210,340,130,1,00301,India
583664,2023-09-15,213,bisleri,6,15,9,1,00301,India
583664,2023-09-15,211,red bull,90,125,35,1,00301,India
583664,2023-09-15,205,classic yogurt,45,60,15,1,00301,India
142647,2023-09-15,202,milk,12,27,15,1,00098,India
587607,2023-09-15,206,yakult,360,400,40,1,00482,India
587607,2023-09-15,202,milk,12,27,15,1,00482,India
587607,2023-09-15,209,pepsi,75,100,25,1,00482,India
955791,2023-09-15,213,bisleri,6,15,9,1,00007,India
955791,2023-09-15,204,strawberry yogurt,50,60,10,1,00007,India
955791,2023-09-15,207,coca cola,75,100,25,1,00007,India
537527,2023-09-15,201,paneer,210,340,130,1,00344,India
537527,2023-09-15,207,coca cola,75,100,25,1,00344,India
537527,2023-09-15,210,mountain dew,75,100,25,1,00344,India
537527,2023-09-15,205,classic yogurt,45,60,15,1,00344,India
528059,2023-09-15,207,coca cola,75,100,25,1,00223,India
528059,2023-09-15,209,pepsi,75,100,25,1,00223,India
528059,2023-09-15,213,bisleri,6,15,9,1,00223,India
528059,2023-09-15,205,classic yogurt,45,60,15,1,00223,India
535900,2023-09-15,203,mango yogurt,50,60,10,1,00302,India
535145,2023-09-15,205,classic yogurt,45,60,15,1,00319,India
535145,2023-09-15,213,bisleri,6,15,9,1,00319,India
535145,2023-09-15,209,pepsi,75,100,25,1,00319,India
535145,2023-09-15,212,amul cheese,250,315,65,1,00319,India
822420,2023-09-15,212,amul cheese,250,315,65,1,00182,India
906414,2023-09-15,203,mango yogurt,50,60,10,1,00362,India
906414,2023-09-15,201,paneer,210,340,130,1,00362,India
935257,2023-09-15,203,mango yogurt,50,60,10,1,00323,India
935257,2023-09-15,208,sprite,75,100,25,1,00323,India
935257,2023-09-15,213,bisleri,6,15,9,1,00323,India
935257,2023-09-15,205,classic yogurt,45,60,15,1,00323,India
935257,2023-09-15,209,pepsi,75,100,25,1,00323,India
753222,2023-09-15,203,mango yogurt,50,60,10,1,00485,India
753222,2023-09-15,201,paneer,210,340,130,1,00485,India
753222,2023-09-15,206,yakult,360,400,40,1,00485,India
753222,2023-09-15,204,strawberry yogurt,50,60,10,1,00485,India
451425,2023-09-15,213,bisleri,6,15,9,1,00256,India
451425,2023-09-15,202,milk,12,27,15,1,00256,India
451425,2023-09-15,209,pepsi,75,100,25,1,00256,India
736223,2023-09-15,203,mango yogurt,50,60,10,1,00303,India
736223,2023-09-15,207,coca cola,75,100,25,1,00303,India
736223,2023-09-15,211,red bull,90,125,35,1,00303,India
736223,2023-09-15,210,mountain dew,75,100,25,1,00303,India
440066,2023-09-15,204,strawberry yogurt,50,60,10,1,00188,India
440066,2023-09-15,209,pepsi,75,100,25,1,00188,India
440066,2023-09-15,210,mountain dew,75,100,25,1,00188,India
814046,2023-09-15,209,pepsi,75,100,25,1,00069,India
679694,2023-09-15,203,mango yogurt,50,60,10,1,00295,India
679694,2023-09-15,213,bisleri,6,15,9,1,00295,India
679694,2023-09-15,210,mountain dew,75,100,25,1,00295,India
679694,2023-09-15,201,paneer,210,340,130,1,00295,India
569464,2023-09-15,203,mango yogurt,50,60,10,1,00423,India
607984,2023-09-15,204,strawberry yogurt,50,60,10,1,00487,India
900951,2023-09-15,212,amul cheese,250,315,65,1,00485,India
900951,2023-09-15,204,strawberry yogurt,50,60,10,1,00485,India
900951,2023-09-15,207,coca cola,75,100,25,1,00485,India
490913,2023-09-15,210,mountain dew,75,100,25,1,00103,India
490913,2023-09-15,212,amul cheese,250,315,65,1,00103,India
672198,2023-09-15,210,mountain dew,75,100,25,1,00370,India
173341,2023-09-15,206,yakult,360,400,40,1,00177,India
173341,2023-09-15,203,mango yogurt,50,60,10,1,00177,India
173341,2023-09-15,207,coca cola,75,100,25,1,00177,India
173341,2023-09-15,204,strawberry yogurt,50,60,10,1,00177,India
173341,2023-09-15,213,bisleri,6,15,9,1,00177,India
601944,2023-09-15,207,coca cola,75,100,25,1,00001,India
601944,2023-09-15,205,classic yogurt,45,60,15,1,00001,India
601944,2023-09-15,213,bisleri,6,15,9,1,00001,India
197813,2023-09-15,202,milk,12,27,15,1,00346,India
197813,2023-09-15,205,classic yogurt,45,60,15,1,00346,India
426658,2023-09-15,213,bisleri,6,15,9,1,00313,India
426658,2023-09-15,207,coca cola,75,100,25,1,00313,India
426658,2023-09-15,201,paneer,210,340,130,1,00313,India
426658,2023-09-15,209,pepsi,75,100,25,1,00313,India
499370,2023-09-16,209,pepsi,75,100,25,1,00440,India
499370,2023-09-16,202,milk,12,27,15,1,00440,India
499370,2023-09-16,208,sprite,75,100,25,1,00440,India
499370,2023-09-16,206,yakult,360,400,40,1,00440,India
451401,2023-09-16,211,red bull,90,125,35,1,00158,India
451401,2023-09-16,206,yakult,360,400,40,1,00158,India
451401,2023-09-16,207,coca cola,75,100,25,1,00158,India
771485,2023-09-16,202,milk,12,27,15,1,00279,India
771485,2023-09-16,205,classic yogurt,45,60,15,1,00279,India
771485,2023-09-16,201,paneer,210,340,130,1,00279,India
771485,2023-09-16,204,strawberry yogurt,50,60,10,1,00279,India
710269,2023-09-16,207,coca cola,75,100,25,1,00116,India
710269,2023-09-16,211,red bull,90,125,35,1,00116,India
710269,2023-09-16,204,strawberry yogurt,50,60,10,1,00116,India
735531,2023-09-16,207,coca cola,75,100,25,1,00464,India
673461,2023-09-16,205,classic yogurt,45,60,15,1,00216,India
673461,2023-09-16,208,sprite,75,100,25,1,00216,India
127517,2023-09-16,202,milk,12,27,15,1,00419,India
542282,2023-09-16,206,yakult,360,400,40,1,00461,India
542282,2023-09-16,208,sprite,75,100,25,1,00461,India
624371,2023-09-16,205,classic yogurt,45,60,15,1,00358,India
624371,2023-09-16,201,paneer,210,340,130,1,00358,India
107861,2023-09-16,206,yakult,360,400,40,1,00127,India
107861,2023-09-16,204,strawberry yogurt,50,60,10,1,00127,India
695764,2023-09-16,205,classic yogurt,45,60,15,1,00496,India
695764,2023-09-16,212,amul cheese,250,315,65,1,00496,India
186093,2023-09-16,210,mountain dew,75,100,25,1,00360,India
186093,2023-09-16,208,sprite,75,100,25,1,00360,India
186093,2023-09-16,204,strawberry yogurt,50,60,10,1,00360,India
900509,2023-09-16,212,amul cheese,250,315,65,1,00496,India
115791,2023-09-16,209,pepsi,75,100,25,1,00387,India
115791,2023-09-16,206,yakult,360,400,40,1,00387,India
962343,2023-09-16,210,mountain dew,75,100,25,1,00002,India
962343,2023-09-16,206,yakult,360,400,40,1,00002,India
962343,2023-09-16,213,bisleri,6,15,9,1,00002,India
962343,2023-09-16,205,classic yogurt,45,60,15,1,00002,India
962343,2023-09-16,211,red bull,90,125,35,1,00002,India
211895,2023-09-16,210,mountain dew,75,100,25,1,00369,India
211895,2023-09-16,209,pepsi,75,100,25,1,00369,India
211895,2023-09-16,203,mango yogurt,50,60,10,1,00369,India
211895,2023-09-16,213,bisleri,6,15,9,1,00369,India
873348,2023-09-16,213,bisleri,6,15,9,1,00326,India
232663,2023-09-16,211,red bull,90,125,35,1,00253,India
232663,2023-09-16,213,bisleri,6,15,9,1,00253,India
378402,2023-09-16,201,paneer,210,340,130,1,00423,India
378402,2023-09-16,202,milk,12,27,15,1,00423,India
378402,2023-09-16,209,pepsi,75,100,25,1,00423,India
984136,2023-09-16,213,bisleri,6,15,9,1,00393,India
984136,2023-09-16,212,amul cheese,250,315,65,1,00393,India
893928,2023-09-16,211,red bull,90,125,35,1,00461,India
306059,2023-09-16,203,mango yogurt,50,60,10,1,00414,India
306059,2023-09-16,207,coca cola,75,100,25,1,00414,India
306059,2023-09-16,202,milk,12,27,15,1,00414,India
306059,2023-09-16,213,bisleri,6,15,9,1,00414,India
803700,2023-09-16,201,paneer,210,340,130,1,00316,India
803700,2023-09-16,206,yakult,360,400,40,1,00316,India
803700,2023-09-16,205,classic yogurt,45,60,15,1,00316,India
699809,2023-09-16,207,coca cola,75,100,25,1,00082,India
396635,2023-09-16,206,yakult,360,400,40,1,00177,India
396635,2023-09-16,212,amul cheese,250,315,65,1,00177,India
396635,2023-09-16,208,sprite,75,100,25,1,00177,India
396635,2023-09-16,203,mango yogurt,50,60,10,1,00177,India
651084,2023-09-16,213,bisleri,6,15,9,1,00002,India
651084,2023-09-16,210,mountain dew,75,100,25,1,00002,India
226478,2023-09-16,202,milk,12,27,15,1,00284,India
226478,2023-09-16,203,mango yogurt,50,60,10,1,00284,India
226478,2023-09-16,206,yakult,360,400,40,1,00284,India
226478,2023-09-16,207,coca cola,75,100,25,1,00284,India
232282,2023-09-16,210,mountain dew,75,100,25,1,00257,India
232282,2023-09-16,208,sprite,75,100,25,1,00257,India
903409,2023-09-16,201,paneer,210,340,130,1,00253,India
903409,2023-09-16,207,coca cola,75,100,25,1,00253,India
141625,2023-09-16,205,classic yogurt,45,60,15,1,00295,India
141625,2023-09-16,208,sprite,75,100,25,1,00295,India
141625,2023-09-16,210,mountain dew,75,100,25,1,00295,India
141625,2023-09-16,206,yakult,360,400,40,1,00295,India
141625,2023-09-16,209,pepsi,75,100,25,1,00295,India
911983,2023-09-16,204,strawberry yogurt,50,60,10,1,00491,India
911983,2023-09-16,203,mango yogurt,50,60,10,1,00491,India
911983,2023-09-16,213,bisleri,6,15,9,1,00491,India
911983,2023-09-16,205,classic yogurt,45,60,15,1,00491,India
845202,2023-09-16,205,classic yogurt,45,60,15,1,00028,India
357934,2023-09-16,210,mountain dew,75,100,25,1,00467,India
901133,2023-09-16,213,bisleri,6,15,9,1,00375,India
901133,2023-09-16,202,milk,12,27,15,1,00375,India
901133,2023-09-16,205,classic yogurt,45,60,15,1,00375,India
180359,2023-09-16,203,mango yogurt,50,60,10,1,00046,India
180359,2023-09-16,202,milk,12,27,15,1,00046,India
180359,2023-09-16,205,classic yogurt,45,60,15,1,00046,India
169837,2023-09-16,208,sprite,75,100,25,1,00009,India
169837,2023-09-16,202,milk,12,27,15,1,00009,India
169837,2023-09-16,206,yakult,360,400,40,1,00009,India
169837,2023-09-16,209,pepsi,75,100,25,1,00009,India
752791,2023-09-16,209,pepsi,75,100,25,1,00136,India
635879,2023-09-16,207,coca cola,75,100,25,1,00076,India
211065,2023-09-16,207,coca cola,75,100,25,1,00025,India
211065,2023-09-16,211,red bull,90,125,35,1,00025,India
211065,2023-09-16,210,mountain dew,75,100,25,1,00025,India
357007,2023-09-16,201,paneer,210,340,130,1,00277,India
357007,2023-09-16,213,bisleri,6,15,9,1,00277,India
357007,2023-09-16,205,classic yogurt,45,60,15,1,00277,India
357007,2023-09-16,202,milk,12,27,15,1,00277,India
485609,2023-09-16,202,milk,12,27,15,1,00031,India
485609,2023-09-16,209,pepsi,75,100,25,1,00031,India
485609,2023-09-16,211,red bull,90,125,35,1,00031,India
485609,2023-09-16,206,yakult,360,400,40,1,00031,India
301243,2023-09-16,210,mountain dew,75,100,25,1,00003,India
301243,2023-09-16,208,sprite,75,100,25,1,00003,India
301243,2023-09-16,203,mango yogurt,50,60,10,1,00003,India
384714,2023-09-16,212,amul cheese,250,315,65,1,00151,India
384714,2023-09-16,210,mountain dew,75,100,25,1,00151,India
384714,2023-09-16,209,pepsi,75,100,25,1,00151,India
527587,2023-09-16,204,strawberry yogurt,50,60,10,1,00355,India
527587,2023-09-16,211,red bull,90,125,35,1,00355,India
527587,2023-09-16,210,mountain dew,75,100,25,1,00355,India
527587,2023-09-16,201,paneer,210,340,130,1,00355,India
182402,2023-09-16,213,bisleri,6,15,9,1,00302,India
182402,2023-09-16,208,sprite,75,100,25,1,00302,India
600659,2023-09-16,203,mango yogurt,50,60,10,1,00404,India
253235,2023-09-16,201,paneer,210,340,130,1,00313,India
253235,2023-09-16,211,red bull,90,125,35,1,00313,India
777924,2023-09-16,208,sprite,75,100,25,1,00425,India
777924,2023-09-16,209,pepsi,75,100,25,1,00425,India
777924,2023-09-16,207,coca cola,75,100,25,1,00425,India
777924,2023-09-16,212,amul cheese,250,315,65,1,00425,India
612266,2023-09-16,205,classic yogurt,45,60,15,1,00010,India
612266,2023-09-16,206,yakult,360,400,40,1,00010,India
612266,2023-09-16,210,mountain dew,75,100,25,1,00010,India
612266,2023-09-16,213,bisleri,6,15,9,1,00010,India
424003,2023-09-16,202,milk,12,27,15,1,00271,India
424003,2023-09-16,211,red bull,90,125,35,1,00271,India
424003,2023-09-16,201,paneer,210,340,130,1,00271,India
424003,2023-09-16,213,bisleri,6,15,9,1,00271,India
424003,2023-09-16,207,coca cola,75,100,25,1,00271,India
852948,2023-09-16,209,pepsi,75,100,25,1,00185,India
852948,2023-09-16,202,milk,12,27,15,1,00185,India
852948,2023-09-16,203,mango yogurt,50,60,10,1,00185,India
852948,2023-09-16,211,red bull,90,125,35,1,00185,India
400666,2023-09-16,206,yakult,360,400,40,1,00336,India
400666,2023-09-16,205,classic yogurt,45,60,15,1,00336,India
400666,2023-09-16,207,coca cola,75,100,25,1,00336,India
822397,2023-09-16,213,bisleri,6,15,9,1,00177,India
822397,2023-09-16,206,yakult,360,400,40,1,00177,India
822397,2023-09-16,202,milk,12,27,15,1,00177,India
822397,2023-09-16,211,red bull,90,125,35,1,00177,India
822397,2023-09-16,212,amul cheese,250,315,65,1,00177,India
407603,2023-09-16,211,red bull,90,125,35,1,00359,India
407603,2023-09-16,205,classic yogurt,45,60,15,1,00359,India
407603,2023-09-16,203,mango yogurt,50,60,10,1,00359,India
904350,2023-09-16,204,strawberry yogurt,50,60,10,1,00274,India
261687,2023-09-16,209,pepsi,75,100,25,1,00272,India
261687,2023-09-16,211,red bull,90,125,35,1,00272,India
261687,2023-09-16,206,yakult,360,400,40,1,00272,India
261687,2023-09-16,213,bisleri,6,15,9,1,00272,India
727104,2023-09-16,212,amul cheese,250,315,65,1,00101,India
727104,2023-09-16,211,red bull,90,125,35,1,00101,India
358821,2023-09-16,201,paneer,210,340,130,1,00363,India
358821,2023-09-16,207,coca cola,75,100,25,1,00363,India
358821,2023-09-16,204,strawberry yogurt,50,60,10,1,00363,India
358821,2023-09-16,213,bisleri,6,15,9,1,00363,India
358821,2023-09-16,206,yakult,360,400,40,1,00363,India
969209,2023-09-16,210,mountain dew,75,100,25,1,00336,India
969209,2023-09-16,204,strawberry yogurt,50,60,10,1,00336,India
817356,2023-09-16,210,mountain dew,75,100,25,1,00064,India
817356,2023-09-16,204,strawberry yogurt,50,60,10,1,00064,India
817356,2023-09-16,213,bisleri,6,15,9,1,00064,India
817356,2023-09-16,208,sprite,75,100,25,1,00064,India
313697,2023-09-16,206,yakult,360,400,40,1,00343,India
313697,2023-09-16,205,classic yogurt,45,60,15,1,00343,India
313697,2023-09-16,209,pepsi,75,100,25,1,00343,India
224479,2023-09-16,202,milk,12,27,15,1,00126,India
224479,2023-09-16,208,sprite,75,100,25,1,00126,India
224479,2023-09-16,211,red bull,90,125,35,1,00126,India
224479,2023-09-16,203,mango yogurt,50,60,10,1,00126,India
373893,2023-09-16,213,bisleri,6,15,9,1,00298,India
373893,2023-09-16,204,strawberry yogurt,50,60,10,1,00298,India
306311,2023-09-16,204,strawberry yogurt,50,60,10,1,00251,India
306311,2023-09-16,201,paneer,210,340,130,1,00251,India
306311,2023-09-16,208,sprite,75,100,25,1,00251,India
982320,2023-09-16,206,yakult,360,400,40,1,00052,India
982320,2023-09-16,212,amul cheese,250,315,65,1,00052,India
982320,2023-09-16,205,classic yogurt,45,60,15,1,00052,India
982320,2023-09-16,207,coca cola,75,100,25,1,00052,India
402851,2023-09-16,210,mountain dew,75,100,25,1,00251,India
277776,2023-09-16,208,sprite,75,100,25,1,00348,India
277776,2023-09-16,209,pepsi,75,100,25,1,00348,India
277776,2023-09-16,207,coca cola,75,100,25,1,00348,India
934182,2023-09-16,204,strawberry yogurt,50,60,10,1,00221,India
934182,2023-09-16,202,milk,12,27,15,1,00221,India
519101,2023-09-16,209,pepsi,75,100,25,1,00358,India
519101,2023-09-16,212,amul cheese,250,315,65,1,00358,India
291409,2023-09-16,213,bisleri,6,15,9,1,00025,India
291409,2023-09-16,209,pepsi,75,100,25,1,00025,India
291409,2023-09-16,201,paneer,210,340,130,1,00025,India
291409,2023-09-16,203,mango yogurt,50,60,10,1,00025,India
629966,2023-09-16,211,red bull,90,125,35,1,00189,India
629966,2023-09-16,205,classic yogurt,45,60,15,1,00189,India
629966,2023-09-16,209,pepsi,75,100,25,1,00189,India
629966,2023-09-16,207,coca cola,75,100,25,1,00189,India
280348,2023-09-16,208,sprite,75,100,25,1,00435,India
280348,2023-09-16,213,bisleri,6,15,9,1,00435,India
280348,2023-09-16,206,yakult,360,400,40,1,00435,India
280348,2023-09-16,205,classic yogurt,45,60,15,1,00435,India
827951,2023-09-16,211,red bull,90,125,35,1,00467,India
827951,2023-09-16,203,mango yogurt,50,60,10,1,00467,India
464052,2023-09-16,204,strawberry yogurt,50,60,10,1,00471,India
464052,2023-09-16,203,mango yogurt,50,60,10,1,00471,India
464052,2023-09-16,209,pepsi,75,100,25,1,00471,India
464052,2023-09-16,210,mountain dew,75,100,25,1,00471,India
831233,2023-09-16,204,strawberry yogurt,50,60,10,1,00122,India
831233,2023-09-16,203,mango yogurt,50,60,10,1,00122,India
831233,2023-09-16,202,milk,12,27,15,1,00122,India
831233,2023-09-16,207,coca cola,75,100,25,1,00122,India
831233,2023-09-16,213,bisleri,6,15,9,1,00122,India
866555,2023-09-17,203,mango yogurt,50,60,10,1,00275,India
866555,2023-09-17,213,bisleri,6,15,9,1,00275,India
866555,2023-09-17,212,amul cheese,250,315,65,1,00275,India
866555,2023-09-17,211,red bull,90,125,35,1,00275,India
462215,2023-09-17,202,milk,12,27,15,1,00457,India
462215,2023-09-17,208,sprite,75,100,25,1,00457,India
790993,2023-09-17,211,red bull,90,125,35,1,00379,India
790993,2023-09-17,209,pepsi,75,100,25,1,00379,India
790993,2023-09-17,212,amul cheese,250,315,65,1,00379,India
790993,2023-09-17,206,yakult,360,400,40,1,00379,India
790993,2023-09-17,208,sprite,75,100,25,1,00379,India
172533,2023-09-17,203,mango yogurt,50,60,10,1,00230,India
172533,2023-09-17,202,milk,12,27,15,1,00230,India
259253,2023-09-17,213,bisleri,6,15,9,1,00088,India
259253,2023-09-17,211,red bull,90,125,35,1,00088,India
129694,2023-09-17,202,milk,12,27,15,1,00299,India
129694,2023-09-17,203,mango yogurt,50,60,10,1,00299,India
129694,2023-09-17,208,sprite,75,100,25,1,00299,India
129694,2023-09-17,201,paneer,210,340,130,1,00299,India
120229,2023-09-17,211,red bull,90,125,35,1,00453,India
120229,2023-09-17,212,amul cheese,250,315,65,1,00453,India
120229,2023-09-17,201,paneer,210,340,130,1,00453,India
120229,2023-09-17,209,pepsi,75,100,25,1,00453,India
497635,2023-09-17,202,milk,12,27,15,1,00345,India
497635,2023-09-17,210,mountain dew,75,100,25,1,00345,India
774011,2023-09-17,210,mountain dew,75,100,25,1,00463,India
774011,2023-09-17,213,bisleri,6,15,9,1,00463,India
902492,2023-09-17,206,yakult,360,400,40,1,00369,India
902492,2023-09-17,210,mountain dew,75,100,25,1,00369,India
902492,2023-09-17,204,strawberry yogurt,50,60,10,1,00369,India
902492,2023-09-17,211,red bull,90,125,35,1,00369,India
814870,2023-09-17,210,mountain dew,75,100,25,1,00130,India
814870,2023-09-17,209,pepsi,75,100,25,1,00130,India
814870,2023-09-17,206,yakult,360,400,40,1,00130,India
529647,2023-09-17,202,milk,12,27,15,1,00318,India
529647,2023-09-17,210,mountain dew,75,100,25,1,00318,India
529647,2023-09-17,207,coca cola,75,100,25,1,00318,India
529647,2023-09-17,213,bisleri,6,15,9,1,00318,India
529647,2023-09-17,203,mango yogurt,50,60,10,1,00318,India
994151,2023-09-17,210,mountain dew,75,100,25,1,00132,India
994151,2023-09-17,202,milk,12,27,15,1,00132,India
994151,2023-09-17,208,sprite,75,100,25,1,00132,India
479871,2023-09-17,209,pepsi,75,100,25,1,00085,India
479871,2023-09-17,213,bisleri,6,15,9,1,00085,India
479871,2023-09-17,201,paneer,210,340,130,1,00085,India
432653,2023-09-17,213,bisleri,6,15,9,1,00391,India
432653,2023-09-17,207,coca cola,75,100,25,1,00391,India
432653,2023-09-17,208,sprite,75,100,25,1,00391,India
432653,2023-09-17,202,milk,12,27,15,1,00391,India
327594,2023-09-17,213,bisleri,6,15,9,1,00072,India
327594,2023-09-17,203,mango yogurt,50,60,10,1,00072,India
541093,2023-09-17,213,bisleri,6,15,9,1,00060,India
541093,2023-09-17,205,classic yogurt,45,60,15,1,00060,India
541093,2023-09-17,211,red bull,90,125,35,1,00060,India
345130,2023-09-17,209,pepsi,75,100,25,1,00169,India
360812,2023-09-17,213,bisleri,6,15,9,1,00040,India
360812,2023-09-17,206,yakult,360,400,40,1,00040,India
943887,2023-09-17,213,bisleri,6,15,9,1,00114,India
943887,2023-09-17,204,strawberry yogurt,50,60,10,1,00114,India
943887,2023-09-17,205,classic yogurt,45,60,15,1,00114,India
943887,2023-09-17,203,mango yogurt,50,60,10,1,00114,India
953333,2023-09-17,203,mango yogurt,50,60,10,1,00404,India
953333,2023-09-17,208,sprite,75,100,25,1,00404,India
953333,2023-09-17,205,classic yogurt,45,60,15,1,00404,India
491858,2023-09-17,202,milk,12,27,15,1,00361,India
491858,2023-09-17,206,yakult,360,400,40,1,00361,India
491858,2023-09-17,201,paneer,210,340,130,1,00361,India
921953,2023-09-17,204,strawberry yogurt,50,60,10,1,00470,India
921953,2023-09-17,205,classic yogurt,45,60,15,1,00470,India
921953,2023-09-17,211,red bull,90,125,35,1,00470,India
855997,2023-09-17,207,coca cola,75,100,25,1,00283,India
855997,2023-09-17,212,amul cheese,250,315,65,1,00283,India
855997,2023-09-17,205,classic yogurt,45,60,15,1,00283,India
855997,2023-09-17,213,bisleri,6,15,9,1,00283,India
855997,2023-09-17,201,paneer,210,340,130,1,00283,India
895936,2023-09-17,205,classic yogurt,45,60,15,1,00414,India
895936,2023-09-17,209,pepsi,75,100,25,1,00414,India
895936,2023-09-17,203,mango yogurt,50,60,10,1,00414,India
895936,2023-09-17,207,coca cola,75,100,25,1,00414,India
895936,2023-09-17,210,mountain dew,75,100,25,1,00414,India
932107,2023-09-17,202,milk,12,27,15,1,00027,India
932107,2023-09-17,207,coca cola,75,100,25,1,00027,India
932107,2023-09-17,204,strawberry yogurt,50,60,10,1,00027,India
932107,2023-09-17,212,amul cheese,250,315,65,1,00027,India
932107,2023-09-17,206,yakult,360,400,40,1,00027,India
560082,2023-09-17,209,pepsi,75,100,25,1,00471,India
560082,2023-09-17,211,red bull,90,125,35,1,00471,India
560082,2023-09-17,204,strawberry yogurt,50,60,10,1,00471,India
560082,2023-09-17,201,paneer,210,340,130,1,00471,India
580330,2023-09-17,203,mango yogurt,50,60,10,1,00201,India
580330,2023-09-17,206,yakult,360,400,40,1,00201,India
580330,2023-09-17,213,bisleri,6,15,9,1,00201,India
580330,2023-09-17,209,pepsi,75,100,25,1,00201,India
628742,2023-09-17,213,bisleri,6,15,9,1,00475,India
628742,2023-09-17,202,milk,12,27,15,1,00475,India
628742,2023-09-17,204,strawberry yogurt,50,60,10,1,00475,India
628742,2023-09-17,205,classic yogurt,45,60,15,1,00475,India
579865,2023-09-17,203,mango yogurt,50,60,10,1,00499,India
579865,2023-09-17,212,amul cheese,250,315,65,1,00499,India
579865,2023-09-17,208,sprite,75,100,25,1,00499,India
469264,2023-09-17,209,pepsi,75,100,25,1,00497,India
469264,2023-09-17,206,yakult,360,400,40,1,00497,India
469264,2023-09-17,212,amul cheese,250,315,65,1,00497,India
469264,2023-09-17,207,coca cola,75,100,25,1,00497,India
203682,2023-09-17,207,coca cola,75,100,25,1,00172,India
203682,2023-09-17,213,bisleri,6,15,9,1,00172,India
946253,2023-09-17,212,amul cheese,250,315,65,1,00323,India
692711,2023-09-17,203,mango yogurt,50,60,10,1,00435,India
692711,2023-09-17,209,pepsi,75,100,25,1,00435,India
177226,2023-09-17,201,paneer,210,340,130,1,00176,India
177226,2023-09-17,205,classic yogurt,45,60,15,1,00176,India
177226,2023-09-17,206,yakult,360,400,40,1,00176,India
177226,2023-09-17,203,mango yogurt,50,60,10,1,00176,India
177226,2023-09-17,209,pepsi,75,100,25,1,00176,India
282998,2023-09-17,203,mango yogurt,50,60,10,1,00041,India
282998,2023-09-17,204,strawberry yogurt,50,60,10,1,00041,India
282998,2023-09-17,209,pepsi,75,100,25,1,00041,India
282998,2023-09-17,202,milk,12,27,15,1,00041,India
336417,2023-09-17,207,coca cola,75,100,25,1,00065,India
336417,2023-09-17,209,pepsi,75,100,25,1,00065,India
336417,2023-09-17,211,red bull,90,125,35,1,00065,India
336417,2023-09-17,203,mango yogurt,50,60,10,1,00065,India
238804,2023-09-17,201,paneer,210,340,130,1,00361,India
238804,2023-09-17,208,sprite,75,100,25,1,00361,India
238804,2023-09-17,211,red bull,90,125,35,1,00361,India
555696,2023-09-17,207,coca cola,75,100,25,1,00322,India
555696,2023-09-17,210,mountain dew,75,100,25,1,00322,India
732155,2023-09-17,204,strawberry yogurt,50,60,10,1,00107,India
732155,2023-09-17,213,bisleri,6,15,9,1,00107,India
732155,2023-09-17,209,pepsi,75,100,25,1,00107,India
732155,2023-09-17,206,yakult,360,400,40,1,00107,India
339607,2023-09-17,206,yakult,360,400,40,1,00240,India
339607,2023-09-17,211,red bull,90,125,35,1,00240,India
339607,2023-09-17,208,sprite,75,100,25,1,00240,India
339607,2023-09-17,210,mountain dew,75,100,25,1,00240,India
353796,2023-09-17,205,classic yogurt,45,60,15,1,00028,India
353796,2023-09-17,212,amul cheese,250,315,65,1,00028,India
353796,2023-09-17,209,pepsi,75,100,25,1,00028,India
353796,2023-09-17,213,bisleri,6,15,9,1,00028,India
725420,2023-09-17,207,coca cola,75,100,25,1,00161,India
725420,2023-09-17,213,bisleri,6,15,9,1,00161,India
774110,2023-09-17,208,sprite,75,100,25,1,00112,India
299204,2023-09-17,210,mountain dew,75,100,25,1,00169,India
299204,2023-09-17,207,coca cola,75,100,25,1,00169,India
102633,2023-09-17,202,milk,12,27,15,1,00273,India
102633,2023-09-17,204,strawberry yogurt,50,60,10,1,00273,India
102633,2023-09-17,201,paneer,210,340,130,1,00273,India
102633,2023-09-17,213,bisleri,6,15,9,1,00273,India
102633,2023-09-17,210,mountain dew,75,100,25,1,00273,India
491427,2023-09-17,212,amul cheese,250,315,65,1,00348,India
491427,2023-09-17,209,pepsi,75,100,25,1,00348,India
602554,2023-09-17,212,amul cheese,250,315,65,1,00358,India
602554,2023-09-17,205,classic yogurt,45,60,15,1,00358,India
602554,2023-09-17,209,pepsi,75,100,25,1,00358,India
731887,2023-09-17,208,sprite,75,100,25,1,00073,India
731887,2023-09-17,212,amul cheese,250,315,65,1,00073,India
731887,2023-09-17,207,coca cola,75,100,25,1,00073,India
923577,2023-09-17,205,classic yogurt,45,60,15,1,00479,India
923577,2023-09-17,213,bisleri,6,15,9,1,00479,India
918773,2023-09-17,212,amul cheese,250,315,65,1,00025,India
918773,2023-09-17,207,coca cola,75,100,25,1,00025,India
918773,2023-09-17,201,paneer,210,340,130,1,00025,India
918773,2023-09-17,203,mango yogurt,50,60,10,1,00025,India
304792,2023-09-17,209,pepsi,75,100,25,1,00050,India
304792,2023-09-17,206,yakult,360,400,40,1,00050,India
304792,2023-09-17,213,bisleri,6,15,9,1,00050,India
304792,2023-09-17,201,paneer,210,340,130,1,00050,India
304792,2023-09-17,212,amul cheese,250,315,65,1,00050,India
691895,2023-09-17,209,pepsi,75,100,25,1,00007,India
691895,2023-09-17,205,classic yogurt,45,60,15,1,00007,India
691895,2023-09-17,213,bisleri,6,15,9,1,00007,India
488295,2023-09-17,203,mango yogurt,50,60,10,1,00492,India
488295,2023-09-17,213,bisleri,6,15,9,1,00492,India
488295,2023-09-17,201,paneer,210,340,130,1,00492,India
488295,2023-09-17,207,coca cola,75,100,25,1,00492,India
488295,2023-09-17,212,amul cheese,250,315,65,1,00492,India
878057,2023-09-17,211,red bull,90,125,35,1,00209,India
316419,2023-09-17,208,sprite,75,100,25,1,00404,India
316419,2023-09-17,211,red bull,90,125,35,1,00404,India
294874,2023-09-17,205,classic yogurt,45,60,15,1,00013,India
294874,2023-09-17,202,milk,12,27,15,1,00013,India
294874,2023-09-17,213,bisleri,6,15,9,1,00013,India
294874,2023-09-17,206,yakult,360,400,40,1,00013,India
366087,2023-09-17,210,mountain dew,75,100,25,1,00027,India
366087,2023-09-17,205,classic yogurt,45,60,15,1,00027,India
366087,2023-09-17,211,red bull,90,125,35,1,00027,India
366087,2023-09-17,203,mango yogurt,50,60,10,1,00027,India
366087,2023-09-17,207,coca cola,75,100,25,1,00027,India
103882,2023-09-17,203,mango yogurt,50,60,10,1,00136,India
103882,2023-09-17,211,red bull,90,125,35,1,00136,India
103882,2023-09-17,204,strawberry yogurt,50,60,10,1,00136,India
732092,2023-09-17,212,amul cheese,250,315,65,1,00099,India
732092,2023-09-17,206,yakult,360,400,40,1,00099,India
732092,2023-09-17,205,classic yogurt,45,60,15,1,00099,India
403946,2023-09-17,207,coca cola,75,100,25,1,00226,India
403946,2023-09-17,213,bisleri,6,15,9,1,00226,India
844539,2023-09-17,209,pepsi,75,100,25,1,00388,India
505904,2023-09-17,210,mountain dew,75,100,25,1,00040,India
505904,2023-09-17,208,sprite,75,100,25,1,00040,India
505904,2023-09-17,209,pepsi,75,100,25,1,00040,India
505904,2023-09-17,211,red bull,90,125,35,1,00040,India
968999,2023-09-17,212,amul cheese,250,315,65,1,00430,India
968999,2023-09-17,205,classic yogurt,45,60,15,1,00430,India
968999,2023-09-17,211,red bull,90,125,35,1,00430,India
642622,2023-09-17,206,yakult,360,400,40,1,00071,India
994284,2023-09-17,213,bisleri,6,15,9,1,00232,India
994284,2023-09-17,212,amul cheese,250,315,65,1,00232,India
994284,2023-09-17,203,mango yogurt,50,60,10,1,00232,India
517507,2023-09-17,213,bisleri,6,15,9,1,00006,India
517507,2023-09-17,202,milk,12,27,15,1,00006,India
517507,2023-09-17,204,strawberry yogurt,50,60,10,1,00006,India
441045,2023-09-17,201,paneer,210,340,130,1,00307,India
441045,2023-09-17,212,amul cheese,250,315,65,1,00307,India
727389,2023-09-17,213,bisleri,6,15,9,1,00484,India
727389,2023-09-17,203,mango yogurt,50,60,10,1,00484,India
727389,2023-09-17,207,coca cola,75,100,25,1,00484,India
149153,2023-09-17,206,yakult,360,400,40,1,00243,India
149153,2023-09-17,212,amul cheese,250,315,65,1,00243,India
149153,2023-09-17,209,pepsi,75,100,25,1,00243,India
149153,2023-09-17,207,coca cola,75,100,25,1,00243,India
797590,2023-09-17,201,paneer,210,340,130,1,00124,India
433243,2023-09-17,208,sprite,75,100,25,1,00436,India
433243,2023-09-17,202,milk,12,27,15,1,00436,India
433243,2023-09-17,209,pepsi,75,100,25,1,00436,India
433243,2023-09-17,213,bisleri,6,15,9,1,00436,India
433243,2023-09-17,203,mango yogurt,50,60,10,1,00436,India
492424,2023-09-17,206,yakult,360,400,40,1,00196,India
433570,2023-09-17,206,yakult,360,400,40,1,00438,India
433570,2023-09-17,202,milk,12,27,15,1,00438,India
433570,2023-09-17,213,bisleri,6,15,9,1,00438,India
433570,2023-09-17,211,red bull,90,125,35,1,00438,India
433570,2023-09-17,207,coca cola,75,100,25,1,00438,India
482877,2023-09-17,207,coca cola,75,100,25,1,00226,India
482877,2023-09-17,208,sprite,75,100,25,1,00226,India
482877,2023-09-17,203,mango yogurt,50,60,10,1,00226,India
482877,2023-09-17,206,yakult,360,400,40,1,00226,India
507117,2023-09-17,202,milk,12,27,15,1,00164,India
507117,2023-09-17,206,yakult,360,400,40,1,00164,India
507117,2023-09-17,213,bisleri,6,15,9,1,00164,India
507117,2023-09-17,212,amul cheese,250,315,65,1,00164,India
507117,2023-09-17,211,red bull,90,125,35,1,00164,India
716851,2023-09-17,208,sprite,75,100,25,1,00075,India
609511,2023-09-17,203,mango yogurt,50,60,10,1,00215,India
609511,2023-09-17,202,milk,12,27,15,1,00215,India
609511,2023-09-17,212,amul cheese,250,315,65,1,00215,India
609511,2023-09-17,211,red bull,90,125,35,1,00215,India
753378,2023-09-17,207,coca cola,75,100,25,1,00243,India
753378,2023-09-17,210,mountain dew,75,100,25,1,00243,India
753378,2023-09-17,213,bisleri,6,15,9,1,00243,India
943648,2023-09-17,208,sprite,75,100,25,1,00007,India
943648,2023-09-17,206,yakult,360,400,40,1,00007,India
943648,2023-09-17,204,strawberry yogurt,50,60,10,1,00007,India
943648,2023-09-17,201,paneer,210,340,130,1,00007,India
943648,2023-09-17,207,coca cola,75,100,25,1,00007,India
400383,2023-09-17,203,mango yogurt,50,60,10,1,00295,India
400383,2023-09-17,202,milk,12,27,15,1,00295,India
400383,2023-09-17,212,amul cheese,250,315,65,1,00295,India
400383,2023-09-17,205,classic yogurt,45,60,15,1,00295,India
864836,2023-09-17,212,amul cheese,250,315,65,1,00073,India
864836,2023-09-17,202,milk,12,27,15,1,00073,India
864836,2023-09-17,205,classic yogurt,45,60,15,1,00073,India
531706,2023-09-17,208,sprite,75,100,25,1,00180,India
531706,2023-09-17,202,milk,12,27,15,1,00180,India
531706,2023-09-17,206,yakult,360,400,40,1,00180,India
275136,2023-09-17,202,milk,12,27,15,1,00090,India
275136,2023-09-17,208,sprite,75,100,25,1,00090,India
275136,2023-09-17,203,mango yogurt,50,60,10,1,00090,India
275136,2023-09-17,209,pepsi,75,100,25,1,00090,India
275136,2023-09-17,205,classic yogurt,45,60,15,1,00090,India
651082,2023-09-17,202,milk,12,27,15,1,00135,India
651082,2023-09-17,212,amul cheese,250,315,65,1,00135,India
651082,2023-09-17,211,red bull,90,125,35,1,00135,India
227089,2023-09-17,212,amul cheese,250,315,65,1,00205,India
495079,2023-09-17,209,pepsi,75,100,25,1,00113,India
577683,2023-09-17,209,pepsi,75,100,25,1,00204,India
577683,2023-09-17,211,red bull,90,125,35,1,00204,India
577683,2023-09-17,204,strawberry yogurt,50,60,10,1,00204,India
577683,2023-09-17,208,sprite,75,100,25,1,00204,India
577683,2023-09-17,206,yakult,360,400,40,1,00204,India
547097,2023-09-17,205,classic yogurt,45,60,15,1,00483,India
547097,2023-09-17,213,bisleri,6,15,9,1,00483,India
547097,2023-09-17,201,paneer,210,340,130,1,00483,India
547097,2023-09-17,204,strawberry yogurt,50,60,10,1,00483,India
124900,2023-09-17,203,mango yogurt,50,60,10,1,00147,India
124900,2023-09-17,208,sprite,75,100,25,1,00147,India
124900,2023-09-17,201,paneer,210,340,130,1,00147,India
124900,2023-09-17,206,yakult,360,400,40,1,00147,India
998024,2023-09-17,202,milk,12,27,15,1,00089,India
850536,2023-09-17,206,yakult,360,400,40,1,00280,India
684360,2023-09-17,212,amul cheese,250,315,65,1,00197,India
936431,2023-09-17,202,milk,12,27,15,1,00165,India
936431,2023-09-17,211,red bull,90,125,35,1,00165,India
936431,2023-09-17,209,pepsi,75,100,25,1,00165,India
785187,2023-09-17,208,sprite,75,100,25,1,00420,India
785187,2023-09-17,210,mountain dew,75,100,25,1,00420,India
108679,2023-09-17,207,coca cola,75,100,25,1,00123,India
376575,2023-09-17,201,paneer,210,340,130,1,00124,India
376575,2023-09-17,207,coca cola,75,100,25,1,00124,India
376575,2023-09-17,211,red bull,90,125,35,1,00124,India
713189,2023-09-17,212,amul cheese,250,315,65,1,00346,India
713189,2023-09-17,204,strawberry yogurt,50,60,10,1,00346,India
713189,2023-09-17,203,mango yogurt,50,60,10,1,00346,India
713189,2023-09-17,201,paneer,210,340,130,1,00346,India
929520,2023-09-17,203,mango yogurt,50,60,10,1,00418,India
704235,2023-09-17,206,yakult,360,400,40,1,00419,India
704235,2023-09-17,211,red bull,90,125,35,1,00419,India
698541,2023-09-18,212,amul cheese,250,315,65,1,00480,India
698541,2023-09-18,211,red bull,90,125,35,1,00480,India
698541,2023-09-18,207,coca cola,75,100,25,1,00480,India
698541,2023-09-18,213,bisleri,6,15,9,1,00480,India
981345,2023-09-18,211,red bull,90,125,35,1,00077,India
206153,2023-09-18,206,yakult,360,400,40,1,00193,India
206153,2023-09-18,210,mountain dew,75,100,25,1,00193,India
206153,2023-09-18,203,mango yogurt,50,60,10,1,00193,India
206153,2023-09-18,209,pepsi,75,100,25,1,00193,India
871557,2023-09-18,204,strawberry yogurt,50,60,10,1,00397,India
871557,2023-09-18,210,mountain dew,75,100,25,1,00397,India
871557,2023-09-18,205,classic yogurt,45,60,15,1,00397,India
871557,2023-09-18,209,pepsi,75,100,25,1,00397,India
671455,2023-09-18,202,milk,12,27,15,1,00183,India
671455,2023-09-18,210,mountain dew,75,100,25,1,00183,India
671455,2023-09-18,203,mango yogurt,50,60,10,1,00183,India
883247,2023-09-18,201,paneer,210,340,130,1,00432,India
883247,2023-09-18,213,bisleri,6,15,9,1,00432,India
883247,2023-09-18,203,mango yogurt,50,60,10,1,00432,India
323903,2023-09-18,212,amul cheese,250,315,65,1,00097,India
233725,2023-09-18,209,pepsi,75,100,25,1,00007,India
406288,2023-09-18,206,yakult,360,400,40,1,00255,India
406288,2023-09-18,210,mountain dew,75,100,25,1,00255,India
406288,2023-09-18,204,strawberry yogurt,50,60,10,1,00255,India
965260,2023-09-18,212,amul cheese,250,315,65,1,00095,India
965260,2023-09-18,203,mango yogurt,50,60,10,1,00095,India
941119,2023-09-18,201,paneer,210,340,130,1,00309,India
941119,2023-09-18,212,amul cheese,250,315,65,1,00309,India
458188,2023-09-18,204,strawberry yogurt,50,60,10,1,00197,India
458188,2023-09-18,206,yakult,360,400,40,1,00197,India
458188,2023-09-18,201,paneer,210,340,130,1,00197,India
458188,2023-09-18,202,milk,12,27,15,1,00197,India
458188,2023-09-18,205,classic yogurt,45,60,15,1,00197,India
464076,2023-09-18,206,yakult,360,400,40,1,00309,India
319235,2023-09-18,204,strawberry yogurt,50,60,10,1,00376,India
319235,2023-09-18,209,pepsi,75,100,25,1,00376,India
319235,2023-09-18,208,sprite,75,100,25,1,00376,India
319235,2023-09-18,207,coca cola,75,100,25,1,00376,India
313781,2023-09-18,207,coca cola,75,100,25,1,00392,India
313781,2023-09-18,208,sprite,75,100,25,1,00392,India
211072,2023-09-18,206,yakult,360,400,40,1,00269,India
211072,2023-09-18,210,mountain dew,75,100,25,1,00269,India
904799,2023-09-18,209,pepsi,75,100,25,1,00252,India
904799,2023-09-18,212,amul cheese,250,315,65,1,00252,India
904799,2023-09-18,203,mango yogurt,50,60,10,1,00252,India
904799,2023-09-18,213,bisleri,6,15,9,1,00252,India
904799,2023-09-18,204,strawberry yogurt,50,60,10,1,00252,India
937001,2023-09-18,202,milk,12,27,15,1,00471,India
310563,2023-09-18,201,paneer,210,340,130,1,00246,India
614551,2023-09-18,208,sprite,75,100,25,1,00324,India
614551,2023-09-18,213,bisleri,6,15,9,1,00324,India
783220,2023-09-18,209,pepsi,75,100,25,1,00219,India
389905,2023-09-18,212,amul cheese,250,315,65,1,00472,India
389905,2023-09-18,201,paneer,210,340,130,1,00472,India
389905,2023-09-18,202,milk,12,27,15,1,00472,India
389905,2023-09-18,213,bisleri,6,15,9,1,00472,India
377404,2023-09-18,204,strawberry yogurt,50,60,10,1,00189,India
377404,2023-09-18,205,classic yogurt,45,60,15,1,00189,India
393280,2023-09-18,204,strawberry yogurt,50,60,10,1,00129,India
393280,2023-09-18,207,coca cola,75,100,25,1,00129,India
393280,2023-09-18,201,paneer,210,340,130,1,00129,India
295857,2023-09-18,212,amul cheese,250,315,65,1,00267,India
295857,2023-09-18,201,paneer,210,340,130,1,00267,India
295857,2023-09-18,209,pepsi,75,100,25,1,00267,India
295857,2023-09-18,208,sprite,75,100,25,1,00267,India
726289,2023-09-18,202,milk,12,27,15,1,00430,India
658880,2023-09-18,210,mountain dew,75,100,25,1,00267,India
876794,2023-09-18,211,red bull,90,125,35,1,00468,India
876794,2023-09-18,205,classic yogurt,45,60,15,1,00468,India
367847,2023-09-18,205,classic yogurt,45,60,15,1,00341,India
367847,2023-09-18,203,mango yogurt,50,60,10,1,00341,India
928174,2023-09-18,210,mountain dew,75,100,25,1,00408,India
144948,2023-09-18,202,milk,12,27,15,1,00384,India
144948,2023-09-18,204,strawberry yogurt,50,60,10,1,00384,India
144948,2023-09-18,205,classic yogurt,45,60,15,1,00384,India
144948,2023-09-18,211,red bull,90,125,35,1,00384,India
377510,2023-09-18,204,strawberry yogurt,50,60,10,1,00133,India
377510,2023-09-18,211,red bull,90,125,35,1,00133,India
199164,2023-09-18,211,red bull,90,125,35,1,00390,India
736136,2023-09-18,203,mango yogurt,50,60,10,1,00227,India
736136,2023-09-18,202,milk,12,27,15,1,00227,India
540736,2023-09-18,210,mountain dew,75,100,25,1,00022,India
540736,2023-09-18,212,amul cheese,250,315,65,1,00022,India
994414,2023-09-18,206,yakult,360,400,40,1,00188,India
895117,2023-09-18,209,pepsi,75,100,25,1,00375,India
895117,2023-09-18,206,yakult,360,400,40,1,00375,India
895117,2023-09-18,203,mango yogurt,50,60,10,1,00375,India
756311,2023-09-18,201,paneer,210,340,130,1,00460,India
756311,2023-09-18,203,mango yogurt,50,60,10,1,00460,India
756311,2023-09-18,207,coca cola,75,100,25,1,00460,India
423228,2023-09-18,201,paneer,210,340,130,1,00139,India
423228,2023-09-18,204,strawberry yogurt,50,60,10,1,00139,India
423228,2023-09-18,208,sprite,75,100,25,1,00139,India
423228,2023-09-18,205,classic yogurt,45,60,15,1,00139,India
423228,2023-09-18,211,red bull,90,125,35,1,00139,India
738742,2023-09-18,206,yakult,360,400,40,1,00069,India
738742,2023-09-18,213,bisleri,6,15,9,1,00069,India
980079,2023-09-18,201,paneer,210,340,130,1,00268,India
980079,2023-09-18,209,pepsi,75,100,25,1,00268,India
980079,2023-09-18,206,yakult,360,400,40,1,00268,India
980079,2023-09-18,210,mountain dew,75,100,25,1,00268,India
980079,2023-09-18,205,classic yogurt,45,60,15,1,00268,India
919107,2023-09-18,202,milk,12,27,15,1,00488,India
919107,2023-09-18,210,mountain dew,75,100,25,1,00488,India
186584,2023-09-18,213,bisleri,6,15,9,1,00296,India
186584,2023-09-18,206,yakult,360,400,40,1,00296,India
186584,2023-09-18,205,classic yogurt,45,60,15,1,00296,India
186584,2023-09-18,203,mango yogurt,50,60,10,1,00296,India
246191,2023-09-18,209,pepsi,75,100,25,1,00232,India
246191,2023-09-18,206,yakult,360,400,40,1,00232,India
246191,2023-09-18,208,sprite,75,100,25,1,00232,India
246191,2023-09-18,204,strawberry yogurt,50,60,10,1,00232,India
957776,2023-09-18,201,paneer,210,340,130,1,00444,India
957776,2023-09-18,213,bisleri,6,15,9,1,00444,India
957776,2023-09-18,205,classic yogurt,45,60,15,1,00444,India
957776,2023-09-18,212,amul cheese,250,315,65,1,00444,India
957776,2023-09-18,202,milk,12,27,15,1,00444,India
125046,2023-09-18,206,yakult,360,400,40,1,00375,India
125046,2023-09-18,204,strawberry yogurt,50,60,10,1,00375,India
125046,2023-09-18,201,paneer,210,340,130,1,00375,India
742106,2023-09-18,205,classic yogurt,45,60,15,1,00460,India
742106,2023-09-18,213,bisleri,6,15,9,1,00460,India
742106,2023-09-18,209,pepsi,75,100,25,1,00460,India
126692,2023-09-18,202,milk,12,27,15,1,00341,India
126692,2023-09-18,210,mountain dew,75,100,25,1,00341,India
126692,2023-09-18,211,red bull,90,125,35,1,00341,India
870396,2023-09-18,208,sprite,75,100,25,1,00225,India
809530,2023-09-18,204,strawberry yogurt,50,60,10,1,00430,India
809530,2023-09-18,209,pepsi,75,100,25,1,00430,India
809530,2023-09-18,207,coca cola,75,100,25,1,00430,India
866203,2023-09-18,210,mountain dew,75,100,25,1,00430,India
866203,2023-09-18,208,sprite,75,100,25,1,00430,India
866203,2023-09-18,213,bisleri,6,15,9,1,00430,India
277373,2023-09-18,207,coca cola,75,100,25,1,00256,India
277373,2023-09-18,213,bisleri,6,15,9,1,00256,India
277373,2023-09-18,203,mango yogurt,50,60,10,1,00256,India
277373,2023-09-18,205,classic yogurt,45,60,15,1,00256,India
439962,2023-09-18,213,bisleri,6,15,9,1,00276,India
439962,2023-09-18,203,mango yogurt,50,60,10,1,00276,India
439962,2023-09-18,202,milk,12,27,15,1,00276,India
439962,2023-09-18,210,mountain dew,75,100,25,1,00276,India
264173,2023-09-18,201,paneer,210,340,130,1,00416,India
264173,2023-09-18,203,mango yogurt,50,60,10,1,00416,India
264173,2023-09-18,207,coca cola,75,100,25,1,00416,India
264173,2023-09-18,212,amul cheese,250,315,65,1,00416,India
282711,2023-09-18,210,mountain dew,75,100,25,1,00273,India
282711,2023-09-18,211,red bull,90,125,35,1,00273,India
282711,2023-09-18,209,pepsi,75,100,25,1,00273,India
282711,2023-09-18,201,paneer,210,340,130,1,00273,India
611124,2023-09-18,210,mountain dew,75,100,25,1,00191,India
611124,2023-09-18,207,coca cola,75,100,25,1,00191,India
611124,2023-09-18,201,paneer,210,340,130,1,00191,India
168278,2023-09-18,211,red bull,90,125,35,1,00425,India
168278,2023-09-18,207,coca cola,75,100,25,1,00425,India
168278,2023-09-18,206,yakult,360,400,40,1,00425,India
168278,2023-09-18,201,paneer,210,340,130,1,00425,India
168278,2023-09-18,212,amul cheese,250,315,65,1,00425,India
627803,2023-09-18,210,mountain dew,75,100,25,1,00460,India
457415,2023-09-18,207,coca cola,75,100,25,1,00407,India
457415,2023-09-18,209,pepsi,75,100,25,1,00407,India
457415,2023-09-18,203,mango yogurt,50,60,10,1,00407,India
457415,2023-09-18,208,sprite,75,100,25,1,00407,India
221049,2023-09-18,211,red bull,90,125,35,1,00486,India
221049,2023-09-18,208,sprite,75,100,25,1,00486,India
221049,2023-09-18,212,amul cheese,250,315,65,1,00486,India
758687,2023-09-18,207,coca cola,75,100,25,1,00006,India
758687,2023-09-18,203,mango yogurt,50,60,10,1,00006,India
758687,2023-09-18,209,pepsi,75,100,25,1,00006,India
660563,2023-09-18,208,sprite,75,100,25,1,00097,India
660563,2023-09-18,206,yakult,360,400,40,1,00097,India
660563,2023-09-18,201,paneer,210,340,130,1,00097,India
195088,2023-09-18,204,strawberry yogurt,50,60,10,1,00325,India
195088,2023-09-18,202,milk,12,27,15,1,00325,India
479130,2023-09-18,207,coca cola,75,100,25,1,00070,India
303390,2023-09-18,202,milk,12,27,15,1,00439,India
303390,2023-09-18,204,strawberry yogurt,50,60,10,1,00439,India
303390,2023-09-18,205,classic yogurt,45,60,15,1,00439,India
303390,2023-09-18,211,red bull,90,125,35,1,00439,India
476947,2023-09-18,202,milk,12,27,15,1,00380,India
476947,2023-09-18,209,pepsi,75,100,25,1,00380,India
476947,2023-09-18,207,coca cola,75,100,25,1,00380,India
476947,2023-09-18,208,sprite,75,100,25,1,00380,India
476947,2023-09-18,201,paneer,210,340,130,1,00380,India
924141,2023-09-18,204,strawberry yogurt,50,60,10,1,00173,India
924141,2023-09-18,205,classic yogurt,45,60,15,1,00173,India
924141,2023-09-18,210,mountain dew,75,100,25,1,00173,India
924141,2023-09-18,203,mango yogurt,50,60,10,1,00173,India
924141,2023-09-18,202,milk,12,27,15,1,00173,India
757920,2023-09-18,210,mountain dew,75,100,25,1,00021,India
249353,2023-09-18,211,red bull,90,125,35,1,00476,India
249353,2023-09-18,206,yakult,360,400,40,1,00476,India
296307,2023-09-18,204,strawberry yogurt,50,60,10,1,00372,India
296307,2023-09-18,210,mountain dew,75,100,25,1,00372,India
296307,2023-09-18,203,mango yogurt,50,60,10,1,00372,India
296307,2023-09-18,208,sprite,75,100,25,1,00372,India
334186,2023-09-18,202,milk,12,27,15,1,00227,India
928928,2023-09-18,202,milk,12,27,15,1,00123,India
110333,2023-09-19,210,mountain dew,75,100,25,1,00294,India
110333,2023-09-19,204,strawberry yogurt,50,60,10,1,00294,India
110333,2023-09-19,205,classic yogurt,45,60,15,1,00294,India
532165,2023-09-19,201,paneer,210,340,130,1,00330,India
650499,2023-09-19,207,coca cola,75,100,25,1,00243,India
650499,2023-09-19,203,mango yogurt,50,60,10,1,00243,India
650499,2023-09-19,210,mountain dew,75,100,25,1,00243,India
206429,2023-09-19,207,coca cola,75,100,25,1,00020,India
206429,2023-09-19,202,milk,12,27,15,1,00020,India
435200,2023-09-19,205,classic yogurt,45,60,15,1,00475,India
435200,2023-09-19,213,bisleri,6,15,9,1,00475,India
435200,2023-09-19,202,milk,12,27,15,1,00475,India
612144,2023-09-19,203,mango yogurt,50,60,10,1,00374,India
612144,2023-09-19,207,coca cola,75,100,25,1,00374,India
424418,2023-09-19,208,sprite,75,100,25,1,00242,India
424418,2023-09-19,213,bisleri,6,15,9,1,00242,India
497112,2023-09-19,201,paneer,210,340,130,1,00387,India
497112,2023-09-19,208,sprite,75,100,25,1,00387,India
497112,2023-09-19,202,milk,12,27,15,1,00387,India
497112,2023-09-19,209,pepsi,75,100,25,1,00387,India
686290,2023-09-19,207,coca cola,75,100,25,1,00410,India
686290,2023-09-19,213,bisleri,6,15,9,1,00410,India
686290,2023-09-19,211,red bull,90,125,35,1,00410,India
579401,2023-09-19,206,yakult,360,400,40,1,00483,India
579401,2023-09-19,207,coca cola,75,100,25,1,00483,India
579401,2023-09-19,210,mountain dew,75,100,25,1,00483,India
579401,2023-09-19,202,milk,12,27,15,1,00483,India
756501,2023-09-19,206,yakult,360,400,40,1,00137,India
756501,2023-09-19,204,strawberry yogurt,50,60,10,1,00137,India
991754,2023-09-19,206,yakult,360,400,40,1,00187,India
991754,2023-09-19,208,sprite,75,100,25,1,00187,India
991754,2023-09-19,213,bisleri,6,15,9,1,00187,India
991754,2023-09-19,211,red bull,90,125,35,1,00187,India
953755,2023-09-19,206,yakult,360,400,40,1,00088,India
615622,2023-09-19,213,bisleri,6,15,9,1,00299,India
615622,2023-09-19,202,milk,12,27,15,1,00299,India
615622,2023-09-19,209,pepsi,75,100,25,1,00299,India
449397,2023-09-19,206,yakult,360,400,40,1,00364,India
449397,2023-09-19,202,milk,12,27,15,1,00364,India
449397,2023-09-19,204,strawberry yogurt,50,60,10,1,00364,India
112351,2023-09-19,208,sprite,75,100,25,1,00331,India
112351,2023-09-19,213,bisleri,6,15,9,1,00331,India
612221,2023-09-19,201,paneer,210,340,130,1,00228,India
612221,2023-09-19,203,mango yogurt,50,60,10,1,00228,India
178915,2023-09-19,211,red bull,90,125,35,1,00466,India
178915,2023-09-19,210,mountain dew,75,100,25,1,00466,India
178915,2023-09-19,202,milk,12,27,15,1,00466,India
178915,2023-09-19,204,strawberry yogurt,50,60,10,1,00466,India
694824,2023-09-19,210,mountain dew,75,100,25,1,00295,India
694824,2023-09-19,204,strawberry yogurt,50,60,10,1,00295,India
694824,2023-09-19,207,coca cola,75,100,25,1,00295,India
694824,2023-09-19,202,milk,12,27,15,1,00295,India
694824,2023-09-19,208,sprite,75,100,25,1,00295,India
315829,2023-09-19,208,sprite,75,100,25,1,00495,India
315829,2023-09-19,202,milk,12,27,15,1,00495,India
315829,2023-09-19,209,pepsi,75,100,25,1,00495,India
554309,2023-09-19,208,sprite,75,100,25,1,00011,India
554309,2023-09-19,210,mountain dew,75,100,25,1,00011,India
101869,2023-09-19,213,bisleri,6,15,9,1,00222,India
511007,2023-09-19,207,coca cola,75,100,25,1,00390,India
511007,2023-09-19,211,red bull,90,125,35,1,00390,India
511007,2023-09-19,203,mango yogurt,50,60,10,1,00390,India
705983,2023-09-19,207,coca cola,75,100,25,1,00262,India
705983,2023-09-19,211,red bull,90,125,35,1,00262,India
705983,2023-09-19,204,strawberry yogurt,50,60,10,1,00262,India
594974,2023-09-19,201,paneer,210,340,130,1,00300,India
106120,2023-09-19,211,red bull,90,125,35,1,00193,India
546520,2023-09-19,212,amul cheese,250,315,65,1,00087,India
954347,2023-09-19,207,coca cola,75,100,25,1,00191,India
954347,2023-09-19,209,pepsi,75,100,25,1,00191,India
427615,2023-09-19,209,pepsi,75,100,25,1,00134,India
611710,2023-09-19,202,milk,12,27,15,1,00242,India
201558,2023-09-19,201,paneer,210,340,130,1,00311,India
201558,2023-09-19,208,sprite,75,100,25,1,00311,India
201558,2023-09-19,211,red bull,90,125,35,1,00311,India
201558,2023-09-19,206,yakult,360,400,40,1,00311,India
201558,2023-09-19,213,bisleri,6,15,9,1,00311,India
640661,2023-09-19,208,sprite,75,100,25,1,00240,India
640661,2023-09-19,201,paneer,210,340,130,1,00240,India
873405,2023-09-19,203,mango yogurt,50,60,10,1,00103,India
873405,2023-09-19,207,coca cola,75,100,25,1,00103,India
873405,2023-09-19,210,mountain dew,75,100,25,1,00103,India
873405,2023-09-19,206,yakult,360,400,40,1,00103,India
279092,2023-09-19,209,pepsi,75,100,25,1,00249,India
279092,2023-09-19,212,amul cheese,250,315,65,1,00249,India
279092,2023-09-19,203,mango yogurt,50,60,10,1,00249,India
279092,2023-09-19,201,paneer,210,340,130,1,00249,India
880313,2023-09-19,212,amul cheese,250,315,65,1,00075,India
880313,2023-09-19,205,classic yogurt,45,60,15,1,00075,India
483585,2023-09-19,207,coca cola,75,100,25,1,00259,India
805974,2023-09-19,209,pepsi,75,100,25,1,00344,India
805974,2023-09-19,211,red bull,90,125,35,1,00344,India
754576,2023-09-19,208,sprite,75,100,25,1,00383,India
754576,2023-09-19,210,mountain dew,75,100,25,1,00383,India
754576,2023-09-19,206,yakult,360,400,40,1,00383,India
816715,2023-09-19,213,bisleri,6,15,9,1,00246,India
816715,2023-09-19,212,amul cheese,250,315,65,1,00246,India
816715,2023-09-19,211,red bull,90,125,35,1,00246,India
816715,2023-09-19,202,milk,12,27,15,1,00246,India
816715,2023-09-19,209,pepsi,75,100,25,1,00246,India
826193,2023-09-19,201,paneer,210,340,130,1,00466,India
826193,2023-09-19,211,red bull,90,125,35,1,00466,India
547261,2023-09-19,209,pepsi,75,100,25,1,00256,India
963091,2023-09-19,206,yakult,360,400,40,1,00064,India
100380,2023-09-19,207,coca cola,75,100,25,1,00028,India
100380,2023-09-19,208,sprite,75,100,25,1,00028,India
938128,2023-09-19,212,amul cheese,250,315,65,1,00427,India
938128,2023-09-19,211,red bull,90,125,35,1,00427,India
938128,2023-09-19,208,sprite,75,100,25,1,00427,India
483457,2023-09-19,213,bisleri,6,15,9,1,00155,India
483457,2023-09-19,202,milk,12,27,15,1,00155,India
483457,2023-09-19,209,pepsi,75,100,25,1,00155,India
483457,2023-09-19,207,coca cola,75,100,25,1,00155,India
516549,2023-09-19,205,classic yogurt,45,60,15,1,00075,India
516549,2023-09-19,213,bisleri,6,15,9,1,00075,India
516549,2023-09-19,209,pepsi,75,100,25,1,00075,India
541766,2023-09-19,212,amul cheese,250,315,65,1,00180,India
541766,2023-09-19,201,paneer,210,340,130,1,00180,India
448636,2023-09-19,209,pepsi,75,100,25,1,00388,India
448636,2023-09-19,212,amul cheese,250,315,65,1,00388,India
448636,2023-09-19,208,sprite,75,100,25,1,00388,India
448636,2023-09-19,207,coca cola,75,100,25,1,00388,India
479388,2023-09-19,207,coca cola,75,100,25,1,00392,India
146607,2023-09-19,210,mountain dew,75,100,25,1,00180,India
146607,2023-09-19,204,strawberry yogurt,50,60,10,1,00180,India
146607,2023-09-19,213,bisleri,6,15,9,1,00180,India
779568,2023-09-19,208,sprite,75,100,25,1,00342,India
104391,2023-09-19,213,bisleri,6,15,9,1,00279,India
104391,2023-09-19,203,mango yogurt,50,60,10,1,00279,India
104391,2023-09-19,204,strawberry yogurt,50,60,10,1,00279,India
104391,2023-09-19,206,yakult,360,400,40,1,00279,India
595910,2023-09-19,208,sprite,75,100,25,1,00397,India
595910,2023-09-19,204,strawberry yogurt,50,60,10,1,00397,India
327646,2023-09-19,201,paneer,210,340,130,1,00152,India
327646,2023-09-19,213,bisleri,6,15,9,1,00152,India
327646,2023-09-19,211,red bull,90,125,35,1,00152,India
973140,2023-09-19,212,amul cheese,250,315,65,1,00419,India
973140,2023-09-19,213,bisleri,6,15,9,1,00419,India
973140,2023-09-19,211,red bull,90,125,35,1,00419,India
534157,2023-09-19,206,yakult,360,400,40,1,00381,India
951126,2023-09-19,207,coca cola,75,100,25,1,00384,India
336995,2023-09-19,207,coca cola,75,100,25,1,00358,India
336995,2023-09-19,213,bisleri,6,15,9,1,00358,India
336995,2023-09-19,204,strawberry yogurt,50,60,10,1,00358,India
972073,2023-09-19,211,red bull,90,125,35,1,00038,India
972073,2023-09-19,203,mango yogurt,50,60,10,1,00038,India
447387,2023-09-19,201,paneer,210,340,130,1,00489,India
447387,2023-09-19,204,strawberry yogurt,50,60,10,1,00489,India
147086,2023-09-19,209,pepsi,75,100,25,1,00431,India
147086,2023-09-19,203,mango yogurt,50,60,10,1,00431,India
147086,2023-09-19,208,sprite,75,100,25,1,00431,India
152162,2023-09-19,201,paneer,210,340,130,1,00128,India
685763,2023-09-19,211,red bull,90,125,35,1,00163,India
685763,2023-09-19,206,yakult,360,400,40,1,00163,India
126338,2023-09-19,213,bisleri,6,15,9,1,00385,India
126338,2023-09-19,207,coca cola,75,100,25,1,00385,India
126338,2023-09-19,203,mango yogurt,50,60,10,1,00385,India
126338,2023-09-19,206,yakult,360,400,40,1,00385,India
187145,2023-09-19,207,coca cola,75,100,25,1,00241,India
187145,2023-09-19,212,amul cheese,250,315,65,1,00241,India
187145,2023-09-19,201,paneer,210,340,130,1,00241,India
521908,2023-09-19,212,amul cheese,250,315,65,1,00417,India
521908,2023-09-19,210,mountain dew,75,100,25,1,00417,India
521908,2023-09-19,209,pepsi,75,100,25,1,00417,India
736718,2023-09-19,211,red bull,90,125,35,1,00445,India
736718,2023-09-19,208,sprite,75,100,25,1,00445,India
311566,2023-09-19,204,strawberry yogurt,50,60,10,1,00485,India
311566,2023-09-19,207,coca cola,75,100,25,1,00485,India
311566,2023-09-19,213,bisleri,6,15,9,1,00485,India
746409,2023-09-19,213,bisleri,6,15,9,1,00180,India
746409,2023-09-19,203,mango yogurt,50,60,10,1,00180,India
746409,2023-09-19,208,sprite,75,100,25,1,00180,India
746409,2023-09-19,204,strawberry yogurt,50,60,10,1,00180,India
908935,2023-09-19,205,classic yogurt,45,60,15,1,00489,India
908935,2023-09-19,212,amul cheese,250,315,65,1,00489,India
923489,2023-09-19,211,red bull,90,125,35,1,00276,India
923489,2023-09-19,213,bisleri,6,15,9,1,00276,India
923489,2023-09-19,207,coca cola,75,100,25,1,00276,India
923489,2023-09-19,201,paneer,210,340,130,1,00276,India
283653,2023-09-19,210,mountain dew,75,100,25,1,00453,India
283653,2023-09-19,206,yakult,360,400,40,1,00453,India
875203,2023-09-19,201,paneer,210,340,130,1,00428,India
497720,2023-09-19,204,strawberry yogurt,50,60,10,1,00150,India
497720,2023-09-19,207,coca cola,75,100,25,1,00150,India
205650,2023-09-19,202,milk,12,27,15,1,00069,India
205650,2023-09-19,210,mountain dew,75,100,25,1,00069,India
205650,2023-09-19,201,paneer,210,340,130,1,00069,India
205650,2023-09-19,206,yakult,360,400,40,1,00069,India
930861,2023-09-19,204,strawberry yogurt,50,60,10,1,00340,India
930861,2023-09-19,201,paneer,210,340,130,1,00340,India
930861,2023-09-19,206,yakult,360,400,40,1,00340,India
508552,2023-09-19,212,amul cheese,250,315,65,1,00104,India
508552,2023-09-19,202,milk,12,27,15,1,00104,India
508552,2023-09-19,203,mango yogurt,50,60,10,1,00104,India
508552,2023-09-19,201,paneer,210,340,130,1,00104,India
855809,2023-09-19,206,yakult,360,400,40,1,00449,India
855809,2023-09-19,211,red bull,90,125,35,1,00449,India
855809,2023-09-19,204,strawberry yogurt,50,60,10,1,00449,India
801470,2023-09-19,212,amul cheese,250,315,65,1,00294,India
890013,2023-09-19,207,coca cola,75,100,25,1,00027,India
890013,2023-09-19,202,milk,12,27,15,1,00027,India
935776,2023-09-19,209,pepsi,75,100,25,1,00327,India
935776,2023-09-19,206,yakult,360,400,40,1,00327,India
985011,2023-09-19,204,strawberry yogurt,50,60,10,1,00237,India
985011,2023-09-19,207,coca cola,75,100,25,1,00237,India
161581,2023-09-19,211,red bull,90,125,35,1,00194,India
161581,2023-09-19,208,sprite,75,100,25,1,00194,India
161581,2023-09-19,207,coca cola,75,100,25,1,00194,India
161581,2023-09-19,209,pepsi,75,100,25,1,00194,India
532777,2023-09-19,205,classic yogurt,45,60,15,1,00282,India
532777,2023-09-19,206,yakult,360,400,40,1,00282,India
532777,2023-09-19,202,milk,12,27,15,1,00282,India
505382,2023-09-19,212,amul cheese,250,315,65,1,00233,India
505382,2023-09-19,205,classic yogurt,45,60,15,1,00233,India
505382,2023-09-19,213,bisleri,6,15,9,1,00233,India
900157,2023-09-19,211,red bull,90,125,35,1,00411,India
900157,2023-09-19,209,pepsi,75,100,25,1,00411,India
900157,2023-09-19,208,sprite,75,100,25,1,00411,India
141274,2023-09-19,212,amul cheese,250,315,65,1,00438,India
141274,2023-09-19,211,red bull,90,125,35,1,00438,India
415658,2023-09-19,204,strawberry yogurt,50,60,10,1,00038,India
415658,2023-09-19,201,paneer,210,340,130,1,00038,India
415658,2023-09-19,211,red bull,90,125,35,1,00038,India
415658,2023-09-19,208,sprite,75,100,25,1,00038,India
415658,2023-09-19,212,amul cheese,250,315,65,1,00038,India
566503,2023-09-19,213,bisleri,6,15,9,1,00112,India
566503,2023-09-19,210,mountain dew,75,100,25,1,00112,India
900431,2023-09-19,211,red bull,90,125,35,1,00299,India
410299,2023-09-20,207,coca cola,75,100,25,1,00028,India
410299,2023-09-20,211,red bull,90,125,35,1,00028,India
410299,2023-09-20,202,milk,12,27,15,1,00028,India
410299,2023-09-20,204,strawberry yogurt,50,60,10,1,00028,India
111094,2023-09-20,213,bisleri,6,15,9,1,00034,India
111094,2023-09-20,206,yakult,360,400,40,1,00034,India
253379,2023-09-20,205,classic yogurt,45,60,15,1,00349,India
253379,2023-09-20,203,mango yogurt,50,60,10,1,00349,India
287946,2023-09-20,201,paneer,210,340,130,1,00047,India
287946,2023-09-20,202,milk,12,27,15,1,00047,India
287946,2023-09-20,209,pepsi,75,100,25,1,00047,India
287946,2023-09-20,211,red bull,90,125,35,1,00047,India
628717,2023-09-20,208,sprite,75,100,25,1,00276,India
628717,2023-09-20,206,yakult,360,400,40,1,00276,India
628717,2023-09-20,210,mountain dew,75,100,25,1,00276,India
628717,2023-09-20,213,bisleri,6,15,9,1,00276,India
293361,2023-09-20,201,paneer,210,340,130,1,00230,India
498314,2023-09-20,212,amul cheese,250,315,65,1,00472,India
498314,2023-09-20,210,mountain dew,75,100,25,1,00472,India
498314,2023-09-20,208,sprite,75,100,25,1,00472,India
498314,2023-09-20,211,red bull,90,125,35,1,00472,India
521922,2023-09-20,212,amul cheese,250,315,65,1,00379,India
356461,2023-09-20,213,bisleri,6,15,9,1,00132,India
356461,2023-09-20,204,strawberry yogurt,50,60,10,1,00132,India
733622,2023-09-20,213,bisleri,6,15,9,1,00342,India
999553,2023-09-20,202,milk,12,27,15,1,00397,India
999553,2023-09-20,201,paneer,210,340,130,1,00397,India
999553,2023-09-20,206,yakult,360,400,40,1,00397,India
999553,2023-09-20,209,pepsi,75,100,25,1,00397,India
295520,2023-09-20,202,milk,12,27,15,1,00392,India
295520,2023-09-20,211,red bull,90,125,35,1,00392,India
295520,2023-09-20,206,yakult,360,400,40,1,00392,India
295520,2023-09-20,213,bisleri,6,15,9,1,00392,India
153251,2023-09-20,206,yakult,360,400,40,1,00115,India
153251,2023-09-20,207,coca cola,75,100,25,1,00115,India
714821,2023-09-20,213,bisleri,6,15,9,1,00070,India
542301,2023-09-20,207,coca cola,75,100,25,1,00314,India
542301,2023-09-20,209,pepsi,75,100,25,1,00314,India
542301,2023-09-20,202,milk,12,27,15,1,00314,India
542301,2023-09-20,213,bisleri,6,15,9,1,00314,India
542301,2023-09-20,203,mango yogurt,50,60,10,1,00314,India
830686,2023-09-20,207,coca cola,75,100,25,1,00173,India
830686,2023-09-20,209,pepsi,75,100,25,1,00173,India
868271,2023-09-20,211,red bull,90,125,35,1,00413,India
868271,2023-09-20,204,strawberry yogurt,50,60,10,1,00413,India
274855,2023-09-20,211,red bull,90,125,35,1,00133,India
274855,2023-09-20,210,mountain dew,75,100,25,1,00133,India
274855,2023-09-20,201,paneer,210,340,130,1,00133,India
274855,2023-09-20,212,amul cheese,250,315,65,1,00133,India
319529,2023-09-20,202,milk,12,27,15,1,00359,India
319529,2023-09-20,213,bisleri,6,15,9,1,00359,India
319529,2023-09-20,205,classic yogurt,45,60,15,1,00359,India
930144,2023-09-20,208,sprite,75,100,25,1,00021,India
283233,2023-09-20,212,amul cheese,250,315,65,1,00335,India
283233,2023-09-20,201,paneer,210,340,130,1,00335,India
283233,2023-09-20,210,mountain dew,75,100,25,1,00335,India
283233,2023-09-20,207,coca cola,75,100,25,1,00335,India
343022,2023-09-20,209,pepsi,75,100,25,1,00037,India
343022,2023-09-20,210,mountain dew,75,100,25,1,00037,India
343022,2023-09-20,202,milk,12,27,15,1,00037,India
343022,2023-09-20,212,amul cheese,250,315,65,1,00037,India
959189,2023-09-20,211,red bull,90,125,35,1,00068,India
959189,2023-09-20,208,sprite,75,100,25,1,00068,India
441951,2023-09-20,213,bisleri,6,15,9,1,00008,India
463688,2023-09-20,201,paneer,210,340,130,1,00352,India
463688,2023-09-20,213,bisleri,6,15,9,1,00352,India
463688,2023-09-20,212,amul cheese,250,315,65,1,00352,India
463688,2023-09-20,211,red bull,90,125,35,1,00352,India
463688,2023-09-20,206,yakult,360,400,40,1,00352,India
384317,2023-09-20,205,classic yogurt,45,60,15,1,00234,India
384317,2023-09-20,211,red bull,90,125,35,1,00234,India
432499,2023-09-20,203,mango yogurt,50,60,10,1,00396,India
432499,2023-09-20,208,sprite,75,100,25,1,00396,India
432499,2023-09-20,205,classic yogurt,45,60,15,1,00396,India
284703,2023-09-20,208,sprite,75,100,25,1,00104,India
284703,2023-09-20,202,milk,12,27,15,1,00104,India
284703,2023-09-20,201,paneer,210,340,130,1,00104,India
284703,2023-09-20,210,mountain dew,75,100,25,1,00104,India
931164,2023-09-20,204,strawberry yogurt,50,60,10,1,00309,India
450765,2023-09-20,205,classic yogurt,45,60,15,1,00489,India
465259,2023-09-20,201,paneer,210,340,130,1,00266,India
465259,2023-09-20,208,sprite,75,100,25,1,00266,India
465259,2023-09-20,213,bisleri,6,15,9,1,00266,India
465259,2023-09-20,212,amul cheese,250,315,65,1,00266,India
560566,2023-09-20,201,paneer,210,340,130,1,00130,India
560566,2023-09-20,202,milk,12,27,15,1,00130,India
560566,2023-09-20,208,sprite,75,100,25,1,00130,India
991937,2023-09-20,201,paneer,210,340,130,1,00191,India
991937,2023-09-20,202,milk,12,27,15,1,00191,India
968373,2023-09-20,210,mountain dew,75,100,25,1,00489,India
135170,2023-09-20,210,mountain dew,75,100,25,1,00045,India
135170,2023-09-20,202,milk,12,27,15,1,00045,India
490495,2023-09-20,204,strawberry yogurt,50,60,10,1,00181,India
265430,2023-09-20,201,paneer,210,340,130,1,00322,India
265430,2023-09-20,209,pepsi,75,100,25,1,00322,India
351899,2023-09-20,202,milk,12,27,15,1,00155,India
351899,2023-09-20,211,red bull,90,125,35,1,00155,India
136235,2023-09-20,202,milk,12,27,15,1,00131,India
136235,2023-09-20,203,mango yogurt,50,60,10,1,00131,India
921997,2023-09-20,201,paneer,210,340,130,1,00105,India
921997,2023-09-20,210,mountain dew,75,100,25,1,00105,India
921997,2023-09-20,206,yakult,360,400,40,1,00105,India
921997,2023-09-20,202,milk,12,27,15,1,00105,India
921997,2023-09-20,212,amul cheese,250,315,65,1,00105,India
840203,2023-09-20,208,sprite,75,100,25,1,00409,India
840203,2023-09-20,209,pepsi,75,100,25,1,00409,India
840203,2023-09-20,204,strawberry yogurt,50,60,10,1,00409,India
363196,2023-09-20,213,bisleri,6,15,9,1,00363,India
363196,2023-09-20,205,classic yogurt,45,60,15,1,00363,India
363196,2023-09-20,208,sprite,75,100,25,1,00363,India
363196,2023-09-20,211,red bull,90,125,35,1,00363,India
495530,2023-09-20,205,classic yogurt,45,60,15,1,00461,India
495530,2023-09-20,211,red bull,90,125,35,1,00461,India
495530,2023-09-20,204,strawberry yogurt,50,60,10,1,00461,India
495530,2023-09-20,206,yakult,360,400,40,1,00461,India
528960,2023-09-20,207,coca cola,75,100,25,1,00131,India
528960,2023-09-20,204,strawberry yogurt,50,60,10,1,00131,India
263519,2023-09-20,210,mountain dew,75,100,25,1,00298,India
263519,2023-09-20,203,mango yogurt,50,60,10,1,00298,India
263519,2023-09-20,209,pepsi,75,100,25,1,00298,India
263519,2023-09-20,202,milk,12,27,15,1,00298,India
263519,2023-09-20,204,strawberry yogurt,50,60,10,1,00298,India
466742,2023-09-20,210,mountain dew,75,100,25,1,00250,India
466742,2023-09-20,208,sprite,75,100,25,1,00250,India
466742,2023-09-20,206,yakult,360,400,40,1,00250,India
466742,2023-09-20,204,strawberry yogurt,50,60,10,1,00250,India
971604,2023-09-20,211,red bull,90,125,35,1,00022,India
971604,2023-09-20,205,classic yogurt,45,60,15,1,00022,India
930538,2023-09-20,213,bisleri,6,15,9,1,00305,India
930538,2023-09-20,212,amul cheese,250,315,65,1,00305,India
240608,2023-09-20,204,strawberry yogurt,50,60,10,1,00137,India
240608,2023-09-20,203,mango yogurt,50,60,10,1,00137,India
240608,2023-09-20,206,yakult,360,400,40,1,00137,India
240608,2023-09-20,202,milk,12,27,15,1,00137,India
300993,2023-09-20,201,paneer,210,340,130,1,00467,India
300993,2023-09-20,205,classic yogurt,45,60,15,1,00467,India
300993,2023-09-20,203,mango yogurt,50,60,10,1,00467,India
909438,2023-09-20,207,coca cola,75,100,25,1,00312,India
909438,2023-09-20,208,sprite,75,100,25,1,00312,India
909438,2023-09-20,203,mango yogurt,50,60,10,1,00312,India
909438,2023-09-20,212,amul cheese,250,315,65,1,00312,India
805538,2023-09-20,212,amul cheese,250,315,65,1,00293,India
326504,2023-09-20,213,bisleri,6,15,9,1,00435,India
326504,2023-09-20,208,sprite,75,100,25,1,00435,India
672592,2023-09-20,207,coca cola,75,100,25,1,00135,India
672592,2023-09-20,210,mountain dew,75,100,25,1,00135,India
672592,2023-09-20,204,strawberry yogurt,50,60,10,1,00135,India
672592,2023-09-20,205,classic yogurt,45,60,15,1,00135,India
194444,2023-09-20,205,classic yogurt,45,60,15,1,00253,India
194444,2023-09-20,212,amul cheese,250,315,65,1,00253,India
194444,2023-09-20,210,mountain dew,75,100,25,1,00253,India
286023,2023-09-20,212,amul cheese,250,315,65,1,00227,India
286023,2023-09-20,208,sprite,75,100,25,1,00227,India
286023,2023-09-20,213,bisleri,6,15,9,1,00227,India
822911,2023-09-20,202,milk,12,27,15,1,00480,India
822911,2023-09-20,203,mango yogurt,50,60,10,1,00480,India
841877,2023-09-20,201,paneer,210,340,130,1,00054,India
978094,2023-09-20,208,sprite,75,100,25,1,00416,India
612524,2023-09-20,206,yakult,360,400,40,1,00134,India
612524,2023-09-20,210,mountain dew,75,100,25,1,00134,India
448201,2023-09-20,203,mango yogurt,50,60,10,1,00369,India
448201,2023-09-20,213,bisleri,6,15,9,1,00369,India
448201,2023-09-20,210,mountain dew,75,100,25,1,00369,India
448201,2023-09-20,206,yakult,360,400,40,1,00369,India
774099,2023-09-20,210,mountain dew,75,100,25,1,00295,India
774099,2023-09-20,208,sprite,75,100,25,1,00295,India
774099,2023-09-20,206,yakult,360,400,40,1,00295,India
774099,2023-09-20,209,pepsi,75,100,25,1,00295,India
477409,2023-09-20,212,amul cheese,250,315,65,1,00201,India
477409,2023-09-20,209,pepsi,75,100,25,1,00201,India
693041,2023-09-20,209,pepsi,75,100,25,1,00418,India
693041,2023-09-20,207,coca cola,75,100,25,1,00418,India
693041,2023-09-20,205,classic yogurt,45,60,15,1,00418,India
693041,2023-09-20,206,yakult,360,400,40,1,00418,India
403624,2023-09-20,209,pepsi,75,100,25,1,00313,India
403624,2023-09-20,206,yakult,360,400,40,1,00313,India
403624,2023-09-20,204,strawberry yogurt,50,60,10,1,00313,India
403624,2023-09-20,211,red bull,90,125,35,1,00313,India
299416,2023-09-20,212,amul cheese,250,315,65,1,00011,India
299416,2023-09-20,210,mountain dew,75,100,25,1,00011,India
299416,2023-09-20,207,coca cola,75,100,25,1,00011,India
218029,2023-09-20,206,yakult,360,400,40,1,00296,India
218029,2023-09-20,204,strawberry yogurt,50,60,10,1,00296,India
218029,2023-09-20,210,mountain dew,75,100,25,1,00296,India
611018,2023-09-20,209,pepsi,75,100,25,1,00162,India
611018,2023-09-20,211,red bull,90,125,35,1,00162,India
526621,2023-09-20,213,bisleri,6,15,9,1,00443,India
526621,2023-09-20,206,yakult,360,400,40,1,00443,India
526621,2023-09-20,203,mango yogurt,50,60,10,1,00443,India
105035,2023-09-20,213,bisleri,6,15,9,1,00443,India
696973,2023-09-20,201,paneer,210,340,130,1,00363,India
696973,2023-09-20,204,strawberry yogurt,50,60,10,1,00363,India
696973,2023-09-20,203,mango yogurt,50,60,10,1,00363,India
696973,2023-09-20,205,classic yogurt,45,60,15,1,00363,India
108588,2023-09-20,206,yakult,360,400,40,1,00359,India
646411,2023-09-20,213,bisleri,6,15,9,1,00044,India
646411,2023-09-20,212,amul cheese,250,315,65,1,00044,India
646411,2023-09-20,206,yakult,360,400,40,1,00044,India
634516,2023-09-20,203,mango yogurt,50,60,10,1,00178,India
634516,2023-09-20,212,amul cheese,250,315,65,1,00178,India
527987,2023-09-20,211,red bull,90,125,35,1,00408,India
112471,2023-09-20,209,pepsi,75,100,25,1,00126,India
112471,2023-09-20,212,amul cheese,250,315,65,1,00126,India
112471,2023-09-20,205,classic yogurt,45,60,15,1,00126,India
112471,2023-09-20,207,coca cola,75,100,25,1,00126,India
761373,2023-09-20,204,strawberry yogurt,50,60,10,1,00104,India
106276,2023-09-20,208,sprite,75,100,25,1,00394,India
106276,2023-09-20,207,coca cola,75,100,25,1,00394,India
995520,2023-09-20,211,red bull,90,125,35,1,00300,India
995520,2023-09-20,209,pepsi,75,100,25,1,00300,India
995520,2023-09-20,208,sprite,75,100,25,1,00300,India
995520,2023-09-20,213,bisleri,6,15,9,1,00300,India
995520,2023-09-20,206,yakult,360,400,40,1,00300,India
343549,2023-09-20,203,mango yogurt,50,60,10,1,00298,India
343549,2023-09-20,211,red bull,90,125,35,1,00298,India
343549,2023-09-20,212,amul cheese,250,315,65,1,00298,India
877278,2023-09-20,212,amul cheese,250,315,65,1,00340,India
728049,2023-09-20,204,strawberry yogurt,50,60,10,1,00225,India
728049,2023-09-20,206,yakult,360,400,40,1,00225,India
728049,2023-09-20,202,milk,12,27,15,1,00225,India
728049,2023-09-20,210,mountain dew,75,100,25,1,00225,India
147972,2023-09-20,202,milk,12,27,15,1,00265,India
147972,2023-09-20,206,yakult,360,400,40,1,00265,India
147972,2023-09-20,207,coca cola,75,100,25,1,00265,India
147972,2023-09-20,210,mountain dew,75,100,25,1,00265,India
546109,2023-09-21,207,coca cola,75,100,25,1,00285,India
546109,2023-09-21,211,red bull,90,125,35,1,00285,India
546109,2023-09-21,213,bisleri,6,15,9,1,00285,India
917217,2023-09-21,203,mango yogurt,50,60,10,1,00005,India
917217,2023-09-21,201,paneer,210,340,130,1,00005,India
917217,2023-09-21,205,classic yogurt,45,60,15,1,00005,India
917217,2023-09-21,202,milk,12,27,15,1,00005,India
377565,2023-09-21,212,amul cheese,250,315,65,1,00327,India
775200,2023-09-21,209,pepsi,75,100,25,1,00464,India
775200,2023-09-21,204,strawberry yogurt,50,60,10,1,00464,India
775200,2023-09-21,203,mango yogurt,50,60,10,1,00464,India
853063,2023-09-21,207,coca cola,75,100,25,1,00343,India
853063,2023-09-21,209,pepsi,75,100,25,1,00343,India
853063,2023-09-21,204,strawberry yogurt,50,60,10,1,00343,India
233030,2023-09-21,208,sprite,75,100,25,1,00492,India
670215,2023-09-21,204,strawberry yogurt,50,60,10,1,00230,India
670215,2023-09-21,209,pepsi,75,100,25,1,00230,India
670215,2023-09-21,202,milk,12,27,15,1,00230,India
841460,2023-09-21,209,pepsi,75,100,25,1,00170,India
841460,2023-09-21,206,yakult,360,400,40,1,00170,India
841460,2023-09-21,203,mango yogurt,50,60,10,1,00170,India
770349,2023-09-21,202,milk,12,27,15,1,00460,India
770349,2023-09-21,213,bisleri,6,15,9,1,00460,India
770349,2023-09-21,210,mountain dew,75,100,25,1,00460,India
756638,2023-09-21,201,paneer,210,340,130,1,00314,India
756638,2023-09-21,205,classic yogurt,45,60,15,1,00314,India
461080,2023-09-21,213,bisleri,6,15,9,1,00227,India
461080,2023-09-21,201,paneer,210,340,130,1,00227,India
461080,2023-09-21,209,pepsi,75,100,25,1,00227,India
552881,2023-09-21,211,red bull,90,125,35,1,00331,India
552881,2023-09-21,213,bisleri,6,15,9,1,00331,India
552881,2023-09-21,202,milk,12,27,15,1,00331,India
336344,2023-09-21,205,classic yogurt,45,60,15,1,00174,India
336344,2023-09-21,204,strawberry yogurt,50,60,10,1,00174,India
336344,2023-09-21,208,sprite,75,100,25,1,00174,India
336344,2023-09-21,203,mango yogurt,50,60,10,1,00174,India
114063,2023-09-21,210,mountain dew,75,100,25,1,00461,India
114063,2023-09-21,201,paneer,210,340,130,1,00461,India
114063,2023-09-21,206,yakult,360,400,40,1,00461,India
321717,2023-09-21,202,milk,12,27,15,1,00089,India
321717,2023-09-21,208,sprite,75,100,25,1,00089,India
662597,2023-09-21,203,mango yogurt,50,60,10,1,00144,India
662597,2023-09-21,212,amul cheese,250,315,65,1,00144,India
662597,2023-09-21,207,coca cola,75,100,25,1,00144,India
662597,2023-09-21,208,sprite,75,100,25,1,00144,India
595713,2023-09-21,211,red bull,90,125,35,1,00414,India
894172,2023-09-21,210,mountain dew,75,100,25,1,00356,India
894172,2023-09-21,206,yakult,360,400,40,1,00356,India
378189,2023-09-21,203,mango yogurt,50,60,10,1,00023,India
378189,2023-09-21,201,paneer,210,340,130,1,00023,India
378189,2023-09-21,208,sprite,75,100,25,1,00023,India
378189,2023-09-21,204,strawberry yogurt,50,60,10,1,00023,India
448077,2023-09-21,208,sprite,75,100,25,1,00209,India
448077,2023-09-21,211,red bull,90,125,35,1,00209,India
448077,2023-09-21,212,amul cheese,250,315,65,1,00209,India
833416,2023-09-21,208,sprite,75,100,25,1,00188,India
833416,2023-09-21,213,bisleri,6,15,9,1,00188,India
184833,2023-09-21,202,milk,12,27,15,1,00111,India
415453,2023-09-21,212,amul cheese,250,315,65,1,00350,India
415453,2023-09-21,208,sprite,75,100,25,1,00350,India
415453,2023-09-21,207,coca cola,75,100,25,1,00350,India
415453,2023-09-21,213,bisleri,6,15,9,1,00350,India
106122,2023-09-21,212,amul cheese,250,315,65,1,00269,India
106122,2023-09-21,206,yakult,360,400,40,1,00269,India
106122,2023-09-21,203,mango yogurt,50,60,10,1,00269,India
293835,2023-09-21,210,mountain dew,75,100,25,1,00302,India
293835,2023-09-21,208,sprite,75,100,25,1,00302,India
293835,2023-09-21,212,amul cheese,250,315,65,1,00302,India
617501,2023-09-21,205,classic yogurt,45,60,15,1,00007,India
617501,2023-09-21,206,yakult,360,400,40,1,00007,India
617501,2023-09-21,210,mountain dew,75,100,25,1,00007,India
617501,2023-09-21,209,pepsi,75,100,25,1,00007,India
617501,2023-09-21,213,bisleri,6,15,9,1,00007,India
545871,2023-09-21,213,bisleri,6,15,9,1,00108,India
545871,2023-09-21,208,sprite,75,100,25,1,00108,India
545871,2023-09-21,211,red bull,90,125,35,1,00108,India
545871,2023-09-21,202,milk,12,27,15,1,00108,India
481068,2023-09-21,210,mountain dew,75,100,25,1,00022,India
481068,2023-09-21,205,classic yogurt,45,60,15,1,00022,India
481068,2023-09-21,209,pepsi,75,100,25,1,00022,India
965065,2023-09-21,211,red bull,90,125,35,1,00434,India
965065,2023-09-21,207,coca cola,75,100,25,1,00434,India
965065,2023-09-21,201,paneer,210,340,130,1,00434,India
965065,2023-09-21,210,mountain dew,75,100,25,1,00434,India
965065,2023-09-21,204,strawberry yogurt,50,60,10,1,00434,India
639237,2023-09-21,209,pepsi,75,100,25,1,00179,India
639237,2023-09-21,203,mango yogurt,50,60,10,1,00179,India
639237,2023-09-21,206,yakult,360,400,40,1,00179,India
639237,2023-09-21,207,coca cola,75,100,25,1,00179,India
294224,2023-09-21,211,red bull,90,125,35,1,00004,India
294224,2023-09-21,212,amul cheese,250,315,65,1,00004,India
294224,2023-09-21,201,paneer,210,340,130,1,00004,India
294224,2023-09-21,204,strawberry yogurt,50,60,10,1,00004,India
133031,2023-09-21,205,classic yogurt,45,60,15,1,00165,India
133031,2023-09-21,209,pepsi,75,100,25,1,00165,India
133031,2023-09-21,208,sprite,75,100,25,1,00165,India
133031,2023-09-21,210,mountain dew,75,100,25,1,00165,India
270057,2023-09-21,209,pepsi,75,100,25,1,00386,India
270057,2023-09-21,206,yakult,360,400,40,1,00386,India
270057,2023-09-21,205,classic yogurt,45,60,15,1,00386,India
837860,2023-09-21,204,strawberry yogurt,50,60,10,1,00282,India
771799,2023-09-21,208,sprite,75,100,25,1,00015,India
169056,2023-09-21,204,strawberry yogurt,50,60,10,1,00380,India
169056,2023-09-21,206,yakult,360,400,40,1,00380,India
169056,2023-09-21,202,milk,12,27,15,1,00380,India
169526,2023-09-21,207,coca cola,75,100,25,1,00347,India
169526,2023-09-21,203,mango yogurt,50,60,10,1,00347,India
531550,2023-09-21,207,coca cola,75,100,25,1,00099,India
531550,2023-09-21,202,milk,12,27,15,1,00099,India
531550,2023-09-21,208,sprite,75,100,25,1,00099,India
531550,2023-09-21,201,paneer,210,340,130,1,00099,India
531550,2023-09-21,205,classic yogurt,45,60,15,1,00099,India
454866,2023-09-21,211,red bull,90,125,35,1,00092,India
499762,2023-09-21,208,sprite,75,100,25,1,00079,India
104341,2023-09-21,210,mountain dew,75,100,25,1,00294,India
104341,2023-09-21,201,paneer,210,340,130,1,00294,India
104341,2023-09-21,211,red bull,90,125,35,1,00294,India
597300,2023-09-21,204,strawberry yogurt,50,60,10,1,00409,India
597300,2023-09-21,201,paneer,210,340,130,1,00409,India
597300,2023-09-21,209,pepsi,75,100,25,1,00409,India
597300,2023-09-21,212,amul cheese,250,315,65,1,00409,India
597300,2023-09-21,213,bisleri,6,15,9,1,00409,India
266978,2023-09-21,210,mountain dew,75,100,25,1,00345,India
473820,2023-09-21,206,yakult,360,400,40,1,00466,India
473820,2023-09-21,204,strawberry yogurt,50,60,10,1,00466,India
473820,2023-09-21,211,red bull,90,125,35,1,00466,India
473820,2023-09-21,205,classic yogurt,45,60,15,1,00466,India
473820,2023-09-21,208,sprite,75,100,25,1,00466,India
214701,2023-09-21,213,bisleri,6,15,9,1,00148,India
214701,2023-09-21,205,classic yogurt,45,60,15,1,00148,India
214701,2023-09-21,210,mountain dew,75,100,25,1,00148,India
214701,2023-09-21,206,yakult,360,400,40,1,00148,India
562526,2023-09-21,206,yakult,360,400,40,1,00003,India
322655,2023-09-21,213,bisleri,6,15,9,1,00365,India
322655,2023-09-21,203,mango yogurt,50,60,10,1,00365,India
322655,2023-09-21,211,red bull,90,125,35,1,00365,India
322655,2023-09-21,208,sprite,75,100,25,1,00365,India
352098,2023-09-21,206,yakult,360,400,40,1,00173,India
789499,2023-09-21,213,bisleri,6,15,9,1,00465,India
789499,2023-09-21,208,sprite,75,100,25,1,00465,India
822615,2023-09-21,208,sprite,75,100,25,1,00364,India
822615,2023-09-21,209,pepsi,75,100,25,1,00364,India
822615,2023-09-21,213,bisleri,6,15,9,1,00364,India
822615,2023-09-21,202,milk,12,27,15,1,00364,India
822615,2023-09-21,205,classic yogurt,45,60,15,1,00364,India
378172,2023-09-21,201,paneer,210,340,130,1,00113,India
378172,2023-09-21,213,bisleri,6,15,9,1,00113,India
378172,2023-09-21,204,strawberry yogurt,50,60,10,1,00113,India
635718,2023-09-21,209,pepsi,75,100,25,1,00042,India
635718,2023-09-21,204,strawberry yogurt,50,60,10,1,00042,India
635718,2023-09-21,201,paneer,210,340,130,1,00042,India
346942,2023-09-21,202,milk,12,27,15,1,00060,India
346942,2023-09-21,208,sprite,75,100,25,1,00060,India
309432,2023-09-21,211,red bull,90,125,35,1,00302,India
309432,2023-09-21,209,pepsi,75,100,25,1,00302,India
998075,2023-09-21,201,paneer,210,340,130,1,00272,India
998075,2023-09-21,207,coca cola,75,100,25,1,00272,India
998075,2023-09-21,212,amul cheese,250,315,65,1,00272,India
998075,2023-09-21,213,bisleri,6,15,9,1,00272,India
141235,2023-09-21,205,classic yogurt,45,60,15,1,00020,India
141235,2023-09-21,213,bisleri,6,15,9,1,00020,India
798183,2023-09-21,211,red bull,90,125,35,1,00468,India
798183,2023-09-21,210,mountain dew,75,100,25,1,00468,India
666452,2023-09-21,207,coca cola,75,100,25,1,00381,India
666452,2023-09-21,212,amul cheese,250,315,65,1,00381,India
666452,2023-09-21,211,red bull,90,125,35,1,00381,India
187084,2023-09-21,208,sprite,75,100,25,1,00190,India
187084,2023-09-21,213,bisleri,6,15,9,1,00190,India
187084,2023-09-21,212,amul cheese,250,315,65,1,00190,India
187084,2023-09-21,203,mango yogurt,50,60,10,1,00190,India
261668,2023-09-21,208,sprite,75,100,25,1,00273,India
474972,2023-09-21,213,bisleri,6,15,9,1,00003,India
474972,2023-09-21,201,paneer,210,340,130,1,00003,India
326548,2023-09-21,211,red bull,90,125,35,1,00047,India
326548,2023-09-21,209,pepsi,75,100,25,1,00047,India
908447,2023-09-21,213,bisleri,6,15,9,1,00178,India
908447,2023-09-21,212,amul cheese,250,315,65,1,00178,India
908447,2023-09-21,204,strawberry yogurt,50,60,10,1,00178,India
908447,2023-09-21,209,pepsi,75,100,25,1,00178,India
191500,2023-09-21,211,red bull,90,125,35,1,00262,India
191500,2023-09-21,206,yakult,360,400,40,1,00262,India
755486,2023-09-21,212,amul cheese,250,315,65,1,00012,India
755486,2023-09-21,208,sprite,75,100,25,1,00012,India
755486,2023-09-21,211,red bull,90,125,35,1,00012,India
459521,2023-09-21,204,strawberry yogurt,50,60,10,1,00237,India
459521,2023-09-21,212,amul cheese,250,315,65,1,00237,India
459521,2023-09-21,205,classic yogurt,45,60,15,1,00237,India
834399,2023-09-21,207,coca cola,75,100,25,1,00431,India
834399,2023-09-21,201,paneer,210,340,130,1,00431,India
834399,2023-09-21,210,mountain dew,75,100,25,1,00431,India
834399,2023-09-21,213,bisleri,6,15,9,1,00431,India
210017,2023-09-21,208,sprite,75,100,25,1,00093,India
210017,2023-09-21,206,yakult,360,400,40,1,00093,India
210017,2023-09-21,203,mango yogurt,50,60,10,1,00093,India
210017,2023-09-21,212,amul cheese,250,315,65,1,00093,India
210017,2023-09-21,202,milk,12,27,15,1,00093,India
574534,2023-09-21,213,bisleri,6,15,9,1,00285,India
574534,2023-09-21,209,pepsi,75,100,25,1,00285,India
574534,2023-09-21,208,sprite,75,100,25,1,00285,India
574534,2023-09-21,210,mountain dew,75,100,25,1,00285,India
319678,2023-09-21,212,amul cheese,250,315,65,1,00065,India
319678,2023-09-21,208,sprite,75,100,25,1,00065,India
319678,2023-09-21,201,paneer,210,340,130,1,00065,India
942437,2023-09-21,211,red bull,90,125,35,1,00125,India
942437,2023-09-21,212,amul cheese,250,315,65,1,00125,India
942437,2023-09-21,207,coca cola,75,100,25,1,00125,India
727345,2023-09-22,205,classic yogurt,45,60,15,1,00111,India
315657,2023-09-22,207,coca cola,75,100,25,1,00208,India
315657,2023-09-22,208,sprite,75,100,25,1,00208,India
581458,2023-09-22,209,pepsi,75,100,25,1,00317,India
968615,2023-09-22,202,milk,12,27,15,1,00165,India
562421,2023-09-22,203,mango yogurt,50,60,10,1,00426,India
562421,2023-09-22,207,coca cola,75,100,25,1,00426,India
692858,2023-09-22,211,red bull,90,125,35,1,00251,India
692858,2023-09-22,203,mango yogurt,50,60,10,1,00251,India
842954,2023-09-22,206,yakult,360,400,40,1,00462,India
667415,2023-09-22,201,paneer,210,340,130,1,00355,India
667415,2023-09-22,210,mountain dew,75,100,25,1,00355,India
667415,2023-09-22,211,red bull,90,125,35,1,00355,India
934312,2023-09-22,206,yakult,360,400,40,1,00156,India
934312,2023-09-22,209,pepsi,75,100,25,1,00156,India
887885,2023-09-22,201,paneer,210,340,130,1,00085,India
887885,2023-09-22,206,yakult,360,400,40,1,00085,India
887885,2023-09-22,205,classic yogurt,45,60,15,1,00085,India
887885,2023-09-22,204,strawberry yogurt,50,60,10,1,00085,India
946288,2023-09-22,201,paneer,210,340,130,1,00458,India
946288,2023-09-22,212,amul cheese,250,315,65,1,00458,India
946288,2023-09-22,208,sprite,75,100,25,1,00458,India
946288,2023-09-22,209,pepsi,75,100,25,1,00458,India
245626,2023-09-22,212,amul cheese,250,315,65,1,00420,India
601655,2023-09-22,204,strawberry yogurt,50,60,10,1,00016,India
601655,2023-09-22,211,red bull,90,125,35,1,00016,India
601655,2023-09-22,212,amul cheese,250,315,65,1,00016,India
737671,2023-09-22,203,mango yogurt,50,60,10,1,00101,India
737671,2023-09-22,211,red bull,90,125,35,1,00101,India
737671,2023-09-22,204,strawberry yogurt,50,60,10,1,00101,India
186385,2023-09-22,209,pepsi,75,100,25,1,00417,India
787658,2023-09-22,205,classic yogurt,45,60,15,1,00383,India
411600,2023-09-22,212,amul cheese,250,315,65,1,00047,India
499214,2023-09-22,213,bisleri,6,15,9,1,00405,India
499214,2023-09-22,201,paneer,210,340,130,1,00405,India
736133,2023-09-22,202,milk,12,27,15,1,00271,India
736133,2023-09-22,206,yakult,360,400,40,1,00271,India
736133,2023-09-22,203,mango yogurt,50,60,10,1,00271,India
736133,2023-09-22,204,strawberry yogurt,50,60,10,1,00271,India
736133,2023-09-22,211,red bull,90,125,35,1,00271,India
966271,2023-09-22,204,strawberry yogurt,50,60,10,1,00466,India
966271,2023-09-22,202,milk,12,27,15,1,00466,India
966271,2023-09-22,212,amul cheese,250,315,65,1,00466,India
429571,2023-09-22,201,paneer,210,340,130,1,00423,India
429571,2023-09-22,205,classic yogurt,45,60,15,1,00423,India
429571,2023-09-22,211,red bull,90,125,35,1,00423,India
429571,2023-09-22,203,mango yogurt,50,60,10,1,00423,India
709189,2023-09-22,202,milk,12,27,15,1,00232,India
709189,2023-09-22,207,coca cola,75,100,25,1,00232,India
709189,2023-09-22,210,mountain dew,75,100,25,1,00232,India
709189,2023-09-22,203,mango yogurt,50,60,10,1,00232,India
710708,2023-09-22,206,yakult,360,400,40,1,00191,India
710708,2023-09-22,212,amul cheese,250,315,65,1,00191,India
710708,2023-09-22,213,bisleri,6,15,9,1,00191,India
347814,2023-09-22,208,sprite,75,100,25,1,00164,India
347814,2023-09-22,207,coca cola,75,100,25,1,00164,India
347814,2023-09-22,205,classic yogurt,45,60,15,1,00164,India
347814,2023-09-22,210,mountain dew,75,100,25,1,00164,India
331735,2023-09-22,204,strawberry yogurt,50,60,10,1,00244,India
331735,2023-09-22,210,mountain dew,75,100,25,1,00244,India
331735,2023-09-22,206,yakult,360,400,40,1,00244,India
327205,2023-09-22,204,strawberry yogurt,50,60,10,1,00122,India
327205,2023-09-22,208,sprite,75,100,25,1,00122,India
203881,2023-09-22,210,mountain dew,75,100,25,1,00425,India
203881,2023-09-22,206,yakult,360,400,40,1,00425,India
917582,2023-09-22,206,yakult,360,400,40,1,00131,India
674249,2023-09-22,201,paneer,210,340,130,1,00047,India
674249,2023-09-22,210,mountain dew,75,100,25,1,00047,India
674249,2023-09-22,205,classic yogurt,45,60,15,1,00047,India
967128,2023-09-22,212,amul cheese,250,315,65,1,00048,India
845727,2023-09-22,201,paneer,210,340,130,1,00499,India
845727,2023-09-22,204,strawberry yogurt,50,60,10,1,00499,India
845727,2023-09-22,209,pepsi,75,100,25,1,00499,India
845727,2023-09-22,203,mango yogurt,50,60,10,1,00499,India
845727,2023-09-22,212,amul cheese,250,315,65,1,00499,India
909032,2023-09-22,206,yakult,360,400,40,1,00086,India
676095,2023-09-22,212,amul cheese,250,315,65,1,00448,India
676095,2023-09-22,201,paneer,210,340,130,1,00448,India
676095,2023-09-22,208,sprite,75,100,25,1,00448,India
266805,2023-09-22,212,amul cheese,250,315,65,1,00444,India
266805,2023-09-22,205,classic yogurt,45,60,15,1,00444,India
266805,2023-09-22,204,strawberry yogurt,50,60,10,1,00444,India
953558,2023-09-22,202,milk,12,27,15,1,00409,India
953558,2023-09-22,213,bisleri,6,15,9,1,00409,India
995414,2023-09-22,205,classic yogurt,45,60,15,1,00283,India
995414,2023-09-22,208,sprite,75,100,25,1,00283,India
101102,2023-09-22,209,pepsi,75,100,25,1,00451,India
276370,2023-09-22,209,pepsi,75,100,25,1,00093,India
276370,2023-09-22,211,red bull,90,125,35,1,00093,India
785293,2023-09-22,213,bisleri,6,15,9,1,00223,India
405308,2023-09-22,209,pepsi,75,100,25,1,00319,India
405308,2023-09-22,213,bisleri,6,15,9,1,00319,India
405308,2023-09-22,206,yakult,360,400,40,1,00319,India
405308,2023-09-22,210,mountain dew,75,100,25,1,00319,India
767254,2023-09-22,210,mountain dew,75,100,25,1,00325,India
767254,2023-09-22,211,red bull,90,125,35,1,00325,India
767254,2023-09-22,209,pepsi,75,100,25,1,00325,India
767254,2023-09-22,213,bisleri,6,15,9,1,00325,India
279952,2023-09-22,202,milk,12,27,15,1,00435,India
279952,2023-09-22,212,amul cheese,250,315,65,1,00435,India
279952,2023-09-22,213,bisleri,6,15,9,1,00435,India
279952,2023-09-22,201,paneer,210,340,130,1,00435,India
265412,2023-09-22,207,coca cola,75,100,25,1,00063,India
234363,2023-09-22,202,milk,12,27,15,1,00196,India
210203,2023-09-22,211,red bull,90,125,35,1,00038,India
210203,2023-09-22,213,bisleri,6,15,9,1,00038,India
498793,2023-09-22,202,milk,12,27,15,1,00253,India
498793,2023-09-22,205,classic yogurt,45,60,15,1,00253,India
498793,2023-09-22,213,bisleri,6,15,9,1,00253,India
498793,2023-09-22,207,coca cola,75,100,25,1,00253,India
619858,2023-09-22,213,bisleri,6,15,9,1,00453,India
619858,2023-09-22,204,strawberry yogurt,50,60,10,1,00453,India
619858,2023-09-22,201,paneer,210,340,130,1,00453,India
619858,2023-09-22,211,red bull,90,125,35,1,00453,India
929087,2023-09-22,204,strawberry yogurt,50,60,10,1,00447,India
929087,2023-09-22,211,red bull,90,125,35,1,00447,India
610299,2023-09-22,205,classic yogurt,45,60,15,1,00358,India
922617,2023-09-22,206,yakult,360,400,40,1,00269,India
922617,2023-09-22,207,coca cola,75,100,25,1,00269,India
895075,2023-09-22,206,yakult,360,400,40,1,00461,India
895075,2023-09-22,202,milk,12,27,15,1,00461,India
659009,2023-09-22,210,mountain dew,75,100,25,1,00281,India
659009,2023-09-22,211,red bull,90,125,35,1,00281,India
659009,2023-09-22,203,mango yogurt,50,60,10,1,00281,India
659009,2023-09-22,202,milk,12,27,15,1,00281,India
551048,2023-09-22,206,yakult,360,400,40,1,00074,India
551048,2023-09-22,203,mango yogurt,50,60,10,1,00074,India
551048,2023-09-22,207,coca cola,75,100,25,1,00074,India
720008,2023-09-22,203,mango yogurt,50,60,10,1,00304,India
720008,2023-09-22,208,sprite,75,100,25,1,00304,India
720008,2023-09-22,207,coca cola,75,100,25,1,00304,India
720008,2023-09-22,205,classic yogurt,45,60,15,1,00304,India
344306,2023-09-22,211,red bull,90,125,35,1,00393,India
344306,2023-09-22,202,milk,12,27,15,1,00393,India
344306,2023-09-22,205,classic yogurt,45,60,15,1,00393,India
344306,2023-09-22,213,bisleri,6,15,9,1,00393,India
920922,2023-09-22,202,milk,12,27,15,1,00327,India
920922,2023-09-22,205,classic yogurt,45,60,15,1,00327,India
920922,2023-09-22,210,mountain dew,75,100,25,1,00327,India
920922,2023-09-22,213,bisleri,6,15,9,1,00327,India
920922,2023-09-22,209,pepsi,75,100,25,1,00327,India
307444,2023-09-22,204,strawberry yogurt,50,60,10,1,00030,India
824627,2023-09-22,203,mango yogurt,50,60,10,1,00267,India
668666,2023-09-22,209,pepsi,75,100,25,1,00411,India
668666,2023-09-22,206,yakult,360,400,40,1,00411,India
668666,2023-09-22,204,strawberry yogurt,50,60,10,1,00411,India
668666,2023-09-22,211,red bull,90,125,35,1,00411,India
439043,2023-09-22,201,paneer,210,340,130,1,00227,India
528365,2023-09-23,203,mango yogurt,50,60,10,1,00271,India
528365,2023-09-23,209,pepsi,75,100,25,1,00271,India
528365,2023-09-23,202,milk,12,27,15,1,00271,India
528365,2023-09-23,212,amul cheese,250,315,65,1,00271,India
528365,2023-09-23,208,sprite,75,100,25,1,00271,India
152594,2023-09-23,212,amul cheese,250,315,65,1,00232,India
306609,2023-09-23,203,mango yogurt,50,60,10,1,00310,India
621944,2023-09-23,203,mango yogurt,50,60,10,1,00478,India
621944,2023-09-23,212,amul cheese,250,315,65,1,00478,India
621944,2023-09-23,209,pepsi,75,100,25,1,00478,India
634901,2023-09-23,212,amul cheese,250,315,65,1,00193,India
634901,2023-09-23,202,milk,12,27,15,1,00193,India
634901,2023-09-23,213,bisleri,6,15,9,1,00193,India
634901,2023-09-23,205,classic yogurt,45,60,15,1,00193,India
329661,2023-09-23,201,paneer,210,340,130,1,00416,India
329661,2023-09-23,211,red bull,90,125,35,1,00416,India
329661,2023-09-23,210,mountain dew,75,100,25,1,00416,India
126025,2023-09-23,208,sprite,75,100,25,1,00013,India
126025,2023-09-23,213,bisleri,6,15,9,1,00013,India
126025,2023-09-23,209,pepsi,75,100,25,1,00013,India
200912,2023-09-23,211,red bull,90,125,35,1,00320,India
200912,2023-09-23,208,sprite,75,100,25,1,00320,India
200912,2023-09-23,213,bisleri,6,15,9,1,00320,India
200912,2023-09-23,212,amul cheese,250,315,65,1,00320,India
622498,2023-09-23,203,mango yogurt,50,60,10,1,00482,India
622498,2023-09-23,209,pepsi,75,100,25,1,00482,India
622498,2023-09-23,206,yakult,360,400,40,1,00482,India
407414,2023-09-23,210,mountain dew,75,100,25,1,00405,India
407414,2023-09-23,206,yakult,360,400,40,1,00405,India
739740,2023-09-23,203,mango yogurt,50,60,10,1,00359,India
739740,2023-09-23,204,strawberry yogurt,50,60,10,1,00359,India
739740,2023-09-23,212,amul cheese,250,315,65,1,00359,India
136088,2023-09-23,208,sprite,75,100,25,1,00072,India
580694,2023-09-23,213,bisleri,6,15,9,1,00405,India
580694,2023-09-23,207,coca cola,75,100,25,1,00405,India
387960,2023-09-23,210,mountain dew,75,100,25,1,00414,India
256762,2023-09-23,213,bisleri,6,15,9,1,00067,India
256762,2023-09-23,206,yakult,360,400,40,1,00067,India
924360,2023-09-23,202,milk,12,27,15,1,00347,India
924360,2023-09-23,206,yakult,360,400,40,1,00347,India
924360,2023-09-23,209,pepsi,75,100,25,1,00347,India
163620,2023-09-23,203,mango yogurt,50,60,10,1,00108,India
163620,2023-09-23,211,red bull,90,125,35,1,00108,India
163620,2023-09-23,213,bisleri,6,15,9,1,00108,India
735152,2023-09-23,205,classic yogurt,45,60,15,1,00324,India
735152,2023-09-23,207,coca cola,75,100,25,1,00324,India
735152,2023-09-23,202,milk,12,27,15,1,00324,India
735152,2023-09-23,204,strawberry yogurt,50,60,10,1,00324,India
735152,2023-09-23,213,bisleri,6,15,9,1,00324,India
738223,2023-09-23,213,bisleri,6,15,9,1,00448,India
738223,2023-09-23,208,sprite,75,100,25,1,00448,India
738223,2023-09-23,207,coca cola,75,100,25,1,00448,India
168123,2023-09-23,203,mango yogurt,50,60,10,1,00267,India
168123,2023-09-23,207,coca cola,75,100,25,1,00267,India
168123,2023-09-23,204,strawberry yogurt,50,60,10,1,00267,India
168123,2023-09-23,201,paneer,210,340,130,1,00267,India
168123,2023-09-23,202,milk,12,27,15,1,00267,India
296690,2023-09-23,207,coca cola,75,100,25,1,00160,India
296690,2023-09-23,211,red bull,90,125,35,1,00160,India
296690,2023-09-23,213,bisleri,6,15,9,1,00160,India
452632,2023-09-23,202,milk,12,27,15,1,00453,India
452632,2023-09-23,205,classic yogurt,45,60,15,1,00453,India
452632,2023-09-23,213,bisleri,6,15,9,1,00453,India
452632,2023-09-23,206,yakult,360,400,40,1,00453,India
452632,2023-09-23,203,mango yogurt,50,60,10,1,00453,India
954227,2023-09-23,210,mountain dew,75,100,25,1,00432,India
954227,2023-09-23,204,strawberry yogurt,50,60,10,1,00432,India
970814,2023-09-23,201,paneer,210,340,130,1,00313,India
970814,2023-09-23,206,yakult,360,400,40,1,00313,India
970814,2023-09-23,204,strawberry yogurt,50,60,10,1,00313,India
426337,2023-09-23,206,yakult,360,400,40,1,00422,India
426337,2023-09-23,210,mountain dew,75,100,25,1,00422,India
908997,2023-09-23,203,mango yogurt,50,60,10,1,00003,India
761640,2023-09-23,205,classic yogurt,45,60,15,1,00459,India
467824,2023-09-23,203,mango yogurt,50,60,10,1,00037,India
467824,2023-09-23,201,paneer,210,340,130,1,00037,India
467824,2023-09-23,213,bisleri,6,15,9,1,00037,India
467824,2023-09-23,209,pepsi,75,100,25,1,00037,India
519844,2023-09-23,209,pepsi,75,100,25,1,00146,India
519844,2023-09-23,205,classic yogurt,45,60,15,1,00146,India
374292,2023-09-23,201,paneer,210,340,130,1,00279,India
374292,2023-09-23,213,bisleri,6,15,9,1,00279,India
374292,2023-09-23,202,milk,12,27,15,1,00279,India
284635,2023-09-23,204,strawberry yogurt,50,60,10,1,00240,India
381021,2023-09-23,207,coca cola,75,100,25,1,00461,India
381021,2023-09-23,202,milk,12,27,15,1,00461,India
381021,2023-09-23,206,yakult,360,400,40,1,00461,India
388147,2023-09-23,202,milk,12,27,15,1,00167,India
668233,2023-09-23,202,milk,12,27,15,1,00043,India
366299,2023-09-23,211,red bull,90,125,35,1,00094,India
366299,2023-09-23,213,bisleri,6,15,9,1,00094,India
889362,2023-09-23,210,mountain dew,75,100,25,1,00110,India
903100,2023-09-23,204,strawberry yogurt,50,60,10,1,00111,India
903100,2023-09-23,210,mountain dew,75,100,25,1,00111,India
903100,2023-09-23,202,milk,12,27,15,1,00111,India
903100,2023-09-23,209,pepsi,75,100,25,1,00111,India
903100,2023-09-23,203,mango yogurt,50,60,10,1,00111,India
538831,2023-09-23,202,milk,12,27,15,1,00424,India
723507,2023-09-23,205,classic yogurt,45,60,15,1,00377,India
723507,2023-09-23,203,mango yogurt,50,60,10,1,00377,India
723507,2023-09-23,209,pepsi,75,100,25,1,00377,India
723507,2023-09-23,208,sprite,75,100,25,1,00377,India
723507,2023-09-23,206,yakult,360,400,40,1,00377,India
586131,2023-09-23,204,strawberry yogurt,50,60,10,1,00479,India
586131,2023-09-23,212,amul cheese,250,315,65,1,00479,India
586131,2023-09-23,210,mountain dew,75,100,25,1,00479,India
586131,2023-09-23,206,yakult,360,400,40,1,00479,India
586131,2023-09-23,203,mango yogurt,50,60,10,1,00479,India
823479,2023-09-23,203,mango yogurt,50,60,10,1,00105,India
823479,2023-09-23,202,milk,12,27,15,1,00105,India
823479,2023-09-23,211,red bull,90,125,35,1,00105,India
119407,2023-09-23,209,pepsi,75,100,25,1,00350,India
981666,2023-09-23,201,paneer,210,340,130,1,00360,India
288463,2023-09-23,204,strawberry yogurt,50,60,10,1,00338,India
288463,2023-09-23,210,mountain dew,75,100,25,1,00338,India
288463,2023-09-23,207,coca cola,75,100,25,1,00338,India
288463,2023-09-23,213,bisleri,6,15,9,1,00338,India
288463,2023-09-23,203,mango yogurt,50,60,10,1,00338,India
724560,2023-09-23,211,red bull,90,125,35,1,00008,India
724560,2023-09-23,209,pepsi,75,100,25,1,00008,India
724560,2023-09-23,208,sprite,75,100,25,1,00008,India
559052,2023-09-23,201,paneer,210,340,130,1,00205,India
559052,2023-09-23,202,milk,12,27,15,1,00205,India
199387,2023-09-23,208,sprite,75,100,25,1,00038,India
199387,2023-09-23,204,strawberry yogurt,50,60,10,1,00038,India
551833,2023-09-23,213,bisleri,6,15,9,1,00240,India
551833,2023-09-23,212,amul cheese,250,315,65,1,00240,India
139785,2023-09-23,205,classic yogurt,45,60,15,1,00331,India
583787,2023-09-23,203,mango yogurt,50,60,10,1,00457,India
583787,2023-09-23,206,yakult,360,400,40,1,00457,India
583787,2023-09-23,207,coca cola,75,100,25,1,00457,India
797045,2023-09-23,208,sprite,75,100,25,1,00277,India
797045,2023-09-23,206,yakult,360,400,40,1,00277,India
293752,2023-09-23,203,mango yogurt,50,60,10,1,00277,India
796102,2023-09-23,208,sprite,75,100,25,1,00476,India
796102,2023-09-23,204,strawberry yogurt,50,60,10,1,00476,India
796102,2023-09-23,211,red bull,90,125,35,1,00476,India
849115,2023-09-23,201,paneer,210,340,130,1,00460,India
849115,2023-09-23,205,classic yogurt,45,60,15,1,00460,India
849115,2023-09-23,210,mountain dew,75,100,25,1,00460,India
849228,2023-09-23,206,yakult,360,400,40,1,00231,India
849228,2023-09-23,212,amul cheese,250,315,65,1,00231,India
849228,2023-09-23,211,red bull,90,125,35,1,00231,India
592046,2023-09-23,205,classic yogurt,45,60,15,1,00041,India
592046,2023-09-23,206,yakult,360,400,40,1,00041,India
592046,2023-09-23,212,amul cheese,250,315,65,1,00041,India
868990,2023-09-23,204,strawberry yogurt,50,60,10,1,00032,India
868990,2023-09-23,206,yakult,360,400,40,1,00032,India
868990,2023-09-23,201,paneer,210,340,130,1,00032,India
469089,2023-09-23,202,milk,12,27,15,1,00319,India
469089,2023-09-23,204,strawberry yogurt,50,60,10,1,00319,India
469089,2023-09-23,210,mountain dew,75,100,25,1,00319,India
469089,2023-09-23,201,paneer,210,340,130,1,00319,India
341073,2023-09-23,213,bisleri,6,15,9,1,00253,India
341073,2023-09-23,208,sprite,75,100,25,1,00253,India
341073,2023-09-23,203,mango yogurt,50,60,10,1,00253,India
341073,2023-09-23,202,milk,12,27,15,1,00253,India
190154,2023-09-23,204,strawberry yogurt,50,60,10,1,00411,India
190154,2023-09-23,202,milk,12,27,15,1,00411,India
190154,2023-09-23,203,mango yogurt,50,60,10,1,00411,India
231265,2023-09-23,213,bisleri,6,15,9,1,00327,India
231265,2023-09-23,205,classic yogurt,45,60,15,1,00327,India
111334,2023-09-23,201,paneer,210,340,130,1,00412,India
111334,2023-09-23,207,coca cola,75,100,25,1,00412,India
111334,2023-09-23,208,sprite,75,100,25,1,00412,India
997473,2023-09-23,206,yakult,360,400,40,1,00470,India
997473,2023-09-23,209,pepsi,75,100,25,1,00470,India
997473,2023-09-23,205,classic yogurt,45,60,15,1,00470,India
502089,2023-09-23,205,classic yogurt,45,60,15,1,00222,India
502089,2023-09-23,210,mountain dew,75,100,25,1,00222,India
502089,2023-09-23,206,yakult,360,400,40,1,00222,India
272392,2023-09-23,201,paneer,210,340,130,1,00440,India
272392,2023-09-23,210,mountain dew,75,100,25,1,00440,India
272392,2023-09-23,207,coca cola,75,100,25,1,00440,India
279075,2023-09-23,207,coca cola,75,100,25,1,00136,India
279075,2023-09-23,213,bisleri,6,15,9,1,00136,India
696873,2023-09-23,204,strawberry yogurt,50,60,10,1,00226,India
696873,2023-09-23,209,pepsi,75,100,25,1,00226,India
995591,2023-09-23,204,strawberry yogurt,50,60,10,1,00038,India
995591,2023-09-23,207,coca cola,75,100,25,1,00038,India
995591,2023-09-23,206,yakult,360,400,40,1,00038,India
859164,2023-09-23,207,coca cola,75,100,25,1,00029,India
512441,2023-09-23,212,amul cheese,250,315,65,1,00061,India
512441,2023-09-23,208,sprite,75,100,25,1,00061,India
512441,2023-09-23,207,coca cola,75,100,25,1,00061,India
641317,2023-09-23,210,mountain dew,75,100,25,1,00324,India
641317,2023-09-23,209,pepsi,75,100,25,1,00324,India
641317,2023-09-23,205,classic yogurt,45,60,15,1,00324,India
641317,2023-09-23,202,milk,12,27,15,1,00324,India
641317,2023-09-23,203,mango yogurt,50,60,10,1,00324,India
248300,2023-09-23,207,coca cola,75,100,25,1,00376,India
248300,2023-09-23,211,red bull,90,125,35,1,00376,India
248300,2023-09-23,209,pepsi,75,100,25,1,00376,India
248300,2023-09-23,212,amul cheese,250,315,65,1,00376,India
813802,2023-09-24,212,amul cheese,250,315,65,1,00400,India
813802,2023-09-24,203,mango yogurt,50,60,10,1,00400,India
174950,2023-09-24,209,pepsi,75,100,25,1,00479,India
174950,2023-09-24,202,milk,12,27,15,1,00479,India
174950,2023-09-24,212,amul cheese,250,315,65,1,00479,India
174950,2023-09-24,203,mango yogurt,50,60,10,1,00479,India
174950,2023-09-24,207,coca cola,75,100,25,1,00479,India
758036,2023-09-24,213,bisleri,6,15,9,1,00280,India
758036,2023-09-24,209,pepsi,75,100,25,1,00280,India
758036,2023-09-24,208,sprite,75,100,25,1,00280,India
105305,2023-09-24,203,mango yogurt,50,60,10,1,00316,India
105305,2023-09-24,201,paneer,210,340,130,1,00316,India
105305,2023-09-24,211,red bull,90,125,35,1,00316,India
783741,2023-09-24,206,yakult,360,400,40,1,00052,India
783741,2023-09-24,210,mountain dew,75,100,25,1,00052,India
138828,2023-09-24,202,milk,12,27,15,1,00306,India
988554,2023-09-24,208,sprite,75,100,25,1,00478,India
988554,2023-09-24,205,classic yogurt,45,60,15,1,00478,India
988554,2023-09-24,202,milk,12,27,15,1,00478,India
988554,2023-09-24,207,coca cola,75,100,25,1,00478,India
382483,2023-09-24,206,yakult,360,400,40,1,00420,India
382483,2023-09-24,203,mango yogurt,50,60,10,1,00420,India
382483,2023-09-24,205,classic yogurt,45,60,15,1,00420,India
382483,2023-09-24,202,milk,12,27,15,1,00420,India
382483,2023-09-24,209,pepsi,75,100,25,1,00420,India
809748,2023-09-24,204,strawberry yogurt,50,60,10,1,00393,India
809748,2023-09-24,213,bisleri,6,15,9,1,00393,India
673171,2023-09-24,212,amul cheese,250,315,65,1,00326,India
673171,2023-09-24,204,strawberry yogurt,50,60,10,1,00326,India
673171,2023-09-24,208,sprite,75,100,25,1,00326,India
279385,2023-09-24,209,pepsi,75,100,25,1,00349,India
179727,2023-09-24,210,mountain dew,75,100,25,1,00060,India
555951,2023-09-24,204,strawberry yogurt,50,60,10,1,00257,India
255625,2023-09-24,202,milk,12,27,15,1,00309,India
255625,2023-09-24,205,classic yogurt,45,60,15,1,00309,India
255625,2023-09-24,204,strawberry yogurt,50,60,10,1,00309,India
255625,2023-09-24,210,mountain dew,75,100,25,1,00309,India
364510,2023-09-24,205,classic yogurt,45,60,15,1,00337,India
364510,2023-09-24,209,pepsi,75,100,25,1,00337,India
335873,2023-09-24,205,classic yogurt,45,60,15,1,00389,India
335873,2023-09-24,212,amul cheese,250,315,65,1,00389,India
335873,2023-09-24,207,coca cola,75,100,25,1,00389,India
848600,2023-09-24,212,amul cheese,250,315,65,1,00322,India
848600,2023-09-24,201,paneer,210,340,130,1,00322,India
848600,2023-09-24,205,classic yogurt,45,60,15,1,00322,India
839854,2023-09-24,210,mountain dew,75,100,25,1,00437,India
839854,2023-09-24,208,sprite,75,100,25,1,00437,India
839854,2023-09-24,213,bisleri,6,15,9,1,00437,India
633224,2023-09-24,205,classic yogurt,45,60,15,1,00069,India
633224,2023-09-24,203,mango yogurt,50,60,10,1,00069,India
633224,2023-09-24,209,pepsi,75,100,25,1,00069,India
938179,2023-09-24,205,classic yogurt,45,60,15,1,00285,India
938179,2023-09-24,202,milk,12,27,15,1,00285,India
536996,2023-09-24,206,yakult,360,400,40,1,00437,India
467143,2023-09-24,208,sprite,75,100,25,1,00256,India
775402,2023-09-24,213,bisleri,6,15,9,1,00277,India
756938,2023-09-24,210,mountain dew,75,100,25,1,00161,India
756938,2023-09-24,213,bisleri,6,15,9,1,00161,India
756938,2023-09-24,206,yakult,360,400,40,1,00161,India
459675,2023-09-24,206,yakult,360,400,40,1,00265,India
459675,2023-09-24,205,classic yogurt,45,60,15,1,00265,India
480349,2023-09-24,213,bisleri,6,15,9,1,00423,India
480349,2023-09-24,210,mountain dew,75,100,25,1,00423,India
480349,2023-09-24,204,strawberry yogurt,50,60,10,1,00423,India
480349,2023-09-24,202,milk,12,27,15,1,00423,India
850359,2023-09-24,209,pepsi,75,100,25,1,00310,India
162799,2023-09-24,202,milk,12,27,15,1,00224,India
162799,2023-09-24,209,pepsi,75,100,25,1,00224,India
944461,2023-09-24,206,yakult,360,400,40,1,00142,India
944461,2023-09-24,210,mountain dew,75,100,25,1,00142,India
944461,2023-09-24,209,pepsi,75,100,25,1,00142,India
826807,2023-09-24,201,paneer,210,340,130,1,00408,India
826807,2023-09-24,212,amul cheese,250,315,65,1,00408,India
826807,2023-09-24,204,strawberry yogurt,50,60,10,1,00408,India
716448,2023-09-24,209,pepsi,75,100,25,1,00101,India
716448,2023-09-24,201,paneer,210,340,130,1,00101,India
716448,2023-09-24,211,red bull,90,125,35,1,00101,India
716448,2023-09-24,213,bisleri,6,15,9,1,00101,India
163580,2023-09-24,205,classic yogurt,45,60,15,1,00379,India
163580,2023-09-24,212,amul cheese,250,315,65,1,00379,India
163580,2023-09-24,202,milk,12,27,15,1,00379,India
163580,2023-09-24,213,bisleri,6,15,9,1,00379,India
207514,2023-09-24,201,paneer,210,340,130,1,00382,India
207514,2023-09-24,212,amul cheese,250,315,65,1,00382,India
207514,2023-09-24,211,red bull,90,125,35,1,00382,India
909468,2023-09-24,202,milk,12,27,15,1,00032,India
909468,2023-09-24,204,strawberry yogurt,50,60,10,1,00032,India
909468,2023-09-24,206,yakult,360,400,40,1,00032,India
376507,2023-09-24,204,strawberry yogurt,50,60,10,1,00351,India
376507,2023-09-24,210,mountain dew,75,100,25,1,00351,India
376507,2023-09-24,207,coca cola,75,100,25,1,00351,India
989026,2023-09-24,209,pepsi,75,100,25,1,00083,India
989026,2023-09-24,211,red bull,90,125,35,1,00083,India
989026,2023-09-24,210,mountain dew,75,100,25,1,00083,India
989026,2023-09-24,213,bisleri,6,15,9,1,00083,India
989026,2023-09-24,212,amul cheese,250,315,65,1,00083,India
385552,2023-09-24,209,pepsi,75,100,25,1,00420,India
385552,2023-09-24,212,amul cheese,250,315,65,1,00420,India
349505,2023-09-24,201,paneer,210,340,130,1,00402,India
349505,2023-09-24,213,bisleri,6,15,9,1,00402,India
349505,2023-09-24,202,milk,12,27,15,1,00402,India
660257,2023-09-24,202,milk,12,27,15,1,00385,India
660257,2023-09-24,204,strawberry yogurt,50,60,10,1,00385,India
511361,2023-09-24,203,mango yogurt,50,60,10,1,00336,India
511361,2023-09-24,206,yakult,360,400,40,1,00336,India
511361,2023-09-24,204,strawberry yogurt,50,60,10,1,00336,India
192602,2023-09-24,202,milk,12,27,15,1,00417,India
361460,2023-09-24,210,mountain dew,75,100,25,1,00038,India
361460,2023-09-24,213,bisleri,6,15,9,1,00038,India
361460,2023-09-24,201,paneer,210,340,130,1,00038,India
361460,2023-09-24,202,milk,12,27,15,1,00038,India
769647,2023-09-24,201,paneer,210,340,130,1,00160,India
769647,2023-09-24,205,classic yogurt,45,60,15,1,00160,India
769647,2023-09-24,213,bisleri,6,15,9,1,00160,India
769647,2023-09-24,206,yakult,360,400,40,1,00160,India
848807,2023-09-24,204,strawberry yogurt,50,60,10,1,00407,India
462926,2023-09-24,210,mountain dew,75,100,25,1,00269,India
462926,2023-09-24,207,coca cola,75,100,25,1,00269,India
549659,2023-09-24,201,paneer,210,340,130,1,00184,India
627731,2023-09-24,206,yakult,360,400,40,1,00429,India
627731,2023-09-24,204,strawberry yogurt,50,60,10,1,00429,India
627731,2023-09-24,208,sprite,75,100,25,1,00429,India
811196,2023-09-24,211,red bull,90,125,35,1,00273,India
811196,2023-09-24,201,paneer,210,340,130,1,00273,India
192300,2023-09-24,208,sprite,75,100,25,1,00049,India
192300,2023-09-24,201,paneer,210,340,130,1,00049,India
192300,2023-09-24,202,milk,12,27,15,1,00049,India
192300,2023-09-24,204,strawberry yogurt,50,60,10,1,00049,India
123253,2023-09-24,202,milk,12,27,15,1,00490,India
123253,2023-09-24,206,yakult,360,400,40,1,00490,India
123253,2023-09-24,210,mountain dew,75,100,25,1,00490,India
438263,2023-09-24,209,pepsi,75,100,25,1,00400,India
128902,2023-09-24,209,pepsi,75,100,25,1,00165,India
128902,2023-09-24,205,classic yogurt,45,60,15,1,00165,India
128902,2023-09-24,213,bisleri,6,15,9,1,00165,India
128902,2023-09-24,201,paneer,210,340,130,1,00165,India
565015,2023-09-24,204,strawberry yogurt,50,60,10,1,00269,India
565015,2023-09-24,206,yakult,360,400,40,1,00269,India
620378,2023-09-24,201,paneer,210,340,130,1,00299,India
431117,2023-09-24,208,sprite,75,100,25,1,00355,India
431117,2023-09-24,201,paneer,210,340,130,1,00355,India
431117,2023-09-24,206,yakult,360,400,40,1,00355,India
499838,2023-09-24,211,red bull,90,125,35,1,00389,India
903311,2023-09-24,204,strawberry yogurt,50,60,10,1,00340,India
903311,2023-09-24,205,classic yogurt,45,60,15,1,00340,India
903311,2023-09-24,208,sprite,75,100,25,1,00340,India
148155,2023-09-24,211,red bull,90,125,35,1,00132,India
148155,2023-09-24,205,classic yogurt,45,60,15,1,00132,India
148155,2023-09-24,207,coca cola,75,100,25,1,00132,India
148155,2023-09-24,209,pepsi,75,100,25,1,00132,India
653007,2023-09-24,210,mountain dew,75,100,25,1,00045,India
653007,2023-09-24,213,bisleri,6,15,9,1,00045,India
229301,2023-09-24,207,coca cola,75,100,25,1,00208,India
819034,2023-09-24,212,amul cheese,250,315,65,1,00082,India
819034,2023-09-24,210,mountain dew,75,100,25,1,00082,India
819034,2023-09-24,209,pepsi,75,100,25,1,00082,India
599685,2023-09-24,204,strawberry yogurt,50,60,10,1,00420,India
289954,2023-09-24,213,bisleri,6,15,9,1,00266,India
289954,2023-09-24,206,yakult,360,400,40,1,00266,India
289954,2023-09-24,211,red bull,90,125,35,1,00266,India
289954,2023-09-24,207,coca cola,75,100,25,1,00266,India
723379,2023-09-24,210,mountain dew,75,100,25,1,00216,India
571680,2023-09-24,201,paneer,210,340,130,1,00360,India
571680,2023-09-24,207,coca cola,75,100,25,1,00360,India
571680,2023-09-24,204,strawberry yogurt,50,60,10,1,00360,India
507539,2023-09-24,209,pepsi,75,100,25,1,00254,India
621172,2023-09-24,213,bisleri,6,15,9,1,00292,India
621172,2023-09-24,203,mango yogurt,50,60,10,1,00292,India
621172,2023-09-24,212,amul cheese,250,315,65,1,00292,India
621172,2023-09-24,202,milk,12,27,15,1,00292,India
880960,2023-09-24,202,milk,12,27,15,1,00310,India
880960,2023-09-24,212,amul cheese,250,315,65,1,00310,India
880960,2023-09-24,211,red bull,90,125,35,1,00310,India
569112,2023-09-24,207,coca cola,75,100,25,1,00139,India
569112,2023-09-24,208,sprite,75,100,25,1,00139,India
569112,2023-09-24,212,amul cheese,250,315,65,1,00139,India
569112,2023-09-24,210,mountain dew,75,100,25,1,00139,India
569112,2023-09-24,206,yakult,360,400,40,1,00139,India
245711,2023-09-24,212,amul cheese,250,315,65,1,00101,India
174848,2023-09-24,210,mountain dew,75,100,25,1,00177,India
850668,2023-09-24,207,coca cola,75,100,25,1,00140,India
850668,2023-09-24,213,bisleri,6,15,9,1,00140,India
850668,2023-09-24,205,classic yogurt,45,60,15,1,00140,India
850668,2023-09-24,201,paneer,210,340,130,1,00140,India
850668,2023-09-24,208,sprite,75,100,25,1,00140,India
123662,2023-09-24,207,coca cola,75,100,25,1,00118,India
123662,2023-09-24,209,pepsi,75,100,25,1,00118,India
123662,2023-09-24,208,sprite,75,100,25,1,00118,India
855988,2023-09-24,202,milk,12,27,15,1,00192,India
855988,2023-09-24,205,classic yogurt,45,60,15,1,00192,India
855988,2023-09-24,201,paneer,210,340,130,1,00192,India
461040,2023-09-24,212,amul cheese,250,315,65,1,00281,India
461040,2023-09-24,203,mango yogurt,50,60,10,1,00281,India
461040,2023-09-24,210,mountain dew,75,100,25,1,00281,India
242713,2023-09-24,213,bisleri,6,15,9,1,00446,India
242713,2023-09-24,208,sprite,75,100,25,1,00446,India
242713,2023-09-24,211,red bull,90,125,35,1,00446,India
242713,2023-09-24,201,paneer,210,340,130,1,00446,India
178201,2023-09-24,206,yakult,360,400,40,1,00174,India
178201,2023-09-24,201,paneer,210,340,130,1,00174,India
178201,2023-09-24,208,sprite,75,100,25,1,00174,India
178201,2023-09-24,205,classic yogurt,45,60,15,1,00174,India
477013,2023-09-24,204,strawberry yogurt,50,60,10,1,00276,India
477013,2023-09-24,202,milk,12,27,15,1,00276,India
907128,2023-09-24,208,sprite,75,100,25,1,00029,India
907128,2023-09-24,207,coca cola,75,100,25,1,00029,India
907128,2023-09-24,212,amul cheese,250,315,65,1,00029,India
907128,2023-09-24,205,classic yogurt,45,60,15,1,00029,India
188623,2023-09-24,202,milk,12,27,15,1,00138,India
188623,2023-09-24,201,paneer,210,340,130,1,00138,India
188623,2023-09-24,208,sprite,75,100,25,1,00138,India
468167,2023-09-24,205,classic yogurt,45,60,15,1,00104,India
468167,2023-09-24,212,amul cheese,250,315,65,1,00104,India
403461,2023-09-24,213,bisleri,6,15,9,1,00148,India
403461,2023-09-24,211,red bull,90,125,35,1,00148,India
403461,2023-09-24,206,yakult,360,400,40,1,00148,India
138968,2023-09-24,202,milk,12,27,15,1,00414,India
312023,2023-09-24,207,coca cola,75,100,25,1,00112,India
312023,2023-09-24,213,bisleri,6,15,9,1,00112,India
710972,2023-09-24,206,yakult,360,400,40,1,00217,India
622608,2023-09-24,208,sprite,75,100,25,1,00153,India
622608,2023-09-24,202,milk,12,27,15,1,00153,India
770057,2023-09-24,212,amul cheese,250,315,65,1,00387,India
770057,2023-09-24,204,strawberry yogurt,50,60,10,1,00387,India
770057,2023-09-24,206,yakult,360,400,40,1,00387,India
770057,2023-09-24,202,milk,12,27,15,1,00387,India
607740,2023-09-24,210,mountain dew,75,100,25,1,00230,India
607740,2023-09-24,213,bisleri,6,15,9,1,00230,India
607740,2023-09-24,209,pepsi,75,100,25,1,00230,India
476220,2023-09-24,210,mountain dew,75,100,25,1,00209,India
476220,2023-09-24,209,pepsi,75,100,25,1,00209,India
678119,2023-09-24,208,sprite,75,100,25,1,00316,India
678119,2023-09-24,212,amul cheese,250,315,65,1,00316,India
163955,2023-09-24,208,sprite,75,100,25,1,00376,India
163955,2023-09-24,213,bisleri,6,15,9,1,00376,India
163955,2023-09-24,210,mountain dew,75,100,25,1,00376,India
585295,2023-09-24,201,paneer,210,340,130,1,00494,India
585295,2023-09-24,203,mango yogurt,50,60,10,1,00494,India
585295,2023-09-24,202,milk,12,27,15,1,00494,India
134701,2023-09-24,212,amul cheese,250,315,65,1,00432,India
134701,2023-09-24,206,yakult,360,400,40,1,00432,India
134701,2023-09-24,205,classic yogurt,45,60,15,1,00432,India
134701,2023-09-24,208,sprite,75,100,25,1,00432,India
134701,2023-09-24,207,coca cola,75,100,25,1,00432,India
393975,2023-09-24,211,red bull,90,125,35,1,00029,India
393975,2023-09-24,202,milk,12,27,15,1,00029,India
985326,2023-09-24,209,pepsi,75,100,25,1,00483,India
985326,2023-09-24,212,amul cheese,250,315,65,1,00483,India
280476,2023-09-24,204,strawberry yogurt,50,60,10,1,00460,India
280476,2023-09-24,212,amul cheese,250,315,65,1,00460,India
280476,2023-09-24,207,coca cola,75,100,25,1,00460,India
907729,2023-09-24,202,milk,12,27,15,1,00362,India
907729,2023-09-24,210,mountain dew,75,100,25,1,00362,India
907729,2023-09-24,201,paneer,210,340,130,1,00362,India
940488,2023-09-25,210,mountain dew,75,100,25,1,00102,India
940488,2023-09-25,209,pepsi,75,100,25,1,00102,India
940488,2023-09-25,208,sprite,75,100,25,1,00102,India
459499,2023-09-25,209,pepsi,75,100,25,1,00014,India
459499,2023-09-25,202,milk,12,27,15,1,00014,India
459499,2023-09-25,213,bisleri,6,15,9,1,00014,India
665014,2023-09-25,209,pepsi,75,100,25,1,00198,India
665014,2023-09-25,201,paneer,210,340,130,1,00198,India
665014,2023-09-25,211,red bull,90,125,35,1,00198,India
665014,2023-09-25,205,classic yogurt,45,60,15,1,00198,India
735276,2023-09-25,210,mountain dew,75,100,25,1,00057,India
735276,2023-09-25,205,classic yogurt,45,60,15,1,00057,India
735276,2023-09-25,204,strawberry yogurt,50,60,10,1,00057,India
735276,2023-09-25,207,coca cola,75,100,25,1,00057,India
735276,2023-09-25,211,red bull,90,125,35,1,00057,India
189555,2023-09-25,208,sprite,75,100,25,1,00278,India
189555,2023-09-25,212,amul cheese,250,315,65,1,00278,India
585086,2023-09-25,204,strawberry yogurt,50,60,10,1,00155,India
581642,2023-09-25,203,mango yogurt,50,60,10,1,00119,India
581642,2023-09-25,202,milk,12,27,15,1,00119,India
581642,2023-09-25,209,pepsi,75,100,25,1,00119,India
961195,2023-09-25,213,bisleri,6,15,9,1,00218,India
961195,2023-09-25,212,amul cheese,250,315,65,1,00218,India
961195,2023-09-25,205,classic yogurt,45,60,15,1,00218,India
398303,2023-09-25,205,classic yogurt,45,60,15,1,00451,India
398303,2023-09-25,206,yakult,360,400,40,1,00451,India
108255,2023-09-25,203,mango yogurt,50,60,10,1,00390,India
108255,2023-09-25,201,paneer,210,340,130,1,00390,India
108255,2023-09-25,208,sprite,75,100,25,1,00390,India
108255,2023-09-25,205,classic yogurt,45,60,15,1,00390,India
850859,2023-09-25,207,coca cola,75,100,25,1,00115,India
850859,2023-09-25,202,milk,12,27,15,1,00115,India
850859,2023-09-25,212,amul cheese,250,315,65,1,00115,India
850859,2023-09-25,213,bisleri,6,15,9,1,00115,India
199361,2023-09-25,211,red bull,90,125,35,1,00340,India
199361,2023-09-25,210,mountain dew,75,100,25,1,00340,India
199361,2023-09-25,212,amul cheese,250,315,65,1,00340,India
357552,2023-09-25,204,strawberry yogurt,50,60,10,1,00113,India
357552,2023-09-25,208,sprite,75,100,25,1,00113,India
357552,2023-09-25,205,classic yogurt,45,60,15,1,00113,India
357552,2023-09-25,202,milk,12,27,15,1,00113,India
205697,2023-09-25,209,pepsi,75,100,25,1,00142,India
229620,2023-09-25,210,mountain dew,75,100,25,1,00153,India
229620,2023-09-25,202,milk,12,27,15,1,00153,India
229620,2023-09-25,203,mango yogurt,50,60,10,1,00153,India
907847,2023-09-25,207,coca cola,75,100,25,1,00038,India
672930,2023-09-25,208,sprite,75,100,25,1,00236,India
672930,2023-09-25,207,coca cola,75,100,25,1,00236,India
444780,2023-09-25,210,mountain dew,75,100,25,1,00169,India
444780,2023-09-25,203,mango yogurt,50,60,10,1,00169,India
444780,2023-09-25,212,amul cheese,250,315,65,1,00169,India
324518,2023-09-25,209,pepsi,75,100,25,1,00118,India
324518,2023-09-25,201,paneer,210,340,130,1,00118,India
324518,2023-09-25,203,mango yogurt,50,60,10,1,00118,India
842492,2023-09-25,205,classic yogurt,45,60,15,1,00210,India
842492,2023-09-25,210,mountain dew,75,100,25,1,00210,India
791856,2023-09-25,205,classic yogurt,45,60,15,1,00247,India
836308,2023-09-25,213,bisleri,6,15,9,1,00141,India
836308,2023-09-25,211,red bull,90,125,35,1,00141,India
836308,2023-09-25,210,mountain dew,75,100,25,1,00141,India
234537,2023-09-25,203,mango yogurt,50,60,10,1,00106,India
234537,2023-09-25,206,yakult,360,400,40,1,00106,India
234537,2023-09-25,208,sprite,75,100,25,1,00106,India
179490,2023-09-25,209,pepsi,75,100,25,1,00335,India
179490,2023-09-25,213,bisleri,6,15,9,1,00335,India
500543,2023-09-25,212,amul cheese,250,315,65,1,00101,India
500543,2023-09-25,213,bisleri,6,15,9,1,00101,India
500543,2023-09-25,204,strawberry yogurt,50,60,10,1,00101,India
500543,2023-09-25,211,red bull,90,125,35,1,00101,India
915074,2023-09-25,204,strawberry yogurt,50,60,10,1,00070,India
444399,2023-09-25,202,milk,12,27,15,1,00433,India
168765,2023-09-25,210,mountain dew,75,100,25,1,00189,India
168765,2023-09-25,208,sprite,75,100,25,1,00189,India
792724,2023-09-25,213,bisleri,6,15,9,1,00238,India
792724,2023-09-25,205,classic yogurt,45,60,15,1,00238,India
792724,2023-09-25,207,coca cola,75,100,25,1,00238,India
792724,2023-09-25,211,red bull,90,125,35,1,00238,India
869933,2023-09-25,204,strawberry yogurt,50,60,10,1,00187,India
869933,2023-09-25,212,amul cheese,250,315,65,1,00187,India
869933,2023-09-25,203,mango yogurt,50,60,10,1,00187,India
869933,2023-09-25,206,yakult,360,400,40,1,00187,India
782370,2023-09-25,213,bisleri,6,15,9,1,00076,India
782370,2023-09-25,204,strawberry yogurt,50,60,10,1,00076,India
484357,2023-09-25,201,paneer,210,340,130,1,00307,India
484357,2023-09-25,210,mountain dew,75,100,25,1,00307,India
484357,2023-09-25,206,yakult,360,400,40,1,00307,India
826105,2023-09-25,206,yakult,360,400,40,1,00389,India
826105,2023-09-25,203,mango yogurt,50,60,10,1,00389,India
826105,2023-09-25,211,red bull,90,125,35,1,00389,India
595078,2023-09-25,208,sprite,75,100,25,1,00084,India
595078,2023-09-25,210,mountain dew,75,100,25,1,00084,India
595078,2023-09-25,203,mango yogurt,50,60,10,1,00084,India
595078,2023-09-25,207,coca cola,75,100,25,1,00084,India
411179,2023-09-25,207,coca cola,75,100,25,1,00020,India
411179,2023-09-25,201,paneer,210,340,130,1,00020,India
411179,2023-09-25,211,red bull,90,125,35,1,00020,India
411179,2023-09-25,213,bisleri,6,15,9,1,00020,India
855752,2023-09-25,212,amul cheese,250,315,65,1,00035,India
855752,2023-09-25,203,mango yogurt,50,60,10,1,00035,India
855752,2023-09-25,209,pepsi,75,100,25,1,00035,India
855752,2023-09-25,211,red bull,90,125,35,1,00035,India
316445,2023-09-25,213,bisleri,6,15,9,1,00319,India
316445,2023-09-25,202,milk,12,27,15,1,00319,India
316445,2023-09-25,201,paneer,210,340,130,1,00319,India
316445,2023-09-25,210,mountain dew,75,100,25,1,00319,India
316445,2023-09-25,212,amul cheese,250,315,65,1,00319,India
328761,2023-09-25,211,red bull,90,125,35,1,00326,India
792805,2023-09-25,210,mountain dew,75,100,25,1,00043,India
792805,2023-09-25,205,classic yogurt,45,60,15,1,00043,India
792805,2023-09-25,211,red bull,90,125,35,1,00043,India
548545,2023-09-25,210,mountain dew,75,100,25,1,00415,India
548545,2023-09-25,211,red bull,90,125,35,1,00415,India
372469,2023-09-25,205,classic yogurt,45,60,15,1,00262,India
372469,2023-09-25,211,red bull,90,125,35,1,00262,India
372469,2023-09-25,207,coca cola,75,100,25,1,00262,India
372469,2023-09-25,209,pepsi,75,100,25,1,00262,India
372469,2023-09-25,206,yakult,360,400,40,1,00262,India
604143,2023-09-25,206,yakult,360,400,40,1,00260,India
604143,2023-09-25,211,red bull,90,125,35,1,00260,India
604143,2023-09-25,204,strawberry yogurt,50,60,10,1,00260,India
113804,2023-09-25,204,strawberry yogurt,50,60,10,1,00003,India
113804,2023-09-25,208,sprite,75,100,25,1,00003,India
113804,2023-09-25,211,red bull,90,125,35,1,00003,India
882539,2023-09-25,201,paneer,210,340,130,1,00421,India
710689,2023-09-25,202,milk,12,27,15,1,00190,India
710689,2023-09-25,203,mango yogurt,50,60,10,1,00190,India
710689,2023-09-25,206,yakult,360,400,40,1,00190,India
710689,2023-09-25,209,pepsi,75,100,25,1,00190,India
994847,2023-09-25,209,pepsi,75,100,25,1,00271,India
994847,2023-09-25,201,paneer,210,340,130,1,00271,India
805474,2023-09-25,202,milk,12,27,15,1,00356,India
805474,2023-09-25,207,coca cola,75,100,25,1,00356,India
805474,2023-09-25,212,amul cheese,250,315,65,1,00356,India
390635,2023-09-25,210,mountain dew,75,100,25,1,00131,India
390635,2023-09-25,211,red bull,90,125,35,1,00131,India
390635,2023-09-25,204,strawberry yogurt,50,60,10,1,00131,India
631791,2023-09-25,204,strawberry yogurt,50,60,10,1,00095,India
631791,2023-09-25,203,mango yogurt,50,60,10,1,00095,India
909997,2023-09-25,212,amul cheese,250,315,65,1,00158,India
909997,2023-09-25,206,yakult,360,400,40,1,00158,India
909997,2023-09-25,201,paneer,210,340,130,1,00158,India
909997,2023-09-25,204,strawberry yogurt,50,60,10,1,00158,India
909997,2023-09-25,211,red bull,90,125,35,1,00158,India
739547,2023-09-25,206,yakult,360,400,40,1,00123,India
602244,2023-09-25,203,mango yogurt,50,60,10,1,00436,India
186993,2023-09-25,210,mountain dew,75,100,25,1,00466,India
948502,2023-09-25,206,yakult,360,400,40,1,00318,India
948502,2023-09-25,202,milk,12,27,15,1,00318,India
948502,2023-09-25,213,bisleri,6,15,9,1,00318,India
948502,2023-09-25,208,sprite,75,100,25,1,00318,India
950672,2023-09-25,213,bisleri,6,15,9,1,00263,India
950672,2023-09-25,202,milk,12,27,15,1,00263,India
950672,2023-09-25,208,sprite,75,100,25,1,00263,India
950672,2023-09-25,212,amul cheese,250,315,65,1,00263,India
144886,2023-09-25,205,classic yogurt,45,60,15,1,00160,India
144886,2023-09-25,209,pepsi,75,100,25,1,00160,India
144886,2023-09-25,210,mountain dew,75,100,25,1,00160,India
144886,2023-09-25,211,red bull,90,125,35,1,00160,India
761070,2023-09-25,212,amul cheese,250,315,65,1,00061,India
761070,2023-09-25,205,classic yogurt,45,60,15,1,00061,India
761070,2023-09-25,203,mango yogurt,50,60,10,1,00061,India
761070,2023-09-25,210,mountain dew,75,100,25,1,00061,India
453400,2023-09-25,205,classic yogurt,45,60,15,1,00346,India
453400,2023-09-25,211,red bull,90,125,35,1,00346,India
453400,2023-09-25,203,mango yogurt,50,60,10,1,00346,India
453400,2023-09-25,204,strawberry yogurt,50,60,10,1,00346,India
318137,2023-09-25,207,coca cola,75,100,25,1,00266,India
608826,2023-09-25,211,red bull,90,125,35,1,00143,India
608826,2023-09-25,208,sprite,75,100,25,1,00143,India
608826,2023-09-25,212,amul cheese,250,315,65,1,00143,India
889252,2023-09-25,204,strawberry yogurt,50,60,10,1,00357,India
928048,2023-09-25,209,pepsi,75,100,25,1,00336,India
857384,2023-09-25,201,paneer,210,340,130,1,00440,India
814121,2023-09-25,205,classic yogurt,45,60,15,1,00438,India
814121,2023-09-25,212,amul cheese,250,315,65,1,00438,India
485015,2023-09-25,208,sprite,75,100,25,1,00202,India
973799,2023-09-25,206,yakult,360,400,40,1,00068,India
973799,2023-09-25,202,milk,12,27,15,1,00068,India
973799,2023-09-25,212,amul cheese,250,315,65,1,00068,India
973799,2023-09-25,208,sprite,75,100,25,1,00068,India
368235,2023-09-25,212,amul cheese,250,315,65,1,00135,India
368235,2023-09-25,213,bisleri,6,15,9,1,00135,India
368235,2023-09-25,206,yakult,360,400,40,1,00135,India
368235,2023-09-25,204,strawberry yogurt,50,60,10,1,00135,India
610265,2023-09-25,205,classic yogurt,45,60,15,1,00372,India
610265,2023-09-25,212,amul cheese,250,315,65,1,00372,India
610265,2023-09-25,210,mountain dew,75,100,25,1,00372,India
610265,2023-09-25,201,paneer,210,340,130,1,00372,India
610265,2023-09-25,209,pepsi,75,100,25,1,00372,India
799793,2023-09-25,205,classic yogurt,45,60,15,1,00097,India
703501,2023-09-25,212,amul cheese,250,315,65,1,00303,India
703501,2023-09-25,204,strawberry yogurt,50,60,10,1,00303,India
703501,2023-09-25,207,coca cola,75,100,25,1,00303,India
703501,2023-09-25,201,paneer,210,340,130,1,00303,India
117296,2023-09-25,210,mountain dew,75,100,25,1,00195,India
117296,2023-09-25,211,red bull,90,125,35,1,00195,India
117296,2023-09-25,209,pepsi,75,100,25,1,00195,India
117296,2023-09-25,203,mango yogurt,50,60,10,1,00195,India
420014,2023-09-25,206,yakult,360,400,40,1,00294,India
420014,2023-09-25,212,amul cheese,250,315,65,1,00294,India
420014,2023-09-25,210,mountain dew,75,100,25,1,00294,India
284524,2023-09-25,210,mountain dew,75,100,25,1,00339,India
284524,2023-09-25,205,classic yogurt,45,60,15,1,00339,India
284524,2023-09-25,202,milk,12,27,15,1,00339,India
284524,2023-09-25,201,paneer,210,340,130,1,00339,India
238796,2023-09-25,204,strawberry yogurt,50,60,10,1,00217,India
238796,2023-09-25,202,milk,12,27,15,1,00217,India
976168,2023-09-26,205,classic yogurt,45,60,15,1,00183,India
976168,2023-09-26,208,sprite,75,100,25,1,00183,India
976168,2023-09-26,210,mountain dew,75,100,25,1,00183,India
188559,2023-09-26,209,pepsi,75,100,25,1,00226,India
692931,2023-09-26,207,coca cola,75,100,25,1,00251,India
692931,2023-09-26,201,paneer,210,340,130,1,00251,India
692931,2023-09-26,213,bisleri,6,15,9,1,00251,India
692931,2023-09-26,205,classic yogurt,45,60,15,1,00251,India
692931,2023-09-26,210,mountain dew,75,100,25,1,00251,India
152682,2023-09-26,212,amul cheese,250,315,65,1,00072,India
152682,2023-09-26,213,bisleri,6,15,9,1,00072,India
744267,2023-09-26,210,mountain dew,75,100,25,1,00106,India
505106,2023-09-26,207,coca cola,75,100,25,1,00327,India
948148,2023-09-26,206,yakult,360,400,40,1,00081,India
623376,2023-09-26,209,pepsi,75,100,25,1,00403,India
623376,2023-09-26,213,bisleri,6,15,9,1,00403,India
623376,2023-09-26,206,yakult,360,400,40,1,00403,India
623376,2023-09-26,203,mango yogurt,50,60,10,1,00403,India
221700,2023-09-26,204,strawberry yogurt,50,60,10,1,00119,India
314291,2023-09-26,209,pepsi,75,100,25,1,00035,India
314291,2023-09-26,202,milk,12,27,15,1,00035,India
314291,2023-09-26,205,classic yogurt,45,60,15,1,00035,India
314291,2023-09-26,203,mango yogurt,50,60,10,1,00035,India
349243,2023-09-26,210,mountain dew,75,100,25,1,00044,India
272810,2023-09-26,211,red bull,90,125,35,1,00187,India
272810,2023-09-26,212,amul cheese,250,315,65,1,00187,India
272810,2023-09-26,204,strawberry yogurt,50,60,10,1,00187,India
547298,2023-09-26,203,mango yogurt,50,60,10,1,00459,India
547298,2023-09-26,207,coca cola,75,100,25,1,00459,India
547298,2023-09-26,211,red bull,90,125,35,1,00459,India
547298,2023-09-26,209,pepsi,75,100,25,1,00459,India
266093,2023-09-26,210,mountain dew,75,100,25,1,00171,India
266093,2023-09-26,205,classic yogurt,45,60,15,1,00171,India
266093,2023-09-26,211,red bull,90,125,35,1,00171,India
266093,2023-09-26,209,pepsi,75,100,25,1,00171,India
585065,2023-09-26,207,coca cola,75,100,25,1,00157,India
585065,2023-09-26,201,paneer,210,340,130,1,00157,India
585065,2023-09-26,213,bisleri,6,15,9,1,00157,India
585065,2023-09-26,203,mango yogurt,50,60,10,1,00157,India
585065,2023-09-26,210,mountain dew,75,100,25,1,00157,India
833124,2023-09-26,202,milk,12,27,15,1,00400,India
833124,2023-09-26,212,amul cheese,250,315,65,1,00400,India
833124,2023-09-26,204,strawberry yogurt,50,60,10,1,00400,India
833124,2023-09-26,210,mountain dew,75,100,25,1,00400,India
929476,2023-09-26,212,amul cheese,250,315,65,1,00441,India
929476,2023-09-26,209,pepsi,75,100,25,1,00441,India
929476,2023-09-26,206,yakult,360,400,40,1,00441,India
929476,2023-09-26,203,mango yogurt,50,60,10,1,00441,India
929476,2023-09-26,204,strawberry yogurt,50,60,10,1,00441,India
595089,2023-09-26,206,yakult,360,400,40,1,00473,India
856050,2023-09-26,208,sprite,75,100,25,1,00371,India
856050,2023-09-26,209,pepsi,75,100,25,1,00371,India
856050,2023-09-26,203,mango yogurt,50,60,10,1,00371,India
856050,2023-09-26,201,paneer,210,340,130,1,00371,India
372621,2023-09-26,211,red bull,90,125,35,1,00496,India
372621,2023-09-26,213,bisleri,6,15,9,1,00496,India
372621,2023-09-26,204,strawberry yogurt,50,60,10,1,00496,India
372621,2023-09-26,203,mango yogurt,50,60,10,1,00496,India
767440,2023-09-26,202,milk,12,27,15,1,00423,India
767440,2023-09-26,210,mountain dew,75,100,25,1,00423,India
767440,2023-09-26,206,yakult,360,400,40,1,00423,India
983974,2023-09-26,207,coca cola,75,100,25,1,00458,India
983974,2023-09-26,205,classic yogurt,45,60,15,1,00458,India
983974,2023-09-26,210,mountain dew,75,100,25,1,00458,India
983974,2023-09-26,209,pepsi,75,100,25,1,00458,India
106368,2023-09-26,207,coca cola,75,100,25,1,00288,India
106368,2023-09-26,201,paneer,210,340,130,1,00288,India
607877,2023-09-26,213,bisleri,6,15,9,1,00476,India
607877,2023-09-26,210,mountain dew,75,100,25,1,00476,India
607877,2023-09-26,202,milk,12,27,15,1,00476,India
607877,2023-09-26,209,pepsi,75,100,25,1,00476,India
793823,2023-09-26,206,yakult,360,400,40,1,00034,India
793823,2023-09-26,203,mango yogurt,50,60,10,1,00034,India
793823,2023-09-26,202,milk,12,27,15,1,00034,India
531585,2023-09-26,205,classic yogurt,45,60,15,1,00438,India
531585,2023-09-26,201,paneer,210,340,130,1,00438,India
531585,2023-09-26,212,amul cheese,250,315,65,1,00438,India
531585,2023-09-26,207,coca cola,75,100,25,1,00438,India
531585,2023-09-26,203,mango yogurt,50,60,10,1,00438,India
360649,2023-09-26,206,yakult,360,400,40,1,00304,India
360649,2023-09-26,213,bisleri,6,15,9,1,00304,India
360649,2023-09-26,201,paneer,210,340,130,1,00304,India
360649,2023-09-26,204,strawberry yogurt,50,60,10,1,00304,India
568463,2023-09-26,204,strawberry yogurt,50,60,10,1,00184,India
568463,2023-09-26,202,milk,12,27,15,1,00184,India
568463,2023-09-26,211,red bull,90,125,35,1,00184,India
568463,2023-09-26,213,bisleri,6,15,9,1,00184,India
873157,2023-09-26,211,red bull,90,125,35,1,00223,India
873157,2023-09-26,207,coca cola,75,100,25,1,00223,India
905840,2023-09-26,208,sprite,75,100,25,1,00482,India
905840,2023-09-26,202,milk,12,27,15,1,00482,India
905840,2023-09-26,206,yakult,360,400,40,1,00482,India
548787,2023-09-26,206,yakult,360,400,40,1,00004,India
548787,2023-09-26,202,milk,12,27,15,1,00004,India
741757,2023-09-26,203,mango yogurt,50,60,10,1,00369,India
741757,2023-09-26,204,strawberry yogurt,50,60,10,1,00369,India
741757,2023-09-26,206,yakult,360,400,40,1,00369,India
741757,2023-09-26,212,amul cheese,250,315,65,1,00369,India
141047,2023-09-26,209,pepsi,75,100,25,1,00153,India
227026,2023-09-26,203,mango yogurt,50,60,10,1,00300,India
227026,2023-09-26,208,sprite,75,100,25,1,00300,India
185077,2023-09-26,208,sprite,75,100,25,1,00248,India
185077,2023-09-26,204,strawberry yogurt,50,60,10,1,00248,India
518847,2023-09-26,206,yakult,360,400,40,1,00413,India
518847,2023-09-26,211,red bull,90,125,35,1,00413,India
518847,2023-09-26,204,strawberry yogurt,50,60,10,1,00413,India
518847,2023-09-26,207,coca cola,75,100,25,1,00413,India
257367,2023-09-26,211,red bull,90,125,35,1,00165,India
257367,2023-09-26,203,mango yogurt,50,60,10,1,00165,India
257367,2023-09-26,212,amul cheese,250,315,65,1,00165,India
257367,2023-09-26,204,strawberry yogurt,50,60,10,1,00165,India
768293,2023-09-26,203,mango yogurt,50,60,10,1,00499,India
768293,2023-09-26,209,pepsi,75,100,25,1,00499,India
786223,2023-09-26,212,amul cheese,250,315,65,1,00252,India
786223,2023-09-26,203,mango yogurt,50,60,10,1,00252,India
786223,2023-09-26,213,bisleri,6,15,9,1,00252,India
786223,2023-09-26,202,milk,12,27,15,1,00252,India
284901,2023-09-26,203,mango yogurt,50,60,10,1,00477,India
284901,2023-09-26,206,yakult,360,400,40,1,00477,India
284901,2023-09-26,205,classic yogurt,45,60,15,1,00477,India
731762,2023-09-26,213,bisleri,6,15,9,1,00326,India
731762,2023-09-26,212,amul cheese,250,315,65,1,00326,India
731762,2023-09-26,209,pepsi,75,100,25,1,00326,India
121709,2023-09-26,206,yakult,360,400,40,1,00070,India
121709,2023-09-26,208,sprite,75,100,25,1,00070,India
315378,2023-09-26,202,milk,12,27,15,1,00022,India
763974,2023-09-26,201,paneer,210,340,130,1,00141,India
763974,2023-09-26,205,classic yogurt,45,60,15,1,00141,India
223413,2023-09-26,210,mountain dew,75,100,25,1,00386,India
223413,2023-09-26,211,red bull,90,125,35,1,00386,India
223413,2023-09-26,201,paneer,210,340,130,1,00386,India
228151,2023-09-26,210,mountain dew,75,100,25,1,00011,India
228151,2023-09-26,201,paneer,210,340,130,1,00011,India
106549,2023-09-26,208,sprite,75,100,25,1,00137,India
351400,2023-09-26,201,paneer,210,340,130,1,00060,India
351400,2023-09-26,202,milk,12,27,15,1,00060,India
351400,2023-09-26,206,yakult,360,400,40,1,00060,India
351400,2023-09-26,212,amul cheese,250,315,65,1,00060,India
351400,2023-09-26,208,sprite,75,100,25,1,00060,India
169106,2023-09-26,201,paneer,210,340,130,1,00278,India
169106,2023-09-26,203,mango yogurt,50,60,10,1,00278,India
169106,2023-09-26,212,amul cheese,250,315,65,1,00278,India
169106,2023-09-26,204,strawberry yogurt,50,60,10,1,00278,India
169106,2023-09-26,211,red bull,90,125,35,1,00278,India
920450,2023-09-26,212,amul cheese,250,315,65,1,00117,India
920450,2023-09-26,209,pepsi,75,100,25,1,00117,India
920450,2023-09-26,205,classic yogurt,45,60,15,1,00117,India
760170,2023-09-26,213,bisleri,6,15,9,1,00041,India
362958,2023-09-26,206,yakult,360,400,40,1,00284,India
362958,2023-09-26,203,mango yogurt,50,60,10,1,00284,India
271479,2023-09-26,213,bisleri,6,15,9,1,00210,India
338993,2023-09-26,212,amul cheese,250,315,65,1,00500,India
260108,2023-09-26,209,pepsi,75,100,25,1,00465,India
260108,2023-09-26,201,paneer,210,340,130,1,00465,India
342487,2023-09-26,203,mango yogurt,50,60,10,1,00238,India
342487,2023-09-26,209,pepsi,75,100,25,1,00238,India
417168,2023-09-26,211,red bull,90,125,35,1,00380,India
417168,2023-09-26,208,sprite,75,100,25,1,00380,India
417168,2023-09-26,209,pepsi,75,100,25,1,00380,India
417168,2023-09-26,212,amul cheese,250,315,65,1,00380,India
417168,2023-09-26,205,classic yogurt,45,60,15,1,00380,India
349998,2023-09-26,213,bisleri,6,15,9,1,00401,India
349998,2023-09-26,209,pepsi,75,100,25,1,00401,India
744326,2023-09-26,205,classic yogurt,45,60,15,1,00431,India
744326,2023-09-26,201,paneer,210,340,130,1,00431,India
744326,2023-09-26,209,pepsi,75,100,25,1,00431,India
148350,2023-09-26,206,yakult,360,400,40,1,00032,India
148350,2023-09-26,205,classic yogurt,45,60,15,1,00032,India
148350,2023-09-26,212,amul cheese,250,315,65,1,00032,India
148350,2023-09-26,204,strawberry yogurt,50,60,10,1,00032,India
636040,2023-09-26,204,strawberry yogurt,50,60,10,1,00009,India
636040,2023-09-26,201,paneer,210,340,130,1,00009,India
636040,2023-09-26,213,bisleri,6,15,9,1,00009,India
476143,2023-09-26,204,strawberry yogurt,50,60,10,1,00306,India
476143,2023-09-26,201,paneer,210,340,130,1,00306,India
476143,2023-09-26,202,milk,12,27,15,1,00306,India
629964,2023-09-26,201,paneer,210,340,130,1,00223,India
629964,2023-09-26,202,milk,12,27,15,1,00223,India
629964,2023-09-26,208,sprite,75,100,25,1,00223,India
320215,2023-09-26,206,yakult,360,400,40,1,00469,India
320215,2023-09-26,209,pepsi,75,100,25,1,00469,India
320215,2023-09-26,203,mango yogurt,50,60,10,1,00469,India
441879,2023-09-26,211,red bull,90,125,35,1,00388,India
441879,2023-09-26,203,mango yogurt,50,60,10,1,00388,India
441879,2023-09-26,206,yakult,360,400,40,1,00388,India
711891,2023-09-26,210,mountain dew,75,100,25,1,00373,India
293406,2023-09-26,203,mango yogurt,50,60,10,1,00257,India
328073,2023-09-26,211,red bull,90,125,35,1,00056,India
328073,2023-09-26,205,classic yogurt,45,60,15,1,00056,India
328073,2023-09-26,203,mango yogurt,50,60,10,1,00056,India
328073,2023-09-26,209,pepsi,75,100,25,1,00056,India
192603,2023-09-26,203,mango yogurt,50,60,10,1,00044,India
192603,2023-09-26,211,red bull,90,125,35,1,00044,India
192603,2023-09-26,208,sprite,75,100,25,1,00044,India
192603,2023-09-26,207,coca cola,75,100,25,1,00044,India
192603,2023-09-26,202,milk,12,27,15,1,00044,India
220819,2023-09-26,201,paneer,210,340,130,1,00305,India
414802,2023-09-26,206,yakult,360,400,40,1,00110,India
414802,2023-09-26,207,coca cola,75,100,25,1,00110,India
414802,2023-09-26,202,milk,12,27,15,1,00110,India
811173,2023-09-26,212,amul cheese,250,315,65,1,00422,India
805667,2023-09-26,205,classic yogurt,45,60,15,1,00286,India
805667,2023-09-26,206,yakult,360,400,40,1,00286,India
805667,2023-09-26,204,strawberry yogurt,50,60,10,1,00286,India
805667,2023-09-26,207,coca cola,75,100,25,1,00286,India
463070,2023-09-26,205,classic yogurt,45,60,15,1,00381,India
458599,2023-09-26,206,yakult,360,400,40,1,00300,India
458599,2023-09-26,202,milk,12,27,15,1,00300,India
458599,2023-09-26,204,strawberry yogurt,50,60,10,1,00300,India
184581,2023-09-26,205,classic yogurt,45,60,15,1,00092,India
184581,2023-09-26,202,milk,12,27,15,1,00092,India
184581,2023-09-26,204,strawberry yogurt,50,60,10,1,00092,India
184581,2023-09-26,203,mango yogurt,50,60,10,1,00092,India
184581,2023-09-26,212,amul cheese,250,315,65,1,00092,India
652408,2023-09-26,201,paneer,210,340,130,1,00122,India
255190,2023-09-26,207,coca cola,75,100,25,1,00193,India
255190,2023-09-26,205,classic yogurt,45,60,15,1,00193,India
229554,2023-09-26,209,pepsi,75,100,25,1,00141,India
192177,2023-09-26,203,mango yogurt,50,60,10,1,00072,India
770545,2023-09-26,212,amul cheese,250,315,65,1,00423,India
770545,2023-09-26,202,milk,12,27,15,1,00423,India
770545,2023-09-26,209,pepsi,75,100,25,1,00423,India
704748,2023-09-26,207,coca cola,75,100,25,1,00102,India
704748,2023-09-26,210,mountain dew,75,100,25,1,00102,India
704748,2023-09-26,204,strawberry yogurt,50,60,10,1,00102,India
774159,2023-09-26,212,amul cheese,250,315,65,1,00393,India
774159,2023-09-26,210,mountain dew,75,100,25,1,00393,India
774159,2023-09-26,211,red bull,90,125,35,1,00393,India
849496,2023-09-26,207,coca cola,75,100,25,1,00448,India
849496,2023-09-26,203,mango yogurt,50,60,10,1,00448,India
849496,2023-09-26,209,pepsi,75,100,25,1,00448,India
849496,2023-09-26,201,paneer,210,340,130,1,00448,India
849496,2023-09-26,211,red bull,90,125,35,1,00448,India
470096,2023-09-26,202,milk,12,27,15,1,00476,India
470096,2023-09-26,206,yakult,360,400,40,1,00476,India
470096,2023-09-26,210,mountain dew,75,100,25,1,00476,India
470096,2023-09-26,204,strawberry yogurt,50,60,10,1,00476,India
861274,2023-09-26,202,milk,12,27,15,1,00247,India
861274,2023-09-26,204,strawberry yogurt,50,60,10,1,00247,India
861274,2023-09-26,208,sprite,75,100,25,1,00247,India
915023,2023-09-26,201,paneer,210,340,130,1,00444,India
915023,2023-09-26,206,yakult,360,400,40,1,00444,India
915023,2023-09-26,213,bisleri,6,15,9,1,00444,India
915023,2023-09-26,205,classic yogurt,45,60,15,1,00444,India
915023,2023-09-26,212,amul cheese,250,315,65,1,00444,India
121393,2023-09-26,210,mountain dew,75,100,25,1,00016,India
121393,2023-09-26,204,strawberry yogurt,50,60,10,1,00016,India
121393,2023-09-26,205,classic yogurt,45,60,15,1,00016,India
886571,2023-09-26,208,sprite,75,100,25,1,00160,India
886571,2023-09-26,201,paneer,210,340,130,1,00160,India
886571,2023-09-26,206,yakult,360,400,40,1,00160,India
630326,2023-09-26,204,strawberry yogurt,50,60,10,1,00307,India
109465,2023-09-26,211,red bull,90,125,35,1,00199,India
652726,2023-09-26,211,red bull,90,125,35,1,00295,India
652726,2023-09-26,210,mountain dew,75,100,25,1,00295,India
970371,2023-09-26,202,milk,12,27,15,1,00288,India
970371,2023-09-26,212,amul cheese,250,315,65,1,00288,India
970371,2023-09-26,205,classic yogurt,45,60,15,1,00288,India
613317,2023-09-26,211,red bull,90,125,35,1,00422,India
613317,2023-09-26,207,coca cola,75,100,25,1,00422,India
613317,2023-09-26,204,strawberry yogurt,50,60,10,1,00422,India
613317,2023-09-26,205,classic yogurt,45,60,15,1,00422,India
613317,2023-09-26,208,sprite,75,100,25,1,00422,India
933218,2023-09-26,202,milk,12,27,15,1,00492,India
933218,2023-09-26,203,mango yogurt,50,60,10,1,00492,India
878941,2023-09-26,209,pepsi,75,100,25,1,00123,India
878941,2023-09-26,205,classic yogurt,45,60,15,1,00123,India
878941,2023-09-26,210,mountain dew,75,100,25,1,00123,India
878941,2023-09-26,202,milk,12,27,15,1,00123,India
931286,2023-09-26,205,classic yogurt,45,60,15,1,00131,India
555166,2023-09-26,212,amul cheese,250,315,65,1,00262,India
555166,2023-09-26,206,yakult,360,400,40,1,00262,India
555166,2023-09-26,203,mango yogurt,50,60,10,1,00262,India
555166,2023-09-26,207,coca cola,75,100,25,1,00262,India
555166,2023-09-26,205,classic yogurt,45,60,15,1,00262,India
161709,2023-09-26,209,pepsi,75,100,25,1,00082,India
161709,2023-09-26,211,red bull,90,125,35,1,00082,India
161709,2023-09-26,205,classic yogurt,45,60,15,1,00082,India
161709,2023-09-26,201,paneer,210,340,130,1,00082,India
161709,2023-09-26,213,bisleri,6,15,9,1,00082,India
198242,2023-09-27,207,coca cola,75,100,25,1,00438,India
198242,2023-09-27,209,pepsi,75,100,25,1,00438,India
717158,2023-09-27,205,classic yogurt,45,60,15,1,00123,India
717158,2023-09-27,201,paneer,210,340,130,1,00123,India
556992,2023-09-27,203,mango yogurt,50,60,10,1,00358,India
556992,2023-09-27,205,classic yogurt,45,60,15,1,00358,India
556992,2023-09-27,211,red bull,90,125,35,1,00358,India
128302,2023-09-27,203,mango yogurt,50,60,10,1,00461,India
128302,2023-09-27,208,sprite,75,100,25,1,00461,India
128302,2023-09-27,204,strawberry yogurt,50,60,10,1,00461,India
128302,2023-09-27,209,pepsi,75,100,25,1,00461,India
128302,2023-09-27,211,red bull,90,125,35,1,00461,India
224190,2023-09-27,213,bisleri,6,15,9,1,00293,India
224190,2023-09-27,212,amul cheese,250,315,65,1,00293,India
224190,2023-09-27,210,mountain dew,75,100,25,1,00293,India
162808,2023-09-27,203,mango yogurt,50,60,10,1,00198,India
162808,2023-09-27,212,amul cheese,250,315,65,1,00198,India
162808,2023-09-27,201,paneer,210,340,130,1,00198,India
162808,2023-09-27,211,red bull,90,125,35,1,00198,India
611796,2023-09-27,206,yakult,360,400,40,1,00040,India
611796,2023-09-27,210,mountain dew,75,100,25,1,00040,India
362075,2023-09-27,212,amul cheese,250,315,65,1,00048,India
362075,2023-09-27,203,mango yogurt,50,60,10,1,00048,India
362075,2023-09-27,204,strawberry yogurt,50,60,10,1,00048,India
675146,2023-09-27,206,yakult,360,400,40,1,00349,India
675146,2023-09-27,212,amul cheese,250,315,65,1,00349,India
806810,2023-09-27,209,pepsi,75,100,25,1,00242,India
806810,2023-09-27,208,sprite,75,100,25,1,00242,India
848473,2023-09-27,207,coca cola,75,100,25,1,00145,India
848473,2023-09-27,205,classic yogurt,45,60,15,1,00145,India
640900,2023-09-27,212,amul cheese,250,315,65,1,00205,India
640900,2023-09-27,206,yakult,360,400,40,1,00205,India
640900,2023-09-27,204,strawberry yogurt,50,60,10,1,00205,India
945578,2023-09-27,201,paneer,210,340,130,1,00115,India
463353,2023-09-27,203,mango yogurt,50,60,10,1,00174,India
463353,2023-09-27,213,bisleri,6,15,9,1,00174,India
558921,2023-09-27,212,amul cheese,250,315,65,1,00317,India
558921,2023-09-27,202,milk,12,27,15,1,00317,India
558921,2023-09-27,207,coca cola,75,100,25,1,00317,India
472974,2023-09-27,201,paneer,210,340,130,1,00489,India
472974,2023-09-27,209,pepsi,75,100,25,1,00489,India
472974,2023-09-27,205,classic yogurt,45,60,15,1,00489,India
990192,2023-09-27,209,pepsi,75,100,25,1,00247,India
990192,2023-09-27,203,mango yogurt,50,60,10,1,00247,India
288690,2023-09-27,208,sprite,75,100,25,1,00006,India
288690,2023-09-27,209,pepsi,75,100,25,1,00006,India
288690,2023-09-27,205,classic yogurt,45,60,15,1,00006,India
288690,2023-09-27,206,yakult,360,400,40,1,00006,India
261340,2023-09-27,212,amul cheese,250,315,65,1,00389,India
261340,2023-09-27,204,strawberry yogurt,50,60,10,1,00389,India
261340,2023-09-27,203,mango yogurt,50,60,10,1,00389,India
261340,2023-09-27,202,milk,12,27,15,1,00389,India
714059,2023-09-27,210,mountain dew,75,100,25,1,00341,India
916768,2023-09-27,203,mango yogurt,50,60,10,1,00061,India
916768,2023-09-27,211,red bull,90,125,35,1,00061,India
916768,2023-09-27,208,sprite,75,100,25,1,00061,India
916768,2023-09-27,213,bisleri,6,15,9,1,00061,India
559031,2023-09-27,212,amul cheese,250,315,65,1,00385,India
559031,2023-09-27,206,yakult,360,400,40,1,00385,India
552277,2023-09-27,207,coca cola,75,100,25,1,00360,India
552277,2023-09-27,204,strawberry yogurt,50,60,10,1,00360,India
633647,2023-09-27,209,pepsi,75,100,25,1,00219,India
633647,2023-09-27,202,milk,12,27,15,1,00219,India
465747,2023-09-27,205,classic yogurt,45,60,15,1,00459,India
465747,2023-09-27,202,milk,12,27,15,1,00459,India
725374,2023-09-27,207,coca cola,75,100,25,1,00214,India
725374,2023-09-27,201,paneer,210,340,130,1,00214,India
725374,2023-09-27,203,mango yogurt,50,60,10,1,00214,India
725374,2023-09-27,210,mountain dew,75,100,25,1,00214,India
725374,2023-09-27,213,bisleri,6,15,9,1,00214,India
275913,2023-09-27,206,yakult,360,400,40,1,00426,India
275913,2023-09-27,201,paneer,210,340,130,1,00426,India
336215,2023-09-27,204,strawberry yogurt,50,60,10,1,00161,India
336215,2023-09-27,209,pepsi,75,100,25,1,00161,India
732328,2023-09-27,212,amul cheese,250,315,65,1,00369,India
732328,2023-09-27,210,mountain dew,75,100,25,1,00369,India
732328,2023-09-27,213,bisleri,6,15,9,1,00369,India
732328,2023-09-27,202,milk,12,27,15,1,00369,India
732328,2023-09-27,206,yakult,360,400,40,1,00369,India
514733,2023-09-27,213,bisleri,6,15,9,1,00081,India
514733,2023-09-27,211,red bull,90,125,35,1,00081,India
514733,2023-09-27,212,amul cheese,250,315,65,1,00081,India
759871,2023-09-27,210,mountain dew,75,100,25,1,00168,India
652109,2023-09-27,207,coca cola,75,100,25,1,00071,India
652109,2023-09-27,208,sprite,75,100,25,1,00071,India
652109,2023-09-27,202,milk,12,27,15,1,00071,India
400202,2023-09-27,211,red bull,90,125,35,1,00359,India
408314,2023-09-27,212,amul cheese,250,315,65,1,00093,India
408314,2023-09-27,213,bisleri,6,15,9,1,00093,India
408314,2023-09-27,210,mountain dew,75,100,25,1,00093,India
408314,2023-09-27,209,pepsi,75,100,25,1,00093,India
572620,2023-09-27,201,paneer,210,340,130,1,00315,India
862611,2023-09-27,203,mango yogurt,50,60,10,1,00067,India
862611,2023-09-27,201,paneer,210,340,130,1,00067,India
862611,2023-09-27,208,sprite,75,100,25,1,00067,India
862611,2023-09-27,202,milk,12,27,15,1,00067,India
862611,2023-09-27,204,strawberry yogurt,50,60,10,1,00067,India
996545,2023-09-27,203,mango yogurt,50,60,10,1,00323,India
996545,2023-09-27,201,paneer,210,340,130,1,00323,India
996545,2023-09-27,210,mountain dew,75,100,25,1,00323,India
528932,2023-09-27,210,mountain dew,75,100,25,1,00045,India
528932,2023-09-27,209,pepsi,75,100,25,1,00045,India
528932,2023-09-27,205,classic yogurt,45,60,15,1,00045,India
528932,2023-09-27,212,amul cheese,250,315,65,1,00045,India
528932,2023-09-27,207,coca cola,75,100,25,1,00045,India
870435,2023-09-27,212,amul cheese,250,315,65,1,00073,India
510323,2023-09-27,211,red bull,90,125,35,1,00299,India
510323,2023-09-27,203,mango yogurt,50,60,10,1,00299,India
510323,2023-09-27,213,bisleri,6,15,9,1,00299,India
917657,2023-09-27,201,paneer,210,340,130,1,00417,India
917657,2023-09-27,207,coca cola,75,100,25,1,00417,India
494129,2023-09-27,206,yakult,360,400,40,1,00067,India
918089,2023-09-27,204,strawberry yogurt,50,60,10,1,00419,India
918089,2023-09-27,213,bisleri,6,15,9,1,00419,India
918089,2023-09-27,209,pepsi,75,100,25,1,00419,India
918089,2023-09-27,207,coca cola,75,100,25,1,00419,India
112964,2023-09-27,213,bisleri,6,15,9,1,00375,India
426919,2023-09-27,201,paneer,210,340,130,1,00444,India
426919,2023-09-27,208,sprite,75,100,25,1,00444,India
426919,2023-09-27,211,red bull,90,125,35,1,00444,India
426919,2023-09-27,206,yakult,360,400,40,1,00444,India
426919,2023-09-27,203,mango yogurt,50,60,10,1,00444,India
965996,2023-09-27,211,red bull,90,125,35,1,00336,India
965996,2023-09-27,212,amul cheese,250,315,65,1,00336,India
965996,2023-09-27,201,paneer,210,340,130,1,00336,India
851118,2023-09-27,207,coca cola,75,100,25,1,00415,India
851118,2023-09-27,206,yakult,360,400,40,1,00415,India
851118,2023-09-27,211,red bull,90,125,35,1,00415,India
851118,2023-09-27,208,sprite,75,100,25,1,00415,India
660510,2023-09-27,208,sprite,75,100,25,1,00415,India
660510,2023-09-27,202,milk,12,27,15,1,00415,India
660510,2023-09-27,213,bisleri,6,15,9,1,00415,India
329274,2023-09-27,207,coca cola,75,100,25,1,00273,India
329274,2023-09-27,209,pepsi,75,100,25,1,00273,India
329274,2023-09-27,205,classic yogurt,45,60,15,1,00273,India
329274,2023-09-27,203,mango yogurt,50,60,10,1,00273,India
171678,2023-09-27,203,mango yogurt,50,60,10,1,00289,India
171678,2023-09-27,204,strawberry yogurt,50,60,10,1,00289,India
171678,2023-09-27,208,sprite,75,100,25,1,00289,India
171678,2023-09-27,207,coca cola,75,100,25,1,00289,India
171678,2023-09-27,213,bisleri,6,15,9,1,00289,India
888843,2023-09-27,207,coca cola,75,100,25,1,00068,India
888843,2023-09-27,213,bisleri,6,15,9,1,00068,India
888843,2023-09-27,206,yakult,360,400,40,1,00068,India
572297,2023-09-27,211,red bull,90,125,35,1,00180,India
174089,2023-09-27,206,yakult,360,400,40,1,00395,India
174089,2023-09-27,202,milk,12,27,15,1,00395,India
174089,2023-09-27,201,paneer,210,340,130,1,00395,India
413291,2023-09-27,210,mountain dew,75,100,25,1,00328,India
413291,2023-09-27,201,paneer,210,340,130,1,00328,India
413291,2023-09-27,212,amul cheese,250,315,65,1,00328,India
413291,2023-09-27,209,pepsi,75,100,25,1,00328,India
205723,2023-09-27,208,sprite,75,100,25,1,00453,India
205723,2023-09-27,211,red bull,90,125,35,1,00453,India
880145,2023-09-27,202,milk,12,27,15,1,00245,India
880145,2023-09-27,203,mango yogurt,50,60,10,1,00245,India
880145,2023-09-27,204,strawberry yogurt,50,60,10,1,00245,India
880145,2023-09-27,212,amul cheese,250,315,65,1,00245,India
880145,2023-09-27,208,sprite,75,100,25,1,00245,India
342660,2023-09-27,204,strawberry yogurt,50,60,10,1,00252,India
342660,2023-09-27,206,yakult,360,400,40,1,00252,India
342660,2023-09-27,212,amul cheese,250,315,65,1,00252,India
483832,2023-09-27,210,mountain dew,75,100,25,1,00018,India
483832,2023-09-27,209,pepsi,75,100,25,1,00018,India
483832,2023-09-27,203,mango yogurt,50,60,10,1,00018,India
483832,2023-09-27,213,bisleri,6,15,9,1,00018,India
307931,2023-09-27,209,pepsi,75,100,25,1,00039,India
445432,2023-09-28,202,milk,12,27,15,1,00500,India
848296,2023-09-28,201,paneer,210,340,130,1,00360,India
848296,2023-09-28,210,mountain dew,75,100,25,1,00360,India
848296,2023-09-28,212,amul cheese,250,315,65,1,00360,India
848296,2023-09-28,202,milk,12,27,15,1,00360,India
294470,2023-09-28,201,paneer,210,340,130,1,00412,India
294470,2023-09-28,207,coca cola,75,100,25,1,00412,India
294470,2023-09-28,205,classic yogurt,45,60,15,1,00412,India
444644,2023-09-28,211,red bull,90,125,35,1,00179,India
444644,2023-09-28,206,yakult,360,400,40,1,00179,India
444644,2023-09-28,209,pepsi,75,100,25,1,00179,India
444644,2023-09-28,208,sprite,75,100,25,1,00179,India
444644,2023-09-28,212,amul cheese,250,315,65,1,00179,India
100286,2023-09-28,206,yakult,360,400,40,1,00292,India
100286,2023-09-28,209,pepsi,75,100,25,1,00292,India
734932,2023-09-28,212,amul cheese,250,315,65,1,00373,India
823791,2023-09-28,210,mountain dew,75,100,25,1,00302,India
102922,2023-09-28,213,bisleri,6,15,9,1,00233,India
102922,2023-09-28,203,mango yogurt,50,60,10,1,00233,India
645643,2023-09-28,209,pepsi,75,100,25,1,00229,India
645643,2023-09-28,205,classic yogurt,45,60,15,1,00229,India
645643,2023-09-28,207,coca cola,75,100,25,1,00229,India
645643,2023-09-28,213,bisleri,6,15,9,1,00229,India
705226,2023-09-28,209,pepsi,75,100,25,1,00105,India
705226,2023-09-28,212,amul cheese,250,315,65,1,00105,India
705226,2023-09-28,204,strawberry yogurt,50,60,10,1,00105,India
845492,2023-09-28,201,paneer,210,340,130,1,00177,India
845492,2023-09-28,205,classic yogurt,45,60,15,1,00177,India
845492,2023-09-28,209,pepsi,75,100,25,1,00177,India
129699,2023-09-28,204,strawberry yogurt,50,60,10,1,00191,India
542934,2023-09-28,206,yakult,360,400,40,1,00283,India
542934,2023-09-28,208,sprite,75,100,25,1,00283,India
542934,2023-09-28,213,bisleri,6,15,9,1,00283,India
542934,2023-09-28,202,milk,12,27,15,1,00283,India
443005,2023-09-28,207,coca cola,75,100,25,1,00419,India
443005,2023-09-28,203,mango yogurt,50,60,10,1,00419,India
443005,2023-09-28,212,amul cheese,250,315,65,1,00419,India
914435,2023-09-28,210,mountain dew,75,100,25,1,00375,India
914435,2023-09-28,201,paneer,210,340,130,1,00375,India
857166,2023-09-28,206,yakult,360,400,40,1,00018,India
834970,2023-09-28,206,yakult,360,400,40,1,00323,India
834970,2023-09-28,203,mango yogurt,50,60,10,1,00323,India
834970,2023-09-28,202,milk,12,27,15,1,00323,India
246629,2023-09-28,206,yakult,360,400,40,1,00301,India
246629,2023-09-28,208,sprite,75,100,25,1,00301,India
246629,2023-09-28,204,strawberry yogurt,50,60,10,1,00301,India
702897,2023-09-28,208,sprite,75,100,25,1,00396,India
702897,2023-09-28,211,red bull,90,125,35,1,00396,India
702897,2023-09-28,204,strawberry yogurt,50,60,10,1,00396,India
347112,2023-09-28,213,bisleri,6,15,9,1,00387,India
347112,2023-09-28,211,red bull,90,125,35,1,00387,India
335525,2023-09-28,202,milk,12,27,15,1,00359,India
335525,2023-09-28,203,mango yogurt,50,60,10,1,00359,India
682446,2023-09-28,203,mango yogurt,50,60,10,1,00480,India
682446,2023-09-28,206,yakult,360,400,40,1,00480,India
682446,2023-09-28,201,paneer,210,340,130,1,00480,India
682446,2023-09-28,213,bisleri,6,15,9,1,00480,India
677412,2023-09-28,205,classic yogurt,45,60,15,1,00332,India
677412,2023-09-28,212,amul cheese,250,315,65,1,00332,India
677412,2023-09-28,213,bisleri,6,15,9,1,00332,India
677412,2023-09-28,210,mountain dew,75,100,25,1,00332,India
677412,2023-09-28,203,mango yogurt,50,60,10,1,00332,India
369482,2023-09-28,213,bisleri,6,15,9,1,00131,India
178758,2023-09-28,211,red bull,90,125,35,1,00191,India
178758,2023-09-28,202,milk,12,27,15,1,00191,India
178758,2023-09-28,201,paneer,210,340,130,1,00191,India
561419,2023-09-28,204,strawberry yogurt,50,60,10,1,00055,India
561419,2023-09-28,205,classic yogurt,45,60,15,1,00055,India
561419,2023-09-28,213,bisleri,6,15,9,1,00055,India
561419,2023-09-28,211,red bull,90,125,35,1,00055,India
636124,2023-09-28,212,amul cheese,250,315,65,1,00390,India
636124,2023-09-28,203,mango yogurt,50,60,10,1,00390,India
636124,2023-09-28,204,strawberry yogurt,50,60,10,1,00390,India
572739,2023-09-28,208,sprite,75,100,25,1,00155,India
744303,2023-09-28,206,yakult,360,400,40,1,00085,India
720149,2023-09-28,211,red bull,90,125,35,1,00231,India
720149,2023-09-28,212,amul cheese,250,315,65,1,00231,India
954461,2023-09-28,202,milk,12,27,15,1,00191,India
945072,2023-09-28,213,bisleri,6,15,9,1,00187,India
945072,2023-09-28,212,amul cheese,250,315,65,1,00187,India
945072,2023-09-28,209,pepsi,75,100,25,1,00187,India
875379,2023-09-28,208,sprite,75,100,25,1,00370,India
875379,2023-09-28,204,strawberry yogurt,50,60,10,1,00370,India
875379,2023-09-28,207,coca cola,75,100,25,1,00370,India
875379,2023-09-28,213,bisleri,6,15,9,1,00370,India
794240,2023-09-28,206,yakult,360,400,40,1,00095,India
985598,2023-09-28,213,bisleri,6,15,9,1,00049,India
243480,2023-09-28,208,sprite,75,100,25,1,00317,India
243480,2023-09-28,211,red bull,90,125,35,1,00317,India
157135,2023-09-28,205,classic yogurt,45,60,15,1,00043,India
157135,2023-09-28,207,coca cola,75,100,25,1,00043,India
788671,2023-09-28,201,paneer,210,340,130,1,00235,India
788671,2023-09-28,202,milk,12,27,15,1,00235,India
788671,2023-09-28,208,sprite,75,100,25,1,00235,India
788671,2023-09-28,213,bisleri,6,15,9,1,00235,India
104605,2023-09-28,205,classic yogurt,45,60,15,1,00207,India
104605,2023-09-28,204,strawberry yogurt,50,60,10,1,00207,India
824223,2023-09-28,206,yakult,360,400,40,1,00267,India
831356,2023-09-28,210,mountain dew,75,100,25,1,00498,India
763398,2023-09-28,202,milk,12,27,15,1,00422,India
763398,2023-09-28,203,mango yogurt,50,60,10,1,00422,India
544280,2023-09-28,203,mango yogurt,50,60,10,1,00228,India
544280,2023-09-28,206,yakult,360,400,40,1,00228,India
544280,2023-09-28,202,milk,12,27,15,1,00228,India
692536,2023-09-28,201,paneer,210,340,130,1,00099,India
354767,2023-09-28,212,amul cheese,250,315,65,1,00265,India
354767,2023-09-28,206,yakult,360,400,40,1,00265,India
354767,2023-09-28,204,strawberry yogurt,50,60,10,1,00265,India
354767,2023-09-28,208,sprite,75,100,25,1,00265,India
750438,2023-09-28,205,classic yogurt,45,60,15,1,00298,India
766473,2023-09-28,208,sprite,75,100,25,1,00117,India
766473,2023-09-28,201,paneer,210,340,130,1,00117,India
446915,2023-09-28,212,amul cheese,250,315,65,1,00186,India
446915,2023-09-28,208,sprite,75,100,25,1,00186,India
279356,2023-09-28,209,pepsi,75,100,25,1,00035,India
279356,2023-09-28,203,mango yogurt,50,60,10,1,00035,India
279356,2023-09-28,211,red bull,90,125,35,1,00035,India
117468,2023-09-28,211,red bull,90,125,35,1,00453,India
117468,2023-09-28,208,sprite,75,100,25,1,00453,India
600176,2023-09-28,207,coca cola,75,100,25,1,00398,India
928737,2023-09-28,202,milk,12,27,15,1,00303,India
928737,2023-09-28,213,bisleri,6,15,9,1,00303,India
819302,2023-09-29,210,mountain dew,75,100,25,1,00287,India
819302,2023-09-29,206,yakult,360,400,40,1,00287,India
819302,2023-09-29,209,pepsi,75,100,25,1,00287,India
819302,2023-09-29,213,bisleri,6,15,9,1,00287,India
402070,2023-09-29,209,pepsi,75,100,25,1,00493,India
402070,2023-09-29,204,strawberry yogurt,50,60,10,1,00493,India
402070,2023-09-29,201,paneer,210,340,130,1,00493,India
402070,2023-09-29,208,sprite,75,100,25,1,00493,India
402070,2023-09-29,205,classic yogurt,45,60,15,1,00493,India
957127,2023-09-29,202,milk,12,27,15,1,00352,India
957127,2023-09-29,205,classic yogurt,45,60,15,1,00352,India
957127,2023-09-29,211,red bull,90,125,35,1,00352,India
957127,2023-09-29,207,coca cola,75,100,25,1,00352,India
870228,2023-09-29,203,mango yogurt,50,60,10,1,00209,India
870228,2023-09-29,204,strawberry yogurt,50,60,10,1,00209,India
870228,2023-09-29,211,red bull,90,125,35,1,00209,India
870228,2023-09-29,208,sprite,75,100,25,1,00209,India
774365,2023-09-29,212,amul cheese,250,315,65,1,00408,India
774365,2023-09-29,213,bisleri,6,15,9,1,00408,India
774365,2023-09-29,201,paneer,210,340,130,1,00408,India
774365,2023-09-29,210,mountain dew,75,100,25,1,00408,India
883095,2023-09-29,202,milk,12,27,15,1,00482,India
883095,2023-09-29,208,sprite,75,100,25,1,00482,India
533312,2023-09-29,211,red bull,90,125,35,1,00474,India
533312,2023-09-29,207,coca cola,75,100,25,1,00474,India
229242,2023-09-29,202,milk,12,27,15,1,00221,India
782720,2023-09-29,205,classic yogurt,45,60,15,1,00461,India
392670,2023-09-29,201,paneer,210,340,130,1,00216,India
392670,2023-09-29,206,yakult,360,400,40,1,00216,India
968710,2023-09-29,207,coca cola,75,100,25,1,00213,India
203294,2023-09-29,212,amul cheese,250,315,65,1,00359,India
203294,2023-09-29,208,sprite,75,100,25,1,00359,India
203294,2023-09-29,207,coca cola,75,100,25,1,00359,India
293707,2023-09-29,210,mountain dew,75,100,25,1,00074,India
293707,2023-09-29,205,classic yogurt,45,60,15,1,00074,India
293707,2023-09-29,207,coca cola,75,100,25,1,00074,India
770848,2023-09-29,208,sprite,75,100,25,1,00375,India
770848,2023-09-29,206,yakult,360,400,40,1,00375,India
690037,2023-09-29,209,pepsi,75,100,25,1,00500,India
690037,2023-09-29,202,milk,12,27,15,1,00500,India
690037,2023-09-29,207,coca cola,75,100,25,1,00500,India
996905,2023-09-29,201,paneer,210,340,130,1,00403,India
996905,2023-09-29,213,bisleri,6,15,9,1,00403,India
996905,2023-09-29,207,coca cola,75,100,25,1,00403,India
996905,2023-09-29,208,sprite,75,100,25,1,00403,India
264550,2023-09-29,210,mountain dew,75,100,25,1,00025,India
264550,2023-09-29,207,coca cola,75,100,25,1,00025,India
763062,2023-09-29,206,yakult,360,400,40,1,00291,India
763062,2023-09-29,202,milk,12,27,15,1,00291,India
215318,2023-09-29,204,strawberry yogurt,50,60,10,1,00080,India
215318,2023-09-29,206,yakult,360,400,40,1,00080,India
215318,2023-09-29,209,pepsi,75,100,25,1,00080,India
215318,2023-09-29,207,coca cola,75,100,25,1,00080,India
948691,2023-09-29,205,classic yogurt,45,60,15,1,00391,India
948691,2023-09-29,204,strawberry yogurt,50,60,10,1,00391,India
339904,2023-09-29,201,paneer,210,340,130,1,00375,India
257413,2023-09-29,206,yakult,360,400,40,1,00360,India
257413,2023-09-29,208,sprite,75,100,25,1,00360,India
571604,2023-09-29,204,strawberry yogurt,50,60,10,1,00220,India
571604,2023-09-29,209,pepsi,75,100,25,1,00220,India
571604,2023-09-29,210,mountain dew,75,100,25,1,00220,India
571604,2023-09-29,202,milk,12,27,15,1,00220,India
571604,2023-09-29,212,amul cheese,250,315,65,1,00220,India
568517,2023-09-29,212,amul cheese,250,315,65,1,00364,India
509272,2023-09-29,205,classic yogurt,45,60,15,1,00029,India
509272,2023-09-29,209,pepsi,75,100,25,1,00029,India
509272,2023-09-29,201,paneer,210,340,130,1,00029,India
658281,2023-09-29,205,classic yogurt,45,60,15,1,00339,India
658281,2023-09-29,201,paneer,210,340,130,1,00339,India
658281,2023-09-29,210,mountain dew,75,100,25,1,00339,India
460555,2023-09-29,209,pepsi,75,100,25,1,00162,India
460555,2023-09-29,202,milk,12,27,15,1,00162,India
460555,2023-09-29,203,mango yogurt,50,60,10,1,00162,India
634419,2023-09-29,208,sprite,75,100,25,1,00222,India
634419,2023-09-29,212,amul cheese,250,315,65,1,00222,India
634419,2023-09-29,207,coca cola,75,100,25,1,00222,India
634419,2023-09-29,201,paneer,210,340,130,1,00222,India
634419,2023-09-29,206,yakult,360,400,40,1,00222,India
642869,2023-09-29,209,pepsi,75,100,25,1,00355,India
642869,2023-09-29,211,red bull,90,125,35,1,00355,India
642869,2023-09-29,206,yakult,360,400,40,1,00355,India
642869,2023-09-29,213,bisleri,6,15,9,1,00355,India
896377,2023-09-29,212,amul cheese,250,315,65,1,00132,India
272447,2023-09-29,205,classic yogurt,45,60,15,1,00358,India
852470,2023-09-29,204,strawberry yogurt,50,60,10,1,00060,India
852470,2023-09-29,209,pepsi,75,100,25,1,00060,India
852470,2023-09-29,202,milk,12,27,15,1,00060,India
852470,2023-09-29,213,bisleri,6,15,9,1,00060,India
852470,2023-09-29,210,mountain dew,75,100,25,1,00060,India
908186,2023-09-29,203,mango yogurt,50,60,10,1,00453,India
908186,2023-09-29,201,paneer,210,340,130,1,00453,India
908186,2023-09-29,206,yakult,360,400,40,1,00453,India
492194,2023-09-29,210,mountain dew,75,100,25,1,00011,India
492194,2023-09-29,213,bisleri,6,15,9,1,00011,India
492194,2023-09-29,206,yakult,360,400,40,1,00011,India
492194,2023-09-29,208,sprite,75,100,25,1,00011,India
686442,2023-09-29,210,mountain dew,75,100,25,1,00240,India
686442,2023-09-29,209,pepsi,75,100,25,1,00240,India
686442,2023-09-29,207,coca cola,75,100,25,1,00240,India
738883,2023-09-29,202,milk,12,27,15,1,00488,India
738883,2023-09-29,210,mountain dew,75,100,25,1,00488,India
738883,2023-09-29,211,red bull,90,125,35,1,00488,India
738883,2023-09-29,208,sprite,75,100,25,1,00488,India
162168,2023-09-29,206,yakult,360,400,40,1,00283,India
162168,2023-09-29,201,paneer,210,340,130,1,00283,India
162168,2023-09-29,212,amul cheese,250,315,65,1,00283,India
162168,2023-09-29,203,mango yogurt,50,60,10,1,00283,India
480314,2023-09-29,201,paneer,210,340,130,1,00197,India
480314,2023-09-29,213,bisleri,6,15,9,1,00197,India
480314,2023-09-29,204,strawberry yogurt,50,60,10,1,00197,India
316760,2023-09-29,210,mountain dew,75,100,25,1,00268,India
316760,2023-09-29,203,mango yogurt,50,60,10,1,00268,India
316760,2023-09-29,208,sprite,75,100,25,1,00268,India
893933,2023-09-29,213,bisleri,6,15,9,1,00148,India
893933,2023-09-29,210,mountain dew,75,100,25,1,00148,India
893933,2023-09-29,206,yakult,360,400,40,1,00148,India
405118,2023-09-29,213,bisleri,6,15,9,1,00372,India
405118,2023-09-29,211,red bull,90,125,35,1,00372,India
405118,2023-09-29,205,classic yogurt,45,60,15,1,00372,India
135803,2023-09-29,210,mountain dew,75,100,25,1,00480,India
135803,2023-09-29,203,mango yogurt,50,60,10,1,00480,India
135803,2023-09-29,212,amul cheese,250,315,65,1,00480,India
524320,2023-09-29,210,mountain dew,75,100,25,1,00159,India
524320,2023-09-29,205,classic yogurt,45,60,15,1,00159,India
524320,2023-09-29,208,sprite,75,100,25,1,00159,India
524320,2023-09-29,207,coca cola,75,100,25,1,00159,India
524320,2023-09-29,201,paneer,210,340,130,1,00159,India
502916,2023-09-29,210,mountain dew,75,100,25,1,00161,India
502916,2023-09-29,206,yakult,360,400,40,1,00161,India
502916,2023-09-29,212,amul cheese,250,315,65,1,00161,India
746058,2023-09-29,208,sprite,75,100,25,1,00032,India
362437,2023-09-29,202,milk,12,27,15,1,00335,India
362437,2023-09-29,212,amul cheese,250,315,65,1,00335,India
865411,2023-09-29,210,mountain dew,75,100,25,1,00154,India
865411,2023-09-29,201,paneer,210,340,130,1,00154,India
865411,2023-09-29,208,sprite,75,100,25,1,00154,India
865411,2023-09-29,203,mango yogurt,50,60,10,1,00154,India
762151,2023-09-29,208,sprite,75,100,25,1,00371,India
762151,2023-09-29,206,yakult,360,400,40,1,00371,India
762151,2023-09-29,211,red bull,90,125,35,1,00371,India
762151,2023-09-29,202,milk,12,27,15,1,00371,India
762151,2023-09-29,201,paneer,210,340,130,1,00371,India
981727,2023-09-29,202,milk,12,27,15,1,00123,India
981727,2023-09-29,203,mango yogurt,50,60,10,1,00123,India
981727,2023-09-29,205,classic yogurt,45,60,15,1,00123,India
981727,2023-09-29,210,mountain dew,75,100,25,1,00123,India
981727,2023-09-29,211,red bull,90,125,35,1,00123,India
941396,2023-09-29,207,coca cola,75,100,25,1,00193,India
941396,2023-09-29,213,bisleri,6,15,9,1,00193,India
941396,2023-09-29,203,mango yogurt,50,60,10,1,00193,India
589413,2023-09-29,211,red bull,90,125,35,1,00140,India
849586,2023-09-29,204,strawberry yogurt,50,60,10,1,00092,India
849586,2023-09-29,201,paneer,210,340,130,1,00092,India
849586,2023-09-29,209,pepsi,75,100,25,1,00092,India
489869,2023-09-29,203,mango yogurt,50,60,10,1,00345,India
489869,2023-09-29,202,milk,12,27,15,1,00345,India
905670,2023-09-29,212,amul cheese,250,315,65,1,00211,India
492173,2023-09-29,211,red bull,90,125,35,1,00246,India
492173,2023-09-29,202,milk,12,27,15,1,00246,India
492173,2023-09-29,207,coca cola,75,100,25,1,00246,India
498745,2023-09-29,201,paneer,210,340,130,1,00318,India
498745,2023-09-29,208,sprite,75,100,25,1,00318,India
498745,2023-09-29,206,yakult,360,400,40,1,00318,India
482102,2023-09-29,213,bisleri,6,15,9,1,00253,India
522709,2023-09-29,203,mango yogurt,50,60,10,1,00475,India
522709,2023-09-29,208,sprite,75,100,25,1,00475,India
522709,2023-09-29,205,classic yogurt,45,60,15,1,00475,India
276758,2023-09-29,208,sprite,75,100,25,1,00116,India
322967,2023-09-29,206,yakult,360,400,40,1,00103,India
210186,2023-09-29,208,sprite,75,100,25,1,00420,India
210186,2023-09-29,212,amul cheese,250,315,65,1,00420,India
128149,2023-09-29,213,bisleri,6,15,9,1,00188,India
128149,2023-09-29,208,sprite,75,100,25,1,00188,India
537337,2023-09-29,209,pepsi,75,100,25,1,00235,India
537337,2023-09-29,207,coca cola,75,100,25,1,00235,India
537337,2023-09-29,206,yakult,360,400,40,1,00235,India
335222,2023-09-29,213,bisleri,6,15,9,1,00421,India
916568,2023-09-29,212,amul cheese,250,315,65,1,00401,India
916568,2023-09-29,213,bisleri,6,15,9,1,00401,India
916568,2023-09-29,209,pepsi,75,100,25,1,00401,India
916568,2023-09-29,206,yakult,360,400,40,1,00401,India
408240,2023-09-29,206,yakult,360,400,40,1,00070,India
408240,2023-09-29,203,mango yogurt,50,60,10,1,00070,India
408240,2023-09-29,201,paneer,210,340,130,1,00070,India
408240,2023-09-29,207,coca cola,75,100,25,1,00070,India
737137,2023-09-29,202,milk,12,27,15,1,00216,India
737137,2023-09-29,208,sprite,75,100,25,1,00216,India
737137,2023-09-29,209,pepsi,75,100,25,1,00216,India
635565,2023-09-29,206,yakult,360,400,40,1,00051,India
635565,2023-09-29,201,paneer,210,340,130,1,00051,India
635565,2023-09-29,211,red bull,90,125,35,1,00051,India
635565,2023-09-29,208,sprite,75,100,25,1,00051,India
254705,2023-09-29,207,coca cola,75,100,25,1,00346,India
254705,2023-09-29,201,paneer,210,340,130,1,00346,India
254705,2023-09-29,212,amul cheese,250,315,65,1,00346,India
388740,2023-09-29,203,mango yogurt,50,60,10,1,00310,India
200127,2023-09-29,203,mango yogurt,50,60,10,1,00153,India
200127,2023-09-29,208,sprite,75,100,25,1,00153,India
200127,2023-09-29,201,paneer,210,340,130,1,00153,India
200127,2023-09-29,202,milk,12,27,15,1,00153,India
531084,2023-09-29,203,mango yogurt,50,60,10,1,00303,India
531084,2023-09-29,213,bisleri,6,15,9,1,00303,India
531084,2023-09-29,207,coca cola,75,100,25,1,00303,India
831928,2023-09-29,210,mountain dew,75,100,25,1,00112,India
831928,2023-09-29,204,strawberry yogurt,50,60,10,1,00112,India
831928,2023-09-29,203,mango yogurt,50,60,10,1,00112,India
362802,2023-09-29,210,mountain dew,75,100,25,1,00241,India
362802,2023-09-29,208,sprite,75,100,25,1,00241,India
362802,2023-09-29,202,milk,12,27,15,1,00241,India
931574,2023-09-29,210,mountain dew,75,100,25,1,00358,India
931574,2023-09-29,203,mango yogurt,50,60,10,1,00358,India
631642,2023-09-29,201,paneer,210,340,130,1,00416,India
631642,2023-09-29,206,yakult,360,400,40,1,00416,India
631642,2023-09-29,213,bisleri,6,15,9,1,00416,India
631642,2023-09-29,208,sprite,75,100,25,1,00416,India
631642,2023-09-29,204,strawberry yogurt,50,60,10,1,00416,India
430527,2023-09-29,212,amul cheese,250,315,65,1,00389,India
430527,2023-09-29,208,sprite,75,100,25,1,00389,India
784949,2023-09-29,207,coca cola,75,100,25,1,00452,India
784949,2023-09-29,210,mountain dew,75,100,25,1,00452,India
784949,2023-09-29,211,red bull,90,125,35,1,00452,India
786588,2023-09-29,204,strawberry yogurt,50,60,10,1,00344,India
786588,2023-09-29,207,coca cola,75,100,25,1,00344,India
862249,2023-09-29,203,mango yogurt,50,60,10,1,00013,India
862249,2023-09-29,213,bisleri,6,15,9,1,00013,India
862249,2023-09-29,206,yakult,360,400,40,1,00013,India
862249,2023-09-29,201,paneer,210,340,130,1,00013,India
862249,2023-09-29,208,sprite,75,100,25,1,00013,India
234652,2023-09-29,201,paneer,210,340,130,1,00301,India
234652,2023-09-29,202,milk,12,27,15,1,00301,India
234652,2023-09-29,209,pepsi,75,100,25,1,00301,India
234652,2023-09-29,207,coca cola,75,100,25,1,00301,India
841920,2023-09-29,205,classic yogurt,45,60,15,1,00252,India
841920,2023-09-29,210,mountain dew,75,100,25,1,00252,India
945309,2023-09-29,206,yakult,360,400,40,1,00496,India
945309,2023-09-29,211,red bull,90,125,35,1,00496,India
821824,2023-09-29,207,coca cola,75,100,25,1,00240,India
821824,2023-09-29,202,milk,12,27,15,1,00240,India
681449,2023-09-29,209,pepsi,75,100,25,1,00143,India
510068,2023-09-29,211,red bull,90,125,35,1,00251,India
743160,2023-09-29,211,red bull,90,125,35,1,00333,India
743160,2023-09-29,209,pepsi,75,100,25,1,00333,India
582552,2023-09-29,202,milk,12,27,15,1,00385,India
955620,2023-09-29,211,red bull,90,125,35,1,00105,India
955620,2023-09-29,213,bisleri,6,15,9,1,00105,India
636449,2023-09-29,212,amul cheese,250,315,65,1,00163,India
636449,2023-09-29,209,pepsi,75,100,25,1,00163,India
301673,2023-09-29,210,mountain dew,75,100,25,1,00421,India
327022,2023-09-29,202,milk,12,27,15,1,00448,India
327022,2023-09-29,207,coca cola,75,100,25,1,00448,India
327022,2023-09-29,205,classic yogurt,45,60,15,1,00448,India
327022,2023-09-29,213,bisleri,6,15,9,1,00448,India
327022,2023-09-29,209,pepsi,75,100,25,1,00448,India
454794,2023-09-29,201,paneer,210,340,130,1,00492,India
454794,2023-09-29,209,pepsi,75,100,25,1,00492,India
312436,2023-09-29,209,pepsi,75,100,25,1,00388,India
272368,2023-09-29,212,amul cheese,250,315,65,1,00369,India
272368,2023-09-29,210,mountain dew,75,100,25,1,00369,India
192005,2023-09-29,206,yakult,360,400,40,1,00075,India
992333,2023-09-29,205,classic yogurt,45,60,15,1,00181,India
646215,2023-09-29,207,coca cola,75,100,25,1,00183,India
768534,2023-09-30,206,yakult,360,400,40,1,00394,India
106411,2023-09-30,205,classic yogurt,45,60,15,1,00285,India
106411,2023-09-30,203,mango yogurt,50,60,10,1,00285,India
106411,2023-09-30,206,yakult,360,400,40,1,00285,India
106411,2023-09-30,202,milk,12,27,15,1,00285,India
106411,2023-09-30,211,red bull,90,125,35,1,00285,India
806008,2023-09-30,212,amul cheese,250,315,65,1,00399,India
806008,2023-09-30,202,milk,12,27,15,1,00399,India
102063,2023-09-30,207,coca cola,75,100,25,1,00070,India
102063,2023-09-30,203,mango yogurt,50,60,10,1,00070,India
102063,2023-09-30,213,bisleri,6,15,9,1,00070,India
571509,2023-09-30,207,coca cola,75,100,25,1,00206,India
945953,2023-09-30,203,mango yogurt,50,60,10,1,00053,India
945953,2023-09-30,202,milk,12,27,15,1,00053,India
945953,2023-09-30,205,classic yogurt,45,60,15,1,00053,India
945953,2023-09-30,212,amul cheese,250,315,65,1,00053,India
945953,2023-09-30,204,strawberry yogurt,50,60,10,1,00053,India
793610,2023-09-30,210,mountain dew,75,100,25,1,00250,India
793610,2023-09-30,202,milk,12,27,15,1,00250,India
793610,2023-09-30,207,coca cola,75,100,25,1,00250,India
793610,2023-09-30,208,sprite,75,100,25,1,00250,India
742115,2023-09-30,206,yakult,360,400,40,1,00026,India
742115,2023-09-30,212,amul cheese,250,315,65,1,00026,India
105188,2023-09-30,210,mountain dew,75,100,25,1,00438,India
105188,2023-09-30,207,coca cola,75,100,25,1,00438,India
105188,2023-09-30,211,red bull,90,125,35,1,00438,India
105188,2023-09-30,206,yakult,360,400,40,1,00438,India
808307,2023-09-30,207,coca cola,75,100,25,1,00041,India
808307,2023-09-30,203,mango yogurt,50,60,10,1,00041,India
808307,2023-09-30,205,classic yogurt,45,60,15,1,00041,India
808307,2023-09-30,210,mountain dew,75,100,25,1,00041,India
336551,2023-09-30,208,sprite,75,100,25,1,00480,India
336551,2023-09-30,205,classic yogurt,45,60,15,1,00480,India
336551,2023-09-30,203,mango yogurt,50,60,10,1,00480,India
336551,2023-09-30,211,red bull,90,125,35,1,00480,India
336551,2023-09-30,202,milk,12,27,15,1,00480,India
971429,2023-09-30,206,yakult,360,400,40,1,00046,India
971429,2023-09-30,202,milk,12,27,15,1,00046,India
454555,2023-09-30,212,amul cheese,250,315,65,1,00060,India
454555,2023-09-30,202,milk,12,27,15,1,00060,India
454555,2023-09-30,208,sprite,75,100,25,1,00060,India
454555,2023-09-30,205,classic yogurt,45,60,15,1,00060,India
287109,2023-09-30,205,classic yogurt,45,60,15,1,00364,India
287109,2023-09-30,210,mountain dew,75,100,25,1,00364,India
287109,2023-09-30,206,yakult,360,400,40,1,00364,India
164793,2023-09-30,209,pepsi,75,100,25,1,00409,India
650663,2023-09-30,202,milk,12,27,15,1,00012,India
650663,2023-09-30,201,paneer,210,340,130,1,00012,India
677053,2023-09-30,203,mango yogurt,50,60,10,1,00137,India
677053,2023-09-30,209,pepsi,75,100,25,1,00137,India
142265,2023-09-30,213,bisleri,6,15,9,1,00237,India
142265,2023-09-30,211,red bull,90,125,35,1,00237,India
726502,2023-09-30,206,yakult,360,400,40,1,00384,India
726502,2023-09-30,213,bisleri,6,15,9,1,00384,India
726502,2023-09-30,204,strawberry yogurt,50,60,10,1,00384,India
481552,2023-09-30,206,yakult,360,400,40,1,00093,India
481552,2023-09-30,213,bisleri,6,15,9,1,00093,India
481552,2023-09-30,204,strawberry yogurt,50,60,10,1,00093,India
481552,2023-09-30,203,mango yogurt,50,60,10,1,00093,India
649970,2023-09-30,207,coca cola,75,100,25,1,00206,India
649970,2023-09-30,201,paneer,210,340,130,1,00206,India
649970,2023-09-30,204,strawberry yogurt,50,60,10,1,00206,India
649970,2023-09-30,206,yakult,360,400,40,1,00206,India
584883,2023-09-30,201,paneer,210,340,130,1,00392,India
584883,2023-09-30,202,milk,12,27,15,1,00392,India
584883,2023-09-30,209,pepsi,75,100,25,1,00392,India
503860,2023-09-30,206,yakult,360,400,40,1,00340,India
503860,2023-09-30,202,milk,12,27,15,1,00340,India
503860,2023-09-30,212,amul cheese,250,315,65,1,00340,India
503860,2023-09-30,210,mountain dew,75,100,25,1,00340,India
347509,2023-09-30,208,sprite,75,100,25,1,00245,India
347509,2023-09-30,201,paneer,210,340,130,1,00245,India
347509,2023-09-30,202,milk,12,27,15,1,00245,India
177526,2023-09-30,210,mountain dew,75,100,25,1,00498,India
177526,2023-09-30,209,pepsi,75,100,25,1,00498,India
177526,2023-09-30,202,milk,12,27,15,1,00498,India
177526,2023-09-30,204,strawberry yogurt,50,60,10,1,00498,India
177526,2023-09-30,211,red bull,90,125,35,1,00498,India
724234,2023-09-30,212,amul cheese,250,315,65,1,00143,India
724234,2023-09-30,205,classic yogurt,45,60,15,1,00143,India
724234,2023-09-30,209,pepsi,75,100,25,1,00143,India
724234,2023-09-30,204,strawberry yogurt,50,60,10,1,00143,India
825651,2023-09-30,211,red bull,90,125,35,1,00067,India
825651,2023-09-30,210,mountain dew,75,100,25,1,00067,India
825651,2023-09-30,206,yakult,360,400,40,1,00067,India
825651,2023-09-30,204,strawberry yogurt,50,60,10,1,00067,India
828842,2023-09-30,203,mango yogurt,50,60,10,1,00168,India
828842,2023-09-30,207,coca cola,75,100,25,1,00168,India
828842,2023-09-30,211,red bull,90,125,35,1,00168,India
828842,2023-09-30,212,amul cheese,250,315,65,1,00168,India
828842,2023-09-30,213,bisleri,6,15,9,1,00168,India
571004,2023-09-30,208,sprite,75,100,25,1,00498,India
571004,2023-09-30,207,coca cola,75,100,25,1,00498,India
507592,2023-09-30,202,milk,12,27,15,1,00147,India
507592,2023-09-30,205,classic yogurt,45,60,15,1,00147,India
507592,2023-09-30,210,mountain dew,75,100,25,1,00147,India
770768,2023-09-30,205,classic yogurt,45,60,15,1,00139,India
770768,2023-09-30,203,mango yogurt,50,60,10,1,00139,India
770768,2023-09-30,212,amul cheese,250,315,65,1,00139,India
331939,2023-09-30,203,mango yogurt,50,60,10,1,00014,India
124567,2023-09-30,208,sprite,75,100,25,1,00362,India
124567,2023-09-30,210,mountain dew,75,100,25,1,00362,India
972698,2023-09-30,205,classic yogurt,45,60,15,1,00108,India
972698,2023-09-30,212,amul cheese,250,315,65,1,00108,India
972698,2023-09-30,201,paneer,210,340,130,1,00108,India
115726,2023-09-30,206,yakult,360,400,40,1,00059,India
115726,2023-09-30,207,coca cola,75,100,25,1,00059,India
115726,2023-09-30,211,red bull,90,125,35,1,00059,India
115726,2023-09-30,210,mountain dew,75,100,25,1,00059,India
268019,2023-09-30,207,coca cola,75,100,25,1,00267,India
268019,2023-09-30,209,pepsi,75,100,25,1,00267,India
222698,2023-09-30,209,pepsi,75,100,25,1,00042,India
424311,2023-09-30,211,red bull,90,125,35,1,00234,India
424311,2023-09-30,210,mountain dew,75,100,25,1,00234,India
424311,2023-09-30,208,sprite,75,100,25,1,00234,India
852192,2023-09-30,207,coca cola,75,100,25,1,00270,India
852192,2023-09-30,205,classic yogurt,45,60,15,1,00270,India
618393,2023-09-30,205,classic yogurt,45,60,15,1,00115,India
618393,2023-09-30,212,amul cheese,250,315,65,1,00115,India
618393,2023-09-30,209,pepsi,75,100,25,1,00115,India
618393,2023-09-30,210,mountain dew,75,100,25,1,00115,India
545764,2023-09-30,208,sprite,75,100,25,1,00431,India
545764,2023-09-30,209,pepsi,75,100,25,1,00431,India
545764,2023-09-30,202,milk,12,27,15,1,00431,India
545764,2023-09-30,203,mango yogurt,50,60,10,1,00431,India
590889,2023-09-30,211,red bull,90,125,35,1,00389,India
590889,2023-09-30,212,amul cheese,250,315,65,1,00389,India
590889,2023-09-30,209,pepsi,75,100,25,1,00389,India
590889,2023-09-30,202,milk,12,27,15,1,00389,India
968291,2023-09-30,201,paneer,210,340,130,1,00139,India
968291,2023-09-30,205,classic yogurt,45,60,15,1,00139,India
968291,2023-09-30,211,red bull,90,125,35,1,00139,India
813513,2023-09-30,202,milk,12,27,15,1,00129,India
813513,2023-09-30,207,coca cola,75,100,25,1,00129,India
813513,2023-09-30,203,mango yogurt,50,60,10,1,00129,India
278121,2023-09-30,202,milk,12,27,15,1,00241,India
789937,2023-09-30,206,yakult,360,400,40,1,00226,India
789937,2023-09-30,208,sprite,75,100,25,1,00226,India
789937,2023-09-30,205,classic yogurt,45,60,15,1,00226,India
798105,2023-09-30,203,mango yogurt,50,60,10,1,00285,India
798105,2023-09-30,201,paneer,210,340,130,1,00285,India
798105,2023-09-30,207,coca cola,75,100,25,1,00285,India
798105,2023-09-30,205,classic yogurt,45,60,15,1,00285,India
539711,2023-09-30,213,bisleri,6,15,9,1,00200,India
827892,2023-09-30,201,paneer,210,340,130,1,00193,India
827892,2023-09-30,213,bisleri,6,15,9,1,00193,India
957381,2023-09-30,211,red bull,90,125,35,1,00282,India
957381,2023-09-30,213,bisleri,6,15,9,1,00282,India
767321,2023-09-30,208,sprite,75,100,25,1,00131,India
767321,2023-09-30,204,strawberry yogurt,50,60,10,1,00131,India
767321,2023-09-30,209,pepsi,75,100,25,1,00131,India
767321,2023-09-30,203,mango yogurt,50,60,10,1,00131,India
313683,2023-09-30,202,milk,12,27,15,1,00005,India
708199,2023-09-30,204,strawberry yogurt,50,60,10,1,00296,India
421614,2023-09-30,206,yakult,360,400,40,1,00062,India
421614,2023-09-30,212,amul cheese,250,315,65,1,00062,India
421614,2023-09-30,208,sprite,75,100,25,1,00062,India
218855,2023-09-30,209,pepsi,75,100,25,1,00129,India
218855,2023-09-30,203,mango yogurt,50,60,10,1,00129,India
218855,2023-09-30,210,mountain dew,75,100,25,1,00129,India
856488,2023-09-30,209,pepsi,75,100,25,1,00214,India
838391,2023-09-30,208,sprite,75,100,25,1,00078,India
838391,2023-09-30,206,yakult,360,400,40,1,00078,India
738109,2023-09-30,206,yakult,360,400,40,1,00142,India
738109,2023-09-30,204,strawberry yogurt,50,60,10,1,00142,India
460970,2023-09-30,202,milk,12,27,15,1,00025,India
460970,2023-09-30,210,mountain dew,75,100,25,1,00025,India
994569,2023-09-30,201,paneer,210,340,130,1,00315,India
994569,2023-09-30,209,pepsi,75,100,25,1,00315,India
994569,2023-09-30,202,milk,12,27,15,1,00315,India
617709,2023-09-30,201,paneer,210,340,130,1,00180,India
959599,2023-09-30,207,coca cola,75,100,25,1,00053,India
959599,2023-09-30,206,yakult,360,400,40,1,00053,India
959599,2023-09-30,203,mango yogurt,50,60,10,1,00053,India
959599,2023-09-30,202,milk,12,27,15,1,00053,India
724403,2023-09-30,201,paneer,210,340,130,1,00299,India
724403,2023-09-30,209,pepsi,75,100,25,1,00299,India
724403,2023-09-30,212,amul cheese,250,315,65,1,00299,India
724403,2023-09-30,206,yakult,360,400,40,1,00299,India
524004,2023-09-30,205,classic yogurt,45,60,15,1,00259,India
524004,2023-09-30,203,mango yogurt,50,60,10,1,00259,India
524004,2023-09-30,201,paneer,210,340,130,1,00259,India
322433,2023-09-30,202,milk,12,27,15,1,00410,India
322433,2023-09-30,203,mango yogurt,50,60,10,1,00410,India
821702,2023-09-30,212,amul cheese,250,315,65,1,00001,India
821702,2023-09-30,206,yakult,360,400,40,1,00001,India
821702,2023-09-30,210,mountain dew,75,100,25,1,00001,India
849201,2023-09-30,202,milk,12,27,15,1,00500,India
576129,2023-09-30,209,pepsi,75,100,25,1,00301,India
576129,2023-09-30,205,classic yogurt,45,60,15,1,00301,India
576129,2023-09-30,201,paneer,210,340,130,1,00301,India
692229,2023-09-30,210,mountain dew,75,100,25,1,00242,India
692229,2023-09-30,206,yakult,360,400,40,1,00242,India
692229,2023-09-30,209,pepsi,75,100,25,1,00242,India
256503,2023-09-30,208,sprite,75,100,25,1,00127,India
562368,2023-09-30,203,mango yogurt,50,60,10,1,00388,India
562368,2023-09-30,205,classic yogurt,45,60,15,1,00388,India
562368,2023-09-30,201,paneer,210,340,130,1,00388,India
716162,2023-09-30,201,paneer,210,340,130,1,00172,India
716162,2023-09-30,204,strawberry yogurt,50,60,10,1,00172,India
716162,2023-09-30,210,mountain dew,75,100,25,1,00172,India
925432,2023-09-30,202,milk,12,27,15,1,00146,India
925432,2023-09-30,213,bisleri,6,15,9,1,00146,India
925432,2023-09-30,212,amul cheese,250,315,65,1,00146,India
925432,2023-09-30,211,red bull,90,125,35,1,00146,India
438926,2023-09-30,203,mango yogurt,50,60,10,1,00030,India
438926,2023-09-30,211,red bull,90,125,35,1,00030,India
438926,2023-09-30,202,milk,12,27,15,1,00030,India
438926,2023-09-30,205,classic yogurt,45,60,15,1,00030,India
438926,2023-09-30,208,sprite,75,100,25,1,00030,India
225673,2023-09-30,205,classic yogurt,45,60,15,1,00358,India
225673,2023-09-30,202,milk,12,27,15,1,00358,India
225673,2023-09-30,201,paneer,210,340,130,1,00358,India
187834,2023-09-30,209,pepsi,75,100,25,1,00492,India
187834,2023-09-30,204,strawberry yogurt,50,60,10,1,00492,India
899201,2023-09-30,208,sprite,75,100,25,1,00168,India
899201,2023-09-30,213,bisleri,6,15,9,1,00168,India
595733,2023-09-30,210,mountain dew,75,100,25,1,00445,India
595733,2023-09-30,209,pepsi,75,100,25,1,00445,India
595733,2023-09-30,213,bisleri,6,15,9,1,00445,India
455375,2023-09-30,206,yakult,360,400,40,1,00163,India
931265,2023-09-30,205,classic yogurt,45,60,15,1,00380,India
931265,2023-09-30,202,milk,12,27,15,1,00380,India
931265,2023-09-30,204,strawberry yogurt,50,60,10,1,00380,India
931265,2023-09-30,209,pepsi,75,100,25,1,00380,India
273594,2023-09-30,209,pepsi,75,100,25,1,00108,India
273594,2023-09-30,208,sprite,75,100,25,1,00108,India
273594,2023-09-30,204,strawberry yogurt,50,60,10,1,00108,India
273594,2023-09-30,212,amul cheese,250,315,65,1,00108,India
847435,2023-09-30,202,milk,12,27,15,1,00473,India
847435,2023-09-30,204,strawberry yogurt,50,60,10,1,00473,India
847435,2023-09-30,206,yakult,360,400,40,1,00473,India
847435,2023-09-30,207,coca cola,75,100,25,1,00473,India
529657,2023-09-30,207,coca cola,75,100,25,1,00094,India
113116,2023-09-30,208,sprite,75,100,25,1,00362,India
379957,2023-09-30,206,yakult,360,400,40,1,00476,India
379957,2023-09-30,212,amul cheese,250,315,65,1,00476,India
379957,2023-09-30,204,strawberry yogurt,50,60,10,1,00476,India
819764,2023-09-30,212,amul cheese,250,315,65,1,00093,India
228160,2023-09-30,210,mountain dew,75,100,25,1,00491,India
242825,2023-09-30,211,red bull,90,125,35,1,00071,India
242825,2023-09-30,208,sprite,75,100,25,1,00071,India
242825,2023-09-30,201,paneer,210,340,130,1,00071,India
666357,2023-09-30,209,pepsi,75,100,25,1,00328,India
666357,2023-09-30,210,mountain dew,75,100,25,1,00328,India
666357,2023-09-30,212,amul cheese,250,315,65,1,00328,India
666357,2023-09-30,207,coca cola,75,100,25,1,00328,India
666357,2023-09-30,206,yakult,360,400,40,1,00328,India
634352,2023-09-30,207,coca cola,75,100,25,1,00494,India
634352,2023-09-30,211,red bull,90,125,35,1,00494,India
287508,2023-09-30,205,classic yogurt,45,60,15,1,00065,India
287508,2023-09-30,204,strawberry yogurt,50,60,10,1,00065,India
232295,2023-09-30,210,mountain dew,75,100,25,1,00146,India
232295,2023-09-30,213,bisleri,6,15,9,1,00146,India
232295,2023-09-30,211,red bull,90,125,35,1,00146,India
690664,2023-10-01,204,strawberry yogurt,50,60,10,1,00387,India
757014,2023-10-01,213,bisleri,6,15,9,1,00223,India
498797,2023-10-01,210,mountain dew,75,100,25,1,00347,India
358909,2023-10-01,212,amul cheese,250,315,65,1,00127,India
358909,2023-10-01,202,milk,12,27,15,1,00127,India
358909,2023-10-01,207,coca cola,75,100,25,1,00127,India
367357,2023-10-01,206,yakult,360,400,40,1,00391,India
367357,2023-10-01,210,mountain dew,75,100,25,1,00391,India
367357,2023-10-01,213,bisleri,6,15,9,1,00391,India
367357,2023-10-01,205,classic yogurt,45,60,15,1,00391,India
367357,2023-10-01,211,red bull,90,125,35,1,00391,India
335053,2023-10-01,211,red bull,90,125,35,1,00186,India
335053,2023-10-01,213,bisleri,6,15,9,1,00186,India
335053,2023-10-01,207,coca cola,75,100,25,1,00186,India
335053,2023-10-01,204,strawberry yogurt,50,60,10,1,00186,India
335053,2023-10-01,209,pepsi,75,100,25,1,00186,India
514994,2023-10-01,212,amul cheese,250,315,65,1,00110,India
514994,2023-10-01,211,red bull,90,125,35,1,00110,India
514994,2023-10-01,206,yakult,360,400,40,1,00110,India
514994,2023-10-01,202,milk,12,27,15,1,00110,India
814965,2023-10-01,212,amul cheese,250,315,65,1,00371,India
814965,2023-10-01,201,paneer,210,340,130,1,00371,India
655387,2023-10-01,204,strawberry yogurt,50,60,10,1,00233,India
655387,2023-10-01,205,classic yogurt,45,60,15,1,00233,India
608974,2023-10-01,205,classic yogurt,45,60,15,1,00034,India
608974,2023-10-01,203,mango yogurt,50,60,10,1,00034,India
608974,2023-10-01,212,amul cheese,250,315,65,1,00034,India
878628,2023-10-01,212,amul cheese,250,315,65,1,00050,India
878628,2023-10-01,204,strawberry yogurt,50,60,10,1,00050,India
878628,2023-10-01,205,classic yogurt,45,60,15,1,00050,India
878628,2023-10-01,203,mango yogurt,50,60,10,1,00050,India
878628,2023-10-01,206,yakult,360,400,40,1,00050,India
131672,2023-10-01,208,sprite,75,100,25,1,00342,India
131672,2023-10-01,206,yakult,360,400,40,1,00342,India
131672,2023-10-01,205,classic yogurt,45,60,15,1,00342,India
302214,2023-10-01,201,paneer,210,340,130,1,00172,India
738627,2023-10-01,207,coca cola,75,100,25,1,00135,India
738627,2023-10-01,209,pepsi,75,100,25,1,00135,India
738627,2023-10-01,203,mango yogurt,50,60,10,1,00135,India
738627,2023-10-01,205,classic yogurt,45,60,15,1,00135,India
792772,2023-10-01,212,amul cheese,250,315,65,1,00406,India
792772,2023-10-01,203,mango yogurt,50,60,10,1,00406,India
973006,2023-10-01,201,paneer,210,340,130,1,00033,India
973006,2023-10-01,205,classic yogurt,45,60,15,1,00033,India
973006,2023-10-01,208,sprite,75,100,25,1,00033,India
973006,2023-10-01,211,red bull,90,125,35,1,00033,India
982201,2023-10-01,207,coca cola,75,100,25,1,00308,India
341063,2023-10-01,202,milk,12,27,15,1,00357,India
341063,2023-10-01,210,mountain dew,75,100,25,1,00357,India
537505,2023-10-01,202,milk,12,27,15,1,00481,India
537505,2023-10-01,206,yakult,360,400,40,1,00481,India
616249,2023-10-01,201,paneer,210,340,130,1,00010,India
616249,2023-10-01,205,classic yogurt,45,60,15,1,00010,India
616249,2023-10-01,209,pepsi,75,100,25,1,00010,India
616249,2023-10-01,211,red bull,90,125,35,1,00010,India
526147,2023-10-01,213,bisleri,6,15,9,1,00004,India
122670,2023-10-01,209,pepsi,75,100,25,1,00250,India
122670,2023-10-01,201,paneer,210,340,130,1,00250,India
122670,2023-10-01,213,bisleri,6,15,9,1,00250,India
361637,2023-10-01,201,paneer,210,340,130,1,00469,India
778650,2023-10-01,213,bisleri,6,15,9,1,00161,India
778650,2023-10-01,205,classic yogurt,45,60,15,1,00161,India
778650,2023-10-01,206,yakult,360,400,40,1,00161,India
778650,2023-10-01,210,mountain dew,75,100,25,1,00161,India
778650,2023-10-01,201,paneer,210,340,130,1,00161,India
964906,2023-10-01,211,red bull,90,125,35,1,00009,India
691930,2023-10-01,202,milk,12,27,15,1,00122,India
691930,2023-10-01,205,classic yogurt,45,60,15,1,00122,India
360607,2023-10-01,213,bisleri,6,15,9,1,00217,India
415328,2023-10-01,211,red bull,90,125,35,1,00108,India
415328,2023-10-01,210,mountain dew,75,100,25,1,00108,India
415328,2023-10-01,206,yakult,360,400,40,1,00108,India
311641,2023-10-01,206,yakult,360,400,40,1,00491,India
311641,2023-10-01,213,bisleri,6,15,9,1,00491,India
419635,2023-10-01,210,mountain dew,75,100,25,1,00461,India
412619,2023-10-01,204,strawberry yogurt,50,60,10,1,00401,India
412619,2023-10-01,205,classic yogurt,45,60,15,1,00401,India
412619,2023-10-01,203,mango yogurt,50,60,10,1,00401,India
412619,2023-10-01,210,mountain dew,75,100,25,1,00401,India
838663,2023-10-01,211,red bull,90,125,35,1,00169,India
329826,2023-10-01,206,yakult,360,400,40,1,00317,India
329826,2023-10-01,201,paneer,210,340,130,1,00317,India
749100,2023-10-01,213,bisleri,6,15,9,1,00432,India
749100,2023-10-01,206,yakult,360,400,40,1,00432,India
528683,2023-10-01,202,milk,12,27,15,1,00343,India
528683,2023-10-01,210,mountain dew,75,100,25,1,00343,India
528683,2023-10-01,204,strawberry yogurt,50,60,10,1,00343,India
863300,2023-10-01,207,coca cola,75,100,25,1,00106,India
863300,2023-10-01,213,bisleri,6,15,9,1,00106,India
534017,2023-10-01,205,classic yogurt,45,60,15,1,00453,India
534017,2023-10-01,204,strawberry yogurt,50,60,10,1,00453,India
534017,2023-10-01,213,bisleri,6,15,9,1,00453,India
534017,2023-10-01,206,yakult,360,400,40,1,00453,India
534017,2023-10-01,201,paneer,210,340,130,1,00453,India
953124,2023-10-01,201,paneer,210,340,130,1,00395,India
953124,2023-10-01,209,pepsi,75,100,25,1,00395,India
953124,2023-10-01,202,milk,12,27,15,1,00395,India
569822,2023-10-01,212,amul cheese,250,315,65,1,00357,India
569822,2023-10-01,211,red bull,90,125,35,1,00357,India
569822,2023-10-01,203,mango yogurt,50,60,10,1,00357,India
555940,2023-10-01,202,milk,12,27,15,1,00045,India
919732,2023-10-01,211,red bull,90,125,35,1,00118,India
918004,2023-10-01,212,amul cheese,250,315,65,1,00095,India
918004,2023-10-01,204,strawberry yogurt,50,60,10,1,00095,India
918004,2023-10-01,211,red bull,90,125,35,1,00095,India
918004,2023-10-01,208,sprite,75,100,25,1,00095,India
918004,2023-10-01,213,bisleri,6,15,9,1,00095,India
613442,2023-10-01,213,bisleri,6,15,9,1,00020,India
613442,2023-10-01,201,paneer,210,340,130,1,00020,India
613442,2023-10-01,207,coca cola,75,100,25,1,00020,India
593948,2023-10-01,209,pepsi,75,100,25,1,00489,India
593948,2023-10-01,204,strawberry yogurt,50,60,10,1,00489,India
593948,2023-10-01,206,yakult,360,400,40,1,00489,India
593948,2023-10-01,210,mountain dew,75,100,25,1,00489,India
593948,2023-10-01,207,coca cola,75,100,25,1,00489,India
441181,2023-10-01,211,red bull,90,125,35,1,00204,India
441181,2023-10-01,212,amul cheese,250,315,65,1,00204,India
923998,2023-10-01,203,mango yogurt,50,60,10,1,00154,India
204614,2023-10-01,206,yakult,360,400,40,1,00266,India
204614,2023-10-01,212,amul cheese,250,315,65,1,00266,India
204614,2023-10-01,209,pepsi,75,100,25,1,00266,India
204614,2023-10-01,202,milk,12,27,15,1,00266,India
230871,2023-10-01,209,pepsi,75,100,25,1,00024,India
230871,2023-10-01,204,strawberry yogurt,50,60,10,1,00024,India
230871,2023-10-01,205,classic yogurt,45,60,15,1,00024,India
723073,2023-10-01,209,pepsi,75,100,25,1,00019,India
723073,2023-10-01,206,yakult,360,400,40,1,00019,India
723073,2023-10-01,211,red bull,90,125,35,1,00019,India
489221,2023-10-01,203,mango yogurt,50,60,10,1,00062,India
414978,2023-10-01,213,bisleri,6,15,9,1,00449,India
414978,2023-10-01,207,coca cola,75,100,25,1,00449,India
430146,2023-10-01,203,mango yogurt,50,60,10,1,00388,India
717827,2023-10-01,209,pepsi,75,100,25,1,00403,India
717827,2023-10-01,206,yakult,360,400,40,1,00403,India
717827,2023-10-01,212,amul cheese,250,315,65,1,00403,India
575955,2023-10-01,209,pepsi,75,100,25,1,00178,India
575955,2023-10-01,210,mountain dew,75,100,25,1,00178,India
575955,2023-10-01,213,bisleri,6,15,9,1,00178,India
788653,2023-10-01,210,mountain dew,75,100,25,1,00096,India
788653,2023-10-01,206,yakult,360,400,40,1,00096,India
788653,2023-10-01,211,red bull,90,125,35,1,00096,India
523785,2023-10-01,203,mango yogurt,50,60,10,1,00319,India
523785,2023-10-01,209,pepsi,75,100,25,1,00319,India
523785,2023-10-01,205,classic yogurt,45,60,15,1,00319,India
370769,2023-10-01,206,yakult,360,400,40,1,00478,India
370769,2023-10-01,203,mango yogurt,50,60,10,1,00478,India
370769,2023-10-01,210,mountain dew,75,100,25,1,00478,India
370769,2023-10-01,209,pepsi,75,100,25,1,00478,India
108850,2023-10-01,211,red bull,90,125,35,1,00454,India
111413,2023-10-01,203,mango yogurt,50,60,10,1,00127,India
111413,2023-10-01,211,red bull,90,125,35,1,00127,India
111413,2023-10-01,213,bisleri,6,15,9,1,00127,India
111413,2023-10-01,201,paneer,210,340,130,1,00127,India
870725,2023-10-01,209,pepsi,75,100,25,1,00361,India
870725,2023-10-01,205,classic yogurt,45,60,15,1,00361,India
870725,2023-10-01,210,mountain dew,75,100,25,1,00361,India
904211,2023-10-01,206,yakult,360,400,40,1,00176,India
933446,2023-10-01,201,paneer,210,340,130,1,00465,India
933446,2023-10-01,203,mango yogurt,50,60,10,1,00465,India
933446,2023-10-01,209,pepsi,75,100,25,1,00465,India
933446,2023-10-01,206,yakult,360,400,40,1,00465,India
511147,2023-10-01,207,coca cola,75,100,25,1,00485,India
511147,2023-10-01,211,red bull,90,125,35,1,00485,India
433241,2023-10-01,206,yakult,360,400,40,1,00086,India
433241,2023-10-01,203,mango yogurt,50,60,10,1,00086,India
433241,2023-10-01,205,classic yogurt,45,60,15,1,00086,India
433241,2023-10-01,211,red bull,90,125,35,1,00086,India
917064,2023-10-01,206,yakult,360,400,40,1,00399,India
917064,2023-10-01,203,mango yogurt,50,60,10,1,00399,India
917064,2023-10-01,209,pepsi,75,100,25,1,00399,India
917064,2023-10-01,201,paneer,210,340,130,1,00399,India
295108,2023-10-01,213,bisleri,6,15,9,1,00420,India
295108,2023-10-01,207,coca cola,75,100,25,1,00420,India
295108,2023-10-01,209,pepsi,75,100,25,1,00420,India
295108,2023-10-01,211,red bull,90,125,35,1,00420,India
295108,2023-10-01,208,sprite,75,100,25,1,00420,India
934164,2023-10-01,202,milk,12,27,15,1,00422,India
934164,2023-10-01,206,yakult,360,400,40,1,00422,India
934164,2023-10-01,213,bisleri,6,15,9,1,00422,India
878605,2023-10-01,209,pepsi,75,100,25,1,00339,India
878605,2023-10-01,208,sprite,75,100,25,1,00339,India
878605,2023-10-01,206,yakult,360,400,40,1,00339,India
878605,2023-10-01,201,paneer,210,340,130,1,00339,India
134121,2023-10-01,204,strawberry yogurt,50,60,10,1,00124,India
134121,2023-10-01,205,classic yogurt,45,60,15,1,00124,India
134121,2023-10-01,211,red bull,90,125,35,1,00124,India
134121,2023-10-01,209,pepsi,75,100,25,1,00124,India
626349,2023-10-01,210,mountain dew,75,100,25,1,00262,India
626349,2023-10-01,213,bisleri,6,15,9,1,00262,India
626349,2023-10-01,212,amul cheese,250,315,65,1,00262,India
626349,2023-10-01,206,yakult,360,400,40,1,00262,India
626349,2023-10-01,209,pepsi,75,100,25,1,00262,India
973011,2023-10-01,210,mountain dew,75,100,25,1,00370,India
973011,2023-10-01,208,sprite,75,100,25,1,00370,India
973011,2023-10-01,205,classic yogurt,45,60,15,1,00370,India
973011,2023-10-01,203,mango yogurt,50,60,10,1,00370,India
414399,2023-10-01,204,strawberry yogurt,50,60,10,1,00286,India
414399,2023-10-01,206,yakult,360,400,40,1,00286,India
414399,2023-10-01,201,paneer,210,340,130,1,00286,India
824074,2023-10-01,207,coca cola,75,100,25,1,00065,India
824074,2023-10-01,206,yakult,360,400,40,1,00065,India
824074,2023-10-01,203,mango yogurt,50,60,10,1,00065,India
866914,2023-10-01,213,bisleri,6,15,9,1,00368,India
866914,2023-10-01,207,coca cola,75,100,25,1,00368,India
866914,2023-10-01,209,pepsi,75,100,25,1,00368,India
866914,2023-10-01,206,yakult,360,400,40,1,00368,India
399474,2023-10-01,203,mango yogurt,50,60,10,1,00495,India
399474,2023-10-01,206,yakult,360,400,40,1,00495,India
399474,2023-10-01,205,classic yogurt,45,60,15,1,00495,India
762815,2023-10-01,202,milk,12,27,15,1,00165,India
851894,2023-10-01,204,strawberry yogurt,50,60,10,1,00456,India
851894,2023-10-01,212,amul cheese,250,315,65,1,00456,India
851894,2023-10-01,210,mountain dew,75,100,25,1,00456,India
348241,2023-10-01,207,coca cola,75,100,25,1,00097,India
348241,2023-10-01,211,red bull,90,125,35,1,00097,India
348241,2023-10-01,201,paneer,210,340,130,1,00097,India
348241,2023-10-01,203,mango yogurt,50,60,10,1,00097,India
285095,2023-10-01,213,bisleri,6,15,9,1,00139,India
285095,2023-10-01,206,yakult,360,400,40,1,00139,India
285095,2023-10-01,210,mountain dew,75,100,25,1,00139,India
285095,2023-10-01,202,milk,12,27,15,1,00139,India
285095,2023-10-01,204,strawberry yogurt,50,60,10,1,00139,India
325397,2023-10-01,213,bisleri,6,15,9,1,00401,India
174150,2023-10-01,205,classic yogurt,45,60,15,1,00196,India
174150,2023-10-01,207,coca cola,75,100,25,1,00196,India
174150,2023-10-01,213,bisleri,6,15,9,1,00196,India
174150,2023-10-01,206,yakult,360,400,40,1,00196,India
320465,2023-10-01,209,pepsi,75,100,25,1,00415,India
727607,2023-10-01,211,red bull,90,125,35,1,00455,India
727607,2023-10-01,201,paneer,210,340,130,1,00455,India
727607,2023-10-01,204,strawberry yogurt,50,60,10,1,00455,India
370400,2023-10-01,202,milk,12,27,15,1,00012,India
370400,2023-10-01,207,coca cola,75,100,25,1,00012,India
370400,2023-10-01,212,amul cheese,250,315,65,1,00012,India
533466,2023-10-01,211,red bull,90,125,35,1,00138,India
533466,2023-10-01,202,milk,12,27,15,1,00138,India
408687,2023-10-02,201,paneer,210,340,130,1,00292,India
408687,2023-10-02,211,red bull,90,125,35,1,00292,India
742180,2023-10-02,211,red bull,90,125,35,1,00202,India
742180,2023-10-02,208,sprite,75,100,25,1,00202,India
742180,2023-10-02,205,classic yogurt,45,60,15,1,00202,India
599940,2023-10-02,204,strawberry yogurt,50,60,10,1,00344,India
599940,2023-10-02,207,coca cola,75,100,25,1,00344,India
599940,2023-10-02,209,pepsi,75,100,25,1,00344,India
828216,2023-10-02,201,paneer,210,340,130,1,00287,India
828216,2023-10-02,204,strawberry yogurt,50,60,10,1,00287,India
828216,2023-10-02,213,bisleri,6,15,9,1,00287,India
616839,2023-10-02,204,strawberry yogurt,50,60,10,1,00244,India
616839,2023-10-02,201,paneer,210,340,130,1,00244,India
616839,2023-10-02,207,coca cola,75,100,25,1,00244,India
154147,2023-10-02,210,mountain dew,75,100,25,1,00211,India
154147,2023-10-02,207,coca cola,75,100,25,1,00211,India
373375,2023-10-02,205,classic yogurt,45,60,15,1,00401,India
294280,2023-10-02,209,pepsi,75,100,25,1,00074,India
728598,2023-10-02,201,paneer,210,340,130,1,00284,India
728598,2023-10-02,203,mango yogurt,50,60,10,1,00284,India
728598,2023-10-02,212,amul cheese,250,315,65,1,00284,India
809972,2023-10-02,211,red bull,90,125,35,1,00351,India
809972,2023-10-02,210,mountain dew,75,100,25,1,00351,India
541916,2023-10-02,213,bisleri,6,15,9,1,00015,India
541916,2023-10-02,202,milk,12,27,15,1,00015,India
436097,2023-10-02,213,bisleri,6,15,9,1,00074,India
848485,2023-10-02,211,red bull,90,125,35,1,00069,India
848485,2023-10-02,212,amul cheese,250,315,65,1,00069,India
848485,2023-10-02,213,bisleri,6,15,9,1,00069,India
848485,2023-10-02,207,coca cola,75,100,25,1,00069,India
848485,2023-10-02,208,sprite,75,100,25,1,00069,India
289324,2023-10-02,201,paneer,210,340,130,1,00423,India
890484,2023-10-02,211,red bull,90,125,35,1,00318,India
890484,2023-10-02,201,paneer,210,340,130,1,00318,India
890484,2023-10-02,209,pepsi,75,100,25,1,00318,India
890484,2023-10-02,212,amul cheese,250,315,65,1,00318,India
890484,2023-10-02,210,mountain dew,75,100,25,1,00318,India
695953,2023-10-02,201,paneer,210,340,130,1,00129,India
803696,2023-10-02,203,mango yogurt,50,60,10,1,00197,India
803696,2023-10-02,201,paneer,210,340,130,1,00197,India
803696,2023-10-02,205,classic yogurt,45,60,15,1,00197,India
803696,2023-10-02,204,strawberry yogurt,50,60,10,1,00197,India
629222,2023-10-02,213,bisleri,6,15,9,1,00443,India
629222,2023-10-02,205,classic yogurt,45,60,15,1,00443,India
495758,2023-10-02,212,amul cheese,250,315,65,1,00090,India
495758,2023-10-02,210,mountain dew,75,100,25,1,00090,India
495758,2023-10-02,204,strawberry yogurt,50,60,10,1,00090,India
689098,2023-10-02,208,sprite,75,100,25,1,00020,India
777965,2023-10-02,207,coca cola,75,100,25,1,00346,India
524107,2023-10-02,201,paneer,210,340,130,1,00411,India
524107,2023-10-02,205,classic yogurt,45,60,15,1,00411,India
524107,2023-10-02,202,milk,12,27,15,1,00411,India
963196,2023-10-02,204,strawberry yogurt,50,60,10,1,00226,India
963196,2023-10-02,203,mango yogurt,50,60,10,1,00226,India
177812,2023-10-02,212,amul cheese,250,315,65,1,00282,India
141626,2023-10-02,203,mango yogurt,50,60,10,1,00381,India
141626,2023-10-02,209,pepsi,75,100,25,1,00381,India
141626,2023-10-02,202,milk,12,27,15,1,00381,India
141626,2023-10-02,213,bisleri,6,15,9,1,00381,India
826337,2023-10-02,202,milk,12,27,15,1,00062,India
826337,2023-10-02,208,sprite,75,100,25,1,00062,India
826337,2023-10-02,205,classic yogurt,45,60,15,1,00062,India
826337,2023-10-02,211,red bull,90,125,35,1,00062,India
495741,2023-10-02,206,yakult,360,400,40,1,00087,India
994526,2023-10-02,208,sprite,75,100,25,1,00305,India
994526,2023-10-02,206,yakult,360,400,40,1,00305,India
900543,2023-10-02,209,pepsi,75,100,25,1,00119,India
900543,2023-10-02,207,coca cola,75,100,25,1,00119,India
900543,2023-10-02,210,mountain dew,75,100,25,1,00119,India
900543,2023-10-02,208,sprite,75,100,25,1,00119,India
718819,2023-10-02,204,strawberry yogurt,50,60,10,1,00239,India
718819,2023-10-02,201,paneer,210,340,130,1,00239,India
718819,2023-10-02,209,pepsi,75,100,25,1,00239,India
718819,2023-10-02,213,bisleri,6,15,9,1,00239,India
923516,2023-10-02,206,yakult,360,400,40,1,00261,India
923516,2023-10-02,208,sprite,75,100,25,1,00261,India
485884,2023-10-02,210,mountain dew,75,100,25,1,00176,India
485884,2023-10-02,206,yakult,360,400,40,1,00176,India
485884,2023-10-02,209,pepsi,75,100,25,1,00176,India
485884,2023-10-02,205,classic yogurt,45,60,15,1,00176,India
485884,2023-10-02,201,paneer,210,340,130,1,00176,India
525534,2023-10-02,213,bisleri,6,15,9,1,00019,India
525534,2023-10-02,205,classic yogurt,45,60,15,1,00019,India
525534,2023-10-02,202,milk,12,27,15,1,00019,India
627256,2023-10-02,203,mango yogurt,50,60,10,1,00146,India
627256,2023-10-02,211,red bull,90,125,35,1,00146,India
227413,2023-10-02,207,coca cola,75,100,25,1,00171,India
227413,2023-10-02,210,mountain dew,75,100,25,1,00171,India
227413,2023-10-02,203,mango yogurt,50,60,10,1,00171,India
227413,2023-10-02,204,strawberry yogurt,50,60,10,1,00171,India
550467,2023-10-02,204,strawberry yogurt,50,60,10,1,00415,India
550467,2023-10-02,213,bisleri,6,15,9,1,00415,India
550467,2023-10-02,209,pepsi,75,100,25,1,00415,India
550467,2023-10-02,202,milk,12,27,15,1,00415,India
550467,2023-10-02,208,sprite,75,100,25,1,00415,India
593311,2023-10-02,202,milk,12,27,15,1,00353,India
593311,2023-10-02,203,mango yogurt,50,60,10,1,00353,India
868142,2023-10-02,212,amul cheese,250,315,65,1,00210,India
868142,2023-10-02,211,red bull,90,125,35,1,00210,India
375748,2023-10-02,212,amul cheese,250,315,65,1,00112,India
375748,2023-10-02,210,mountain dew,75,100,25,1,00112,India
364080,2023-10-02,212,amul cheese,250,315,65,1,00002,India
364080,2023-10-02,213,bisleri,6,15,9,1,00002,India
364080,2023-10-02,204,strawberry yogurt,50,60,10,1,00002,India
364080,2023-10-02,203,mango yogurt,50,60,10,1,00002,India
411377,2023-10-02,212,amul cheese,250,315,65,1,00232,India
411377,2023-10-02,211,red bull,90,125,35,1,00232,India
411377,2023-10-02,201,paneer,210,340,130,1,00232,India
411377,2023-10-02,208,sprite,75,100,25,1,00232,India
255356,2023-10-02,206,yakult,360,400,40,1,00015,India
900629,2023-10-02,207,coca cola,75,100,25,1,00422,India
900629,2023-10-02,201,paneer,210,340,130,1,00422,India
900629,2023-10-02,205,classic yogurt,45,60,15,1,00422,India
999367,2023-10-02,209,pepsi,75,100,25,1,00173,India
999367,2023-10-02,210,mountain dew,75,100,25,1,00173,India
369364,2023-10-02,212,amul cheese,250,315,65,1,00133,India
369364,2023-10-02,206,yakult,360,400,40,1,00133,India
369364,2023-10-02,211,red bull,90,125,35,1,00133,India
369364,2023-10-02,201,paneer,210,340,130,1,00133,India
442489,2023-10-02,202,milk,12,27,15,1,00409,India
442489,2023-10-02,203,mango yogurt,50,60,10,1,00409,India
442489,2023-10-02,206,yakult,360,400,40,1,00409,India
442489,2023-10-02,213,bisleri,6,15,9,1,00409,India
709922,2023-10-02,204,strawberry yogurt,50,60,10,1,00011,India
709922,2023-10-02,201,paneer,210,340,130,1,00011,India
709922,2023-10-02,206,yakult,360,400,40,1,00011,India
901711,2023-10-02,213,bisleri,6,15,9,1,00227,India
345969,2023-10-02,212,amul cheese,250,315,65,1,00296,India
345969,2023-10-02,204,strawberry yogurt,50,60,10,1,00296,India
345969,2023-10-02,209,pepsi,75,100,25,1,00296,India
233627,2023-10-02,213,bisleri,6,15,9,1,00173,India
233627,2023-10-02,211,red bull,90,125,35,1,00173,India
233627,2023-10-02,210,mountain dew,75,100,25,1,00173,India
233627,2023-10-02,202,milk,12,27,15,1,00173,India
233627,2023-10-02,212,amul cheese,250,315,65,1,00173,India
720144,2023-10-02,210,mountain dew,75,100,25,1,00369,India
829966,2023-10-02,204,strawberry yogurt,50,60,10,1,00009,India
994737,2023-10-02,206,yakult,360,400,40,1,00158,India
994737,2023-10-02,208,sprite,75,100,25,1,00158,India
699531,2023-10-02,206,yakult,360,400,40,1,00274,India
548270,2023-10-02,209,pepsi,75,100,25,1,00263,India
548270,2023-10-02,212,amul cheese,250,315,65,1,00263,India
128782,2023-10-02,209,pepsi,75,100,25,1,00062,India
128782,2023-10-02,205,classic yogurt,45,60,15,1,00062,India
960224,2023-10-02,213,bisleri,6,15,9,1,00054,India
960224,2023-10-02,203,mango yogurt,50,60,10,1,00054,India
960224,2023-10-02,209,pepsi,75,100,25,1,00054,India
960224,2023-10-02,206,yakult,360,400,40,1,00054,India
544433,2023-10-02,203,mango yogurt,50,60,10,1,00068,India
544433,2023-10-02,205,classic yogurt,45,60,15,1,00068,India
544433,2023-10-02,206,yakult,360,400,40,1,00068,India
544433,2023-10-02,208,sprite,75,100,25,1,00068,India
544433,2023-10-02,201,paneer,210,340,130,1,00068,India
160147,2023-10-02,210,mountain dew,75,100,25,1,00034,India
160147,2023-10-02,205,classic yogurt,45,60,15,1,00034,India
213514,2023-10-02,211,red bull,90,125,35,1,00421,India
213514,2023-10-02,201,paneer,210,340,130,1,00421,India
213514,2023-10-02,208,sprite,75,100,25,1,00421,India
213514,2023-10-02,212,amul cheese,250,315,65,1,00421,India
636644,2023-10-02,202,milk,12,27,15,1,00471,India
358380,2023-10-02,208,sprite,75,100,25,1,00181,India
358380,2023-10-02,202,milk,12,27,15,1,00181,India
358380,2023-10-02,203,mango yogurt,50,60,10,1,00181,India
468998,2023-10-02,202,milk,12,27,15,1,00344,India
468998,2023-10-02,213,bisleri,6,15,9,1,00344,India
909784,2023-10-02,204,strawberry yogurt,50,60,10,1,00160,India
909784,2023-10-02,213,bisleri,6,15,9,1,00160,India
909784,2023-10-02,205,classic yogurt,45,60,15,1,00160,India
909784,2023-10-02,202,milk,12,27,15,1,00160,India
909784,2023-10-02,207,coca cola,75,100,25,1,00160,India
621613,2023-10-02,207,coca cola,75,100,25,1,00024,India
621613,2023-10-02,205,classic yogurt,45,60,15,1,00024,India
621613,2023-10-02,201,paneer,210,340,130,1,00024,India
944513,2023-10-02,203,mango yogurt,50,60,10,1,00242,India
944513,2023-10-02,201,paneer,210,340,130,1,00242,India
944513,2023-10-02,204,strawberry yogurt,50,60,10,1,00242,India
944513,2023-10-02,213,bisleri,6,15,9,1,00242,India
653478,2023-10-02,204,strawberry yogurt,50,60,10,1,00477,India
280590,2023-10-02,209,pepsi,75,100,25,1,00436,India
280590,2023-10-02,205,classic yogurt,45,60,15,1,00436,India
280590,2023-10-02,206,yakult,360,400,40,1,00436,India
280590,2023-10-02,212,amul cheese,250,315,65,1,00436,India
498465,2023-10-02,209,pepsi,75,100,25,1,00292,India
801726,2023-10-02,204,strawberry yogurt,50,60,10,1,00421,India
801726,2023-10-02,202,milk,12,27,15,1,00421,India
801726,2023-10-02,213,bisleri,6,15,9,1,00421,India
801726,2023-10-02,209,pepsi,75,100,25,1,00421,India
577488,2023-10-02,204,strawberry yogurt,50,60,10,1,00277,India
577488,2023-10-02,206,yakult,360,400,40,1,00277,India
243331,2023-10-02,205,classic yogurt,45,60,15,1,00109,India
243331,2023-10-02,209,pepsi,75,100,25,1,00109,India
243331,2023-10-02,208,sprite,75,100,25,1,00109,India
244730,2023-10-02,213,bisleri,6,15,9,1,00016,India
244730,2023-10-02,205,classic yogurt,45,60,15,1,00016,India
244730,2023-10-02,201,paneer,210,340,130,1,00016,India
925221,2023-10-02,208,sprite,75,100,25,1,00268,India
925221,2023-10-02,206,yakult,360,400,40,1,00268,India
925221,2023-10-02,202,milk,12,27,15,1,00268,India
425178,2023-10-02,203,mango yogurt,50,60,10,1,00006,India
425178,2023-10-02,206,yakult,360,400,40,1,00006,India
425178,2023-10-02,202,milk,12,27,15,1,00006,India
425178,2023-10-02,210,mountain dew,75,100,25,1,00006,India
733242,2023-10-02,209,pepsi,75,100,25,1,00353,India
733242,2023-10-02,207,coca cola,75,100,25,1,00353,India
733242,2023-10-02,205,classic yogurt,45,60,15,1,00353,India
733242,2023-10-02,206,yakult,360,400,40,1,00353,India
182611,2023-10-02,213,bisleri,6,15,9,1,00418,India
182611,2023-10-02,207,coca cola,75,100,25,1,00418,India
182611,2023-10-02,205,classic yogurt,45,60,15,1,00418,India
569724,2023-10-02,202,milk,12,27,15,1,00001,India
258351,2023-10-02,201,paneer,210,340,130,1,00485,India
258351,2023-10-02,213,bisleri,6,15,9,1,00485,India
258351,2023-10-02,207,coca cola,75,100,25,1,00485,India
258351,2023-10-02,210,mountain dew,75,100,25,1,00485,India
643768,2023-10-02,202,milk,12,27,15,1,00230,India
511592,2023-10-02,203,mango yogurt,50,60,10,1,00007,India
511592,2023-10-02,211,red bull,90,125,35,1,00007,India
981479,2023-10-02,207,coca cola,75,100,25,1,00383,India
226107,2023-10-02,205,classic yogurt,45,60,15,1,00373,India
226107,2023-10-02,212,amul cheese,250,315,65,1,00373,India
226107,2023-10-02,208,sprite,75,100,25,1,00373,India
226107,2023-10-02,202,milk,12,27,15,1,00373,India
226107,2023-10-02,210,mountain dew,75,100,25,1,00373,India
128679,2023-10-02,203,mango yogurt,50,60,10,1,00471,India
128679,2023-10-02,201,paneer,210,340,130,1,00471,India
315457,2023-10-02,205,classic yogurt,45,60,15,1,00493,India
315457,2023-10-02,208,sprite,75,100,25,1,00493,India
287374,2023-10-02,205,classic yogurt,45,60,15,1,00146,India
287374,2023-10-02,207,coca cola,75,100,25,1,00146,India
287374,2023-10-02,203,mango yogurt,50,60,10,1,00146,India
287374,2023-10-02,202,milk,12,27,15,1,00146,India
858459,2023-10-02,209,pepsi,75,100,25,1,00211,India
858459,2023-10-02,204,strawberry yogurt,50,60,10,1,00211,India
516559,2023-10-02,210,mountain dew,75,100,25,1,00255,India
479243,2023-10-02,211,red bull,90,125,35,1,00354,India
479243,2023-10-02,203,mango yogurt,50,60,10,1,00354,India
479243,2023-10-02,210,mountain dew,75,100,25,1,00354,India
667057,2023-10-02,205,classic yogurt,45,60,15,1,00263,India
667057,2023-10-02,213,bisleri,6,15,9,1,00263,India
223913,2023-10-02,205,classic yogurt,45,60,15,1,00066,India
223913,2023-10-02,204,strawberry yogurt,50,60,10,1,00066,India
223913,2023-10-02,202,milk,12,27,15,1,00066,India
223913,2023-10-02,211,red bull,90,125,35,1,00066,India
266849,2023-10-03,213,bisleri,6,15,9,1,00458,India
970511,2023-10-03,213,bisleri,6,15,9,1,00178,India
970511,2023-10-03,202,milk,12,27,15,1,00178,India
970511,2023-10-03,207,coca cola,75,100,25,1,00178,India
341569,2023-10-03,202,milk,12,27,15,1,00188,India
341569,2023-10-03,208,sprite,75,100,25,1,00188,India
341569,2023-10-03,212,amul cheese,250,315,65,1,00188,India
341569,2023-10-03,204,strawberry yogurt,50,60,10,1,00188,India
271887,2023-10-03,206,yakult,360,400,40,1,00188,India
271887,2023-10-03,212,amul cheese,250,315,65,1,00188,India
271887,2023-10-03,213,bisleri,6,15,9,1,00188,India
271887,2023-10-03,209,pepsi,75,100,25,1,00188,India
271887,2023-10-03,203,mango yogurt,50,60,10,1,00188,India
292067,2023-10-03,211,red bull,90,125,35,1,00253,India
292067,2023-10-03,203,mango yogurt,50,60,10,1,00253,India
292067,2023-10-03,206,yakult,360,400,40,1,00253,India
292067,2023-10-03,207,coca cola,75,100,25,1,00253,India
149854,2023-10-03,210,mountain dew,75,100,25,1,00201,India
190125,2023-10-03,210,mountain dew,75,100,25,1,00313,India
278645,2023-10-03,208,sprite,75,100,25,1,00488,India
278645,2023-10-03,202,milk,12,27,15,1,00488,India
807153,2023-10-03,212,amul cheese,250,315,65,1,00095,India
807153,2023-10-03,204,strawberry yogurt,50,60,10,1,00095,India
807153,2023-10-03,201,paneer,210,340,130,1,00095,India
807153,2023-10-03,209,pepsi,75,100,25,1,00095,India
411974,2023-10-03,213,bisleri,6,15,9,1,00157,India
411974,2023-10-03,201,paneer,210,340,130,1,00157,India
411974,2023-10-03,209,pepsi,75,100,25,1,00157,India
917943,2023-10-03,202,milk,12,27,15,1,00354,India
917943,2023-10-03,204,strawberry yogurt,50,60,10,1,00354,India
917943,2023-10-03,206,yakult,360,400,40,1,00354,India
423147,2023-10-03,201,paneer,210,340,130,1,00266,India
423147,2023-10-03,203,mango yogurt,50,60,10,1,00266,India
423147,2023-10-03,204,strawberry yogurt,50,60,10,1,00266,India
518049,2023-10-03,205,classic yogurt,45,60,15,1,00255,India
518049,2023-10-03,203,mango yogurt,50,60,10,1,00255,India
518049,2023-10-03,201,paneer,210,340,130,1,00255,India
743900,2023-10-03,207,coca cola,75,100,25,1,00253,India
743900,2023-10-03,202,milk,12,27,15,1,00253,India
831284,2023-10-03,209,pepsi,75,100,25,1,00493,India
831284,2023-10-03,204,strawberry yogurt,50,60,10,1,00493,India
831284,2023-10-03,201,paneer,210,340,130,1,00493,India
831284,2023-10-03,213,bisleri,6,15,9,1,00493,India
677064,2023-10-03,213,bisleri,6,15,9,1,00042,India
677064,2023-10-03,205,classic yogurt,45,60,15,1,00042,India
677064,2023-10-03,207,coca cola,75,100,25,1,00042,India
677064,2023-10-03,210,mountain dew,75,100,25,1,00042,India
677064,2023-10-03,212,amul cheese,250,315,65,1,00042,India
937319,2023-10-03,208,sprite,75,100,25,1,00226,India
937319,2023-10-03,204,strawberry yogurt,50,60,10,1,00226,India
937319,2023-10-03,213,bisleri,6,15,9,1,00226,India
645993,2023-10-03,211,red bull,90,125,35,1,00426,India
645993,2023-10-03,201,paneer,210,340,130,1,00426,India
645993,2023-10-03,210,mountain dew,75,100,25,1,00426,India
930586,2023-10-03,211,red bull,90,125,35,1,00008,India
930586,2023-10-03,210,mountain dew,75,100,25,1,00008,India
401370,2023-10-03,203,mango yogurt,50,60,10,1,00071,India
401370,2023-10-03,207,coca cola,75,100,25,1,00071,India
401370,2023-10-03,202,milk,12,27,15,1,00071,India
370674,2023-10-03,204,strawberry yogurt,50,60,10,1,00443,India
370674,2023-10-03,211,red bull,90,125,35,1,00443,India
370674,2023-10-03,201,paneer,210,340,130,1,00443,India
370674,2023-10-03,209,pepsi,75,100,25,1,00443,India
525688,2023-10-03,208,sprite,75,100,25,1,00133,India
525688,2023-10-03,213,bisleri,6,15,9,1,00133,India
525688,2023-10-03,210,mountain dew,75,100,25,1,00133,India
748728,2023-10-03,208,sprite,75,100,25,1,00474,India
748728,2023-10-03,204,strawberry yogurt,50,60,10,1,00474,India
748728,2023-10-03,209,pepsi,75,100,25,1,00474,India
748728,2023-10-03,202,milk,12,27,15,1,00474,India
436373,2023-10-03,209,pepsi,75,100,25,1,00403,India
436373,2023-10-03,212,amul cheese,250,315,65,1,00403,India
334170,2023-10-03,211,red bull,90,125,35,1,00160,India
334170,2023-10-03,210,mountain dew,75,100,25,1,00160,India
334170,2023-10-03,203,mango yogurt,50,60,10,1,00160,India
911628,2023-10-03,211,red bull,90,125,35,1,00316,India
911628,2023-10-03,208,sprite,75,100,25,1,00316,India
911628,2023-10-03,212,amul cheese,250,315,65,1,00316,India
911628,2023-10-03,204,strawberry yogurt,50,60,10,1,00316,India
911628,2023-10-03,203,mango yogurt,50,60,10,1,00316,India
567738,2023-10-03,204,strawberry yogurt,50,60,10,1,00389,India
567738,2023-10-03,206,yakult,360,400,40,1,00389,India
567738,2023-10-03,211,red bull,90,125,35,1,00389,India
525761,2023-10-03,208,sprite,75,100,25,1,00210,India
525761,2023-10-03,212,amul cheese,250,315,65,1,00210,India
525761,2023-10-03,207,coca cola,75,100,25,1,00210,India
525761,2023-10-03,204,strawberry yogurt,50,60,10,1,00210,India
760944,2023-10-03,213,bisleri,6,15,9,1,00196,India
743176,2023-10-03,212,amul cheese,250,315,65,1,00492,India
743176,2023-10-03,204,strawberry yogurt,50,60,10,1,00492,India
743176,2023-10-03,205,classic yogurt,45,60,15,1,00492,India
146922,2023-10-03,213,bisleri,6,15,9,1,00240,India
146922,2023-10-03,210,mountain dew,75,100,25,1,00240,India
146922,2023-10-03,209,pepsi,75,100,25,1,00240,India
146922,2023-10-03,212,amul cheese,250,315,65,1,00240,India
806987,2023-10-03,201,paneer,210,340,130,1,00290,India
806987,2023-10-03,205,classic yogurt,45,60,15,1,00290,India
806987,2023-10-03,207,coca cola,75,100,25,1,00290,India
806987,2023-10-03,211,red bull,90,125,35,1,00290,India
628716,2023-10-03,211,red bull,90,125,35,1,00322,India
291931,2023-10-03,206,yakult,360,400,40,1,00450,India
291931,2023-10-03,208,sprite,75,100,25,1,00450,India
291931,2023-10-03,212,amul cheese,250,315,65,1,00450,India
309022,2023-10-03,201,paneer,210,340,130,1,00227,India
296744,2023-10-03,202,milk,12,27,15,1,00045,India
296744,2023-10-03,209,pepsi,75,100,25,1,00045,India
296744,2023-10-03,204,strawberry yogurt,50,60,10,1,00045,India
296744,2023-10-03,211,red bull,90,125,35,1,00045,India
427522,2023-10-03,204,strawberry yogurt,50,60,10,1,00179,India
427522,2023-10-03,213,bisleri,6,15,9,1,00179,India
427522,2023-10-03,201,paneer,210,340,130,1,00179,India
740088,2023-10-03,201,paneer,210,340,130,1,00435,India
740088,2023-10-03,213,bisleri,6,15,9,1,00435,India
740088,2023-10-03,202,milk,12,27,15,1,00435,India
740088,2023-10-03,205,classic yogurt,45,60,15,1,00435,India
740088,2023-10-03,210,mountain dew,75,100,25,1,00435,India
820221,2023-10-03,201,paneer,210,340,130,1,00431,India
820221,2023-10-03,208,sprite,75,100,25,1,00431,India
820221,2023-10-03,207,coca cola,75,100,25,1,00431,India
820221,2023-10-03,204,strawberry yogurt,50,60,10,1,00431,India
319775,2023-10-03,201,paneer,210,340,130,1,00166,India
319775,2023-10-03,213,bisleri,6,15,9,1,00166,India
594005,2023-10-03,203,mango yogurt,50,60,10,1,00312,India
594005,2023-10-03,212,amul cheese,250,315,65,1,00312,India
882361,2023-10-03,203,mango yogurt,50,60,10,1,00025,India
882361,2023-10-03,209,pepsi,75,100,25,1,00025,India
675783,2023-10-03,211,red bull,90,125,35,1,00408,India
675783,2023-10-03,213,bisleri,6,15,9,1,00408,India
675783,2023-10-03,208,sprite,75,100,25,1,00408,India
675783,2023-10-03,207,coca cola,75,100,25,1,00408,India
675783,2023-10-03,206,yakult,360,400,40,1,00408,India
559113,2023-10-03,212,amul cheese,250,315,65,1,00242,India
559113,2023-10-03,213,bisleri,6,15,9,1,00242,India
559113,2023-10-03,208,sprite,75,100,25,1,00242,India
893621,2023-10-03,208,sprite,75,100,25,1,00101,India
893621,2023-10-03,205,classic yogurt,45,60,15,1,00101,India
594808,2023-10-03,211,red bull,90,125,35,1,00136,India
594808,2023-10-03,202,milk,12,27,15,1,00136,India
119516,2023-10-03,207,coca cola,75,100,25,1,00249,India
119516,2023-10-03,204,strawberry yogurt,50,60,10,1,00249,India
119516,2023-10-03,210,mountain dew,75,100,25,1,00249,India
119516,2023-10-03,206,yakult,360,400,40,1,00249,India
405902,2023-10-03,207,coca cola,75,100,25,1,00310,India
405902,2023-10-03,213,bisleri,6,15,9,1,00310,India
405902,2023-10-03,203,mango yogurt,50,60,10,1,00310,India
405902,2023-10-03,210,mountain dew,75,100,25,1,00310,India
405902,2023-10-03,206,yakult,360,400,40,1,00310,India
604408,2023-10-03,213,bisleri,6,15,9,1,00426,India
604408,2023-10-03,208,sprite,75,100,25,1,00426,India
604408,2023-10-03,212,amul cheese,250,315,65,1,00426,India
604408,2023-10-03,206,yakult,360,400,40,1,00426,India
604408,2023-10-03,205,classic yogurt,45,60,15,1,00426,India
154172,2023-10-03,202,milk,12,27,15,1,00352,India
154172,2023-10-03,208,sprite,75,100,25,1,00352,India
154172,2023-10-03,209,pepsi,75,100,25,1,00352,India
154172,2023-10-03,201,paneer,210,340,130,1,00352,India
154172,2023-10-03,205,classic yogurt,45,60,15,1,00352,India
522122,2023-10-03,211,red bull,90,125,35,1,00333,India
522122,2023-10-03,212,amul cheese,250,315,65,1,00333,India
522122,2023-10-03,206,yakult,360,400,40,1,00333,India
519543,2023-10-03,209,pepsi,75,100,25,1,00133,India
187620,2023-10-03,212,amul cheese,250,315,65,1,00086,India
245823,2023-10-03,212,amul cheese,250,315,65,1,00128,India
245823,2023-10-03,206,yakult,360,400,40,1,00128,India
245823,2023-10-03,205,classic yogurt,45,60,15,1,00128,India
245823,2023-10-03,213,bisleri,6,15,9,1,00128,India
275641,2023-10-03,207,coca cola,75,100,25,1,00211,India
275641,2023-10-03,204,strawberry yogurt,50,60,10,1,00211,India
275641,2023-10-03,202,milk,12,27,15,1,00211,India
696261,2023-10-03,207,coca cola,75,100,25,1,00408,India
757005,2023-10-03,206,yakult,360,400,40,1,00017,India
501950,2023-10-03,210,mountain dew,75,100,25,1,00412,India
501950,2023-10-03,207,coca cola,75,100,25,1,00412,India
501950,2023-10-03,204,strawberry yogurt,50,60,10,1,00412,India
888200,2023-10-03,213,bisleri,6,15,9,1,00121,India
864154,2023-10-03,210,mountain dew,75,100,25,1,00392,India
864154,2023-10-03,212,amul cheese,250,315,65,1,00392,India
864154,2023-10-03,208,sprite,75,100,25,1,00392,India
947676,2023-10-03,201,paneer,210,340,130,1,00055,India
947676,2023-10-03,210,mountain dew,75,100,25,1,00055,India
199615,2023-10-03,204,strawberry yogurt,50,60,10,1,00006,India
199615,2023-10-03,201,paneer,210,340,130,1,00006,India
199615,2023-10-03,210,mountain dew,75,100,25,1,00006,India
199615,2023-10-03,209,pepsi,75,100,25,1,00006,India
617417,2023-10-03,207,coca cola,75,100,25,1,00351,India
617417,2023-10-03,203,mango yogurt,50,60,10,1,00351,India
617417,2023-10-03,202,milk,12,27,15,1,00351,India
617417,2023-10-03,204,strawberry yogurt,50,60,10,1,00351,India
878409,2023-10-03,203,mango yogurt,50,60,10,1,00345,India
878409,2023-10-03,207,coca cola,75,100,25,1,00345,India
878409,2023-10-03,209,pepsi,75,100,25,1,00345,India
746492,2023-10-03,209,pepsi,75,100,25,1,00326,India
746492,2023-10-03,213,bisleri,6,15,9,1,00326,India
980239,2023-10-03,211,red bull,90,125,35,1,00218,India
980239,2023-10-03,210,mountain dew,75,100,25,1,00218,India
980239,2023-10-03,213,bisleri,6,15,9,1,00218,India
980239,2023-10-03,206,yakult,360,400,40,1,00218,India
251484,2023-10-03,209,pepsi,75,100,25,1,00098,India
251484,2023-10-03,212,amul cheese,250,315,65,1,00098,India
684467,2023-10-03,205,classic yogurt,45,60,15,1,00139,India
770217,2023-10-03,212,amul cheese,250,315,65,1,00103,India
770217,2023-10-03,205,classic yogurt,45,60,15,1,00103,India
786333,2023-10-03,211,red bull,90,125,35,1,00323,India
786333,2023-10-03,204,strawberry yogurt,50,60,10,1,00323,India
214219,2023-10-03,205,classic yogurt,45,60,15,1,00205,India
214219,2023-10-03,202,milk,12,27,15,1,00205,India
214219,2023-10-03,210,mountain dew,75,100,25,1,00205,India
974242,2023-10-03,210,mountain dew,75,100,25,1,00428,India
974242,2023-10-03,204,strawberry yogurt,50,60,10,1,00428,India
974242,2023-10-03,205,classic yogurt,45,60,15,1,00428,India
974242,2023-10-03,212,amul cheese,250,315,65,1,00428,India
974242,2023-10-03,207,coca cola,75,100,25,1,00428,India
225341,2023-10-03,211,red bull,90,125,35,1,00151,India
225341,2023-10-03,212,amul cheese,250,315,65,1,00151,India
794108,2023-10-03,213,bisleri,6,15,9,1,00122,India
794108,2023-10-03,201,paneer,210,340,130,1,00122,India
280724,2023-10-03,203,mango yogurt,50,60,10,1,00226,India
280724,2023-10-03,209,pepsi,75,100,25,1,00226,India
366982,2023-10-04,207,coca cola,75,100,25,1,00111,India
995798,2023-10-04,201,paneer,210,340,130,1,00214,India
995798,2023-10-04,211,red bull,90,125,35,1,00214,India
995798,2023-10-04,209,pepsi,75,100,25,1,00214,India
690810,2023-10-04,204,strawberry yogurt,50,60,10,1,00342,India
690810,2023-10-04,211,red bull,90,125,35,1,00342,India
641012,2023-10-04,204,strawberry yogurt,50,60,10,1,00387,India
641012,2023-10-04,205,classic yogurt,45,60,15,1,00387,India
241312,2023-10-04,213,bisleri,6,15,9,1,00473,India
241312,2023-10-04,208,sprite,75,100,25,1,00473,India
241312,2023-10-04,207,coca cola,75,100,25,1,00473,India
241312,2023-10-04,202,milk,12,27,15,1,00473,India
264253,2023-10-04,202,milk,12,27,15,1,00439,India
145200,2023-10-04,207,coca cola,75,100,25,1,00001,India
145200,2023-10-04,201,paneer,210,340,130,1,00001,India
365626,2023-10-04,203,mango yogurt,50,60,10,1,00147,India
365626,2023-10-04,204,strawberry yogurt,50,60,10,1,00147,India
344805,2023-10-04,205,classic yogurt,45,60,15,1,00094,India
816882,2023-10-04,202,milk,12,27,15,1,00467,India
816882,2023-10-04,209,pepsi,75,100,25,1,00467,India
816882,2023-10-04,213,bisleri,6,15,9,1,00467,India
816882,2023-10-04,201,paneer,210,340,130,1,00467,India
821396,2023-10-04,206,yakult,360,400,40,1,00197,India
821396,2023-10-04,201,paneer,210,340,130,1,00197,India
783898,2023-10-04,206,yakult,360,400,40,1,00210,India
730228,2023-10-04,206,yakult,360,400,40,1,00165,India
730228,2023-10-04,210,mountain dew,75,100,25,1,00165,India
730228,2023-10-04,201,paneer,210,340,130,1,00165,India
730228,2023-10-04,204,strawberry yogurt,50,60,10,1,00165,India
730228,2023-10-04,203,mango yogurt,50,60,10,1,00165,India
279906,2023-10-04,209,pepsi,75,100,25,1,00135,India
279906,2023-10-04,204,strawberry yogurt,50,60,10,1,00135,India
279906,2023-10-04,211,red bull,90,125,35,1,00135,India
120918,2023-10-04,202,milk,12,27,15,1,00395,India
117052,2023-10-04,205,classic yogurt,45,60,15,1,00333,India
117052,2023-10-04,208,sprite,75,100,25,1,00333,India
117052,2023-10-04,212,amul cheese,250,315,65,1,00333,India
117052,2023-10-04,210,mountain dew,75,100,25,1,00333,India
212812,2023-10-04,205,classic yogurt,45,60,15,1,00122,India
212812,2023-10-04,213,bisleri,6,15,9,1,00122,India
212812,2023-10-04,212,amul cheese,250,315,65,1,00122,India
212812,2023-10-04,203,mango yogurt,50,60,10,1,00122,India
565878,2023-10-04,209,pepsi,75,100,25,1,00275,India
445494,2023-10-04,201,paneer,210,340,130,1,00313,India
445494,2023-10-04,206,yakult,360,400,40,1,00313,India
445494,2023-10-04,207,coca cola,75,100,25,1,00313,India
445494,2023-10-04,212,amul cheese,250,315,65,1,00313,India
773206,2023-10-04,212,amul cheese,250,315,65,1,00312,India
773206,2023-10-04,201,paneer,210,340,130,1,00312,India
799769,2023-10-04,213,bisleri,6,15,9,1,00250,India
799769,2023-10-04,202,milk,12,27,15,1,00250,India
799769,2023-10-04,206,yakult,360,400,40,1,00250,India
395872,2023-10-04,205,classic yogurt,45,60,15,1,00187,India
395872,2023-10-04,207,coca cola,75,100,25,1,00187,India
395872,2023-10-04,204,strawberry yogurt,50,60,10,1,00187,India
395872,2023-10-04,201,paneer,210,340,130,1,00187,India
106973,2023-10-04,210,mountain dew,75,100,25,1,00494,India
106973,2023-10-04,209,pepsi,75,100,25,1,00494,India
106973,2023-10-04,206,yakult,360,400,40,1,00494,India
106973,2023-10-04,213,bisleri,6,15,9,1,00494,India
930080,2023-10-04,207,coca cola,75,100,25,1,00429,India
930080,2023-10-04,210,mountain dew,75,100,25,1,00429,India
498222,2023-10-04,212,amul cheese,250,315,65,1,00308,India
498222,2023-10-04,203,mango yogurt,50,60,10,1,00308,India
498222,2023-10-04,207,coca cola,75,100,25,1,00308,India
498222,2023-10-04,201,paneer,210,340,130,1,00308,India
582879,2023-10-04,207,coca cola,75,100,25,1,00028,India
582879,2023-10-04,212,amul cheese,250,315,65,1,00028,India
582879,2023-10-04,203,mango yogurt,50,60,10,1,00028,India
281655,2023-10-04,209,pepsi,75,100,25,1,00043,India
333954,2023-10-04,207,coca cola,75,100,25,1,00489,India
333954,2023-10-04,203,mango yogurt,50,60,10,1,00489,India
333954,2023-10-04,213,bisleri,6,15,9,1,00489,India
211882,2023-10-04,211,red bull,90,125,35,1,00136,India
211882,2023-10-04,203,mango yogurt,50,60,10,1,00136,India
502065,2023-10-04,206,yakult,360,400,40,1,00395,India
502065,2023-10-04,213,bisleri,6,15,9,1,00395,India
502065,2023-10-04,211,red bull,90,125,35,1,00395,India
502065,2023-10-04,212,amul cheese,250,315,65,1,00395,India
883280,2023-10-04,201,paneer,210,340,130,1,00133,India
883280,2023-10-04,208,sprite,75,100,25,1,00133,India
909177,2023-10-04,212,amul cheese,250,315,65,1,00421,India
909177,2023-10-04,213,bisleri,6,15,9,1,00421,India
909177,2023-10-04,211,red bull,90,125,35,1,00421,India
983842,2023-10-04,209,pepsi,75,100,25,1,00039,India
983842,2023-10-04,206,yakult,360,400,40,1,00039,India
842672,2023-10-04,206,yakult,360,400,40,1,00490,India
842672,2023-10-04,210,mountain dew,75,100,25,1,00490,India
753886,2023-10-04,208,sprite,75,100,25,1,00371,India
753886,2023-10-04,201,paneer,210,340,130,1,00371,India
470522,2023-10-04,208,sprite,75,100,25,1,00025,India
470522,2023-10-04,213,bisleri,6,15,9,1,00025,India
470522,2023-10-04,204,strawberry yogurt,50,60,10,1,00025,India
470522,2023-10-04,203,mango yogurt,50,60,10,1,00025,India
332124,2023-10-04,212,amul cheese,250,315,65,1,00063,India
332124,2023-10-04,206,yakult,360,400,40,1,00063,India
332124,2023-10-04,208,sprite,75,100,25,1,00063,India
332124,2023-10-04,205,classic yogurt,45,60,15,1,00063,India
350379,2023-10-04,211,red bull,90,125,35,1,00319,India
350379,2023-10-04,205,classic yogurt,45,60,15,1,00319,India
977075,2023-10-04,201,paneer,210,340,130,1,00424,India
977075,2023-10-04,205,classic yogurt,45,60,15,1,00424,India
977075,2023-10-04,207,coca cola,75,100,25,1,00424,India
977075,2023-10-04,208,sprite,75,100,25,1,00424,India
376096,2023-10-04,211,red bull,90,125,35,1,00195,India
376096,2023-10-04,202,milk,12,27,15,1,00195,India
376096,2023-10-04,208,sprite,75,100,25,1,00195,India
376096,2023-10-04,207,coca cola,75,100,25,1,00195,India
252574,2023-10-04,207,coca cola,75,100,25,1,00274,India
252574,2023-10-04,210,mountain dew,75,100,25,1,00274,India
252574,2023-10-04,212,amul cheese,250,315,65,1,00274,India
252574,2023-10-04,208,sprite,75,100,25,1,00274,India
252574,2023-10-04,202,milk,12,27,15,1,00274,India
621448,2023-10-04,204,strawberry yogurt,50,60,10,1,00148,India
621448,2023-10-04,213,bisleri,6,15,9,1,00148,India
621448,2023-10-04,206,yakult,360,400,40,1,00148,India
589834,2023-10-04,205,classic yogurt,45,60,15,1,00327,India
589834,2023-10-04,208,sprite,75,100,25,1,00327,India
552340,2023-10-04,205,classic yogurt,45,60,15,1,00180,India
552340,2023-10-04,202,milk,12,27,15,1,00180,India
552340,2023-10-04,203,mango yogurt,50,60,10,1,00180,India
552340,2023-10-04,213,bisleri,6,15,9,1,00180,India
552340,2023-10-04,210,mountain dew,75,100,25,1,00180,India
566777,2023-10-04,201,paneer,210,340,130,1,00466,India
566777,2023-10-04,204,strawberry yogurt,50,60,10,1,00466,India
566777,2023-10-04,210,mountain dew,75,100,25,1,00466,India
566777,2023-10-04,211,red bull,90,125,35,1,00466,India
800716,2023-10-04,201,paneer,210,340,130,1,00210,India
800716,2023-10-04,203,mango yogurt,50,60,10,1,00210,India
990615,2023-10-04,202,milk,12,27,15,1,00185,India
990615,2023-10-04,205,classic yogurt,45,60,15,1,00185,India
990615,2023-10-04,212,amul cheese,250,315,65,1,00185,India
740926,2023-10-04,202,milk,12,27,15,1,00010,India
658741,2023-10-04,207,coca cola,75,100,25,1,00331,India
658741,2023-10-04,205,classic yogurt,45,60,15,1,00331,India
658741,2023-10-04,208,sprite,75,100,25,1,00331,India
658741,2023-10-04,203,mango yogurt,50,60,10,1,00331,India
435008,2023-10-04,201,paneer,210,340,130,1,00155,India
435008,2023-10-04,204,strawberry yogurt,50,60,10,1,00155,India
120589,2023-10-04,207,coca cola,75,100,25,1,00222,India
120589,2023-10-04,205,classic yogurt,45,60,15,1,00222,India
120589,2023-10-04,209,pepsi,75,100,25,1,00222,India
959656,2023-10-04,204,strawberry yogurt,50,60,10,1,00096,India
959656,2023-10-04,203,mango yogurt,50,60,10,1,00096,India
959656,2023-10-04,209,pepsi,75,100,25,1,00096,India
959656,2023-10-04,208,sprite,75,100,25,1,00096,India
983027,2023-10-04,202,milk,12,27,15,1,00493,India
220054,2023-10-04,210,mountain dew,75,100,25,1,00166,India
220054,2023-10-04,212,amul cheese,250,315,65,1,00166,India
220054,2023-10-04,206,yakult,360,400,40,1,00166,India
220054,2023-10-04,205,classic yogurt,45,60,15,1,00166,India
277265,2023-10-04,206,yakult,360,400,40,1,00018,India
277265,2023-10-04,201,paneer,210,340,130,1,00018,India
277265,2023-10-04,205,classic yogurt,45,60,15,1,00018,India
815097,2023-10-04,202,milk,12,27,15,1,00037,India
173945,2023-10-04,213,bisleri,6,15,9,1,00015,India
173945,2023-10-04,208,sprite,75,100,25,1,00015,India
173945,2023-10-04,201,paneer,210,340,130,1,00015,India
173945,2023-10-04,202,milk,12,27,15,1,00015,India
141571,2023-10-04,206,yakult,360,400,40,1,00407,India
141571,2023-10-04,207,coca cola,75,100,25,1,00407,India
141571,2023-10-04,210,mountain dew,75,100,25,1,00407,India
256299,2023-10-04,207,coca cola,75,100,25,1,00223,India
256299,2023-10-04,202,milk,12,27,15,1,00223,India
256299,2023-10-04,205,classic yogurt,45,60,15,1,00223,India
256299,2023-10-04,210,mountain dew,75,100,25,1,00223,India
196455,2023-10-04,209,pepsi,75,100,25,1,00238,India
196455,2023-10-04,205,classic yogurt,45,60,15,1,00238,India
196455,2023-10-04,210,mountain dew,75,100,25,1,00238,India
196455,2023-10-04,213,bisleri,6,15,9,1,00238,India
534333,2023-10-04,206,yakult,360,400,40,1,00040,India
534333,2023-10-04,205,classic yogurt,45,60,15,1,00040,India
294691,2023-10-04,213,bisleri,6,15,9,1,00106,India
294691,2023-10-04,204,strawberry yogurt,50,60,10,1,00106,India
654504,2023-10-04,207,coca cola,75,100,25,1,00254,India
941740,2023-10-04,209,pepsi,75,100,25,1,00291,India
941740,2023-10-04,208,sprite,75,100,25,1,00291,India
941740,2023-10-04,211,red bull,90,125,35,1,00291,India
941740,2023-10-04,212,amul cheese,250,315,65,1,00291,India
150152,2023-10-04,207,coca cola,75,100,25,1,00066,India
150152,2023-10-04,210,mountain dew,75,100,25,1,00066,India
150152,2023-10-04,202,milk,12,27,15,1,00066,India
105333,2023-10-04,207,coca cola,75,100,25,1,00036,India
958288,2023-10-04,210,mountain dew,75,100,25,1,00218,India
958288,2023-10-04,211,red bull,90,125,35,1,00218,India
500708,2023-10-04,212,amul cheese,250,315,65,1,00357,India
500708,2023-10-04,204,strawberry yogurt,50,60,10,1,00357,India
500708,2023-10-04,206,yakult,360,400,40,1,00357,India
500708,2023-10-04,211,red bull,90,125,35,1,00357,India
584466,2023-10-04,205,classic yogurt,45,60,15,1,00001,India
591667,2023-10-04,213,bisleri,6,15,9,1,00374,India
591667,2023-10-04,211,red bull,90,125,35,1,00374,India
591667,2023-10-04,206,yakult,360,400,40,1,00374,India
591667,2023-10-04,209,pepsi,75,100,25,1,00374,India
591667,2023-10-04,202,milk,12,27,15,1,00374,India
940634,2023-10-04,206,yakult,360,400,40,1,00081,India
940634,2023-10-04,208,sprite,75,100,25,1,00081,India
506085,2023-10-04,205,classic yogurt,45,60,15,1,00081,India
506085,2023-10-04,210,mountain dew,75,100,25,1,00081,India
506085,2023-10-04,212,amul cheese,250,315,65,1,00081,India
506085,2023-10-04,203,mango yogurt,50,60,10,1,00081,India
688567,2023-10-04,209,pepsi,75,100,25,1,00422,India
688567,2023-10-04,205,classic yogurt,45,60,15,1,00422,India
688567,2023-10-04,203,mango yogurt,50,60,10,1,00422,India
688567,2023-10-04,210,mountain dew,75,100,25,1,00422,India
993672,2023-10-04,202,milk,12,27,15,1,00111,India
993672,2023-10-04,210,mountain dew,75,100,25,1,00111,India
180063,2023-10-04,213,bisleri,6,15,9,1,00040,India
180063,2023-10-04,203,mango yogurt,50,60,10,1,00040,India
396251,2023-10-04,211,red bull,90,125,35,1,00012,India
396251,2023-10-04,213,bisleri,6,15,9,1,00012,India
886762,2023-10-04,213,bisleri,6,15,9,1,00330,India
686030,2023-10-04,202,milk,12,27,15,1,00233,India
686030,2023-10-04,212,amul cheese,250,315,65,1,00233,India
134880,2023-10-04,205,classic yogurt,45,60,15,1,00135,India
123668,2023-10-04,203,mango yogurt,50,60,10,1,00477,India
123668,2023-10-04,204,strawberry yogurt,50,60,10,1,00477,India
123668,2023-10-04,209,pepsi,75,100,25,1,00477,India
123668,2023-10-04,208,sprite,75,100,25,1,00477,India
390940,2023-10-04,207,coca cola,75,100,25,1,00332,India
774125,2023-10-04,212,amul cheese,250,315,65,1,00382,India
774125,2023-10-04,213,bisleri,6,15,9,1,00382,India
774125,2023-10-04,202,milk,12,27,15,1,00382,India
164737,2023-10-04,201,paneer,210,340,130,1,00434,India
164737,2023-10-04,206,yakult,360,400,40,1,00434,India
802796,2023-10-04,213,bisleri,6,15,9,1,00234,India
483975,2023-10-04,202,milk,12,27,15,1,00411,India
483975,2023-10-04,213,bisleri,6,15,9,1,00411,India
273864,2023-10-04,203,mango yogurt,50,60,10,1,00322,India
273864,2023-10-04,209,pepsi,75,100,25,1,00322,India
273864,2023-10-04,201,paneer,210,340,130,1,00322,India
931254,2023-10-04,210,mountain dew,75,100,25,1,00335,India
405188,2023-10-04,210,mountain dew,75,100,25,1,00435,India
405188,2023-10-04,209,pepsi,75,100,25,1,00435,India
261345,2023-10-04,208,sprite,75,100,25,1,00272,India
354126,2023-10-05,208,sprite,75,100,25,1,00368,India
354126,2023-10-05,201,paneer,210,340,130,1,00368,India
354126,2023-10-05,202,milk,12,27,15,1,00368,India
354126,2023-10-05,209,pepsi,75,100,25,1,00368,India
208014,2023-10-05,202,milk,12,27,15,1,00374,India
208014,2023-10-05,212,amul cheese,250,315,65,1,00374,India
208014,2023-10-05,213,bisleri,6,15,9,1,00374,India
208014,2023-10-05,204,strawberry yogurt,50,60,10,1,00374,India
960831,2023-10-05,213,bisleri,6,15,9,1,00165,India
960831,2023-10-05,209,pepsi,75,100,25,1,00165,India
587328,2023-10-05,207,coca cola,75,100,25,1,00385,India
587328,2023-10-05,204,strawberry yogurt,50,60,10,1,00385,India
587328,2023-10-05,212,amul cheese,250,315,65,1,00385,India
587328,2023-10-05,202,milk,12,27,15,1,00385,India
811376,2023-10-05,209,pepsi,75,100,25,1,00097,India
811376,2023-10-05,201,paneer,210,340,130,1,00097,India
214478,2023-10-05,201,paneer,210,340,130,1,00466,India
214478,2023-10-05,212,amul cheese,250,315,65,1,00466,India
214478,2023-10-05,205,classic yogurt,45,60,15,1,00466,India
499404,2023-10-05,211,red bull,90,125,35,1,00166,India
499404,2023-10-05,205,classic yogurt,45,60,15,1,00166,India
834100,2023-10-05,203,mango yogurt,50,60,10,1,00308,India
834100,2023-10-05,205,classic yogurt,45,60,15,1,00308,India
487736,2023-10-05,209,pepsi,75,100,25,1,00135,India
487736,2023-10-05,211,red bull,90,125,35,1,00135,India
656052,2023-10-05,208,sprite,75,100,25,1,00364,India
656052,2023-10-05,210,mountain dew,75,100,25,1,00364,India
656052,2023-10-05,205,classic yogurt,45,60,15,1,00364,India
656052,2023-10-05,212,amul cheese,250,315,65,1,00364,India
961272,2023-10-05,213,bisleri,6,15,9,1,00019,India
961272,2023-10-05,206,yakult,360,400,40,1,00019,India
961272,2023-10-05,201,paneer,210,340,130,1,00019,India
961272,2023-10-05,204,strawberry yogurt,50,60,10,1,00019,India
421878,2023-10-05,213,bisleri,6,15,9,1,00359,India
386355,2023-10-05,202,milk,12,27,15,1,00012,India
386355,2023-10-05,203,mango yogurt,50,60,10,1,00012,India
386355,2023-10-05,208,sprite,75,100,25,1,00012,India
757521,2023-10-05,211,red bull,90,125,35,1,00200,India
757521,2023-10-05,209,pepsi,75,100,25,1,00200,India
757521,2023-10-05,203,mango yogurt,50,60,10,1,00200,India
757521,2023-10-05,210,mountain dew,75,100,25,1,00200,India
757521,2023-10-05,206,yakult,360,400,40,1,00200,India
252267,2023-10-05,207,coca cola,75,100,25,1,00072,India
252267,2023-10-05,208,sprite,75,100,25,1,00072,India
252267,2023-10-05,206,yakult,360,400,40,1,00072,India
280354,2023-10-05,210,mountain dew,75,100,25,1,00004,India
280354,2023-10-05,205,classic yogurt,45,60,15,1,00004,India
280354,2023-10-05,212,amul cheese,250,315,65,1,00004,India
280354,2023-10-05,201,paneer,210,340,130,1,00004,India
952771,2023-10-05,208,sprite,75,100,25,1,00385,India
952771,2023-10-05,209,pepsi,75,100,25,1,00385,India
176528,2023-10-05,213,bisleri,6,15,9,1,00212,India
176528,2023-10-05,212,amul cheese,250,315,65,1,00212,India
176528,2023-10-05,211,red bull,90,125,35,1,00212,India
649814,2023-10-05,205,classic yogurt,45,60,15,1,00036,India
649814,2023-10-05,210,mountain dew,75,100,25,1,00036,India
649814,2023-10-05,213,bisleri,6,15,9,1,00036,India
649814,2023-10-05,204,strawberry yogurt,50,60,10,1,00036,India
590879,2023-10-05,208,sprite,75,100,25,1,00242,India
453139,2023-10-05,204,strawberry yogurt,50,60,10,1,00010,India
453139,2023-10-05,212,amul cheese,250,315,65,1,00010,India
453139,2023-10-05,206,yakult,360,400,40,1,00010,India
453139,2023-10-05,208,sprite,75,100,25,1,00010,India
941973,2023-10-05,203,mango yogurt,50,60,10,1,00059,India
941973,2023-10-05,205,classic yogurt,45,60,15,1,00059,India
941973,2023-10-05,211,red bull,90,125,35,1,00059,India
941973,2023-10-05,204,strawberry yogurt,50,60,10,1,00059,India
258776,2023-10-05,211,red bull,90,125,35,1,00320,India
258776,2023-10-05,201,paneer,210,340,130,1,00320,India
258776,2023-10-05,208,sprite,75,100,25,1,00320,India
258776,2023-10-05,207,coca cola,75,100,25,1,00320,India
198529,2023-10-05,213,bisleri,6,15,9,1,00008,India
198529,2023-10-05,208,sprite,75,100,25,1,00008,India
198529,2023-10-05,209,pepsi,75,100,25,1,00008,India
935553,2023-10-05,210,mountain dew,75,100,25,1,00394,India
868431,2023-10-05,213,bisleri,6,15,9,1,00190,India
868431,2023-10-05,211,red bull,90,125,35,1,00190,India
868431,2023-10-05,205,classic yogurt,45,60,15,1,00190,India
372973,2023-10-05,210,mountain dew,75,100,25,1,00234,India
372973,2023-10-05,204,strawberry yogurt,50,60,10,1,00234,India
372973,2023-10-05,202,milk,12,27,15,1,00234,India
372973,2023-10-05,213,bisleri,6,15,9,1,00234,India
372973,2023-10-05,208,sprite,75,100,25,1,00234,India
381481,2023-10-05,212,amul cheese,250,315,65,1,00143,India
220256,2023-10-05,213,bisleri,6,15,9,1,00370,India
220256,2023-10-05,212,amul cheese,250,315,65,1,00370,India
220256,2023-10-05,211,red bull,90,125,35,1,00370,India
500827,2023-10-05,204,strawberry yogurt,50,60,10,1,00191,India
634525,2023-10-05,211,red bull,90,125,35,1,00395,India
634525,2023-10-05,204,strawberry yogurt,50,60,10,1,00395,India
634525,2023-10-05,209,pepsi,75,100,25,1,00395,India
634525,2023-10-05,203,mango yogurt,50,60,10,1,00395,India
634525,2023-10-05,212,amul cheese,250,315,65,1,00395,India
100320,2023-10-05,208,sprite,75,100,25,1,00455,India
100320,2023-10-05,209,pepsi,75,100,25,1,00455,India
870176,2023-10-05,208,sprite,75,100,25,1,00420,India
870176,2023-10-05,212,amul cheese,250,315,65,1,00420,India
870176,2023-10-05,204,strawberry yogurt,50,60,10,1,00420,India
350470,2023-10-05,203,mango yogurt,50,60,10,1,00408,India
350470,2023-10-05,202,milk,12,27,15,1,00408,India
755334,2023-10-05,201,paneer,210,340,130,1,00105,India
543033,2023-10-05,205,classic yogurt,45,60,15,1,00319,India
543033,2023-10-05,201,paneer,210,340,130,1,00319,India
543033,2023-10-05,206,yakult,360,400,40,1,00319,India
543033,2023-10-05,202,milk,12,27,15,1,00319,India
543033,2023-10-05,212,amul cheese,250,315,65,1,00319,India
415640,2023-10-05,210,mountain dew,75,100,25,1,00216,India
415640,2023-10-05,208,sprite,75,100,25,1,00216,India
415640,2023-10-05,205,classic yogurt,45,60,15,1,00216,India
783907,2023-10-05,202,milk,12,27,15,1,00123,India
359540,2023-10-05,205,classic yogurt,45,60,15,1,00370,India
359540,2023-10-05,210,mountain dew,75,100,25,1,00370,India
789773,2023-10-05,212,amul cheese,250,315,65,1,00300,India
981603,2023-10-05,205,classic yogurt,45,60,15,1,00472,India
235694,2023-10-05,201,paneer,210,340,130,1,00179,India
235694,2023-10-05,205,classic yogurt,45,60,15,1,00179,India
609008,2023-10-05,206,yakult,360,400,40,1,00400,India
609008,2023-10-05,213,bisleri,6,15,9,1,00400,India
609008,2023-10-05,201,paneer,210,340,130,1,00400,India
609008,2023-10-05,209,pepsi,75,100,25,1,00400,India
171938,2023-10-05,210,mountain dew,75,100,25,1,00034,India
171938,2023-10-05,201,paneer,210,340,130,1,00034,India
171938,2023-10-05,207,coca cola,75,100,25,1,00034,India
171938,2023-10-05,212,amul cheese,250,315,65,1,00034,India
171938,2023-10-05,208,sprite,75,100,25,1,00034,India
913349,2023-10-05,211,red bull,90,125,35,1,00410,India
913349,2023-10-05,202,milk,12,27,15,1,00410,India
913349,2023-10-05,207,coca cola,75,100,25,1,00410,India
913349,2023-10-05,212,amul cheese,250,315,65,1,00410,India
861279,2023-10-05,207,coca cola,75,100,25,1,00119,India
861279,2023-10-05,206,yakult,360,400,40,1,00119,India
413753,2023-10-05,202,milk,12,27,15,1,00260,India
315062,2023-10-05,203,mango yogurt,50,60,10,1,00055,India
315062,2023-10-05,209,pepsi,75,100,25,1,00055,India
512307,2023-10-05,210,mountain dew,75,100,25,1,00105,India
938242,2023-10-05,210,mountain dew,75,100,25,1,00406,India
938242,2023-10-05,208,sprite,75,100,25,1,00406,India
938242,2023-10-05,202,milk,12,27,15,1,00406,India
938242,2023-10-05,201,paneer,210,340,130,1,00406,India
994871,2023-10-05,210,mountain dew,75,100,25,1,00021,India
994871,2023-10-05,203,mango yogurt,50,60,10,1,00021,India
994871,2023-10-05,207,coca cola,75,100,25,1,00021,India
994871,2023-10-05,209,pepsi,75,100,25,1,00021,India
994871,2023-10-05,212,amul cheese,250,315,65,1,00021,India
156500,2023-10-05,211,red bull,90,125,35,1,00129,India
156500,2023-10-05,202,milk,12,27,15,1,00129,India
156500,2023-10-05,209,pepsi,75,100,25,1,00129,India
156500,2023-10-05,208,sprite,75,100,25,1,00129,India
855955,2023-10-05,212,amul cheese,250,315,65,1,00316,India
855955,2023-10-05,201,paneer,210,340,130,1,00316,India
855955,2023-10-05,205,classic yogurt,45,60,15,1,00316,India
989756,2023-10-05,208,sprite,75,100,25,1,00376,India
989756,2023-10-05,211,red bull,90,125,35,1,00376,India
989756,2023-10-05,201,paneer,210,340,130,1,00376,India
989756,2023-10-05,210,mountain dew,75,100,25,1,00376,India
643222,2023-10-05,213,bisleri,6,15,9,1,00208,India
643222,2023-10-05,205,classic yogurt,45,60,15,1,00208,India
643222,2023-10-05,210,mountain dew,75,100,25,1,00208,India
494594,2023-10-05,212,amul cheese,250,315,65,1,00396,India
630854,2023-10-05,208,sprite,75,100,25,1,00471,India
630854,2023-10-05,207,coca cola,75,100,25,1,00471,India
630854,2023-10-05,209,pepsi,75,100,25,1,00471,India
630854,2023-10-05,212,amul cheese,250,315,65,1,00471,India
189580,2023-10-05,203,mango yogurt,50,60,10,1,00430,India
189580,2023-10-05,208,sprite,75,100,25,1,00430,India
189580,2023-10-05,207,coca cola,75,100,25,1,00430,India
189580,2023-10-05,205,classic yogurt,45,60,15,1,00430,India
811425,2023-10-05,208,sprite,75,100,25,1,00165,India
544801,2023-10-05,210,mountain dew,75,100,25,1,00326,India
569123,2023-10-05,210,mountain dew,75,100,25,1,00392,India
569123,2023-10-05,203,mango yogurt,50,60,10,1,00392,India
569123,2023-10-05,213,bisleri,6,15,9,1,00392,India
569123,2023-10-05,211,red bull,90,125,35,1,00392,India
167900,2023-10-05,201,paneer,210,340,130,1,00455,India
167900,2023-10-05,204,strawberry yogurt,50,60,10,1,00455,India
167900,2023-10-05,213,bisleri,6,15,9,1,00455,India
351566,2023-10-05,201,paneer,210,340,130,1,00407,India
665799,2023-10-05,213,bisleri,6,15,9,1,00014,India
665799,2023-10-05,202,milk,12,27,15,1,00014,India
926896,2023-10-05,205,classic yogurt,45,60,15,1,00089,India
926896,2023-10-05,211,red bull,90,125,35,1,00089,India
926896,2023-10-05,210,mountain dew,75,100,25,1,00089,India
926896,2023-10-05,206,yakult,360,400,40,1,00089,India
657183,2023-10-05,211,red bull,90,125,35,1,00245,India
657183,2023-10-05,202,milk,12,27,15,1,00245,India
657183,2023-10-05,212,amul cheese,250,315,65,1,00245,India
879875,2023-10-05,213,bisleri,6,15,9,1,00071,India
879875,2023-10-05,203,mango yogurt,50,60,10,1,00071,India
879875,2023-10-05,212,amul cheese,250,315,65,1,00071,India
879875,2023-10-05,211,red bull,90,125,35,1,00071,India
879875,2023-10-05,207,coca cola,75,100,25,1,00071,India
985296,2023-10-05,203,mango yogurt,50,60,10,1,00034,India
337506,2023-10-05,211,red bull,90,125,35,1,00089,India
337506,2023-10-05,210,mountain dew,75,100,25,1,00089,India
337506,2023-10-05,212,amul cheese,250,315,65,1,00089,India
337506,2023-10-05,208,sprite,75,100,25,1,00089,India
840924,2023-10-06,212,amul cheese,250,315,65,1,00455,India
840924,2023-10-06,204,strawberry yogurt,50,60,10,1,00455,India
840924,2023-10-06,206,yakult,360,400,40,1,00455,India
840924,2023-10-06,201,paneer,210,340,130,1,00455,India
603011,2023-10-06,211,red bull,90,125,35,1,00097,India
603011,2023-10-06,210,mountain dew,75,100,25,1,00097,India
603011,2023-10-06,204,strawberry yogurt,50,60,10,1,00097,India
603011,2023-10-06,208,sprite,75,100,25,1,00097,India
603011,2023-10-06,203,mango yogurt,50,60,10,1,00097,India
245566,2023-10-06,202,milk,12,27,15,1,00351,India
245566,2023-10-06,210,mountain dew,75,100,25,1,00351,India
976520,2023-10-06,205,classic yogurt,45,60,15,1,00317,India
660768,2023-10-06,203,mango yogurt,50,60,10,1,00457,India
660768,2023-10-06,201,paneer,210,340,130,1,00457,India
310343,2023-10-06,210,mountain dew,75,100,25,1,00350,India
310343,2023-10-06,213,bisleri,6,15,9,1,00350,India
310343,2023-10-06,212,amul cheese,250,315,65,1,00350,India
310343,2023-10-06,209,pepsi,75,100,25,1,00350,India
185934,2023-10-06,204,strawberry yogurt,50,60,10,1,00217,India
420479,2023-10-06,211,red bull,90,125,35,1,00246,India
420479,2023-10-06,203,mango yogurt,50,60,10,1,00246,India
458426,2023-10-06,207,coca cola,75,100,25,1,00300,India
458426,2023-10-06,202,milk,12,27,15,1,00300,India
458426,2023-10-06,208,sprite,75,100,25,1,00300,India
158603,2023-10-06,208,sprite,75,100,25,1,00356,India
650871,2023-10-06,201,paneer,210,340,130,1,00378,India
650871,2023-10-06,212,amul cheese,250,315,65,1,00378,India
650871,2023-10-06,203,mango yogurt,50,60,10,1,00378,India
858473,2023-10-06,207,coca cola,75,100,25,1,00172,India
858473,2023-10-06,206,yakult,360,400,40,1,00172,India
858473,2023-10-06,202,milk,12,27,15,1,00172,India
402997,2023-10-06,205,classic yogurt,45,60,15,1,00132,India
402997,2023-10-06,204,strawberry yogurt,50,60,10,1,00132,India
402997,2023-10-06,206,yakult,360,400,40,1,00132,India
321124,2023-10-06,201,paneer,210,340,130,1,00386,India
641857,2023-10-06,203,mango yogurt,50,60,10,1,00168,India
641857,2023-10-06,202,milk,12,27,15,1,00168,India
641857,2023-10-06,213,bisleri,6,15,9,1,00168,India
641857,2023-10-06,210,mountain dew,75,100,25,1,00168,India
776792,2023-10-06,209,pepsi,75,100,25,1,00303,India
776792,2023-10-06,205,classic yogurt,45,60,15,1,00303,India
776792,2023-10-06,208,sprite,75,100,25,1,00303,India
776792,2023-10-06,207,coca cola,75,100,25,1,00303,India
707205,2023-10-06,207,coca cola,75,100,25,1,00053,India
172583,2023-10-06,212,amul cheese,250,315,65,1,00295,India
172583,2023-10-06,209,pepsi,75,100,25,1,00295,India
172583,2023-10-06,207,coca cola,75,100,25,1,00295,India
258352,2023-10-06,212,amul cheese,250,315,65,1,00361,India
258352,2023-10-06,210,mountain dew,75,100,25,1,00361,India
258352,2023-10-06,203,mango yogurt,50,60,10,1,00361,India
258352,2023-10-06,205,classic yogurt,45,60,15,1,00361,India
905424,2023-10-06,207,coca cola,75,100,25,1,00357,India
905424,2023-10-06,209,pepsi,75,100,25,1,00357,India
905424,2023-10-06,206,yakult,360,400,40,1,00357,India
556656,2023-10-06,209,pepsi,75,100,25,1,00080,India
556656,2023-10-06,211,red bull,90,125,35,1,00080,India
556656,2023-10-06,210,mountain dew,75,100,25,1,00080,India
556656,2023-10-06,206,yakult,360,400,40,1,00080,India
556656,2023-10-06,208,sprite,75,100,25,1,00080,India
139173,2023-10-06,203,mango yogurt,50,60,10,1,00452,India
683726,2023-10-06,209,pepsi,75,100,25,1,00421,India
683726,2023-10-06,203,mango yogurt,50,60,10,1,00421,India
477050,2023-10-06,210,mountain dew,75,100,25,1,00110,India
477050,2023-10-06,202,milk,12,27,15,1,00110,India
477050,2023-10-06,201,paneer,210,340,130,1,00110,India
477050,2023-10-06,209,pepsi,75,100,25,1,00110,India
477050,2023-10-06,205,classic yogurt,45,60,15,1,00110,India
990264,2023-10-06,211,red bull,90,125,35,1,00037,India
990264,2023-10-06,202,milk,12,27,15,1,00037,India
990264,2023-10-06,204,strawberry yogurt,50,60,10,1,00037,India
990264,2023-10-06,205,classic yogurt,45,60,15,1,00037,India
526449,2023-10-06,210,mountain dew,75,100,25,1,00162,India
852182,2023-10-06,208,sprite,75,100,25,1,00175,India
852182,2023-10-06,207,coca cola,75,100,25,1,00175,India
852182,2023-10-06,210,mountain dew,75,100,25,1,00175,India
783194,2023-10-06,210,mountain dew,75,100,25,1,00348,India
783194,2023-10-06,202,milk,12,27,15,1,00348,India
783194,2023-10-06,204,strawberry yogurt,50,60,10,1,00348,India
783194,2023-10-06,201,paneer,210,340,130,1,00348,India
783194,2023-10-06,206,yakult,360,400,40,1,00348,India
683776,2023-10-06,210,mountain dew,75,100,25,1,00179,India
122509,2023-10-06,207,coca cola,75,100,25,1,00429,India
122509,2023-10-06,206,yakult,360,400,40,1,00429,India
854506,2023-10-06,207,coca cola,75,100,25,1,00214,India
854506,2023-10-06,205,classic yogurt,45,60,15,1,00214,India
854506,2023-10-06,202,milk,12,27,15,1,00214,India
312823,2023-10-06,206,yakult,360,400,40,1,00077,India
312823,2023-10-06,203,mango yogurt,50,60,10,1,00077,India
102138,2023-10-06,212,amul cheese,250,315,65,1,00041,India
526678,2023-10-06,203,mango yogurt,50,60,10,1,00491,India
526678,2023-10-06,206,yakult,360,400,40,1,00491,India
526678,2023-10-06,207,coca cola,75,100,25,1,00491,India
526678,2023-10-06,213,bisleri,6,15,9,1,00491,India
986706,2023-10-06,204,strawberry yogurt,50,60,10,1,00435,India
986706,2023-10-06,213,bisleri,6,15,9,1,00435,India
232708,2023-10-06,201,paneer,210,340,130,1,00489,India
232708,2023-10-06,208,sprite,75,100,25,1,00489,India
232708,2023-10-06,209,pepsi,75,100,25,1,00489,India
232708,2023-10-06,203,mango yogurt,50,60,10,1,00489,India
477374,2023-10-06,212,amul cheese,250,315,65,1,00283,India
477374,2023-10-06,208,sprite,75,100,25,1,00283,India
477374,2023-10-06,213,bisleri,6,15,9,1,00283,India
399414,2023-10-06,213,bisleri,6,15,9,1,00262,India
399414,2023-10-06,204,strawberry yogurt,50,60,10,1,00262,India
127979,2023-10-06,208,sprite,75,100,25,1,00311,India
127979,2023-10-06,210,mountain dew,75,100,25,1,00311,India
788792,2023-10-06,204,strawberry yogurt,50,60,10,1,00465,India
788792,2023-10-06,207,coca cola,75,100,25,1,00465,India
788792,2023-10-06,209,pepsi,75,100,25,1,00465,India
788792,2023-10-06,210,mountain dew,75,100,25,1,00465,India
788792,2023-10-06,208,sprite,75,100,25,1,00465,India
287968,2023-10-06,211,red bull,90,125,35,1,00133,India
287968,2023-10-06,205,classic yogurt,45,60,15,1,00133,India
287968,2023-10-06,209,pepsi,75,100,25,1,00133,India
372077,2023-10-06,213,bisleri,6,15,9,1,00040,India
372077,2023-10-06,204,strawberry yogurt,50,60,10,1,00040,India
372077,2023-10-06,203,mango yogurt,50,60,10,1,00040,India
372077,2023-10-06,205,classic yogurt,45,60,15,1,00040,India
372077,2023-10-06,206,yakult,360,400,40,1,00040,India
699030,2023-10-06,212,amul cheese,250,315,65,1,00442,India
699030,2023-10-06,201,paneer,210,340,130,1,00442,India
699030,2023-10-06,210,mountain dew,75,100,25,1,00442,India
699030,2023-10-06,211,red bull,90,125,35,1,00442,India
331039,2023-10-06,206,yakult,360,400,40,1,00052,India
331039,2023-10-06,212,amul cheese,250,315,65,1,00052,India
331039,2023-10-06,205,classic yogurt,45,60,15,1,00052,India
733530,2023-10-06,210,mountain dew,75,100,25,1,00131,India
733530,2023-10-06,211,red bull,90,125,35,1,00131,India
733530,2023-10-06,204,strawberry yogurt,50,60,10,1,00131,India
733530,2023-10-06,207,coca cola,75,100,25,1,00131,India
435159,2023-10-06,209,pepsi,75,100,25,1,00421,India
435159,2023-10-06,211,red bull,90,125,35,1,00421,India
435159,2023-10-06,210,mountain dew,75,100,25,1,00421,India
611102,2023-10-06,201,paneer,210,340,130,1,00207,India
611102,2023-10-06,202,milk,12,27,15,1,00207,India
611102,2023-10-06,213,bisleri,6,15,9,1,00207,India
611102,2023-10-06,203,mango yogurt,50,60,10,1,00207,India
969990,2023-10-06,207,coca cola,75,100,25,1,00176,India
693648,2023-10-06,211,red bull,90,125,35,1,00176,India
693648,2023-10-06,207,coca cola,75,100,25,1,00176,India
693648,2023-10-06,209,pepsi,75,100,25,1,00176,India
693648,2023-10-06,210,mountain dew,75,100,25,1,00176,India
113425,2023-10-06,208,sprite,75,100,25,1,00469,India
113425,2023-10-06,212,amul cheese,250,315,65,1,00469,India
113425,2023-10-06,204,strawberry yogurt,50,60,10,1,00469,India
561459,2023-10-06,201,paneer,210,340,130,1,00148,India
561459,2023-10-06,204,strawberry yogurt,50,60,10,1,00148,India
987000,2023-10-06,212,amul cheese,250,315,65,1,00409,India
533932,2023-10-06,210,mountain dew,75,100,25,1,00087,India
533932,2023-10-06,207,coca cola,75,100,25,1,00087,India
339538,2023-10-06,205,classic yogurt,45,60,15,1,00110,India
339538,2023-10-06,210,mountain dew,75,100,25,1,00110,India
818822,2023-10-06,208,sprite,75,100,25,1,00350,India
818822,2023-10-06,203,mango yogurt,50,60,10,1,00350,India
818822,2023-10-06,202,milk,12,27,15,1,00350,India
313785,2023-10-06,205,classic yogurt,45,60,15,1,00483,India
313785,2023-10-06,213,bisleri,6,15,9,1,00483,India
437829,2023-10-06,212,amul cheese,250,315,65,1,00039,India
437829,2023-10-06,204,strawberry yogurt,50,60,10,1,00039,India
437829,2023-10-06,207,coca cola,75,100,25,1,00039,India
437829,2023-10-06,203,mango yogurt,50,60,10,1,00039,India
129626,2023-10-06,206,yakult,360,400,40,1,00490,India
129626,2023-10-06,203,mango yogurt,50,60,10,1,00490,India
129626,2023-10-06,212,amul cheese,250,315,65,1,00490,India
788919,2023-10-06,204,strawberry yogurt,50,60,10,1,00437,India
788919,2023-10-06,205,classic yogurt,45,60,15,1,00437,India
788919,2023-10-06,210,mountain dew,75,100,25,1,00437,India
788919,2023-10-06,209,pepsi,75,100,25,1,00437,India
316996,2023-10-06,202,milk,12,27,15,1,00317,India
316996,2023-10-06,208,sprite,75,100,25,1,00317,India
316996,2023-10-06,206,yakult,360,400,40,1,00317,India
131792,2023-10-06,207,coca cola,75,100,25,1,00023,India
443533,2023-10-06,201,paneer,210,340,130,1,00175,India
443533,2023-10-06,204,strawberry yogurt,50,60,10,1,00175,India
443533,2023-10-06,207,coca cola,75,100,25,1,00175,India
443533,2023-10-06,212,amul cheese,250,315,65,1,00175,India
392140,2023-10-06,209,pepsi,75,100,25,1,00268,India
392140,2023-10-06,203,mango yogurt,50,60,10,1,00268,India
255555,2023-10-06,204,strawberry yogurt,50,60,10,1,00381,India
255555,2023-10-06,209,pepsi,75,100,25,1,00381,India
255555,2023-10-06,211,red bull,90,125,35,1,00381,India
255555,2023-10-06,203,mango yogurt,50,60,10,1,00381,India
255555,2023-10-06,210,mountain dew,75,100,25,1,00381,India
146584,2023-10-06,210,mountain dew,75,100,25,1,00006,India
146584,2023-10-06,213,bisleri,6,15,9,1,00006,India
937398,2023-10-06,203,mango yogurt,50,60,10,1,00086,India
937398,2023-10-06,210,mountain dew,75,100,25,1,00086,India
937398,2023-10-06,201,paneer,210,340,130,1,00086,India
937398,2023-10-06,211,red bull,90,125,35,1,00086,India
937398,2023-10-06,204,strawberry yogurt,50,60,10,1,00086,India
235567,2023-10-06,212,amul cheese,250,315,65,1,00224,India
235567,2023-10-06,201,paneer,210,340,130,1,00224,India
235567,2023-10-06,208,sprite,75,100,25,1,00224,India
235567,2023-10-06,206,yakult,360,400,40,1,00224,India
742063,2023-10-06,206,yakult,360,400,40,1,00196,India
742063,2023-10-06,210,mountain dew,75,100,25,1,00196,India
742063,2023-10-06,212,amul cheese,250,315,65,1,00196,India
742063,2023-10-06,201,paneer,210,340,130,1,00196,India
907870,2023-10-06,203,mango yogurt,50,60,10,1,00284,India
907870,2023-10-06,209,pepsi,75,100,25,1,00284,India
907870,2023-10-06,212,amul cheese,250,315,65,1,00284,India
197540,2023-10-06,207,coca cola,75,100,25,1,00137,India
197540,2023-10-06,209,pepsi,75,100,25,1,00137,India
197540,2023-10-06,206,yakult,360,400,40,1,00137,India
197540,2023-10-06,204,strawberry yogurt,50,60,10,1,00137,India
960906,2023-10-06,213,bisleri,6,15,9,1,00339,India
960906,2023-10-06,204,strawberry yogurt,50,60,10,1,00339,India
646632,2023-10-06,203,mango yogurt,50,60,10,1,00208,India
829001,2023-10-06,212,amul cheese,250,315,65,1,00075,India
829001,2023-10-06,208,sprite,75,100,25,1,00075,India
412360,2023-10-06,213,bisleri,6,15,9,1,00096,India
412360,2023-10-06,203,mango yogurt,50,60,10,1,00096,India
170936,2023-10-07,201,paneer,210,340,130,1,00275,India
170936,2023-10-07,213,bisleri,6,15,9,1,00275,India
170936,2023-10-07,211,red bull,90,125,35,1,00275,India
170936,2023-10-07,203,mango yogurt,50,60,10,1,00275,India
229060,2023-10-07,202,milk,12,27,15,1,00021,India
229060,2023-10-07,212,amul cheese,250,315,65,1,00021,India
229060,2023-10-07,209,pepsi,75,100,25,1,00021,India
145425,2023-10-07,201,paneer,210,340,130,1,00087,India
145425,2023-10-07,205,classic yogurt,45,60,15,1,00087,India
145425,2023-10-07,203,mango yogurt,50,60,10,1,00087,India
145425,2023-10-07,209,pepsi,75,100,25,1,00087,India
901743,2023-10-07,202,milk,12,27,15,1,00075,India
901743,2023-10-07,211,red bull,90,125,35,1,00075,India
901743,2023-10-07,207,coca cola,75,100,25,1,00075,India
901743,2023-10-07,212,amul cheese,250,315,65,1,00075,India
790185,2023-10-07,206,yakult,360,400,40,1,00423,India
790185,2023-10-07,205,classic yogurt,45,60,15,1,00423,India
790185,2023-10-07,207,coca cola,75,100,25,1,00423,India
885540,2023-10-07,213,bisleri,6,15,9,1,00120,India
318122,2023-10-07,209,pepsi,75,100,25,1,00130,India
318122,2023-10-07,208,sprite,75,100,25,1,00130,India
318122,2023-10-07,204,strawberry yogurt,50,60,10,1,00130,India
318122,2023-10-07,201,paneer,210,340,130,1,00130,India
318122,2023-10-07,212,amul cheese,250,315,65,1,00130,India
936828,2023-10-07,208,sprite,75,100,25,1,00167,India
936828,2023-10-07,213,bisleri,6,15,9,1,00167,India
936828,2023-10-07,207,coca cola,75,100,25,1,00167,India
936828,2023-10-07,211,red bull,90,125,35,1,00167,India
208942,2023-10-07,210,mountain dew,75,100,25,1,00292,India
208942,2023-10-07,207,coca cola,75,100,25,1,00292,India
208942,2023-10-07,206,yakult,360,400,40,1,00292,India
208942,2023-10-07,213,bisleri,6,15,9,1,00292,India
224821,2023-10-07,207,coca cola,75,100,25,1,00243,India
224821,2023-10-07,208,sprite,75,100,25,1,00243,India
656414,2023-10-07,210,mountain dew,75,100,25,1,00210,India
656414,2023-10-07,206,yakult,360,400,40,1,00210,India
595948,2023-10-07,213,bisleri,6,15,9,1,00234,India
595948,2023-10-07,210,mountain dew,75,100,25,1,00234,India
595948,2023-10-07,207,coca cola,75,100,25,1,00234,India
595948,2023-10-07,206,yakult,360,400,40,1,00234,India
423787,2023-10-07,205,classic yogurt,45,60,15,1,00383,India
423787,2023-10-07,213,bisleri,6,15,9,1,00383,India
423787,2023-10-07,204,strawberry yogurt,50,60,10,1,00383,India
368561,2023-10-07,204,strawberry yogurt,50,60,10,1,00334,India
368561,2023-10-07,205,classic yogurt,45,60,15,1,00334,India
368561,2023-10-07,212,amul cheese,250,315,65,1,00334,India
368561,2023-10-07,201,paneer,210,340,130,1,00334,India
997941,2023-10-07,210,mountain dew,75,100,25,1,00457,India
997941,2023-10-07,211,red bull,90,125,35,1,00457,India
997941,2023-10-07,206,yakult,360,400,40,1,00457,India
171619,2023-10-07,213,bisleri,6,15,9,1,00076,India
171619,2023-10-07,201,paneer,210,340,130,1,00076,India
171619,2023-10-07,210,mountain dew,75,100,25,1,00076,India
171619,2023-10-07,206,yakult,360,400,40,1,00076,India
981121,2023-10-07,212,amul cheese,250,315,65,1,00376,India
471631,2023-10-07,207,coca cola,75,100,25,1,00498,India
471631,2023-10-07,208,sprite,75,100,25,1,00498,India
471631,2023-10-07,211,red bull,90,125,35,1,00498,India
788380,2023-10-07,210,mountain dew,75,100,25,1,00142,India
788380,2023-10-07,203,mango yogurt,50,60,10,1,00142,India
788380,2023-10-07,213,bisleri,6,15,9,1,00142,India
788380,2023-10-07,202,milk,12,27,15,1,00142,India
208418,2023-10-07,213,bisleri,6,15,9,1,00157,India
894198,2023-10-07,211,red bull,90,125,35,1,00297,India
894198,2023-10-07,213,bisleri,6,15,9,1,00297,India
894198,2023-10-07,205,classic yogurt,45,60,15,1,00297,India
894198,2023-10-07,212,amul cheese,250,315,65,1,00297,India
894198,2023-10-07,201,paneer,210,340,130,1,00297,India
547455,2023-10-07,211,red bull,90,125,35,1,00413,India
547455,2023-10-07,202,milk,12,27,15,1,00413,India
547455,2023-10-07,213,bisleri,6,15,9,1,00413,India
547455,2023-10-07,208,sprite,75,100,25,1,00413,India
838537,2023-10-07,202,milk,12,27,15,1,00474,India
838537,2023-10-07,204,strawberry yogurt,50,60,10,1,00474,India
983092,2023-10-07,204,strawberry yogurt,50,60,10,1,00500,India
983092,2023-10-07,207,coca cola,75,100,25,1,00500,India
983092,2023-10-07,210,mountain dew,75,100,25,1,00500,India
983092,2023-10-07,201,paneer,210,340,130,1,00500,India
636816,2023-10-07,212,amul cheese,250,315,65,1,00221,India
636816,2023-10-07,208,sprite,75,100,25,1,00221,India
636816,2023-10-07,213,bisleri,6,15,9,1,00221,India
636816,2023-10-07,205,classic yogurt,45,60,15,1,00221,India
598284,2023-10-07,202,milk,12,27,15,1,00097,India
598284,2023-10-07,204,strawberry yogurt,50,60,10,1,00097,India
263484,2023-10-07,210,mountain dew,75,100,25,1,00496,India
263484,2023-10-07,202,milk,12,27,15,1,00496,India
263484,2023-10-07,213,bisleri,6,15,9,1,00496,India
263484,2023-10-07,203,mango yogurt,50,60,10,1,00496,India
145299,2023-10-07,211,red bull,90,125,35,1,00401,India
145299,2023-10-07,212,amul cheese,250,315,65,1,00401,India
145299,2023-10-07,208,sprite,75,100,25,1,00401,India
145299,2023-10-07,209,pepsi,75,100,25,1,00401,India
676753,2023-10-07,209,pepsi,75,100,25,1,00120,India
676753,2023-10-07,202,milk,12,27,15,1,00120,India
676753,2023-10-07,211,red bull,90,125,35,1,00120,India
873909,2023-10-07,205,classic yogurt,45,60,15,1,00498,India
873909,2023-10-07,207,coca cola,75,100,25,1,00498,India
873909,2023-10-07,201,paneer,210,340,130,1,00498,India
873909,2023-10-07,203,mango yogurt,50,60,10,1,00498,India
568641,2023-10-07,207,coca cola,75,100,25,1,00049,India
568641,2023-10-07,203,mango yogurt,50,60,10,1,00049,India
863155,2023-10-07,208,sprite,75,100,25,1,00453,India
863155,2023-10-07,210,mountain dew,75,100,25,1,00453,India
863155,2023-10-07,212,amul cheese,250,315,65,1,00453,India
863155,2023-10-07,203,mango yogurt,50,60,10,1,00453,India
204256,2023-10-07,205,classic yogurt,45,60,15,1,00158,India
104799,2023-10-07,201,paneer,210,340,130,1,00187,India
104799,2023-10-07,206,yakult,360,400,40,1,00187,India
104799,2023-10-07,213,bisleri,6,15,9,1,00187,India
104799,2023-10-07,208,sprite,75,100,25,1,00187,India
104799,2023-10-07,205,classic yogurt,45,60,15,1,00187,India
509554,2023-10-07,204,strawberry yogurt,50,60,10,1,00274,India
509554,2023-10-07,209,pepsi,75,100,25,1,00274,India
482036,2023-10-07,203,mango yogurt,50,60,10,1,00230,India
482036,2023-10-07,208,sprite,75,100,25,1,00230,India
482036,2023-10-07,202,milk,12,27,15,1,00230,India
482036,2023-10-07,211,red bull,90,125,35,1,00230,India
208647,2023-10-07,208,sprite,75,100,25,1,00467,India
208647,2023-10-07,204,strawberry yogurt,50,60,10,1,00467,India
208647,2023-10-07,205,classic yogurt,45,60,15,1,00467,India
208647,2023-10-07,210,mountain dew,75,100,25,1,00467,India
208647,2023-10-07,213,bisleri,6,15,9,1,00467,India
344006,2023-10-07,213,bisleri,6,15,9,1,00449,India
344006,2023-10-07,203,mango yogurt,50,60,10,1,00449,India
344006,2023-10-07,202,milk,12,27,15,1,00449,India
674129,2023-10-07,206,yakult,360,400,40,1,00091,India
674129,2023-10-07,213,bisleri,6,15,9,1,00091,India
674129,2023-10-07,203,mango yogurt,50,60,10,1,00091,India
674129,2023-10-07,205,classic yogurt,45,60,15,1,00091,India
202051,2023-10-07,206,yakult,360,400,40,1,00092,India
202051,2023-10-07,209,pepsi,75,100,25,1,00092,India
202051,2023-10-07,210,mountain dew,75,100,25,1,00092,India
202051,2023-10-07,208,sprite,75,100,25,1,00092,India
202051,2023-10-07,201,paneer,210,340,130,1,00092,India
319510,2023-10-07,205,classic yogurt,45,60,15,1,00168,India
319510,2023-10-07,207,coca cola,75,100,25,1,00168,India
319510,2023-10-07,208,sprite,75,100,25,1,00168,India
319510,2023-10-07,210,mountain dew,75,100,25,1,00168,India
894345,2023-10-07,205,classic yogurt,45,60,15,1,00122,India
894345,2023-10-07,207,coca cola,75,100,25,1,00122,India
179826,2023-10-07,207,coca cola,75,100,25,1,00062,India
208909,2023-10-07,212,amul cheese,250,315,65,1,00086,India
208909,2023-10-07,205,classic yogurt,45,60,15,1,00086,India
276887,2023-10-07,208,sprite,75,100,25,1,00198,India
276887,2023-10-07,201,paneer,210,340,130,1,00198,India
276887,2023-10-07,211,red bull,90,125,35,1,00198,India
276887,2023-10-07,202,milk,12,27,15,1,00198,India
828745,2023-10-07,208,sprite,75,100,25,1,00274,India
828745,2023-10-07,205,classic yogurt,45,60,15,1,00274,India
828745,2023-10-07,203,mango yogurt,50,60,10,1,00274,India
828745,2023-10-07,210,mountain dew,75,100,25,1,00274,India
260460,2023-10-07,206,yakult,360,400,40,1,00433,India
260460,2023-10-07,212,amul cheese,250,315,65,1,00433,India
548027,2023-10-07,208,sprite,75,100,25,1,00121,India
548027,2023-10-07,205,classic yogurt,45,60,15,1,00121,India
765556,2023-10-07,213,bisleri,6,15,9,1,00433,India
508165,2023-10-07,209,pepsi,75,100,25,1,00371,India
508165,2023-10-07,213,bisleri,6,15,9,1,00371,India
508165,2023-10-07,207,coca cola,75,100,25,1,00371,India
922430,2023-10-07,209,pepsi,75,100,25,1,00224,India
922430,2023-10-07,204,strawberry yogurt,50,60,10,1,00224,India
922430,2023-10-07,203,mango yogurt,50,60,10,1,00224,India
231352,2023-10-07,212,amul cheese,250,315,65,1,00406,India
231352,2023-10-07,202,milk,12,27,15,1,00406,India
231352,2023-10-07,207,coca cola,75,100,25,1,00406,India
231352,2023-10-07,205,classic yogurt,45,60,15,1,00406,India
729584,2023-10-07,211,red bull,90,125,35,1,00353,India
729584,2023-10-07,212,amul cheese,250,315,65,1,00353,India
738083,2023-10-07,209,pepsi,75,100,25,1,00072,India
159256,2023-10-07,213,bisleri,6,15,9,1,00074,India
159256,2023-10-07,208,sprite,75,100,25,1,00074,India
420006,2023-10-07,206,yakult,360,400,40,1,00198,India
420006,2023-10-07,201,paneer,210,340,130,1,00198,India
420006,2023-10-07,205,classic yogurt,45,60,15,1,00198,India
420006,2023-10-07,208,sprite,75,100,25,1,00198,India
614924,2023-10-07,207,coca cola,75,100,25,1,00229,India
943452,2023-10-07,209,pepsi,75,100,25,1,00404,India
943452,2023-10-07,201,paneer,210,340,130,1,00404,India
943452,2023-10-07,205,classic yogurt,45,60,15,1,00404,India
943452,2023-10-07,207,coca cola,75,100,25,1,00404,India
943452,2023-10-07,206,yakult,360,400,40,1,00404,India
572693,2023-10-07,209,pepsi,75,100,25,1,00054,India
572693,2023-10-07,201,paneer,210,340,130,1,00054,India
572693,2023-10-07,204,strawberry yogurt,50,60,10,1,00054,India
572693,2023-10-07,206,yakult,360,400,40,1,00054,India
572693,2023-10-07,210,mountain dew,75,100,25,1,00054,India
840277,2023-10-07,204,strawberry yogurt,50,60,10,1,00398,India
840277,2023-10-07,201,paneer,210,340,130,1,00398,India
840277,2023-10-07,205,classic yogurt,45,60,15,1,00398,India
570663,2023-10-07,211,red bull,90,125,35,1,00263,India
464651,2023-10-07,208,sprite,75,100,25,1,00333,India
464651,2023-10-07,206,yakult,360,400,40,1,00333,India
464651,2023-10-07,201,paneer,210,340,130,1,00333,India
464651,2023-10-07,213,bisleri,6,15,9,1,00333,India
330060,2023-10-07,210,mountain dew,75,100,25,1,00470,India
330060,2023-10-07,205,classic yogurt,45,60,15,1,00470,India
195641,2023-10-07,212,amul cheese,250,315,65,1,00053,India
195641,2023-10-07,202,milk,12,27,15,1,00053,India
195641,2023-10-07,208,sprite,75,100,25,1,00053,India
412810,2023-10-07,206,yakult,360,400,40,1,00172,India
412810,2023-10-07,202,milk,12,27,15,1,00172,India
412810,2023-10-07,210,mountain dew,75,100,25,1,00172,India
412810,2023-10-07,201,paneer,210,340,130,1,00172,India
551189,2023-10-07,203,mango yogurt,50,60,10,1,00017,India
551189,2023-10-07,205,classic yogurt,45,60,15,1,00017,India
493659,2023-10-07,209,pepsi,75,100,25,1,00194,India
493659,2023-10-07,211,red bull,90,125,35,1,00194,India
493659,2023-10-07,213,bisleri,6,15,9,1,00194,India
493659,2023-10-07,208,sprite,75,100,25,1,00194,India
493659,2023-10-07,212,amul cheese,250,315,65,1,00194,India
169718,2023-10-07,213,bisleri,6,15,9,1,00187,India
169718,2023-10-07,210,mountain dew,75,100,25,1,00187,India
169718,2023-10-07,205,classic yogurt,45,60,15,1,00187,India
391079,2023-10-08,205,classic yogurt,45,60,15,1,00257,India
391079,2023-10-08,202,milk,12,27,15,1,00257,India
391079,2023-10-08,208,sprite,75,100,25,1,00257,India
274080,2023-10-08,207,coca cola,75,100,25,1,00428,India
274080,2023-10-08,203,mango yogurt,50,60,10,1,00428,India
432836,2023-10-08,201,paneer,210,340,130,1,00165,India
586014,2023-10-08,206,yakult,360,400,40,1,00345,India
399625,2023-10-08,210,mountain dew,75,100,25,1,00295,India
399625,2023-10-08,212,amul cheese,250,315,65,1,00295,India
399625,2023-10-08,202,milk,12,27,15,1,00295,India
399625,2023-10-08,208,sprite,75,100,25,1,00295,India
399625,2023-10-08,206,yakult,360,400,40,1,00295,India
850647,2023-10-08,206,yakult,360,400,40,1,00054,India
929358,2023-10-08,203,mango yogurt,50,60,10,1,00417,India
929358,2023-10-08,209,pepsi,75,100,25,1,00417,India
683935,2023-10-08,208,sprite,75,100,25,1,00426,India
683935,2023-10-08,206,yakult,360,400,40,1,00426,India
410008,2023-10-08,205,classic yogurt,45,60,15,1,00264,India
410008,2023-10-08,212,amul cheese,250,315,65,1,00264,India
217846,2023-10-08,207,coca cola,75,100,25,1,00492,India
217846,2023-10-08,211,red bull,90,125,35,1,00492,India
217846,2023-10-08,203,mango yogurt,50,60,10,1,00492,India
217846,2023-10-08,204,strawberry yogurt,50,60,10,1,00492,India
573035,2023-10-08,207,coca cola,75,100,25,1,00362,India
573035,2023-10-08,201,paneer,210,340,130,1,00362,India
573035,2023-10-08,204,strawberry yogurt,50,60,10,1,00362,India
573035,2023-10-08,210,mountain dew,75,100,25,1,00362,India
540178,2023-10-08,210,mountain dew,75,100,25,1,00050,India
496799,2023-10-08,204,strawberry yogurt,50,60,10,1,00483,India
496799,2023-10-08,203,mango yogurt,50,60,10,1,00483,India
133598,2023-10-08,203,mango yogurt,50,60,10,1,00123,India
133598,2023-10-08,201,paneer,210,340,130,1,00123,India
133598,2023-10-08,206,yakult,360,400,40,1,00123,India
133598,2023-10-08,205,classic yogurt,45,60,15,1,00123,India
514729,2023-10-08,207,coca cola,75,100,25,1,00379,India
514729,2023-10-08,202,milk,12,27,15,1,00379,India
514729,2023-10-08,206,yakult,360,400,40,1,00379,India
443895,2023-10-08,201,paneer,210,340,130,1,00083,India
443895,2023-10-08,210,mountain dew,75,100,25,1,00083,India
200174,2023-10-08,207,coca cola,75,100,25,1,00397,India
200174,2023-10-08,209,pepsi,75,100,25,1,00397,India
200174,2023-10-08,208,sprite,75,100,25,1,00397,India
200174,2023-10-08,203,mango yogurt,50,60,10,1,00397,India
417747,2023-10-08,211,red bull,90,125,35,1,00108,India
417747,2023-10-08,209,pepsi,75,100,25,1,00108,India
417747,2023-10-08,201,paneer,210,340,130,1,00108,India
417747,2023-10-08,204,strawberry yogurt,50,60,10,1,00108,India
535092,2023-10-08,213,bisleri,6,15,9,1,00167,India
414638,2023-10-08,204,strawberry yogurt,50,60,10,1,00176,India
414638,2023-10-08,213,bisleri,6,15,9,1,00176,India
414638,2023-10-08,203,mango yogurt,50,60,10,1,00176,India
414638,2023-10-08,212,amul cheese,250,315,65,1,00176,India
519981,2023-10-08,211,red bull,90,125,35,1,00313,India
519981,2023-10-08,210,mountain dew,75,100,25,1,00313,India
768979,2023-10-08,207,coca cola,75,100,25,1,00159,India
768979,2023-10-08,202,milk,12,27,15,1,00159,India
955148,2023-10-08,207,coca cola,75,100,25,1,00177,India
955148,2023-10-08,210,mountain dew,75,100,25,1,00177,India
575390,2023-10-08,211,red bull,90,125,35,1,00091,India
575390,2023-10-08,212,amul cheese,250,315,65,1,00091,India
575390,2023-10-08,201,paneer,210,340,130,1,00091,India
588605,2023-10-08,212,amul cheese,250,315,65,1,00176,India
588605,2023-10-08,213,bisleri,6,15,9,1,00176,India
588605,2023-10-08,210,mountain dew,75,100,25,1,00176,India
588605,2023-10-08,203,mango yogurt,50,60,10,1,00176,India
395458,2023-10-08,210,mountain dew,75,100,25,1,00481,India
789622,2023-10-08,212,amul cheese,250,315,65,1,00059,India
789622,2023-10-08,211,red bull,90,125,35,1,00059,India
293212,2023-10-08,206,yakult,360,400,40,1,00275,India
293212,2023-10-08,211,red bull,90,125,35,1,00275,India
293212,2023-10-08,208,sprite,75,100,25,1,00275,India
293212,2023-10-08,210,mountain dew,75,100,25,1,00275,India
293212,2023-10-08,207,coca cola,75,100,25,1,00275,India
111437,2023-10-08,206,yakult,360,400,40,1,00197,India
779543,2023-10-08,208,sprite,75,100,25,1,00220,India
779543,2023-10-08,211,red bull,90,125,35,1,00220,India
779543,2023-10-08,202,milk,12,27,15,1,00220,India
779543,2023-10-08,203,mango yogurt,50,60,10,1,00220,India
779543,2023-10-08,205,classic yogurt,45,60,15,1,00220,India
978195,2023-10-08,205,classic yogurt,45,60,15,1,00265,India
978195,2023-10-08,210,mountain dew,75,100,25,1,00265,India
978195,2023-10-08,206,yakult,360,400,40,1,00265,India
751923,2023-10-08,203,mango yogurt,50,60,10,1,00370,India
751923,2023-10-08,205,classic yogurt,45,60,15,1,00370,India
751923,2023-10-08,207,coca cola,75,100,25,1,00370,India
751923,2023-10-08,210,mountain dew,75,100,25,1,00370,India
190263,2023-10-08,209,pepsi,75,100,25,1,00164,India
190263,2023-10-08,205,classic yogurt,45,60,15,1,00164,India
642348,2023-10-08,211,red bull,90,125,35,1,00117,India
633093,2023-10-08,206,yakult,360,400,40,1,00083,India
930069,2023-10-08,211,red bull,90,125,35,1,00107,India
930069,2023-10-08,207,coca cola,75,100,25,1,00107,India
930069,2023-10-08,201,paneer,210,340,130,1,00107,India
930069,2023-10-08,212,amul cheese,250,315,65,1,00107,India
930069,2023-10-08,204,strawberry yogurt,50,60,10,1,00107,India
843905,2023-10-08,205,classic yogurt,45,60,15,1,00412,India
843905,2023-10-08,203,mango yogurt,50,60,10,1,00412,India
115078,2023-10-08,209,pepsi,75,100,25,1,00262,India
115078,2023-10-08,213,bisleri,6,15,9,1,00262,India
381875,2023-10-08,204,strawberry yogurt,50,60,10,1,00165,India
464036,2023-10-08,201,paneer,210,340,130,1,00060,India
346244,2023-10-08,201,paneer,210,340,130,1,00281,India
346244,2023-10-08,206,yakult,360,400,40,1,00281,India
623309,2023-10-08,202,milk,12,27,15,1,00113,India
705357,2023-10-08,203,mango yogurt,50,60,10,1,00361,India
806855,2023-10-08,208,sprite,75,100,25,1,00064,India
317177,2023-10-08,211,red bull,90,125,35,1,00110,India
317177,2023-10-08,212,amul cheese,250,315,65,1,00110,India
495043,2023-10-08,213,bisleri,6,15,9,1,00025,India
495043,2023-10-08,211,red bull,90,125,35,1,00025,India
495043,2023-10-08,202,milk,12,27,15,1,00025,India
495043,2023-10-08,204,strawberry yogurt,50,60,10,1,00025,India
193134,2023-10-08,206,yakult,360,400,40,1,00420,India
193134,2023-10-08,210,mountain dew,75,100,25,1,00420,India
970404,2023-10-08,209,pepsi,75,100,25,1,00083,India
970404,2023-10-08,211,red bull,90,125,35,1,00083,India
970404,2023-10-08,206,yakult,360,400,40,1,00083,India
970404,2023-10-08,205,classic yogurt,45,60,15,1,00083,India
970404,2023-10-08,203,mango yogurt,50,60,10,1,00083,India
367153,2023-10-08,213,bisleri,6,15,9,1,00303,India
367153,2023-10-08,203,mango yogurt,50,60,10,1,00303,India
367153,2023-10-08,206,yakult,360,400,40,1,00303,India
501129,2023-10-08,203,mango yogurt,50,60,10,1,00449,India
501129,2023-10-08,208,sprite,75,100,25,1,00449,India
501129,2023-10-08,213,bisleri,6,15,9,1,00449,India
501129,2023-10-08,210,mountain dew,75,100,25,1,00449,India
570193,2023-10-08,206,yakult,360,400,40,1,00082,India
570193,2023-10-08,202,milk,12,27,15,1,00082,India
570193,2023-10-08,204,strawberry yogurt,50,60,10,1,00082,India
734040,2023-10-08,205,classic yogurt,45,60,15,1,00046,India
734040,2023-10-08,209,pepsi,75,100,25,1,00046,India
734040,2023-10-08,206,yakult,360,400,40,1,00046,India
734040,2023-10-08,211,red bull,90,125,35,1,00046,India
375277,2023-10-08,212,amul cheese,250,315,65,1,00314,India
375277,2023-10-08,211,red bull,90,125,35,1,00314,India
375277,2023-10-08,207,coca cola,75,100,25,1,00314,India
375277,2023-10-08,206,yakult,360,400,40,1,00314,India
375277,2023-10-08,203,mango yogurt,50,60,10,1,00314,India
871665,2023-10-08,206,yakult,360,400,40,1,00341,India
650918,2023-10-08,205,classic yogurt,45,60,15,1,00498,India
650918,2023-10-08,213,bisleri,6,15,9,1,00498,India
650918,2023-10-08,208,sprite,75,100,25,1,00498,India
650918,2023-10-08,201,paneer,210,340,130,1,00498,India
533332,2023-10-08,203,mango yogurt,50,60,10,1,00179,India
533332,2023-10-08,205,classic yogurt,45,60,15,1,00179,India
533332,2023-10-08,210,mountain dew,75,100,25,1,00179,India
374413,2023-10-08,206,yakult,360,400,40,1,00424,India
374413,2023-10-08,211,red bull,90,125,35,1,00424,India
843799,2023-10-08,201,paneer,210,340,130,1,00292,India
843799,2023-10-08,207,coca cola,75,100,25,1,00292,India
341988,2023-10-08,205,classic yogurt,45,60,15,1,00054,India
341988,2023-10-08,202,milk,12,27,15,1,00054,India
341988,2023-10-08,207,coca cola,75,100,25,1,00054,India
341988,2023-10-08,209,pepsi,75,100,25,1,00054,India
341988,2023-10-08,208,sprite,75,100,25,1,00054,India
701878,2023-10-08,209,pepsi,75,100,25,1,00265,India
701878,2023-10-08,211,red bull,90,125,35,1,00265,India
701878,2023-10-08,203,mango yogurt,50,60,10,1,00265,India
701878,2023-10-08,206,yakult,360,400,40,1,00265,India
534614,2023-10-08,201,paneer,210,340,130,1,00087,India
534614,2023-10-08,205,classic yogurt,45,60,15,1,00087,India
238392,2023-10-08,213,bisleri,6,15,9,1,00365,India
238392,2023-10-08,202,milk,12,27,15,1,00365,India
238392,2023-10-08,209,pepsi,75,100,25,1,00365,India
238392,2023-10-08,207,coca cola,75,100,25,1,00365,India
323013,2023-10-08,207,coca cola,75,100,25,1,00172,India
323013,2023-10-08,208,sprite,75,100,25,1,00172,India
323013,2023-10-08,209,pepsi,75,100,25,1,00172,India
323013,2023-10-08,203,mango yogurt,50,60,10,1,00172,India
442305,2023-10-08,203,mango yogurt,50,60,10,1,00266,India
407643,2023-10-08,212,amul cheese,250,315,65,1,00060,India
407643,2023-10-08,209,pepsi,75,100,25,1,00060,India
985451,2023-10-08,203,mango yogurt,50,60,10,1,00037,India
630357,2023-10-08,210,mountain dew,75,100,25,1,00489,India
630357,2023-10-08,213,bisleri,6,15,9,1,00489,India
381005,2023-10-08,205,classic yogurt,45,60,15,1,00422,India
381005,2023-10-08,203,mango yogurt,50,60,10,1,00422,India
469153,2023-10-08,206,yakult,360,400,40,1,00065,India
347448,2023-10-08,204,strawberry yogurt,50,60,10,1,00208,India
172039,2023-10-08,204,strawberry yogurt,50,60,10,1,00050,India
172039,2023-10-08,210,mountain dew,75,100,25,1,00050,India
608279,2023-10-08,211,red bull,90,125,35,1,00105,India
608279,2023-10-08,208,sprite,75,100,25,1,00105,India
608279,2023-10-08,202,milk,12,27,15,1,00105,India
703595,2023-10-08,203,mango yogurt,50,60,10,1,00500,India
703595,2023-10-08,206,yakult,360,400,40,1,00500,India
703595,2023-10-08,202,milk,12,27,15,1,00500,India
369144,2023-10-08,211,red bull,90,125,35,1,00161,India
547023,2023-10-08,211,red bull,90,125,35,1,00442,India
547023,2023-10-08,210,mountain dew,75,100,25,1,00442,India
547023,2023-10-08,202,milk,12,27,15,1,00442,India
547023,2023-10-08,205,classic yogurt,45,60,15,1,00442,India
836937,2023-10-08,205,classic yogurt,45,60,15,1,00204,India
836937,2023-10-08,201,paneer,210,340,130,1,00204,India
836937,2023-10-08,210,mountain dew,75,100,25,1,00204,India
872084,2023-10-09,204,strawberry yogurt,50,60,10,1,00015,India
654980,2023-10-09,210,mountain dew,75,100,25,1,00145,India
654980,2023-10-09,213,bisleri,6,15,9,1,00145,India
654980,2023-10-09,208,sprite,75,100,25,1,00145,India
553264,2023-10-09,202,milk,12,27,15,1,00217,India
553264,2023-10-09,207,coca cola,75,100,25,1,00217,India
345280,2023-10-09,207,coca cola,75,100,25,1,00377,India
345280,2023-10-09,208,sprite,75,100,25,1,00377,India
345280,2023-10-09,201,paneer,210,340,130,1,00377,India
960309,2023-10-09,210,mountain dew,75,100,25,1,00255,India
960309,2023-10-09,205,classic yogurt,45,60,15,1,00255,India
837028,2023-10-09,201,paneer,210,340,130,1,00253,India
837028,2023-10-09,213,bisleri,6,15,9,1,00253,India
837028,2023-10-09,205,classic yogurt,45,60,15,1,00253,India
837028,2023-10-09,212,amul cheese,250,315,65,1,00253,India
392594,2023-10-09,205,classic yogurt,45,60,15,1,00367,India
392594,2023-10-09,204,strawberry yogurt,50,60,10,1,00367,India
546135,2023-10-09,204,strawberry yogurt,50,60,10,1,00358,India
546135,2023-10-09,207,coca cola,75,100,25,1,00358,India
546135,2023-10-09,203,mango yogurt,50,60,10,1,00358,India
546135,2023-10-09,212,amul cheese,250,315,65,1,00358,India
546135,2023-10-09,213,bisleri,6,15,9,1,00358,India
393931,2023-10-09,213,bisleri,6,15,9,1,00188,India
122438,2023-10-09,213,bisleri,6,15,9,1,00395,India
873673,2023-10-09,205,classic yogurt,45,60,15,1,00459,India
665785,2023-10-09,204,strawberry yogurt,50,60,10,1,00041,India
982448,2023-10-09,209,pepsi,75,100,25,1,00182,India
982448,2023-10-09,208,sprite,75,100,25,1,00182,India
982448,2023-10-09,211,red bull,90,125,35,1,00182,India
907762,2023-10-09,201,paneer,210,340,130,1,00300,India
907762,2023-10-09,204,strawberry yogurt,50,60,10,1,00300,India
666089,2023-10-09,209,pepsi,75,100,25,1,00039,India
666089,2023-10-09,210,mountain dew,75,100,25,1,00039,India
927421,2023-10-09,212,amul cheese,250,315,65,1,00372,India
367866,2023-10-09,207,coca cola,75,100,25,1,00489,India
802718,2023-10-09,204,strawberry yogurt,50,60,10,1,00491,India
802718,2023-10-09,211,red bull,90,125,35,1,00491,India
802718,2023-10-09,203,mango yogurt,50,60,10,1,00491,India
243238,2023-10-09,212,amul cheese,250,315,65,1,00077,India
243238,2023-10-09,207,coca cola,75,100,25,1,00077,India
243238,2023-10-09,205,classic yogurt,45,60,15,1,00077,India
243238,2023-10-09,210,mountain dew,75,100,25,1,00077,India
793656,2023-10-09,208,sprite,75,100,25,1,00161,India
793656,2023-10-09,211,red bull,90,125,35,1,00161,India
793656,2023-10-09,201,paneer,210,340,130,1,00161,India
793656,2023-10-09,209,pepsi,75,100,25,1,00161,India
376404,2023-10-09,201,paneer,210,340,130,1,00415,India
376404,2023-10-09,209,pepsi,75,100,25,1,00415,India
520637,2023-10-09,210,mountain dew,75,100,25,1,00238,India
520637,2023-10-09,209,pepsi,75,100,25,1,00238,India
520637,2023-10-09,205,classic yogurt,45,60,15,1,00238,India
176225,2023-10-09,203,mango yogurt,50,60,10,1,00309,India
999593,2023-10-09,203,mango yogurt,50,60,10,1,00338,India
226978,2023-10-09,205,classic yogurt,45,60,15,1,00466,India
640713,2023-10-09,212,amul cheese,250,315,65,1,00290,India
640713,2023-10-09,207,coca cola,75,100,25,1,00290,India
640713,2023-10-09,205,classic yogurt,45,60,15,1,00290,India
911897,2023-10-09,213,bisleri,6,15,9,1,00319,India
911897,2023-10-09,205,classic yogurt,45,60,15,1,00319,India
911897,2023-10-09,201,paneer,210,340,130,1,00319,India
911897,2023-10-09,202,milk,12,27,15,1,00319,India
911897,2023-10-09,212,amul cheese,250,315,65,1,00319,India
997519,2023-10-09,212,amul cheese,250,315,65,1,00330,India
997519,2023-10-09,211,red bull,90,125,35,1,00330,India
111504,2023-10-09,203,mango yogurt,50,60,10,1,00464,India
111504,2023-10-09,213,bisleri,6,15,9,1,00464,India
111504,2023-10-09,206,yakult,360,400,40,1,00464,India
739092,2023-10-09,208,sprite,75,100,25,1,00286,India
739092,2023-10-09,205,classic yogurt,45,60,15,1,00286,India
739092,2023-10-09,204,strawberry yogurt,50,60,10,1,00286,India
117794,2023-10-09,212,amul cheese,250,315,65,1,00471,India
117794,2023-10-09,213,bisleri,6,15,9,1,00471,India
117794,2023-10-09,206,yakult,360,400,40,1,00471,India
117794,2023-10-09,211,red bull,90,125,35,1,00471,India
518728,2023-10-09,205,classic yogurt,45,60,15,1,00010,India
307982,2023-10-09,212,amul cheese,250,315,65,1,00321,India
196528,2023-10-09,206,yakult,360,400,40,1,00357,India
626355,2023-10-09,206,yakult,360,400,40,1,00496,India
626355,2023-10-09,202,milk,12,27,15,1,00496,India
626355,2023-10-09,205,classic yogurt,45,60,15,1,00496,India
626355,2023-10-09,212,amul cheese,250,315,65,1,00496,India
816227,2023-10-09,203,mango yogurt,50,60,10,1,00281,India
816227,2023-10-09,209,pepsi,75,100,25,1,00281,India
411460,2023-10-09,211,red bull,90,125,35,1,00448,India
411460,2023-10-09,210,mountain dew,75,100,25,1,00448,India
310465,2023-10-09,210,mountain dew,75,100,25,1,00410,India
310465,2023-10-09,203,mango yogurt,50,60,10,1,00410,India
310465,2023-10-09,207,coca cola,75,100,25,1,00410,India
310465,2023-10-09,209,pepsi,75,100,25,1,00410,India
775841,2023-10-09,209,pepsi,75,100,25,1,00278,India
376704,2023-10-09,213,bisleri,6,15,9,1,00284,India
376704,2023-10-09,209,pepsi,75,100,25,1,00284,India
376704,2023-10-09,201,paneer,210,340,130,1,00284,India
376704,2023-10-09,212,amul cheese,250,315,65,1,00284,India
257195,2023-10-09,211,red bull,90,125,35,1,00312,India
504934,2023-10-09,211,red bull,90,125,35,1,00279,India
615834,2023-10-09,206,yakult,360,400,40,1,00489,India
615834,2023-10-09,205,classic yogurt,45,60,15,1,00489,India
396403,2023-10-09,207,coca cola,75,100,25,1,00268,India
396403,2023-10-09,204,strawberry yogurt,50,60,10,1,00268,India
396403,2023-10-09,212,amul cheese,250,315,65,1,00268,India
609085,2023-10-09,212,amul cheese,250,315,65,1,00122,India
609085,2023-10-09,208,sprite,75,100,25,1,00122,India
609085,2023-10-09,211,red bull,90,125,35,1,00122,India
438897,2023-10-09,201,paneer,210,340,130,1,00001,India
438897,2023-10-09,203,mango yogurt,50,60,10,1,00001,India
438897,2023-10-09,209,pepsi,75,100,25,1,00001,India
438897,2023-10-09,210,mountain dew,75,100,25,1,00001,India
438897,2023-10-09,204,strawberry yogurt,50,60,10,1,00001,India
196298,2023-10-09,213,bisleri,6,15,9,1,00089,India
196298,2023-10-09,210,mountain dew,75,100,25,1,00089,India
196298,2023-10-09,209,pepsi,75,100,25,1,00089,India
196298,2023-10-09,202,milk,12,27,15,1,00089,India
428206,2023-10-09,206,yakult,360,400,40,1,00217,India
428206,2023-10-09,201,paneer,210,340,130,1,00217,India
428206,2023-10-09,203,mango yogurt,50,60,10,1,00217,India
428206,2023-10-09,210,mountain dew,75,100,25,1,00217,India
428206,2023-10-09,211,red bull,90,125,35,1,00217,India
686370,2023-10-09,210,mountain dew,75,100,25,1,00402,India
360615,2023-10-09,203,mango yogurt,50,60,10,1,00072,India
360615,2023-10-09,212,amul cheese,250,315,65,1,00072,India
360615,2023-10-09,202,milk,12,27,15,1,00072,India
665083,2023-10-09,205,classic yogurt,45,60,15,1,00027,India
665083,2023-10-09,204,strawberry yogurt,50,60,10,1,00027,India
665083,2023-10-09,206,yakult,360,400,40,1,00027,India
665083,2023-10-09,209,pepsi,75,100,25,1,00027,India
800972,2023-10-10,209,pepsi,75,100,25,1,00238,India
800972,2023-10-10,208,sprite,75,100,25,1,00238,India
800972,2023-10-10,203,mango yogurt,50,60,10,1,00238,India
800972,2023-10-10,210,mountain dew,75,100,25,1,00238,India
800972,2023-10-10,206,yakult,360,400,40,1,00238,India
673550,2023-10-10,211,red bull,90,125,35,1,00424,India
864212,2023-10-10,206,yakult,360,400,40,1,00181,India
864212,2023-10-10,208,sprite,75,100,25,1,00181,India
826607,2023-10-10,201,paneer,210,340,130,1,00053,India
826607,2023-10-10,205,classic yogurt,45,60,15,1,00053,India
826607,2023-10-10,212,amul cheese,250,315,65,1,00053,India
826607,2023-10-10,211,red bull,90,125,35,1,00053,India
654278,2023-10-10,212,amul cheese,250,315,65,1,00346,India
435813,2023-10-10,201,paneer,210,340,130,1,00499,India
731184,2023-10-10,202,milk,12,27,15,1,00239,India
731184,2023-10-10,204,strawberry yogurt,50,60,10,1,00239,India
935022,2023-10-10,209,pepsi,75,100,25,1,00174,India
935022,2023-10-10,201,paneer,210,340,130,1,00174,India
495971,2023-10-10,203,mango yogurt,50,60,10,1,00236,India
495971,2023-10-10,213,bisleri,6,15,9,1,00236,India
776426,2023-10-10,206,yakult,360,400,40,1,00109,India
776426,2023-10-10,207,coca cola,75,100,25,1,00109,India
776426,2023-10-10,205,classic yogurt,45,60,15,1,00109,India
776426,2023-10-10,203,mango yogurt,50,60,10,1,00109,India
776426,2023-10-10,209,pepsi,75,100,25,1,00109,India
324900,2023-10-10,213,bisleri,6,15,9,1,00354,India
876458,2023-10-10,206,yakult,360,400,40,1,00428,India
876458,2023-10-10,209,pepsi,75,100,25,1,00428,India
876458,2023-10-10,204,strawberry yogurt,50,60,10,1,00428,India
876458,2023-10-10,210,mountain dew,75,100,25,1,00428,India
876458,2023-10-10,213,bisleri,6,15,9,1,00428,India
898440,2023-10-10,205,classic yogurt,45,60,15,1,00351,India
945152,2023-10-10,204,strawberry yogurt,50,60,10,1,00441,India
945152,2023-10-10,208,sprite,75,100,25,1,00441,India
945152,2023-10-10,202,milk,12,27,15,1,00441,India
945152,2023-10-10,212,amul cheese,250,315,65,1,00441,India
883374,2023-10-10,203,mango yogurt,50,60,10,1,00064,India
883374,2023-10-10,205,classic yogurt,45,60,15,1,00064,India
883374,2023-10-10,202,milk,12,27,15,1,00064,India
172462,2023-10-10,201,paneer,210,340,130,1,00202,India
172462,2023-10-10,204,strawberry yogurt,50,60,10,1,00202,India
172462,2023-10-10,207,coca cola,75,100,25,1,00202,India
172462,2023-10-10,212,amul cheese,250,315,65,1,00202,India
940101,2023-10-10,202,milk,12,27,15,1,00292,India
940101,2023-10-10,204,strawberry yogurt,50,60,10,1,00292,India
940101,2023-10-10,201,paneer,210,340,130,1,00292,India
259501,2023-10-10,208,sprite,75,100,25,1,00354,India
259501,2023-10-10,211,red bull,90,125,35,1,00354,India
259501,2023-10-10,201,paneer,210,340,130,1,00354,India
259501,2023-10-10,210,mountain dew,75,100,25,1,00354,India
799152,2023-10-10,210,mountain dew,75,100,25,1,00298,India
799152,2023-10-10,208,sprite,75,100,25,1,00298,India
799152,2023-10-10,205,classic yogurt,45,60,15,1,00298,India
715422,2023-10-10,204,strawberry yogurt,50,60,10,1,00211,India
715422,2023-10-10,201,paneer,210,340,130,1,00211,India
378395,2023-10-10,207,coca cola,75,100,25,1,00188,India
378395,2023-10-10,209,pepsi,75,100,25,1,00188,India
775900,2023-10-10,212,amul cheese,250,315,65,1,00093,India
775900,2023-10-10,206,yakult,360,400,40,1,00093,India
775900,2023-10-10,203,mango yogurt,50,60,10,1,00093,India
752307,2023-10-10,204,strawberry yogurt,50,60,10,1,00123,India
291294,2023-10-10,207,coca cola,75,100,25,1,00192,India
291294,2023-10-10,211,red bull,90,125,35,1,00192,India
186766,2023-10-10,210,mountain dew,75,100,25,1,00259,India
186766,2023-10-10,203,mango yogurt,50,60,10,1,00259,India
186766,2023-10-10,207,coca cola,75,100,25,1,00259,India
186766,2023-10-10,202,milk,12,27,15,1,00259,India
159475,2023-10-10,210,mountain dew,75,100,25,1,00357,India
159475,2023-10-10,206,yakult,360,400,40,1,00357,India
159475,2023-10-10,205,classic yogurt,45,60,15,1,00357,India
159475,2023-10-10,208,sprite,75,100,25,1,00357,India
159475,2023-10-10,203,mango yogurt,50,60,10,1,00357,India
104347,2023-10-10,212,amul cheese,250,315,65,1,00377,India
104347,2023-10-10,205,classic yogurt,45,60,15,1,00377,India
978269,2023-10-10,206,yakult,360,400,40,1,00081,India
978269,2023-10-10,208,sprite,75,100,25,1,00081,India
978269,2023-10-10,211,red bull,90,125,35,1,00081,India
757106,2023-10-10,212,amul cheese,250,315,65,1,00293,India
757106,2023-10-10,201,paneer,210,340,130,1,00293,India
757106,2023-10-10,208,sprite,75,100,25,1,00293,India
768116,2023-10-10,209,pepsi,75,100,25,1,00229,India
841113,2023-10-10,205,classic yogurt,45,60,15,1,00012,India
841113,2023-10-10,206,yakult,360,400,40,1,00012,India
841113,2023-10-10,204,strawberry yogurt,50,60,10,1,00012,India
923534,2023-10-10,211,red bull,90,125,35,1,00381,India
923534,2023-10-10,207,coca cola,75,100,25,1,00381,India
469719,2023-10-10,210,mountain dew,75,100,25,1,00308,India
469719,2023-10-10,211,red bull,90,125,35,1,00308,India
875180,2023-10-10,211,red bull,90,125,35,1,00057,India
207415,2023-10-10,211,red bull,90,125,35,1,00276,India
207415,2023-10-10,207,coca cola,75,100,25,1,00276,India
207415,2023-10-10,209,pepsi,75,100,25,1,00276,India
425455,2023-10-10,211,red bull,90,125,35,1,00288,India
673447,2023-10-10,205,classic yogurt,45,60,15,1,00360,India
673447,2023-10-10,212,amul cheese,250,315,65,1,00360,India
673447,2023-10-10,211,red bull,90,125,35,1,00360,India
673447,2023-10-10,206,yakult,360,400,40,1,00360,India
127818,2023-10-10,207,coca cola,75,100,25,1,00130,India
127818,2023-10-10,213,bisleri,6,15,9,1,00130,India
284087,2023-10-10,204,strawberry yogurt,50,60,10,1,00072,India
284087,2023-10-10,201,paneer,210,340,130,1,00072,India
284087,2023-10-10,202,milk,12,27,15,1,00072,India
284087,2023-10-10,203,mango yogurt,50,60,10,1,00072,India
733787,2023-10-10,208,sprite,75,100,25,1,00194,India
733787,2023-10-10,207,coca cola,75,100,25,1,00194,India
445509,2023-10-10,211,red bull,90,125,35,1,00102,India
445509,2023-10-10,204,strawberry yogurt,50,60,10,1,00102,India
445509,2023-10-10,209,pepsi,75,100,25,1,00102,India
445509,2023-10-10,202,milk,12,27,15,1,00102,India
542468,2023-10-10,206,yakult,360,400,40,1,00499,India
542468,2023-10-10,213,bisleri,6,15,9,1,00499,India
542468,2023-10-10,211,red bull,90,125,35,1,00499,India
548354,2023-10-10,204,strawberry yogurt,50,60,10,1,00162,India
548354,2023-10-10,201,paneer,210,340,130,1,00162,India
548354,2023-10-10,202,milk,12,27,15,1,00162,India
639863,2023-10-10,210,mountain dew,75,100,25,1,00203,India
639863,2023-10-10,208,sprite,75,100,25,1,00203,India
639863,2023-10-10,202,milk,12,27,15,1,00203,India
639863,2023-10-10,209,pepsi,75,100,25,1,00203,India
639863,2023-10-10,212,amul cheese,250,315,65,1,00203,India
159724,2023-10-10,202,milk,12,27,15,1,00339,India
159724,2023-10-10,209,pepsi,75,100,25,1,00339,India
159724,2023-10-10,213,bisleri,6,15,9,1,00339,India
159724,2023-10-10,207,coca cola,75,100,25,1,00339,India
574372,2023-10-10,206,yakult,360,400,40,1,00382,India
574372,2023-10-10,212,amul cheese,250,315,65,1,00382,India
574372,2023-10-10,209,pepsi,75,100,25,1,00382,India
574372,2023-10-10,213,bisleri,6,15,9,1,00382,India
574372,2023-10-10,208,sprite,75,100,25,1,00382,India
481833,2023-10-10,208,sprite,75,100,25,1,00363,India
481833,2023-10-10,212,amul cheese,250,315,65,1,00363,India
481833,2023-10-10,207,coca cola,75,100,25,1,00363,India
958448,2023-10-10,203,mango yogurt,50,60,10,1,00102,India
986792,2023-10-10,212,amul cheese,250,315,65,1,00165,India
986792,2023-10-10,208,sprite,75,100,25,1,00165,India
154545,2023-10-10,204,strawberry yogurt,50,60,10,1,00384,India
154545,2023-10-10,207,coca cola,75,100,25,1,00384,India
154545,2023-10-10,201,paneer,210,340,130,1,00384,India
162792,2023-10-10,206,yakult,360,400,40,1,00499,India
251643,2023-10-10,204,strawberry yogurt,50,60,10,1,00176,India
251643,2023-10-10,201,paneer,210,340,130,1,00176,India
251643,2023-10-10,213,bisleri,6,15,9,1,00176,India
251643,2023-10-10,203,mango yogurt,50,60,10,1,00176,India
530302,2023-10-10,208,sprite,75,100,25,1,00451,India
193243,2023-10-10,210,mountain dew,75,100,25,1,00397,India
193243,2023-10-10,209,pepsi,75,100,25,1,00397,India
193243,2023-10-10,212,amul cheese,250,315,65,1,00397,India
193243,2023-10-10,203,mango yogurt,50,60,10,1,00397,India
193243,2023-10-10,213,bisleri,6,15,9,1,00397,India
138286,2023-10-10,213,bisleri,6,15,9,1,00132,India
138286,2023-10-10,212,amul cheese,250,315,65,1,00132,India
696411,2023-10-10,201,paneer,210,340,130,1,00351,India
696411,2023-10-10,205,classic yogurt,45,60,15,1,00351,India
696411,2023-10-10,210,mountain dew,75,100,25,1,00351,India
696411,2023-10-10,212,amul cheese,250,315,65,1,00351,India
559939,2023-10-10,202,milk,12,27,15,1,00267,India
559939,2023-10-10,212,amul cheese,250,315,65,1,00267,India
798460,2023-10-10,211,red bull,90,125,35,1,00312,India
798460,2023-10-10,206,yakult,360,400,40,1,00312,India
798460,2023-10-10,207,coca cola,75,100,25,1,00312,India
798460,2023-10-10,212,amul cheese,250,315,65,1,00312,India
798460,2023-10-10,204,strawberry yogurt,50,60,10,1,00312,India
316985,2023-10-10,213,bisleri,6,15,9,1,00308,India
316985,2023-10-10,202,milk,12,27,15,1,00308,India
316985,2023-10-10,206,yakult,360,400,40,1,00308,India
249209,2023-10-10,204,strawberry yogurt,50,60,10,1,00188,India
249209,2023-10-10,208,sprite,75,100,25,1,00188,India
699519,2023-10-10,206,yakult,360,400,40,1,00338,India
343565,2023-10-10,212,amul cheese,250,315,65,1,00019,India
343565,2023-10-10,211,red bull,90,125,35,1,00019,India
111216,2023-10-10,201,paneer,210,340,130,1,00025,India
111216,2023-10-10,204,strawberry yogurt,50,60,10,1,00025,India
111216,2023-10-10,206,yakult,360,400,40,1,00025,India
919503,2023-10-10,212,amul cheese,250,315,65,1,00042,India
919503,2023-10-10,202,milk,12,27,15,1,00042,India
821602,2023-10-10,210,mountain dew,75,100,25,1,00066,India
821602,2023-10-10,212,amul cheese,250,315,65,1,00066,India
704848,2023-10-10,203,mango yogurt,50,60,10,1,00040,India
704848,2023-10-10,213,bisleri,6,15,9,1,00040,India
704848,2023-10-10,202,milk,12,27,15,1,00040,India
704848,2023-10-10,208,sprite,75,100,25,1,00040,India
955198,2023-10-10,207,coca cola,75,100,25,1,00471,India
955198,2023-10-10,210,mountain dew,75,100,25,1,00471,India
955198,2023-10-10,208,sprite,75,100,25,1,00471,India
955198,2023-10-10,203,mango yogurt,50,60,10,1,00471,India
955198,2023-10-10,202,milk,12,27,15,1,00471,India
333320,2023-10-10,209,pepsi,75,100,25,1,00402,India
333320,2023-10-10,212,amul cheese,250,315,65,1,00402,India
952065,2023-10-11,206,yakult,360,400,40,1,00046,India
790433,2023-10-11,213,bisleri,6,15,9,1,00029,India
790433,2023-10-11,212,amul cheese,250,315,65,1,00029,India
790433,2023-10-11,210,mountain dew,75,100,25,1,00029,India
790433,2023-10-11,204,strawberry yogurt,50,60,10,1,00029,India
945920,2023-10-11,204,strawberry yogurt,50,60,10,1,00445,India
945920,2023-10-11,210,mountain dew,75,100,25,1,00445,India
945920,2023-10-11,201,paneer,210,340,130,1,00445,India
945920,2023-10-11,213,bisleri,6,15,9,1,00445,India
332743,2023-10-11,213,bisleri,6,15,9,1,00155,India
332743,2023-10-11,205,classic yogurt,45,60,15,1,00155,India
800426,2023-10-11,204,strawberry yogurt,50,60,10,1,00269,India
800426,2023-10-11,211,red bull,90,125,35,1,00269,India
800426,2023-10-11,206,yakult,360,400,40,1,00269,India
800426,2023-10-11,208,sprite,75,100,25,1,00269,India
800426,2023-10-11,212,amul cheese,250,315,65,1,00269,India
802900,2023-10-11,202,milk,12,27,15,1,00297,India
802900,2023-10-11,211,red bull,90,125,35,1,00297,India
933927,2023-10-11,208,sprite,75,100,25,1,00124,India
933927,2023-10-11,201,paneer,210,340,130,1,00124,India
933927,2023-10-11,209,pepsi,75,100,25,1,00124,India
785710,2023-10-11,207,coca cola,75,100,25,1,00158,India
785710,2023-10-11,203,mango yogurt,50,60,10,1,00158,India
707331,2023-10-11,211,red bull,90,125,35,1,00422,India
707331,2023-10-11,207,coca cola,75,100,25,1,00422,India
707331,2023-10-11,206,yakult,360,400,40,1,00422,India
707331,2023-10-11,203,mango yogurt,50,60,10,1,00422,India
141706,2023-10-11,208,sprite,75,100,25,1,00009,India
141706,2023-10-11,205,classic yogurt,45,60,15,1,00009,India
141706,2023-10-11,206,yakult,360,400,40,1,00009,India
652442,2023-10-11,204,strawberry yogurt,50,60,10,1,00460,India
652442,2023-10-11,205,classic yogurt,45,60,15,1,00460,India
652442,2023-10-11,209,pepsi,75,100,25,1,00460,India
304669,2023-10-11,210,mountain dew,75,100,25,1,00278,India
304669,2023-10-11,212,amul cheese,250,315,65,1,00278,India
304669,2023-10-11,207,coca cola,75,100,25,1,00278,India
304669,2023-10-11,211,red bull,90,125,35,1,00278,India
564046,2023-10-11,201,paneer,210,340,130,1,00002,India
564046,2023-10-11,203,mango yogurt,50,60,10,1,00002,India
564046,2023-10-11,209,pepsi,75,100,25,1,00002,India
564046,2023-10-11,210,mountain dew,75,100,25,1,00002,India
305956,2023-10-11,213,bisleri,6,15,9,1,00060,India
305956,2023-10-11,212,amul cheese,250,315,65,1,00060,India
305956,2023-10-11,205,classic yogurt,45,60,15,1,00060,India
464348,2023-10-11,204,strawberry yogurt,50,60,10,1,00001,India
464348,2023-10-11,213,bisleri,6,15,9,1,00001,India
949986,2023-10-11,209,pepsi,75,100,25,1,00014,India
949986,2023-10-11,202,milk,12,27,15,1,00014,India
949986,2023-10-11,206,yakult,360,400,40,1,00014,India
429653,2023-10-11,209,pepsi,75,100,25,1,00304,India
429653,2023-10-11,211,red bull,90,125,35,1,00304,India
429653,2023-10-11,202,milk,12,27,15,1,00304,India
429653,2023-10-11,201,paneer,210,340,130,1,00304,India
736355,2023-10-11,204,strawberry yogurt,50,60,10,1,00038,India
736355,2023-10-11,205,classic yogurt,45,60,15,1,00038,India
528354,2023-10-11,202,milk,12,27,15,1,00316,India
528354,2023-10-11,206,yakult,360,400,40,1,00316,India
528354,2023-10-11,204,strawberry yogurt,50,60,10,1,00316,India
528354,2023-10-11,201,paneer,210,340,130,1,00316,India
459405,2023-10-11,211,red bull,90,125,35,1,00485,India
459405,2023-10-11,206,yakult,360,400,40,1,00485,India
459405,2023-10-11,203,mango yogurt,50,60,10,1,00485,India
410194,2023-10-11,205,classic yogurt,45,60,15,1,00001,India
410194,2023-10-11,209,pepsi,75,100,25,1,00001,India
410194,2023-10-11,204,strawberry yogurt,50,60,10,1,00001,India
410194,2023-10-11,208,sprite,75,100,25,1,00001,India
410194,2023-10-11,210,mountain dew,75,100,25,1,00001,India
480477,2023-10-11,207,coca cola,75,100,25,1,00012,India
480477,2023-10-11,206,yakult,360,400,40,1,00012,India
359999,2023-10-11,201,paneer,210,340,130,1,00337,India
465431,2023-10-11,204,strawberry yogurt,50,60,10,1,00392,India
465431,2023-10-11,206,yakult,360,400,40,1,00392,India
465431,2023-10-11,209,pepsi,75,100,25,1,00392,India
189435,2023-10-11,207,coca cola,75,100,25,1,00138,India
189435,2023-10-11,210,mountain dew,75,100,25,1,00138,India
189435,2023-10-11,209,pepsi,75,100,25,1,00138,India
189435,2023-10-11,211,red bull,90,125,35,1,00138,India
291258,2023-10-11,201,paneer,210,340,130,1,00028,India
291258,2023-10-11,205,classic yogurt,45,60,15,1,00028,India
291258,2023-10-11,212,amul cheese,250,315,65,1,00028,India
905323,2023-10-11,211,red bull,90,125,35,1,00379,India
905323,2023-10-11,204,strawberry yogurt,50,60,10,1,00379,India
905323,2023-10-11,209,pepsi,75,100,25,1,00379,India
495087,2023-10-11,213,bisleri,6,15,9,1,00077,India
495087,2023-10-11,201,paneer,210,340,130,1,00077,India
495087,2023-10-11,205,classic yogurt,45,60,15,1,00077,India
398805,2023-10-11,211,red bull,90,125,35,1,00399,India
398805,2023-10-11,209,pepsi,75,100,25,1,00399,India
398805,2023-10-11,206,yakult,360,400,40,1,00399,India
439526,2023-10-11,205,classic yogurt,45,60,15,1,00500,India
439526,2023-10-11,211,red bull,90,125,35,1,00500,India
126038,2023-10-11,206,yakult,360,400,40,1,00491,India
126038,2023-10-11,204,strawberry yogurt,50,60,10,1,00491,India
126038,2023-10-11,211,red bull,90,125,35,1,00491,India
199784,2023-10-11,206,yakult,360,400,40,1,00476,India
199784,2023-10-11,208,sprite,75,100,25,1,00476,India
508601,2023-10-11,205,classic yogurt,45,60,15,1,00145,India
508601,2023-10-11,210,mountain dew,75,100,25,1,00145,India
508601,2023-10-11,209,pepsi,75,100,25,1,00145,India
508601,2023-10-11,213,bisleri,6,15,9,1,00145,India
823990,2023-10-11,202,milk,12,27,15,1,00207,India
823990,2023-10-11,203,mango yogurt,50,60,10,1,00207,India
823990,2023-10-11,208,sprite,75,100,25,1,00207,India
823990,2023-10-11,204,strawberry yogurt,50,60,10,1,00207,India
823990,2023-10-11,210,mountain dew,75,100,25,1,00207,India
941302,2023-10-11,213,bisleri,6,15,9,1,00250,India
941302,2023-10-11,205,classic yogurt,45,60,15,1,00250,India
123231,2023-10-11,204,strawberry yogurt,50,60,10,1,00132,India
123231,2023-10-11,203,mango yogurt,50,60,10,1,00132,India
123231,2023-10-11,206,yakult,360,400,40,1,00132,India
123231,2023-10-11,210,mountain dew,75,100,25,1,00132,India
457595,2023-10-11,211,red bull,90,125,35,1,00497,India
457595,2023-10-11,213,bisleri,6,15,9,1,00497,India
495217,2023-10-11,205,classic yogurt,45,60,15,1,00296,India
495217,2023-10-11,213,bisleri,6,15,9,1,00296,India
495217,2023-10-11,207,coca cola,75,100,25,1,00296,India
566675,2023-10-11,206,yakult,360,400,40,1,00489,India
566675,2023-10-11,209,pepsi,75,100,25,1,00489,India
630441,2023-10-11,202,milk,12,27,15,1,00410,India
490866,2023-10-11,213,bisleri,6,15,9,1,00230,India
383587,2023-10-11,209,pepsi,75,100,25,1,00481,India
383587,2023-10-11,206,yakult,360,400,40,1,00481,India
383587,2023-10-11,207,coca cola,75,100,25,1,00481,India
198278,2023-10-11,201,paneer,210,340,130,1,00483,India
198278,2023-10-11,202,milk,12,27,15,1,00483,India
198278,2023-10-11,207,coca cola,75,100,25,1,00483,India
928930,2023-10-11,207,coca cola,75,100,25,1,00116,India
539323,2023-10-11,202,milk,12,27,15,1,00092,India
539323,2023-10-11,203,mango yogurt,50,60,10,1,00092,India
539323,2023-10-11,208,sprite,75,100,25,1,00092,India
946952,2023-10-11,209,pepsi,75,100,25,1,00240,India
946952,2023-10-11,210,mountain dew,75,100,25,1,00240,India
946952,2023-10-11,201,paneer,210,340,130,1,00240,India
946952,2023-10-11,202,milk,12,27,15,1,00240,India
270386,2023-10-11,205,classic yogurt,45,60,15,1,00128,India
270386,2023-10-11,204,strawberry yogurt,50,60,10,1,00128,India
270386,2023-10-11,211,red bull,90,125,35,1,00128,India
470510,2023-10-11,204,strawberry yogurt,50,60,10,1,00321,India
470510,2023-10-11,212,amul cheese,250,315,65,1,00321,India
894191,2023-10-11,212,amul cheese,250,315,65,1,00345,India
894191,2023-10-11,204,strawberry yogurt,50,60,10,1,00345,India
894191,2023-10-11,211,red bull,90,125,35,1,00345,India
453775,2023-10-11,204,strawberry yogurt,50,60,10,1,00209,India
453775,2023-10-11,205,classic yogurt,45,60,15,1,00209,India
453775,2023-10-11,201,paneer,210,340,130,1,00209,India
950470,2023-10-11,209,pepsi,75,100,25,1,00156,India
950470,2023-10-11,212,amul cheese,250,315,65,1,00156,India
950470,2023-10-11,202,milk,12,27,15,1,00156,India
950470,2023-10-11,201,paneer,210,340,130,1,00156,India
627015,2023-10-11,210,mountain dew,75,100,25,1,00344,India
627015,2023-10-11,211,red bull,90,125,35,1,00344,India
627015,2023-10-11,205,classic yogurt,45,60,15,1,00344,India
791139,2023-10-11,204,strawberry yogurt,50,60,10,1,00037,India
388688,2023-10-11,205,classic yogurt,45,60,15,1,00246,India
388688,2023-10-11,210,mountain dew,75,100,25,1,00246,India
388688,2023-10-11,212,amul cheese,250,315,65,1,00246,India
388688,2023-10-11,208,sprite,75,100,25,1,00246,India
692983,2023-10-11,205,classic yogurt,45,60,15,1,00379,India
692983,2023-10-11,209,pepsi,75,100,25,1,00379,India
611212,2023-10-11,211,red bull,90,125,35,1,00093,India
611212,2023-10-11,208,sprite,75,100,25,1,00093,India
611212,2023-10-11,206,yakult,360,400,40,1,00093,India
765187,2023-10-11,203,mango yogurt,50,60,10,1,00206,India
765187,2023-10-11,208,sprite,75,100,25,1,00206,India
765187,2023-10-11,202,milk,12,27,15,1,00206,India
786039,2023-10-11,210,mountain dew,75,100,25,1,00014,India
786039,2023-10-11,205,classic yogurt,45,60,15,1,00014,India
786039,2023-10-11,212,amul cheese,250,315,65,1,00014,India
854377,2023-10-11,205,classic yogurt,45,60,15,1,00264,India
854377,2023-10-11,203,mango yogurt,50,60,10,1,00264,India
375165,2023-10-11,205,classic yogurt,45,60,15,1,00382,India
375165,2023-10-11,201,paneer,210,340,130,1,00382,India
375165,2023-10-11,206,yakult,360,400,40,1,00382,India
375165,2023-10-11,212,amul cheese,250,315,65,1,00382,India
578691,2023-10-11,207,coca cola,75,100,25,1,00395,India
677587,2023-10-11,201,paneer,210,340,130,1,00442,India
677587,2023-10-11,210,mountain dew,75,100,25,1,00442,India
677587,2023-10-11,213,bisleri,6,15,9,1,00442,India
142983,2023-10-11,205,classic yogurt,45,60,15,1,00211,India
142983,2023-10-11,212,amul cheese,250,315,65,1,00211,India
142983,2023-10-11,213,bisleri,6,15,9,1,00211,India
142983,2023-10-11,210,mountain dew,75,100,25,1,00211,India
270383,2023-10-11,210,mountain dew,75,100,25,1,00243,India
707542,2023-10-11,212,amul cheese,250,315,65,1,00028,India
707542,2023-10-11,206,yakult,360,400,40,1,00028,India
707542,2023-10-11,205,classic yogurt,45,60,15,1,00028,India
387864,2023-10-11,202,milk,12,27,15,1,00050,India
387864,2023-10-11,205,classic yogurt,45,60,15,1,00050,India
387864,2023-10-11,212,amul cheese,250,315,65,1,00050,India
387864,2023-10-11,211,red bull,90,125,35,1,00050,India
653434,2023-10-11,211,red bull,90,125,35,1,00046,India
653434,2023-10-11,212,amul cheese,250,315,65,1,00046,India
425275,2023-10-11,202,milk,12,27,15,1,00441,India
425275,2023-10-11,208,sprite,75,100,25,1,00441,India
425275,2023-10-11,212,amul cheese,250,315,65,1,00441,India
394620,2023-10-11,204,strawberry yogurt,50,60,10,1,00072,India
394620,2023-10-11,213,bisleri,6,15,9,1,00072,India
394620,2023-10-11,205,classic yogurt,45,60,15,1,00072,India
394620,2023-10-11,211,red bull,90,125,35,1,00072,India
705355,2023-10-11,205,classic yogurt,45,60,15,1,00392,India
705355,2023-10-11,208,sprite,75,100,25,1,00392,India
705355,2023-10-11,206,yakult,360,400,40,1,00392,India
731312,2023-10-11,212,amul cheese,250,315,65,1,00113,India
430750,2023-10-11,212,amul cheese,250,315,65,1,00429,India
217920,2023-10-11,204,strawberry yogurt,50,60,10,1,00031,India
217920,2023-10-11,202,milk,12,27,15,1,00031,India
217920,2023-10-11,209,pepsi,75,100,25,1,00031,India
217920,2023-10-11,206,yakult,360,400,40,1,00031,India
217920,2023-10-11,213,bisleri,6,15,9,1,00031,India
315468,2023-10-11,206,yakult,360,400,40,1,00116,India
315468,2023-10-11,211,red bull,90,125,35,1,00116,India
315468,2023-10-11,205,classic yogurt,45,60,15,1,00116,India
292406,2023-10-11,213,bisleri,6,15,9,1,00027,India
292406,2023-10-11,203,mango yogurt,50,60,10,1,00027,India
548797,2023-10-11,208,sprite,75,100,25,1,00004,India
548797,2023-10-11,204,strawberry yogurt,50,60,10,1,00004,India
914423,2023-10-11,213,bisleri,6,15,9,1,00463,India
914423,2023-10-11,207,coca cola,75,100,25,1,00463,India
914423,2023-10-11,212,amul cheese,250,315,65,1,00463,India
883148,2023-10-11,210,mountain dew,75,100,25,1,00191,India
883148,2023-10-11,212,amul cheese,250,315,65,1,00191,India
554092,2023-10-11,203,mango yogurt,50,60,10,1,00355,India
554092,2023-10-11,207,coca cola,75,100,25,1,00355,India
554092,2023-10-11,211,red bull,90,125,35,1,00355,India
892364,2023-10-11,204,strawberry yogurt,50,60,10,1,00126,India
892364,2023-10-11,206,yakult,360,400,40,1,00126,India
892364,2023-10-11,208,sprite,75,100,25,1,00126,India
892364,2023-10-11,201,paneer,210,340,130,1,00126,India
892364,2023-10-11,212,amul cheese,250,315,65,1,00126,India
281577,2023-10-11,204,strawberry yogurt,50,60,10,1,00187,India
281577,2023-10-11,210,mountain dew,75,100,25,1,00187,India
281577,2023-10-11,201,paneer,210,340,130,1,00187,India
281577,2023-10-11,203,mango yogurt,50,60,10,1,00187,India
816934,2023-10-11,210,mountain dew,75,100,25,1,00113,India
816934,2023-10-11,208,sprite,75,100,25,1,00113,India
610144,2023-10-11,212,amul cheese,250,315,65,1,00026,India
918832,2023-10-11,206,yakult,360,400,40,1,00003,India
918832,2023-10-11,203,mango yogurt,50,60,10,1,00003,India
918832,2023-10-11,202,milk,12,27,15,1,00003,India
918832,2023-10-11,207,coca cola,75,100,25,1,00003,India
918832,2023-10-11,204,strawberry yogurt,50,60,10,1,00003,India
675410,2023-10-11,208,sprite,75,100,25,1,00114,India
675410,2023-10-11,202,milk,12,27,15,1,00114,India
350338,2023-10-11,209,pepsi,75,100,25,1,00254,India
147573,2023-10-11,208,sprite,75,100,25,1,00040,India
147573,2023-10-11,202,milk,12,27,15,1,00040,India
947257,2023-10-12,206,yakult,360,400,40,1,00047,India
947257,2023-10-12,209,pepsi,75,100,25,1,00047,India
947257,2023-10-12,202,milk,12,27,15,1,00047,India
906866,2023-10-12,206,yakult,360,400,40,1,00256,India
727227,2023-10-12,204,strawberry yogurt,50,60,10,1,00337,India
727227,2023-10-12,202,milk,12,27,15,1,00337,India
727227,2023-10-12,210,mountain dew,75,100,25,1,00337,India
727227,2023-10-12,211,red bull,90,125,35,1,00337,India
733499,2023-10-12,207,coca cola,75,100,25,1,00077,India
733499,2023-10-12,213,bisleri,6,15,9,1,00077,India
733499,2023-10-12,201,paneer,210,340,130,1,00077,India
733499,2023-10-12,208,sprite,75,100,25,1,00077,India
732387,2023-10-12,204,strawberry yogurt,50,60,10,1,00416,India
732387,2023-10-12,208,sprite,75,100,25,1,00416,India
732387,2023-10-12,212,amul cheese,250,315,65,1,00416,India
732387,2023-10-12,213,bisleri,6,15,9,1,00416,India
732387,2023-10-12,206,yakult,360,400,40,1,00416,India
354742,2023-10-12,208,sprite,75,100,25,1,00019,India
416029,2023-10-12,201,paneer,210,340,130,1,00031,India
416029,2023-10-12,206,yakult,360,400,40,1,00031,India
416029,2023-10-12,210,mountain dew,75,100,25,1,00031,India
702052,2023-10-12,212,amul cheese,250,315,65,1,00370,India
448794,2023-10-12,205,classic yogurt,45,60,15,1,00453,India
448794,2023-10-12,204,strawberry yogurt,50,60,10,1,00453,India
448794,2023-10-12,209,pepsi,75,100,25,1,00453,India
448794,2023-10-12,212,amul cheese,250,315,65,1,00453,India
448794,2023-10-12,207,coca cola,75,100,25,1,00453,India
851594,2023-10-12,206,yakult,360,400,40,1,00219,India
377546,2023-10-12,202,milk,12,27,15,1,00013,India
377546,2023-10-12,211,red bull,90,125,35,1,00013,India
377546,2023-10-12,210,mountain dew,75,100,25,1,00013,India
377546,2023-10-12,212,amul cheese,250,315,65,1,00013,India
295086,2023-10-12,210,mountain dew,75,100,25,1,00116,India
295086,2023-10-12,212,amul cheese,250,315,65,1,00116,India
295086,2023-10-12,204,strawberry yogurt,50,60,10,1,00116,India
672084,2023-10-12,213,bisleri,6,15,9,1,00197,India
672084,2023-10-12,210,mountain dew,75,100,25,1,00197,India
672084,2023-10-12,207,coca cola,75,100,25,1,00197,India
672084,2023-10-12,201,paneer,210,340,130,1,00197,India
672084,2023-10-12,208,sprite,75,100,25,1,00197,India
284075,2023-10-12,208,sprite,75,100,25,1,00287,India
284075,2023-10-12,209,pepsi,75,100,25,1,00287,India
284075,2023-10-12,211,red bull,90,125,35,1,00287,India
418026,2023-10-12,209,pepsi,75,100,25,1,00203,India
418026,2023-10-12,207,coca cola,75,100,25,1,00203,India
312270,2023-10-12,201,paneer,210,340,130,1,00181,India
312270,2023-10-12,211,red bull,90,125,35,1,00181,India
700551,2023-10-12,208,sprite,75,100,25,1,00354,India
700551,2023-10-12,207,coca cola,75,100,25,1,00354,India
998959,2023-10-12,205,classic yogurt,45,60,15,1,00432,India
998959,2023-10-12,212,amul cheese,250,315,65,1,00432,India
998959,2023-10-12,201,paneer,210,340,130,1,00432,India
998959,2023-10-12,207,coca cola,75,100,25,1,00432,India
824258,2023-10-12,205,classic yogurt,45,60,15,1,00193,India
824258,2023-10-12,206,yakult,360,400,40,1,00193,India
957439,2023-10-12,208,sprite,75,100,25,1,00093,India
257297,2023-10-12,202,milk,12,27,15,1,00480,India
257297,2023-10-12,205,classic yogurt,45,60,15,1,00480,India
257297,2023-10-12,207,coca cola,75,100,25,1,00480,India
897905,2023-10-12,203,mango yogurt,50,60,10,1,00426,India
897905,2023-10-12,204,strawberry yogurt,50,60,10,1,00426,India
871876,2023-10-12,206,yakult,360,400,40,1,00020,India
871876,2023-10-12,213,bisleri,6,15,9,1,00020,India
871876,2023-10-12,201,paneer,210,340,130,1,00020,India
871876,2023-10-12,202,milk,12,27,15,1,00020,India
953533,2023-10-12,204,strawberry yogurt,50,60,10,1,00237,India
953533,2023-10-12,206,yakult,360,400,40,1,00237,India
469725,2023-10-12,205,classic yogurt,45,60,15,1,00051,India
732353,2023-10-12,207,coca cola,75,100,25,1,00293,India
732353,2023-10-12,203,mango yogurt,50,60,10,1,00293,India
732353,2023-10-12,204,strawberry yogurt,50,60,10,1,00293,India
651693,2023-10-12,211,red bull,90,125,35,1,00188,India
651693,2023-10-12,212,amul cheese,250,315,65,1,00188,India
848815,2023-10-12,203,mango yogurt,50,60,10,1,00268,India
600954,2023-10-12,213,bisleri,6,15,9,1,00360,India
779781,2023-10-12,207,coca cola,75,100,25,1,00283,India
779781,2023-10-12,213,bisleri,6,15,9,1,00283,India
779781,2023-10-12,210,mountain dew,75,100,25,1,00283,India
779781,2023-10-12,211,red bull,90,125,35,1,00283,India
555810,2023-10-12,202,milk,12,27,15,1,00444,India
714777,2023-10-12,201,paneer,210,340,130,1,00363,India
714777,2023-10-12,202,milk,12,27,15,1,00363,India
714777,2023-10-12,209,pepsi,75,100,25,1,00363,India
714777,2023-10-12,204,strawberry yogurt,50,60,10,1,00363,India
880101,2023-10-12,201,paneer,210,340,130,1,00297,India
880101,2023-10-12,207,coca cola,75,100,25,1,00297,India
880101,2023-10-12,211,red bull,90,125,35,1,00297,India
880101,2023-10-12,210,mountain dew,75,100,25,1,00297,India
880101,2023-10-12,202,milk,12,27,15,1,00297,India
168897,2023-10-12,207,coca cola,75,100,25,1,00410,India
168897,2023-10-12,204,strawberry yogurt,50,60,10,1,00410,India
168897,2023-10-12,201,paneer,210,340,130,1,00410,India
644972,2023-10-12,212,amul cheese,250,315,65,1,00415,India
644972,2023-10-12,208,sprite,75,100,25,1,00415,India
644972,2023-10-12,205,classic yogurt,45,60,15,1,00415,India
747491,2023-10-12,201,paneer,210,340,130,1,00130,India
747491,2023-10-12,212,amul cheese,250,315,65,1,00130,India
747491,2023-10-12,204,strawberry yogurt,50,60,10,1,00130,India
747491,2023-10-12,209,pepsi,75,100,25,1,00130,India
742441,2023-10-12,204,strawberry yogurt,50,60,10,1,00366,India
742441,2023-10-12,208,sprite,75,100,25,1,00366,India
742441,2023-10-12,203,mango yogurt,50,60,10,1,00366,India
742441,2023-10-12,210,mountain dew,75,100,25,1,00366,India
742441,2023-10-12,202,milk,12,27,15,1,00366,India
822348,2023-10-12,207,coca cola,75,100,25,1,00246,India
822348,2023-10-12,203,mango yogurt,50,60,10,1,00246,India
822348,2023-10-12,210,mountain dew,75,100,25,1,00246,India
822348,2023-10-12,208,sprite,75,100,25,1,00246,India
822348,2023-10-12,204,strawberry yogurt,50,60,10,1,00246,India
300070,2023-10-12,213,bisleri,6,15,9,1,00326,India
480580,2023-10-12,213,bisleri,6,15,9,1,00212,India
356307,2023-10-12,203,mango yogurt,50,60,10,1,00284,India
356307,2023-10-12,206,yakult,360,400,40,1,00284,India
356307,2023-10-12,211,red bull,90,125,35,1,00284,India
655840,2023-10-12,211,red bull,90,125,35,1,00165,India
655840,2023-10-12,204,strawberry yogurt,50,60,10,1,00165,India
655840,2023-10-12,213,bisleri,6,15,9,1,00165,India
915643,2023-10-12,210,mountain dew,75,100,25,1,00490,India
254747,2023-10-12,202,milk,12,27,15,1,00263,India
254747,2023-10-12,211,red bull,90,125,35,1,00263,India
254747,2023-10-12,212,amul cheese,250,315,65,1,00263,India
254747,2023-10-12,203,mango yogurt,50,60,10,1,00263,India
324213,2023-10-12,209,pepsi,75,100,25,1,00206,India
324213,2023-10-12,208,sprite,75,100,25,1,00206,India
303296,2023-10-12,201,paneer,210,340,130,1,00345,India
303296,2023-10-12,205,classic yogurt,45,60,15,1,00345,India
303296,2023-10-12,210,mountain dew,75,100,25,1,00345,India
730064,2023-10-12,205,classic yogurt,45,60,15,1,00008,India
730064,2023-10-12,203,mango yogurt,50,60,10,1,00008,India
369328,2023-10-12,211,red bull,90,125,35,1,00422,India
369328,2023-10-12,203,mango yogurt,50,60,10,1,00422,India
369328,2023-10-12,207,coca cola,75,100,25,1,00422,India
369328,2023-10-12,210,mountain dew,75,100,25,1,00422,India
317741,2023-10-12,202,milk,12,27,15,1,00235,India
317741,2023-10-12,201,paneer,210,340,130,1,00235,India
317741,2023-10-12,213,bisleri,6,15,9,1,00235,India
939027,2023-10-12,205,classic yogurt,45,60,15,1,00296,India
939027,2023-10-12,207,coca cola,75,100,25,1,00296,India
939027,2023-10-12,203,mango yogurt,50,60,10,1,00296,India
939027,2023-10-12,209,pepsi,75,100,25,1,00296,India
125717,2023-10-12,206,yakult,360,400,40,1,00262,India
125717,2023-10-12,211,red bull,90,125,35,1,00262,India
636801,2023-10-12,206,yakult,360,400,40,1,00193,India
636801,2023-10-12,205,classic yogurt,45,60,15,1,00193,India
636801,2023-10-12,201,paneer,210,340,130,1,00193,India
636801,2023-10-12,202,milk,12,27,15,1,00193,India
636801,2023-10-12,208,sprite,75,100,25,1,00193,India
765104,2023-10-12,205,classic yogurt,45,60,15,1,00175,India
693067,2023-10-12,211,red bull,90,125,35,1,00326,India
693067,2023-10-12,204,strawberry yogurt,50,60,10,1,00326,India
693067,2023-10-12,202,milk,12,27,15,1,00326,India
892731,2023-10-12,210,mountain dew,75,100,25,1,00023,India
892731,2023-10-12,208,sprite,75,100,25,1,00023,India
892731,2023-10-12,201,paneer,210,340,130,1,00023,India
892731,2023-10-12,204,strawberry yogurt,50,60,10,1,00023,India
799097,2023-10-12,201,paneer,210,340,130,1,00137,India
799097,2023-10-12,202,milk,12,27,15,1,00137,India
467630,2023-10-12,201,paneer,210,340,130,1,00399,India
467630,2023-10-12,212,amul cheese,250,315,65,1,00399,India
467630,2023-10-12,205,classic yogurt,45,60,15,1,00399,India
163480,2023-10-12,207,coca cola,75,100,25,1,00485,India
163480,2023-10-12,201,paneer,210,340,130,1,00485,India
163480,2023-10-12,203,mango yogurt,50,60,10,1,00485,India
625455,2023-10-12,207,coca cola,75,100,25,1,00010,India
847441,2023-10-12,202,milk,12,27,15,1,00301,India
847441,2023-10-12,210,mountain dew,75,100,25,1,00301,India
847441,2023-10-12,209,pepsi,75,100,25,1,00301,India
690932,2023-10-12,202,milk,12,27,15,1,00268,India
690932,2023-10-12,201,paneer,210,340,130,1,00268,India
690932,2023-10-12,205,classic yogurt,45,60,15,1,00268,India
900374,2023-10-12,203,mango yogurt,50,60,10,1,00451,India
900374,2023-10-12,206,yakult,360,400,40,1,00451,India
900374,2023-10-12,208,sprite,75,100,25,1,00451,India
872422,2023-10-12,205,classic yogurt,45,60,15,1,00057,India
872422,2023-10-12,206,yakult,360,400,40,1,00057,India
872422,2023-10-12,208,sprite,75,100,25,1,00057,India
582883,2023-10-12,212,amul cheese,250,315,65,1,00369,India
582883,2023-10-12,208,sprite,75,100,25,1,00369,India
417519,2023-10-12,208,sprite,75,100,25,1,00246,India
865080,2023-10-12,204,strawberry yogurt,50,60,10,1,00444,India
865080,2023-10-12,207,coca cola,75,100,25,1,00444,India
865080,2023-10-12,202,milk,12,27,15,1,00444,India
394815,2023-10-12,213,bisleri,6,15,9,1,00293,India
394815,2023-10-12,205,classic yogurt,45,60,15,1,00293,India
307434,2023-10-12,203,mango yogurt,50,60,10,1,00274,India
307434,2023-10-12,212,amul cheese,250,315,65,1,00274,India
307434,2023-10-12,206,yakult,360,400,40,1,00274,India
307434,2023-10-12,208,sprite,75,100,25,1,00274,India
307434,2023-10-12,209,pepsi,75,100,25,1,00274,India
853899,2023-10-12,210,mountain dew,75,100,25,1,00256,India
853899,2023-10-12,201,paneer,210,340,130,1,00256,India
853899,2023-10-12,205,classic yogurt,45,60,15,1,00256,India
213786,2023-10-12,212,amul cheese,250,315,65,1,00377,India
213786,2023-10-12,208,sprite,75,100,25,1,00377,India
213786,2023-10-12,209,pepsi,75,100,25,1,00377,India
213786,2023-10-12,205,classic yogurt,45,60,15,1,00377,India
847543,2023-10-12,203,mango yogurt,50,60,10,1,00317,India
847543,2023-10-12,201,paneer,210,340,130,1,00317,India
847543,2023-10-12,204,strawberry yogurt,50,60,10,1,00317,India
847543,2023-10-12,208,sprite,75,100,25,1,00317,India
412973,2023-10-12,207,coca cola,75,100,25,1,00399,India
412973,2023-10-12,202,milk,12,27,15,1,00399,India
973439,2023-10-12,203,mango yogurt,50,60,10,1,00155,India
796654,2023-10-12,209,pepsi,75,100,25,1,00090,India
796654,2023-10-12,212,amul cheese,250,315,65,1,00090,India
440046,2023-10-12,202,milk,12,27,15,1,00228,India
810243,2023-10-12,206,yakult,360,400,40,1,00453,India
812314,2023-10-12,213,bisleri,6,15,9,1,00305,India
812314,2023-10-12,211,red bull,90,125,35,1,00305,India
812314,2023-10-12,212,amul cheese,250,315,65,1,00305,India
812314,2023-10-12,202,milk,12,27,15,1,00305,India
812314,2023-10-12,204,strawberry yogurt,50,60,10,1,00305,India
176796,2023-10-12,212,amul cheese,250,315,65,1,00081,India
176796,2023-10-12,204,strawberry yogurt,50,60,10,1,00081,India
114764,2023-10-12,202,milk,12,27,15,1,00114,India
114764,2023-10-12,210,mountain dew,75,100,25,1,00114,India
406556,2023-10-12,206,yakult,360,400,40,1,00380,India
275827,2023-10-12,213,bisleri,6,15,9,1,00280,India
348455,2023-10-12,209,pepsi,75,100,25,1,00101,India
434588,2023-10-12,202,milk,12,27,15,1,00347,India
434588,2023-10-12,201,paneer,210,340,130,1,00347,India
478164,2023-10-12,208,sprite,75,100,25,1,00267,India
478164,2023-10-12,209,pepsi,75,100,25,1,00267,India
478164,2023-10-12,203,mango yogurt,50,60,10,1,00267,India
478164,2023-10-12,202,milk,12,27,15,1,00267,India
126537,2023-10-12,210,mountain dew,75,100,25,1,00356,India
126537,2023-10-12,208,sprite,75,100,25,1,00356,India
126537,2023-10-12,204,strawberry yogurt,50,60,10,1,00356,India
911331,2023-10-12,206,yakult,360,400,40,1,00390,India
911331,2023-10-12,202,milk,12,27,15,1,00390,India
963983,2023-10-12,202,milk,12,27,15,1,00153,India
963983,2023-10-12,211,red bull,90,125,35,1,00153,India
748542,2023-10-12,204,strawberry yogurt,50,60,10,1,00098,India
748542,2023-10-12,202,milk,12,27,15,1,00098,India
748542,2023-10-12,210,mountain dew,75,100,25,1,00098,India
748542,2023-10-12,212,amul cheese,250,315,65,1,00098,India
148051,2023-10-12,210,mountain dew,75,100,25,1,00446,India
148051,2023-10-12,204,strawberry yogurt,50,60,10,1,00446,India
148051,2023-10-12,209,pepsi,75,100,25,1,00446,India
148051,2023-10-12,201,paneer,210,340,130,1,00446,India
148051,2023-10-12,202,milk,12,27,15,1,00446,India
461986,2023-10-12,211,red bull,90,125,35,1,00170,India
461986,2023-10-12,209,pepsi,75,100,25,1,00170,India
956844,2023-10-12,209,pepsi,75,100,25,1,00280,India
238770,2023-10-12,204,strawberry yogurt,50,60,10,1,00039,India
933040,2023-10-12,211,red bull,90,125,35,1,00034,India
933040,2023-10-12,206,yakult,360,400,40,1,00034,India
196790,2023-10-12,213,bisleri,6,15,9,1,00334,India
196790,2023-10-12,204,strawberry yogurt,50,60,10,1,00334,India
196790,2023-10-12,202,milk,12,27,15,1,00334,India
527855,2023-10-12,208,sprite,75,100,25,1,00355,India
527855,2023-10-12,201,paneer,210,340,130,1,00355,India
527855,2023-10-12,202,milk,12,27,15,1,00355,India
527855,2023-10-12,205,classic yogurt,45,60,15,1,00355,India
856040,2023-10-12,213,bisleri,6,15,9,1,00461,India
159612,2023-10-12,210,mountain dew,75,100,25,1,00161,India
159612,2023-10-12,201,paneer,210,340,130,1,00161,India
543774,2023-10-12,202,milk,12,27,15,1,00325,India
543774,2023-10-12,201,paneer,210,340,130,1,00325,India
127224,2023-10-12,208,sprite,75,100,25,1,00024,India
127224,2023-10-12,204,strawberry yogurt,50,60,10,1,00024,India
127224,2023-10-12,213,bisleri,6,15,9,1,00024,India
418885,2023-10-12,212,amul cheese,250,315,65,1,00244,India
840193,2023-10-13,207,coca cola,75,100,25,1,00468,India
840193,2023-10-13,205,classic yogurt,45,60,15,1,00468,India
903974,2023-10-13,212,amul cheese,250,315,65,1,00258,India
903974,2023-10-13,206,yakult,360,400,40,1,00258,India
903974,2023-10-13,211,red bull,90,125,35,1,00258,India
903974,2023-10-13,213,bisleri,6,15,9,1,00258,India
156480,2023-10-13,213,bisleri,6,15,9,1,00191,India
156480,2023-10-13,208,sprite,75,100,25,1,00191,India
156480,2023-10-13,204,strawberry yogurt,50,60,10,1,00191,India
156480,2023-10-13,203,mango yogurt,50,60,10,1,00191,India
156480,2023-10-13,202,milk,12,27,15,1,00191,India
573150,2023-10-13,205,classic yogurt,45,60,15,1,00095,India
573150,2023-10-13,206,yakult,360,400,40,1,00095,India
573150,2023-10-13,202,milk,12,27,15,1,00095,India
573150,2023-10-13,210,mountain dew,75,100,25,1,00095,India
988205,2023-10-13,211,red bull,90,125,35,1,00408,India
335516,2023-10-13,202,milk,12,27,15,1,00021,India
335516,2023-10-13,212,amul cheese,250,315,65,1,00021,India
156969,2023-10-13,208,sprite,75,100,25,1,00388,India
156969,2023-10-13,202,milk,12,27,15,1,00388,India
156969,2023-10-13,209,pepsi,75,100,25,1,00388,India
636342,2023-10-13,212,amul cheese,250,315,65,1,00086,India
636342,2023-10-13,209,pepsi,75,100,25,1,00086,India
586601,2023-10-13,205,classic yogurt,45,60,15,1,00256,India
586601,2023-10-13,213,bisleri,6,15,9,1,00256,India
586601,2023-10-13,206,yakult,360,400,40,1,00256,India
586601,2023-10-13,209,pepsi,75,100,25,1,00256,India
108139,2023-10-13,206,yakult,360,400,40,1,00038,India
361441,2023-10-13,210,mountain dew,75,100,25,1,00370,India
361441,2023-10-13,213,bisleri,6,15,9,1,00370,India
361441,2023-10-13,209,pepsi,75,100,25,1,00370,India
361441,2023-10-13,204,strawberry yogurt,50,60,10,1,00370,India
112844,2023-10-13,204,strawberry yogurt,50,60,10,1,00359,India
112844,2023-10-13,210,mountain dew,75,100,25,1,00359,India
592434,2023-10-13,202,milk,12,27,15,1,00353,India
592434,2023-10-13,205,classic yogurt,45,60,15,1,00353,India
579258,2023-10-13,211,red bull,90,125,35,1,00402,India
579258,2023-10-13,208,sprite,75,100,25,1,00402,India
579258,2023-10-13,201,paneer,210,340,130,1,00402,India
700528,2023-10-13,210,mountain dew,75,100,25,1,00059,India
700528,2023-10-13,204,strawberry yogurt,50,60,10,1,00059,India
700528,2023-10-13,206,yakult,360,400,40,1,00059,India
368517,2023-10-13,208,sprite,75,100,25,1,00112,India
459883,2023-10-13,203,mango yogurt,50,60,10,1,00173,India
459883,2023-10-13,208,sprite,75,100,25,1,00173,India
459883,2023-10-13,207,coca cola,75,100,25,1,00173,India
426954,2023-10-13,204,strawberry yogurt,50,60,10,1,00432,India
426954,2023-10-13,211,red bull,90,125,35,1,00432,India
426954,2023-10-13,203,mango yogurt,50,60,10,1,00432,India
426954,2023-10-13,205,classic yogurt,45,60,15,1,00432,India
113863,2023-10-13,212,amul cheese,250,315,65,1,00054,India
113863,2023-10-13,206,yakult,360,400,40,1,00054,India
580655,2023-10-13,206,yakult,360,400,40,1,00478,India
580655,2023-10-13,203,mango yogurt,50,60,10,1,00478,India
101681,2023-10-13,204,strawberry yogurt,50,60,10,1,00489,India
101681,2023-10-13,212,amul cheese,250,315,65,1,00489,India
101681,2023-10-13,210,mountain dew,75,100,25,1,00489,India
101681,2023-10-13,209,pepsi,75,100,25,1,00489,India
101681,2023-10-13,201,paneer,210,340,130,1,00489,India
357283,2023-10-13,205,classic yogurt,45,60,15,1,00100,India
357283,2023-10-13,209,pepsi,75,100,25,1,00100,India
357283,2023-10-13,208,sprite,75,100,25,1,00100,India
357283,2023-10-13,206,yakult,360,400,40,1,00100,India
800872,2023-10-13,202,milk,12,27,15,1,00333,India
800872,2023-10-13,207,coca cola,75,100,25,1,00333,India
800872,2023-10-13,206,yakult,360,400,40,1,00333,India
816037,2023-10-13,202,milk,12,27,15,1,00169,India
816037,2023-10-13,211,red bull,90,125,35,1,00169,India
342290,2023-10-13,211,red bull,90,125,35,1,00483,India
149597,2023-10-13,204,strawberry yogurt,50,60,10,1,00038,India
149597,2023-10-13,211,red bull,90,125,35,1,00038,India
149597,2023-10-13,201,paneer,210,340,130,1,00038,India
978726,2023-10-13,203,mango yogurt,50,60,10,1,00178,India
978726,2023-10-13,211,red bull,90,125,35,1,00178,India
876880,2023-10-13,202,milk,12,27,15,1,00032,India
876880,2023-10-13,206,yakult,360,400,40,1,00032,India
876880,2023-10-13,213,bisleri,6,15,9,1,00032,India
972714,2023-10-13,209,pepsi,75,100,25,1,00320,India
972714,2023-10-13,204,strawberry yogurt,50,60,10,1,00320,India
972714,2023-10-13,212,amul cheese,250,315,65,1,00320,India
229096,2023-10-13,213,bisleri,6,15,9,1,00169,India
229096,2023-10-13,203,mango yogurt,50,60,10,1,00169,India
229096,2023-10-13,206,yakult,360,400,40,1,00169,India
965342,2023-10-13,206,yakult,360,400,40,1,00191,India
479835,2023-10-13,212,amul cheese,250,315,65,1,00463,India
564532,2023-10-13,202,milk,12,27,15,1,00444,India
564532,2023-10-13,212,amul cheese,250,315,65,1,00444,India
564532,2023-10-13,204,strawberry yogurt,50,60,10,1,00444,India
564532,2023-10-13,206,yakult,360,400,40,1,00444,India
564532,2023-10-13,201,paneer,210,340,130,1,00444,India
622156,2023-10-13,205,classic yogurt,45,60,15,1,00181,India
622156,2023-10-13,201,paneer,210,340,130,1,00181,India
963795,2023-10-13,208,sprite,75,100,25,1,00066,India
963795,2023-10-13,205,classic yogurt,45,60,15,1,00066,India
672349,2023-10-13,202,milk,12,27,15,1,00019,India
684906,2023-10-13,205,classic yogurt,45,60,15,1,00401,India
684906,2023-10-13,210,mountain dew,75,100,25,1,00401,India
684906,2023-10-13,209,pepsi,75,100,25,1,00401,India
842993,2023-10-13,201,paneer,210,340,130,1,00470,India
842993,2023-10-13,205,classic yogurt,45,60,15,1,00470,India
588018,2023-10-13,212,amul cheese,250,315,65,1,00026,India
588018,2023-10-13,210,mountain dew,75,100,25,1,00026,India
588018,2023-10-13,208,sprite,75,100,25,1,00026,India
588018,2023-10-13,202,milk,12,27,15,1,00026,India
588018,2023-10-13,213,bisleri,6,15,9,1,00026,India
565753,2023-10-13,204,strawberry yogurt,50,60,10,1,00470,India
183554,2023-10-13,209,pepsi,75,100,25,1,00061,India
183554,2023-10-13,207,coca cola,75,100,25,1,00061,India
183554,2023-10-13,212,amul cheese,250,315,65,1,00061,India
184242,2023-10-13,210,mountain dew,75,100,25,1,00102,India
184242,2023-10-13,201,paneer,210,340,130,1,00102,India
184242,2023-10-13,212,amul cheese,250,315,65,1,00102,India
184242,2023-10-13,206,yakult,360,400,40,1,00102,India
184242,2023-10-13,208,sprite,75,100,25,1,00102,India
444998,2023-10-13,203,mango yogurt,50,60,10,1,00404,India
763921,2023-10-13,204,strawberry yogurt,50,60,10,1,00108,India
763921,2023-10-13,213,bisleri,6,15,9,1,00108,India
735290,2023-10-13,206,yakult,360,400,40,1,00040,India
735290,2023-10-13,211,red bull,90,125,35,1,00040,India
735290,2023-10-13,205,classic yogurt,45,60,15,1,00040,India
735290,2023-10-13,204,strawberry yogurt,50,60,10,1,00040,India
233939,2023-10-13,208,sprite,75,100,25,1,00042,India
233939,2023-10-13,213,bisleri,6,15,9,1,00042,India
824116,2023-10-13,208,sprite,75,100,25,1,00331,India
929025,2023-10-13,213,bisleri,6,15,9,1,00371,India
929025,2023-10-13,205,classic yogurt,45,60,15,1,00371,India
988671,2023-10-13,206,yakult,360,400,40,1,00102,India
988671,2023-10-13,204,strawberry yogurt,50,60,10,1,00102,India
496019,2023-10-13,212,amul cheese,250,315,65,1,00045,India
496019,2023-10-13,204,strawberry yogurt,50,60,10,1,00045,India
496019,2023-10-13,207,coca cola,75,100,25,1,00045,India
496019,2023-10-13,209,pepsi,75,100,25,1,00045,India
496019,2023-10-13,203,mango yogurt,50,60,10,1,00045,India
638538,2023-10-13,211,red bull,90,125,35,1,00379,India
638538,2023-10-13,203,mango yogurt,50,60,10,1,00379,India
617209,2023-10-13,213,bisleri,6,15,9,1,00376,India
617209,2023-10-13,210,mountain dew,75,100,25,1,00376,India
617209,2023-10-13,206,yakult,360,400,40,1,00376,India
154586,2023-10-13,212,amul cheese,250,315,65,1,00116,India
154586,2023-10-13,204,strawberry yogurt,50,60,10,1,00116,India
154586,2023-10-13,202,milk,12,27,15,1,00116,India
368152,2023-10-13,211,red bull,90,125,35,1,00056,India
368152,2023-10-13,202,milk,12,27,15,1,00056,India
368152,2023-10-13,212,amul cheese,250,315,65,1,00056,India
464491,2023-10-13,201,paneer,210,340,130,1,00450,India
464491,2023-10-13,206,yakult,360,400,40,1,00450,India
464491,2023-10-13,203,mango yogurt,50,60,10,1,00450,India
464491,2023-10-13,213,bisleri,6,15,9,1,00450,India
464491,2023-10-13,205,classic yogurt,45,60,15,1,00450,India
494542,2023-10-14,211,red bull,90,125,35,1,00291,India
494542,2023-10-14,212,amul cheese,250,315,65,1,00291,India
494542,2023-10-14,203,mango yogurt,50,60,10,1,00291,India
844346,2023-10-14,201,paneer,210,340,130,1,00409,India
844346,2023-10-14,208,sprite,75,100,25,1,00409,India
811082,2023-10-14,212,amul cheese,250,315,65,1,00479,India
811082,2023-10-14,213,bisleri,6,15,9,1,00479,India
811082,2023-10-14,208,sprite,75,100,25,1,00479,India
811082,2023-10-14,211,red bull,90,125,35,1,00479,India
811082,2023-10-14,204,strawberry yogurt,50,60,10,1,00479,India
970398,2023-10-14,201,paneer,210,340,130,1,00089,India
970398,2023-10-14,210,mountain dew,75,100,25,1,00089,India
970398,2023-10-14,204,strawberry yogurt,50,60,10,1,00089,India
970398,2023-10-14,206,yakult,360,400,40,1,00089,India
652187,2023-10-14,204,strawberry yogurt,50,60,10,1,00346,India
989452,2023-10-14,211,red bull,90,125,35,1,00221,India
989452,2023-10-14,209,pepsi,75,100,25,1,00221,India
318856,2023-10-14,203,mango yogurt,50,60,10,1,00241,India
318856,2023-10-14,209,pepsi,75,100,25,1,00241,India
318856,2023-10-14,206,yakult,360,400,40,1,00241,India
645484,2023-10-14,210,mountain dew,75,100,25,1,00208,India
645484,2023-10-14,211,red bull,90,125,35,1,00208,India
645484,2023-10-14,209,pepsi,75,100,25,1,00208,India
645484,2023-10-14,212,amul cheese,250,315,65,1,00208,India
561238,2023-10-14,208,sprite,75,100,25,1,00169,India
389811,2023-10-14,210,mountain dew,75,100,25,1,00483,India
389811,2023-10-14,206,yakult,360,400,40,1,00483,India
389811,2023-10-14,202,milk,12,27,15,1,00483,India
389811,2023-10-14,213,bisleri,6,15,9,1,00483,India
296911,2023-10-14,206,yakult,360,400,40,1,00077,India
690075,2023-10-14,213,bisleri,6,15,9,1,00286,India
690075,2023-10-14,203,mango yogurt,50,60,10,1,00286,India
690075,2023-10-14,211,red bull,90,125,35,1,00286,India
690075,2023-10-14,207,coca cola,75,100,25,1,00286,India
690075,2023-10-14,202,milk,12,27,15,1,00286,India
909292,2023-10-14,208,sprite,75,100,25,1,00314,India
298638,2023-10-14,202,milk,12,27,15,1,00086,India
298638,2023-10-14,212,amul cheese,250,315,65,1,00086,India
298638,2023-10-14,209,pepsi,75,100,25,1,00086,India
298638,2023-10-14,207,coca cola,75,100,25,1,00086,India
268762,2023-10-14,213,bisleri,6,15,9,1,00157,India
352533,2023-10-14,209,pepsi,75,100,25,1,00432,India
352533,2023-10-14,202,milk,12,27,15,1,00432,India
352533,2023-10-14,210,mountain dew,75,100,25,1,00432,India
352533,2023-10-14,204,strawberry yogurt,50,60,10,1,00432,India
352533,2023-10-14,203,mango yogurt,50,60,10,1,00432,India
776045,2023-10-14,203,mango yogurt,50,60,10,1,00438,India
776045,2023-10-14,202,milk,12,27,15,1,00438,India
776045,2023-10-14,210,mountain dew,75,100,25,1,00438,India
676816,2023-10-14,210,mountain dew,75,100,25,1,00397,India
676816,2023-10-14,213,bisleri,6,15,9,1,00397,India
127376,2023-10-14,209,pepsi,75,100,25,1,00464,India
127376,2023-10-14,203,mango yogurt,50,60,10,1,00464,India
127376,2023-10-14,202,milk,12,27,15,1,00464,India
150443,2023-10-14,208,sprite,75,100,25,1,00055,India
150443,2023-10-14,209,pepsi,75,100,25,1,00055,India
150443,2023-10-14,206,yakult,360,400,40,1,00055,India
384361,2023-10-14,202,milk,12,27,15,1,00122,India
384361,2023-10-14,206,yakult,360,400,40,1,00122,India
384361,2023-10-14,208,sprite,75,100,25,1,00122,India
384361,2023-10-14,210,mountain dew,75,100,25,1,00122,India
229648,2023-10-14,204,strawberry yogurt,50,60,10,1,00001,India
229648,2023-10-14,210,mountain dew,75,100,25,1,00001,India
952530,2023-10-14,202,milk,12,27,15,1,00337,India
952530,2023-10-14,205,classic yogurt,45,60,15,1,00337,India
952530,2023-10-14,203,mango yogurt,50,60,10,1,00337,India
494479,2023-10-14,210,mountain dew,75,100,25,1,00034,India
719517,2023-10-14,213,bisleri,6,15,9,1,00469,India
719517,2023-10-14,212,amul cheese,250,315,65,1,00469,India
223358,2023-10-14,210,mountain dew,75,100,25,1,00398,India
223358,2023-10-14,201,paneer,210,340,130,1,00398,India
223358,2023-10-14,209,pepsi,75,100,25,1,00398,India
550298,2023-10-14,204,strawberry yogurt,50,60,10,1,00196,India
550298,2023-10-14,208,sprite,75,100,25,1,00196,India
550298,2023-10-14,205,classic yogurt,45,60,15,1,00196,India
550298,2023-10-14,209,pepsi,75,100,25,1,00196,India
550298,2023-10-14,206,yakult,360,400,40,1,00196,India
702088,2023-10-14,206,yakult,360,400,40,1,00210,India
896427,2023-10-14,205,classic yogurt,45,60,15,1,00006,India
790430,2023-10-14,206,yakult,360,400,40,1,00230,India
210173,2023-10-14,209,pepsi,75,100,25,1,00286,India
210173,2023-10-14,201,paneer,210,340,130,1,00286,India
210173,2023-10-14,206,yakult,360,400,40,1,00286,India
424641,2023-10-14,202,milk,12,27,15,1,00141,India
424641,2023-10-14,206,yakult,360,400,40,1,00141,India
424641,2023-10-14,209,pepsi,75,100,25,1,00141,India
424641,2023-10-14,207,coca cola,75,100,25,1,00141,India
139743,2023-10-14,205,classic yogurt,45,60,15,1,00101,India
139743,2023-10-14,202,milk,12,27,15,1,00101,India
139743,2023-10-14,213,bisleri,6,15,9,1,00101,India
139743,2023-10-14,201,paneer,210,340,130,1,00101,India
786035,2023-10-14,201,paneer,210,340,130,1,00067,India
786035,2023-10-14,213,bisleri,6,15,9,1,00067,India
127285,2023-10-14,203,mango yogurt,50,60,10,1,00264,India
127285,2023-10-14,204,strawberry yogurt,50,60,10,1,00264,India
127285,2023-10-14,202,milk,12,27,15,1,00264,India
473068,2023-10-14,211,red bull,90,125,35,1,00244,India
473068,2023-10-14,213,bisleri,6,15,9,1,00244,India
473068,2023-10-14,206,yakult,360,400,40,1,00244,India
473068,2023-10-14,212,amul cheese,250,315,65,1,00244,India
360131,2023-10-14,208,sprite,75,100,25,1,00262,India
360131,2023-10-14,210,mountain dew,75,100,25,1,00262,India
172781,2023-10-14,203,mango yogurt,50,60,10,1,00173,India
172781,2023-10-14,210,mountain dew,75,100,25,1,00173,India
172781,2023-10-14,204,strawberry yogurt,50,60,10,1,00173,India
172781,2023-10-14,202,milk,12,27,15,1,00173,India
481642,2023-10-14,208,sprite,75,100,25,1,00447,India
481642,2023-10-14,206,yakult,360,400,40,1,00447,India
481642,2023-10-14,209,pepsi,75,100,25,1,00447,India
856334,2023-10-14,206,yakult,360,400,40,1,00063,India
856334,2023-10-14,202,milk,12,27,15,1,00063,India
856334,2023-10-14,213,bisleri,6,15,9,1,00063,India
357934,2023-10-14,205,classic yogurt,45,60,15,1,00467,India
357934,2023-10-14,201,paneer,210,340,130,1,00467,India
357934,2023-10-14,213,bisleri,6,15,9,1,00467,India
983502,2023-10-14,212,amul cheese,250,315,65,1,00078,India
917673,2023-10-14,203,mango yogurt,50,60,10,1,00264,India
917673,2023-10-14,211,red bull,90,125,35,1,00264,India
917673,2023-10-14,202,milk,12,27,15,1,00264,India
129929,2023-10-14,202,milk,12,27,15,1,00079,India
129929,2023-10-14,210,mountain dew,75,100,25,1,00079,India
866580,2023-10-14,205,classic yogurt,45,60,15,1,00326,India
866580,2023-10-14,210,mountain dew,75,100,25,1,00326,India
866580,2023-10-14,209,pepsi,75,100,25,1,00326,India
866580,2023-10-14,208,sprite,75,100,25,1,00326,India
876489,2023-10-14,202,milk,12,27,15,1,00210,India
255979,2023-10-14,203,mango yogurt,50,60,10,1,00078,India
971661,2023-10-14,211,red bull,90,125,35,1,00233,India
914197,2023-10-14,206,yakult,360,400,40,1,00146,India
914197,2023-10-14,201,paneer,210,340,130,1,00146,India
914197,2023-10-14,202,milk,12,27,15,1,00146,India
914197,2023-10-14,208,sprite,75,100,25,1,00146,India
122983,2023-10-14,208,sprite,75,100,25,1,00359,India
122983,2023-10-14,201,paneer,210,340,130,1,00359,India
679155,2023-10-14,211,red bull,90,125,35,1,00280,India
679155,2023-10-14,203,mango yogurt,50,60,10,1,00280,India
679155,2023-10-14,213,bisleri,6,15,9,1,00280,India
101451,2023-10-14,210,mountain dew,75,100,25,1,00109,India
101451,2023-10-14,209,pepsi,75,100,25,1,00109,India
101451,2023-10-14,201,paneer,210,340,130,1,00109,India
101451,2023-10-14,211,red bull,90,125,35,1,00109,India
179064,2023-10-14,213,bisleri,6,15,9,1,00477,India
154793,2023-10-14,206,yakult,360,400,40,1,00312,India
154793,2023-10-14,201,paneer,210,340,130,1,00312,India
154793,2023-10-14,207,coca cola,75,100,25,1,00312,India
590440,2023-10-14,210,mountain dew,75,100,25,1,00175,India
590440,2023-10-14,207,coca cola,75,100,25,1,00175,India
590440,2023-10-14,205,classic yogurt,45,60,15,1,00175,India
881090,2023-10-14,201,paneer,210,340,130,1,00493,India
881090,2023-10-14,207,coca cola,75,100,25,1,00493,India
509731,2023-10-14,209,pepsi,75,100,25,1,00107,India
209714,2023-10-14,204,strawberry yogurt,50,60,10,1,00178,India
201038,2023-10-14,203,mango yogurt,50,60,10,1,00030,India
975136,2023-10-14,207,coca cola,75,100,25,1,00481,India
975136,2023-10-14,201,paneer,210,340,130,1,00481,India
975136,2023-10-14,210,mountain dew,75,100,25,1,00481,India
990073,2023-10-14,201,paneer,210,340,130,1,00396,India
990073,2023-10-14,210,mountain dew,75,100,25,1,00396,India
990073,2023-10-14,212,amul cheese,250,315,65,1,00396,India
990073,2023-10-14,204,strawberry yogurt,50,60,10,1,00396,India
219011,2023-10-14,212,amul cheese,250,315,65,1,00210,India
894158,2023-10-14,209,pepsi,75,100,25,1,00484,India
894158,2023-10-14,204,strawberry yogurt,50,60,10,1,00484,India
894158,2023-10-14,210,mountain dew,75,100,25,1,00484,India
894158,2023-10-14,211,red bull,90,125,35,1,00484,India
200146,2023-10-14,206,yakult,360,400,40,1,00443,India
200146,2023-10-14,205,classic yogurt,45,60,15,1,00443,India
147092,2023-10-14,206,yakult,360,400,40,1,00025,India
469321,2023-10-14,205,classic yogurt,45,60,15,1,00030,India
469321,2023-10-14,208,sprite,75,100,25,1,00030,India
894597,2023-10-14,207,coca cola,75,100,25,1,00432,India
894597,2023-10-14,213,bisleri,6,15,9,1,00432,India
955327,2023-10-14,201,paneer,210,340,130,1,00220,India
955327,2023-10-14,210,mountain dew,75,100,25,1,00220,India
376937,2023-10-14,212,amul cheese,250,315,65,1,00420,India
729169,2023-10-14,205,classic yogurt,45,60,15,1,00020,India
729169,2023-10-14,206,yakult,360,400,40,1,00020,India
729169,2023-10-14,212,amul cheese,250,315,65,1,00020,India
101861,2023-10-14,211,red bull,90,125,35,1,00401,India
911696,2023-10-14,202,milk,12,27,15,1,00078,India
911696,2023-10-14,206,yakult,360,400,40,1,00078,India
911696,2023-10-14,201,paneer,210,340,130,1,00078,India
911696,2023-10-14,207,coca cola,75,100,25,1,00078,India
911696,2023-10-14,203,mango yogurt,50,60,10,1,00078,India
684353,2023-10-14,211,red bull,90,125,35,1,00130,India
684353,2023-10-14,203,mango yogurt,50,60,10,1,00130,India
456060,2023-10-14,207,coca cola,75,100,25,1,00162,India
456060,2023-10-14,208,sprite,75,100,25,1,00162,India
456060,2023-10-14,211,red bull,90,125,35,1,00162,India
546402,2023-10-14,202,milk,12,27,15,1,00048,India
546402,2023-10-14,204,strawberry yogurt,50,60,10,1,00048,India
281471,2023-10-14,208,sprite,75,100,25,1,00084,India
281471,2023-10-14,201,paneer,210,340,130,1,00084,India
263585,2023-10-14,207,coca cola,75,100,25,1,00025,India
263585,2023-10-14,201,paneer,210,340,130,1,00025,India
263585,2023-10-14,205,classic yogurt,45,60,15,1,00025,India
263585,2023-10-14,210,mountain dew,75,100,25,1,00025,India
321395,2023-10-14,202,milk,12,27,15,1,00313,India
321395,2023-10-14,206,yakult,360,400,40,1,00313,India
321395,2023-10-14,211,red bull,90,125,35,1,00313,India
580978,2023-10-14,211,red bull,90,125,35,1,00458,India
676019,2023-10-14,212,amul cheese,250,315,65,1,00415,India
676019,2023-10-14,213,bisleri,6,15,9,1,00415,India
542041,2023-10-14,208,sprite,75,100,25,1,00335,India
600728,2023-10-14,201,paneer,210,340,130,1,00101,India
600728,2023-10-14,205,classic yogurt,45,60,15,1,00101,India
600728,2023-10-14,202,milk,12,27,15,1,00101,India
600728,2023-10-14,209,pepsi,75,100,25,1,00101,India
600728,2023-10-14,204,strawberry yogurt,50,60,10,1,00101,India
238413,2023-10-14,210,mountain dew,75,100,25,1,00485,India
238413,2023-10-14,202,milk,12,27,15,1,00485,India
238413,2023-10-14,208,sprite,75,100,25,1,00485,India
238413,2023-10-14,205,classic yogurt,45,60,15,1,00485,India
238413,2023-10-14,206,yakult,360,400,40,1,00485,India
522787,2023-10-14,210,mountain dew,75,100,25,1,00396,India
522787,2023-10-14,203,mango yogurt,50,60,10,1,00396,India
522787,2023-10-14,205,classic yogurt,45,60,15,1,00396,India
522787,2023-10-14,204,strawberry yogurt,50,60,10,1,00396,India
222415,2023-10-14,204,strawberry yogurt,50,60,10,1,00184,India
222415,2023-10-14,205,classic yogurt,45,60,15,1,00184,India
222415,2023-10-14,207,coca cola,75,100,25,1,00184,India
222415,2023-10-14,208,sprite,75,100,25,1,00184,India
222415,2023-10-14,212,amul cheese,250,315,65,1,00184,India
884596,2023-10-14,203,mango yogurt,50,60,10,1,00442,India
884596,2023-10-14,206,yakult,360,400,40,1,00442,India
884596,2023-10-14,209,pepsi,75,100,25,1,00442,India
392273,2023-10-14,201,paneer,210,340,130,1,00256,India
392273,2023-10-14,202,milk,12,27,15,1,00256,India
392273,2023-10-14,212,amul cheese,250,315,65,1,00256,India
392273,2023-10-14,204,strawberry yogurt,50,60,10,1,00256,India
144278,2023-10-14,207,coca cola,75,100,25,1,00139,India
721076,2023-10-14,204,strawberry yogurt,50,60,10,1,00295,India
721076,2023-10-14,209,pepsi,75,100,25,1,00295,India
721076,2023-10-14,206,yakult,360,400,40,1,00295,India
721076,2023-10-14,212,amul cheese,250,315,65,1,00295,India
721076,2023-10-14,205,classic yogurt,45,60,15,1,00295,India
199745,2023-10-14,209,pepsi,75,100,25,1,00496,India
199745,2023-10-14,211,red bull,90,125,35,1,00496,India
648293,2023-10-14,204,strawberry yogurt,50,60,10,1,00453,India
648293,2023-10-14,208,sprite,75,100,25,1,00453,India
648293,2023-10-14,201,paneer,210,340,130,1,00453,India
648293,2023-10-14,202,milk,12,27,15,1,00453,India
380677,2023-10-14,202,milk,12,27,15,1,00175,India
380677,2023-10-14,210,mountain dew,75,100,25,1,00175,India
997001,2023-10-14,206,yakult,360,400,40,1,00208,India
997001,2023-10-14,213,bisleri,6,15,9,1,00208,India
997001,2023-10-14,204,strawberry yogurt,50,60,10,1,00208,India
997001,2023-10-14,209,pepsi,75,100,25,1,00208,India
205204,2023-10-14,202,milk,12,27,15,1,00259,India
205204,2023-10-14,206,yakult,360,400,40,1,00259,India
205204,2023-10-14,210,mountain dew,75,100,25,1,00259,India
152989,2023-10-15,205,classic yogurt,45,60,15,1,00068,India
754602,2023-10-15,206,yakult,360,400,40,1,00110,India
754602,2023-10-15,210,mountain dew,75,100,25,1,00110,India
754602,2023-10-15,205,classic yogurt,45,60,15,1,00110,India
716675,2023-10-15,212,amul cheese,250,315,65,1,00178,India
716675,2023-10-15,209,pepsi,75,100,25,1,00178,India
716675,2023-10-15,204,strawberry yogurt,50,60,10,1,00178,India
800972,2023-10-15,210,mountain dew,75,100,25,1,00238,India
695843,2023-10-15,206,yakult,360,400,40,1,00325,India
695843,2023-10-15,201,paneer,210,340,130,1,00325,India
695843,2023-10-15,207,coca cola,75,100,25,1,00325,India
695843,2023-10-15,211,red bull,90,125,35,1,00325,India
493479,2023-10-15,206,yakult,360,400,40,1,00095,India
493479,2023-10-15,204,strawberry yogurt,50,60,10,1,00095,India
192989,2023-10-15,203,mango yogurt,50,60,10,1,00034,India
192989,2023-10-15,204,strawberry yogurt,50,60,10,1,00034,India
192989,2023-10-15,208,sprite,75,100,25,1,00034,India
680842,2023-10-15,202,milk,12,27,15,1,00062,India
680842,2023-10-15,207,coca cola,75,100,25,1,00062,India
680842,2023-10-15,205,classic yogurt,45,60,15,1,00062,India
680842,2023-10-15,209,pepsi,75,100,25,1,00062,India
293376,2023-10-15,203,mango yogurt,50,60,10,1,00458,India
293376,2023-10-15,207,coca cola,75,100,25,1,00458,India
293376,2023-10-15,209,pepsi,75,100,25,1,00458,India
293376,2023-10-15,201,paneer,210,340,130,1,00458,India
738551,2023-10-15,207,coca cola,75,100,25,1,00341,India
738551,2023-10-15,208,sprite,75,100,25,1,00341,India
738551,2023-10-15,213,bisleri,6,15,9,1,00341,India
738551,2023-10-15,205,classic yogurt,45,60,15,1,00341,India
604876,2023-10-15,207,coca cola,75,100,25,1,00435,India
604876,2023-10-15,201,paneer,210,340,130,1,00435,India
604876,2023-10-15,209,pepsi,75,100,25,1,00435,India
604876,2023-10-15,210,mountain dew,75,100,25,1,00435,India
604876,2023-10-15,208,sprite,75,100,25,1,00435,India
516196,2023-10-15,203,mango yogurt,50,60,10,1,00282,India
516196,2023-10-15,211,red bull,90,125,35,1,00282,India
866812,2023-10-15,204,strawberry yogurt,50,60,10,1,00104,India
866812,2023-10-15,207,coca cola,75,100,25,1,00104,India
866812,2023-10-15,201,paneer,210,340,130,1,00104,India
866812,2023-10-15,206,yakult,360,400,40,1,00104,India
866812,2023-10-15,205,classic yogurt,45,60,15,1,00104,India
756039,2023-10-15,203,mango yogurt,50,60,10,1,00465,India
756039,2023-10-15,212,amul cheese,250,315,65,1,00465,India
756039,2023-10-15,204,strawberry yogurt,50,60,10,1,00465,India
614200,2023-10-15,213,bisleri,6,15,9,1,00418,India
614200,2023-10-15,204,strawberry yogurt,50,60,10,1,00418,India
614200,2023-10-15,201,paneer,210,340,130,1,00418,India
148066,2023-10-15,208,sprite,75,100,25,1,00184,India
240752,2023-10-15,204,strawberry yogurt,50,60,10,1,00159,India
240752,2023-10-15,207,coca cola,75,100,25,1,00159,India
240752,2023-10-15,203,mango yogurt,50,60,10,1,00159,India
287253,2023-10-15,203,mango yogurt,50,60,10,1,00047,India
287253,2023-10-15,207,coca cola,75,100,25,1,00047,India
287253,2023-10-15,202,milk,12,27,15,1,00047,India
308688,2023-10-15,211,red bull,90,125,35,1,00037,India
308688,2023-10-15,209,pepsi,75,100,25,1,00037,India
308688,2023-10-15,202,milk,12,27,15,1,00037,India
671661,2023-10-15,202,milk,12,27,15,1,00298,India
252052,2023-10-15,206,yakult,360,400,40,1,00083,India
252052,2023-10-15,210,mountain dew,75,100,25,1,00083,India
604450,2023-10-15,206,yakult,360,400,40,1,00408,India
604450,2023-10-15,209,pepsi,75,100,25,1,00408,India
972896,2023-10-15,208,sprite,75,100,25,1,00076,India
972896,2023-10-15,213,bisleri,6,15,9,1,00076,India
972896,2023-10-15,212,amul cheese,250,315,65,1,00076,India
488800,2023-10-15,207,coca cola,75,100,25,1,00098,India
488800,2023-10-15,206,yakult,360,400,40,1,00098,India
488800,2023-10-15,212,amul cheese,250,315,65,1,00098,India
488800,2023-10-15,210,mountain dew,75,100,25,1,00098,India
488800,2023-10-15,201,paneer,210,340,130,1,00098,India
588582,2023-10-15,207,coca cola,75,100,25,1,00305,India
588582,2023-10-15,205,classic yogurt,45,60,15,1,00305,India
588582,2023-10-15,213,bisleri,6,15,9,1,00305,India
588582,2023-10-15,201,paneer,210,340,130,1,00305,India
263442,2023-10-15,209,pepsi,75,100,25,1,00321,India
263442,2023-10-15,205,classic yogurt,45,60,15,1,00321,India
263442,2023-10-15,203,mango yogurt,50,60,10,1,00321,India
263442,2023-10-15,211,red bull,90,125,35,1,00321,India
263442,2023-10-15,207,coca cola,75,100,25,1,00321,India
653125,2023-10-15,213,bisleri,6,15,9,1,00372,India
653125,2023-10-15,212,amul cheese,250,315,65,1,00372,India
653125,2023-10-15,202,milk,12,27,15,1,00372,India
653125,2023-10-15,205,classic yogurt,45,60,15,1,00372,India
503167,2023-10-15,205,classic yogurt,45,60,15,1,00224,India
503167,2023-10-15,204,strawberry yogurt,50,60,10,1,00224,India
503167,2023-10-15,203,mango yogurt,50,60,10,1,00224,India
518806,2023-10-15,213,bisleri,6,15,9,1,00329,India
895634,2023-10-15,202,milk,12,27,15,1,00320,India
895634,2023-10-15,206,yakult,360,400,40,1,00320,India
895634,2023-10-15,213,bisleri,6,15,9,1,00320,India
895634,2023-10-15,208,sprite,75,100,25,1,00320,India
335966,2023-10-15,211,red bull,90,125,35,1,00229,India
335966,2023-10-15,206,yakult,360,400,40,1,00229,India
335966,2023-10-15,201,paneer,210,340,130,1,00229,India
229255,2023-10-15,213,bisleri,6,15,9,1,00454,India
872492,2023-10-15,210,mountain dew,75,100,25,1,00218,India
872492,2023-10-15,203,mango yogurt,50,60,10,1,00218,India
872492,2023-10-15,209,pepsi,75,100,25,1,00218,India
872492,2023-10-15,206,yakult,360,400,40,1,00218,India
287265,2023-10-15,208,sprite,75,100,25,1,00039,India
287265,2023-10-15,213,bisleri,6,15,9,1,00039,India
287265,2023-10-15,203,mango yogurt,50,60,10,1,00039,India
287265,2023-10-15,211,red bull,90,125,35,1,00039,India
392019,2023-10-15,208,sprite,75,100,25,1,00195,India
392019,2023-10-15,205,classic yogurt,45,60,15,1,00195,India
392019,2023-10-15,209,pepsi,75,100,25,1,00195,India
786161,2023-10-15,208,sprite,75,100,25,1,00125,India
786161,2023-10-15,212,amul cheese,250,315,65,1,00125,India
772898,2023-10-15,206,yakult,360,400,40,1,00303,India
772898,2023-10-15,202,milk,12,27,15,1,00303,India
922391,2023-10-15,201,paneer,210,340,130,1,00036,India
922391,2023-10-15,205,classic yogurt,45,60,15,1,00036,India
281332,2023-10-15,201,paneer,210,340,130,1,00007,India
281332,2023-10-15,210,mountain dew,75,100,25,1,00007,India
281332,2023-10-15,213,bisleri,6,15,9,1,00007,India
281332,2023-10-15,208,sprite,75,100,25,1,00007,India
943121,2023-10-15,208,sprite,75,100,25,1,00237,India
784877,2023-10-15,203,mango yogurt,50,60,10,1,00115,India
784877,2023-10-15,204,strawberry yogurt,50,60,10,1,00115,India
212824,2023-10-15,203,mango yogurt,50,60,10,1,00314,India
526897,2023-10-15,207,coca cola,75,100,25,1,00011,India
526897,2023-10-15,212,amul cheese,250,315,65,1,00011,India
526897,2023-10-15,201,paneer,210,340,130,1,00011,India
429578,2023-10-15,206,yakult,360,400,40,1,00200,India
429578,2023-10-15,205,classic yogurt,45,60,15,1,00200,India
429578,2023-10-15,202,milk,12,27,15,1,00200,India
429578,2023-10-15,213,bisleri,6,15,9,1,00200,India
724734,2023-10-15,210,mountain dew,75,100,25,1,00297,India
724734,2023-10-15,203,mango yogurt,50,60,10,1,00297,India
164461,2023-10-15,206,yakult,360,400,40,1,00059,India
164461,2023-10-15,212,amul cheese,250,315,65,1,00059,India
164461,2023-10-15,210,mountain dew,75,100,25,1,00059,India
274678,2023-10-15,206,yakult,360,400,40,1,00177,India
274678,2023-10-15,205,classic yogurt,45,60,15,1,00177,India
274678,2023-10-15,202,milk,12,27,15,1,00177,India
274678,2023-10-15,207,coca cola,75,100,25,1,00177,India
274678,2023-10-15,211,red bull,90,125,35,1,00177,India
555229,2023-10-15,205,classic yogurt,45,60,15,1,00151,India
328217,2023-10-15,204,strawberry yogurt,50,60,10,1,00280,India
328217,2023-10-15,209,pepsi,75,100,25,1,00280,India
328217,2023-10-15,202,milk,12,27,15,1,00280,India
328217,2023-10-15,213,bisleri,6,15,9,1,00280,India
762304,2023-10-15,203,mango yogurt,50,60,10,1,00138,India
762304,2023-10-15,207,coca cola,75,100,25,1,00138,India
762304,2023-10-15,208,sprite,75,100,25,1,00138,India
762304,2023-10-15,202,milk,12,27,15,1,00138,India
762304,2023-10-15,205,classic yogurt,45,60,15,1,00138,India
166723,2023-10-15,207,coca cola,75,100,25,1,00195,India
166723,2023-10-15,213,bisleri,6,15,9,1,00195,India
591193,2023-10-15,205,classic yogurt,45,60,15,1,00058,India
591193,2023-10-15,202,milk,12,27,15,1,00058,India
591193,2023-10-15,211,red bull,90,125,35,1,00058,India
591193,2023-10-15,208,sprite,75,100,25,1,00058,India
725513,2023-10-15,203,mango yogurt,50,60,10,1,00404,India
595087,2023-10-15,203,mango yogurt,50,60,10,1,00450,India
595087,2023-10-15,212,amul cheese,250,315,65,1,00450,India
595087,2023-10-15,202,milk,12,27,15,1,00450,India
553703,2023-10-15,206,yakult,360,400,40,1,00255,India
553703,2023-10-15,211,red bull,90,125,35,1,00255,India
553703,2023-10-15,212,amul cheese,250,315,65,1,00255,India
553703,2023-10-15,204,strawberry yogurt,50,60,10,1,00255,India
636653,2023-10-15,204,strawberry yogurt,50,60,10,1,00043,India
636653,2023-10-15,205,classic yogurt,45,60,15,1,00043,India
636653,2023-10-15,203,mango yogurt,50,60,10,1,00043,India
636653,2023-10-15,202,milk,12,27,15,1,00043,India
496150,2023-10-15,208,sprite,75,100,25,1,00107,India
496150,2023-10-15,209,pepsi,75,100,25,1,00107,India
496150,2023-10-15,211,red bull,90,125,35,1,00107,India
883175,2023-10-15,213,bisleri,6,15,9,1,00272,India
883175,2023-10-15,207,coca cola,75,100,25,1,00272,India
883175,2023-10-15,205,classic yogurt,45,60,15,1,00272,India
883175,2023-10-15,211,red bull,90,125,35,1,00272,India
728851,2023-10-15,208,sprite,75,100,25,1,00034,India
480278,2023-10-15,211,red bull,90,125,35,1,00353,India
480278,2023-10-15,204,strawberry yogurt,50,60,10,1,00353,India
480278,2023-10-15,213,bisleri,6,15,9,1,00353,India
480278,2023-10-15,203,mango yogurt,50,60,10,1,00353,India
872600,2023-10-15,203,mango yogurt,50,60,10,1,00231,India
872600,2023-10-15,209,pepsi,75,100,25,1,00231,India
872600,2023-10-15,201,paneer,210,340,130,1,00231,India
872600,2023-10-15,207,coca cola,75,100,25,1,00231,India
573652,2023-10-15,207,coca cola,75,100,25,1,00091,India
573652,2023-10-15,211,red bull,90,125,35,1,00091,India
573652,2023-10-15,210,mountain dew,75,100,25,1,00091,India
345719,2023-10-15,206,yakult,360,400,40,1,00195,India
345719,2023-10-15,209,pepsi,75,100,25,1,00195,India
345719,2023-10-15,203,mango yogurt,50,60,10,1,00195,India
345719,2023-10-15,210,mountain dew,75,100,25,1,00195,India
345719,2023-10-15,213,bisleri,6,15,9,1,00195,India
621114,2023-10-15,205,classic yogurt,45,60,15,1,00301,India
621114,2023-10-15,210,mountain dew,75,100,25,1,00301,India
621114,2023-10-15,213,bisleri,6,15,9,1,00301,India
621114,2023-10-15,206,yakult,360,400,40,1,00301,India
763384,2023-10-15,202,milk,12,27,15,1,00499,India
763384,2023-10-15,213,bisleri,6,15,9,1,00499,India
453921,2023-10-15,210,mountain dew,75,100,25,1,00246,India
453921,2023-10-15,212,amul cheese,250,315,65,1,00246,India
916880,2023-10-15,206,yakult,360,400,40,1,00304,India
562923,2023-10-15,212,amul cheese,250,315,65,1,00146,India
562923,2023-10-15,201,paneer,210,340,130,1,00146,India
562923,2023-10-15,203,mango yogurt,50,60,10,1,00146,India
905260,2023-10-15,207,coca cola,75,100,25,1,00218,India
184507,2023-10-15,209,pepsi,75,100,25,1,00473,India
184507,2023-10-15,210,mountain dew,75,100,25,1,00473,India
209951,2023-10-15,202,milk,12,27,15,1,00379,India
809713,2023-10-15,211,red bull,90,125,35,1,00081,India
849118,2023-10-15,211,red bull,90,125,35,1,00239,India
849118,2023-10-15,204,strawberry yogurt,50,60,10,1,00239,India
849118,2023-10-15,203,mango yogurt,50,60,10,1,00239,India
447817,2023-10-15,206,yakult,360,400,40,1,00233,India
447817,2023-10-15,209,pepsi,75,100,25,1,00233,India
447817,2023-10-15,202,milk,12,27,15,1,00233,India
447817,2023-10-15,204,strawberry yogurt,50,60,10,1,00233,India
447817,2023-10-15,212,amul cheese,250,315,65,1,00233,India
441711,2023-10-15,213,bisleri,6,15,9,1,00235,India
441711,2023-10-15,205,classic yogurt,45,60,15,1,00235,India
441711,2023-10-15,210,mountain dew,75,100,25,1,00235,India
441711,2023-10-15,206,yakult,360,400,40,1,00235,India
191517,2023-10-15,202,milk,12,27,15,1,00342,India
221150,2023-10-15,202,milk,12,27,15,1,00027,India
221150,2023-10-15,206,yakult,360,400,40,1,00027,India
221150,2023-10-15,212,amul cheese,250,315,65,1,00027,India
815398,2023-10-15,201,paneer,210,340,130,1,00210,India
951591,2023-10-15,203,mango yogurt,50,60,10,1,00375,India
951591,2023-10-15,212,amul cheese,250,315,65,1,00375,India
951591,2023-10-15,208,sprite,75,100,25,1,00375,India
951591,2023-10-15,213,bisleri,6,15,9,1,00375,India
951591,2023-10-15,207,coca cola,75,100,25,1,00375,India
473993,2023-10-15,207,coca cola,75,100,25,1,00001,India
473993,2023-10-15,204,strawberry yogurt,50,60,10,1,00001,India
473993,2023-10-15,201,paneer,210,340,130,1,00001,India
535842,2023-10-15,209,pepsi,75,100,25,1,00146,India
535842,2023-10-15,212,amul cheese,250,315,65,1,00146,India
535842,2023-10-15,201,paneer,210,340,130,1,00146,India
535842,2023-10-15,213,bisleri,6,15,9,1,00146,India
883064,2023-10-15,209,pepsi,75,100,25,1,00351,India
883064,2023-10-15,207,coca cola,75,100,25,1,00351,India
883064,2023-10-15,213,bisleri,6,15,9,1,00351,India
474254,2023-10-15,210,mountain dew,75,100,25,1,00067,India
474254,2023-10-15,202,milk,12,27,15,1,00067,India
474254,2023-10-15,205,classic yogurt,45,60,15,1,00067,India
474254,2023-10-15,212,amul cheese,250,315,65,1,00067,India
950984,2023-10-15,206,yakult,360,400,40,1,00424,India
950984,2023-10-15,202,milk,12,27,15,1,00424,India
250551,2023-10-15,203,mango yogurt,50,60,10,1,00031,India
250551,2023-10-15,208,sprite,75,100,25,1,00031,India
250551,2023-10-15,205,classic yogurt,45,60,15,1,00031,India
250551,2023-10-15,209,pepsi,75,100,25,1,00031,India
250551,2023-10-15,211,red bull,90,125,35,1,00031,India
130952,2023-10-15,213,bisleri,6,15,9,1,00160,India
130952,2023-10-15,205,classic yogurt,45,60,15,1,00160,India
130952,2023-10-15,201,paneer,210,340,130,1,00160,India
952364,2023-10-15,212,amul cheese,250,315,65,1,00431,India
952364,2023-10-15,203,mango yogurt,50,60,10,1,00431,India
419289,2023-10-15,211,red bull,90,125,35,1,00379,India
419289,2023-10-15,201,paneer,210,340,130,1,00379,India
419289,2023-10-15,205,classic yogurt,45,60,15,1,00379,India
419289,2023-10-15,213,bisleri,6,15,9,1,00379,India
687713,2023-10-16,205,classic yogurt,45,60,15,1,00180,India
687713,2023-10-16,202,milk,12,27,15,1,00180,India
687713,2023-10-16,210,mountain dew,75,100,25,1,00180,India
687713,2023-10-16,201,paneer,210,340,130,1,00180,India
687713,2023-10-16,209,pepsi,75,100,25,1,00180,India
927486,2023-10-16,212,amul cheese,250,315,65,1,00217,India
927486,2023-10-16,202,milk,12,27,15,1,00217,India
927486,2023-10-16,208,sprite,75,100,25,1,00217,India
927486,2023-10-16,205,classic yogurt,45,60,15,1,00217,India
927486,2023-10-16,211,red bull,90,125,35,1,00217,India
575423,2023-10-16,206,yakult,360,400,40,1,00043,India
575423,2023-10-16,211,red bull,90,125,35,1,00043,India
575423,2023-10-16,201,paneer,210,340,130,1,00043,India
575423,2023-10-16,208,sprite,75,100,25,1,00043,India
931751,2023-10-16,201,paneer,210,340,130,1,00258,India
775191,2023-10-16,201,paneer,210,340,130,1,00424,India
829711,2023-10-16,205,classic yogurt,45,60,15,1,00499,India
829711,2023-10-16,203,mango yogurt,50,60,10,1,00499,India
890016,2023-10-16,209,pepsi,75,100,25,1,00311,India
890016,2023-10-16,203,mango yogurt,50,60,10,1,00311,India
134737,2023-10-16,203,mango yogurt,50,60,10,1,00120,India
134737,2023-10-16,213,bisleri,6,15,9,1,00120,India
134737,2023-10-16,202,milk,12,27,15,1,00120,India
134737,2023-10-16,211,red bull,90,125,35,1,00120,India
318480,2023-10-16,209,pepsi,75,100,25,1,00258,India
318480,2023-10-16,203,mango yogurt,50,60,10,1,00258,India
594521,2023-10-16,212,amul cheese,250,315,65,1,00393,India
594521,2023-10-16,202,milk,12,27,15,1,00393,India
594521,2023-10-16,201,paneer,210,340,130,1,00393,India
594521,2023-10-16,208,sprite,75,100,25,1,00393,India
513448,2023-10-16,211,red bull,90,125,35,1,00474,India
609372,2023-10-16,204,strawberry yogurt,50,60,10,1,00423,India
973160,2023-10-16,207,coca cola,75,100,25,1,00239,India
973160,2023-10-16,203,mango yogurt,50,60,10,1,00239,India
973160,2023-10-16,212,amul cheese,250,315,65,1,00239,India
973160,2023-10-16,210,mountain dew,75,100,25,1,00239,India
513944,2023-10-16,213,bisleri,6,15,9,1,00261,India
513944,2023-10-16,212,amul cheese,250,315,65,1,00261,India
513944,2023-10-16,203,mango yogurt,50,60,10,1,00261,India
513944,2023-10-16,208,sprite,75,100,25,1,00261,India
183528,2023-10-16,202,milk,12,27,15,1,00430,India
183528,2023-10-16,204,strawberry yogurt,50,60,10,1,00430,India
183528,2023-10-16,211,red bull,90,125,35,1,00430,India
897989,2023-10-16,212,amul cheese,250,315,65,1,00291,India
183480,2023-10-16,203,mango yogurt,50,60,10,1,00116,India
183480,2023-10-16,209,pepsi,75,100,25,1,00116,India
183480,2023-10-16,213,bisleri,6,15,9,1,00116,India
183480,2023-10-16,205,classic yogurt,45,60,15,1,00116,India
183480,2023-10-16,208,sprite,75,100,25,1,00116,India
176206,2023-10-16,207,coca cola,75,100,25,1,00015,India
176206,2023-10-16,211,red bull,90,125,35,1,00015,India
176206,2023-10-16,205,classic yogurt,45,60,15,1,00015,India
128219,2023-10-16,212,amul cheese,250,315,65,1,00101,India
128219,2023-10-16,203,mango yogurt,50,60,10,1,00101,India
128219,2023-10-16,210,mountain dew,75,100,25,1,00101,India
569768,2023-10-16,213,bisleri,6,15,9,1,00193,India
840254,2023-10-16,210,mountain dew,75,100,25,1,00231,India
840254,2023-10-16,207,coca cola,75,100,25,1,00231,India
840254,2023-10-16,205,classic yogurt,45,60,15,1,00231,India
842887,2023-10-16,208,sprite,75,100,25,1,00378,India
842887,2023-10-16,206,yakult,360,400,40,1,00378,India
842887,2023-10-16,212,amul cheese,250,315,65,1,00378,India
842887,2023-10-16,203,mango yogurt,50,60,10,1,00378,India
842887,2023-10-16,207,coca cola,75,100,25,1,00378,India
675867,2023-10-16,208,sprite,75,100,25,1,00126,India
675867,2023-10-16,206,yakult,360,400,40,1,00126,India
675867,2023-10-16,201,paneer,210,340,130,1,00126,India
675867,2023-10-16,204,strawberry yogurt,50,60,10,1,00126,India
526543,2023-10-16,209,pepsi,75,100,25,1,00264,India
526543,2023-10-16,203,mango yogurt,50,60,10,1,00264,India
526543,2023-10-16,212,amul cheese,250,315,65,1,00264,India
502156,2023-10-16,206,yakult,360,400,40,1,00328,India
276359,2023-10-16,213,bisleri,6,15,9,1,00390,India
512626,2023-10-16,210,mountain dew,75,100,25,1,00302,India
512626,2023-10-16,205,classic yogurt,45,60,15,1,00302,India
512626,2023-10-16,209,pepsi,75,100,25,1,00302,India
512626,2023-10-16,212,amul cheese,250,315,65,1,00302,India
512626,2023-10-16,207,coca cola,75,100,25,1,00302,India
217888,2023-10-16,202,milk,12,27,15,1,00220,India
217888,2023-10-16,204,strawberry yogurt,50,60,10,1,00220,India
217888,2023-10-16,212,amul cheese,250,315,65,1,00220,India
827711,2023-10-16,213,bisleri,6,15,9,1,00168,India
827711,2023-10-16,212,amul cheese,250,315,65,1,00168,India
827711,2023-10-16,207,coca cola,75,100,25,1,00168,India
779504,2023-10-16,207,coca cola,75,100,25,1,00179,India
779504,2023-10-16,213,bisleri,6,15,9,1,00179,India
779504,2023-10-16,204,strawberry yogurt,50,60,10,1,00179,India
779504,2023-10-16,212,amul cheese,250,315,65,1,00179,India
611797,2023-10-16,211,red bull,90,125,35,1,00150,India
351827,2023-10-16,208,sprite,75,100,25,1,00499,India
351827,2023-10-16,210,mountain dew,75,100,25,1,00499,India
351827,2023-10-16,213,bisleri,6,15,9,1,00499,India
351827,2023-10-16,202,milk,12,27,15,1,00499,India
331507,2023-10-16,202,milk,12,27,15,1,00063,India
331507,2023-10-16,209,pepsi,75,100,25,1,00063,India
331507,2023-10-16,205,classic yogurt,45,60,15,1,00063,India
656365,2023-10-16,208,sprite,75,100,25,1,00100,India
656365,2023-10-16,209,pepsi,75,100,25,1,00100,India
656365,2023-10-16,201,paneer,210,340,130,1,00100,India
972686,2023-10-16,201,paneer,210,340,130,1,00309,India
972686,2023-10-16,203,mango yogurt,50,60,10,1,00309,India
972686,2023-10-16,211,red bull,90,125,35,1,00309,India
213623,2023-10-16,202,milk,12,27,15,1,00106,India
213623,2023-10-16,208,sprite,75,100,25,1,00106,India
213623,2023-10-16,211,red bull,90,125,35,1,00106,India
213623,2023-10-16,209,pepsi,75,100,25,1,00106,India
995606,2023-10-16,213,bisleri,6,15,9,1,00279,India
995606,2023-10-16,205,classic yogurt,45,60,15,1,00279,India
995606,2023-10-16,212,amul cheese,250,315,65,1,00279,India
593904,2023-10-16,207,coca cola,75,100,25,1,00371,India
593904,2023-10-16,205,classic yogurt,45,60,15,1,00371,India
593904,2023-10-16,201,paneer,210,340,130,1,00371,India
593904,2023-10-16,202,milk,12,27,15,1,00371,India
593904,2023-10-16,204,strawberry yogurt,50,60,10,1,00371,India
849620,2023-10-16,209,pepsi,75,100,25,1,00255,India
632218,2023-10-16,207,coca cola,75,100,25,1,00098,India
632218,2023-10-16,205,classic yogurt,45,60,15,1,00098,India
372796,2023-10-16,206,yakult,360,400,40,1,00289,India
372796,2023-10-16,202,milk,12,27,15,1,00289,India
372796,2023-10-16,208,sprite,75,100,25,1,00289,India
372796,2023-10-16,213,bisleri,6,15,9,1,00289,India
477829,2023-10-16,207,coca cola,75,100,25,1,00022,India
477829,2023-10-16,201,paneer,210,340,130,1,00022,India
865892,2023-10-16,202,milk,12,27,15,1,00441,India
865892,2023-10-16,211,red bull,90,125,35,1,00441,India
865892,2023-10-16,205,classic yogurt,45,60,15,1,00441,India
865892,2023-10-16,206,yakult,360,400,40,1,00441,India
475215,2023-10-16,204,strawberry yogurt,50,60,10,1,00186,India
475215,2023-10-16,210,mountain dew,75,100,25,1,00186,India
475215,2023-10-16,205,classic yogurt,45,60,15,1,00186,India
116803,2023-10-16,212,amul cheese,250,315,65,1,00042,India
116803,2023-10-16,204,strawberry yogurt,50,60,10,1,00042,India
116803,2023-10-16,213,bisleri,6,15,9,1,00042,India
389285,2023-10-16,203,mango yogurt,50,60,10,1,00322,India
406994,2023-10-16,210,mountain dew,75,100,25,1,00263,India
406994,2023-10-16,207,coca cola,75,100,25,1,00263,India
233683,2023-10-16,210,mountain dew,75,100,25,1,00413,India
233683,2023-10-16,201,paneer,210,340,130,1,00413,India
233683,2023-10-16,209,pepsi,75,100,25,1,00413,India
233683,2023-10-16,202,milk,12,27,15,1,00413,India
822234,2023-10-16,211,red bull,90,125,35,1,00222,India
419519,2023-10-16,213,bisleri,6,15,9,1,00116,India
889443,2023-10-16,213,bisleri,6,15,9,1,00069,India
889443,2023-10-16,202,milk,12,27,15,1,00069,India
889443,2023-10-16,206,yakult,360,400,40,1,00069,India
487495,2023-10-16,211,red bull,90,125,35,1,00296,India
487495,2023-10-16,204,strawberry yogurt,50,60,10,1,00296,India
487495,2023-10-16,202,milk,12,27,15,1,00296,India
364737,2023-10-16,213,bisleri,6,15,9,1,00259,India
928592,2023-10-16,208,sprite,75,100,25,1,00103,India
928592,2023-10-16,212,amul cheese,250,315,65,1,00103,India
928592,2023-10-16,203,mango yogurt,50,60,10,1,00103,India
847861,2023-10-16,204,strawberry yogurt,50,60,10,1,00225,India
847861,2023-10-16,201,paneer,210,340,130,1,00225,India
800371,2023-10-16,201,paneer,210,340,130,1,00082,India
544558,2023-10-16,203,mango yogurt,50,60,10,1,00270,India
782393,2023-10-16,213,bisleri,6,15,9,1,00283,India
782393,2023-10-16,209,pepsi,75,100,25,1,00283,India
623496,2023-10-16,212,amul cheese,250,315,65,1,00443,India
623496,2023-10-16,210,mountain dew,75,100,25,1,00443,India
839125,2023-10-16,210,mountain dew,75,100,25,1,00212,India
594722,2023-10-16,201,paneer,210,340,130,1,00065,India
594722,2023-10-16,209,pepsi,75,100,25,1,00065,India
908376,2023-10-16,205,classic yogurt,45,60,15,1,00114,India
522733,2023-10-16,212,amul cheese,250,315,65,1,00152,India
522733,2023-10-16,203,mango yogurt,50,60,10,1,00152,India
522733,2023-10-16,208,sprite,75,100,25,1,00152,India
522733,2023-10-16,205,classic yogurt,45,60,15,1,00152,India
254814,2023-10-16,212,amul cheese,250,315,65,1,00292,India
254814,2023-10-16,201,paneer,210,340,130,1,00292,India
254814,2023-10-16,211,red bull,90,125,35,1,00292,India
254814,2023-10-16,206,yakult,360,400,40,1,00292,India
274344,2023-10-16,210,mountain dew,75,100,25,1,00179,India
274344,2023-10-16,204,strawberry yogurt,50,60,10,1,00179,India
274344,2023-10-16,213,bisleri,6,15,9,1,00179,India
274344,2023-10-16,208,sprite,75,100,25,1,00179,India
955438,2023-10-16,213,bisleri,6,15,9,1,00282,India
955438,2023-10-16,208,sprite,75,100,25,1,00282,India
955438,2023-10-16,203,mango yogurt,50,60,10,1,00282,India
955438,2023-10-16,212,amul cheese,250,315,65,1,00282,India
342934,2023-10-16,208,sprite,75,100,25,1,00184,India
342934,2023-10-16,209,pepsi,75,100,25,1,00184,India
342934,2023-10-16,202,milk,12,27,15,1,00184,India
964164,2023-10-16,212,amul cheese,250,315,65,1,00276,India
964164,2023-10-16,209,pepsi,75,100,25,1,00276,India
725146,2023-10-16,213,bisleri,6,15,9,1,00285,India
725146,2023-10-16,212,amul cheese,250,315,65,1,00285,India
984321,2023-10-16,205,classic yogurt,45,60,15,1,00499,India
699431,2023-10-16,204,strawberry yogurt,50,60,10,1,00322,India
699431,2023-10-16,201,paneer,210,340,130,1,00322,India
699431,2023-10-16,205,classic yogurt,45,60,15,1,00322,India
699431,2023-10-16,202,milk,12,27,15,1,00322,India
728697,2023-10-16,208,sprite,75,100,25,1,00147,India
728697,2023-10-16,205,classic yogurt,45,60,15,1,00147,India
492908,2023-10-16,210,mountain dew,75,100,25,1,00357,India
492908,2023-10-16,213,bisleri,6,15,9,1,00357,India
536492,2023-10-16,213,bisleri,6,15,9,1,00383,India
536492,2023-10-16,205,classic yogurt,45,60,15,1,00383,India
536492,2023-10-16,201,paneer,210,340,130,1,00383,India
536492,2023-10-16,210,mountain dew,75,100,25,1,00383,India
314527,2023-10-16,202,milk,12,27,15,1,00205,India
314527,2023-10-16,201,paneer,210,340,130,1,00205,India
314527,2023-10-16,213,bisleri,6,15,9,1,00205,India
847777,2023-10-17,207,coca cola,75,100,25,1,00475,India
331668,2023-10-17,208,sprite,75,100,25,1,00208,India
331668,2023-10-17,203,mango yogurt,50,60,10,1,00208,India
755451,2023-10-17,206,yakult,360,400,40,1,00046,India
939333,2023-10-17,212,amul cheese,250,315,65,1,00016,India
663708,2023-10-17,201,paneer,210,340,130,1,00433,India
667055,2023-10-17,209,pepsi,75,100,25,1,00023,India
667055,2023-10-17,205,classic yogurt,45,60,15,1,00023,India
667055,2023-10-17,203,mango yogurt,50,60,10,1,00023,India
667055,2023-10-17,211,red bull,90,125,35,1,00023,India
386354,2023-10-17,207,coca cola,75,100,25,1,00379,India
386354,2023-10-17,205,classic yogurt,45,60,15,1,00379,India
386354,2023-10-17,201,paneer,210,340,130,1,00379,India
102036,2023-10-17,203,mango yogurt,50,60,10,1,00295,India
207937,2023-10-17,205,classic yogurt,45,60,15,1,00484,India
207937,2023-10-17,213,bisleri,6,15,9,1,00484,India
248849,2023-10-17,207,coca cola,75,100,25,1,00327,India
248849,2023-10-17,205,classic yogurt,45,60,15,1,00327,India
248849,2023-10-17,211,red bull,90,125,35,1,00327,India
101772,2023-10-17,207,coca cola,75,100,25,1,00452,India
101772,2023-10-17,209,pepsi,75,100,25,1,00452,India
783345,2023-10-17,206,yakult,360,400,40,1,00200,India
783345,2023-10-17,203,mango yogurt,50,60,10,1,00200,India
783345,2023-10-17,202,milk,12,27,15,1,00200,India
783345,2023-10-17,205,classic yogurt,45,60,15,1,00200,India
783345,2023-10-17,211,red bull,90,125,35,1,00200,India
779117,2023-10-17,212,amul cheese,250,315,65,1,00020,India
779117,2023-10-17,209,pepsi,75,100,25,1,00020,India
779117,2023-10-17,204,strawberry yogurt,50,60,10,1,00020,India
779117,2023-10-17,202,milk,12,27,15,1,00020,India
712398,2023-10-17,213,bisleri,6,15,9,1,00294,India
546608,2023-10-17,211,red bull,90,125,35,1,00399,India
956180,2023-10-17,202,milk,12,27,15,1,00379,India
884199,2023-10-17,202,milk,12,27,15,1,00370,India
884199,2023-10-17,204,strawberry yogurt,50,60,10,1,00370,India
253403,2023-10-17,210,mountain dew,75,100,25,1,00425,India
253403,2023-10-17,209,pepsi,75,100,25,1,00425,India
253403,2023-10-17,202,milk,12,27,15,1,00425,India
253403,2023-10-17,213,bisleri,6,15,9,1,00425,India
467674,2023-10-17,209,pepsi,75,100,25,1,00106,India
689083,2023-10-17,206,yakult,360,400,40,1,00115,India
689083,2023-10-17,204,strawberry yogurt,50,60,10,1,00115,India
818015,2023-10-17,210,mountain dew,75,100,25,1,00129,India
700364,2023-10-17,208,sprite,75,100,25,1,00110,India
700364,2023-10-17,202,milk,12,27,15,1,00110,India
346146,2023-10-17,212,amul cheese,250,315,65,1,00317,India
346146,2023-10-17,203,mango yogurt,50,60,10,1,00317,India
346146,2023-10-17,208,sprite,75,100,25,1,00317,India
346146,2023-10-17,202,milk,12,27,15,1,00317,India
169923,2023-10-17,209,pepsi,75,100,25,1,00306,India
169923,2023-10-17,208,sprite,75,100,25,1,00306,India
276757,2023-10-17,202,milk,12,27,15,1,00468,India
572484,2023-10-17,213,bisleri,6,15,9,1,00114,India
572484,2023-10-17,202,milk,12,27,15,1,00114,India
572484,2023-10-17,212,amul cheese,250,315,65,1,00114,India
451667,2023-10-17,212,amul cheese,250,315,65,1,00413,India
487371,2023-10-17,212,amul cheese,250,315,65,1,00442,India
507052,2023-10-17,210,mountain dew,75,100,25,1,00327,India
507052,2023-10-17,203,mango yogurt,50,60,10,1,00327,India
507052,2023-10-17,204,strawberry yogurt,50,60,10,1,00327,India
507052,2023-10-17,213,bisleri,6,15,9,1,00327,India
507052,2023-10-17,212,amul cheese,250,315,65,1,00327,India
816380,2023-10-17,201,paneer,210,340,130,1,00487,India
222661,2023-10-17,206,yakult,360,400,40,1,00071,India
222661,2023-10-17,204,strawberry yogurt,50,60,10,1,00071,India
222661,2023-10-17,212,amul cheese,250,315,65,1,00071,India
222661,2023-10-17,203,mango yogurt,50,60,10,1,00071,India
433499,2023-10-17,209,pepsi,75,100,25,1,00338,India
433499,2023-10-17,211,red bull,90,125,35,1,00338,India
433499,2023-10-17,205,classic yogurt,45,60,15,1,00338,India
433499,2023-10-17,213,bisleri,6,15,9,1,00338,India
921739,2023-10-17,207,coca cola,75,100,25,1,00314,India
921739,2023-10-17,201,paneer,210,340,130,1,00314,India
921739,2023-10-17,211,red bull,90,125,35,1,00314,India
921739,2023-10-17,205,classic yogurt,45,60,15,1,00314,India
921739,2023-10-17,204,strawberry yogurt,50,60,10,1,00314,India
868428,2023-10-17,203,mango yogurt,50,60,10,1,00384,India
868428,2023-10-17,202,milk,12,27,15,1,00384,India
868428,2023-10-17,204,strawberry yogurt,50,60,10,1,00384,India
868428,2023-10-17,212,amul cheese,250,315,65,1,00384,India
310978,2023-10-17,202,milk,12,27,15,1,00473,India
310978,2023-10-17,201,paneer,210,340,130,1,00473,India
310978,2023-10-17,207,coca cola,75,100,25,1,00473,India
328906,2023-10-17,204,strawberry yogurt,50,60,10,1,00153,India
328906,2023-10-17,201,paneer,210,340,130,1,00153,India
328906,2023-10-17,205,classic yogurt,45,60,15,1,00153,India
328906,2023-10-17,211,red bull,90,125,35,1,00153,India
127518,2023-10-17,210,mountain dew,75,100,25,1,00012,India
459749,2023-10-17,208,sprite,75,100,25,1,00224,India
459749,2023-10-17,206,yakult,360,400,40,1,00224,India
459749,2023-10-17,212,amul cheese,250,315,65,1,00224,India
459749,2023-10-17,205,classic yogurt,45,60,15,1,00224,India
324991,2023-10-17,212,amul cheese,250,315,65,1,00201,India
324991,2023-10-17,201,paneer,210,340,130,1,00201,India
586278,2023-10-17,209,pepsi,75,100,25,1,00008,India
586278,2023-10-17,201,paneer,210,340,130,1,00008,India
586278,2023-10-17,210,mountain dew,75,100,25,1,00008,India
227443,2023-10-17,209,pepsi,75,100,25,1,00337,India
227443,2023-10-17,213,bisleri,6,15,9,1,00337,India
227443,2023-10-17,201,paneer,210,340,130,1,00337,India
227443,2023-10-17,212,amul cheese,250,315,65,1,00337,India
114677,2023-10-17,210,mountain dew,75,100,25,1,00103,India
114677,2023-10-17,202,milk,12,27,15,1,00103,India
114677,2023-10-17,211,red bull,90,125,35,1,00103,India
114677,2023-10-17,205,classic yogurt,45,60,15,1,00103,India
570914,2023-10-17,206,yakult,360,400,40,1,00412,India
570914,2023-10-17,204,strawberry yogurt,50,60,10,1,00412,India
570914,2023-10-17,207,coca cola,75,100,25,1,00412,India
290641,2023-10-17,204,strawberry yogurt,50,60,10,1,00052,India
290641,2023-10-17,205,classic yogurt,45,60,15,1,00052,India
290641,2023-10-17,213,bisleri,6,15,9,1,00052,India
657473,2023-10-17,201,paneer,210,340,130,1,00016,India
657473,2023-10-17,209,pepsi,75,100,25,1,00016,India
657473,2023-10-17,205,classic yogurt,45,60,15,1,00016,India
235261,2023-10-17,207,coca cola,75,100,25,1,00108,India
235261,2023-10-17,201,paneer,210,340,130,1,00108,India
235261,2023-10-17,210,mountain dew,75,100,25,1,00108,India
235261,2023-10-17,212,amul cheese,250,315,65,1,00108,India
227974,2023-10-17,201,paneer,210,340,130,1,00316,India
227974,2023-10-17,202,milk,12,27,15,1,00316,India
227974,2023-10-17,206,yakult,360,400,40,1,00316,India
724187,2023-10-17,209,pepsi,75,100,25,1,00351,India
724187,2023-10-17,206,yakult,360,400,40,1,00351,India
642074,2023-10-17,201,paneer,210,340,130,1,00066,India
642074,2023-10-17,210,mountain dew,75,100,25,1,00066,India
642074,2023-10-17,204,strawberry yogurt,50,60,10,1,00066,India
642074,2023-10-17,211,red bull,90,125,35,1,00066,India
642074,2023-10-17,213,bisleri,6,15,9,1,00066,India
367270,2023-10-17,207,coca cola,75,100,25,1,00088,India
315757,2023-10-17,213,bisleri,6,15,9,1,00393,India
315757,2023-10-17,201,paneer,210,340,130,1,00393,India
315757,2023-10-17,202,milk,12,27,15,1,00393,India
315757,2023-10-17,209,pepsi,75,100,25,1,00393,India
939868,2023-10-17,213,bisleri,6,15,9,1,00416,India
939868,2023-10-17,210,mountain dew,75,100,25,1,00416,India
939868,2023-10-17,212,amul cheese,250,315,65,1,00416,India
939868,2023-10-17,208,sprite,75,100,25,1,00416,India
939868,2023-10-17,204,strawberry yogurt,50,60,10,1,00416,India
398631,2023-10-18,212,amul cheese,250,315,65,1,00281,India
398631,2023-10-18,213,bisleri,6,15,9,1,00281,India
398631,2023-10-18,204,strawberry yogurt,50,60,10,1,00281,India
118409,2023-10-18,206,yakult,360,400,40,1,00302,India
569504,2023-10-18,208,sprite,75,100,25,1,00207,India
569504,2023-10-18,203,mango yogurt,50,60,10,1,00207,India
346053,2023-10-18,209,pepsi,75,100,25,1,00470,India
346053,2023-10-18,204,strawberry yogurt,50,60,10,1,00470,India
346053,2023-10-18,205,classic yogurt,45,60,15,1,00470,India
346053,2023-10-18,203,mango yogurt,50,60,10,1,00470,India
649009,2023-10-18,206,yakult,360,400,40,1,00211,India
649009,2023-10-18,202,milk,12,27,15,1,00211,India
649009,2023-10-18,208,sprite,75,100,25,1,00211,India
649009,2023-10-18,209,pepsi,75,100,25,1,00211,India
649009,2023-10-18,211,red bull,90,125,35,1,00211,India
242992,2023-10-18,202,milk,12,27,15,1,00025,India
242992,2023-10-18,209,pepsi,75,100,25,1,00025,India
242992,2023-10-18,205,classic yogurt,45,60,15,1,00025,India
242992,2023-10-18,203,mango yogurt,50,60,10,1,00025,India
702535,2023-10-18,208,sprite,75,100,25,1,00414,India
702535,2023-10-18,202,milk,12,27,15,1,00414,India
702535,2023-10-18,203,mango yogurt,50,60,10,1,00414,India
702535,2023-10-18,212,amul cheese,250,315,65,1,00414,India
989201,2023-10-18,209,pepsi,75,100,25,1,00134,India
989201,2023-10-18,203,mango yogurt,50,60,10,1,00134,India
529605,2023-10-18,204,strawberry yogurt,50,60,10,1,00195,India
529605,2023-10-18,210,mountain dew,75,100,25,1,00195,India
105635,2023-10-18,205,classic yogurt,45,60,15,1,00270,India
105635,2023-10-18,211,red bull,90,125,35,1,00270,India
105635,2023-10-18,208,sprite,75,100,25,1,00270,India
107894,2023-10-18,204,strawberry yogurt,50,60,10,1,00335,India
107894,2023-10-18,201,paneer,210,340,130,1,00335,India
800133,2023-10-18,205,classic yogurt,45,60,15,1,00022,India
800133,2023-10-18,213,bisleri,6,15,9,1,00022,India
800133,2023-10-18,202,milk,12,27,15,1,00022,India
281615,2023-10-18,212,amul cheese,250,315,65,1,00061,India
281615,2023-10-18,210,mountain dew,75,100,25,1,00061,India
252560,2023-10-18,205,classic yogurt,45,60,15,1,00057,India
252560,2023-10-18,202,milk,12,27,15,1,00057,India
252560,2023-10-18,207,coca cola,75,100,25,1,00057,India
252560,2023-10-18,204,strawberry yogurt,50,60,10,1,00057,India
992519,2023-10-18,210,mountain dew,75,100,25,1,00301,India
182887,2023-10-18,212,amul cheese,250,315,65,1,00412,India
222606,2023-10-18,213,bisleri,6,15,9,1,00258,India
222606,2023-10-18,210,mountain dew,75,100,25,1,00258,India
222606,2023-10-18,211,red bull,90,125,35,1,00258,India
460257,2023-10-18,213,bisleri,6,15,9,1,00329,India
460257,2023-10-18,210,mountain dew,75,100,25,1,00329,India
460257,2023-10-18,206,yakult,360,400,40,1,00329,India
460257,2023-10-18,207,coca cola,75,100,25,1,00329,India
883579,2023-10-18,201,paneer,210,340,130,1,00132,India
883579,2023-10-18,202,milk,12,27,15,1,00132,India
883579,2023-10-18,205,classic yogurt,45,60,15,1,00132,India
342584,2023-10-18,211,red bull,90,125,35,1,00412,India
342584,2023-10-18,209,pepsi,75,100,25,1,00412,India
358472,2023-10-18,201,paneer,210,340,130,1,00226,India
358472,2023-10-18,206,yakult,360,400,40,1,00226,India
665563,2023-10-18,212,amul cheese,250,315,65,1,00182,India
665563,2023-10-18,209,pepsi,75,100,25,1,00182,India
665563,2023-10-18,203,mango yogurt,50,60,10,1,00182,India
665563,2023-10-18,210,mountain dew,75,100,25,1,00182,India
686049,2023-10-18,208,sprite,75,100,25,1,00251,India
686049,2023-10-18,207,coca cola,75,100,25,1,00251,India
986229,2023-10-18,208,sprite,75,100,25,1,00326,India
986229,2023-10-18,204,strawberry yogurt,50,60,10,1,00326,India
440905,2023-10-18,209,pepsi,75,100,25,1,00128,India
440905,2023-10-18,208,sprite,75,100,25,1,00128,India
440905,2023-10-18,210,mountain dew,75,100,25,1,00128,India
440905,2023-10-18,212,amul cheese,250,315,65,1,00128,India
362321,2023-10-18,208,sprite,75,100,25,1,00390,India
899496,2023-10-18,201,paneer,210,340,130,1,00211,India
899496,2023-10-18,213,bisleri,6,15,9,1,00211,India
899496,2023-10-18,205,classic yogurt,45,60,15,1,00211,India
685673,2023-10-18,212,amul cheese,250,315,65,1,00321,India
739743,2023-10-18,211,red bull,90,125,35,1,00489,India
353790,2023-10-18,212,amul cheese,250,315,65,1,00473,India
506408,2023-10-18,213,bisleri,6,15,9,1,00094,India
506408,2023-10-18,212,amul cheese,250,315,65,1,00094,India
429200,2023-10-18,205,classic yogurt,45,60,15,1,00082,India
429200,2023-10-18,211,red bull,90,125,35,1,00082,India
861557,2023-10-18,213,bisleri,6,15,9,1,00476,India
287390,2023-10-18,206,yakult,360,400,40,1,00035,India
283438,2023-10-18,203,mango yogurt,50,60,10,1,00003,India
283438,2023-10-18,204,strawberry yogurt,50,60,10,1,00003,India
931071,2023-10-18,204,strawberry yogurt,50,60,10,1,00226,India
877692,2023-10-18,213,bisleri,6,15,9,1,00003,India
552223,2023-10-18,204,strawberry yogurt,50,60,10,1,00470,India
796681,2023-10-18,209,pepsi,75,100,25,1,00227,India
796681,2023-10-18,208,sprite,75,100,25,1,00227,India
796681,2023-10-18,203,mango yogurt,50,60,10,1,00227,India
521352,2023-10-18,211,red bull,90,125,35,1,00007,India
521352,2023-10-18,202,milk,12,27,15,1,00007,India
282538,2023-10-18,211,red bull,90,125,35,1,00492,India
282538,2023-10-18,212,amul cheese,250,315,65,1,00492,India
282538,2023-10-18,204,strawberry yogurt,50,60,10,1,00492,India
282538,2023-10-18,208,sprite,75,100,25,1,00492,India
282538,2023-10-18,206,yakult,360,400,40,1,00492,India
399626,2023-10-18,209,pepsi,75,100,25,1,00433,India
399626,2023-10-18,201,paneer,210,340,130,1,00433,India
663958,2023-10-18,201,paneer,210,340,130,1,00479,India
663958,2023-10-18,202,milk,12,27,15,1,00479,India
299476,2023-10-18,211,red bull,90,125,35,1,00314,India
795523,2023-10-18,213,bisleri,6,15,9,1,00068,India
795523,2023-10-18,205,classic yogurt,45,60,15,1,00068,India
979312,2023-10-18,206,yakult,360,400,40,1,00048,India
217346,2023-10-18,206,yakult,360,400,40,1,00387,India
217346,2023-10-18,208,sprite,75,100,25,1,00387,India
712031,2023-10-18,204,strawberry yogurt,50,60,10,1,00479,India
712031,2023-10-18,212,amul cheese,250,315,65,1,00479,India
712031,2023-10-18,211,red bull,90,125,35,1,00479,India
611155,2023-10-18,202,milk,12,27,15,1,00199,India
611155,2023-10-18,210,mountain dew,75,100,25,1,00199,India
611155,2023-10-18,205,classic yogurt,45,60,15,1,00199,India
908035,2023-10-18,201,paneer,210,340,130,1,00364,India
908035,2023-10-18,211,red bull,90,125,35,1,00364,India
908035,2023-10-18,207,coca cola,75,100,25,1,00364,India
908035,2023-10-18,212,amul cheese,250,315,65,1,00364,India
527839,2023-10-18,205,classic yogurt,45,60,15,1,00338,India
527839,2023-10-18,212,amul cheese,250,315,65,1,00338,India
695754,2023-10-18,207,coca cola,75,100,25,1,00243,India
695754,2023-10-18,212,amul cheese,250,315,65,1,00243,India
695754,2023-10-18,208,sprite,75,100,25,1,00243,India
500303,2023-10-18,212,amul cheese,250,315,65,1,00386,India
500303,2023-10-18,203,mango yogurt,50,60,10,1,00386,India
974324,2023-10-18,207,coca cola,75,100,25,1,00321,India
974324,2023-10-18,206,yakult,360,400,40,1,00321,India
353840,2023-10-18,212,amul cheese,250,315,65,1,00112,India
353840,2023-10-18,203,mango yogurt,50,60,10,1,00112,India
353840,2023-10-18,211,red bull,90,125,35,1,00112,India
533994,2023-10-18,202,milk,12,27,15,1,00342,India
533994,2023-10-18,210,mountain dew,75,100,25,1,00342,India
246860,2023-10-18,202,milk,12,27,15,1,00130,India
246860,2023-10-18,205,classic yogurt,45,60,15,1,00130,India
246860,2023-10-18,212,amul cheese,250,315,65,1,00130,India
246860,2023-10-18,201,paneer,210,340,130,1,00130,India
246860,2023-10-18,209,pepsi,75,100,25,1,00130,India
978438,2023-10-18,213,bisleri,6,15,9,1,00214,India
978438,2023-10-18,204,strawberry yogurt,50,60,10,1,00214,India
978438,2023-10-18,207,coca cola,75,100,25,1,00214,India
407096,2023-10-18,202,milk,12,27,15,1,00006,India
674800,2023-10-18,208,sprite,75,100,25,1,00127,India
674800,2023-10-18,203,mango yogurt,50,60,10,1,00127,India
161510,2023-10-19,207,coca cola,75,100,25,1,00282,India
161510,2023-10-19,202,milk,12,27,15,1,00282,India
161510,2023-10-19,208,sprite,75,100,25,1,00282,India
161510,2023-10-19,201,paneer,210,340,130,1,00282,India
921397,2023-10-19,203,mango yogurt,50,60,10,1,00482,India
921397,2023-10-19,211,red bull,90,125,35,1,00482,India
921397,2023-10-19,202,milk,12,27,15,1,00482,India
921397,2023-10-19,201,paneer,210,340,130,1,00482,India
442754,2023-10-19,203,mango yogurt,50,60,10,1,00331,India
442754,2023-10-19,209,pepsi,75,100,25,1,00331,India
442754,2023-10-19,210,mountain dew,75,100,25,1,00331,India
442754,2023-10-19,211,red bull,90,125,35,1,00331,India
867067,2023-10-19,209,pepsi,75,100,25,1,00213,India
867067,2023-10-19,201,paneer,210,340,130,1,00213,India
339086,2023-10-19,207,coca cola,75,100,25,1,00494,India
339086,2023-10-19,205,classic yogurt,45,60,15,1,00494,India
816481,2023-10-19,212,amul cheese,250,315,65,1,00272,India
816481,2023-10-19,202,milk,12,27,15,1,00272,India
959948,2023-10-19,201,paneer,210,340,130,1,00160,India
959948,2023-10-19,202,milk,12,27,15,1,00160,India
959948,2023-10-19,207,coca cola,75,100,25,1,00160,India
959948,2023-10-19,211,red bull,90,125,35,1,00160,India
550341,2023-10-19,203,mango yogurt,50,60,10,1,00066,India
528406,2023-10-19,202,milk,12,27,15,1,00488,India
528406,2023-10-19,204,strawberry yogurt,50,60,10,1,00488,India
528406,2023-10-19,208,sprite,75,100,25,1,00488,India
505475,2023-10-19,202,milk,12,27,15,1,00278,India
505475,2023-10-19,203,mango yogurt,50,60,10,1,00278,India
622776,2023-10-19,210,mountain dew,75,100,25,1,00240,India
622776,2023-10-19,208,sprite,75,100,25,1,00240,India
622776,2023-10-19,202,milk,12,27,15,1,00240,India
295615,2023-10-19,205,classic yogurt,45,60,15,1,00387,India
573800,2023-10-19,213,bisleri,6,15,9,1,00426,India
573800,2023-10-19,204,strawberry yogurt,50,60,10,1,00426,India
573800,2023-10-19,203,mango yogurt,50,60,10,1,00426,India
573800,2023-10-19,206,yakult,360,400,40,1,00426,India
573800,2023-10-19,211,red bull,90,125,35,1,00426,India
515958,2023-10-19,213,bisleri,6,15,9,1,00076,India
515958,2023-10-19,205,classic yogurt,45,60,15,1,00076,India
515958,2023-10-19,207,coca cola,75,100,25,1,00076,India
539487,2023-10-19,209,pepsi,75,100,25,1,00453,India
539487,2023-10-19,203,mango yogurt,50,60,10,1,00453,India
539487,2023-10-19,208,sprite,75,100,25,1,00453,India
166387,2023-10-19,209,pepsi,75,100,25,1,00150,India
467908,2023-10-19,201,paneer,210,340,130,1,00459,India
467908,2023-10-19,210,mountain dew,75,100,25,1,00459,India
467908,2023-10-19,213,bisleri,6,15,9,1,00459,India
467908,2023-10-19,211,red bull,90,125,35,1,00459,India
467908,2023-10-19,208,sprite,75,100,25,1,00459,India
404316,2023-10-19,203,mango yogurt,50,60,10,1,00354,India
404316,2023-10-19,207,coca cola,75,100,25,1,00354,India
404316,2023-10-19,212,amul cheese,250,315,65,1,00354,India
361440,2023-10-19,205,classic yogurt,45,60,15,1,00092,India
361440,2023-10-19,201,paneer,210,340,130,1,00092,India
957024,2023-10-19,201,paneer,210,340,130,1,00086,India
957024,2023-10-19,203,mango yogurt,50,60,10,1,00086,India
957024,2023-10-19,209,pepsi,75,100,25,1,00086,India
957024,2023-10-19,204,strawberry yogurt,50,60,10,1,00086,India
570574,2023-10-19,207,coca cola,75,100,25,1,00048,India
570574,2023-10-19,213,bisleri,6,15,9,1,00048,India
960451,2023-10-19,205,classic yogurt,45,60,15,1,00413,India
905976,2023-10-19,212,amul cheese,250,315,65,1,00076,India
905976,2023-10-19,206,yakult,360,400,40,1,00076,India
905976,2023-10-19,208,sprite,75,100,25,1,00076,India
505088,2023-10-19,207,coca cola,75,100,25,1,00297,India
505088,2023-10-19,204,strawberry yogurt,50,60,10,1,00297,India
505088,2023-10-19,213,bisleri,6,15,9,1,00297,India
217671,2023-10-19,211,red bull,90,125,35,1,00025,India
217671,2023-10-19,202,milk,12,27,15,1,00025,India
590095,2023-10-19,211,red bull,90,125,35,1,00261,India
590095,2023-10-19,203,mango yogurt,50,60,10,1,00261,India
590095,2023-10-19,212,amul cheese,250,315,65,1,00261,India
805998,2023-10-19,202,milk,12,27,15,1,00082,India
805998,2023-10-19,205,classic yogurt,45,60,15,1,00082,India
805998,2023-10-19,211,red bull,90,125,35,1,00082,India
805998,2023-10-19,212,amul cheese,250,315,65,1,00082,India
572368,2023-10-19,213,bisleri,6,15,9,1,00040,India
572368,2023-10-19,211,red bull,90,125,35,1,00040,India
565681,2023-10-19,207,coca cola,75,100,25,1,00091,India
377687,2023-10-19,203,mango yogurt,50,60,10,1,00349,India
377687,2023-10-19,205,classic yogurt,45,60,15,1,00349,India
377687,2023-10-19,208,sprite,75,100,25,1,00349,India
983250,2023-10-19,207,coca cola,75,100,25,1,00134,India
740448,2023-10-19,209,pepsi,75,100,25,1,00470,India
740448,2023-10-19,213,bisleri,6,15,9,1,00470,India
527188,2023-10-19,208,sprite,75,100,25,1,00475,India
527188,2023-10-19,207,coca cola,75,100,25,1,00475,India
527188,2023-10-19,203,mango yogurt,50,60,10,1,00475,India
474968,2023-10-19,207,coca cola,75,100,25,1,00303,India
474968,2023-10-19,205,classic yogurt,45,60,15,1,00303,India
474968,2023-10-19,202,milk,12,27,15,1,00303,India
474968,2023-10-19,206,yakult,360,400,40,1,00303,India
232588,2023-10-19,209,pepsi,75,100,25,1,00168,India
232588,2023-10-19,207,coca cola,75,100,25,1,00168,India
232588,2023-10-19,203,mango yogurt,50,60,10,1,00168,India
232588,2023-10-19,204,strawberry yogurt,50,60,10,1,00168,India
232588,2023-10-19,210,mountain dew,75,100,25,1,00168,India
491115,2023-10-19,205,classic yogurt,45,60,15,1,00158,India
491115,2023-10-19,203,mango yogurt,50,60,10,1,00158,India
491115,2023-10-19,207,coca cola,75,100,25,1,00158,India
491115,2023-10-19,204,strawberry yogurt,50,60,10,1,00158,India
163378,2023-10-19,208,sprite,75,100,25,1,00029,India
163378,2023-10-19,206,yakult,360,400,40,1,00029,India
163378,2023-10-19,209,pepsi,75,100,25,1,00029,India
544368,2023-10-19,210,mountain dew,75,100,25,1,00140,India
544368,2023-10-19,203,mango yogurt,50,60,10,1,00140,India
544368,2023-10-19,201,paneer,210,340,130,1,00140,India
544368,2023-10-19,213,bisleri,6,15,9,1,00140,India
701497,2023-10-19,212,amul cheese,250,315,65,1,00290,India
701497,2023-10-19,201,paneer,210,340,130,1,00290,India
757423,2023-10-19,206,yakult,360,400,40,1,00350,India
757423,2023-10-19,207,coca cola,75,100,25,1,00350,India
757423,2023-10-19,209,pepsi,75,100,25,1,00350,India
757423,2023-10-19,203,mango yogurt,50,60,10,1,00350,India
190315,2023-10-19,207,coca cola,75,100,25,1,00177,India
682911,2023-10-19,201,paneer,210,340,130,1,00058,India
682911,2023-10-19,212,amul cheese,250,315,65,1,00058,India
682911,2023-10-19,211,red bull,90,125,35,1,00058,India
469110,2023-10-19,205,classic yogurt,45,60,15,1,00307,India
469110,2023-10-19,201,paneer,210,340,130,1,00307,India
469110,2023-10-19,210,mountain dew,75,100,25,1,00307,India
346433,2023-10-19,202,milk,12,27,15,1,00279,India
346433,2023-10-19,211,red bull,90,125,35,1,00279,India
346433,2023-10-19,205,classic yogurt,45,60,15,1,00279,India
346433,2023-10-19,203,mango yogurt,50,60,10,1,00279,India
800623,2023-10-19,206,yakult,360,400,40,1,00155,India
308428,2023-10-19,203,mango yogurt,50,60,10,1,00038,India
308428,2023-10-19,209,pepsi,75,100,25,1,00038,India
994424,2023-10-19,209,pepsi,75,100,25,1,00272,India
994424,2023-10-19,212,amul cheese,250,315,65,1,00272,India
994424,2023-10-19,205,classic yogurt,45,60,15,1,00272,India
391092,2023-10-19,206,yakult,360,400,40,1,00274,India
391092,2023-10-19,207,coca cola,75,100,25,1,00274,India
391092,2023-10-19,208,sprite,75,100,25,1,00274,India
391092,2023-10-19,205,classic yogurt,45,60,15,1,00274,India
490014,2023-10-19,202,milk,12,27,15,1,00440,India
490014,2023-10-19,205,classic yogurt,45,60,15,1,00440,India
490014,2023-10-19,211,red bull,90,125,35,1,00440,India
367458,2023-10-19,211,red bull,90,125,35,1,00458,India
240899,2023-10-19,213,bisleri,6,15,9,1,00317,India
240899,2023-10-19,201,paneer,210,340,130,1,00317,India
431779,2023-10-19,206,yakult,360,400,40,1,00344,India
431779,2023-10-19,204,strawberry yogurt,50,60,10,1,00344,India
797048,2023-10-19,212,amul cheese,250,315,65,1,00476,India
797048,2023-10-19,205,classic yogurt,45,60,15,1,00476,India
797048,2023-10-19,209,pepsi,75,100,25,1,00476,India
512813,2023-10-19,208,sprite,75,100,25,1,00160,India
399014,2023-10-19,213,bisleri,6,15,9,1,00296,India
399014,2023-10-19,211,red bull,90,125,35,1,00296,India
399014,2023-10-19,206,yakult,360,400,40,1,00296,India
399014,2023-10-19,201,paneer,210,340,130,1,00296,India
399014,2023-10-19,208,sprite,75,100,25,1,00296,India
461630,2023-10-19,213,bisleri,6,15,9,1,00101,India
853986,2023-10-19,210,mountain dew,75,100,25,1,00426,India
853986,2023-10-19,208,sprite,75,100,25,1,00426,India
853986,2023-10-19,207,coca cola,75,100,25,1,00426,India
853986,2023-10-19,206,yakult,360,400,40,1,00426,India
936591,2023-10-19,208,sprite,75,100,25,1,00450,India
936591,2023-10-19,210,mountain dew,75,100,25,1,00450,India
936591,2023-10-19,204,strawberry yogurt,50,60,10,1,00450,India
633732,2023-10-19,205,classic yogurt,45,60,15,1,00037,India
633732,2023-10-19,210,mountain dew,75,100,25,1,00037,India
633732,2023-10-19,207,coca cola,75,100,25,1,00037,India
960154,2023-10-19,203,mango yogurt,50,60,10,1,00223,India
960154,2023-10-19,207,coca cola,75,100,25,1,00223,India
960154,2023-10-19,201,paneer,210,340,130,1,00223,India
570695,2023-10-19,210,mountain dew,75,100,25,1,00055,India
570695,2023-10-19,204,strawberry yogurt,50,60,10,1,00055,India
570695,2023-10-19,202,milk,12,27,15,1,00055,India
621160,2023-10-19,204,strawberry yogurt,50,60,10,1,00253,India
515272,2023-10-19,205,classic yogurt,45,60,15,1,00496,India
628704,2023-10-19,206,yakult,360,400,40,1,00281,India
598972,2023-10-19,201,paneer,210,340,130,1,00228,India
598972,2023-10-19,204,strawberry yogurt,50,60,10,1,00228,India
485938,2023-10-19,202,milk,12,27,15,1,00355,India
485938,2023-10-19,204,strawberry yogurt,50,60,10,1,00355,India
485938,2023-10-19,212,amul cheese,250,315,65,1,00355,India
485938,2023-10-19,211,red bull,90,125,35,1,00355,India
515568,2023-10-19,213,bisleri,6,15,9,1,00238,India
917526,2023-10-19,203,mango yogurt,50,60,10,1,00441,India
917526,2023-10-19,206,yakult,360,400,40,1,00441,India
969315,2023-10-20,202,milk,12,27,15,1,00284,India
969315,2023-10-20,203,mango yogurt,50,60,10,1,00284,India
969315,2023-10-20,201,paneer,210,340,130,1,00284,India
969315,2023-10-20,207,coca cola,75,100,25,1,00284,India
296026,2023-10-20,212,amul cheese,250,315,65,1,00252,India
296026,2023-10-20,209,pepsi,75,100,25,1,00252,India
296026,2023-10-20,210,mountain dew,75,100,25,1,00252,India
296026,2023-10-20,205,classic yogurt,45,60,15,1,00252,India
829028,2023-10-20,206,yakult,360,400,40,1,00420,India
502928,2023-10-20,203,mango yogurt,50,60,10,1,00145,India
546441,2023-10-20,210,mountain dew,75,100,25,1,00384,India
677566,2023-10-20,206,yakult,360,400,40,1,00097,India
677566,2023-10-20,209,pepsi,75,100,25,1,00097,India
677566,2023-10-20,205,classic yogurt,45,60,15,1,00097,India
677566,2023-10-20,203,mango yogurt,50,60,10,1,00097,India
180619,2023-10-20,209,pepsi,75,100,25,1,00336,India
180619,2023-10-20,212,amul cheese,250,315,65,1,00336,India
180619,2023-10-20,205,classic yogurt,45,60,15,1,00336,India
986562,2023-10-20,203,mango yogurt,50,60,10,1,00485,India
106644,2023-10-20,201,paneer,210,340,130,1,00144,India
106644,2023-10-20,209,pepsi,75,100,25,1,00144,India
106644,2023-10-20,212,amul cheese,250,315,65,1,00144,India
106644,2023-10-20,203,mango yogurt,50,60,10,1,00144,India
325029,2023-10-20,207,coca cola,75,100,25,1,00341,India
325029,2023-10-20,204,strawberry yogurt,50,60,10,1,00341,India
325029,2023-10-20,209,pepsi,75,100,25,1,00341,India
651444,2023-10-20,210,mountain dew,75,100,25,1,00062,India
651444,2023-10-20,204,strawberry yogurt,50,60,10,1,00062,India
651444,2023-10-20,203,mango yogurt,50,60,10,1,00062,India
683490,2023-10-20,210,mountain dew,75,100,25,1,00388,India
683490,2023-10-20,212,amul cheese,250,315,65,1,00388,India
288961,2023-10-20,210,mountain dew,75,100,25,1,00447,India
288961,2023-10-20,206,yakult,360,400,40,1,00447,India
288961,2023-10-20,201,paneer,210,340,130,1,00447,India
650537,2023-10-20,205,classic yogurt,45,60,15,1,00068,India
634079,2023-10-20,206,yakult,360,400,40,1,00055,India
643908,2023-10-20,205,classic yogurt,45,60,15,1,00287,India
643908,2023-10-20,207,coca cola,75,100,25,1,00287,India
643908,2023-10-20,206,yakult,360,400,40,1,00287,India
643908,2023-10-20,202,milk,12,27,15,1,00287,India
114965,2023-10-20,206,yakult,360,400,40,1,00419,India
114965,2023-10-20,211,red bull,90,125,35,1,00419,India
857096,2023-10-20,206,yakult,360,400,40,1,00036,India
857096,2023-10-20,207,coca cola,75,100,25,1,00036,India
857096,2023-10-20,212,amul cheese,250,315,65,1,00036,India
778821,2023-10-20,203,mango yogurt,50,60,10,1,00037,India
814533,2023-10-20,202,milk,12,27,15,1,00411,India
536449,2023-10-20,209,pepsi,75,100,25,1,00247,India
141502,2023-10-20,208,sprite,75,100,25,1,00361,India
141502,2023-10-20,213,bisleri,6,15,9,1,00361,India
141502,2023-10-20,212,amul cheese,250,315,65,1,00361,India
141502,2023-10-20,205,classic yogurt,45,60,15,1,00361,India
495441,2023-10-20,206,yakult,360,400,40,1,00244,India
495441,2023-10-20,212,amul cheese,250,315,65,1,00244,India
599861,2023-10-20,211,red bull,90,125,35,1,00311,India
599861,2023-10-20,213,bisleri,6,15,9,1,00311,India
599861,2023-10-20,210,mountain dew,75,100,25,1,00311,India
599861,2023-10-20,209,pepsi,75,100,25,1,00311,India
793967,2023-10-20,206,yakult,360,400,40,1,00356,India
793967,2023-10-20,202,milk,12,27,15,1,00356,India
793967,2023-10-20,212,amul cheese,250,315,65,1,00356,India
793967,2023-10-20,213,bisleri,6,15,9,1,00356,India
582014,2023-10-20,202,milk,12,27,15,1,00402,India
582014,2023-10-20,201,paneer,210,340,130,1,00402,India
582014,2023-10-20,207,coca cola,75,100,25,1,00402,India
582014,2023-10-20,209,pepsi,75,100,25,1,00402,India
582014,2023-10-20,206,yakult,360,400,40,1,00402,India
191526,2023-10-20,202,milk,12,27,15,1,00373,India
191526,2023-10-20,201,paneer,210,340,130,1,00373,India
191526,2023-10-20,205,classic yogurt,45,60,15,1,00373,India
191526,2023-10-20,206,yakult,360,400,40,1,00373,India
191526,2023-10-20,203,mango yogurt,50,60,10,1,00373,India
636091,2023-10-20,210,mountain dew,75,100,25,1,00384,India
636091,2023-10-20,206,yakult,360,400,40,1,00384,India
636091,2023-10-20,201,paneer,210,340,130,1,00384,India
651918,2023-10-20,203,mango yogurt,50,60,10,1,00359,India
651918,2023-10-20,201,paneer,210,340,130,1,00359,India
651918,2023-10-20,210,mountain dew,75,100,25,1,00359,India
651918,2023-10-20,213,bisleri,6,15,9,1,00359,India
316564,2023-10-20,204,strawberry yogurt,50,60,10,1,00316,India
113899,2023-10-20,203,mango yogurt,50,60,10,1,00089,India
460032,2023-10-20,206,yakult,360,400,40,1,00398,India
460032,2023-10-20,209,pepsi,75,100,25,1,00398,India
460032,2023-10-20,213,bisleri,6,15,9,1,00398,India
722567,2023-10-20,211,red bull,90,125,35,1,00401,India
722567,2023-10-20,213,bisleri,6,15,9,1,00401,India
722567,2023-10-20,201,paneer,210,340,130,1,00401,India
808971,2023-10-20,204,strawberry yogurt,50,60,10,1,00482,India
808971,2023-10-20,213,bisleri,6,15,9,1,00482,India
808971,2023-10-20,210,mountain dew,75,100,25,1,00482,India
808971,2023-10-20,205,classic yogurt,45,60,15,1,00482,India
808971,2023-10-20,202,milk,12,27,15,1,00482,India
636286,2023-10-20,212,amul cheese,250,315,65,1,00185,India
636286,2023-10-20,204,strawberry yogurt,50,60,10,1,00185,India
167144,2023-10-20,203,mango yogurt,50,60,10,1,00011,India
167144,2023-10-20,211,red bull,90,125,35,1,00011,India
758746,2023-10-20,201,paneer,210,340,130,1,00323,India
758746,2023-10-20,213,bisleri,6,15,9,1,00323,India
147572,2023-10-20,210,mountain dew,75,100,25,1,00156,India
147572,2023-10-20,204,strawberry yogurt,50,60,10,1,00156,India
997524,2023-10-20,207,coca cola,75,100,25,1,00161,India
997524,2023-10-20,205,classic yogurt,45,60,15,1,00161,India
435772,2023-10-20,211,red bull,90,125,35,1,00455,India
435772,2023-10-20,204,strawberry yogurt,50,60,10,1,00455,India
435772,2023-10-20,201,paneer,210,340,130,1,00455,India
435772,2023-10-20,203,mango yogurt,50,60,10,1,00455,India
435772,2023-10-20,207,coca cola,75,100,25,1,00455,India
794469,2023-10-20,205,classic yogurt,45,60,15,1,00348,India
794469,2023-10-20,206,yakult,360,400,40,1,00348,India
449425,2023-10-20,208,sprite,75,100,25,1,00425,India
449425,2023-10-20,210,mountain dew,75,100,25,1,00425,India
449425,2023-10-20,205,classic yogurt,45,60,15,1,00425,India
449425,2023-10-20,213,bisleri,6,15,9,1,00425,India
449425,2023-10-20,203,mango yogurt,50,60,10,1,00425,India
293102,2023-10-20,203,mango yogurt,50,60,10,1,00387,India
293102,2023-10-20,205,classic yogurt,45,60,15,1,00387,India
293102,2023-10-20,202,milk,12,27,15,1,00387,India
913812,2023-10-20,205,classic yogurt,45,60,15,1,00366,India
913812,2023-10-20,212,amul cheese,250,315,65,1,00366,India
913812,2023-10-20,213,bisleri,6,15,9,1,00366,India
913812,2023-10-20,211,red bull,90,125,35,1,00366,India
913812,2023-10-20,209,pepsi,75,100,25,1,00366,India
934873,2023-10-20,203,mango yogurt,50,60,10,1,00153,India
934873,2023-10-20,205,classic yogurt,45,60,15,1,00153,India
934873,2023-10-20,213,bisleri,6,15,9,1,00153,India
815817,2023-10-20,205,classic yogurt,45,60,15,1,00481,India
815817,2023-10-20,212,amul cheese,250,315,65,1,00481,India
815817,2023-10-20,213,bisleri,6,15,9,1,00481,India
815817,2023-10-20,207,coca cola,75,100,25,1,00481,India
815817,2023-10-20,203,mango yogurt,50,60,10,1,00481,India
926843,2023-10-20,205,classic yogurt,45,60,15,1,00326,India
926843,2023-10-20,207,coca cola,75,100,25,1,00326,India
926843,2023-10-20,202,milk,12,27,15,1,00326,India
862817,2023-10-20,209,pepsi,75,100,25,1,00051,India
862817,2023-10-20,203,mango yogurt,50,60,10,1,00051,India
862817,2023-10-20,211,red bull,90,125,35,1,00051,India
182589,2023-10-20,204,strawberry yogurt,50,60,10,1,00120,India
182589,2023-10-20,203,mango yogurt,50,60,10,1,00120,India
182589,2023-10-20,206,yakult,360,400,40,1,00120,India
182589,2023-10-20,211,red bull,90,125,35,1,00120,India
182589,2023-10-20,207,coca cola,75,100,25,1,00120,India
589799,2023-10-20,210,mountain dew,75,100,25,1,00106,India
589799,2023-10-20,201,paneer,210,340,130,1,00106,India
302730,2023-10-20,201,paneer,210,340,130,1,00291,India
302730,2023-10-20,203,mango yogurt,50,60,10,1,00291,India
891359,2023-10-20,212,amul cheese,250,315,65,1,00126,India
891359,2023-10-20,206,yakult,360,400,40,1,00126,India
891359,2023-10-20,205,classic yogurt,45,60,15,1,00126,India
205256,2023-10-20,213,bisleri,6,15,9,1,00048,India
205256,2023-10-20,205,classic yogurt,45,60,15,1,00048,India
205256,2023-10-20,209,pepsi,75,100,25,1,00048,India
827279,2023-10-20,207,coca cola,75,100,25,1,00181,India
827279,2023-10-20,211,red bull,90,125,35,1,00181,India
827279,2023-10-20,202,milk,12,27,15,1,00181,India
827279,2023-10-20,205,classic yogurt,45,60,15,1,00181,India
328505,2023-10-20,209,pepsi,75,100,25,1,00129,India
759232,2023-10-20,205,classic yogurt,45,60,15,1,00303,India
580747,2023-10-20,212,amul cheese,250,315,65,1,00131,India
234284,2023-10-20,210,mountain dew,75,100,25,1,00201,India
234284,2023-10-20,212,amul cheese,250,315,65,1,00201,India
234284,2023-10-20,206,yakult,360,400,40,1,00201,India
735389,2023-10-20,202,milk,12,27,15,1,00099,India
735389,2023-10-20,203,mango yogurt,50,60,10,1,00099,India
735389,2023-10-20,209,pepsi,75,100,25,1,00099,India
735389,2023-10-20,210,mountain dew,75,100,25,1,00099,India
735389,2023-10-20,207,coca cola,75,100,25,1,00099,India
835033,2023-10-20,207,coca cola,75,100,25,1,00477,India
835033,2023-10-20,201,paneer,210,340,130,1,00477,India
835033,2023-10-20,205,classic yogurt,45,60,15,1,00477,India
835033,2023-10-20,202,milk,12,27,15,1,00477,India
503858,2023-10-20,211,red bull,90,125,35,1,00485,India
503858,2023-10-20,202,milk,12,27,15,1,00485,India
503858,2023-10-20,209,pepsi,75,100,25,1,00485,India
503858,2023-10-20,213,bisleri,6,15,9,1,00485,India
503858,2023-10-20,210,mountain dew,75,100,25,1,00485,India
747690,2023-10-20,201,paneer,210,340,130,1,00067,India
747690,2023-10-20,213,bisleri,6,15,9,1,00067,India
249096,2023-10-20,211,red bull,90,125,35,1,00192,India
249096,2023-10-20,204,strawberry yogurt,50,60,10,1,00192,India
816069,2023-10-20,207,coca cola,75,100,25,1,00275,India
816069,2023-10-20,210,mountain dew,75,100,25,1,00275,India
359632,2023-10-20,201,paneer,210,340,130,1,00257,India
359632,2023-10-20,204,strawberry yogurt,50,60,10,1,00257,India
359632,2023-10-20,212,amul cheese,250,315,65,1,00257,India
359632,2023-10-20,203,mango yogurt,50,60,10,1,00257,India
359632,2023-10-20,208,sprite,75,100,25,1,00257,India
505961,2023-10-20,213,bisleri,6,15,9,1,00384,India
505961,2023-10-20,202,milk,12,27,15,1,00384,India
117865,2023-10-20,206,yakult,360,400,40,1,00067,India
117865,2023-10-20,204,strawberry yogurt,50,60,10,1,00067,India
117865,2023-10-20,210,mountain dew,75,100,25,1,00067,India
117865,2023-10-20,203,mango yogurt,50,60,10,1,00067,India
734262,2023-10-20,204,strawberry yogurt,50,60,10,1,00472,India
734262,2023-10-20,206,yakult,360,400,40,1,00472,India
734262,2023-10-20,207,coca cola,75,100,25,1,00472,India
406587,2023-10-20,213,bisleri,6,15,9,1,00177,India
155269,2023-10-20,213,bisleri,6,15,9,1,00023,India
155269,2023-10-20,204,strawberry yogurt,50,60,10,1,00023,India
155269,2023-10-20,209,pepsi,75,100,25,1,00023,India
909413,2023-10-20,213,bisleri,6,15,9,1,00454,India
909413,2023-10-20,211,red bull,90,125,35,1,00454,India
909413,2023-10-20,209,pepsi,75,100,25,1,00454,India
326982,2023-10-20,212,amul cheese,250,315,65,1,00205,India
326982,2023-10-20,204,strawberry yogurt,50,60,10,1,00205,India
326982,2023-10-20,213,bisleri,6,15,9,1,00205,India
326982,2023-10-20,205,classic yogurt,45,60,15,1,00205,India
326982,2023-10-20,210,mountain dew,75,100,25,1,00205,India
150684,2023-10-20,212,amul cheese,250,315,65,1,00109,India
150684,2023-10-20,207,coca cola,75,100,25,1,00109,India
150684,2023-10-20,206,yakult,360,400,40,1,00109,India
150684,2023-10-20,204,strawberry yogurt,50,60,10,1,00109,India
251682,2023-10-20,208,sprite,75,100,25,1,00240,India
251682,2023-10-20,204,strawberry yogurt,50,60,10,1,00240,India
251682,2023-10-20,211,red bull,90,125,35,1,00240,India
251682,2023-10-20,205,classic yogurt,45,60,15,1,00240,India
251682,2023-10-20,206,yakult,360,400,40,1,00240,India
664863,2023-10-20,211,red bull,90,125,35,1,00347,India
800985,2023-10-20,209,pepsi,75,100,25,1,00222,India
800985,2023-10-20,208,sprite,75,100,25,1,00222,India
800985,2023-10-20,204,strawberry yogurt,50,60,10,1,00222,India
800985,2023-10-20,206,yakult,360,400,40,1,00222,India
505691,2023-10-20,203,mango yogurt,50,60,10,1,00041,India
589894,2023-10-20,213,bisleri,6,15,9,1,00351,India
589894,2023-10-20,203,mango yogurt,50,60,10,1,00351,India
861846,2023-10-20,202,milk,12,27,15,1,00362,India
861846,2023-10-20,210,mountain dew,75,100,25,1,00362,India
861846,2023-10-20,208,sprite,75,100,25,1,00362,India
602292,2023-10-20,201,paneer,210,340,130,1,00006,India
235145,2023-10-20,205,classic yogurt,45,60,15,1,00395,India
657015,2023-10-20,209,pepsi,75,100,25,1,00139,India
657015,2023-10-20,206,yakult,360,400,40,1,00139,India
657015,2023-10-20,211,red bull,90,125,35,1,00139,India
657015,2023-10-20,204,strawberry yogurt,50,60,10,1,00139,India
973598,2023-10-20,209,pepsi,75,100,25,1,00115,India
973598,2023-10-20,208,sprite,75,100,25,1,00115,India
973598,2023-10-20,203,mango yogurt,50,60,10,1,00115,India
973598,2023-10-20,211,red bull,90,125,35,1,00115,India
151278,2023-10-20,203,mango yogurt,50,60,10,1,00113,India
151278,2023-10-20,202,milk,12,27,15,1,00113,India
106998,2023-10-20,208,sprite,75,100,25,1,00047,India
106998,2023-10-20,213,bisleri,6,15,9,1,00047,India
106998,2023-10-20,203,mango yogurt,50,60,10,1,00047,India
287446,2023-10-20,212,amul cheese,250,315,65,1,00113,India
287446,2023-10-20,205,classic yogurt,45,60,15,1,00113,India
287446,2023-10-20,203,mango yogurt,50,60,10,1,00113,India
587008,2023-10-20,206,yakult,360,400,40,1,00247,India
607551,2023-10-20,207,coca cola,75,100,25,1,00231,India
607551,2023-10-20,201,paneer,210,340,130,1,00231,India
607551,2023-10-20,212,amul cheese,250,315,65,1,00231,India
542010,2023-10-20,201,paneer,210,340,130,1,00195,India
188882,2023-10-20,205,classic yogurt,45,60,15,1,00326,India
141697,2023-10-20,202,milk,12,27,15,1,00486,India
447526,2023-10-20,206,yakult,360,400,40,1,00388,India
447526,2023-10-20,210,mountain dew,75,100,25,1,00388,India
285762,2023-10-20,204,strawberry yogurt,50,60,10,1,00208,India
285762,2023-10-20,213,bisleri,6,15,9,1,00208,India
285762,2023-10-20,212,amul cheese,250,315,65,1,00208,India
285762,2023-10-20,205,classic yogurt,45,60,15,1,00208,India
588035,2023-10-20,208,sprite,75,100,25,1,00369,India
588035,2023-10-20,210,mountain dew,75,100,25,1,00369,India
588035,2023-10-20,203,mango yogurt,50,60,10,1,00369,India
128990,2023-10-20,208,sprite,75,100,25,1,00184,India
128990,2023-10-20,206,yakult,360,400,40,1,00184,India
128990,2023-10-20,209,pepsi,75,100,25,1,00184,India
128990,2023-10-20,207,coca cola,75,100,25,1,00184,India
967546,2023-10-20,206,yakult,360,400,40,1,00195,India
967546,2023-10-20,213,bisleri,6,15,9,1,00195,India
967546,2023-10-20,201,paneer,210,340,130,1,00195,India
830555,2023-10-20,204,strawberry yogurt,50,60,10,1,00165,India
830555,2023-10-20,202,milk,12,27,15,1,00165,India
830555,2023-10-20,212,amul cheese,250,315,65,1,00165,India
830555,2023-10-20,213,bisleri,6,15,9,1,00165,India
887792,2023-10-20,212,amul cheese,250,315,65,1,00360,India
887792,2023-10-20,203,mango yogurt,50,60,10,1,00360,India
887792,2023-10-20,213,bisleri,6,15,9,1,00360,India
328110,2023-10-21,211,red bull,90,125,35,1,00474,India
328110,2023-10-21,210,mountain dew,75,100,25,1,00474,India
328110,2023-10-21,208,sprite,75,100,25,1,00474,India
418295,2023-10-21,202,milk,12,27,15,1,00310,India
418295,2023-10-21,201,paneer,210,340,130,1,00310,India
107892,2023-10-21,201,paneer,210,340,130,1,00343,India
107892,2023-10-21,211,red bull,90,125,35,1,00343,India
107892,2023-10-21,208,sprite,75,100,25,1,00343,India
107892,2023-10-21,212,amul cheese,250,315,65,1,00343,India
543443,2023-10-21,213,bisleri,6,15,9,1,00450,India
543443,2023-10-21,205,classic yogurt,45,60,15,1,00450,India
543443,2023-10-21,207,coca cola,75,100,25,1,00450,India
543443,2023-10-21,203,mango yogurt,50,60,10,1,00450,India
909667,2023-10-21,204,strawberry yogurt,50,60,10,1,00144,India
909667,2023-10-21,203,mango yogurt,50,60,10,1,00144,India
909667,2023-10-21,205,classic yogurt,45,60,15,1,00144,India
909667,2023-10-21,210,mountain dew,75,100,25,1,00144,India
794139,2023-10-21,205,classic yogurt,45,60,15,1,00430,India
794139,2023-10-21,213,bisleri,6,15,9,1,00430,India
794139,2023-10-21,212,amul cheese,250,315,65,1,00430,India
794139,2023-10-21,211,red bull,90,125,35,1,00430,India
888033,2023-10-21,205,classic yogurt,45,60,15,1,00425,India
888033,2023-10-21,201,paneer,210,340,130,1,00425,India
242917,2023-10-21,213,bisleri,6,15,9,1,00499,India
242917,2023-10-21,201,paneer,210,340,130,1,00499,India
242917,2023-10-21,205,classic yogurt,45,60,15,1,00499,India
109874,2023-10-21,205,classic yogurt,45,60,15,1,00145,India
109874,2023-10-21,201,paneer,210,340,130,1,00145,India
109874,2023-10-21,210,mountain dew,75,100,25,1,00145,India
202017,2023-10-21,212,amul cheese,250,315,65,1,00041,India
867039,2023-10-21,206,yakult,360,400,40,1,00242,India
867039,2023-10-21,201,paneer,210,340,130,1,00242,India
867039,2023-10-21,212,amul cheese,250,315,65,1,00242,India
551982,2023-10-21,201,paneer,210,340,130,1,00132,India
551982,2023-10-21,212,amul cheese,250,315,65,1,00132,India
738497,2023-10-21,211,red bull,90,125,35,1,00438,India
738497,2023-10-21,213,bisleri,6,15,9,1,00438,India
738497,2023-10-21,210,mountain dew,75,100,25,1,00438,India
738497,2023-10-21,203,mango yogurt,50,60,10,1,00438,India
738497,2023-10-21,208,sprite,75,100,25,1,00438,India
892380,2023-10-21,211,red bull,90,125,35,1,00310,India
892380,2023-10-21,203,mango yogurt,50,60,10,1,00310,India
892380,2023-10-21,207,coca cola,75,100,25,1,00310,India
892380,2023-10-21,206,yakult,360,400,40,1,00310,India
545192,2023-10-21,201,paneer,210,340,130,1,00217,India
545192,2023-10-21,209,pepsi,75,100,25,1,00217,India
545192,2023-10-21,207,coca cola,75,100,25,1,00217,India
545192,2023-10-21,205,classic yogurt,45,60,15,1,00217,India
787240,2023-10-21,211,red bull,90,125,35,1,00395,India
357927,2023-10-21,212,amul cheese,250,315,65,1,00009,India
357927,2023-10-21,213,bisleri,6,15,9,1,00009,India
357927,2023-10-21,208,sprite,75,100,25,1,00009,India
225193,2023-10-21,205,classic yogurt,45,60,15,1,00429,India
420761,2023-10-21,203,mango yogurt,50,60,10,1,00365,India
420761,2023-10-21,201,paneer,210,340,130,1,00365,India
235332,2023-10-21,206,yakult,360,400,40,1,00447,India
235332,2023-10-21,208,sprite,75,100,25,1,00447,India
235332,2023-10-21,211,red bull,90,125,35,1,00447,India
485946,2023-10-21,203,mango yogurt,50,60,10,1,00480,India
485946,2023-10-21,204,strawberry yogurt,50,60,10,1,00480,India
485946,2023-10-21,213,bisleri,6,15,9,1,00480,India
485946,2023-10-21,211,red bull,90,125,35,1,00480,India
984290,2023-10-21,201,paneer,210,340,130,1,00475,India
984290,2023-10-21,207,coca cola,75,100,25,1,00475,India
984290,2023-10-21,211,red bull,90,125,35,1,00475,India
984290,2023-10-21,204,strawberry yogurt,50,60,10,1,00475,India
299262,2023-10-21,203,mango yogurt,50,60,10,1,00157,India
299262,2023-10-21,206,yakult,360,400,40,1,00157,India
299262,2023-10-21,207,coca cola,75,100,25,1,00157,India
299262,2023-10-21,212,amul cheese,250,315,65,1,00157,India
299262,2023-10-21,209,pepsi,75,100,25,1,00157,India
218078,2023-10-21,206,yakult,360,400,40,1,00449,India
218078,2023-10-21,213,bisleri,6,15,9,1,00449,India
560327,2023-10-21,211,red bull,90,125,35,1,00436,India
560327,2023-10-21,207,coca cola,75,100,25,1,00436,India
525774,2023-10-21,213,bisleri,6,15,9,1,00291,India
525774,2023-10-21,207,coca cola,75,100,25,1,00291,India
525774,2023-10-21,211,red bull,90,125,35,1,00291,India
525774,2023-10-21,201,paneer,210,340,130,1,00291,India
525774,2023-10-21,209,pepsi,75,100,25,1,00291,India
459810,2023-10-21,203,mango yogurt,50,60,10,1,00235,India
459810,2023-10-21,202,milk,12,27,15,1,00235,India
459810,2023-10-21,206,yakult,360,400,40,1,00235,India
459810,2023-10-21,201,paneer,210,340,130,1,00235,India
130955,2023-10-21,207,coca cola,75,100,25,1,00027,India
130955,2023-10-21,210,mountain dew,75,100,25,1,00027,India
291907,2023-10-21,203,mango yogurt,50,60,10,1,00172,India
291907,2023-10-21,209,pepsi,75,100,25,1,00172,India
291907,2023-10-21,201,paneer,210,340,130,1,00172,India
291907,2023-10-21,207,coca cola,75,100,25,1,00172,India
194637,2023-10-21,209,pepsi,75,100,25,1,00256,India
194637,2023-10-21,203,mango yogurt,50,60,10,1,00256,India
194637,2023-10-21,210,mountain dew,75,100,25,1,00256,India
194637,2023-10-21,213,bisleri,6,15,9,1,00256,India
575719,2023-10-21,206,yakult,360,400,40,1,00363,India
575719,2023-10-21,211,red bull,90,125,35,1,00363,India
225004,2023-10-21,211,red bull,90,125,35,1,00430,India
225004,2023-10-21,207,coca cola,75,100,25,1,00430,India
225004,2023-10-21,205,classic yogurt,45,60,15,1,00430,India
538459,2023-10-21,208,sprite,75,100,25,1,00461,India
538459,2023-10-21,205,classic yogurt,45,60,15,1,00461,India
538459,2023-10-21,211,red bull,90,125,35,1,00461,India
538459,2023-10-21,202,milk,12,27,15,1,00461,India
734139,2023-10-21,203,mango yogurt,50,60,10,1,00191,India
734139,2023-10-21,210,mountain dew,75,100,25,1,00191,India
231693,2023-10-21,208,sprite,75,100,25,1,00111,India
137229,2023-10-21,205,classic yogurt,45,60,15,1,00368,India
137229,2023-10-21,201,paneer,210,340,130,1,00368,India
389983,2023-10-21,209,pepsi,75,100,25,1,00088,India
389983,2023-10-21,213,bisleri,6,15,9,1,00088,India
389983,2023-10-21,211,red bull,90,125,35,1,00088,India
455616,2023-10-21,209,pepsi,75,100,25,1,00201,India
455616,2023-10-21,208,sprite,75,100,25,1,00201,India
455616,2023-10-21,212,amul cheese,250,315,65,1,00201,India
665019,2023-10-21,201,paneer,210,340,130,1,00030,India
665019,2023-10-21,213,bisleri,6,15,9,1,00030,India
665019,2023-10-21,202,milk,12,27,15,1,00030,India
665019,2023-10-21,203,mango yogurt,50,60,10,1,00030,India
665019,2023-10-21,209,pepsi,75,100,25,1,00030,India
912835,2023-10-21,201,paneer,210,340,130,1,00434,India
912835,2023-10-21,203,mango yogurt,50,60,10,1,00434,India
204425,2023-10-21,203,mango yogurt,50,60,10,1,00420,India
204425,2023-10-21,206,yakult,360,400,40,1,00420,India
204425,2023-10-21,212,amul cheese,250,315,65,1,00420,India
803525,2023-10-21,205,classic yogurt,45,60,15,1,00143,India
220238,2023-10-21,208,sprite,75,100,25,1,00353,India
220238,2023-10-21,209,pepsi,75,100,25,1,00353,India
147770,2023-10-21,210,mountain dew,75,100,25,1,00389,India
147770,2023-10-21,208,sprite,75,100,25,1,00389,India
147770,2023-10-21,207,coca cola,75,100,25,1,00389,India
858236,2023-10-21,201,paneer,210,340,130,1,00285,India
858236,2023-10-21,203,mango yogurt,50,60,10,1,00285,India
858236,2023-10-21,206,yakult,360,400,40,1,00285,India
795772,2023-10-21,210,mountain dew,75,100,25,1,00118,India
431240,2023-10-21,201,paneer,210,340,130,1,00287,India
431240,2023-10-21,208,sprite,75,100,25,1,00287,India
431240,2023-10-21,207,coca cola,75,100,25,1,00287,India
431240,2023-10-21,204,strawberry yogurt,50,60,10,1,00287,India
206671,2023-10-21,207,coca cola,75,100,25,1,00401,India
206671,2023-10-21,208,sprite,75,100,25,1,00401,India
206671,2023-10-21,202,milk,12,27,15,1,00401,India
206671,2023-10-21,203,mango yogurt,50,60,10,1,00401,India
947034,2023-10-21,209,pepsi,75,100,25,1,00408,India
947034,2023-10-21,204,strawberry yogurt,50,60,10,1,00408,India
947034,2023-10-21,208,sprite,75,100,25,1,00408,India
530810,2023-10-21,213,bisleri,6,15,9,1,00042,India
530810,2023-10-21,211,red bull,90,125,35,1,00042,India
530810,2023-10-21,210,mountain dew,75,100,25,1,00042,India
993787,2023-10-21,203,mango yogurt,50,60,10,1,00293,India
993787,2023-10-21,210,mountain dew,75,100,25,1,00293,India
993787,2023-10-21,212,amul cheese,250,315,65,1,00293,India
993787,2023-10-21,205,classic yogurt,45,60,15,1,00293,India
577321,2023-10-21,206,yakult,360,400,40,1,00213,India
577321,2023-10-21,209,pepsi,75,100,25,1,00213,India
460722,2023-10-21,204,strawberry yogurt,50,60,10,1,00121,India
460722,2023-10-21,209,pepsi,75,100,25,1,00121,India
460722,2023-10-21,202,milk,12,27,15,1,00121,India
460722,2023-10-21,205,classic yogurt,45,60,15,1,00121,India
460722,2023-10-21,201,paneer,210,340,130,1,00121,India
857074,2023-10-21,203,mango yogurt,50,60,10,1,00011,India
342237,2023-10-21,205,classic yogurt,45,60,15,1,00206,India
342237,2023-10-21,213,bisleri,6,15,9,1,00206,India
342237,2023-10-21,202,milk,12,27,15,1,00206,India
342237,2023-10-21,212,amul cheese,250,315,65,1,00206,India
359118,2023-10-21,208,sprite,75,100,25,1,00339,India
501908,2023-10-21,207,coca cola,75,100,25,1,00437,India
692475,2023-10-21,201,paneer,210,340,130,1,00121,India
886589,2023-10-21,206,yakult,360,400,40,1,00257,India
886589,2023-10-21,204,strawberry yogurt,50,60,10,1,00257,India
886589,2023-10-21,203,mango yogurt,50,60,10,1,00257,India
886589,2023-10-21,207,coca cola,75,100,25,1,00257,India
927632,2023-10-21,209,pepsi,75,100,25,1,00092,India
927632,2023-10-21,210,mountain dew,75,100,25,1,00092,India
454683,2023-10-21,206,yakult,360,400,40,1,00198,India
454683,2023-10-21,205,classic yogurt,45,60,15,1,00198,India
454683,2023-10-21,203,mango yogurt,50,60,10,1,00198,India
436683,2023-10-21,202,milk,12,27,15,1,00178,India
436683,2023-10-21,208,sprite,75,100,25,1,00178,India
847533,2023-10-21,202,milk,12,27,15,1,00153,India
847533,2023-10-21,213,bisleri,6,15,9,1,00153,India
874256,2023-10-21,201,paneer,210,340,130,1,00130,India
658703,2023-10-21,212,amul cheese,250,315,65,1,00439,India
658703,2023-10-21,204,strawberry yogurt,50,60,10,1,00439,India
513870,2023-10-21,210,mountain dew,75,100,25,1,00187,India
513870,2023-10-21,201,paneer,210,340,130,1,00187,India
513870,2023-10-21,203,mango yogurt,50,60,10,1,00187,India
871004,2023-10-21,211,red bull,90,125,35,1,00063,India
396491,2023-10-21,213,bisleri,6,15,9,1,00459,India
203428,2023-10-21,212,amul cheese,250,315,65,1,00243,India
203428,2023-10-21,202,milk,12,27,15,1,00243,India
484878,2023-10-22,210,mountain dew,75,100,25,1,00360,India
484878,2023-10-22,209,pepsi,75,100,25,1,00360,India
493688,2023-10-22,208,sprite,75,100,25,1,00197,India
578650,2023-10-22,210,mountain dew,75,100,25,1,00266,India
578650,2023-10-22,208,sprite,75,100,25,1,00266,India
488406,2023-10-22,209,pepsi,75,100,25,1,00012,India
488406,2023-10-22,212,amul cheese,250,315,65,1,00012,India
488016,2023-10-22,210,mountain dew,75,100,25,1,00242,India
353976,2023-10-22,211,red bull,90,125,35,1,00496,India
353976,2023-10-22,208,sprite,75,100,25,1,00496,India
353976,2023-10-22,212,amul cheese,250,315,65,1,00496,India
424151,2023-10-22,207,coca cola,75,100,25,1,00254,India
424151,2023-10-22,202,milk,12,27,15,1,00254,India
424151,2023-10-22,203,mango yogurt,50,60,10,1,00254,India
519020,2023-10-22,208,sprite,75,100,25,1,00444,India
751161,2023-10-22,204,strawberry yogurt,50,60,10,1,00088,India
751161,2023-10-22,207,coca cola,75,100,25,1,00088,India
751161,2023-10-22,213,bisleri,6,15,9,1,00088,India
751161,2023-10-22,205,classic yogurt,45,60,15,1,00088,India
751161,2023-10-22,202,milk,12,27,15,1,00088,India
853923,2023-10-22,209,pepsi,75,100,25,1,00476,India
853923,2023-10-22,202,milk,12,27,15,1,00476,India
478818,2023-10-22,202,milk,12,27,15,1,00055,India
478818,2023-10-22,210,mountain dew,75,100,25,1,00055,India
478818,2023-10-22,205,classic yogurt,45,60,15,1,00055,India
478818,2023-10-22,213,bisleri,6,15,9,1,00055,India
407977,2023-10-22,202,milk,12,27,15,1,00396,India
407977,2023-10-22,213,bisleri,6,15,9,1,00396,India
826786,2023-10-22,210,mountain dew,75,100,25,1,00408,India
861245,2023-10-22,210,mountain dew,75,100,25,1,00499,India
853530,2023-10-22,202,milk,12,27,15,1,00208,India
853530,2023-10-22,203,mango yogurt,50,60,10,1,00208,India
853530,2023-10-22,210,mountain dew,75,100,25,1,00208,India
675195,2023-10-22,206,yakult,360,400,40,1,00057,India
675195,2023-10-22,211,red bull,90,125,35,1,00057,India
675195,2023-10-22,204,strawberry yogurt,50,60,10,1,00057,India
524998,2023-10-22,208,sprite,75,100,25,1,00153,India
524998,2023-10-22,205,classic yogurt,45,60,15,1,00153,India
524998,2023-10-22,201,paneer,210,340,130,1,00153,India
524998,2023-10-22,206,yakult,360,400,40,1,00153,India
796723,2023-10-22,211,red bull,90,125,35,1,00103,India
796723,2023-10-22,204,strawberry yogurt,50,60,10,1,00103,India
670650,2023-10-22,211,red bull,90,125,35,1,00381,India
715554,2023-10-22,210,mountain dew,75,100,25,1,00278,India
715554,2023-10-22,205,classic yogurt,45,60,15,1,00278,India
943838,2023-10-22,210,mountain dew,75,100,25,1,00202,India
943838,2023-10-22,207,coca cola,75,100,25,1,00202,India
943838,2023-10-22,206,yakult,360,400,40,1,00202,India
324742,2023-10-22,207,coca cola,75,100,25,1,00214,India
226891,2023-10-22,211,red bull,90,125,35,1,00287,India
413888,2023-10-22,209,pepsi,75,100,25,1,00083,India
413888,2023-10-22,208,sprite,75,100,25,1,00083,India
562906,2023-10-22,202,milk,12,27,15,1,00247,India
111802,2023-10-22,204,strawberry yogurt,50,60,10,1,00372,India
111802,2023-10-22,208,sprite,75,100,25,1,00372,India
111802,2023-10-22,202,milk,12,27,15,1,00372,India
111802,2023-10-22,213,bisleri,6,15,9,1,00372,India
183763,2023-10-22,212,amul cheese,250,315,65,1,00405,India
183763,2023-10-22,202,milk,12,27,15,1,00405,India
183763,2023-10-22,206,yakult,360,400,40,1,00405,India
183763,2023-10-22,208,sprite,75,100,25,1,00405,India
228049,2023-10-22,208,sprite,75,100,25,1,00441,India
228049,2023-10-22,203,mango yogurt,50,60,10,1,00441,India
228049,2023-10-22,205,classic yogurt,45,60,15,1,00441,India
228049,2023-10-22,212,amul cheese,250,315,65,1,00441,India
228049,2023-10-22,204,strawberry yogurt,50,60,10,1,00441,India
659455,2023-10-22,207,coca cola,75,100,25,1,00451,India
642485,2023-10-22,207,coca cola,75,100,25,1,00058,India
642485,2023-10-22,204,strawberry yogurt,50,60,10,1,00058,India
642485,2023-10-22,208,sprite,75,100,25,1,00058,India
642485,2023-10-22,213,bisleri,6,15,9,1,00058,India
360900,2023-10-22,213,bisleri,6,15,9,1,00332,India
363856,2023-10-22,209,pepsi,75,100,25,1,00177,India
363856,2023-10-22,207,coca cola,75,100,25,1,00177,India
363856,2023-10-22,211,red bull,90,125,35,1,00177,India
662038,2023-10-22,207,coca cola,75,100,25,1,00148,India
662038,2023-10-22,203,mango yogurt,50,60,10,1,00148,India
662038,2023-10-22,213,bisleri,6,15,9,1,00148,India
177437,2023-10-22,205,classic yogurt,45,60,15,1,00240,India
177437,2023-10-22,210,mountain dew,75,100,25,1,00240,India
177437,2023-10-22,208,sprite,75,100,25,1,00240,India
177437,2023-10-22,206,yakult,360,400,40,1,00240,India
177437,2023-10-22,201,paneer,210,340,130,1,00240,India
647477,2023-10-22,203,mango yogurt,50,60,10,1,00036,India
647477,2023-10-22,209,pepsi,75,100,25,1,00036,India
213568,2023-10-22,207,coca cola,75,100,25,1,00357,India
993686,2023-10-22,210,mountain dew,75,100,25,1,00382,India
993686,2023-10-22,211,red bull,90,125,35,1,00382,India
993686,2023-10-22,205,classic yogurt,45,60,15,1,00382,India
786169,2023-10-22,201,paneer,210,340,130,1,00097,India
786169,2023-10-22,203,mango yogurt,50,60,10,1,00097,India
786169,2023-10-22,210,mountain dew,75,100,25,1,00097,India
341755,2023-10-22,203,mango yogurt,50,60,10,1,00448,India
383281,2023-10-22,213,bisleri,6,15,9,1,00132,India
383281,2023-10-22,207,coca cola,75,100,25,1,00132,India
694717,2023-10-22,210,mountain dew,75,100,25,1,00327,India
694717,2023-10-22,201,paneer,210,340,130,1,00327,India
806644,2023-10-22,207,coca cola,75,100,25,1,00141,India
806644,2023-10-22,210,mountain dew,75,100,25,1,00141,India
806644,2023-10-22,204,strawberry yogurt,50,60,10,1,00141,India
451993,2023-10-22,206,yakult,360,400,40,1,00191,India
451993,2023-10-22,201,paneer,210,340,130,1,00191,India
451993,2023-10-22,202,milk,12,27,15,1,00191,India
387114,2023-10-22,206,yakult,360,400,40,1,00441,India
468575,2023-10-22,205,classic yogurt,45,60,15,1,00121,India
468575,2023-10-22,212,amul cheese,250,315,65,1,00121,India
468575,2023-10-22,208,sprite,75,100,25,1,00121,India
468575,2023-10-22,201,paneer,210,340,130,1,00121,India
468575,2023-10-22,204,strawberry yogurt,50,60,10,1,00121,India
768976,2023-10-22,211,red bull,90,125,35,1,00431,India
768976,2023-10-22,205,classic yogurt,45,60,15,1,00431,India
629780,2023-10-22,209,pepsi,75,100,25,1,00315,India
629780,2023-10-22,201,paneer,210,340,130,1,00315,India
629780,2023-10-22,210,mountain dew,75,100,25,1,00315,India
517092,2023-10-22,203,mango yogurt,50,60,10,1,00244,India
517092,2023-10-22,211,red bull,90,125,35,1,00244,India
517092,2023-10-22,204,strawberry yogurt,50,60,10,1,00244,India
517092,2023-10-22,209,pepsi,75,100,25,1,00244,India
336583,2023-10-22,205,classic yogurt,45,60,15,1,00154,India
336583,2023-10-22,209,pepsi,75,100,25,1,00154,India
336583,2023-10-22,201,paneer,210,340,130,1,00154,India
336583,2023-10-22,207,coca cola,75,100,25,1,00154,India
829910,2023-10-22,203,mango yogurt,50,60,10,1,00218,India
829910,2023-10-22,201,paneer,210,340,130,1,00218,India
829910,2023-10-22,202,milk,12,27,15,1,00218,India
944295,2023-10-22,205,classic yogurt,45,60,15,1,00385,India
667511,2023-10-22,201,paneer,210,340,130,1,00364,India
667511,2023-10-22,203,mango yogurt,50,60,10,1,00364,India
667511,2023-10-22,208,sprite,75,100,25,1,00364,India
667511,2023-10-22,206,yakult,360,400,40,1,00364,India
888287,2023-10-22,208,sprite,75,100,25,1,00255,India
888287,2023-10-22,207,coca cola,75,100,25,1,00255,India
888287,2023-10-22,211,red bull,90,125,35,1,00255,India
888287,2023-10-22,201,paneer,210,340,130,1,00255,India
770623,2023-10-22,207,coca cola,75,100,25,1,00167,India
770623,2023-10-22,201,paneer,210,340,130,1,00167,India
302712,2023-10-22,212,amul cheese,250,315,65,1,00443,India
302712,2023-10-22,205,classic yogurt,45,60,15,1,00443,India
302712,2023-10-22,210,mountain dew,75,100,25,1,00443,India
162523,2023-10-22,208,sprite,75,100,25,1,00201,India
162523,2023-10-22,211,red bull,90,125,35,1,00201,India
853645,2023-10-22,204,strawberry yogurt,50,60,10,1,00089,India
567959,2023-10-22,208,sprite,75,100,25,1,00238,India
567959,2023-10-22,211,red bull,90,125,35,1,00238,India
567959,2023-10-22,206,yakult,360,400,40,1,00238,India
468390,2023-10-22,213,bisleri,6,15,9,1,00345,India
989231,2023-10-22,206,yakult,360,400,40,1,00177,India
989231,2023-10-22,205,classic yogurt,45,60,15,1,00177,India
989231,2023-10-22,212,amul cheese,250,315,65,1,00177,India
989231,2023-10-22,209,pepsi,75,100,25,1,00177,India
291020,2023-10-22,201,paneer,210,340,130,1,00235,India
291020,2023-10-22,212,amul cheese,250,315,65,1,00235,India
291020,2023-10-22,213,bisleri,6,15,9,1,00235,India
210583,2023-10-22,206,yakult,360,400,40,1,00289,India
210583,2023-10-22,207,coca cola,75,100,25,1,00289,India
210583,2023-10-22,210,mountain dew,75,100,25,1,00289,India
210583,2023-10-22,208,sprite,75,100,25,1,00289,India
525326,2023-10-22,213,bisleri,6,15,9,1,00079,India
525326,2023-10-22,209,pepsi,75,100,25,1,00079,India
525326,2023-10-22,210,mountain dew,75,100,25,1,00079,India
525326,2023-10-22,205,classic yogurt,45,60,15,1,00079,India
851818,2023-10-22,207,coca cola,75,100,25,1,00082,India
851818,2023-10-22,209,pepsi,75,100,25,1,00082,India
659390,2023-10-22,201,paneer,210,340,130,1,00434,India
659390,2023-10-22,207,coca cola,75,100,25,1,00434,India
659390,2023-10-22,206,yakult,360,400,40,1,00434,India
438585,2023-10-22,209,pepsi,75,100,25,1,00183,India
184678,2023-10-22,205,classic yogurt,45,60,15,1,00357,India
426151,2023-10-22,207,coca cola,75,100,25,1,00392,India
426151,2023-10-22,204,strawberry yogurt,50,60,10,1,00392,India
426151,2023-10-22,211,red bull,90,125,35,1,00392,India
510633,2023-10-22,213,bisleri,6,15,9,1,00362,India
510633,2023-10-22,209,pepsi,75,100,25,1,00362,India
510633,2023-10-22,212,amul cheese,250,315,65,1,00362,India
510633,2023-10-22,205,classic yogurt,45,60,15,1,00362,India
889850,2023-10-22,209,pepsi,75,100,25,1,00407,India
889850,2023-10-22,207,coca cola,75,100,25,1,00407,India
226598,2023-10-22,202,milk,12,27,15,1,00035,India
226598,2023-10-22,208,sprite,75,100,25,1,00035,India
226598,2023-10-22,206,yakult,360,400,40,1,00035,India
791226,2023-10-22,212,amul cheese,250,315,65,1,00125,India
791226,2023-10-22,201,paneer,210,340,130,1,00125,India
791226,2023-10-22,208,sprite,75,100,25,1,00125,India
949825,2023-10-22,202,milk,12,27,15,1,00403,India
949825,2023-10-22,204,strawberry yogurt,50,60,10,1,00403,India
265355,2023-10-22,210,mountain dew,75,100,25,1,00225,India
265355,2023-10-22,213,bisleri,6,15,9,1,00225,India
791013,2023-10-22,212,amul cheese,250,315,65,1,00342,India
791013,2023-10-22,211,red bull,90,125,35,1,00342,India
791013,2023-10-22,210,mountain dew,75,100,25,1,00342,India
973968,2023-10-22,208,sprite,75,100,25,1,00108,India
973968,2023-10-22,201,paneer,210,340,130,1,00108,India
973968,2023-10-22,209,pepsi,75,100,25,1,00108,India
457443,2023-10-22,201,paneer,210,340,130,1,00268,India
457443,2023-10-22,210,mountain dew,75,100,25,1,00268,India
643026,2023-10-22,203,mango yogurt,50,60,10,1,00342,India
643026,2023-10-22,208,sprite,75,100,25,1,00342,India
643026,2023-10-22,206,yakult,360,400,40,1,00342,India
643026,2023-10-22,213,bisleri,6,15,9,1,00342,India
643026,2023-10-22,212,amul cheese,250,315,65,1,00342,India
176721,2023-10-22,203,mango yogurt,50,60,10,1,00150,India
176721,2023-10-22,202,milk,12,27,15,1,00150,India
619200,2023-10-22,207,coca cola,75,100,25,1,00467,India
619200,2023-10-22,204,strawberry yogurt,50,60,10,1,00467,India
619200,2023-10-22,206,yakult,360,400,40,1,00467,India
763407,2023-10-22,210,mountain dew,75,100,25,1,00267,India
763407,2023-10-22,212,amul cheese,250,315,65,1,00267,India
763407,2023-10-22,203,mango yogurt,50,60,10,1,00267,India
200646,2023-10-22,207,coca cola,75,100,25,1,00418,India
200646,2023-10-22,209,pepsi,75,100,25,1,00418,India
200646,2023-10-22,212,amul cheese,250,315,65,1,00418,India
200646,2023-10-22,203,mango yogurt,50,60,10,1,00418,India
580361,2023-10-22,209,pepsi,75,100,25,1,00255,India
580361,2023-10-22,203,mango yogurt,50,60,10,1,00255,India
580361,2023-10-22,208,sprite,75,100,25,1,00255,India
299838,2023-10-22,207,coca cola,75,100,25,1,00227,India
299838,2023-10-22,205,classic yogurt,45,60,15,1,00227,India
299838,2023-10-22,211,red bull,90,125,35,1,00227,India
299838,2023-10-22,201,paneer,210,340,130,1,00227,India
299838,2023-10-22,212,amul cheese,250,315,65,1,00227,India
187958,2023-10-22,208,sprite,75,100,25,1,00035,India
187958,2023-10-22,209,pepsi,75,100,25,1,00035,India
235840,2023-10-22,207,coca cola,75,100,25,1,00135,India
235840,2023-10-22,205,classic yogurt,45,60,15,1,00135,India
442222,2023-10-22,202,milk,12,27,15,1,00453,India
442222,2023-10-22,211,red bull,90,125,35,1,00453,India
442222,2023-10-22,207,coca cola,75,100,25,1,00453,India
658980,2023-10-23,212,amul cheese,250,315,65,1,00072,India
658980,2023-10-23,205,classic yogurt,45,60,15,1,00072,India
979274,2023-10-23,204,strawberry yogurt,50,60,10,1,00441,India
364555,2023-10-23,201,paneer,210,340,130,1,00344,India
364555,2023-10-23,205,classic yogurt,45,60,15,1,00344,India
272722,2023-10-23,207,coca cola,75,100,25,1,00376,India
272722,2023-10-23,204,strawberry yogurt,50,60,10,1,00376,India
272722,2023-10-23,201,paneer,210,340,130,1,00376,India
272722,2023-10-23,212,amul cheese,250,315,65,1,00376,India
810664,2023-10-23,205,classic yogurt,45,60,15,1,00298,India
810664,2023-10-23,211,red bull,90,125,35,1,00298,India
810664,2023-10-23,208,sprite,75,100,25,1,00298,India
810664,2023-10-23,204,strawberry yogurt,50,60,10,1,00298,India
375847,2023-10-23,212,amul cheese,250,315,65,1,00491,India
375847,2023-10-23,209,pepsi,75,100,25,1,00491,India
375847,2023-10-23,211,red bull,90,125,35,1,00491,India
544674,2023-10-23,202,milk,12,27,15,1,00404,India
544674,2023-10-23,201,paneer,210,340,130,1,00404,India
544674,2023-10-23,207,coca cola,75,100,25,1,00404,India
933147,2023-10-23,211,red bull,90,125,35,1,00133,India
933147,2023-10-23,203,mango yogurt,50,60,10,1,00133,India
933147,2023-10-23,212,amul cheese,250,315,65,1,00133,India
184048,2023-10-23,205,classic yogurt,45,60,15,1,00069,India
184048,2023-10-23,206,yakult,360,400,40,1,00069,India
546691,2023-10-23,202,milk,12,27,15,1,00205,India
546691,2023-10-23,204,strawberry yogurt,50,60,10,1,00205,India
984732,2023-10-23,212,amul cheese,250,315,65,1,00169,India
984732,2023-10-23,205,classic yogurt,45,60,15,1,00169,India
984732,2023-10-23,209,pepsi,75,100,25,1,00169,India
270903,2023-10-23,210,mountain dew,75,100,25,1,00059,India
270903,2023-10-23,206,yakult,360,400,40,1,00059,India
222346,2023-10-23,202,milk,12,27,15,1,00172,India
620619,2023-10-23,213,bisleri,6,15,9,1,00076,India
620619,2023-10-23,210,mountain dew,75,100,25,1,00076,India
620619,2023-10-23,204,strawberry yogurt,50,60,10,1,00076,India
620619,2023-10-23,212,amul cheese,250,315,65,1,00076,India
192041,2023-10-23,203,mango yogurt,50,60,10,1,00320,India
192041,2023-10-23,213,bisleri,6,15,9,1,00320,India
492093,2023-10-23,201,paneer,210,340,130,1,00126,India
492093,2023-10-23,208,sprite,75,100,25,1,00126,India
492093,2023-10-23,207,coca cola,75,100,25,1,00126,India
884134,2023-10-23,206,yakult,360,400,40,1,00093,India
884134,2023-10-23,204,strawberry yogurt,50,60,10,1,00093,India
884134,2023-10-23,207,coca cola,75,100,25,1,00093,India
884134,2023-10-23,212,amul cheese,250,315,65,1,00093,India
481091,2023-10-23,213,bisleri,6,15,9,1,00004,India
481091,2023-10-23,208,sprite,75,100,25,1,00004,India
481091,2023-10-23,205,classic yogurt,45,60,15,1,00004,India
971473,2023-10-23,204,strawberry yogurt,50,60,10,1,00485,India
971473,2023-10-23,210,mountain dew,75,100,25,1,00485,India
971473,2023-10-23,207,coca cola,75,100,25,1,00485,India
971473,2023-10-23,211,red bull,90,125,35,1,00485,India
469409,2023-10-23,202,milk,12,27,15,1,00383,India
469409,2023-10-23,206,yakult,360,400,40,1,00383,India
469409,2023-10-23,207,coca cola,75,100,25,1,00383,India
217838,2023-10-23,211,red bull,90,125,35,1,00295,India
217838,2023-10-23,207,coca cola,75,100,25,1,00295,India
217838,2023-10-23,203,mango yogurt,50,60,10,1,00295,India
217838,2023-10-23,209,pepsi,75,100,25,1,00295,India
825102,2023-10-23,208,sprite,75,100,25,1,00132,India
825102,2023-10-23,210,mountain dew,75,100,25,1,00132,India
825102,2023-10-23,207,coca cola,75,100,25,1,00132,India
501908,2023-10-23,209,pepsi,75,100,25,1,00437,India
501908,2023-10-23,211,red bull,90,125,35,1,00437,India
501908,2023-10-23,213,bisleri,6,15,9,1,00437,India
566474,2023-10-23,210,mountain dew,75,100,25,1,00171,India
566474,2023-10-23,212,amul cheese,250,315,65,1,00171,India
566474,2023-10-23,208,sprite,75,100,25,1,00171,India
230552,2023-10-23,210,mountain dew,75,100,25,1,00492,India
230552,2023-10-23,202,milk,12,27,15,1,00492,India
230552,2023-10-23,208,sprite,75,100,25,1,00492,India
301962,2023-10-23,203,mango yogurt,50,60,10,1,00078,India
301962,2023-10-23,205,classic yogurt,45,60,15,1,00078,India
301962,2023-10-23,202,milk,12,27,15,1,00078,India
301962,2023-10-23,211,red bull,90,125,35,1,00078,India
825110,2023-10-23,211,red bull,90,125,35,1,00469,India
825110,2023-10-23,206,yakult,360,400,40,1,00469,India
825110,2023-10-23,213,bisleri,6,15,9,1,00469,India
825110,2023-10-23,208,sprite,75,100,25,1,00469,India
295301,2023-10-23,205,classic yogurt,45,60,15,1,00047,India
295301,2023-10-23,203,mango yogurt,50,60,10,1,00047,India
295301,2023-10-23,212,amul cheese,250,315,65,1,00047,India
295301,2023-10-23,210,mountain dew,75,100,25,1,00047,India
771701,2023-10-23,209,pepsi,75,100,25,1,00181,India
906345,2023-10-23,211,red bull,90,125,35,1,00013,India
906345,2023-10-23,213,bisleri,6,15,9,1,00013,India
643600,2023-10-23,207,coca cola,75,100,25,1,00118,India
425796,2023-10-23,203,mango yogurt,50,60,10,1,00409,India
425796,2023-10-23,201,paneer,210,340,130,1,00409,India
425796,2023-10-23,212,amul cheese,250,315,65,1,00409,India
161175,2023-10-23,207,coca cola,75,100,25,1,00498,India
161175,2023-10-23,213,bisleri,6,15,9,1,00498,India
161175,2023-10-23,212,amul cheese,250,315,65,1,00498,India
579289,2023-10-23,208,sprite,75,100,25,1,00192,India
579289,2023-10-23,201,paneer,210,340,130,1,00192,India
579289,2023-10-23,213,bisleri,6,15,9,1,00192,India
579289,2023-10-23,212,amul cheese,250,315,65,1,00192,India
579289,2023-10-23,210,mountain dew,75,100,25,1,00192,India
172980,2023-10-23,211,red bull,90,125,35,1,00466,India
615343,2023-10-23,212,amul cheese,250,315,65,1,00008,India
615343,2023-10-23,205,classic yogurt,45,60,15,1,00008,India
615343,2023-10-23,211,red bull,90,125,35,1,00008,India
615343,2023-10-23,204,strawberry yogurt,50,60,10,1,00008,India
619068,2023-10-23,207,coca cola,75,100,25,1,00111,India
619068,2023-10-23,209,pepsi,75,100,25,1,00111,India
619068,2023-10-23,212,amul cheese,250,315,65,1,00111,India
619068,2023-10-23,208,sprite,75,100,25,1,00111,India
182261,2023-10-23,205,classic yogurt,45,60,15,1,00435,India
182261,2023-10-23,202,milk,12,27,15,1,00435,India
182261,2023-10-23,207,coca cola,75,100,25,1,00435,India
549489,2023-10-23,205,classic yogurt,45,60,15,1,00151,India
549489,2023-10-23,213,bisleri,6,15,9,1,00151,India
549489,2023-10-23,208,sprite,75,100,25,1,00151,India
549489,2023-10-23,211,red bull,90,125,35,1,00151,India
549489,2023-10-23,202,milk,12,27,15,1,00151,India
767797,2023-10-23,203,mango yogurt,50,60,10,1,00469,India
767797,2023-10-23,201,paneer,210,340,130,1,00469,India
767797,2023-10-23,213,bisleri,6,15,9,1,00469,India
767797,2023-10-23,208,sprite,75,100,25,1,00469,India
896648,2023-10-23,202,milk,12,27,15,1,00044,India
896648,2023-10-23,205,classic yogurt,45,60,15,1,00044,India
390239,2023-10-23,207,coca cola,75,100,25,1,00159,India
505283,2023-10-23,211,red bull,90,125,35,1,00294,India
505283,2023-10-23,208,sprite,75,100,25,1,00294,India
505283,2023-10-23,213,bisleri,6,15,9,1,00294,India
505283,2023-10-23,209,pepsi,75,100,25,1,00294,India
657690,2023-10-23,204,strawberry yogurt,50,60,10,1,00258,India
657690,2023-10-23,208,sprite,75,100,25,1,00258,India
879489,2023-10-23,203,mango yogurt,50,60,10,1,00392,India
879489,2023-10-23,206,yakult,360,400,40,1,00392,India
879489,2023-10-23,212,amul cheese,250,315,65,1,00392,India
783522,2023-10-23,209,pepsi,75,100,25,1,00443,India
783522,2023-10-23,202,milk,12,27,15,1,00443,India
582255,2023-10-23,205,classic yogurt,45,60,15,1,00225,India
582255,2023-10-23,208,sprite,75,100,25,1,00225,India
274020,2023-10-23,209,pepsi,75,100,25,1,00071,India
151256,2023-10-23,206,yakult,360,400,40,1,00417,India
151256,2023-10-23,211,red bull,90,125,35,1,00417,India
570795,2023-10-23,202,milk,12,27,15,1,00326,India
570795,2023-10-23,205,classic yogurt,45,60,15,1,00326,India
570795,2023-10-23,208,sprite,75,100,25,1,00326,India
570795,2023-10-23,211,red bull,90,125,35,1,00326,India
427978,2023-10-23,202,milk,12,27,15,1,00376,India
427978,2023-10-23,212,amul cheese,250,315,65,1,00376,India
427978,2023-10-23,209,pepsi,75,100,25,1,00376,India
609036,2023-10-23,208,sprite,75,100,25,1,00256,India
609036,2023-10-23,204,strawberry yogurt,50,60,10,1,00256,India
609036,2023-10-23,207,coca cola,75,100,25,1,00256,India
609036,2023-10-23,213,bisleri,6,15,9,1,00256,India
675524,2023-10-23,207,coca cola,75,100,25,1,00448,India
675524,2023-10-23,202,milk,12,27,15,1,00448,India
675524,2023-10-23,208,sprite,75,100,25,1,00448,India
904028,2023-10-23,209,pepsi,75,100,25,1,00101,India
904028,2023-10-23,204,strawberry yogurt,50,60,10,1,00101,India
904028,2023-10-23,212,amul cheese,250,315,65,1,00101,India
904028,2023-10-23,205,classic yogurt,45,60,15,1,00101,India
260598,2023-10-23,201,paneer,210,340,130,1,00259,India
260598,2023-10-23,202,milk,12,27,15,1,00259,India
567721,2023-10-23,206,yakult,360,400,40,1,00192,India
567721,2023-10-23,204,strawberry yogurt,50,60,10,1,00192,India
567721,2023-10-23,202,milk,12,27,15,1,00192,India
958907,2023-10-23,201,paneer,210,340,130,1,00205,India
958907,2023-10-23,211,red bull,90,125,35,1,00205,India
958907,2023-10-23,207,coca cola,75,100,25,1,00205,India
958907,2023-10-23,206,yakult,360,400,40,1,00205,India
299646,2023-10-23,209,pepsi,75,100,25,1,00059,India
299646,2023-10-23,203,mango yogurt,50,60,10,1,00059,India
299646,2023-10-23,205,classic yogurt,45,60,15,1,00059,India
660816,2023-10-23,202,milk,12,27,15,1,00451,India
660816,2023-10-23,213,bisleri,6,15,9,1,00451,India
652665,2023-10-23,208,sprite,75,100,25,1,00177,India
851318,2023-10-23,201,paneer,210,340,130,1,00388,India
851318,2023-10-23,204,strawberry yogurt,50,60,10,1,00388,India
851318,2023-10-23,210,mountain dew,75,100,25,1,00388,India
147199,2023-10-23,201,paneer,210,340,130,1,00185,India
147199,2023-10-23,205,classic yogurt,45,60,15,1,00185,India
147199,2023-10-23,211,red bull,90,125,35,1,00185,India
147199,2023-10-23,209,pepsi,75,100,25,1,00185,India
147199,2023-10-23,210,mountain dew,75,100,25,1,00185,India
639525,2023-10-23,212,amul cheese,250,315,65,1,00247,India
639525,2023-10-23,205,classic yogurt,45,60,15,1,00247,India
639525,2023-10-23,206,yakult,360,400,40,1,00247,India
639525,2023-10-23,204,strawberry yogurt,50,60,10,1,00247,India
639525,2023-10-23,203,mango yogurt,50,60,10,1,00247,India
858334,2023-10-23,203,mango yogurt,50,60,10,1,00316,India
690400,2023-10-23,210,mountain dew,75,100,25,1,00480,India
690400,2023-10-23,208,sprite,75,100,25,1,00480,India
998241,2023-10-24,207,coca cola,75,100,25,1,00075,India
230348,2023-10-24,211,red bull,90,125,35,1,00363,India
230348,2023-10-24,208,sprite,75,100,25,1,00363,India
230348,2023-10-24,204,strawberry yogurt,50,60,10,1,00363,India
230348,2023-10-24,201,paneer,210,340,130,1,00363,India
571926,2023-10-24,208,sprite,75,100,25,1,00029,India
571926,2023-10-24,212,amul cheese,250,315,65,1,00029,India
571926,2023-10-24,211,red bull,90,125,35,1,00029,India
843469,2023-10-24,207,coca cola,75,100,25,1,00108,India
843469,2023-10-24,213,bisleri,6,15,9,1,00108,India
843469,2023-10-24,206,yakult,360,400,40,1,00108,India
843469,2023-10-24,209,pepsi,75,100,25,1,00108,India
792455,2023-10-24,203,mango yogurt,50,60,10,1,00188,India
710164,2023-10-24,207,coca cola,75,100,25,1,00015,India
710164,2023-10-24,206,yakult,360,400,40,1,00015,India
710164,2023-10-24,203,mango yogurt,50,60,10,1,00015,India
710164,2023-10-24,212,amul cheese,250,315,65,1,00015,India
710164,2023-10-24,205,classic yogurt,45,60,15,1,00015,India
238397,2023-10-24,204,strawberry yogurt,50,60,10,1,00362,India
528511,2023-10-24,213,bisleri,6,15,9,1,00193,India
528511,2023-10-24,208,sprite,75,100,25,1,00193,India
934041,2023-10-24,202,milk,12,27,15,1,00352,India
934041,2023-10-24,210,mountain dew,75,100,25,1,00352,India
934041,2023-10-24,207,coca cola,75,100,25,1,00352,India
266166,2023-10-24,210,mountain dew,75,100,25,1,00487,India
618783,2023-10-24,203,mango yogurt,50,60,10,1,00217,India
618783,2023-10-24,202,milk,12,27,15,1,00217,India
618783,2023-10-24,201,paneer,210,340,130,1,00217,India
873941,2023-10-24,204,strawberry yogurt,50,60,10,1,00480,India
873941,2023-10-24,213,bisleri,6,15,9,1,00480,India
873941,2023-10-24,212,amul cheese,250,315,65,1,00480,India
873941,2023-10-24,201,paneer,210,340,130,1,00480,India
119259,2023-10-24,201,paneer,210,340,130,1,00253,India
119259,2023-10-24,213,bisleri,6,15,9,1,00253,India
882304,2023-10-24,211,red bull,90,125,35,1,00302,India
159687,2023-10-24,210,mountain dew,75,100,25,1,00024,India
159687,2023-10-24,205,classic yogurt,45,60,15,1,00024,India
770100,2023-10-24,208,sprite,75,100,25,1,00245,India
770100,2023-10-24,203,mango yogurt,50,60,10,1,00245,India
770100,2023-10-24,210,mountain dew,75,100,25,1,00245,India
890722,2023-10-24,208,sprite,75,100,25,1,00210,India
415122,2023-10-24,209,pepsi,75,100,25,1,00333,India
415122,2023-10-24,205,classic yogurt,45,60,15,1,00333,India
415122,2023-10-24,203,mango yogurt,50,60,10,1,00333,India
415122,2023-10-24,207,coca cola,75,100,25,1,00333,India
102789,2023-10-24,204,strawberry yogurt,50,60,10,1,00301,India
458288,2023-10-24,204,strawberry yogurt,50,60,10,1,00410,India
458288,2023-10-24,208,sprite,75,100,25,1,00410,India
269678,2023-10-24,207,coca cola,75,100,25,1,00044,India
269678,2023-10-24,201,paneer,210,340,130,1,00044,India
269678,2023-10-24,204,strawberry yogurt,50,60,10,1,00044,India
228118,2023-10-24,205,classic yogurt,45,60,15,1,00146,India
228118,2023-10-24,206,yakult,360,400,40,1,00146,India
228118,2023-10-24,207,coca cola,75,100,25,1,00146,India
533525,2023-10-24,212,amul cheese,250,315,65,1,00401,India
533525,2023-10-24,213,bisleri,6,15,9,1,00401,India
533525,2023-10-24,208,sprite,75,100,25,1,00401,India
646825,2023-10-24,210,mountain dew,75,100,25,1,00400,India
390094,2023-10-24,207,coca cola,75,100,25,1,00216,India
390094,2023-10-24,203,mango yogurt,50,60,10,1,00216,India
390094,2023-10-24,202,milk,12,27,15,1,00216,India
550974,2023-10-24,206,yakult,360,400,40,1,00168,India
550974,2023-10-24,202,milk,12,27,15,1,00168,India
550974,2023-10-24,213,bisleri,6,15,9,1,00168,India
825329,2023-10-24,213,bisleri,6,15,9,1,00130,India
825329,2023-10-24,211,red bull,90,125,35,1,00130,India
221587,2023-10-24,206,yakult,360,400,40,1,00282,India
221587,2023-10-24,210,mountain dew,75,100,25,1,00282,India
652078,2023-10-24,204,strawberry yogurt,50,60,10,1,00287,India
902525,2023-10-24,210,mountain dew,75,100,25,1,00181,India
902525,2023-10-24,204,strawberry yogurt,50,60,10,1,00181,India
902525,2023-10-24,209,pepsi,75,100,25,1,00181,India
902525,2023-10-24,211,red bull,90,125,35,1,00181,India
571476,2023-10-24,206,yakult,360,400,40,1,00090,India
571476,2023-10-24,212,amul cheese,250,315,65,1,00090,India
571476,2023-10-24,203,mango yogurt,50,60,10,1,00090,India
571476,2023-10-24,207,coca cola,75,100,25,1,00090,India
702296,2023-10-24,208,sprite,75,100,25,1,00211,India
702296,2023-10-24,205,classic yogurt,45,60,15,1,00211,India
702296,2023-10-24,206,yakult,360,400,40,1,00211,India
881157,2023-10-24,202,milk,12,27,15,1,00382,India
366263,2023-10-24,212,amul cheese,250,315,65,1,00257,India
366263,2023-10-24,209,pepsi,75,100,25,1,00257,India
366263,2023-10-24,213,bisleri,6,15,9,1,00257,India
366263,2023-10-24,207,coca cola,75,100,25,1,00257,India
366263,2023-10-24,204,strawberry yogurt,50,60,10,1,00257,India
481701,2023-10-24,213,bisleri,6,15,9,1,00219,India
559179,2023-10-24,202,milk,12,27,15,1,00374,India
784672,2023-10-24,203,mango yogurt,50,60,10,1,00063,India
784672,2023-10-24,213,bisleri,6,15,9,1,00063,India
784672,2023-10-24,207,coca cola,75,100,25,1,00063,India
784672,2023-10-24,210,mountain dew,75,100,25,1,00063,India
577774,2023-10-24,212,amul cheese,250,315,65,1,00362,India
577774,2023-10-24,213,bisleri,6,15,9,1,00362,India
593089,2023-10-24,212,amul cheese,250,315,65,1,00038,India
593089,2023-10-24,202,milk,12,27,15,1,00038,India
593089,2023-10-24,208,sprite,75,100,25,1,00038,India
175510,2023-10-24,210,mountain dew,75,100,25,1,00037,India
175510,2023-10-24,205,classic yogurt,45,60,15,1,00037,India
175510,2023-10-24,211,red bull,90,125,35,1,00037,India
498647,2023-10-24,203,mango yogurt,50,60,10,1,00273,India
498647,2023-10-24,206,yakult,360,400,40,1,00273,India
498647,2023-10-24,207,coca cola,75,100,25,1,00273,India
453282,2023-10-24,212,amul cheese,250,315,65,1,00158,India
453282,2023-10-24,201,paneer,210,340,130,1,00158,India
303084,2023-10-24,207,coca cola,75,100,25,1,00283,India
303084,2023-10-24,203,mango yogurt,50,60,10,1,00283,India
932985,2023-10-24,211,red bull,90,125,35,1,00045,India
932985,2023-10-24,210,mountain dew,75,100,25,1,00045,India
474808,2023-10-24,203,mango yogurt,50,60,10,1,00190,India
474808,2023-10-24,206,yakult,360,400,40,1,00190,India
474808,2023-10-24,210,mountain dew,75,100,25,1,00190,India
474808,2023-10-24,207,coca cola,75,100,25,1,00190,India
620694,2023-10-24,202,milk,12,27,15,1,00338,India
620694,2023-10-24,208,sprite,75,100,25,1,00338,India
620694,2023-10-24,212,amul cheese,250,315,65,1,00338,India
620694,2023-10-24,213,bisleri,6,15,9,1,00338,India
381046,2023-10-24,210,mountain dew,75,100,25,1,00374,India
381046,2023-10-24,203,mango yogurt,50,60,10,1,00374,India
381046,2023-10-24,201,paneer,210,340,130,1,00374,India
381046,2023-10-24,207,coca cola,75,100,25,1,00374,India
626858,2023-10-24,206,yakult,360,400,40,1,00158,India
920895,2023-10-24,201,paneer,210,340,130,1,00294,India
920895,2023-10-24,204,strawberry yogurt,50,60,10,1,00294,India
295540,2023-10-24,208,sprite,75,100,25,1,00299,India
618142,2023-10-24,211,red bull,90,125,35,1,00315,India
618142,2023-10-24,212,amul cheese,250,315,65,1,00315,India
618142,2023-10-24,209,pepsi,75,100,25,1,00315,India
618142,2023-10-24,206,yakult,360,400,40,1,00315,India
618142,2023-10-24,208,sprite,75,100,25,1,00315,India
944123,2023-10-24,213,bisleri,6,15,9,1,00209,India
944123,2023-10-24,208,sprite,75,100,25,1,00209,India
944123,2023-10-24,209,pepsi,75,100,25,1,00209,India
751597,2023-10-24,207,coca cola,75,100,25,1,00049,India
751597,2023-10-24,204,strawberry yogurt,50,60,10,1,00049,India
751597,2023-10-24,210,mountain dew,75,100,25,1,00049,India
751597,2023-10-24,206,yakult,360,400,40,1,00049,India
282904,2023-10-24,209,pepsi,75,100,25,1,00227,India
282904,2023-10-24,201,paneer,210,340,130,1,00227,India
481788,2023-10-24,212,amul cheese,250,315,65,1,00071,India
481788,2023-10-24,211,red bull,90,125,35,1,00071,India
481788,2023-10-24,205,classic yogurt,45,60,15,1,00071,India
899411,2023-10-24,201,paneer,210,340,130,1,00432,India
716766,2023-10-24,212,amul cheese,250,315,65,1,00297,India
716766,2023-10-24,206,yakult,360,400,40,1,00297,India
870584,2023-10-24,212,amul cheese,250,315,65,1,00273,India
870584,2023-10-24,203,mango yogurt,50,60,10,1,00273,India
870584,2023-10-24,204,strawberry yogurt,50,60,10,1,00273,India
870584,2023-10-24,206,yakult,360,400,40,1,00273,India
504427,2023-10-24,205,classic yogurt,45,60,15,1,00423,India
504427,2023-10-24,204,strawberry yogurt,50,60,10,1,00423,India
504427,2023-10-24,202,milk,12,27,15,1,00423,India
753947,2023-10-24,203,mango yogurt,50,60,10,1,00252,India
753947,2023-10-24,207,coca cola,75,100,25,1,00252,India
753947,2023-10-24,211,red bull,90,125,35,1,00252,India
753947,2023-10-24,212,amul cheese,250,315,65,1,00252,India
285579,2023-10-24,212,amul cheese,250,315,65,1,00160,India
285579,2023-10-24,208,sprite,75,100,25,1,00160,India
137788,2023-10-24,204,strawberry yogurt,50,60,10,1,00060,India
137788,2023-10-24,201,paneer,210,340,130,1,00060,India
137788,2023-10-24,211,red bull,90,125,35,1,00060,India
356198,2023-10-24,213,bisleri,6,15,9,1,00365,India
356198,2023-10-24,206,yakult,360,400,40,1,00365,India
356198,2023-10-24,212,amul cheese,250,315,65,1,00365,India
860360,2023-10-24,208,sprite,75,100,25,1,00211,India
860360,2023-10-24,213,bisleri,6,15,9,1,00211,India
860360,2023-10-24,201,paneer,210,340,130,1,00211,India
935711,2023-10-24,209,pepsi,75,100,25,1,00020,India
935711,2023-10-24,205,classic yogurt,45,60,15,1,00020,India
725491,2023-10-24,201,paneer,210,340,130,1,00001,India
725491,2023-10-24,208,sprite,75,100,25,1,00001,India
725491,2023-10-24,206,yakult,360,400,40,1,00001,India
725491,2023-10-24,212,amul cheese,250,315,65,1,00001,India
872709,2023-10-24,208,sprite,75,100,25,1,00285,India
872709,2023-10-24,202,milk,12,27,15,1,00285,India
872709,2023-10-24,213,bisleri,6,15,9,1,00285,India
958364,2023-10-24,210,mountain dew,75,100,25,1,00356,India
958364,2023-10-24,213,bisleri,6,15,9,1,00356,India
958364,2023-10-24,206,yakult,360,400,40,1,00356,India
351096,2023-10-24,209,pepsi,75,100,25,1,00483,India
580617,2023-10-24,210,mountain dew,75,100,25,1,00330,India
580617,2023-10-24,206,yakult,360,400,40,1,00330,India
580617,2023-10-24,208,sprite,75,100,25,1,00330,India
361877,2023-10-24,203,mango yogurt,50,60,10,1,00341,India
361877,2023-10-24,205,classic yogurt,45,60,15,1,00341,India
189186,2023-10-24,203,mango yogurt,50,60,10,1,00195,India
189186,2023-10-24,208,sprite,75,100,25,1,00195,India
189186,2023-10-24,212,amul cheese,250,315,65,1,00195,India
146981,2023-10-24,211,red bull,90,125,35,1,00453,India
615460,2023-10-25,207,coca cola,75,100,25,1,00149,India
615460,2023-10-25,213,bisleri,6,15,9,1,00149,India
615460,2023-10-25,203,mango yogurt,50,60,10,1,00149,India
187206,2023-10-25,208,sprite,75,100,25,1,00214,India
762564,2023-10-25,203,mango yogurt,50,60,10,1,00010,India
762564,2023-10-25,211,red bull,90,125,35,1,00010,India
762564,2023-10-25,208,sprite,75,100,25,1,00010,India
762564,2023-10-25,201,paneer,210,340,130,1,00010,India
231458,2023-10-25,208,sprite,75,100,25,1,00400,India
231458,2023-10-25,202,milk,12,27,15,1,00400,India
231458,2023-10-25,210,mountain dew,75,100,25,1,00400,India
231458,2023-10-25,205,classic yogurt,45,60,15,1,00400,India
291858,2023-10-25,204,strawberry yogurt,50,60,10,1,00102,India
291858,2023-10-25,203,mango yogurt,50,60,10,1,00102,India
291858,2023-10-25,205,classic yogurt,45,60,15,1,00102,India
291858,2023-10-25,207,coca cola,75,100,25,1,00102,India
776851,2023-10-25,206,yakult,360,400,40,1,00423,India
776851,2023-10-25,202,milk,12,27,15,1,00423,India
776851,2023-10-25,205,classic yogurt,45,60,15,1,00423,India
693937,2023-10-25,203,mango yogurt,50,60,10,1,00178,India
422858,2023-10-25,205,classic yogurt,45,60,15,1,00036,India
391935,2023-10-25,203,mango yogurt,50,60,10,1,00234,India
391935,2023-10-25,201,paneer,210,340,130,1,00234,India
391935,2023-10-25,211,red bull,90,125,35,1,00234,India
254742,2023-10-25,213,bisleri,6,15,9,1,00061,India
254742,2023-10-25,205,classic yogurt,45,60,15,1,00061,India
254742,2023-10-25,208,sprite,75,100,25,1,00061,India
254742,2023-10-25,206,yakult,360,400,40,1,00061,India
974118,2023-10-25,207,coca cola,75,100,25,1,00266,India
550238,2023-10-25,213,bisleri,6,15,9,1,00133,India
550238,2023-10-25,207,coca cola,75,100,25,1,00133,India
550238,2023-10-25,201,paneer,210,340,130,1,00133,India
996130,2023-10-25,213,bisleri,6,15,9,1,00180,India
996130,2023-10-25,202,milk,12,27,15,1,00180,India
996130,2023-10-25,203,mango yogurt,50,60,10,1,00180,India
996130,2023-10-25,206,yakult,360,400,40,1,00180,India
701127,2023-10-25,202,milk,12,27,15,1,00396,India
668478,2023-10-25,210,mountain dew,75,100,25,1,00135,India
668478,2023-10-25,212,amul cheese,250,315,65,1,00135,India
105908,2023-10-25,201,paneer,210,340,130,1,00411,India
105908,2023-10-25,212,amul cheese,250,315,65,1,00411,India
105908,2023-10-25,206,yakult,360,400,40,1,00411,India
105908,2023-10-25,208,sprite,75,100,25,1,00411,India
519810,2023-10-25,207,coca cola,75,100,25,1,00044,India
519810,2023-10-25,213,bisleri,6,15,9,1,00044,India
392473,2023-10-25,211,red bull,90,125,35,1,00405,India
392473,2023-10-25,201,paneer,210,340,130,1,00405,India
392473,2023-10-25,203,mango yogurt,50,60,10,1,00405,India
392473,2023-10-25,209,pepsi,75,100,25,1,00405,India
765688,2023-10-25,204,strawberry yogurt,50,60,10,1,00208,India
718060,2023-10-25,207,coca cola,75,100,25,1,00226,India
718060,2023-10-25,212,amul cheese,250,315,65,1,00226,India
718060,2023-10-25,211,red bull,90,125,35,1,00226,India
718060,2023-10-25,209,pepsi,75,100,25,1,00226,India
329482,2023-10-25,211,red bull,90,125,35,1,00215,India
329482,2023-10-25,205,classic yogurt,45,60,15,1,00215,India
329482,2023-10-25,209,pepsi,75,100,25,1,00215,India
329482,2023-10-25,212,amul cheese,250,315,65,1,00215,India
397237,2023-10-25,205,classic yogurt,45,60,15,1,00003,India
141666,2023-10-25,208,sprite,75,100,25,1,00328,India
141666,2023-10-25,201,paneer,210,340,130,1,00328,India
141666,2023-10-25,213,bisleri,6,15,9,1,00328,India
141666,2023-10-25,202,milk,12,27,15,1,00328,India
852316,2023-10-25,207,coca cola,75,100,25,1,00356,India
852316,2023-10-25,213,bisleri,6,15,9,1,00356,India
852316,2023-10-25,206,yakult,360,400,40,1,00356,India
412665,2023-10-25,207,coca cola,75,100,25,1,00301,India
412665,2023-10-25,205,classic yogurt,45,60,15,1,00301,India
137400,2023-10-25,201,paneer,210,340,130,1,00466,India
366159,2023-10-25,211,red bull,90,125,35,1,00331,India
366159,2023-10-25,213,bisleri,6,15,9,1,00331,India
366159,2023-10-25,207,coca cola,75,100,25,1,00331,India
366159,2023-10-25,201,paneer,210,340,130,1,00331,India
670237,2023-10-25,212,amul cheese,250,315,65,1,00149,India
738893,2023-10-25,207,coca cola,75,100,25,1,00005,India
738893,2023-10-25,203,mango yogurt,50,60,10,1,00005,India
738893,2023-10-25,206,yakult,360,400,40,1,00005,India
738893,2023-10-25,208,sprite,75,100,25,1,00005,India
738893,2023-10-25,202,milk,12,27,15,1,00005,India
564900,2023-10-25,212,amul cheese,250,315,65,1,00386,India
564900,2023-10-25,204,strawberry yogurt,50,60,10,1,00386,India
564900,2023-10-25,210,mountain dew,75,100,25,1,00386,India
971283,2023-10-25,212,amul cheese,250,315,65,1,00085,India
971283,2023-10-25,206,yakult,360,400,40,1,00085,India
971283,2023-10-25,201,paneer,210,340,130,1,00085,India
498237,2023-10-25,209,pepsi,75,100,25,1,00095,India
498237,2023-10-25,207,coca cola,75,100,25,1,00095,India
748338,2023-10-25,201,paneer,210,340,130,1,00150,India
748338,2023-10-25,207,coca cola,75,100,25,1,00150,India
748338,2023-10-25,213,bisleri,6,15,9,1,00150,India
748338,2023-10-25,208,sprite,75,100,25,1,00150,India
240777,2023-10-25,212,amul cheese,250,315,65,1,00167,India
476035,2023-10-25,201,paneer,210,340,130,1,00006,India
476035,2023-10-25,213,bisleri,6,15,9,1,00006,India
476035,2023-10-25,204,strawberry yogurt,50,60,10,1,00006,India
912608,2023-10-25,207,coca cola,75,100,25,1,00105,India
912608,2023-10-25,208,sprite,75,100,25,1,00105,India
698850,2023-10-25,204,strawberry yogurt,50,60,10,1,00433,India
702437,2023-10-25,205,classic yogurt,45,60,15,1,00075,India
702437,2023-10-25,210,mountain dew,75,100,25,1,00075,India
702437,2023-10-25,201,paneer,210,340,130,1,00075,India
702437,2023-10-25,212,amul cheese,250,315,65,1,00075,India
182487,2023-10-25,211,red bull,90,125,35,1,00143,India
309328,2023-10-25,212,amul cheese,250,315,65,1,00244,India
309328,2023-10-25,210,mountain dew,75,100,25,1,00244,India
309328,2023-10-25,203,mango yogurt,50,60,10,1,00244,India
630051,2023-10-25,213,bisleri,6,15,9,1,00002,India
630051,2023-10-25,203,mango yogurt,50,60,10,1,00002,India
525322,2023-10-25,202,milk,12,27,15,1,00166,India
525322,2023-10-25,208,sprite,75,100,25,1,00166,India
720764,2023-10-25,202,milk,12,27,15,1,00108,India
720764,2023-10-25,210,mountain dew,75,100,25,1,00108,India
720764,2023-10-25,212,amul cheese,250,315,65,1,00108,India
227264,2023-10-25,201,paneer,210,340,130,1,00348,India
768504,2023-10-25,202,milk,12,27,15,1,00446,India
768504,2023-10-25,213,bisleri,6,15,9,1,00446,India
768504,2023-10-25,207,coca cola,75,100,25,1,00446,India
220145,2023-10-25,211,red bull,90,125,35,1,00257,India
384819,2023-10-25,202,milk,12,27,15,1,00468,India
384819,2023-10-25,213,bisleri,6,15,9,1,00468,India
384819,2023-10-25,211,red bull,90,125,35,1,00468,India
811080,2023-10-25,203,mango yogurt,50,60,10,1,00196,India
811080,2023-10-25,201,paneer,210,340,130,1,00196,India
811080,2023-10-25,211,red bull,90,125,35,1,00196,India
811080,2023-10-25,205,classic yogurt,45,60,15,1,00196,India
208766,2023-10-25,212,amul cheese,250,315,65,1,00093,India
208766,2023-10-25,206,yakult,360,400,40,1,00093,India
487534,2023-10-25,206,yakult,360,400,40,1,00273,India
131631,2023-10-25,212,amul cheese,250,315,65,1,00076,India
131631,2023-10-25,201,paneer,210,340,130,1,00076,India
131631,2023-10-25,208,sprite,75,100,25,1,00076,India
131631,2023-10-25,211,red bull,90,125,35,1,00076,India
131631,2023-10-25,210,mountain dew,75,100,25,1,00076,India
718630,2023-10-25,203,mango yogurt,50,60,10,1,00425,India
118396,2023-10-25,206,yakult,360,400,40,1,00387,India
118396,2023-10-25,207,coca cola,75,100,25,1,00387,India
118396,2023-10-25,204,strawberry yogurt,50,60,10,1,00387,India
118396,2023-10-25,210,mountain dew,75,100,25,1,00387,India
415906,2023-10-25,203,mango yogurt,50,60,10,1,00254,India
415906,2023-10-25,213,bisleri,6,15,9,1,00254,India
415906,2023-10-25,205,classic yogurt,45,60,15,1,00254,India
234372,2023-10-25,210,mountain dew,75,100,25,1,00499,India
151957,2023-10-25,206,yakult,360,400,40,1,00159,India
215371,2023-10-25,205,classic yogurt,45,60,15,1,00013,India
215371,2023-10-25,212,amul cheese,250,315,65,1,00013,India
215371,2023-10-25,204,strawberry yogurt,50,60,10,1,00013,India
401173,2023-10-25,201,paneer,210,340,130,1,00295,India
401173,2023-10-25,202,milk,12,27,15,1,00295,India
401173,2023-10-25,208,sprite,75,100,25,1,00295,India
401173,2023-10-25,205,classic yogurt,45,60,15,1,00295,India
710234,2023-10-25,205,classic yogurt,45,60,15,1,00483,India
710234,2023-10-25,202,milk,12,27,15,1,00483,India
710234,2023-10-25,212,amul cheese,250,315,65,1,00483,India
937302,2023-10-25,212,amul cheese,250,315,65,1,00079,India
937302,2023-10-25,205,classic yogurt,45,60,15,1,00079,India
937302,2023-10-25,201,paneer,210,340,130,1,00079,India
747157,2023-10-25,202,milk,12,27,15,1,00473,India
747157,2023-10-25,201,paneer,210,340,130,1,00473,India
865848,2023-10-25,212,amul cheese,250,315,65,1,00494,India
865848,2023-10-25,205,classic yogurt,45,60,15,1,00494,India
865848,2023-10-25,206,yakult,360,400,40,1,00494,India
865848,2023-10-25,213,bisleri,6,15,9,1,00494,India
865848,2023-10-25,209,pepsi,75,100,25,1,00494,India
436341,2023-10-25,208,sprite,75,100,25,1,00444,India
436341,2023-10-25,202,milk,12,27,15,1,00444,India
436341,2023-10-25,210,mountain dew,75,100,25,1,00444,India
436341,2023-10-25,207,coca cola,75,100,25,1,00444,India
668985,2023-10-25,212,amul cheese,250,315,65,1,00148,India
668985,2023-10-25,213,bisleri,6,15,9,1,00148,India
668985,2023-10-25,210,mountain dew,75,100,25,1,00148,India
668985,2023-10-25,206,yakult,360,400,40,1,00148,India
936383,2023-10-25,206,yakult,360,400,40,1,00100,India
603172,2023-10-25,205,classic yogurt,45,60,15,1,00012,India
603172,2023-10-25,209,pepsi,75,100,25,1,00012,India
792951,2023-10-25,204,strawberry yogurt,50,60,10,1,00194,India
321136,2023-10-25,207,coca cola,75,100,25,1,00010,India
321136,2023-10-25,206,yakult,360,400,40,1,00010,India
321136,2023-10-25,203,mango yogurt,50,60,10,1,00010,India
321136,2023-10-25,213,bisleri,6,15,9,1,00010,India
440380,2023-10-25,212,amul cheese,250,315,65,1,00195,India
440380,2023-10-25,213,bisleri,6,15,9,1,00195,India
440380,2023-10-25,206,yakult,360,400,40,1,00195,India
440380,2023-10-25,203,mango yogurt,50,60,10,1,00195,India
981541,2023-10-25,205,classic yogurt,45,60,15,1,00351,India
981541,2023-10-25,206,yakult,360,400,40,1,00351,India
347469,2023-10-25,207,coca cola,75,100,25,1,00306,India
347469,2023-10-25,202,milk,12,27,15,1,00306,India
347469,2023-10-25,205,classic yogurt,45,60,15,1,00306,India
347469,2023-10-25,212,amul cheese,250,315,65,1,00306,India
580926,2023-10-25,212,amul cheese,250,315,65,1,00181,India
580926,2023-10-25,213,bisleri,6,15,9,1,00181,India
580926,2023-10-25,210,mountain dew,75,100,25,1,00181,India
864585,2023-10-25,212,amul cheese,250,315,65,1,00014,India
864585,2023-10-25,211,red bull,90,125,35,1,00014,India
736828,2023-10-25,201,paneer,210,340,130,1,00182,India
505787,2023-10-25,206,yakult,360,400,40,1,00431,India
505787,2023-10-25,207,coca cola,75,100,25,1,00431,India
505787,2023-10-25,202,milk,12,27,15,1,00431,India
505787,2023-10-25,201,paneer,210,340,130,1,00431,India
931707,2023-10-25,204,strawberry yogurt,50,60,10,1,00285,India
931707,2023-10-25,203,mango yogurt,50,60,10,1,00285,India
931707,2023-10-25,211,red bull,90,125,35,1,00285,India
572235,2023-10-25,208,sprite,75,100,25,1,00398,India
572235,2023-10-25,210,mountain dew,75,100,25,1,00398,India
887797,2023-10-25,205,classic yogurt,45,60,15,1,00310,India
887797,2023-10-25,206,yakult,360,400,40,1,00310,India
887797,2023-10-25,210,mountain dew,75,100,25,1,00310,India
869681,2023-10-25,203,mango yogurt,50,60,10,1,00398,India
869681,2023-10-25,208,sprite,75,100,25,1,00398,India
869681,2023-10-25,206,yakult,360,400,40,1,00398,India
984577,2023-10-25,204,strawberry yogurt,50,60,10,1,00075,India
984577,2023-10-25,207,coca cola,75,100,25,1,00075,India
984577,2023-10-25,211,red bull,90,125,35,1,00075,India
984577,2023-10-25,206,yakult,360,400,40,1,00075,India
974669,2023-10-25,204,strawberry yogurt,50,60,10,1,00131,India
974669,2023-10-25,201,paneer,210,340,130,1,00131,India
974669,2023-10-25,211,red bull,90,125,35,1,00131,India
974669,2023-10-25,209,pepsi,75,100,25,1,00131,India
225027,2023-10-25,213,bisleri,6,15,9,1,00047,India
713880,2023-10-25,204,strawberry yogurt,50,60,10,1,00365,India
713880,2023-10-25,213,bisleri,6,15,9,1,00365,India
713880,2023-10-25,203,mango yogurt,50,60,10,1,00365,India
713880,2023-10-25,208,sprite,75,100,25,1,00365,India
713880,2023-10-25,212,amul cheese,250,315,65,1,00365,India
156015,2023-10-25,201,paneer,210,340,130,1,00497,India
156015,2023-10-25,202,milk,12,27,15,1,00497,India
156015,2023-10-25,204,strawberry yogurt,50,60,10,1,00497,India
650784,2023-10-25,202,milk,12,27,15,1,00312,India
650784,2023-10-25,208,sprite,75,100,25,1,00312,India
650784,2023-10-25,203,mango yogurt,50,60,10,1,00312,India
650784,2023-10-25,205,classic yogurt,45,60,15,1,00312,India
799093,2023-10-26,201,paneer,210,340,130,1,00267,India
799093,2023-10-26,210,mountain dew,75,100,25,1,00267,India
799093,2023-10-26,208,sprite,75,100,25,1,00267,India
799093,2023-10-26,209,pepsi,75,100,25,1,00267,India
961198,2023-10-26,208,sprite,75,100,25,1,00341,India
961198,2023-10-26,205,classic yogurt,45,60,15,1,00341,India
961198,2023-10-26,202,milk,12,27,15,1,00341,India
411827,2023-10-26,208,sprite,75,100,25,1,00281,India
411827,2023-10-26,210,mountain dew,75,100,25,1,00281,India
236030,2023-10-26,206,yakult,360,400,40,1,00194,India
236030,2023-10-26,205,classic yogurt,45,60,15,1,00194,India
236030,2023-10-26,207,coca cola,75,100,25,1,00194,India
236030,2023-10-26,202,milk,12,27,15,1,00194,India
156060,2023-10-26,202,milk,12,27,15,1,00313,India
156060,2023-10-26,207,coca cola,75,100,25,1,00313,India
156060,2023-10-26,213,bisleri,6,15,9,1,00313,India
602318,2023-10-26,210,mountain dew,75,100,25,1,00169,India
602318,2023-10-26,202,milk,12,27,15,1,00169,India
243950,2023-10-26,206,yakult,360,400,40,1,00293,India
754495,2023-10-26,203,mango yogurt,50,60,10,1,00197,India
754495,2023-10-26,208,sprite,75,100,25,1,00197,India
812972,2023-10-26,211,red bull,90,125,35,1,00396,India
812972,2023-10-26,205,classic yogurt,45,60,15,1,00396,India
812972,2023-10-26,201,paneer,210,340,130,1,00396,India
812972,2023-10-26,204,strawberry yogurt,50,60,10,1,00396,India
812972,2023-10-26,212,amul cheese,250,315,65,1,00396,India
123274,2023-10-26,202,milk,12,27,15,1,00165,India
123274,2023-10-26,205,classic yogurt,45,60,15,1,00165,India
123274,2023-10-26,212,amul cheese,250,315,65,1,00165,India
123274,2023-10-26,208,sprite,75,100,25,1,00165,India
671125,2023-10-26,206,yakult,360,400,40,1,00275,India
671125,2023-10-26,201,paneer,210,340,130,1,00275,India
671125,2023-10-26,202,milk,12,27,15,1,00275,India
468454,2023-10-26,203,mango yogurt,50,60,10,1,00136,India
336420,2023-10-26,202,milk,12,27,15,1,00379,India
336420,2023-10-26,203,mango yogurt,50,60,10,1,00379,India
336420,2023-10-26,213,bisleri,6,15,9,1,00379,India
525882,2023-10-26,205,classic yogurt,45,60,15,1,00261,India
525882,2023-10-26,210,mountain dew,75,100,25,1,00261,India
525882,2023-10-26,204,strawberry yogurt,50,60,10,1,00261,India
111827,2023-10-26,202,milk,12,27,15,1,00382,India
111827,2023-10-26,208,sprite,75,100,25,1,00382,India
111827,2023-10-26,207,coca cola,75,100,25,1,00382,India
111827,2023-10-26,210,mountain dew,75,100,25,1,00382,India
111827,2023-10-26,205,classic yogurt,45,60,15,1,00382,India
183548,2023-10-26,210,mountain dew,75,100,25,1,00101,India
628194,2023-10-26,209,pepsi,75,100,25,1,00102,India
628194,2023-10-26,201,paneer,210,340,130,1,00102,India
628194,2023-10-26,205,classic yogurt,45,60,15,1,00102,India
458237,2023-10-26,204,strawberry yogurt,50,60,10,1,00421,India
458237,2023-10-26,207,coca cola,75,100,25,1,00421,India
458237,2023-10-26,208,sprite,75,100,25,1,00421,India
458237,2023-10-26,213,bisleri,6,15,9,1,00421,India
619826,2023-10-26,209,pepsi,75,100,25,1,00465,India
619826,2023-10-26,206,yakult,360,400,40,1,00465,India
619826,2023-10-26,205,classic yogurt,45,60,15,1,00465,India
108663,2023-10-26,213,bisleri,6,15,9,1,00497,India
108663,2023-10-26,208,sprite,75,100,25,1,00497,India
108663,2023-10-26,212,amul cheese,250,315,65,1,00497,India
108663,2023-10-26,201,paneer,210,340,130,1,00497,India
329126,2023-10-26,212,amul cheese,250,315,65,1,00488,India
329126,2023-10-26,203,mango yogurt,50,60,10,1,00488,India
329126,2023-10-26,202,milk,12,27,15,1,00488,India
275346,2023-10-26,206,yakult,360,400,40,1,00268,India
275346,2023-10-26,208,sprite,75,100,25,1,00268,India
275346,2023-10-26,213,bisleri,6,15,9,1,00268,India
614639,2023-10-26,212,amul cheese,250,315,65,1,00423,India
614639,2023-10-26,210,mountain dew,75,100,25,1,00423,India
614639,2023-10-26,206,yakult,360,400,40,1,00423,India
614639,2023-10-26,209,pepsi,75,100,25,1,00423,India
309838,2023-10-26,203,mango yogurt,50,60,10,1,00344,India
309838,2023-10-26,204,strawberry yogurt,50,60,10,1,00344,India
309838,2023-10-26,206,yakult,360,400,40,1,00344,India
309838,2023-10-26,202,milk,12,27,15,1,00344,India
309838,2023-10-26,205,classic yogurt,45,60,15,1,00344,India
645624,2023-10-26,209,pepsi,75,100,25,1,00153,India
645624,2023-10-26,212,amul cheese,250,315,65,1,00153,India
401287,2023-10-26,208,sprite,75,100,25,1,00154,India
401287,2023-10-26,211,red bull,90,125,35,1,00154,India
401287,2023-10-26,209,pepsi,75,100,25,1,00154,India
401287,2023-10-26,212,amul cheese,250,315,65,1,00154,India
561376,2023-10-26,207,coca cola,75,100,25,1,00213,India
561376,2023-10-26,209,pepsi,75,100,25,1,00213,India
445311,2023-10-26,213,bisleri,6,15,9,1,00428,India
113864,2023-10-26,204,strawberry yogurt,50,60,10,1,00404,India
113864,2023-10-26,212,amul cheese,250,315,65,1,00404,India
113864,2023-10-26,201,paneer,210,340,130,1,00404,India
113864,2023-10-26,213,bisleri,6,15,9,1,00404,India
977488,2023-10-26,210,mountain dew,75,100,25,1,00088,India
735993,2023-10-26,205,classic yogurt,45,60,15,1,00104,India
735993,2023-10-26,212,amul cheese,250,315,65,1,00104,India
909222,2023-10-26,203,mango yogurt,50,60,10,1,00343,India
512600,2023-10-26,205,classic yogurt,45,60,15,1,00497,India
512600,2023-10-26,203,mango yogurt,50,60,10,1,00497,India
512600,2023-10-26,206,yakult,360,400,40,1,00497,India
512600,2023-10-26,202,milk,12,27,15,1,00497,India
262710,2023-10-26,213,bisleri,6,15,9,1,00220,India
262710,2023-10-26,208,sprite,75,100,25,1,00220,India
281763,2023-10-26,211,red bull,90,125,35,1,00418,India
281763,2023-10-26,205,classic yogurt,45,60,15,1,00418,India
281763,2023-10-26,208,sprite,75,100,25,1,00418,India
471871,2023-10-26,208,sprite,75,100,25,1,00090,India
471871,2023-10-26,201,paneer,210,340,130,1,00090,India
471871,2023-10-26,207,coca cola,75,100,25,1,00090,India
714981,2023-10-26,209,pepsi,75,100,25,1,00024,India
393197,2023-10-26,210,mountain dew,75,100,25,1,00023,India
541352,2023-10-26,212,amul cheese,250,315,65,1,00382,India
541352,2023-10-26,205,classic yogurt,45,60,15,1,00382,India
541352,2023-10-26,206,yakult,360,400,40,1,00382,India
541352,2023-10-26,203,mango yogurt,50,60,10,1,00382,India
521893,2023-10-26,210,mountain dew,75,100,25,1,00366,India
546931,2023-10-26,208,sprite,75,100,25,1,00246,India
546931,2023-10-26,209,pepsi,75,100,25,1,00246,India
546931,2023-10-26,204,strawberry yogurt,50,60,10,1,00246,India
138479,2023-10-26,204,strawberry yogurt,50,60,10,1,00365,India
138479,2023-10-26,213,bisleri,6,15,9,1,00365,India
138479,2023-10-26,205,classic yogurt,45,60,15,1,00365,India
138479,2023-10-26,211,red bull,90,125,35,1,00365,India
366077,2023-10-26,212,amul cheese,250,315,65,1,00386,India
366077,2023-10-26,210,mountain dew,75,100,25,1,00386,India
366077,2023-10-26,203,mango yogurt,50,60,10,1,00386,India
562243,2023-10-26,209,pepsi,75,100,25,1,00439,India
562243,2023-10-26,202,milk,12,27,15,1,00439,India
562243,2023-10-26,208,sprite,75,100,25,1,00439,India
562243,2023-10-26,201,paneer,210,340,130,1,00439,India
536692,2023-10-26,206,yakult,360,400,40,1,00035,India
138615,2023-10-26,206,yakult,360,400,40,1,00318,India
138615,2023-10-26,208,sprite,75,100,25,1,00318,India
138615,2023-10-26,205,classic yogurt,45,60,15,1,00318,India
697506,2023-10-26,205,classic yogurt,45,60,15,1,00184,India
962558,2023-10-26,205,classic yogurt,45,60,15,1,00254,India
962558,2023-10-26,212,amul cheese,250,315,65,1,00254,India
962558,2023-10-26,202,milk,12,27,15,1,00254,India
675567,2023-10-26,210,mountain dew,75,100,25,1,00268,India
675567,2023-10-26,213,bisleri,6,15,9,1,00268,India
475392,2023-10-26,207,coca cola,75,100,25,1,00201,India
475392,2023-10-26,203,mango yogurt,50,60,10,1,00201,India
487956,2023-10-26,207,coca cola,75,100,25,1,00498,India
435722,2023-10-26,209,pepsi,75,100,25,1,00164,India
435722,2023-10-26,211,red bull,90,125,35,1,00164,India
869848,2023-10-26,208,sprite,75,100,25,1,00430,India
869848,2023-10-26,205,classic yogurt,45,60,15,1,00430,India
869848,2023-10-26,206,yakult,360,400,40,1,00430,India
460610,2023-10-26,204,strawberry yogurt,50,60,10,1,00414,India
869656,2023-10-26,212,amul cheese,250,315,65,1,00357,India
869656,2023-10-26,201,paneer,210,340,130,1,00357,India
869656,2023-10-26,205,classic yogurt,45,60,15,1,00357,India
869656,2023-10-26,211,red bull,90,125,35,1,00357,India
869656,2023-10-26,209,pepsi,75,100,25,1,00357,India
887384,2023-10-26,204,strawberry yogurt,50,60,10,1,00361,India
887384,2023-10-26,209,pepsi,75,100,25,1,00361,India
887384,2023-10-26,201,paneer,210,340,130,1,00361,India
887384,2023-10-26,212,amul cheese,250,315,65,1,00361,India
887384,2023-10-26,207,coca cola,75,100,25,1,00361,India
616582,2023-10-26,213,bisleri,6,15,9,1,00372,India
616582,2023-10-26,211,red bull,90,125,35,1,00372,India
330523,2023-10-26,206,yakult,360,400,40,1,00481,India
330523,2023-10-26,208,sprite,75,100,25,1,00481,India
419266,2023-10-26,209,pepsi,75,100,25,1,00021,India
419266,2023-10-26,213,bisleri,6,15,9,1,00021,India
419266,2023-10-26,212,amul cheese,250,315,65,1,00021,India
419266,2023-10-26,207,coca cola,75,100,25,1,00021,India
419266,2023-10-26,210,mountain dew,75,100,25,1,00021,India
249504,2023-10-26,204,strawberry yogurt,50,60,10,1,00121,India
202302,2023-10-26,207,coca cola,75,100,25,1,00037,India
202302,2023-10-26,210,mountain dew,75,100,25,1,00037,India
202302,2023-10-26,213,bisleri,6,15,9,1,00037,India
783790,2023-10-26,207,coca cola,75,100,25,1,00499,India
783790,2023-10-26,213,bisleri,6,15,9,1,00499,India
804073,2023-10-26,202,milk,12,27,15,1,00106,India
140874,2023-10-26,213,bisleri,6,15,9,1,00414,India
140874,2023-10-26,205,classic yogurt,45,60,15,1,00414,India
140874,2023-10-26,209,pepsi,75,100,25,1,00414,India
805466,2023-10-26,209,pepsi,75,100,25,1,00156,India
805466,2023-10-26,203,mango yogurt,50,60,10,1,00156,India
805466,2023-10-26,207,coca cola,75,100,25,1,00156,India
805466,2023-10-26,201,paneer,210,340,130,1,00156,India
981252,2023-10-26,210,mountain dew,75,100,25,1,00254,India
981252,2023-10-26,212,amul cheese,250,315,65,1,00254,India
981252,2023-10-26,211,red bull,90,125,35,1,00254,India
196163,2023-10-26,211,red bull,90,125,35,1,00277,India
995950,2023-10-26,203,mango yogurt,50,60,10,1,00280,India
995950,2023-10-26,201,paneer,210,340,130,1,00280,India
876352,2023-10-26,212,amul cheese,250,315,65,1,00317,India
876352,2023-10-26,208,sprite,75,100,25,1,00317,India
876352,2023-10-26,207,coca cola,75,100,25,1,00317,India
876352,2023-10-26,204,strawberry yogurt,50,60,10,1,00317,India
467364,2023-10-26,207,coca cola,75,100,25,1,00163,India
467364,2023-10-26,206,yakult,360,400,40,1,00163,India
467364,2023-10-26,203,mango yogurt,50,60,10,1,00163,India
867782,2023-10-26,211,red bull,90,125,35,1,00411,India
170562,2023-10-26,206,yakult,360,400,40,1,00253,India
170562,2023-10-26,213,bisleri,6,15,9,1,00253,India
412173,2023-10-26,209,pepsi,75,100,25,1,00060,India
412173,2023-10-26,212,amul cheese,250,315,65,1,00060,India
412173,2023-10-26,211,red bull,90,125,35,1,00060,India
412173,2023-10-26,213,bisleri,6,15,9,1,00060,India
141101,2023-10-26,205,classic yogurt,45,60,15,1,00311,India
141101,2023-10-26,210,mountain dew,75,100,25,1,00311,India
809132,2023-10-26,213,bisleri,6,15,9,1,00159,India
809132,2023-10-26,212,amul cheese,250,315,65,1,00159,India
809132,2023-10-26,205,classic yogurt,45,60,15,1,00159,India
809132,2023-10-26,204,strawberry yogurt,50,60,10,1,00159,India
969378,2023-10-26,211,red bull,90,125,35,1,00129,India
969378,2023-10-26,207,coca cola,75,100,25,1,00129,India
969378,2023-10-26,210,mountain dew,75,100,25,1,00129,India
969378,2023-10-26,206,yakult,360,400,40,1,00129,India
375080,2023-10-26,208,sprite,75,100,25,1,00279,India
375080,2023-10-26,210,mountain dew,75,100,25,1,00279,India
167100,2023-10-26,213,bisleri,6,15,9,1,00204,India
167100,2023-10-26,208,sprite,75,100,25,1,00204,India
167100,2023-10-26,204,strawberry yogurt,50,60,10,1,00204,India
211004,2023-10-26,205,classic yogurt,45,60,15,1,00045,India
525726,2023-10-26,206,yakult,360,400,40,1,00478,India
525726,2023-10-26,209,pepsi,75,100,25,1,00478,India
525726,2023-10-26,205,classic yogurt,45,60,15,1,00478,India
525726,2023-10-26,208,sprite,75,100,25,1,00478,India
525726,2023-10-26,207,coca cola,75,100,25,1,00478,India
764249,2023-10-26,213,bisleri,6,15,9,1,00070,India
764249,2023-10-26,203,mango yogurt,50,60,10,1,00070,India
764249,2023-10-26,206,yakult,360,400,40,1,00070,India
764249,2023-10-26,212,amul cheese,250,315,65,1,00070,India
707800,2023-10-26,213,bisleri,6,15,9,1,00180,India
707800,2023-10-26,205,classic yogurt,45,60,15,1,00180,India
309434,2023-10-26,211,red bull,90,125,35,1,00149,India
309434,2023-10-26,201,paneer,210,340,130,1,00149,India
309434,2023-10-26,213,bisleri,6,15,9,1,00149,India
309434,2023-10-26,208,sprite,75,100,25,1,00149,India
309434,2023-10-26,204,strawberry yogurt,50,60,10,1,00149,India
497750,2023-10-26,204,strawberry yogurt,50,60,10,1,00320,India
572829,2023-10-26,208,sprite,75,100,25,1,00088,India
572829,2023-10-26,211,red bull,90,125,35,1,00088,India
572829,2023-10-26,202,milk,12,27,15,1,00088,India
572829,2023-10-26,209,pepsi,75,100,25,1,00088,India
554657,2023-10-26,211,red bull,90,125,35,1,00324,India
554657,2023-10-26,204,strawberry yogurt,50,60,10,1,00324,India
554657,2023-10-26,205,classic yogurt,45,60,15,1,00324,India
554657,2023-10-26,213,bisleri,6,15,9,1,00324,India
364793,2023-10-26,209,pepsi,75,100,25,1,00219,India
364793,2023-10-26,212,amul cheese,250,315,65,1,00219,India
364793,2023-10-26,210,mountain dew,75,100,25,1,00219,India
581740,2023-10-26,205,classic yogurt,45,60,15,1,00027,India
581740,2023-10-26,206,yakult,360,400,40,1,00027,India
374113,2023-10-26,202,milk,12,27,15,1,00206,India
374113,2023-10-26,207,coca cola,75,100,25,1,00206,India
374113,2023-10-26,201,paneer,210,340,130,1,00206,India
374113,2023-10-26,203,mango yogurt,50,60,10,1,00206,India
845078,2023-10-26,212,amul cheese,250,315,65,1,00429,India
788544,2023-10-26,205,classic yogurt,45,60,15,1,00224,India
529735,2023-10-26,213,bisleri,6,15,9,1,00496,India
529735,2023-10-26,208,sprite,75,100,25,1,00496,India
529735,2023-10-26,202,milk,12,27,15,1,00496,India
874692,2023-10-26,205,classic yogurt,45,60,15,1,00164,India
874692,2023-10-26,211,red bull,90,125,35,1,00164,India
874692,2023-10-26,210,mountain dew,75,100,25,1,00164,India
874692,2023-10-26,202,milk,12,27,15,1,00164,India
339975,2023-10-26,212,amul cheese,250,315,65,1,00353,India
935410,2023-10-26,206,yakult,360,400,40,1,00039,India
935410,2023-10-26,202,milk,12,27,15,1,00039,India
935410,2023-10-26,201,paneer,210,340,130,1,00039,India
430104,2023-10-26,203,mango yogurt,50,60,10,1,00479,India
430104,2023-10-26,202,milk,12,27,15,1,00479,India
430104,2023-10-26,210,mountain dew,75,100,25,1,00479,India
430104,2023-10-26,208,sprite,75,100,25,1,00479,India
792098,2023-10-26,211,red bull,90,125,35,1,00398,India
792098,2023-10-26,202,milk,12,27,15,1,00398,India
792098,2023-10-26,208,sprite,75,100,25,1,00398,India
822647,2023-10-27,210,mountain dew,75,100,25,1,00377,India
822647,2023-10-27,202,milk,12,27,15,1,00377,India
696734,2023-10-27,212,amul cheese,250,315,65,1,00238,India
696734,2023-10-27,210,mountain dew,75,100,25,1,00238,India
696734,2023-10-27,203,mango yogurt,50,60,10,1,00238,India
125199,2023-10-27,212,amul cheese,250,315,65,1,00372,India
125199,2023-10-27,210,mountain dew,75,100,25,1,00372,India
643595,2023-10-27,213,bisleri,6,15,9,1,00410,India
643595,2023-10-27,206,yakult,360,400,40,1,00410,India
643595,2023-10-27,209,pepsi,75,100,25,1,00410,India
643595,2023-10-27,205,classic yogurt,45,60,15,1,00410,India
268357,2023-10-27,207,coca cola,75,100,25,1,00007,India
268357,2023-10-27,205,classic yogurt,45,60,15,1,00007,India
268357,2023-10-27,211,red bull,90,125,35,1,00007,India
268357,2023-10-27,213,bisleri,6,15,9,1,00007,India
333690,2023-10-27,205,classic yogurt,45,60,15,1,00479,India
333690,2023-10-27,203,mango yogurt,50,60,10,1,00479,India
333690,2023-10-27,209,pepsi,75,100,25,1,00479,India
467765,2023-10-27,209,pepsi,75,100,25,1,00391,India
467765,2023-10-27,204,strawberry yogurt,50,60,10,1,00391,India
467765,2023-10-27,211,red bull,90,125,35,1,00391,India
467765,2023-10-27,208,sprite,75,100,25,1,00391,India
467765,2023-10-27,207,coca cola,75,100,25,1,00391,India
174139,2023-10-27,212,amul cheese,250,315,65,1,00104,India
174139,2023-10-27,208,sprite,75,100,25,1,00104,India
882880,2023-10-27,206,yakult,360,400,40,1,00025,India
822121,2023-10-27,209,pepsi,75,100,25,1,00238,India
822121,2023-10-27,202,milk,12,27,15,1,00238,India
822121,2023-10-27,212,amul cheese,250,315,65,1,00238,India
186179,2023-10-27,208,sprite,75,100,25,1,00149,India
472630,2023-10-27,212,amul cheese,250,315,65,1,00092,India
472630,2023-10-27,205,classic yogurt,45,60,15,1,00092,India
472630,2023-10-27,203,mango yogurt,50,60,10,1,00092,India
472630,2023-10-27,211,red bull,90,125,35,1,00092,India
930612,2023-10-27,207,coca cola,75,100,25,1,00420,India
930612,2023-10-27,211,red bull,90,125,35,1,00420,India
528269,2023-10-27,202,milk,12,27,15,1,00259,India
528269,2023-10-27,212,amul cheese,250,315,65,1,00259,India
364132,2023-10-27,203,mango yogurt,50,60,10,1,00055,India
364132,2023-10-27,205,classic yogurt,45,60,15,1,00055,India
841102,2023-10-27,211,red bull,90,125,35,1,00497,India
841102,2023-10-27,209,pepsi,75,100,25,1,00497,India
841102,2023-10-27,202,milk,12,27,15,1,00497,India
568704,2023-10-27,202,milk,12,27,15,1,00088,India
568704,2023-10-27,209,pepsi,75,100,25,1,00088,India
745517,2023-10-27,209,pepsi,75,100,25,1,00091,India
745517,2023-10-27,211,red bull,90,125,35,1,00091,India
745517,2023-10-27,213,bisleri,6,15,9,1,00091,India
477900,2023-10-27,202,milk,12,27,15,1,00357,India
477900,2023-10-27,212,amul cheese,250,315,65,1,00357,India
477900,2023-10-27,204,strawberry yogurt,50,60,10,1,00357,India
975737,2023-10-27,205,classic yogurt,45,60,15,1,00036,India
975737,2023-10-27,206,yakult,360,400,40,1,00036,India
628227,2023-10-27,209,pepsi,75,100,25,1,00019,India
628227,2023-10-27,201,paneer,210,340,130,1,00019,India
628227,2023-10-27,206,yakult,360,400,40,1,00019,India
628227,2023-10-27,202,milk,12,27,15,1,00019,India
894163,2023-10-27,210,mountain dew,75,100,25,1,00074,India
894163,2023-10-27,209,pepsi,75,100,25,1,00074,India
894163,2023-10-27,213,bisleri,6,15,9,1,00074,India
141067,2023-10-27,209,pepsi,75,100,25,1,00424,India
141067,2023-10-27,208,sprite,75,100,25,1,00424,India
141067,2023-10-27,213,bisleri,6,15,9,1,00424,India
141067,2023-10-27,206,yakult,360,400,40,1,00424,India
587172,2023-10-27,213,bisleri,6,15,9,1,00429,India
828450,2023-10-27,206,yakult,360,400,40,1,00252,India
828450,2023-10-27,211,red bull,90,125,35,1,00252,India
935231,2023-10-27,203,mango yogurt,50,60,10,1,00273,India
935231,2023-10-27,208,sprite,75,100,25,1,00273,India
935231,2023-10-27,207,coca cola,75,100,25,1,00273,India
346800,2023-10-27,210,mountain dew,75,100,25,1,00429,India
346800,2023-10-27,212,amul cheese,250,315,65,1,00429,India
346800,2023-10-27,208,sprite,75,100,25,1,00429,India
684003,2023-10-27,205,classic yogurt,45,60,15,1,00191,India
684003,2023-10-27,203,mango yogurt,50,60,10,1,00191,India
684003,2023-10-27,212,amul cheese,250,315,65,1,00191,India
934526,2023-10-27,202,milk,12,27,15,1,00112,India
238735,2023-10-27,213,bisleri,6,15,9,1,00312,India
375925,2023-10-27,206,yakult,360,400,40,1,00366,India
272158,2023-10-27,213,bisleri,6,15,9,1,00079,India
272158,2023-10-27,208,sprite,75,100,25,1,00079,India
476117,2023-10-27,212,amul cheese,250,315,65,1,00334,India
801619,2023-10-27,206,yakult,360,400,40,1,00349,India
801619,2023-10-27,204,strawberry yogurt,50,60,10,1,00349,India
829848,2023-10-27,212,amul cheese,250,315,65,1,00422,India
829848,2023-10-27,204,strawberry yogurt,50,60,10,1,00422,India
126412,2023-10-27,209,pepsi,75,100,25,1,00198,India
126412,2023-10-27,202,milk,12,27,15,1,00198,India
126412,2023-10-27,211,red bull,90,125,35,1,00198,India
126412,2023-10-27,212,amul cheese,250,315,65,1,00198,India
126412,2023-10-27,206,yakult,360,400,40,1,00198,India
303858,2023-10-27,205,classic yogurt,45,60,15,1,00150,India
303858,2023-10-27,208,sprite,75,100,25,1,00150,India
303858,2023-10-27,202,milk,12,27,15,1,00150,India
471670,2023-10-27,206,yakult,360,400,40,1,00128,India
471670,2023-10-27,202,milk,12,27,15,1,00128,India
471670,2023-10-27,210,mountain dew,75,100,25,1,00128,India
205865,2023-10-27,206,yakult,360,400,40,1,00081,India
205865,2023-10-27,211,red bull,90,125,35,1,00081,India
937252,2023-10-27,213,bisleri,6,15,9,1,00194,India
706387,2023-10-27,203,mango yogurt,50,60,10,1,00490,India
706387,2023-10-27,211,red bull,90,125,35,1,00490,India
706387,2023-10-27,212,amul cheese,250,315,65,1,00490,India
138922,2023-10-27,209,pepsi,75,100,25,1,00388,India
138922,2023-10-27,212,amul cheese,250,315,65,1,00388,India
790849,2023-10-27,201,paneer,210,340,130,1,00062,India
173668,2023-10-27,206,yakult,360,400,40,1,00278,India
173668,2023-10-27,202,milk,12,27,15,1,00278,India
322756,2023-10-27,207,coca cola,75,100,25,1,00357,India
322756,2023-10-27,204,strawberry yogurt,50,60,10,1,00357,India
348119,2023-10-27,204,strawberry yogurt,50,60,10,1,00378,India
348119,2023-10-27,208,sprite,75,100,25,1,00378,India
429538,2023-10-27,211,red bull,90,125,35,1,00484,India
429538,2023-10-27,202,milk,12,27,15,1,00484,India
759209,2023-10-27,207,coca cola,75,100,25,1,00252,India
759209,2023-10-27,201,paneer,210,340,130,1,00252,India
759209,2023-10-27,213,bisleri,6,15,9,1,00252,India
759209,2023-10-27,212,amul cheese,250,315,65,1,00252,India
252853,2023-10-27,205,classic yogurt,45,60,15,1,00344,India
252853,2023-10-27,213,bisleri,6,15,9,1,00344,India
235981,2023-10-27,210,mountain dew,75,100,25,1,00172,India
235981,2023-10-27,201,paneer,210,340,130,1,00172,India
333346,2023-10-27,209,pepsi,75,100,25,1,00339,India
333346,2023-10-27,202,milk,12,27,15,1,00339,India
773323,2023-10-27,213,bisleri,6,15,9,1,00060,India
773323,2023-10-27,204,strawberry yogurt,50,60,10,1,00060,India
773323,2023-10-27,210,mountain dew,75,100,25,1,00060,India
773323,2023-10-27,203,mango yogurt,50,60,10,1,00060,India
603930,2023-10-27,212,amul cheese,250,315,65,1,00113,India
603930,2023-10-27,209,pepsi,75,100,25,1,00113,India
603930,2023-10-27,207,coca cola,75,100,25,1,00113,India
603930,2023-10-27,211,red bull,90,125,35,1,00113,India
197592,2023-10-27,205,classic yogurt,45,60,15,1,00432,India
197592,2023-10-27,203,mango yogurt,50,60,10,1,00432,India
197592,2023-10-27,213,bisleri,6,15,9,1,00432,India
197592,2023-10-27,210,mountain dew,75,100,25,1,00432,India
197592,2023-10-27,208,sprite,75,100,25,1,00432,India
194365,2023-10-27,201,paneer,210,340,130,1,00166,India
175700,2023-10-27,210,mountain dew,75,100,25,1,00365,India
175700,2023-10-27,206,yakult,360,400,40,1,00365,India
278304,2023-10-27,212,amul cheese,250,315,65,1,00323,India
278304,2023-10-27,202,milk,12,27,15,1,00323,India
278304,2023-10-27,207,coca cola,75,100,25,1,00323,India
278304,2023-10-27,210,mountain dew,75,100,25,1,00323,India
278304,2023-10-27,209,pepsi,75,100,25,1,00323,India
391483,2023-10-27,201,paneer,210,340,130,1,00333,India
391483,2023-10-27,203,mango yogurt,50,60,10,1,00333,India
391483,2023-10-27,212,amul cheese,250,315,65,1,00333,India
391483,2023-10-27,205,classic yogurt,45,60,15,1,00333,India
749341,2023-10-27,204,strawberry yogurt,50,60,10,1,00337,India
749341,2023-10-27,203,mango yogurt,50,60,10,1,00337,India
749341,2023-10-27,210,mountain dew,75,100,25,1,00337,India
749341,2023-10-27,213,bisleri,6,15,9,1,00337,India
302175,2023-10-27,211,red bull,90,125,35,1,00374,India
302175,2023-10-27,207,coca cola,75,100,25,1,00374,India
155509,2023-10-27,204,strawberry yogurt,50,60,10,1,00375,India
225256,2023-10-27,204,strawberry yogurt,50,60,10,1,00396,India
225256,2023-10-27,207,coca cola,75,100,25,1,00396,India
225256,2023-10-27,202,milk,12,27,15,1,00396,India
225256,2023-10-27,212,amul cheese,250,315,65,1,00396,India
753162,2023-10-27,212,amul cheese,250,315,65,1,00127,India
753162,2023-10-27,205,classic yogurt,45,60,15,1,00127,India
753162,2023-10-27,213,bisleri,6,15,9,1,00127,India
610946,2023-10-27,210,mountain dew,75,100,25,1,00229,India
610946,2023-10-27,209,pepsi,75,100,25,1,00229,India
610946,2023-10-27,213,bisleri,6,15,9,1,00229,India
640023,2023-10-27,211,red bull,90,125,35,1,00488,India
640023,2023-10-27,209,pepsi,75,100,25,1,00488,India
400016,2023-10-27,212,amul cheese,250,315,65,1,00106,India
400016,2023-10-27,205,classic yogurt,45,60,15,1,00106,India
279868,2023-10-27,203,mango yogurt,50,60,10,1,00169,India
443071,2023-10-27,208,sprite,75,100,25,1,00489,India
676725,2023-10-27,204,strawberry yogurt,50,60,10,1,00290,India
676725,2023-10-27,210,mountain dew,75,100,25,1,00290,India
583612,2023-10-27,203,mango yogurt,50,60,10,1,00278,India
580577,2023-10-27,201,paneer,210,340,130,1,00235,India
671073,2023-10-27,208,sprite,75,100,25,1,00185,India
671073,2023-10-27,204,strawberry yogurt,50,60,10,1,00185,India
671073,2023-10-27,209,pepsi,75,100,25,1,00185,India
829136,2023-10-27,211,red bull,90,125,35,1,00144,India
780279,2023-10-27,213,bisleri,6,15,9,1,00197,India
780279,2023-10-27,209,pepsi,75,100,25,1,00197,India
780279,2023-10-27,203,mango yogurt,50,60,10,1,00197,India
146040,2023-10-27,202,milk,12,27,15,1,00215,India
463831,2023-10-27,212,amul cheese,250,315,65,1,00258,India
463831,2023-10-27,210,mountain dew,75,100,25,1,00258,India
463831,2023-10-27,203,mango yogurt,50,60,10,1,00258,India
863109,2023-10-27,207,coca cola,75,100,25,1,00144,India
863109,2023-10-27,202,milk,12,27,15,1,00144,India
858821,2023-10-27,209,pepsi,75,100,25,1,00011,India
858821,2023-10-27,210,mountain dew,75,100,25,1,00011,India
501673,2023-10-27,202,milk,12,27,15,1,00130,India
564268,2023-10-28,208,sprite,75,100,25,1,00326,India
564268,2023-10-28,212,amul cheese,250,315,65,1,00326,India
564268,2023-10-28,209,pepsi,75,100,25,1,00326,India
564268,2023-10-28,201,paneer,210,340,130,1,00326,India
128023,2023-10-28,204,strawberry yogurt,50,60,10,1,00365,India
128023,2023-10-28,210,mountain dew,75,100,25,1,00365,India
279665,2023-10-28,213,bisleri,6,15,9,1,00198,India
279665,2023-10-28,205,classic yogurt,45,60,15,1,00198,India
604902,2023-10-28,205,classic yogurt,45,60,15,1,00324,India
604902,2023-10-28,206,yakult,360,400,40,1,00324,India
604902,2023-10-28,213,bisleri,6,15,9,1,00324,India
807336,2023-10-28,212,amul cheese,250,315,65,1,00271,India
807336,2023-10-28,203,mango yogurt,50,60,10,1,00271,India
807336,2023-10-28,208,sprite,75,100,25,1,00271,India
807336,2023-10-28,210,mountain dew,75,100,25,1,00271,India
913106,2023-10-28,201,paneer,210,340,130,1,00125,India
913106,2023-10-28,204,strawberry yogurt,50,60,10,1,00125,India
913106,2023-10-28,211,red bull,90,125,35,1,00125,India
621104,2023-10-28,205,classic yogurt,45,60,15,1,00461,India
621104,2023-10-28,212,amul cheese,250,315,65,1,00461,India
621104,2023-10-28,207,coca cola,75,100,25,1,00461,India
320796,2023-10-28,207,coca cola,75,100,25,1,00263,India
320796,2023-10-28,203,mango yogurt,50,60,10,1,00263,India
579325,2023-10-28,207,coca cola,75,100,25,1,00047,India
579325,2023-10-28,210,mountain dew,75,100,25,1,00047,India
804563,2023-10-28,203,mango yogurt,50,60,10,1,00373,India
804563,2023-10-28,204,strawberry yogurt,50,60,10,1,00373,India
804563,2023-10-28,201,paneer,210,340,130,1,00373,India
757258,2023-10-28,209,pepsi,75,100,25,1,00456,India
757258,2023-10-28,212,amul cheese,250,315,65,1,00456,India
757258,2023-10-28,202,milk,12,27,15,1,00456,India
757258,2023-10-28,208,sprite,75,100,25,1,00456,India
488083,2023-10-28,206,yakult,360,400,40,1,00057,India
488083,2023-10-28,203,mango yogurt,50,60,10,1,00057,India
488083,2023-10-28,202,milk,12,27,15,1,00057,India
488083,2023-10-28,207,coca cola,75,100,25,1,00057,India
311441,2023-10-28,203,mango yogurt,50,60,10,1,00001,India
872351,2023-10-28,204,strawberry yogurt,50,60,10,1,00386,India
812074,2023-10-28,211,red bull,90,125,35,1,00205,India
812074,2023-10-28,208,sprite,75,100,25,1,00205,India
812074,2023-10-28,213,bisleri,6,15,9,1,00205,India
812074,2023-10-28,202,milk,12,27,15,1,00205,India
197168,2023-10-28,210,mountain dew,75,100,25,1,00303,India
197168,2023-10-28,207,coca cola,75,100,25,1,00303,India
870187,2023-10-28,207,coca cola,75,100,25,1,00143,India
870187,2023-10-28,212,amul cheese,250,315,65,1,00143,India
570180,2023-10-28,204,strawberry yogurt,50,60,10,1,00094,India
461562,2023-10-28,208,sprite,75,100,25,1,00298,India
461562,2023-10-28,210,mountain dew,75,100,25,1,00298,India
703011,2023-10-28,202,milk,12,27,15,1,00355,India
703011,2023-10-28,209,pepsi,75,100,25,1,00355,India
703011,2023-10-28,203,mango yogurt,50,60,10,1,00355,India
703011,2023-10-28,204,strawberry yogurt,50,60,10,1,00355,India
642577,2023-10-28,211,red bull,90,125,35,1,00431,India
221339,2023-10-28,213,bisleri,6,15,9,1,00316,India
221339,2023-10-28,211,red bull,90,125,35,1,00316,India
221339,2023-10-28,204,strawberry yogurt,50,60,10,1,00316,India
221339,2023-10-28,209,pepsi,75,100,25,1,00316,India
341746,2023-10-28,207,coca cola,75,100,25,1,00196,India
341746,2023-10-28,211,red bull,90,125,35,1,00196,India
765747,2023-10-28,210,mountain dew,75,100,25,1,00109,India
765747,2023-10-28,207,coca cola,75,100,25,1,00109,India
765747,2023-10-28,211,red bull,90,125,35,1,00109,India
765747,2023-10-28,213,bisleri,6,15,9,1,00109,India
765747,2023-10-28,209,pepsi,75,100,25,1,00109,India
899289,2023-10-28,205,classic yogurt,45,60,15,1,00392,India
385541,2023-10-28,211,red bull,90,125,35,1,00212,India
385541,2023-10-28,204,strawberry yogurt,50,60,10,1,00212,India
385541,2023-10-28,210,mountain dew,75,100,25,1,00212,India
693038,2023-10-28,213,bisleri,6,15,9,1,00302,India
693038,2023-10-28,209,pepsi,75,100,25,1,00302,India
854646,2023-10-28,210,mountain dew,75,100,25,1,00227,India
854646,2023-10-28,206,yakult,360,400,40,1,00227,India
854646,2023-10-28,213,bisleri,6,15,9,1,00227,India
854646,2023-10-28,202,milk,12,27,15,1,00227,India
554425,2023-10-28,210,mountain dew,75,100,25,1,00338,India
554425,2023-10-28,203,mango yogurt,50,60,10,1,00338,India
555219,2023-10-28,203,mango yogurt,50,60,10,1,00046,India
555219,2023-10-28,211,red bull,90,125,35,1,00046,India
608481,2023-10-28,204,strawberry yogurt,50,60,10,1,00287,India
608481,2023-10-28,207,coca cola,75,100,25,1,00287,India
977622,2023-10-28,204,strawberry yogurt,50,60,10,1,00453,India
977622,2023-10-28,207,coca cola,75,100,25,1,00453,India
977622,2023-10-28,208,sprite,75,100,25,1,00453,India
977622,2023-10-28,201,paneer,210,340,130,1,00453,India
657079,2023-10-28,204,strawberry yogurt,50,60,10,1,00016,India
324881,2023-10-28,206,yakult,360,400,40,1,00103,India
324881,2023-10-28,201,paneer,210,340,130,1,00103,India
324881,2023-10-28,204,strawberry yogurt,50,60,10,1,00103,India
782763,2023-10-28,206,yakult,360,400,40,1,00316,India
651976,2023-10-28,208,sprite,75,100,25,1,00462,India
651976,2023-10-28,210,mountain dew,75,100,25,1,00462,India
629150,2023-10-28,213,bisleri,6,15,9,1,00227,India
629150,2023-10-28,206,yakult,360,400,40,1,00227,India
629150,2023-10-28,207,coca cola,75,100,25,1,00227,India
583022,2023-10-28,207,coca cola,75,100,25,1,00448,India
883209,2023-10-28,201,paneer,210,340,130,1,00061,India
883209,2023-10-28,204,strawberry yogurt,50,60,10,1,00061,India
883209,2023-10-28,210,mountain dew,75,100,25,1,00061,India
883209,2023-10-28,205,classic yogurt,45,60,15,1,00061,India
252143,2023-10-28,201,paneer,210,340,130,1,00439,India
252143,2023-10-28,205,classic yogurt,45,60,15,1,00439,India
518934,2023-10-28,213,bisleri,6,15,9,1,00355,India
518934,2023-10-28,203,mango yogurt,50,60,10,1,00355,India
124925,2023-10-28,212,amul cheese,250,315,65,1,00473,India
418179,2023-10-28,204,strawberry yogurt,50,60,10,1,00262,India
418179,2023-10-28,213,bisleri,6,15,9,1,00262,India
418179,2023-10-28,206,yakult,360,400,40,1,00262,India
777706,2023-10-28,203,mango yogurt,50,60,10,1,00148,India
777706,2023-10-28,204,strawberry yogurt,50,60,10,1,00148,India
880304,2023-10-28,202,milk,12,27,15,1,00293,India
880304,2023-10-28,201,paneer,210,340,130,1,00293,India
880304,2023-10-28,213,bisleri,6,15,9,1,00293,India
880304,2023-10-28,209,pepsi,75,100,25,1,00293,India
880304,2023-10-28,204,strawberry yogurt,50,60,10,1,00293,India
385450,2023-10-28,213,bisleri,6,15,9,1,00035,India
385450,2023-10-28,204,strawberry yogurt,50,60,10,1,00035,India
385450,2023-10-28,205,classic yogurt,45,60,15,1,00035,India
385450,2023-10-28,211,red bull,90,125,35,1,00035,India
385450,2023-10-28,206,yakult,360,400,40,1,00035,India
485056,2023-10-28,202,milk,12,27,15,1,00334,India
485056,2023-10-28,205,classic yogurt,45,60,15,1,00334,India
485056,2023-10-28,207,coca cola,75,100,25,1,00334,India
358126,2023-10-28,210,mountain dew,75,100,25,1,00138,India
358126,2023-10-28,209,pepsi,75,100,25,1,00138,India
358126,2023-10-28,213,bisleri,6,15,9,1,00138,India
358126,2023-10-28,211,red bull,90,125,35,1,00138,India
358126,2023-10-28,201,paneer,210,340,130,1,00138,India
650991,2023-10-28,212,amul cheese,250,315,65,1,00442,India
650991,2023-10-28,213,bisleri,6,15,9,1,00442,India
639324,2023-10-28,208,sprite,75,100,25,1,00109,India
639324,2023-10-28,205,classic yogurt,45,60,15,1,00109,India
959275,2023-10-28,213,bisleri,6,15,9,1,00251,India
959275,2023-10-28,209,pepsi,75,100,25,1,00251,India
679220,2023-10-28,207,coca cola,75,100,25,1,00040,India
679220,2023-10-28,211,red bull,90,125,35,1,00040,India
717217,2023-10-28,202,milk,12,27,15,1,00346,India
717217,2023-10-28,207,coca cola,75,100,25,1,00346,India
717217,2023-10-28,201,paneer,210,340,130,1,00346,India
696412,2023-10-28,202,milk,12,27,15,1,00441,India
264114,2023-10-29,213,bisleri,6,15,9,1,00119,India
264114,2023-10-29,205,classic yogurt,45,60,15,1,00119,India
264114,2023-10-29,212,amul cheese,250,315,65,1,00119,India
892694,2023-10-29,211,red bull,90,125,35,1,00466,India
892694,2023-10-29,203,mango yogurt,50,60,10,1,00466,India
616771,2023-10-29,203,mango yogurt,50,60,10,1,00400,India
616771,2023-10-29,213,bisleri,6,15,9,1,00400,India
616771,2023-10-29,204,strawberry yogurt,50,60,10,1,00400,India
946722,2023-10-29,202,milk,12,27,15,1,00331,India
946722,2023-10-29,207,coca cola,75,100,25,1,00331,India
946722,2023-10-29,204,strawberry yogurt,50,60,10,1,00331,India
946722,2023-10-29,203,mango yogurt,50,60,10,1,00331,India
946722,2023-10-29,205,classic yogurt,45,60,15,1,00331,India
105734,2023-10-29,211,red bull,90,125,35,1,00035,India
105734,2023-10-29,213,bisleri,6,15,9,1,00035,India
105734,2023-10-29,201,paneer,210,340,130,1,00035,India
402547,2023-10-29,213,bisleri,6,15,9,1,00286,India
646532,2023-10-29,207,coca cola,75,100,25,1,00121,India
646532,2023-10-29,201,paneer,210,340,130,1,00121,India
646532,2023-10-29,205,classic yogurt,45,60,15,1,00121,India
646532,2023-10-29,208,sprite,75,100,25,1,00121,India
646532,2023-10-29,213,bisleri,6,15,9,1,00121,India
692317,2023-10-29,207,coca cola,75,100,25,1,00184,India
692317,2023-10-29,205,classic yogurt,45,60,15,1,00184,India
692317,2023-10-29,203,mango yogurt,50,60,10,1,00184,India
692317,2023-10-29,201,paneer,210,340,130,1,00184,India
692317,2023-10-29,206,yakult,360,400,40,1,00184,India
668914,2023-10-29,204,strawberry yogurt,50,60,10,1,00028,India
170972,2023-10-29,205,classic yogurt,45,60,15,1,00102,India
170972,2023-10-29,213,bisleri,6,15,9,1,00102,India
170972,2023-10-29,202,milk,12,27,15,1,00102,India
170972,2023-10-29,204,strawberry yogurt,50,60,10,1,00102,India
313001,2023-10-29,207,coca cola,75,100,25,1,00382,India
313001,2023-10-29,205,classic yogurt,45,60,15,1,00382,India
326069,2023-10-29,202,milk,12,27,15,1,00332,India
326069,2023-10-29,204,strawberry yogurt,50,60,10,1,00332,India
157365,2023-10-29,208,sprite,75,100,25,1,00037,India
157365,2023-10-29,204,strawberry yogurt,50,60,10,1,00037,India
157365,2023-10-29,209,pepsi,75,100,25,1,00037,India
946725,2023-10-29,205,classic yogurt,45,60,15,1,00223,India
946725,2023-10-29,202,milk,12,27,15,1,00223,India
946725,2023-10-29,208,sprite,75,100,25,1,00223,India
946725,2023-10-29,212,amul cheese,250,315,65,1,00223,India
265346,2023-10-29,212,amul cheese,250,315,65,1,00366,India
265346,2023-10-29,201,paneer,210,340,130,1,00366,India
265346,2023-10-29,203,mango yogurt,50,60,10,1,00366,India
465431,2023-10-29,209,pepsi,75,100,25,1,00392,India
465431,2023-10-29,201,paneer,210,340,130,1,00392,India
465431,2023-10-29,208,sprite,75,100,25,1,00392,India
560497,2023-10-29,202,milk,12,27,15,1,00291,India
560497,2023-10-29,206,yakult,360,400,40,1,00291,India
560497,2023-10-29,205,classic yogurt,45,60,15,1,00291,India
560497,2023-10-29,208,sprite,75,100,25,1,00291,India
903579,2023-10-29,213,bisleri,6,15,9,1,00256,India
903579,2023-10-29,203,mango yogurt,50,60,10,1,00256,India
903579,2023-10-29,204,strawberry yogurt,50,60,10,1,00256,India
903579,2023-10-29,205,classic yogurt,45,60,15,1,00256,India
796069,2023-10-29,202,milk,12,27,15,1,00411,India
875579,2023-10-29,210,mountain dew,75,100,25,1,00274,India
875579,2023-10-29,204,strawberry yogurt,50,60,10,1,00274,India
731649,2023-10-29,212,amul cheese,250,315,65,1,00172,India
731649,2023-10-29,204,strawberry yogurt,50,60,10,1,00172,India
731649,2023-10-29,209,pepsi,75,100,25,1,00172,India
621393,2023-10-29,211,red bull,90,125,35,1,00072,India
621393,2023-10-29,208,sprite,75,100,25,1,00072,India
621393,2023-10-29,202,milk,12,27,15,1,00072,India
899972,2023-10-29,208,sprite,75,100,25,1,00068,India
899972,2023-10-29,210,mountain dew,75,100,25,1,00068,India
899972,2023-10-29,207,coca cola,75,100,25,1,00068,India
899972,2023-10-29,204,strawberry yogurt,50,60,10,1,00068,India
157349,2023-10-29,203,mango yogurt,50,60,10,1,00275,India
157349,2023-10-29,209,pepsi,75,100,25,1,00275,India
157349,2023-10-29,202,milk,12,27,15,1,00275,India
701843,2023-10-29,204,strawberry yogurt,50,60,10,1,00307,India
701843,2023-10-29,206,yakult,360,400,40,1,00307,India
701843,2023-10-29,212,amul cheese,250,315,65,1,00307,India
511102,2023-10-29,201,paneer,210,340,130,1,00453,India
370774,2023-10-29,208,sprite,75,100,25,1,00476,India
370774,2023-10-29,207,coca cola,75,100,25,1,00476,India
370774,2023-10-29,203,mango yogurt,50,60,10,1,00476,India
370774,2023-10-29,201,paneer,210,340,130,1,00476,India
130965,2023-10-29,209,pepsi,75,100,25,1,00497,India
130965,2023-10-29,206,yakult,360,400,40,1,00497,India
130965,2023-10-29,213,bisleri,6,15,9,1,00497,India
130965,2023-10-29,202,milk,12,27,15,1,00497,India
616598,2023-10-29,208,sprite,75,100,25,1,00260,India
616598,2023-10-29,210,mountain dew,75,100,25,1,00260,India
616598,2023-10-29,213,bisleri,6,15,9,1,00260,India
448334,2023-10-29,211,red bull,90,125,35,1,00109,India
448334,2023-10-29,209,pepsi,75,100,25,1,00109,India
448334,2023-10-29,203,mango yogurt,50,60,10,1,00109,India
448334,2023-10-29,202,milk,12,27,15,1,00109,India
792236,2023-10-29,202,milk,12,27,15,1,00170,India
792236,2023-10-29,206,yakult,360,400,40,1,00170,India
792236,2023-10-29,209,pepsi,75,100,25,1,00170,India
782095,2023-10-29,211,red bull,90,125,35,1,00437,India
782095,2023-10-29,201,paneer,210,340,130,1,00437,India
304744,2023-10-29,208,sprite,75,100,25,1,00234,India
304744,2023-10-29,202,milk,12,27,15,1,00234,India
304744,2023-10-29,213,bisleri,6,15,9,1,00234,India
950438,2023-10-29,205,classic yogurt,45,60,15,1,00343,India
950438,2023-10-29,209,pepsi,75,100,25,1,00343,India
950438,2023-10-29,206,yakult,360,400,40,1,00343,India
634963,2023-10-29,204,strawberry yogurt,50,60,10,1,00424,India
634963,2023-10-29,212,amul cheese,250,315,65,1,00424,India
634963,2023-10-29,207,coca cola,75,100,25,1,00424,India
896074,2023-10-29,211,red bull,90,125,35,1,00225,India
896074,2023-10-29,213,bisleri,6,15,9,1,00225,India
896074,2023-10-29,202,milk,12,27,15,1,00225,India
725432,2023-10-29,207,coca cola,75,100,25,1,00317,India
725432,2023-10-29,209,pepsi,75,100,25,1,00317,India
864259,2023-10-29,209,pepsi,75,100,25,1,00455,India
864259,2023-10-29,201,paneer,210,340,130,1,00455,India
864259,2023-10-29,204,strawberry yogurt,50,60,10,1,00455,India
864259,2023-10-29,207,coca cola,75,100,25,1,00455,India
477294,2023-10-29,212,amul cheese,250,315,65,1,00191,India
477294,2023-10-29,203,mango yogurt,50,60,10,1,00191,India
477294,2023-10-29,210,mountain dew,75,100,25,1,00191,India
477294,2023-10-29,205,classic yogurt,45,60,15,1,00191,India
699556,2023-10-29,202,milk,12,27,15,1,00248,India
438247,2023-10-29,201,paneer,210,340,130,1,00411,India
438247,2023-10-29,212,amul cheese,250,315,65,1,00411,India
584929,2023-10-29,210,mountain dew,75,100,25,1,00181,India
584929,2023-10-29,202,milk,12,27,15,1,00181,India
584929,2023-10-29,205,classic yogurt,45,60,15,1,00181,India
666095,2023-10-29,203,mango yogurt,50,60,10,1,00118,India
666095,2023-10-29,209,pepsi,75,100,25,1,00118,India
666095,2023-10-29,210,mountain dew,75,100,25,1,00118,India
478865,2023-10-29,208,sprite,75,100,25,1,00232,India
478865,2023-10-29,206,yakult,360,400,40,1,00232,India
361821,2023-10-29,211,red bull,90,125,35,1,00185,India
361821,2023-10-29,210,mountain dew,75,100,25,1,00185,India
361821,2023-10-29,206,yakult,360,400,40,1,00185,India
361821,2023-10-29,213,bisleri,6,15,9,1,00185,India
578035,2023-10-29,206,yakult,360,400,40,1,00297,India
578035,2023-10-29,211,red bull,90,125,35,1,00297,India
578035,2023-10-29,207,coca cola,75,100,25,1,00297,India
578035,2023-10-29,201,paneer,210,340,130,1,00297,India
407796,2023-10-29,204,strawberry yogurt,50,60,10,1,00262,India
407796,2023-10-29,202,milk,12,27,15,1,00262,India
407796,2023-10-29,212,amul cheese,250,315,65,1,00262,India
407796,2023-10-29,205,classic yogurt,45,60,15,1,00262,India
407796,2023-10-29,210,mountain dew,75,100,25,1,00262,India
442063,2023-10-29,205,classic yogurt,45,60,15,1,00041,India
442063,2023-10-29,210,mountain dew,75,100,25,1,00041,India
500004,2023-10-29,209,pepsi,75,100,25,1,00232,India
500004,2023-10-29,213,bisleri,6,15,9,1,00232,India
551454,2023-10-29,206,yakult,360,400,40,1,00142,India
706938,2023-10-29,205,classic yogurt,45,60,15,1,00060,India
706938,2023-10-29,201,paneer,210,340,130,1,00060,India
706938,2023-10-29,202,milk,12,27,15,1,00060,India
556192,2023-10-29,205,classic yogurt,45,60,15,1,00404,India
556192,2023-10-29,204,strawberry yogurt,50,60,10,1,00404,India
556192,2023-10-29,211,red bull,90,125,35,1,00404,India
556192,2023-10-29,202,milk,12,27,15,1,00404,India
556192,2023-10-29,209,pepsi,75,100,25,1,00404,India
608983,2023-10-29,205,classic yogurt,45,60,15,1,00240,India
808300,2023-10-29,202,milk,12,27,15,1,00265,India
808300,2023-10-29,210,mountain dew,75,100,25,1,00265,India
808300,2023-10-29,205,classic yogurt,45,60,15,1,00265,India
804739,2023-10-29,203,mango yogurt,50,60,10,1,00053,India
804739,2023-10-29,204,strawberry yogurt,50,60,10,1,00053,India
804739,2023-10-29,202,milk,12,27,15,1,00053,India
804739,2023-10-29,201,paneer,210,340,130,1,00053,India
804739,2023-10-29,207,coca cola,75,100,25,1,00053,India
822120,2023-10-29,209,pepsi,75,100,25,1,00398,India
822120,2023-10-29,210,mountain dew,75,100,25,1,00398,India
822120,2023-10-29,204,strawberry yogurt,50,60,10,1,00398,India
780450,2023-10-29,201,paneer,210,340,130,1,00472,India
845619,2023-10-29,206,yakult,360,400,40,1,00082,India
845619,2023-10-29,212,amul cheese,250,315,65,1,00082,India
845619,2023-10-29,211,red bull,90,125,35,1,00082,India
935969,2023-10-29,206,yakult,360,400,40,1,00193,India
935969,2023-10-29,207,coca cola,75,100,25,1,00193,India
935969,2023-10-29,204,strawberry yogurt,50,60,10,1,00193,India
281496,2023-10-29,210,mountain dew,75,100,25,1,00317,India
281496,2023-10-29,212,amul cheese,250,315,65,1,00317,India
281496,2023-10-29,208,sprite,75,100,25,1,00317,India
281496,2023-10-29,202,milk,12,27,15,1,00317,India
281496,2023-10-29,206,yakult,360,400,40,1,00317,India
405500,2023-10-29,211,red bull,90,125,35,1,00488,India
405500,2023-10-29,208,sprite,75,100,25,1,00488,India
405500,2023-10-29,212,amul cheese,250,315,65,1,00488,India
985497,2023-10-29,202,milk,12,27,15,1,00168,India
985497,2023-10-29,213,bisleri,6,15,9,1,00168,India
849501,2023-10-29,206,yakult,360,400,40,1,00309,India
849501,2023-10-29,208,sprite,75,100,25,1,00309,India
263744,2023-10-29,210,mountain dew,75,100,25,1,00464,India
263744,2023-10-29,213,bisleri,6,15,9,1,00464,India
263744,2023-10-29,211,red bull,90,125,35,1,00464,India
263744,2023-10-29,205,classic yogurt,45,60,15,1,00464,India
596467,2023-10-29,206,yakult,360,400,40,1,00037,India
596467,2023-10-29,201,paneer,210,340,130,1,00037,India
596467,2023-10-29,205,classic yogurt,45,60,15,1,00037,India
596467,2023-10-29,203,mango yogurt,50,60,10,1,00037,India
964272,2023-10-29,203,mango yogurt,50,60,10,1,00432,India
964272,2023-10-29,206,yakult,360,400,40,1,00432,India
964272,2023-10-29,208,sprite,75,100,25,1,00432,India
185931,2023-10-29,202,milk,12,27,15,1,00159,India
201966,2023-10-29,210,mountain dew,75,100,25,1,00287,India
201966,2023-10-29,213,bisleri,6,15,9,1,00287,India
201966,2023-10-29,201,paneer,210,340,130,1,00287,India
784881,2023-10-29,207,coca cola,75,100,25,1,00012,India
784881,2023-10-29,201,paneer,210,340,130,1,00012,India
784881,2023-10-29,208,sprite,75,100,25,1,00012,India
784881,2023-10-29,206,yakult,360,400,40,1,00012,India
615564,2023-10-29,202,milk,12,27,15,1,00092,India
615564,2023-10-29,203,mango yogurt,50,60,10,1,00092,India
615564,2023-10-29,207,coca cola,75,100,25,1,00092,India
363683,2023-10-29,206,yakult,360,400,40,1,00037,India
639348,2023-10-29,210,mountain dew,75,100,25,1,00423,India
639348,2023-10-29,213,bisleri,6,15,9,1,00423,India
639348,2023-10-29,212,amul cheese,250,315,65,1,00423,India
691570,2023-10-30,205,classic yogurt,45,60,15,1,00318,India
691570,2023-10-30,212,amul cheese,250,315,65,1,00318,India
384271,2023-10-30,208,sprite,75,100,25,1,00485,India
384271,2023-10-30,203,mango yogurt,50,60,10,1,00485,India
384271,2023-10-30,202,milk,12,27,15,1,00485,India
384271,2023-10-30,213,bisleri,6,15,9,1,00485,India
872986,2023-10-30,209,pepsi,75,100,25,1,00289,India
872986,2023-10-30,210,mountain dew,75,100,25,1,00289,India
872986,2023-10-30,201,paneer,210,340,130,1,00289,India
530752,2023-10-30,205,classic yogurt,45,60,15,1,00081,India
530752,2023-10-30,211,red bull,90,125,35,1,00081,India
820169,2023-10-30,213,bisleri,6,15,9,1,00400,India
820169,2023-10-30,206,yakult,360,400,40,1,00400,India
820169,2023-10-30,210,mountain dew,75,100,25,1,00400,India
682493,2023-10-30,212,amul cheese,250,315,65,1,00235,India
682493,2023-10-30,207,coca cola,75,100,25,1,00235,India
682493,2023-10-30,213,bisleri,6,15,9,1,00235,India
135935,2023-10-30,210,mountain dew,75,100,25,1,00499,India
135935,2023-10-30,212,amul cheese,250,315,65,1,00499,India
135935,2023-10-30,203,mango yogurt,50,60,10,1,00499,India
219321,2023-10-30,206,yakult,360,400,40,1,00246,India
219321,2023-10-30,204,strawberry yogurt,50,60,10,1,00246,India
449947,2023-10-30,213,bisleri,6,15,9,1,00289,India
449947,2023-10-30,209,pepsi,75,100,25,1,00289,India
449947,2023-10-30,202,milk,12,27,15,1,00289,India
449947,2023-10-30,212,amul cheese,250,315,65,1,00289,India
449947,2023-10-30,206,yakult,360,400,40,1,00289,India
643787,2023-10-30,211,red bull,90,125,35,1,00364,India
643787,2023-10-30,213,bisleri,6,15,9,1,00364,India
643787,2023-10-30,206,yakult,360,400,40,1,00364,India
643787,2023-10-30,209,pepsi,75,100,25,1,00364,India
595093,2023-10-30,204,strawberry yogurt,50,60,10,1,00156,India
595093,2023-10-30,205,classic yogurt,45,60,15,1,00156,India
711134,2023-10-30,205,classic yogurt,45,60,15,1,00262,India
711134,2023-10-30,213,bisleri,6,15,9,1,00262,India
106122,2023-10-30,202,milk,12,27,15,1,00269,India
786728,2023-10-30,201,paneer,210,340,130,1,00018,India
786728,2023-10-30,209,pepsi,75,100,25,1,00018,India
786728,2023-10-30,203,mango yogurt,50,60,10,1,00018,India
924329,2023-10-30,209,pepsi,75,100,25,1,00081,India
994237,2023-10-30,213,bisleri,6,15,9,1,00046,India
994237,2023-10-30,212,amul cheese,250,315,65,1,00046,India
994237,2023-10-30,201,paneer,210,340,130,1,00046,India
327953,2023-10-30,206,yakult,360,400,40,1,00240,India
327953,2023-10-30,202,milk,12,27,15,1,00240,India
327953,2023-10-30,207,coca cola,75,100,25,1,00240,India
327953,2023-10-30,201,paneer,210,340,130,1,00240,India
327953,2023-10-30,208,sprite,75,100,25,1,00240,India
630339,2023-10-30,204,strawberry yogurt,50,60,10,1,00454,India
630339,2023-10-30,207,coca cola,75,100,25,1,00454,India
630339,2023-10-30,211,red bull,90,125,35,1,00454,India
630339,2023-10-30,210,mountain dew,75,100,25,1,00454,India
277123,2023-10-30,212,amul cheese,250,315,65,1,00261,India
277123,2023-10-30,202,milk,12,27,15,1,00261,India
601746,2023-10-30,201,paneer,210,340,130,1,00300,India
601746,2023-10-30,213,bisleri,6,15,9,1,00300,India
601746,2023-10-30,204,strawberry yogurt,50,60,10,1,00300,India
533082,2023-10-30,211,red bull,90,125,35,1,00163,India
106820,2023-10-30,207,coca cola,75,100,25,1,00341,India
106820,2023-10-30,206,yakult,360,400,40,1,00341,India
106820,2023-10-30,209,pepsi,75,100,25,1,00341,India
955861,2023-10-30,210,mountain dew,75,100,25,1,00351,India
955861,2023-10-30,206,yakult,360,400,40,1,00351,India
955861,2023-10-30,213,bisleri,6,15,9,1,00351,India
893876,2023-10-30,212,amul cheese,250,315,65,1,00423,India
893876,2023-10-30,202,milk,12,27,15,1,00423,India
893876,2023-10-30,208,sprite,75,100,25,1,00423,India
803091,2023-10-30,203,mango yogurt,50,60,10,1,00199,India
803091,2023-10-30,204,strawberry yogurt,50,60,10,1,00199,India
823075,2023-10-30,206,yakult,360,400,40,1,00102,India
823075,2023-10-30,210,mountain dew,75,100,25,1,00102,India
246935,2023-10-30,201,paneer,210,340,130,1,00464,India
246935,2023-10-30,207,coca cola,75,100,25,1,00464,India
982784,2023-10-30,213,bisleri,6,15,9,1,00300,India
982784,2023-10-30,205,classic yogurt,45,60,15,1,00300,India
982784,2023-10-30,208,sprite,75,100,25,1,00300,India
596624,2023-10-30,208,sprite,75,100,25,1,00394,India
596624,2023-10-30,210,mountain dew,75,100,25,1,00394,India
596624,2023-10-30,205,classic yogurt,45,60,15,1,00394,India
938390,2023-10-30,202,milk,12,27,15,1,00177,India
938390,2023-10-30,210,mountain dew,75,100,25,1,00177,India
938390,2023-10-30,205,classic yogurt,45,60,15,1,00177,India
938390,2023-10-30,213,bisleri,6,15,9,1,00177,India
216860,2023-10-30,212,amul cheese,250,315,65,1,00022,India
216860,2023-10-30,204,strawberry yogurt,50,60,10,1,00022,India
216860,2023-10-30,213,bisleri,6,15,9,1,00022,India
216860,2023-10-30,203,mango yogurt,50,60,10,1,00022,India
192666,2023-10-30,210,mountain dew,75,100,25,1,00496,India
192666,2023-10-30,206,yakult,360,400,40,1,00496,India
907360,2023-10-30,202,milk,12,27,15,1,00365,India
907360,2023-10-30,204,strawberry yogurt,50,60,10,1,00365,India
907360,2023-10-30,209,pepsi,75,100,25,1,00365,India
907360,2023-10-30,205,classic yogurt,45,60,15,1,00365,India
907360,2023-10-30,213,bisleri,6,15,9,1,00365,India
798711,2023-10-30,206,yakult,360,400,40,1,00008,India
798711,2023-10-30,201,paneer,210,340,130,1,00008,India
798711,2023-10-30,207,coca cola,75,100,25,1,00008,India
798711,2023-10-30,209,pepsi,75,100,25,1,00008,India
798711,2023-10-30,210,mountain dew,75,100,25,1,00008,India
534462,2023-10-30,211,red bull,90,125,35,1,00293,India
534462,2023-10-30,213,bisleri,6,15,9,1,00293,India
534462,2023-10-30,201,paneer,210,340,130,1,00293,India
682122,2023-10-30,212,amul cheese,250,315,65,1,00479,India
682122,2023-10-30,202,milk,12,27,15,1,00479,India
774686,2023-10-30,207,coca cola,75,100,25,1,00312,India
774686,2023-10-30,203,mango yogurt,50,60,10,1,00312,India
774686,2023-10-30,206,yakult,360,400,40,1,00312,India
774686,2023-10-30,202,milk,12,27,15,1,00312,India
774686,2023-10-30,201,paneer,210,340,130,1,00312,India
884785,2023-10-30,208,sprite,75,100,25,1,00168,India
681560,2023-10-30,205,classic yogurt,45,60,15,1,00249,India
681560,2023-10-30,211,red bull,90,125,35,1,00249,India
681560,2023-10-30,203,mango yogurt,50,60,10,1,00249,India
826911,2023-10-30,207,coca cola,75,100,25,1,00318,India
826911,2023-10-30,201,paneer,210,340,130,1,00318,India
826911,2023-10-30,206,yakult,360,400,40,1,00318,India
826911,2023-10-30,211,red bull,90,125,35,1,00318,India
693741,2023-10-30,212,amul cheese,250,315,65,1,00489,India
623253,2023-10-30,206,yakult,360,400,40,1,00013,India
623253,2023-10-30,212,amul cheese,250,315,65,1,00013,India
623253,2023-10-30,201,paneer,210,340,130,1,00013,India
623253,2023-10-30,211,red bull,90,125,35,1,00013,India
774201,2023-10-30,212,amul cheese,250,315,65,1,00363,India
774201,2023-10-30,205,classic yogurt,45,60,15,1,00363,India
774201,2023-10-30,213,bisleri,6,15,9,1,00363,India
774201,2023-10-30,203,mango yogurt,50,60,10,1,00363,India
319325,2023-10-30,209,pepsi,75,100,25,1,00381,India
509464,2023-10-30,204,strawberry yogurt,50,60,10,1,00201,India
509464,2023-10-30,208,sprite,75,100,25,1,00201,India
509464,2023-10-30,212,amul cheese,250,315,65,1,00201,India
324462,2023-10-30,201,paneer,210,340,130,1,00470,India
324462,2023-10-30,209,pepsi,75,100,25,1,00470,India
320697,2023-10-30,213,bisleri,6,15,9,1,00004,India
320697,2023-10-30,209,pepsi,75,100,25,1,00004,India
320697,2023-10-30,206,yakult,360,400,40,1,00004,India
320697,2023-10-30,207,coca cola,75,100,25,1,00004,India
320697,2023-10-30,212,amul cheese,250,315,65,1,00004,India
140265,2023-10-30,204,strawberry yogurt,50,60,10,1,00459,India
140265,2023-10-30,209,pepsi,75,100,25,1,00459,India
165991,2023-10-30,201,paneer,210,340,130,1,00286,India
165991,2023-10-30,206,yakult,360,400,40,1,00286,India
518841,2023-10-30,203,mango yogurt,50,60,10,1,00387,India
518841,2023-10-30,206,yakult,360,400,40,1,00387,India
518841,2023-10-30,210,mountain dew,75,100,25,1,00387,India
155600,2023-10-30,201,paneer,210,340,130,1,00358,India
155600,2023-10-30,204,strawberry yogurt,50,60,10,1,00358,India
155600,2023-10-30,202,milk,12,27,15,1,00358,India
155600,2023-10-30,210,mountain dew,75,100,25,1,00358,India
790692,2023-10-30,201,paneer,210,340,130,1,00188,India
790692,2023-10-30,207,coca cola,75,100,25,1,00188,India
501150,2023-10-30,203,mango yogurt,50,60,10,1,00479,India
336559,2023-10-30,213,bisleri,6,15,9,1,00072,India
336559,2023-10-30,206,yakult,360,400,40,1,00072,India
336559,2023-10-30,209,pepsi,75,100,25,1,00072,India
336559,2023-10-30,212,amul cheese,250,315,65,1,00072,India
336559,2023-10-30,204,strawberry yogurt,50,60,10,1,00072,India
566888,2023-10-30,204,strawberry yogurt,50,60,10,1,00200,India
566888,2023-10-30,210,mountain dew,75,100,25,1,00200,India
566888,2023-10-30,212,amul cheese,250,315,65,1,00200,India
566888,2023-10-30,205,classic yogurt,45,60,15,1,00200,India
237535,2023-10-30,213,bisleri,6,15,9,1,00217,India
237535,2023-10-30,211,red bull,90,125,35,1,00217,India
237535,2023-10-30,208,sprite,75,100,25,1,00217,India
237535,2023-10-30,203,mango yogurt,50,60,10,1,00217,India
744580,2023-10-30,209,pepsi,75,100,25,1,00011,India
744580,2023-10-30,211,red bull,90,125,35,1,00011,India
744580,2023-10-30,210,mountain dew,75,100,25,1,00011,India
744580,2023-10-30,203,mango yogurt,50,60,10,1,00011,India
228229,2023-10-30,211,red bull,90,125,35,1,00029,India
228229,2023-10-30,212,amul cheese,250,315,65,1,00029,India
228229,2023-10-30,208,sprite,75,100,25,1,00029,India
989136,2023-10-30,206,yakult,360,400,40,1,00328,India
989136,2023-10-30,210,mountain dew,75,100,25,1,00328,India
989136,2023-10-30,202,milk,12,27,15,1,00328,India
912907,2023-10-30,207,coca cola,75,100,25,1,00364,India
912907,2023-10-30,211,red bull,90,125,35,1,00364,India
460098,2023-10-30,204,strawberry yogurt,50,60,10,1,00137,India
879449,2023-10-30,212,amul cheese,250,315,65,1,00376,India
879449,2023-10-30,204,strawberry yogurt,50,60,10,1,00376,India
747650,2023-10-30,209,pepsi,75,100,25,1,00214,India
747650,2023-10-30,204,strawberry yogurt,50,60,10,1,00214,India
747650,2023-10-30,213,bisleri,6,15,9,1,00214,India
747650,2023-10-30,207,coca cola,75,100,25,1,00214,India
747650,2023-10-30,201,paneer,210,340,130,1,00214,India
472029,2023-10-30,213,bisleri,6,15,9,1,00315,India
472029,2023-10-30,211,red bull,90,125,35,1,00315,India
472029,2023-10-30,206,yakult,360,400,40,1,00315,India
472029,2023-10-30,210,mountain dew,75,100,25,1,00315,India
596660,2023-10-30,206,yakult,360,400,40,1,00219,India
596660,2023-10-30,207,coca cola,75,100,25,1,00219,India
596660,2023-10-30,202,milk,12,27,15,1,00219,India
596660,2023-10-30,213,bisleri,6,15,9,1,00219,India
435285,2023-10-30,206,yakult,360,400,40,1,00469,India
435285,2023-10-30,212,amul cheese,250,315,65,1,00469,India
435285,2023-10-30,204,strawberry yogurt,50,60,10,1,00469,India
435285,2023-10-30,201,paneer,210,340,130,1,00469,India
435285,2023-10-30,208,sprite,75,100,25,1,00469,India
741503,2023-10-30,212,amul cheese,250,315,65,1,00225,India
741503,2023-10-30,211,red bull,90,125,35,1,00225,India
741503,2023-10-30,201,paneer,210,340,130,1,00225,India
458734,2023-10-30,209,pepsi,75,100,25,1,00166,India
458734,2023-10-30,211,red bull,90,125,35,1,00166,India
458734,2023-10-30,201,paneer,210,340,130,1,00166,India
458734,2023-10-30,208,sprite,75,100,25,1,00166,India
458734,2023-10-30,213,bisleri,6,15,9,1,00166,India
287304,2023-10-30,212,amul cheese,250,315,65,1,00250,India
287304,2023-10-30,206,yakult,360,400,40,1,00250,India
287304,2023-10-30,208,sprite,75,100,25,1,00250,India
287304,2023-10-30,204,strawberry yogurt,50,60,10,1,00250,India
964208,2023-10-30,213,bisleri,6,15,9,1,00136,India
964208,2023-10-30,212,amul cheese,250,315,65,1,00136,India
964208,2023-10-30,211,red bull,90,125,35,1,00136,India
964208,2023-10-30,205,classic yogurt,45,60,15,1,00136,India
169180,2023-10-31,209,pepsi,75,100,25,1,00239,India
828035,2023-10-31,203,mango yogurt,50,60,10,1,00412,India
774368,2023-10-31,212,amul cheese,250,315,65,1,00047,India
774368,2023-10-31,210,mountain dew,75,100,25,1,00047,India
774368,2023-10-31,202,milk,12,27,15,1,00047,India
267208,2023-10-31,213,bisleri,6,15,9,1,00293,India
267208,2023-10-31,206,yakult,360,400,40,1,00293,India
267208,2023-10-31,201,paneer,210,340,130,1,00293,India
267208,2023-10-31,205,classic yogurt,45,60,15,1,00293,India
267208,2023-10-31,204,strawberry yogurt,50,60,10,1,00293,India
363778,2023-10-31,208,sprite,75,100,25,1,00293,India
363778,2023-10-31,210,mountain dew,75,100,25,1,00293,India
156396,2023-10-31,212,amul cheese,250,315,65,1,00346,India
914533,2023-10-31,202,milk,12,27,15,1,00044,India
914533,2023-10-31,212,amul cheese,250,315,65,1,00044,India
914533,2023-10-31,207,coca cola,75,100,25,1,00044,India
210112,2023-10-31,209,pepsi,75,100,25,1,00230,India
210112,2023-10-31,204,strawberry yogurt,50,60,10,1,00230,India
210112,2023-10-31,210,mountain dew,75,100,25,1,00230,India
210112,2023-10-31,203,mango yogurt,50,60,10,1,00230,India
210112,2023-10-31,206,yakult,360,400,40,1,00230,India
875237,2023-10-31,212,amul cheese,250,315,65,1,00168,India
875237,2023-10-31,210,mountain dew,75,100,25,1,00168,India
509158,2023-10-31,213,bisleri,6,15,9,1,00464,India
509158,2023-10-31,204,strawberry yogurt,50,60,10,1,00464,India
509158,2023-10-31,209,pepsi,75,100,25,1,00464,India
384599,2023-10-31,213,bisleri,6,15,9,1,00224,India
268164,2023-10-31,208,sprite,75,100,25,1,00307,India
180241,2023-10-31,203,mango yogurt,50,60,10,1,00149,India
298454,2023-10-31,203,mango yogurt,50,60,10,1,00219,India
298454,2023-10-31,204,strawberry yogurt,50,60,10,1,00219,India
665876,2023-10-31,201,paneer,210,340,130,1,00002,India
665876,2023-10-31,211,red bull,90,125,35,1,00002,India
665876,2023-10-31,213,bisleri,6,15,9,1,00002,India
629988,2023-10-31,208,sprite,75,100,25,1,00224,India
629988,2023-10-31,211,red bull,90,125,35,1,00224,India
799655,2023-10-31,207,coca cola,75,100,25,1,00144,India
799655,2023-10-31,211,red bull,90,125,35,1,00144,India
414369,2023-10-31,210,mountain dew,75,100,25,1,00185,India
414369,2023-10-31,202,milk,12,27,15,1,00185,India
414369,2023-10-31,213,bisleri,6,15,9,1,00185,India
549118,2023-10-31,205,classic yogurt,45,60,15,1,00361,India
549118,2023-10-31,208,sprite,75,100,25,1,00361,India
905013,2023-10-31,213,bisleri,6,15,9,1,00318,India
905013,2023-10-31,205,classic yogurt,45,60,15,1,00318,India
905013,2023-10-31,209,pepsi,75,100,25,1,00318,India
905013,2023-10-31,204,strawberry yogurt,50,60,10,1,00318,India
257638,2023-10-31,211,red bull,90,125,35,1,00205,India
257638,2023-10-31,204,strawberry yogurt,50,60,10,1,00205,India
257638,2023-10-31,207,coca cola,75,100,25,1,00205,India
257638,2023-10-31,203,mango yogurt,50,60,10,1,00205,India
856991,2023-10-31,204,strawberry yogurt,50,60,10,1,00481,India
856991,2023-10-31,205,classic yogurt,45,60,15,1,00481,India
455109,2023-10-31,211,red bull,90,125,35,1,00458,India
455109,2023-10-31,201,paneer,210,340,130,1,00458,India
455109,2023-10-31,205,classic yogurt,45,60,15,1,00458,India
739528,2023-10-31,205,classic yogurt,45,60,15,1,00253,India
739528,2023-10-31,206,yakult,360,400,40,1,00253,India
739528,2023-10-31,203,mango yogurt,50,60,10,1,00253,India
739528,2023-10-31,202,milk,12,27,15,1,00253,India
739528,2023-10-31,204,strawberry yogurt,50,60,10,1,00253,India
240041,2023-10-31,208,sprite,75,100,25,1,00314,India
240041,2023-10-31,209,pepsi,75,100,25,1,00314,India
983911,2023-10-31,209,pepsi,75,100,25,1,00248,India
398721,2023-10-31,205,classic yogurt,45,60,15,1,00077,India
398721,2023-10-31,213,bisleri,6,15,9,1,00077,India
398721,2023-10-31,204,strawberry yogurt,50,60,10,1,00077,India
277913,2023-10-31,205,classic yogurt,45,60,15,1,00084,India
277913,2023-10-31,204,strawberry yogurt,50,60,10,1,00084,India
277913,2023-10-31,206,yakult,360,400,40,1,00084,India
277913,2023-10-31,210,mountain dew,75,100,25,1,00084,India
277913,2023-10-31,208,sprite,75,100,25,1,00084,India
144020,2023-10-31,208,sprite,75,100,25,1,00125,India
144020,2023-10-31,204,strawberry yogurt,50,60,10,1,00125,India
714960,2023-10-31,207,coca cola,75,100,25,1,00109,India
714960,2023-10-31,203,mango yogurt,50,60,10,1,00109,India
374483,2023-10-31,210,mountain dew,75,100,25,1,00318,India
374483,2023-10-31,211,red bull,90,125,35,1,00318,India
374483,2023-10-31,213,bisleri,6,15,9,1,00318,India
374483,2023-10-31,208,sprite,75,100,25,1,00318,India
374483,2023-10-31,206,yakult,360,400,40,1,00318,India
401648,2023-10-31,202,milk,12,27,15,1,00492,India
401648,2023-10-31,203,mango yogurt,50,60,10,1,00492,India
401648,2023-10-31,209,pepsi,75,100,25,1,00492,India
401648,2023-10-31,210,mountain dew,75,100,25,1,00492,India
401648,2023-10-31,206,yakult,360,400,40,1,00492,India
233329,2023-10-31,207,coca cola,75,100,25,1,00041,India
233329,2023-10-31,209,pepsi,75,100,25,1,00041,India
731612,2023-10-31,208,sprite,75,100,25,1,00033,India
731612,2023-10-31,201,paneer,210,340,130,1,00033,India
934408,2023-10-31,212,amul cheese,250,315,65,1,00481,India
934408,2023-10-31,208,sprite,75,100,25,1,00481,India
215313,2023-10-31,201,paneer,210,340,130,1,00479,India
215313,2023-10-31,210,mountain dew,75,100,25,1,00479,India
215313,2023-10-31,205,classic yogurt,45,60,15,1,00479,India
215313,2023-10-31,206,yakult,360,400,40,1,00479,India
937554,2023-10-31,209,pepsi,75,100,25,1,00190,India
937554,2023-10-31,201,paneer,210,340,130,1,00190,India
937554,2023-10-31,213,bisleri,6,15,9,1,00190,India
937554,2023-10-31,206,yakult,360,400,40,1,00190,India
415296,2023-10-31,212,amul cheese,250,315,65,1,00169,India
415296,2023-10-31,211,red bull,90,125,35,1,00169,India
415296,2023-10-31,204,strawberry yogurt,50,60,10,1,00169,India
415296,2023-10-31,203,mango yogurt,50,60,10,1,00169,India
415296,2023-10-31,209,pepsi,75,100,25,1,00169,India
345337,2023-10-31,204,strawberry yogurt,50,60,10,1,00072,India
345337,2023-10-31,211,red bull,90,125,35,1,00072,India
345337,2023-10-31,209,pepsi,75,100,25,1,00072,India
345337,2023-10-31,203,mango yogurt,50,60,10,1,00072,India
355763,2023-10-31,211,red bull,90,125,35,1,00079,India
733260,2023-10-31,208,sprite,75,100,25,1,00246,India
733260,2023-10-31,207,coca cola,75,100,25,1,00246,India
156518,2023-10-31,212,amul cheese,250,315,65,1,00001,India
156518,2023-10-31,211,red bull,90,125,35,1,00001,India
156518,2023-10-31,206,yakult,360,400,40,1,00001,India
142741,2023-10-31,208,sprite,75,100,25,1,00358,India
352981,2023-10-31,202,milk,12,27,15,1,00082,India
329908,2023-10-31,202,milk,12,27,15,1,00307,India
329908,2023-10-31,211,red bull,90,125,35,1,00307,India
329908,2023-10-31,203,mango yogurt,50,60,10,1,00307,India
329908,2023-10-31,213,bisleri,6,15,9,1,00307,India
408013,2023-10-31,209,pepsi,75,100,25,1,00273,India
408013,2023-10-31,208,sprite,75,100,25,1,00273,India
788737,2023-10-31,210,mountain dew,75,100,25,1,00090,India
788737,2023-10-31,213,bisleri,6,15,9,1,00090,India
788737,2023-10-31,201,paneer,210,340,130,1,00090,India
644588,2023-10-31,209,pepsi,75,100,25,1,00148,India
644588,2023-10-31,201,paneer,210,340,130,1,00148,India
644588,2023-10-31,202,milk,12,27,15,1,00148,India
644588,2023-10-31,205,classic yogurt,45,60,15,1,00148,India
192341,2023-10-31,202,milk,12,27,15,1,00179,India
192341,2023-10-31,207,coca cola,75,100,25,1,00179,India
192341,2023-10-31,204,strawberry yogurt,50,60,10,1,00179,India
875674,2023-10-31,204,strawberry yogurt,50,60,10,1,00133,India
875674,2023-10-31,213,bisleri,6,15,9,1,00133,India
875674,2023-10-31,211,red bull,90,125,35,1,00133,India
875674,2023-10-31,209,pepsi,75,100,25,1,00133,India
875674,2023-10-31,203,mango yogurt,50,60,10,1,00133,India
441201,2023-10-31,207,coca cola,75,100,25,1,00335,India
441201,2023-10-31,201,paneer,210,340,130,1,00335,India
441201,2023-10-31,213,bisleri,6,15,9,1,00335,India
973349,2023-10-31,212,amul cheese,250,315,65,1,00058,India
973349,2023-10-31,205,classic yogurt,45,60,15,1,00058,India
973349,2023-10-31,211,red bull,90,125,35,1,00058,India
973349,2023-10-31,202,milk,12,27,15,1,00058,India
851091,2023-10-31,208,sprite,75,100,25,1,00427,India
851091,2023-10-31,203,mango yogurt,50,60,10,1,00427,India
851091,2023-10-31,209,pepsi,75,100,25,1,00427,India
851091,2023-10-31,211,red bull,90,125,35,1,00427,India
851091,2023-10-31,201,paneer,210,340,130,1,00427,India
237355,2023-10-31,202,milk,12,27,15,1,00006,India
237355,2023-10-31,207,coca cola,75,100,25,1,00006,India
237355,2023-10-31,208,sprite,75,100,25,1,00006,India
237355,2023-10-31,206,yakult,360,400,40,1,00006,India
236893,2023-10-31,209,pepsi,75,100,25,1,00027,India
231937,2023-10-31,204,strawberry yogurt,50,60,10,1,00020,India
231937,2023-10-31,207,coca cola,75,100,25,1,00020,India
484970,2023-10-31,202,milk,12,27,15,1,00182,India
484970,2023-10-31,204,strawberry yogurt,50,60,10,1,00182,India
484970,2023-10-31,201,paneer,210,340,130,1,00182,India
484970,2023-10-31,213,bisleri,6,15,9,1,00182,India
484970,2023-10-31,210,mountain dew,75,100,25,1,00182,India
838139,2023-10-31,201,paneer,210,340,130,1,00340,India
838139,2023-10-31,205,classic yogurt,45,60,15,1,00340,India
838139,2023-10-31,209,pepsi,75,100,25,1,00340,India
245351,2023-10-31,203,mango yogurt,50,60,10,1,00431,India
245351,2023-10-31,206,yakult,360,400,40,1,00431,India
245351,2023-10-31,211,red bull,90,125,35,1,00431,India
245351,2023-10-31,212,amul cheese,250,315,65,1,00431,India
222629,2023-10-31,210,mountain dew,75,100,25,1,00315,India
222629,2023-10-31,211,red bull,90,125,35,1,00315,India
741689,2023-10-31,209,pepsi,75,100,25,1,00399,India
741689,2023-10-31,203,mango yogurt,50,60,10,1,00399,India
741689,2023-10-31,206,yakult,360,400,40,1,00399,India
945580,2023-10-31,203,mango yogurt,50,60,10,1,00419,India
945580,2023-10-31,212,amul cheese,250,315,65,1,00419,India
658601,2023-10-31,211,red bull,90,125,35,1,00023,India
658601,2023-10-31,208,sprite,75,100,25,1,00023,India
658601,2023-10-31,206,yakult,360,400,40,1,00023,India
658601,2023-10-31,205,classic yogurt,45,60,15,1,00023,India
797996,2023-10-31,203,mango yogurt,50,60,10,1,00471,India
797996,2023-10-31,201,paneer,210,340,130,1,00471,India
797996,2023-10-31,207,coca cola,75,100,25,1,00471,India
805761,2023-10-31,208,sprite,75,100,25,1,00497,India
136518,2023-10-31,213,bisleri,6,15,9,1,00063,India
958222,2023-10-31,207,coca cola,75,100,25,1,00356,India
389417,2023-10-31,201,paneer,210,340,130,1,00396,India
389417,2023-10-31,213,bisleri,6,15,9,1,00396,India
389417,2023-10-31,208,sprite,75,100,25,1,00396,India
223098,2023-10-31,201,paneer,210,340,130,1,00413,India
223098,2023-10-31,204,strawberry yogurt,50,60,10,1,00413,India
421072,2023-10-31,203,mango yogurt,50,60,10,1,00226,India
421072,2023-10-31,209,pepsi,75,100,25,1,00226,India
421072,2023-10-31,202,milk,12,27,15,1,00226,India
702894,2023-10-31,201,paneer,210,340,130,1,00367,India
691499,2023-10-31,206,yakult,360,400,40,1,00273,India
507029,2023-10-31,202,milk,12,27,15,1,00209,India
507029,2023-10-31,206,yakult,360,400,40,1,00209,India
507029,2023-10-31,213,bisleri,6,15,9,1,00209,India
964305,2023-10-31,205,classic yogurt,45,60,15,1,00448,India
964305,2023-10-31,207,coca cola,75,100,25,1,00448,India
385787,2023-10-31,205,classic yogurt,45,60,15,1,00439,India
385787,2023-10-31,213,bisleri,6,15,9,1,00439,India
385787,2023-10-31,202,milk,12,27,15,1,00439,India
814286,2023-10-31,210,mountain dew,75,100,25,1,00459,India
814286,2023-10-31,207,coca cola,75,100,25,1,00459,India
814286,2023-10-31,208,sprite,75,100,25,1,00459,India
929499,2023-10-31,212,amul cheese,250,315,65,1,00034,India
886520,2023-11-01,207,coca cola,75,100,25,1,00255,India
886520,2023-11-01,206,yakult,360,400,40,1,00255,India
886520,2023-11-01,208,sprite,75,100,25,1,00255,India
513719,2023-11-01,213,bisleri,6,15,9,1,00481,India
490097,2023-11-01,208,sprite,75,100,25,1,00175,India
490097,2023-11-01,212,amul cheese,250,315,65,1,00175,India
490097,2023-11-01,211,red bull,90,125,35,1,00175,India
490097,2023-11-01,201,paneer,210,340,130,1,00175,India
524610,2023-11-01,211,red bull,90,125,35,1,00135,India
524610,2023-11-01,212,amul cheese,250,315,65,1,00135,India
934297,2023-11-01,201,paneer,210,340,130,1,00181,India
656681,2023-11-01,202,milk,12,27,15,1,00032,India
656681,2023-11-01,205,classic yogurt,45,60,15,1,00032,India
656681,2023-11-01,208,sprite,75,100,25,1,00032,India
743124,2023-11-01,206,yakult,360,400,40,1,00360,India
338817,2023-11-01,209,pepsi,75,100,25,1,00022,India
407847,2023-11-01,206,yakult,360,400,40,1,00164,India
407847,2023-11-01,205,classic yogurt,45,60,15,1,00164,India
568435,2023-11-01,205,classic yogurt,45,60,15,1,00290,India
568435,2023-11-01,202,milk,12,27,15,1,00290,India
157041,2023-11-01,206,yakult,360,400,40,1,00423,India
157041,2023-11-01,209,pepsi,75,100,25,1,00423,India
465570,2023-11-01,208,sprite,75,100,25,1,00379,India
465570,2023-11-01,203,mango yogurt,50,60,10,1,00379,India
465570,2023-11-01,205,classic yogurt,45,60,15,1,00379,India
465570,2023-11-01,210,mountain dew,75,100,25,1,00379,India
465570,2023-11-01,207,coca cola,75,100,25,1,00379,India
642183,2023-11-01,213,bisleri,6,15,9,1,00409,India
642183,2023-11-01,201,paneer,210,340,130,1,00409,India
530993,2023-11-01,212,amul cheese,250,315,65,1,00354,India
422060,2023-11-01,203,mango yogurt,50,60,10,1,00438,India
422060,2023-11-01,212,amul cheese,250,315,65,1,00438,India
422060,2023-11-01,205,classic yogurt,45,60,15,1,00438,India
511338,2023-11-01,205,classic yogurt,45,60,15,1,00105,India
511338,2023-11-01,207,coca cola,75,100,25,1,00105,India
960815,2023-11-01,211,red bull,90,125,35,1,00306,India
960815,2023-11-01,213,bisleri,6,15,9,1,00306,India
960815,2023-11-01,204,strawberry yogurt,50,60,10,1,00306,India
960815,2023-11-01,201,paneer,210,340,130,1,00306,India
195022,2023-11-01,209,pepsi,75,100,25,1,00290,India
774393,2023-11-01,212,amul cheese,250,315,65,1,00041,India
774393,2023-11-01,209,pepsi,75,100,25,1,00041,India
774393,2023-11-01,206,yakult,360,400,40,1,00041,India
260837,2023-11-01,206,yakult,360,400,40,1,00262,India
260837,2023-11-01,212,amul cheese,250,315,65,1,00262,India
260837,2023-11-01,201,paneer,210,340,130,1,00262,India
141431,2023-11-01,201,paneer,210,340,130,1,00455,India
141431,2023-11-01,208,sprite,75,100,25,1,00455,India
141431,2023-11-01,203,mango yogurt,50,60,10,1,00455,India
141431,2023-11-01,209,pepsi,75,100,25,1,00455,India
679840,2023-11-01,206,yakult,360,400,40,1,00279,India
169151,2023-11-01,213,bisleri,6,15,9,1,00372,India
435495,2023-11-01,201,paneer,210,340,130,1,00089,India
435495,2023-11-01,212,amul cheese,250,315,65,1,00089,India
435495,2023-11-01,210,mountain dew,75,100,25,1,00089,India
499687,2023-11-01,209,pepsi,75,100,25,1,00475,India
499687,2023-11-01,206,yakult,360,400,40,1,00475,India
499687,2023-11-01,213,bisleri,6,15,9,1,00475,India
499687,2023-11-01,210,mountain dew,75,100,25,1,00475,India
713918,2023-11-01,205,classic yogurt,45,60,15,1,00242,India
713918,2023-11-01,203,mango yogurt,50,60,10,1,00242,India
393263,2023-11-01,209,pepsi,75,100,25,1,00225,India
393263,2023-11-01,201,paneer,210,340,130,1,00225,India
393263,2023-11-01,212,amul cheese,250,315,65,1,00225,India
393263,2023-11-01,211,red bull,90,125,35,1,00225,India
166432,2023-11-01,201,paneer,210,340,130,1,00278,India
166432,2023-11-01,206,yakult,360,400,40,1,00278,India
166432,2023-11-01,204,strawberry yogurt,50,60,10,1,00278,India
579922,2023-11-01,203,mango yogurt,50,60,10,1,00138,India
579922,2023-11-01,210,mountain dew,75,100,25,1,00138,India
579922,2023-11-01,207,coca cola,75,100,25,1,00138,India
336516,2023-11-01,208,sprite,75,100,25,1,00486,India
336516,2023-11-01,210,mountain dew,75,100,25,1,00486,India
135212,2023-11-01,210,mountain dew,75,100,25,1,00160,India
501217,2023-11-01,212,amul cheese,250,315,65,1,00024,India
501217,2023-11-01,201,paneer,210,340,130,1,00024,India
501217,2023-11-01,213,bisleri,6,15,9,1,00024,India
386006,2023-11-01,212,amul cheese,250,315,65,1,00122,India
386006,2023-11-01,207,coca cola,75,100,25,1,00122,India
484119,2023-11-01,211,red bull,90,125,35,1,00355,India
484119,2023-11-01,213,bisleri,6,15,9,1,00355,India
484119,2023-11-01,206,yakult,360,400,40,1,00355,India
484119,2023-11-01,202,milk,12,27,15,1,00355,India
429671,2023-11-01,209,pepsi,75,100,25,1,00230,India
429671,2023-11-01,201,paneer,210,340,130,1,00230,India
429671,2023-11-01,211,red bull,90,125,35,1,00230,India
250551,2023-11-01,206,yakult,360,400,40,1,00031,India
250551,2023-11-01,213,bisleri,6,15,9,1,00031,India
250551,2023-11-01,204,strawberry yogurt,50,60,10,1,00031,India
473599,2023-11-01,209,pepsi,75,100,25,1,00089,India
473599,2023-11-01,205,classic yogurt,45,60,15,1,00089,India
473599,2023-11-01,202,milk,12,27,15,1,00089,India
473599,2023-11-01,212,amul cheese,250,315,65,1,00089,India
107300,2023-11-01,203,mango yogurt,50,60,10,1,00329,India
107300,2023-11-01,205,classic yogurt,45,60,15,1,00329,India
583374,2023-11-01,211,red bull,90,125,35,1,00363,India
583374,2023-11-01,202,milk,12,27,15,1,00363,India
583374,2023-11-01,203,mango yogurt,50,60,10,1,00363,India
987389,2023-11-01,205,classic yogurt,45,60,15,1,00431,India
987389,2023-11-01,207,coca cola,75,100,25,1,00431,India
987389,2023-11-01,206,yakult,360,400,40,1,00431,India
987389,2023-11-01,210,mountain dew,75,100,25,1,00431,India
389767,2023-11-01,211,red bull,90,125,35,1,00198,India
389767,2023-11-01,206,yakult,360,400,40,1,00198,India
389767,2023-11-01,213,bisleri,6,15,9,1,00198,India
389767,2023-11-01,205,classic yogurt,45,60,15,1,00198,India
389767,2023-11-01,203,mango yogurt,50,60,10,1,00198,India
212189,2023-11-01,208,sprite,75,100,25,1,00382,India
212189,2023-11-01,204,strawberry yogurt,50,60,10,1,00382,India
212189,2023-11-01,213,bisleri,6,15,9,1,00382,India
212189,2023-11-01,203,mango yogurt,50,60,10,1,00382,India
515849,2023-11-01,208,sprite,75,100,25,1,00254,India
515849,2023-11-01,202,milk,12,27,15,1,00254,India
515849,2023-11-01,206,yakult,360,400,40,1,00254,India
283102,2023-11-01,208,sprite,75,100,25,1,00129,India
283102,2023-11-01,213,bisleri,6,15,9,1,00129,India
938142,2023-11-01,210,mountain dew,75,100,25,1,00334,India
938142,2023-11-01,207,coca cola,75,100,25,1,00334,India
938142,2023-11-01,205,classic yogurt,45,60,15,1,00334,India
281051,2023-11-01,209,pepsi,75,100,25,1,00409,India
281051,2023-11-01,213,bisleri,6,15,9,1,00409,India
281051,2023-11-01,206,yakult,360,400,40,1,00409,India
545137,2023-11-01,201,paneer,210,340,130,1,00422,India
108335,2023-11-01,208,sprite,75,100,25,1,00204,India
108335,2023-11-01,201,paneer,210,340,130,1,00204,India
429646,2023-11-01,213,bisleri,6,15,9,1,00475,India
429646,2023-11-01,203,mango yogurt,50,60,10,1,00475,India
768453,2023-11-01,208,sprite,75,100,25,1,00172,India
704122,2023-11-01,211,red bull,90,125,35,1,00041,India
704122,2023-11-01,205,classic yogurt,45,60,15,1,00041,India
704122,2023-11-01,201,paneer,210,340,130,1,00041,India
520593,2023-11-01,206,yakult,360,400,40,1,00473,India
520593,2023-11-01,209,pepsi,75,100,25,1,00473,India
520593,2023-11-01,201,paneer,210,340,130,1,00473,India
520593,2023-11-01,204,strawberry yogurt,50,60,10,1,00473,India
567537,2023-11-01,207,coca cola,75,100,25,1,00395,India
567537,2023-11-01,204,strawberry yogurt,50,60,10,1,00395,India
502068,2023-11-01,209,pepsi,75,100,25,1,00418,India
502068,2023-11-01,208,sprite,75,100,25,1,00418,India
502068,2023-11-01,213,bisleri,6,15,9,1,00418,India
502068,2023-11-01,203,mango yogurt,50,60,10,1,00418,India
631782,2023-11-01,202,milk,12,27,15,1,00135,India
631782,2023-11-01,212,amul cheese,250,315,65,1,00135,India
527277,2023-11-01,204,strawberry yogurt,50,60,10,1,00089,India
527277,2023-11-01,203,mango yogurt,50,60,10,1,00089,India
527277,2023-11-01,206,yakult,360,400,40,1,00089,India
527277,2023-11-01,207,coca cola,75,100,25,1,00089,India
466453,2023-11-01,205,classic yogurt,45,60,15,1,00392,India
466453,2023-11-01,206,yakult,360,400,40,1,00392,India
268693,2023-11-01,202,milk,12,27,15,1,00160,India
715445,2023-11-01,212,amul cheese,250,315,65,1,00159,India
715445,2023-11-01,207,coca cola,75,100,25,1,00159,India
715445,2023-11-01,210,mountain dew,75,100,25,1,00159,India
715445,2023-11-01,205,classic yogurt,45,60,15,1,00159,India
197858,2023-11-01,209,pepsi,75,100,25,1,00377,India
281065,2023-11-01,202,milk,12,27,15,1,00327,India
281065,2023-11-01,207,coca cola,75,100,25,1,00327,India
281065,2023-11-01,208,sprite,75,100,25,1,00327,India
281065,2023-11-01,212,amul cheese,250,315,65,1,00327,India
281065,2023-11-01,204,strawberry yogurt,50,60,10,1,00327,India
506900,2023-11-01,203,mango yogurt,50,60,10,1,00280,India
506900,2023-11-01,210,mountain dew,75,100,25,1,00280,India
506900,2023-11-01,209,pepsi,75,100,25,1,00280,India
729534,2023-11-01,211,red bull,90,125,35,1,00029,India
729534,2023-11-01,205,classic yogurt,45,60,15,1,00029,India
729534,2023-11-01,201,paneer,210,340,130,1,00029,India
729534,2023-11-01,212,amul cheese,250,315,65,1,00029,India
727377,2023-11-01,207,coca cola,75,100,25,1,00361,India
727377,2023-11-01,213,bisleri,6,15,9,1,00361,India
727377,2023-11-01,203,mango yogurt,50,60,10,1,00361,India
727377,2023-11-01,212,amul cheese,250,315,65,1,00361,India
727377,2023-11-01,211,red bull,90,125,35,1,00361,India
992598,2023-11-01,211,red bull,90,125,35,1,00038,India
992598,2023-11-01,205,classic yogurt,45,60,15,1,00038,India
992598,2023-11-01,209,pepsi,75,100,25,1,00038,India
992598,2023-11-01,202,milk,12,27,15,1,00038,India
316454,2023-11-01,203,mango yogurt,50,60,10,1,00262,India
316454,2023-11-01,205,classic yogurt,45,60,15,1,00262,India
831211,2023-11-01,211,red bull,90,125,35,1,00011,India
320168,2023-11-01,204,strawberry yogurt,50,60,10,1,00418,India
320168,2023-11-01,213,bisleri,6,15,9,1,00418,India
320168,2023-11-01,211,red bull,90,125,35,1,00418,India
320168,2023-11-01,205,classic yogurt,45,60,15,1,00418,India
320168,2023-11-01,207,coca cola,75,100,25,1,00418,India
222120,2023-11-01,208,sprite,75,100,25,1,00327,India
222120,2023-11-01,212,amul cheese,250,315,65,1,00327,India
971026,2023-11-01,209,pepsi,75,100,25,1,00327,India
971026,2023-11-01,201,paneer,210,340,130,1,00327,India
852985,2023-11-01,209,pepsi,75,100,25,1,00111,India
175043,2023-11-01,207,coca cola,75,100,25,1,00451,India
175043,2023-11-01,202,milk,12,27,15,1,00451,India
175043,2023-11-01,208,sprite,75,100,25,1,00451,India
232024,2023-11-01,203,mango yogurt,50,60,10,1,00472,India
657737,2023-11-01,208,sprite,75,100,25,1,00424,India
352456,2023-11-01,204,strawberry yogurt,50,60,10,1,00395,India
352456,2023-11-01,206,yakult,360,400,40,1,00395,India
352456,2023-11-01,209,pepsi,75,100,25,1,00395,India
499359,2023-11-01,205,classic yogurt,45,60,15,1,00313,India
499359,2023-11-01,211,red bull,90,125,35,1,00313,India
499359,2023-11-01,213,bisleri,6,15,9,1,00313,India
499359,2023-11-01,210,mountain dew,75,100,25,1,00313,India
398373,2023-11-01,213,bisleri,6,15,9,1,00314,India
398373,2023-11-01,205,classic yogurt,45,60,15,1,00314,India
398373,2023-11-01,201,paneer,210,340,130,1,00314,India
398373,2023-11-01,206,yakult,360,400,40,1,00314,India
443971,2023-11-01,205,classic yogurt,45,60,15,1,00308,India
443971,2023-11-01,209,pepsi,75,100,25,1,00308,India
206320,2023-11-01,212,amul cheese,250,315,65,1,00180,India
206320,2023-11-01,213,bisleri,6,15,9,1,00180,India
206320,2023-11-01,203,mango yogurt,50,60,10,1,00180,India
206320,2023-11-01,210,mountain dew,75,100,25,1,00180,India
764082,2023-11-01,204,strawberry yogurt,50,60,10,1,00097,India
764082,2023-11-01,202,milk,12,27,15,1,00097,India
764082,2023-11-01,211,red bull,90,125,35,1,00097,India
764082,2023-11-01,206,yakult,360,400,40,1,00097,India
280239,2023-11-01,201,paneer,210,340,130,1,00238,India
332761,2023-11-01,211,red bull,90,125,35,1,00108,India
332761,2023-11-01,205,classic yogurt,45,60,15,1,00108,India
332761,2023-11-01,203,mango yogurt,50,60,10,1,00108,India
332761,2023-11-01,206,yakult,360,400,40,1,00108,India
671664,2023-11-01,212,amul cheese,250,315,65,1,00292,India
671664,2023-11-01,203,mango yogurt,50,60,10,1,00292,India
671664,2023-11-01,208,sprite,75,100,25,1,00292,India
818590,2023-11-01,205,classic yogurt,45,60,15,1,00482,India
818590,2023-11-01,212,amul cheese,250,315,65,1,00482,India
885746,2023-11-01,203,mango yogurt,50,60,10,1,00206,India
885746,2023-11-01,211,red bull,90,125,35,1,00206,India
885746,2023-11-01,205,classic yogurt,45,60,15,1,00206,India
885746,2023-11-01,213,bisleri,6,15,9,1,00206,India
630507,2023-11-01,211,red bull,90,125,35,1,00456,India
630507,2023-11-01,209,pepsi,75,100,25,1,00456,India
630507,2023-11-01,201,paneer,210,340,130,1,00456,India
630507,2023-11-01,208,sprite,75,100,25,1,00456,India
630507,2023-11-01,202,milk,12,27,15,1,00456,India
954714,2023-11-02,210,mountain dew,75,100,25,1,00296,India
954714,2023-11-02,209,pepsi,75,100,25,1,00296,India
954714,2023-11-02,206,yakult,360,400,40,1,00296,India
954714,2023-11-02,213,bisleri,6,15,9,1,00296,India
156588,2023-11-02,201,paneer,210,340,130,1,00437,India
156588,2023-11-02,205,classic yogurt,45,60,15,1,00437,India
156588,2023-11-02,207,coca cola,75,100,25,1,00437,India
156588,2023-11-02,202,milk,12,27,15,1,00437,India
984717,2023-11-02,204,strawberry yogurt,50,60,10,1,00047,India
984717,2023-11-02,201,paneer,210,340,130,1,00047,India
383269,2023-11-02,202,milk,12,27,15,1,00228,India
383269,2023-11-02,208,sprite,75,100,25,1,00228,India
561946,2023-11-02,210,mountain dew,75,100,25,1,00482,India
561946,2023-11-02,207,coca cola,75,100,25,1,00482,India
561946,2023-11-02,212,amul cheese,250,315,65,1,00482,India
612159,2023-11-02,202,milk,12,27,15,1,00020,India
612159,2023-11-02,210,mountain dew,75,100,25,1,00020,India
612159,2023-11-02,201,paneer,210,340,130,1,00020,India
685473,2023-11-02,209,pepsi,75,100,25,1,00003,India
685473,2023-11-02,201,paneer,210,340,130,1,00003,India
685473,2023-11-02,212,amul cheese,250,315,65,1,00003,India
685473,2023-11-02,203,mango yogurt,50,60,10,1,00003,India
326963,2023-11-02,210,mountain dew,75,100,25,1,00019,India
326963,2023-11-02,206,yakult,360,400,40,1,00019,India
326963,2023-11-02,213,bisleri,6,15,9,1,00019,India
142447,2023-11-02,206,yakult,360,400,40,1,00384,India
142447,2023-11-02,207,coca cola,75,100,25,1,00384,India
142447,2023-11-02,204,strawberry yogurt,50,60,10,1,00384,India
142447,2023-11-02,201,paneer,210,340,130,1,00384,India
420028,2023-11-02,211,red bull,90,125,35,1,00085,India
420028,2023-11-02,213,bisleri,6,15,9,1,00085,India
774462,2023-11-02,208,sprite,75,100,25,1,00063,India
774462,2023-11-02,213,bisleri,6,15,9,1,00063,India
774462,2023-11-02,210,mountain dew,75,100,25,1,00063,India
774462,2023-11-02,211,red bull,90,125,35,1,00063,India
472669,2023-11-02,204,strawberry yogurt,50,60,10,1,00450,India
472669,2023-11-02,207,coca cola,75,100,25,1,00450,India
472669,2023-11-02,212,amul cheese,250,315,65,1,00450,India
711772,2023-11-02,208,sprite,75,100,25,1,00299,India
711772,2023-11-02,212,amul cheese,250,315,65,1,00299,India
711772,2023-11-02,205,classic yogurt,45,60,15,1,00299,India
747522,2023-11-02,210,mountain dew,75,100,25,1,00366,India
747522,2023-11-02,206,yakult,360,400,40,1,00366,India
747522,2023-11-02,211,red bull,90,125,35,1,00366,India
689104,2023-11-02,208,sprite,75,100,25,1,00247,India
689104,2023-11-02,201,paneer,210,340,130,1,00247,India
763134,2023-11-02,205,classic yogurt,45,60,15,1,00470,India
763134,2023-11-02,207,coca cola,75,100,25,1,00470,India
790149,2023-11-02,206,yakult,360,400,40,1,00419,India
790149,2023-11-02,212,amul cheese,250,315,65,1,00419,India
790149,2023-11-02,213,bisleri,6,15,9,1,00419,India
201647,2023-11-02,202,milk,12,27,15,1,00376,India
201647,2023-11-02,207,coca cola,75,100,25,1,00376,India
114406,2023-11-02,210,mountain dew,75,100,25,1,00489,India
114406,2023-11-02,211,red bull,90,125,35,1,00489,India
120601,2023-11-02,204,strawberry yogurt,50,60,10,1,00488,India
936448,2023-11-02,213,bisleri,6,15,9,1,00272,India
936448,2023-11-02,208,sprite,75,100,25,1,00272,India
936448,2023-11-02,210,mountain dew,75,100,25,1,00272,India
379834,2023-11-02,203,mango yogurt,50,60,10,1,00406,India
379834,2023-11-02,207,coca cola,75,100,25,1,00406,India
379834,2023-11-02,205,classic yogurt,45,60,15,1,00406,India
379834,2023-11-02,210,mountain dew,75,100,25,1,00406,India
514709,2023-11-02,202,milk,12,27,15,1,00187,India
514709,2023-11-02,204,strawberry yogurt,50,60,10,1,00187,India
514709,2023-11-02,210,mountain dew,75,100,25,1,00187,India
514709,2023-11-02,203,mango yogurt,50,60,10,1,00187,India
935244,2023-11-02,202,milk,12,27,15,1,00471,India
935244,2023-11-02,204,strawberry yogurt,50,60,10,1,00471,India
146311,2023-11-02,201,paneer,210,340,130,1,00458,India
146311,2023-11-02,209,pepsi,75,100,25,1,00458,India
146311,2023-11-02,203,mango yogurt,50,60,10,1,00458,India
323514,2023-11-02,203,mango yogurt,50,60,10,1,00318,India
323514,2023-11-02,210,mountain dew,75,100,25,1,00318,India
323514,2023-11-02,204,strawberry yogurt,50,60,10,1,00318,India
323514,2023-11-02,207,coca cola,75,100,25,1,00318,India
889705,2023-11-02,209,pepsi,75,100,25,1,00500,India
889705,2023-11-02,211,red bull,90,125,35,1,00500,India
889705,2023-11-02,205,classic yogurt,45,60,15,1,00500,India
845305,2023-11-02,204,strawberry yogurt,50,60,10,1,00127,India
845305,2023-11-02,210,mountain dew,75,100,25,1,00127,India
845305,2023-11-02,206,yakult,360,400,40,1,00127,India
845305,2023-11-02,211,red bull,90,125,35,1,00127,India
845305,2023-11-02,208,sprite,75,100,25,1,00127,India
533995,2023-11-02,204,strawberry yogurt,50,60,10,1,00188,India
574552,2023-11-02,212,amul cheese,250,315,65,1,00126,India
818848,2023-11-02,202,milk,12,27,15,1,00338,India
818848,2023-11-02,209,pepsi,75,100,25,1,00338,India
818848,2023-11-02,212,amul cheese,250,315,65,1,00338,India
487265,2023-11-02,212,amul cheese,250,315,65,1,00345,India
487265,2023-11-02,208,sprite,75,100,25,1,00345,India
487265,2023-11-02,209,pepsi,75,100,25,1,00345,India
452326,2023-11-02,201,paneer,210,340,130,1,00226,India
452326,2023-11-02,204,strawberry yogurt,50,60,10,1,00226,India
736032,2023-11-02,211,red bull,90,125,35,1,00368,India
736032,2023-11-02,202,milk,12,27,15,1,00368,India
736032,2023-11-02,209,pepsi,75,100,25,1,00368,India
736032,2023-11-02,210,mountain dew,75,100,25,1,00368,India
736032,2023-11-02,205,classic yogurt,45,60,15,1,00368,India
570550,2023-11-02,202,milk,12,27,15,1,00320,India
278806,2023-11-02,206,yakult,360,400,40,1,00195,India
278806,2023-11-02,210,mountain dew,75,100,25,1,00195,India
278806,2023-11-02,205,classic yogurt,45,60,15,1,00195,India
662115,2023-11-02,206,yakult,360,400,40,1,00089,India
662115,2023-11-02,204,strawberry yogurt,50,60,10,1,00089,India
662115,2023-11-02,201,paneer,210,340,130,1,00089,India
662115,2023-11-02,203,mango yogurt,50,60,10,1,00089,India
277795,2023-11-02,205,classic yogurt,45,60,15,1,00015,India
277795,2023-11-02,202,milk,12,27,15,1,00015,India
277795,2023-11-02,206,yakult,360,400,40,1,00015,India
277283,2023-11-02,204,strawberry yogurt,50,60,10,1,00310,India
277283,2023-11-02,206,yakult,360,400,40,1,00310,India
288633,2023-11-02,208,sprite,75,100,25,1,00454,India
472806,2023-11-02,213,bisleri,6,15,9,1,00341,India
749552,2023-11-02,212,amul cheese,250,315,65,1,00044,India
749552,2023-11-02,207,coca cola,75,100,25,1,00044,India
749552,2023-11-02,211,red bull,90,125,35,1,00044,India
749552,2023-11-02,209,pepsi,75,100,25,1,00044,India
771052,2023-11-02,210,mountain dew,75,100,25,1,00139,India
771052,2023-11-02,207,coca cola,75,100,25,1,00139,India
877031,2023-11-02,212,amul cheese,250,315,65,1,00383,India
877031,2023-11-02,201,paneer,210,340,130,1,00383,India
877031,2023-11-02,203,mango yogurt,50,60,10,1,00383,India
943680,2023-11-02,213,bisleri,6,15,9,1,00221,India
943680,2023-11-02,206,yakult,360,400,40,1,00221,India
181214,2023-11-02,201,paneer,210,340,130,1,00289,India
181214,2023-11-02,204,strawberry yogurt,50,60,10,1,00289,India
181214,2023-11-02,202,milk,12,27,15,1,00289,India
181214,2023-11-02,210,mountain dew,75,100,25,1,00289,India
832314,2023-11-02,205,classic yogurt,45,60,15,1,00276,India
268374,2023-11-02,209,pepsi,75,100,25,1,00238,India
268374,2023-11-02,208,sprite,75,100,25,1,00238,India
268374,2023-11-02,202,milk,12,27,15,1,00238,India
268374,2023-11-02,203,mango yogurt,50,60,10,1,00238,India
520004,2023-11-02,210,mountain dew,75,100,25,1,00022,India
520004,2023-11-02,202,milk,12,27,15,1,00022,India
520004,2023-11-02,205,classic yogurt,45,60,15,1,00022,India
520004,2023-11-02,213,bisleri,6,15,9,1,00022,India
814958,2023-11-02,207,coca cola,75,100,25,1,00112,India
814958,2023-11-02,201,paneer,210,340,130,1,00112,India
585343,2023-11-02,203,mango yogurt,50,60,10,1,00075,India
585343,2023-11-02,207,coca cola,75,100,25,1,00075,India
585343,2023-11-02,211,red bull,90,125,35,1,00075,India
246368,2023-11-02,206,yakult,360,400,40,1,00211,India
246368,2023-11-02,202,milk,12,27,15,1,00211,India
579424,2023-11-02,209,pepsi,75,100,25,1,00162,India
579424,2023-11-02,206,yakult,360,400,40,1,00162,India
579424,2023-11-02,202,milk,12,27,15,1,00162,India
596984,2023-11-02,203,mango yogurt,50,60,10,1,00302,India
538491,2023-11-02,208,sprite,75,100,25,1,00072,India
538491,2023-11-02,207,coca cola,75,100,25,1,00072,India
538491,2023-11-02,206,yakult,360,400,40,1,00072,India
538491,2023-11-02,203,mango yogurt,50,60,10,1,00072,India
691092,2023-11-02,211,red bull,90,125,35,1,00037,India
691092,2023-11-02,212,amul cheese,250,315,65,1,00037,India
691092,2023-11-02,205,classic yogurt,45,60,15,1,00037,India
971549,2023-11-02,201,paneer,210,340,130,1,00457,India
971549,2023-11-02,205,classic yogurt,45,60,15,1,00457,India
113200,2023-11-02,210,mountain dew,75,100,25,1,00450,India
113200,2023-11-02,205,classic yogurt,45,60,15,1,00450,India
113200,2023-11-02,209,pepsi,75,100,25,1,00450,India
113200,2023-11-02,212,amul cheese,250,315,65,1,00450,India
401458,2023-11-02,213,bisleri,6,15,9,1,00398,India
401458,2023-11-02,201,paneer,210,340,130,1,00398,India
401458,2023-11-02,212,amul cheese,250,315,65,1,00398,India
777760,2023-11-02,204,strawberry yogurt,50,60,10,1,00187,India
816440,2023-11-02,210,mountain dew,75,100,25,1,00081,India
816440,2023-11-02,201,paneer,210,340,130,1,00081,India
238818,2023-11-02,206,yakult,360,400,40,1,00243,India
238818,2023-11-02,212,amul cheese,250,315,65,1,00243,India
238818,2023-11-02,211,red bull,90,125,35,1,00243,India
129436,2023-11-02,201,paneer,210,340,130,1,00149,India
416965,2023-11-02,205,classic yogurt,45,60,15,1,00078,India
416965,2023-11-02,212,amul cheese,250,315,65,1,00078,India
701665,2023-11-02,212,amul cheese,250,315,65,1,00230,India
216586,2023-11-02,208,sprite,75,100,25,1,00076,India
216586,2023-11-02,204,strawberry yogurt,50,60,10,1,00076,India
401207,2023-11-02,209,pepsi,75,100,25,1,00196,India
401207,2023-11-02,211,red bull,90,125,35,1,00196,India
401207,2023-11-02,203,mango yogurt,50,60,10,1,00196,India
663407,2023-11-02,207,coca cola,75,100,25,1,00319,India
663407,2023-11-02,201,paneer,210,340,130,1,00319,India
663407,2023-11-02,202,milk,12,27,15,1,00319,India
970904,2023-11-02,205,classic yogurt,45,60,15,1,00351,India
862324,2023-11-02,213,bisleri,6,15,9,1,00213,India
862324,2023-11-02,204,strawberry yogurt,50,60,10,1,00213,India
862324,2023-11-02,210,mountain dew,75,100,25,1,00213,India
617344,2023-11-02,202,milk,12,27,15,1,00145,India
617344,2023-11-02,210,mountain dew,75,100,25,1,00145,India
617344,2023-11-02,204,strawberry yogurt,50,60,10,1,00145,India
708183,2023-11-02,213,bisleri,6,15,9,1,00264,India
708183,2023-11-02,211,red bull,90,125,35,1,00264,India
708183,2023-11-02,209,pepsi,75,100,25,1,00264,India
886442,2023-11-02,213,bisleri,6,15,9,1,00420,India
886442,2023-11-02,205,classic yogurt,45,60,15,1,00420,India
886442,2023-11-02,201,paneer,210,340,130,1,00420,India
886442,2023-11-02,206,yakult,360,400,40,1,00420,India
456706,2023-11-02,205,classic yogurt,45,60,15,1,00306,India
456706,2023-11-02,210,mountain dew,75,100,25,1,00306,India
454591,2023-11-02,208,sprite,75,100,25,1,00353,India
454591,2023-11-02,209,pepsi,75,100,25,1,00353,India
454591,2023-11-02,210,mountain dew,75,100,25,1,00353,India
852954,2023-11-02,211,red bull,90,125,35,1,00450,India
852954,2023-11-02,212,amul cheese,250,315,65,1,00450,India
852954,2023-11-02,213,bisleri,6,15,9,1,00450,India
852954,2023-11-02,202,milk,12,27,15,1,00450,India
915824,2023-11-02,207,coca cola,75,100,25,1,00402,India
915824,2023-11-02,208,sprite,75,100,25,1,00402,India
915824,2023-11-02,206,yakult,360,400,40,1,00402,India
915824,2023-11-02,205,classic yogurt,45,60,15,1,00402,India
318808,2023-11-02,203,mango yogurt,50,60,10,1,00016,India
318808,2023-11-02,209,pepsi,75,100,25,1,00016,India
318808,2023-11-02,206,yakult,360,400,40,1,00016,India
336700,2023-11-02,204,strawberry yogurt,50,60,10,1,00274,India
336700,2023-11-02,207,coca cola,75,100,25,1,00274,India
336700,2023-11-02,211,red bull,90,125,35,1,00274,India
336700,2023-11-02,201,paneer,210,340,130,1,00274,India
673662,2023-11-02,203,mango yogurt,50,60,10,1,00284,India
943609,2023-11-02,211,red bull,90,125,35,1,00233,India
246463,2023-11-02,210,mountain dew,75,100,25,1,00012,India
961680,2023-11-02,209,pepsi,75,100,25,1,00037,India
961680,2023-11-02,213,bisleri,6,15,9,1,00037,India
961680,2023-11-02,206,yakult,360,400,40,1,00037,India
140265,2023-11-02,212,amul cheese,250,315,65,1,00459,India
643552,2023-11-02,208,sprite,75,100,25,1,00171,India
643552,2023-11-02,205,classic yogurt,45,60,15,1,00171,India
643552,2023-11-02,207,coca cola,75,100,25,1,00171,India
567018,2023-11-02,207,coca cola,75,100,25,1,00378,India
567018,2023-11-02,203,mango yogurt,50,60,10,1,00378,India
567018,2023-11-02,208,sprite,75,100,25,1,00378,India
567018,2023-11-02,201,paneer,210,340,130,1,00378,India
600458,2023-11-02,213,bisleri,6,15,9,1,00018,India
600458,2023-11-02,207,coca cola,75,100,25,1,00018,India
619636,2023-11-02,212,amul cheese,250,315,65,1,00053,India
619636,2023-11-02,213,bisleri,6,15,9,1,00053,India
413900,2023-11-02,205,classic yogurt,45,60,15,1,00341,India
413900,2023-11-02,207,coca cola,75,100,25,1,00341,India
399429,2023-11-02,210,mountain dew,75,100,25,1,00493,India
399429,2023-11-02,202,milk,12,27,15,1,00493,India
399429,2023-11-02,203,mango yogurt,50,60,10,1,00493,India
399429,2023-11-02,204,strawberry yogurt,50,60,10,1,00493,India
471137,2023-11-02,201,paneer,210,340,130,1,00488,India
471137,2023-11-02,205,classic yogurt,45,60,15,1,00488,India
150526,2023-11-02,202,milk,12,27,15,1,00245,India
150526,2023-11-02,201,paneer,210,340,130,1,00245,India
150526,2023-11-02,213,bisleri,6,15,9,1,00245,India
150526,2023-11-02,204,strawberry yogurt,50,60,10,1,00245,India
535395,2023-11-02,203,mango yogurt,50,60,10,1,00143,India
535395,2023-11-02,204,strawberry yogurt,50,60,10,1,00143,India
535395,2023-11-02,209,pepsi,75,100,25,1,00143,India
920343,2023-11-02,205,classic yogurt,45,60,15,1,00250,India
920343,2023-11-02,208,sprite,75,100,25,1,00250,India
920343,2023-11-02,201,paneer,210,340,130,1,00250,India
669325,2023-11-02,201,paneer,210,340,130,1,00140,India
839825,2023-11-02,208,sprite,75,100,25,1,00179,India
839825,2023-11-02,211,red bull,90,125,35,1,00179,India
801534,2023-11-02,203,mango yogurt,50,60,10,1,00135,India
801534,2023-11-02,202,milk,12,27,15,1,00135,India
221909,2023-11-02,201,paneer,210,340,130,1,00470,India
221909,2023-11-02,202,milk,12,27,15,1,00470,India
221909,2023-11-02,212,amul cheese,250,315,65,1,00470,India
221909,2023-11-02,203,mango yogurt,50,60,10,1,00470,India
221909,2023-11-02,209,pepsi,75,100,25,1,00470,India
724018,2023-11-03,205,classic yogurt,45,60,15,1,00083,India
724018,2023-11-03,210,mountain dew,75,100,25,1,00083,India
724018,2023-11-03,203,mango yogurt,50,60,10,1,00083,India
832826,2023-11-03,202,milk,12,27,15,1,00059,India
832826,2023-11-03,209,pepsi,75,100,25,1,00059,India
832826,2023-11-03,201,paneer,210,340,130,1,00059,India
517324,2023-11-03,208,sprite,75,100,25,1,00341,India
517324,2023-11-03,211,red bull,90,125,35,1,00341,India
206831,2023-11-03,206,yakult,360,400,40,1,00145,India
989864,2023-11-03,205,classic yogurt,45,60,15,1,00001,India
989864,2023-11-03,202,milk,12,27,15,1,00001,India
448402,2023-11-03,212,amul cheese,250,315,65,1,00357,India
448402,2023-11-03,205,classic yogurt,45,60,15,1,00357,India
391261,2023-11-03,213,bisleri,6,15,9,1,00165,India
391261,2023-11-03,209,pepsi,75,100,25,1,00165,India
243662,2023-11-03,206,yakult,360,400,40,1,00444,India
886864,2023-11-03,208,sprite,75,100,25,1,00129,India
886864,2023-11-03,212,amul cheese,250,315,65,1,00129,India
886864,2023-11-03,206,yakult,360,400,40,1,00129,India
886864,2023-11-03,203,mango yogurt,50,60,10,1,00129,India
886864,2023-11-03,202,milk,12,27,15,1,00129,India
967438,2023-11-03,206,yakult,360,400,40,1,00165,India
804945,2023-11-03,203,mango yogurt,50,60,10,1,00146,India
804945,2023-11-03,209,pepsi,75,100,25,1,00146,India
605892,2023-11-03,208,sprite,75,100,25,1,00115,India
605892,2023-11-03,203,mango yogurt,50,60,10,1,00115,India
605892,2023-11-03,207,coca cola,75,100,25,1,00115,India
216551,2023-11-03,201,paneer,210,340,130,1,00097,India
776923,2023-11-03,207,coca cola,75,100,25,1,00051,India
776923,2023-11-03,208,sprite,75,100,25,1,00051,India
479733,2023-11-03,211,red bull,90,125,35,1,00463,India
479733,2023-11-03,212,amul cheese,250,315,65,1,00463,India
479733,2023-11-03,205,classic yogurt,45,60,15,1,00463,India
479733,2023-11-03,206,yakult,360,400,40,1,00463,India
988456,2023-11-03,210,mountain dew,75,100,25,1,00419,India
988456,2023-11-03,207,coca cola,75,100,25,1,00419,India
988456,2023-11-03,206,yakult,360,400,40,1,00419,India
862750,2023-11-03,210,mountain dew,75,100,25,1,00268,India
862750,2023-11-03,212,amul cheese,250,315,65,1,00268,India
107615,2023-11-03,206,yakult,360,400,40,1,00033,India
107615,2023-11-03,207,coca cola,75,100,25,1,00033,India
187709,2023-11-03,202,milk,12,27,15,1,00236,India
187709,2023-11-03,203,mango yogurt,50,60,10,1,00236,India
187709,2023-11-03,212,amul cheese,250,315,65,1,00236,India
187709,2023-11-03,210,mountain dew,75,100,25,1,00236,India
568222,2023-11-03,202,milk,12,27,15,1,00463,India
568222,2023-11-03,204,strawberry yogurt,50,60,10,1,00463,India
568222,2023-11-03,210,mountain dew,75,100,25,1,00463,India
568222,2023-11-03,205,classic yogurt,45,60,15,1,00463,India
568222,2023-11-03,206,yakult,360,400,40,1,00463,India
973732,2023-11-03,213,bisleri,6,15,9,1,00078,India
973732,2023-11-03,201,paneer,210,340,130,1,00078,India
973732,2023-11-03,208,sprite,75,100,25,1,00078,India
973732,2023-11-03,204,strawberry yogurt,50,60,10,1,00078,India
145599,2023-11-03,210,mountain dew,75,100,25,1,00366,India
145599,2023-11-03,207,coca cola,75,100,25,1,00366,India
383084,2023-11-03,203,mango yogurt,50,60,10,1,00096,India
383084,2023-11-03,205,classic yogurt,45,60,15,1,00096,India
383084,2023-11-03,212,amul cheese,250,315,65,1,00096,India
383084,2023-11-03,208,sprite,75,100,25,1,00096,India
281871,2023-11-03,203,mango yogurt,50,60,10,1,00479,India
494054,2023-11-03,207,coca cola,75,100,25,1,00237,India
494054,2023-11-03,210,mountain dew,75,100,25,1,00237,India
494054,2023-11-03,212,amul cheese,250,315,65,1,00237,India
494054,2023-11-03,202,milk,12,27,15,1,00237,India
969282,2023-11-03,207,coca cola,75,100,25,1,00116,India
969282,2023-11-03,209,pepsi,75,100,25,1,00116,India
422825,2023-11-03,213,bisleri,6,15,9,1,00413,India
422825,2023-11-03,201,paneer,210,340,130,1,00413,India
184654,2023-11-03,202,milk,12,27,15,1,00134,India
631240,2023-11-03,208,sprite,75,100,25,1,00276,India
587421,2023-11-03,207,coca cola,75,100,25,1,00172,India
587421,2023-11-03,205,classic yogurt,45,60,15,1,00172,India
952551,2023-11-03,201,paneer,210,340,130,1,00371,India
952551,2023-11-03,206,yakult,360,400,40,1,00371,India
952551,2023-11-03,210,mountain dew,75,100,25,1,00371,India
952551,2023-11-03,202,milk,12,27,15,1,00371,India
216067,2023-11-03,209,pepsi,75,100,25,1,00310,India
236098,2023-11-03,204,strawberry yogurt,50,60,10,1,00163,India
236098,2023-11-03,210,mountain dew,75,100,25,1,00163,India
236098,2023-11-03,207,coca cola,75,100,25,1,00163,India
236098,2023-11-03,203,mango yogurt,50,60,10,1,00163,India
812927,2023-11-03,210,mountain dew,75,100,25,1,00377,India
812927,2023-11-03,212,amul cheese,250,315,65,1,00377,India
812927,2023-11-03,213,bisleri,6,15,9,1,00377,India
812927,2023-11-03,209,pepsi,75,100,25,1,00377,India
219384,2023-11-03,207,coca cola,75,100,25,1,00420,India
219384,2023-11-03,209,pepsi,75,100,25,1,00420,India
219384,2023-11-03,211,red bull,90,125,35,1,00420,India
631620,2023-11-03,204,strawberry yogurt,50,60,10,1,00006,India
631620,2023-11-03,205,classic yogurt,45,60,15,1,00006,India
631620,2023-11-03,203,mango yogurt,50,60,10,1,00006,India
631620,2023-11-03,208,sprite,75,100,25,1,00006,India
631620,2023-11-03,210,mountain dew,75,100,25,1,00006,India
728145,2023-11-03,203,mango yogurt,50,60,10,1,00268,India
728145,2023-11-03,209,pepsi,75,100,25,1,00268,India
728145,2023-11-03,202,milk,12,27,15,1,00268,India
128495,2023-11-03,209,pepsi,75,100,25,1,00089,India
449455,2023-11-03,208,sprite,75,100,25,1,00071,India
449455,2023-11-03,206,yakult,360,400,40,1,00071,India
449455,2023-11-03,205,classic yogurt,45,60,15,1,00071,India
449455,2023-11-03,212,amul cheese,250,315,65,1,00071,India
380067,2023-11-03,201,paneer,210,340,130,1,00491,India
380067,2023-11-03,210,mountain dew,75,100,25,1,00491,India
380067,2023-11-03,203,mango yogurt,50,60,10,1,00491,India
380067,2023-11-03,213,bisleri,6,15,9,1,00491,India
185155,2023-11-03,206,yakult,360,400,40,1,00395,India
185155,2023-11-03,208,sprite,75,100,25,1,00395,India
448315,2023-11-03,208,sprite,75,100,25,1,00256,India
448315,2023-11-03,201,paneer,210,340,130,1,00256,India
448315,2023-11-03,206,yakult,360,400,40,1,00256,India
828523,2023-11-03,213,bisleri,6,15,9,1,00109,India
828523,2023-11-03,207,coca cola,75,100,25,1,00109,India
130136,2023-11-03,213,bisleri,6,15,9,1,00240,India
130136,2023-11-03,208,sprite,75,100,25,1,00240,India
177738,2023-11-03,205,classic yogurt,45,60,15,1,00273,India
177738,2023-11-03,210,mountain dew,75,100,25,1,00273,India
177738,2023-11-03,208,sprite,75,100,25,1,00273,India
177738,2023-11-03,212,amul cheese,250,315,65,1,00273,India
311719,2023-11-03,207,coca cola,75,100,25,1,00006,India
311719,2023-11-03,201,paneer,210,340,130,1,00006,India
880629,2023-11-03,207,coca cola,75,100,25,1,00233,India
880629,2023-11-03,211,red bull,90,125,35,1,00233,India
880629,2023-11-03,205,classic yogurt,45,60,15,1,00233,India
273572,2023-11-03,205,classic yogurt,45,60,15,1,00208,India
273572,2023-11-03,207,coca cola,75,100,25,1,00208,India
555206,2023-11-03,207,coca cola,75,100,25,1,00054,India
555206,2023-11-03,206,yakult,360,400,40,1,00054,India
555206,2023-11-03,204,strawberry yogurt,50,60,10,1,00054,India
563427,2023-11-03,210,mountain dew,75,100,25,1,00076,India
563427,2023-11-03,202,milk,12,27,15,1,00076,India
563427,2023-11-03,205,classic yogurt,45,60,15,1,00076,India
563427,2023-11-03,204,strawberry yogurt,50,60,10,1,00076,India
563427,2023-11-03,203,mango yogurt,50,60,10,1,00076,India
513574,2023-11-03,211,red bull,90,125,35,1,00050,India
811230,2023-11-03,207,coca cola,75,100,25,1,00323,India
738239,2023-11-03,213,bisleri,6,15,9,1,00390,India
738239,2023-11-03,201,paneer,210,340,130,1,00390,India
738239,2023-11-03,202,milk,12,27,15,1,00390,India
738239,2023-11-03,203,mango yogurt,50,60,10,1,00390,India
492435,2023-11-03,207,coca cola,75,100,25,1,00408,India
492435,2023-11-03,206,yakult,360,400,40,1,00408,India
618426,2023-11-03,207,coca cola,75,100,25,1,00412,India
618426,2023-11-03,211,red bull,90,125,35,1,00412,India
618426,2023-11-03,202,milk,12,27,15,1,00412,India
618426,2023-11-03,206,yakult,360,400,40,1,00412,India
618426,2023-11-03,213,bisleri,6,15,9,1,00412,India
632795,2023-11-03,203,mango yogurt,50,60,10,1,00246,India
632795,2023-11-03,202,milk,12,27,15,1,00246,India
632795,2023-11-03,212,amul cheese,250,315,65,1,00246,India
632795,2023-11-03,208,sprite,75,100,25,1,00246,India
361193,2023-11-03,212,amul cheese,250,315,65,1,00376,India
361193,2023-11-03,209,pepsi,75,100,25,1,00376,India
361193,2023-11-03,211,red bull,90,125,35,1,00376,India
361193,2023-11-03,205,classic yogurt,45,60,15,1,00376,India
532868,2023-11-03,206,yakult,360,400,40,1,00116,India
532868,2023-11-03,202,milk,12,27,15,1,00116,India
532868,2023-11-03,205,classic yogurt,45,60,15,1,00116,India
532868,2023-11-03,201,paneer,210,340,130,1,00116,India
435579,2023-11-03,204,strawberry yogurt,50,60,10,1,00449,India
435579,2023-11-03,211,red bull,90,125,35,1,00449,India
435579,2023-11-03,202,milk,12,27,15,1,00449,India
435579,2023-11-03,203,mango yogurt,50,60,10,1,00449,India
904284,2023-11-03,210,mountain dew,75,100,25,1,00322,India
904284,2023-11-03,202,milk,12,27,15,1,00322,India
904284,2023-11-03,204,strawberry yogurt,50,60,10,1,00322,India
904284,2023-11-03,205,classic yogurt,45,60,15,1,00322,India
770351,2023-11-04,210,mountain dew,75,100,25,1,00004,India
788168,2023-11-04,211,red bull,90,125,35,1,00286,India
788168,2023-11-04,205,classic yogurt,45,60,15,1,00286,India
788168,2023-11-04,209,pepsi,75,100,25,1,00286,India
971322,2023-11-04,205,classic yogurt,45,60,15,1,00488,India
971322,2023-11-04,213,bisleri,6,15,9,1,00488,India
473502,2023-11-04,206,yakult,360,400,40,1,00416,India
473502,2023-11-04,203,mango yogurt,50,60,10,1,00416,India
473502,2023-11-04,210,mountain dew,75,100,25,1,00416,India
357709,2023-11-04,212,amul cheese,250,315,65,1,00138,India
357709,2023-11-04,203,mango yogurt,50,60,10,1,00138,India
357709,2023-11-04,209,pepsi,75,100,25,1,00138,India
357709,2023-11-04,206,yakult,360,400,40,1,00138,India
779594,2023-11-04,213,bisleri,6,15,9,1,00359,India
779594,2023-11-04,205,classic yogurt,45,60,15,1,00359,India
779594,2023-11-04,212,amul cheese,250,315,65,1,00359,India
393308,2023-11-04,201,paneer,210,340,130,1,00355,India
393308,2023-11-04,212,amul cheese,250,315,65,1,00355,India
393308,2023-11-04,203,mango yogurt,50,60,10,1,00355,India
269189,2023-11-04,210,mountain dew,75,100,25,1,00271,India
269189,2023-11-04,212,amul cheese,250,315,65,1,00271,India
269189,2023-11-04,211,red bull,90,125,35,1,00271,India
934079,2023-11-04,201,paneer,210,340,130,1,00472,India
934079,2023-11-04,208,sprite,75,100,25,1,00472,India
934079,2023-11-04,205,classic yogurt,45,60,15,1,00472,India
934079,2023-11-04,212,amul cheese,250,315,65,1,00472,India
714618,2023-11-04,210,mountain dew,75,100,25,1,00364,India
714618,2023-11-04,208,sprite,75,100,25,1,00364,India
161625,2023-11-04,202,milk,12,27,15,1,00374,India
121796,2023-11-04,201,paneer,210,340,130,1,00113,India
121796,2023-11-04,206,yakult,360,400,40,1,00113,India
743476,2023-11-04,206,yakult,360,400,40,1,00252,India
743476,2023-11-04,204,strawberry yogurt,50,60,10,1,00252,India
743476,2023-11-04,208,sprite,75,100,25,1,00252,India
743476,2023-11-04,211,red bull,90,125,35,1,00252,India
101502,2023-11-04,204,strawberry yogurt,50,60,10,1,00239,India
101502,2023-11-04,208,sprite,75,100,25,1,00239,India
101502,2023-11-04,211,red bull,90,125,35,1,00239,India
828175,2023-11-04,209,pepsi,75,100,25,1,00482,India
240023,2023-11-04,205,classic yogurt,45,60,15,1,00019,India
240023,2023-11-04,210,mountain dew,75,100,25,1,00019,India
240023,2023-11-04,208,sprite,75,100,25,1,00019,India
484569,2023-11-04,209,pepsi,75,100,25,1,00029,India
484569,2023-11-04,204,strawberry yogurt,50,60,10,1,00029,India
484569,2023-11-04,212,amul cheese,250,315,65,1,00029,India
666758,2023-11-04,211,red bull,90,125,35,1,00187,India
202506,2023-11-04,201,paneer,210,340,130,1,00374,India
202506,2023-11-04,213,bisleri,6,15,9,1,00374,India
731941,2023-11-04,213,bisleri,6,15,9,1,00449,India
731941,2023-11-04,202,milk,12,27,15,1,00449,India
731941,2023-11-04,206,yakult,360,400,40,1,00449,India
373317,2023-11-04,211,red bull,90,125,35,1,00446,India
373317,2023-11-04,213,bisleri,6,15,9,1,00446,India
305368,2023-11-04,208,sprite,75,100,25,1,00247,India
305368,2023-11-04,210,mountain dew,75,100,25,1,00247,India
305368,2023-11-04,212,amul cheese,250,315,65,1,00247,India
305368,2023-11-04,213,bisleri,6,15,9,1,00247,India
305368,2023-11-04,202,milk,12,27,15,1,00247,India
189129,2023-11-04,211,red bull,90,125,35,1,00076,India
189129,2023-11-04,201,paneer,210,340,130,1,00076,India
189129,2023-11-04,203,mango yogurt,50,60,10,1,00076,India
447087,2023-11-04,205,classic yogurt,45,60,15,1,00018,India
801259,2023-11-04,208,sprite,75,100,25,1,00201,India
438635,2023-11-04,201,paneer,210,340,130,1,00081,India
138891,2023-11-04,210,mountain dew,75,100,25,1,00121,India
138891,2023-11-04,207,coca cola,75,100,25,1,00121,India
138891,2023-11-04,204,strawberry yogurt,50,60,10,1,00121,India
362201,2023-11-04,203,mango yogurt,50,60,10,1,00399,India
780059,2023-11-04,211,red bull,90,125,35,1,00376,India
780059,2023-11-04,207,coca cola,75,100,25,1,00376,India
702863,2023-11-04,202,milk,12,27,15,1,00419,India
702863,2023-11-04,213,bisleri,6,15,9,1,00419,India
477797,2023-11-04,208,sprite,75,100,25,1,00354,India
477797,2023-11-04,205,classic yogurt,45,60,15,1,00354,India
865924,2023-11-04,211,red bull,90,125,35,1,00347,India
579248,2023-11-04,203,mango yogurt,50,60,10,1,00395,India
579248,2023-11-04,201,paneer,210,340,130,1,00395,India
579248,2023-11-04,208,sprite,75,100,25,1,00395,India
579248,2023-11-04,206,yakult,360,400,40,1,00395,India
579248,2023-11-04,211,red bull,90,125,35,1,00395,India
429731,2023-11-04,201,paneer,210,340,130,1,00066,India
429731,2023-11-04,203,mango yogurt,50,60,10,1,00066,India
429731,2023-11-04,202,milk,12,27,15,1,00066,India
429731,2023-11-04,211,red bull,90,125,35,1,00066,India
569622,2023-11-04,203,mango yogurt,50,60,10,1,00200,India
569622,2023-11-04,213,bisleri,6,15,9,1,00200,India
772752,2023-11-04,203,mango yogurt,50,60,10,1,00091,India
772752,2023-11-04,212,amul cheese,250,315,65,1,00091,India
572926,2023-11-04,204,strawberry yogurt,50,60,10,1,00443,India
572926,2023-11-04,212,amul cheese,250,315,65,1,00443,India
407265,2023-11-04,211,red bull,90,125,35,1,00475,India
407265,2023-11-04,202,milk,12,27,15,1,00475,India
513228,2023-11-04,213,bisleri,6,15,9,1,00289,India
513228,2023-11-04,209,pepsi,75,100,25,1,00289,India
513228,2023-11-04,204,strawberry yogurt,50,60,10,1,00289,India
329026,2023-11-04,207,coca cola,75,100,25,1,00114,India
329026,2023-11-04,205,classic yogurt,45,60,15,1,00114,India
329026,2023-11-04,202,milk,12,27,15,1,00114,India
496827,2023-11-04,205,classic yogurt,45,60,15,1,00033,India
496827,2023-11-04,201,paneer,210,340,130,1,00033,India
496827,2023-11-04,206,yakult,360,400,40,1,00033,India
219877,2023-11-04,212,amul cheese,250,315,65,1,00116,India
219877,2023-11-04,201,paneer,210,340,130,1,00116,India
219877,2023-11-04,203,mango yogurt,50,60,10,1,00116,India
219877,2023-11-04,211,red bull,90,125,35,1,00116,India
219877,2023-11-04,207,coca cola,75,100,25,1,00116,India
414006,2023-11-04,202,milk,12,27,15,1,00137,India
414006,2023-11-04,208,sprite,75,100,25,1,00137,India
414006,2023-11-04,206,yakult,360,400,40,1,00137,India
414006,2023-11-04,201,paneer,210,340,130,1,00137,India
414006,2023-11-04,203,mango yogurt,50,60,10,1,00137,India
599803,2023-11-04,204,strawberry yogurt,50,60,10,1,00324,India
599803,2023-11-04,202,milk,12,27,15,1,00324,India
599803,2023-11-04,209,pepsi,75,100,25,1,00324,India
979078,2023-11-04,210,mountain dew,75,100,25,1,00372,India
979078,2023-11-04,206,yakult,360,400,40,1,00372,India
979078,2023-11-04,202,milk,12,27,15,1,00372,India
397539,2023-11-04,211,red bull,90,125,35,1,00482,India
302967,2023-11-04,206,yakult,360,400,40,1,00249,India
302967,2023-11-04,202,milk,12,27,15,1,00249,India
302967,2023-11-04,212,amul cheese,250,315,65,1,00249,India
302967,2023-11-04,210,mountain dew,75,100,25,1,00249,India
195849,2023-11-04,203,mango yogurt,50,60,10,1,00353,India
382149,2023-11-04,204,strawberry yogurt,50,60,10,1,00380,India
382149,2023-11-04,212,amul cheese,250,315,65,1,00380,India
382149,2023-11-04,201,paneer,210,340,130,1,00380,India
382149,2023-11-04,209,pepsi,75,100,25,1,00380,India
244205,2023-11-04,204,strawberry yogurt,50,60,10,1,00186,India
244205,2023-11-04,205,classic yogurt,45,60,15,1,00186,India
244205,2023-11-04,212,amul cheese,250,315,65,1,00186,India
986886,2023-11-04,204,strawberry yogurt,50,60,10,1,00248,India
986886,2023-11-04,207,coca cola,75,100,25,1,00248,India
986886,2023-11-04,206,yakult,360,400,40,1,00248,India
986886,2023-11-04,201,paneer,210,340,130,1,00248,India
484237,2023-11-04,205,classic yogurt,45,60,15,1,00035,India
815534,2023-11-04,201,paneer,210,340,130,1,00142,India
138837,2023-11-04,206,yakult,360,400,40,1,00257,India
138837,2023-11-04,202,milk,12,27,15,1,00257,India
391959,2023-11-04,205,classic yogurt,45,60,15,1,00163,India
985246,2023-11-04,206,yakult,360,400,40,1,00399,India
985246,2023-11-04,207,coca cola,75,100,25,1,00399,India
830324,2023-11-04,210,mountain dew,75,100,25,1,00120,India
830324,2023-11-04,206,yakult,360,400,40,1,00120,India
830324,2023-11-04,211,red bull,90,125,35,1,00120,India
830324,2023-11-04,213,bisleri,6,15,9,1,00120,India
911186,2023-11-04,211,red bull,90,125,35,1,00102,India
911186,2023-11-04,204,strawberry yogurt,50,60,10,1,00102,India
911186,2023-11-04,208,sprite,75,100,25,1,00102,India
911186,2023-11-04,206,yakult,360,400,40,1,00102,India
125244,2023-11-04,203,mango yogurt,50,60,10,1,00139,India
125244,2023-11-04,201,paneer,210,340,130,1,00139,India
125244,2023-11-04,208,sprite,75,100,25,1,00139,India
125244,2023-11-04,209,pepsi,75,100,25,1,00139,India
125244,2023-11-04,211,red bull,90,125,35,1,00139,India
889286,2023-11-04,208,sprite,75,100,25,1,00071,India
889286,2023-11-04,203,mango yogurt,50,60,10,1,00071,India
889286,2023-11-04,206,yakult,360,400,40,1,00071,India
621984,2023-11-04,202,milk,12,27,15,1,00076,India
621984,2023-11-04,205,classic yogurt,45,60,15,1,00076,India
621984,2023-11-04,209,pepsi,75,100,25,1,00076,India
621984,2023-11-04,213,bisleri,6,15,9,1,00076,India
255585,2023-11-04,213,bisleri,6,15,9,1,00445,India
255585,2023-11-04,211,red bull,90,125,35,1,00445,India
137823,2023-11-04,205,classic yogurt,45,60,15,1,00278,India
137823,2023-11-04,203,mango yogurt,50,60,10,1,00278,India
760063,2023-11-04,206,yakult,360,400,40,1,00460,India
760063,2023-11-04,208,sprite,75,100,25,1,00460,India
760063,2023-11-04,201,paneer,210,340,130,1,00460,India
760063,2023-11-04,213,bisleri,6,15,9,1,00460,India
861916,2023-11-04,207,coca cola,75,100,25,1,00155,India
861916,2023-11-04,211,red bull,90,125,35,1,00155,India
861916,2023-11-04,205,classic yogurt,45,60,15,1,00155,India
928068,2023-11-04,208,sprite,75,100,25,1,00252,India
672685,2023-11-04,212,amul cheese,250,315,65,1,00083,India
672685,2023-11-04,211,red bull,90,125,35,1,00083,India
651103,2023-11-04,212,amul cheese,250,315,65,1,00064,India
651103,2023-11-04,210,mountain dew,75,100,25,1,00064,India
536853,2023-11-04,205,classic yogurt,45,60,15,1,00385,India
971702,2023-11-04,213,bisleri,6,15,9,1,00198,India
221251,2023-11-04,206,yakult,360,400,40,1,00483,India
515138,2023-11-04,203,mango yogurt,50,60,10,1,00273,India
424908,2023-11-04,201,paneer,210,340,130,1,00096,India
418975,2023-11-04,212,amul cheese,250,315,65,1,00365,India
848812,2023-11-04,207,coca cola,75,100,25,1,00262,India
848812,2023-11-04,211,red bull,90,125,35,1,00262,India
848812,2023-11-04,201,paneer,210,340,130,1,00262,India
384490,2023-11-04,206,yakult,360,400,40,1,00380,India
384490,2023-11-04,202,milk,12,27,15,1,00380,India
384490,2023-11-04,213,bisleri,6,15,9,1,00380,India
384490,2023-11-04,208,sprite,75,100,25,1,00380,India
384490,2023-11-04,203,mango yogurt,50,60,10,1,00380,India
560230,2023-11-04,211,red bull,90,125,35,1,00405,India
560230,2023-11-04,213,bisleri,6,15,9,1,00405,India
771869,2023-11-04,213,bisleri,6,15,9,1,00026,India
771869,2023-11-04,209,pepsi,75,100,25,1,00026,India
771869,2023-11-04,211,red bull,90,125,35,1,00026,India
526599,2023-11-04,201,paneer,210,340,130,1,00234,India
526599,2023-11-04,208,sprite,75,100,25,1,00234,India
658648,2023-11-04,206,yakult,360,400,40,1,00111,India
658648,2023-11-04,204,strawberry yogurt,50,60,10,1,00111,India
372128,2023-11-04,204,strawberry yogurt,50,60,10,1,00282,India
372128,2023-11-04,201,paneer,210,340,130,1,00282,India
372128,2023-11-04,209,pepsi,75,100,25,1,00282,India
372128,2023-11-04,203,mango yogurt,50,60,10,1,00282,India
710918,2023-11-04,202,milk,12,27,15,1,00376,India
710918,2023-11-04,206,yakult,360,400,40,1,00376,India
710918,2023-11-04,210,mountain dew,75,100,25,1,00376,India
710918,2023-11-04,212,amul cheese,250,315,65,1,00376,India
745067,2023-11-04,207,coca cola,75,100,25,1,00452,India
745067,2023-11-04,205,classic yogurt,45,60,15,1,00452,India
745067,2023-11-04,204,strawberry yogurt,50,60,10,1,00452,India
446800,2023-11-04,213,bisleri,6,15,9,1,00234,India
446800,2023-11-04,207,coca cola,75,100,25,1,00234,India
446800,2023-11-04,201,paneer,210,340,130,1,00234,India
600073,2023-11-04,201,paneer,210,340,130,1,00322,India
600073,2023-11-04,210,mountain dew,75,100,25,1,00322,India
600073,2023-11-04,207,coca cola,75,100,25,1,00322,India
600073,2023-11-04,204,strawberry yogurt,50,60,10,1,00322,India
600073,2023-11-04,203,mango yogurt,50,60,10,1,00322,India
920831,2023-11-04,203,mango yogurt,50,60,10,1,00298,India
920831,2023-11-04,208,sprite,75,100,25,1,00298,India
920831,2023-11-04,210,mountain dew,75,100,25,1,00298,India
920831,2023-11-04,204,strawberry yogurt,50,60,10,1,00298,India
561857,2023-11-04,213,bisleri,6,15,9,1,00319,India
547817,2023-11-04,204,strawberry yogurt,50,60,10,1,00103,India
547817,2023-11-04,208,sprite,75,100,25,1,00103,India
110429,2023-11-04,203,mango yogurt,50,60,10,1,00405,India
110429,2023-11-04,207,coca cola,75,100,25,1,00405,India
110429,2023-11-04,213,bisleri,6,15,9,1,00405,India
110429,2023-11-04,202,milk,12,27,15,1,00405,India
645283,2023-11-04,211,red bull,90,125,35,1,00467,India
164408,2023-11-04,204,strawberry yogurt,50,60,10,1,00051,India
164408,2023-11-04,210,mountain dew,75,100,25,1,00051,India
164408,2023-11-04,206,yakult,360,400,40,1,00051,India
164408,2023-11-04,211,red bull,90,125,35,1,00051,India
384321,2023-11-05,202,milk,12,27,15,1,00474,India
384321,2023-11-05,212,amul cheese,250,315,65,1,00474,India
326405,2023-11-05,210,mountain dew,75,100,25,1,00119,India
326405,2023-11-05,213,bisleri,6,15,9,1,00119,India
326405,2023-11-05,205,classic yogurt,45,60,15,1,00119,India
247099,2023-11-05,210,mountain dew,75,100,25,1,00455,India
247099,2023-11-05,203,mango yogurt,50,60,10,1,00455,India
236402,2023-11-05,211,red bull,90,125,35,1,00297,India
236402,2023-11-05,202,milk,12,27,15,1,00297,India
236402,2023-11-05,213,bisleri,6,15,9,1,00297,India
843408,2023-11-05,207,coca cola,75,100,25,1,00035,India
221660,2023-11-05,202,milk,12,27,15,1,00273,India
221660,2023-11-05,211,red bull,90,125,35,1,00273,India
277841,2023-11-05,213,bisleri,6,15,9,1,00063,India
277841,2023-11-05,203,mango yogurt,50,60,10,1,00063,India
277841,2023-11-05,201,paneer,210,340,130,1,00063,India
642494,2023-11-05,211,red bull,90,125,35,1,00149,India
642494,2023-11-05,201,paneer,210,340,130,1,00149,India
642494,2023-11-05,208,sprite,75,100,25,1,00149,India
642494,2023-11-05,213,bisleri,6,15,9,1,00149,India
549377,2023-11-05,206,yakult,360,400,40,1,00309,India
549377,2023-11-05,201,paneer,210,340,130,1,00309,India
502111,2023-11-05,213,bisleri,6,15,9,1,00188,India
502111,2023-11-05,211,red bull,90,125,35,1,00188,India
308620,2023-11-05,203,mango yogurt,50,60,10,1,00154,India
734124,2023-11-05,205,classic yogurt,45,60,15,1,00156,India
734124,2023-11-05,208,sprite,75,100,25,1,00156,India
130471,2023-11-05,212,amul cheese,250,315,65,1,00159,India
130471,2023-11-05,210,mountain dew,75,100,25,1,00159,India
134774,2023-11-05,205,classic yogurt,45,60,15,1,00368,India
134774,2023-11-05,208,sprite,75,100,25,1,00368,India
133421,2023-11-05,202,milk,12,27,15,1,00239,India
133421,2023-11-05,212,amul cheese,250,315,65,1,00239,India
373918,2023-11-05,212,amul cheese,250,315,65,1,00084,India
373918,2023-11-05,208,sprite,75,100,25,1,00084,India
373918,2023-11-05,205,classic yogurt,45,60,15,1,00084,India
373918,2023-11-05,213,bisleri,6,15,9,1,00084,India
174968,2023-11-05,206,yakult,360,400,40,1,00045,India
174968,2023-11-05,213,bisleri,6,15,9,1,00045,India
174968,2023-11-05,204,strawberry yogurt,50,60,10,1,00045,India
415930,2023-11-05,209,pepsi,75,100,25,1,00005,India
415930,2023-11-05,204,strawberry yogurt,50,60,10,1,00005,India
415930,2023-11-05,208,sprite,75,100,25,1,00005,India
415930,2023-11-05,210,mountain dew,75,100,25,1,00005,India
554313,2023-11-05,212,amul cheese,250,315,65,1,00329,India
554313,2023-11-05,210,mountain dew,75,100,25,1,00329,India
554313,2023-11-05,203,mango yogurt,50,60,10,1,00329,India
554313,2023-11-05,204,strawberry yogurt,50,60,10,1,00329,India
405629,2023-11-05,207,coca cola,75,100,25,1,00237,India
405629,2023-11-05,212,amul cheese,250,315,65,1,00237,India
967484,2023-11-05,211,red bull,90,125,35,1,00230,India
967484,2023-11-05,212,amul cheese,250,315,65,1,00230,India
967484,2023-11-05,201,paneer,210,340,130,1,00230,India
967484,2023-11-05,209,pepsi,75,100,25,1,00230,India
967484,2023-11-05,203,mango yogurt,50,60,10,1,00230,India
443385,2023-11-05,202,milk,12,27,15,1,00081,India
214470,2023-11-05,205,classic yogurt,45,60,15,1,00303,India
214470,2023-11-05,207,coca cola,75,100,25,1,00303,India
214470,2023-11-05,202,milk,12,27,15,1,00303,India
132320,2023-11-05,210,mountain dew,75,100,25,1,00401,India
132320,2023-11-05,202,milk,12,27,15,1,00401,India
132320,2023-11-05,209,pepsi,75,100,25,1,00401,India
165616,2023-11-05,208,sprite,75,100,25,1,00246,India
247969,2023-11-05,212,amul cheese,250,315,65,1,00274,India
247969,2023-11-05,206,yakult,360,400,40,1,00274,India
313354,2023-11-05,202,milk,12,27,15,1,00241,India
313354,2023-11-05,203,mango yogurt,50,60,10,1,00241,India
555401,2023-11-05,203,mango yogurt,50,60,10,1,00227,India
555401,2023-11-05,205,classic yogurt,45,60,15,1,00227,India
960271,2023-11-05,213,bisleri,6,15,9,1,00081,India
960271,2023-11-05,203,mango yogurt,50,60,10,1,00081,India
266348,2023-11-05,210,mountain dew,75,100,25,1,00254,India
266348,2023-11-05,204,strawberry yogurt,50,60,10,1,00254,India
266348,2023-11-05,201,paneer,210,340,130,1,00254,India
781741,2023-11-05,204,strawberry yogurt,50,60,10,1,00182,India
781741,2023-11-05,212,amul cheese,250,315,65,1,00182,India
781741,2023-11-05,207,coca cola,75,100,25,1,00182,India
781741,2023-11-05,210,mountain dew,75,100,25,1,00182,India
153874,2023-11-05,209,pepsi,75,100,25,1,00304,India
153874,2023-11-05,212,amul cheese,250,315,65,1,00304,India
355601,2023-11-05,211,red bull,90,125,35,1,00229,India
355601,2023-11-05,208,sprite,75,100,25,1,00229,India
355601,2023-11-05,201,paneer,210,340,130,1,00229,India
280227,2023-11-05,206,yakult,360,400,40,1,00002,India
280227,2023-11-05,209,pepsi,75,100,25,1,00002,India
280227,2023-11-05,211,red bull,90,125,35,1,00002,India
447158,2023-11-05,211,red bull,90,125,35,1,00040,India
447158,2023-11-05,202,milk,12,27,15,1,00040,India
447158,2023-11-05,210,mountain dew,75,100,25,1,00040,India
447158,2023-11-05,205,classic yogurt,45,60,15,1,00040,India
283913,2023-11-05,213,bisleri,6,15,9,1,00119,India
963004,2023-11-05,204,strawberry yogurt,50,60,10,1,00184,India
963004,2023-11-05,209,pepsi,75,100,25,1,00184,India
963004,2023-11-05,203,mango yogurt,50,60,10,1,00184,India
963004,2023-11-05,210,mountain dew,75,100,25,1,00184,India
496750,2023-11-05,212,amul cheese,250,315,65,1,00210,India
496750,2023-11-05,207,coca cola,75,100,25,1,00210,India
496750,2023-11-05,205,classic yogurt,45,60,15,1,00210,India
273626,2023-11-05,210,mountain dew,75,100,25,1,00350,India
273626,2023-11-05,209,pepsi,75,100,25,1,00350,India
273626,2023-11-05,201,paneer,210,340,130,1,00350,India
700543,2023-11-05,207,coca cola,75,100,25,1,00433,India
700543,2023-11-05,203,mango yogurt,50,60,10,1,00433,India
700543,2023-11-05,206,yakult,360,400,40,1,00433,India
700543,2023-11-05,204,strawberry yogurt,50,60,10,1,00433,India
608231,2023-11-05,207,coca cola,75,100,25,1,00220,India
248895,2023-11-05,213,bisleri,6,15,9,1,00285,India
248895,2023-11-05,201,paneer,210,340,130,1,00285,India
248895,2023-11-05,205,classic yogurt,45,60,15,1,00285,India
756418,2023-11-05,209,pepsi,75,100,25,1,00276,India
756418,2023-11-05,206,yakult,360,400,40,1,00276,India
756418,2023-11-05,212,amul cheese,250,315,65,1,00276,India
927547,2023-11-05,202,milk,12,27,15,1,00131,India
108239,2023-11-05,213,bisleri,6,15,9,1,00098,India
108239,2023-11-05,211,red bull,90,125,35,1,00098,India
108239,2023-11-05,207,coca cola,75,100,25,1,00098,India
602883,2023-11-05,202,milk,12,27,15,1,00291,India
602883,2023-11-05,213,bisleri,6,15,9,1,00291,India
602883,2023-11-05,208,sprite,75,100,25,1,00291,India
654988,2023-11-05,209,pepsi,75,100,25,1,00361,India
933113,2023-11-05,212,amul cheese,250,315,65,1,00023,India
721001,2023-11-05,203,mango yogurt,50,60,10,1,00110,India
721001,2023-11-05,213,bisleri,6,15,9,1,00110,India
721001,2023-11-05,207,coca cola,75,100,25,1,00110,India
502419,2023-11-05,205,classic yogurt,45,60,15,1,00241,India
965262,2023-11-05,211,red bull,90,125,35,1,00043,India
965262,2023-11-05,204,strawberry yogurt,50,60,10,1,00043,India
150977,2023-11-05,203,mango yogurt,50,60,10,1,00360,India
150977,2023-11-05,206,yakult,360,400,40,1,00360,India
150977,2023-11-05,204,strawberry yogurt,50,60,10,1,00360,India
150977,2023-11-05,208,sprite,75,100,25,1,00360,India
483870,2023-11-05,212,amul cheese,250,315,65,1,00161,India
483870,2023-11-05,209,pepsi,75,100,25,1,00161,India
483870,2023-11-05,201,paneer,210,340,130,1,00161,India
973760,2023-11-05,208,sprite,75,100,25,1,00248,India
973760,2023-11-05,212,amul cheese,250,315,65,1,00248,India
407141,2023-11-05,202,milk,12,27,15,1,00155,India
407141,2023-11-05,203,mango yogurt,50,60,10,1,00155,India
407141,2023-11-05,205,classic yogurt,45,60,15,1,00155,India
221383,2023-11-05,201,paneer,210,340,130,1,00129,India
221383,2023-11-05,212,amul cheese,250,315,65,1,00129,India
221383,2023-11-05,213,bisleri,6,15,9,1,00129,India
953552,2023-11-05,204,strawberry yogurt,50,60,10,1,00314,India
953552,2023-11-05,210,mountain dew,75,100,25,1,00314,India
638734,2023-11-05,210,mountain dew,75,100,25,1,00179,India
638734,2023-11-05,209,pepsi,75,100,25,1,00179,India
638734,2023-11-05,203,mango yogurt,50,60,10,1,00179,India
421948,2023-11-05,205,classic yogurt,45,60,15,1,00229,India
421948,2023-11-05,203,mango yogurt,50,60,10,1,00229,India
663022,2023-11-05,201,paneer,210,340,130,1,00175,India
663022,2023-11-05,211,red bull,90,125,35,1,00175,India
663022,2023-11-05,208,sprite,75,100,25,1,00175,India
663022,2023-11-05,212,amul cheese,250,315,65,1,00175,India
663022,2023-11-05,203,mango yogurt,50,60,10,1,00175,India
671216,2023-11-06,202,milk,12,27,15,1,00395,India
671216,2023-11-06,207,coca cola,75,100,25,1,00395,India
280491,2023-11-06,208,sprite,75,100,25,1,00339,India
873377,2023-11-06,206,yakult,360,400,40,1,00043,India
873377,2023-11-06,210,mountain dew,75,100,25,1,00043,India
873377,2023-11-06,207,coca cola,75,100,25,1,00043,India
873377,2023-11-06,201,paneer,210,340,130,1,00043,India
120646,2023-11-06,203,mango yogurt,50,60,10,1,00363,India
120646,2023-11-06,212,amul cheese,250,315,65,1,00363,India
120646,2023-11-06,213,bisleri,6,15,9,1,00363,India
120646,2023-11-06,202,milk,12,27,15,1,00363,India
907760,2023-11-06,213,bisleri,6,15,9,1,00135,India
907760,2023-11-06,205,classic yogurt,45,60,15,1,00135,India
907760,2023-11-06,209,pepsi,75,100,25,1,00135,India
907760,2023-11-06,212,amul cheese,250,315,65,1,00135,India
514962,2023-11-06,212,amul cheese,250,315,65,1,00384,India
514962,2023-11-06,205,classic yogurt,45,60,15,1,00384,India
995819,2023-11-06,207,coca cola,75,100,25,1,00401,India
995819,2023-11-06,201,paneer,210,340,130,1,00401,India
937353,2023-11-06,201,paneer,210,340,130,1,00133,India
937353,2023-11-06,205,classic yogurt,45,60,15,1,00133,India
665852,2023-11-06,203,mango yogurt,50,60,10,1,00132,India
437209,2023-11-06,203,mango yogurt,50,60,10,1,00229,India
437209,2023-11-06,205,classic yogurt,45,60,15,1,00229,India
437209,2023-11-06,208,sprite,75,100,25,1,00229,India
985653,2023-11-06,209,pepsi,75,100,25,1,00023,India
985653,2023-11-06,208,sprite,75,100,25,1,00023,India
443041,2023-11-06,209,pepsi,75,100,25,1,00086,India
937298,2023-11-06,207,coca cola,75,100,25,1,00237,India
937298,2023-11-06,210,mountain dew,75,100,25,1,00237,India
937298,2023-11-06,206,yakult,360,400,40,1,00237,India
620994,2023-11-06,210,mountain dew,75,100,25,1,00436,India
620994,2023-11-06,203,mango yogurt,50,60,10,1,00436,India
657737,2023-11-06,208,sprite,75,100,25,1,00424,India
657737,2023-11-06,205,classic yogurt,45,60,15,1,00424,India
922894,2023-11-06,206,yakult,360,400,40,1,00043,India
922894,2023-11-06,203,mango yogurt,50,60,10,1,00043,India
922894,2023-11-06,209,pepsi,75,100,25,1,00043,India
454807,2023-11-06,207,coca cola,75,100,25,1,00398,India
454807,2023-11-06,213,bisleri,6,15,9,1,00398,India
454807,2023-11-06,210,mountain dew,75,100,25,1,00398,India
538552,2023-11-06,212,amul cheese,250,315,65,1,00181,India
538552,2023-11-06,210,mountain dew,75,100,25,1,00181,India
538552,2023-11-06,205,classic yogurt,45,60,15,1,00181,India
921297,2023-11-06,208,sprite,75,100,25,1,00089,India
921297,2023-11-06,203,mango yogurt,50,60,10,1,00089,India
434076,2023-11-06,204,strawberry yogurt,50,60,10,1,00071,India
434076,2023-11-06,210,mountain dew,75,100,25,1,00071,India
630961,2023-11-06,208,sprite,75,100,25,1,00286,India
505186,2023-11-06,204,strawberry yogurt,50,60,10,1,00031,India
505186,2023-11-06,203,mango yogurt,50,60,10,1,00031,India
505186,2023-11-06,202,milk,12,27,15,1,00031,India
279600,2023-11-06,208,sprite,75,100,25,1,00045,India
279600,2023-11-06,213,bisleri,6,15,9,1,00045,India
279600,2023-11-06,204,strawberry yogurt,50,60,10,1,00045,India
279600,2023-11-06,212,amul cheese,250,315,65,1,00045,India
498138,2023-11-06,201,paneer,210,340,130,1,00114,India
498138,2023-11-06,206,yakult,360,400,40,1,00114,India
498138,2023-11-06,202,milk,12,27,15,1,00114,India
498138,2023-11-06,203,mango yogurt,50,60,10,1,00114,India
761785,2023-11-06,211,red bull,90,125,35,1,00397,India
761785,2023-11-06,202,milk,12,27,15,1,00397,India
826451,2023-11-06,202,milk,12,27,15,1,00219,India
826451,2023-11-06,205,classic yogurt,45,60,15,1,00219,India
122229,2023-11-06,203,mango yogurt,50,60,10,1,00113,India
122229,2023-11-06,201,paneer,210,340,130,1,00113,India
122229,2023-11-06,213,bisleri,6,15,9,1,00113,India
148380,2023-11-06,205,classic yogurt,45,60,15,1,00362,India
991965,2023-11-06,206,yakult,360,400,40,1,00195,India
991965,2023-11-06,213,bisleri,6,15,9,1,00195,India
991965,2023-11-06,210,mountain dew,75,100,25,1,00195,India
587589,2023-11-06,206,yakult,360,400,40,1,00423,India
587589,2023-11-06,205,classic yogurt,45,60,15,1,00423,India
587589,2023-11-06,210,mountain dew,75,100,25,1,00423,India
845755,2023-11-06,213,bisleri,6,15,9,1,00263,India
845755,2023-11-06,204,strawberry yogurt,50,60,10,1,00263,India
845755,2023-11-06,206,yakult,360,400,40,1,00263,India
845755,2023-11-06,209,pepsi,75,100,25,1,00263,India
899294,2023-11-06,204,strawberry yogurt,50,60,10,1,00123,India
197931,2023-11-06,210,mountain dew,75,100,25,1,00295,India
197931,2023-11-06,203,mango yogurt,50,60,10,1,00295,India
373097,2023-11-06,203,mango yogurt,50,60,10,1,00203,India
998742,2023-11-06,201,paneer,210,340,130,1,00288,India
998742,2023-11-06,210,mountain dew,75,100,25,1,00288,India
998742,2023-11-06,213,bisleri,6,15,9,1,00288,India
998742,2023-11-06,202,milk,12,27,15,1,00288,India
745953,2023-11-06,210,mountain dew,75,100,25,1,00347,India
684714,2023-11-06,204,strawberry yogurt,50,60,10,1,00021,India
616822,2023-11-06,208,sprite,75,100,25,1,00128,India
123990,2023-11-06,208,sprite,75,100,25,1,00060,India
123990,2023-11-06,212,amul cheese,250,315,65,1,00060,India
123990,2023-11-06,213,bisleri,6,15,9,1,00060,India
123990,2023-11-06,204,strawberry yogurt,50,60,10,1,00060,India
123990,2023-11-06,201,paneer,210,340,130,1,00060,India
585226,2023-11-06,201,paneer,210,340,130,1,00417,India
585226,2023-11-06,204,strawberry yogurt,50,60,10,1,00417,India
170898,2023-11-06,212,amul cheese,250,315,65,1,00040,India
170898,2023-11-06,210,mountain dew,75,100,25,1,00040,India
170898,2023-11-06,213,bisleri,6,15,9,1,00040,India
170898,2023-11-06,205,classic yogurt,45,60,15,1,00040,India
585587,2023-11-06,213,bisleri,6,15,9,1,00262,India
526293,2023-11-06,203,mango yogurt,50,60,10,1,00461,India
626261,2023-11-06,211,red bull,90,125,35,1,00442,India
626261,2023-11-06,209,pepsi,75,100,25,1,00442,India
626261,2023-11-06,210,mountain dew,75,100,25,1,00442,India
626261,2023-11-06,205,classic yogurt,45,60,15,1,00442,India
825167,2023-11-06,206,yakult,360,400,40,1,00055,India
825167,2023-11-06,208,sprite,75,100,25,1,00055,India
825167,2023-11-06,203,mango yogurt,50,60,10,1,00055,India
825167,2023-11-06,202,milk,12,27,15,1,00055,India
842896,2023-11-06,211,red bull,90,125,35,1,00420,India
842896,2023-11-06,202,milk,12,27,15,1,00420,India
842896,2023-11-06,205,classic yogurt,45,60,15,1,00420,India
842896,2023-11-06,213,bisleri,6,15,9,1,00420,India
497641,2023-11-06,201,paneer,210,340,130,1,00353,India
497641,2023-11-06,213,bisleri,6,15,9,1,00353,India
497641,2023-11-06,205,classic yogurt,45,60,15,1,00353,India
497641,2023-11-06,207,coca cola,75,100,25,1,00353,India
618440,2023-11-06,208,sprite,75,100,25,1,00468,India
707551,2023-11-06,203,mango yogurt,50,60,10,1,00116,India
707551,2023-11-06,207,coca cola,75,100,25,1,00116,India
707551,2023-11-06,206,yakult,360,400,40,1,00116,India
707551,2023-11-06,213,bisleri,6,15,9,1,00116,India
205371,2023-11-06,202,milk,12,27,15,1,00315,India
205371,2023-11-06,209,pepsi,75,100,25,1,00315,India
205371,2023-11-06,210,mountain dew,75,100,25,1,00315,India
692911,2023-11-06,208,sprite,75,100,25,1,00011,India
692911,2023-11-06,201,paneer,210,340,130,1,00011,India
692911,2023-11-06,212,amul cheese,250,315,65,1,00011,India
933968,2023-11-06,209,pepsi,75,100,25,1,00306,India
933968,2023-11-06,204,strawberry yogurt,50,60,10,1,00306,India
933968,2023-11-06,206,yakult,360,400,40,1,00306,India
521306,2023-11-06,205,classic yogurt,45,60,15,1,00022,India
521306,2023-11-06,204,strawberry yogurt,50,60,10,1,00022,India
521306,2023-11-06,201,paneer,210,340,130,1,00022,India
521306,2023-11-06,213,bisleri,6,15,9,1,00022,India
521306,2023-11-06,212,amul cheese,250,315,65,1,00022,India
431961,2023-11-06,205,classic yogurt,45,60,15,1,00293,India
431961,2023-11-06,204,strawberry yogurt,50,60,10,1,00293,India
431961,2023-11-06,210,mountain dew,75,100,25,1,00293,India
431961,2023-11-06,207,coca cola,75,100,25,1,00293,India
431961,2023-11-06,211,red bull,90,125,35,1,00293,India
967235,2023-11-07,204,strawberry yogurt,50,60,10,1,00184,India
350199,2023-11-07,211,red bull,90,125,35,1,00211,India
350199,2023-11-07,212,amul cheese,250,315,65,1,00211,India
350199,2023-11-07,203,mango yogurt,50,60,10,1,00211,India
373494,2023-11-07,202,milk,12,27,15,1,00313,India
373494,2023-11-07,209,pepsi,75,100,25,1,00313,India
373494,2023-11-07,205,classic yogurt,45,60,15,1,00313,India
373494,2023-11-07,212,amul cheese,250,315,65,1,00313,India
862979,2023-11-07,210,mountain dew,75,100,25,1,00347,India
862979,2023-11-07,201,paneer,210,340,130,1,00347,India
862979,2023-11-07,204,strawberry yogurt,50,60,10,1,00347,India
234417,2023-11-07,204,strawberry yogurt,50,60,10,1,00312,India
234417,2023-11-07,202,milk,12,27,15,1,00312,India
234417,2023-11-07,201,paneer,210,340,130,1,00312,India
234417,2023-11-07,207,coca cola,75,100,25,1,00312,India
483400,2023-11-07,209,pepsi,75,100,25,1,00232,India
483400,2023-11-07,205,classic yogurt,45,60,15,1,00232,India
483400,2023-11-07,203,mango yogurt,50,60,10,1,00232,India
420438,2023-11-07,211,red bull,90,125,35,1,00354,India
420438,2023-11-07,207,coca cola,75,100,25,1,00354,India
420438,2023-11-07,203,mango yogurt,50,60,10,1,00354,India
303106,2023-11-07,211,red bull,90,125,35,1,00381,India
303106,2023-11-07,206,yakult,360,400,40,1,00381,India
303106,2023-11-07,205,classic yogurt,45,60,15,1,00381,India
376383,2023-11-07,206,yakult,360,400,40,1,00184,India
376383,2023-11-07,210,mountain dew,75,100,25,1,00184,India
376383,2023-11-07,201,paneer,210,340,130,1,00184,India
633663,2023-11-07,204,strawberry yogurt,50,60,10,1,00346,India
633663,2023-11-07,209,pepsi,75,100,25,1,00346,India
633663,2023-11-07,210,mountain dew,75,100,25,1,00346,India
633663,2023-11-07,203,mango yogurt,50,60,10,1,00346,India
513930,2023-11-07,205,classic yogurt,45,60,15,1,00372,India
513930,2023-11-07,213,bisleri,6,15,9,1,00372,India
513930,2023-11-07,206,yakult,360,400,40,1,00372,India
355742,2023-11-07,206,yakult,360,400,40,1,00002,India
355742,2023-11-07,204,strawberry yogurt,50,60,10,1,00002,India
355742,2023-11-07,202,milk,12,27,15,1,00002,India
825520,2023-11-07,205,classic yogurt,45,60,15,1,00080,India
484873,2023-11-07,206,yakult,360,400,40,1,00139,India
484873,2023-11-07,211,red bull,90,125,35,1,00139,India
778803,2023-11-07,206,yakult,360,400,40,1,00029,India
778803,2023-11-07,202,milk,12,27,15,1,00029,India
778803,2023-11-07,201,paneer,210,340,130,1,00029,India
842367,2023-11-07,209,pepsi,75,100,25,1,00482,India
842367,2023-11-07,204,strawberry yogurt,50,60,10,1,00482,India
842367,2023-11-07,213,bisleri,6,15,9,1,00482,India
841060,2023-11-07,202,milk,12,27,15,1,00012,India
841060,2023-11-07,212,amul cheese,250,315,65,1,00012,India
992356,2023-11-07,203,mango yogurt,50,60,10,1,00233,India
992356,2023-11-07,210,mountain dew,75,100,25,1,00233,India
782161,2023-11-07,211,red bull,90,125,35,1,00396,India
782161,2023-11-07,207,coca cola,75,100,25,1,00396,India
313509,2023-11-07,204,strawberry yogurt,50,60,10,1,00432,India
313509,2023-11-07,211,red bull,90,125,35,1,00432,India
313509,2023-11-07,201,paneer,210,340,130,1,00432,India
193224,2023-11-07,207,coca cola,75,100,25,1,00196,India
193224,2023-11-07,201,paneer,210,340,130,1,00196,India
193224,2023-11-07,211,red bull,90,125,35,1,00196,India
193224,2023-11-07,213,bisleri,6,15,9,1,00196,India
305763,2023-11-07,209,pepsi,75,100,25,1,00384,India
305763,2023-11-07,208,sprite,75,100,25,1,00384,India
305763,2023-11-07,204,strawberry yogurt,50,60,10,1,00384,India
305763,2023-11-07,211,red bull,90,125,35,1,00384,India
868601,2023-11-07,208,sprite,75,100,25,1,00461,India
868601,2023-11-07,209,pepsi,75,100,25,1,00461,India
868601,2023-11-07,213,bisleri,6,15,9,1,00461,India
868601,2023-11-07,211,red bull,90,125,35,1,00461,India
232418,2023-11-07,211,red bull,90,125,35,1,00321,India
232418,2023-11-07,210,mountain dew,75,100,25,1,00321,India
491491,2023-11-07,201,paneer,210,340,130,1,00128,India
491491,2023-11-07,208,sprite,75,100,25,1,00128,India
567695,2023-11-07,207,coca cola,75,100,25,1,00409,India
586975,2023-11-07,210,mountain dew,75,100,25,1,00130,India
586975,2023-11-07,204,strawberry yogurt,50,60,10,1,00130,India
586975,2023-11-07,212,amul cheese,250,315,65,1,00130,India
586975,2023-11-07,201,paneer,210,340,130,1,00130,India
555065,2023-11-07,202,milk,12,27,15,1,00351,India
776030,2023-11-07,208,sprite,75,100,25,1,00444,India
776030,2023-11-07,204,strawberry yogurt,50,60,10,1,00444,India
776030,2023-11-07,203,mango yogurt,50,60,10,1,00444,India
776030,2023-11-07,206,yakult,360,400,40,1,00444,India
164289,2023-11-07,202,milk,12,27,15,1,00105,India
164289,2023-11-07,211,red bull,90,125,35,1,00105,India
164289,2023-11-07,213,bisleri,6,15,9,1,00105,India
164289,2023-11-07,201,paneer,210,340,130,1,00105,India
355810,2023-11-07,209,pepsi,75,100,25,1,00063,India
355810,2023-11-07,213,bisleri,6,15,9,1,00063,India
355810,2023-11-07,210,mountain dew,75,100,25,1,00063,India
355810,2023-11-07,211,red bull,90,125,35,1,00063,India
347123,2023-11-07,212,amul cheese,250,315,65,1,00082,India
347123,2023-11-07,204,strawberry yogurt,50,60,10,1,00082,India
347123,2023-11-07,213,bisleri,6,15,9,1,00082,India
408636,2023-11-07,211,red bull,90,125,35,1,00342,India
471488,2023-11-07,211,red bull,90,125,35,1,00187,India
471488,2023-11-07,204,strawberry yogurt,50,60,10,1,00187,India
471488,2023-11-07,210,mountain dew,75,100,25,1,00187,India
471488,2023-11-07,213,bisleri,6,15,9,1,00187,India
380509,2023-11-07,208,sprite,75,100,25,1,00011,India
884307,2023-11-07,203,mango yogurt,50,60,10,1,00259,India
884307,2023-11-07,211,red bull,90,125,35,1,00259,India
884307,2023-11-07,201,paneer,210,340,130,1,00259,India
884307,2023-11-07,212,amul cheese,250,315,65,1,00259,India
761051,2023-11-07,203,mango yogurt,50,60,10,1,00158,India
761051,2023-11-07,208,sprite,75,100,25,1,00158,India
923666,2023-11-07,205,classic yogurt,45,60,15,1,00489,India
923666,2023-11-07,207,coca cola,75,100,25,1,00489,India
434125,2023-11-07,209,pepsi,75,100,25,1,00202,India
434125,2023-11-07,213,bisleri,6,15,9,1,00202,India
434125,2023-11-07,201,paneer,210,340,130,1,00202,India
434125,2023-11-07,206,yakult,360,400,40,1,00202,India
434125,2023-11-07,203,mango yogurt,50,60,10,1,00202,India
667019,2023-11-07,203,mango yogurt,50,60,10,1,00299,India
667019,2023-11-07,212,amul cheese,250,315,65,1,00299,India
667019,2023-11-07,206,yakult,360,400,40,1,00299,India
667019,2023-11-07,207,coca cola,75,100,25,1,00299,India
500685,2023-11-07,210,mountain dew,75,100,25,1,00404,India
500685,2023-11-07,205,classic yogurt,45,60,15,1,00404,India
500685,2023-11-07,208,sprite,75,100,25,1,00404,India
500685,2023-11-07,211,red bull,90,125,35,1,00404,India
962781,2023-11-07,209,pepsi,75,100,25,1,00259,India
962781,2023-11-07,208,sprite,75,100,25,1,00259,India
962781,2023-11-07,205,classic yogurt,45,60,15,1,00259,India
426012,2023-11-07,209,pepsi,75,100,25,1,00025,India
472030,2023-11-07,206,yakult,360,400,40,1,00169,India
472030,2023-11-07,203,mango yogurt,50,60,10,1,00169,India
429179,2023-11-07,209,pepsi,75,100,25,1,00251,India
429179,2023-11-07,213,bisleri,6,15,9,1,00251,India
429179,2023-11-07,206,yakult,360,400,40,1,00251,India
501822,2023-11-07,203,mango yogurt,50,60,10,1,00040,India
501822,2023-11-07,208,sprite,75,100,25,1,00040,India
501822,2023-11-07,211,red bull,90,125,35,1,00040,India
501822,2023-11-07,209,pepsi,75,100,25,1,00040,India
956740,2023-11-07,202,milk,12,27,15,1,00355,India
956740,2023-11-07,205,classic yogurt,45,60,15,1,00355,India
956740,2023-11-07,203,mango yogurt,50,60,10,1,00355,India
588785,2023-11-07,210,mountain dew,75,100,25,1,00334,India
588785,2023-11-07,208,sprite,75,100,25,1,00334,India
588785,2023-11-07,211,red bull,90,125,35,1,00334,India
588785,2023-11-07,212,amul cheese,250,315,65,1,00334,India
478803,2023-11-07,206,yakult,360,400,40,1,00217,India
478803,2023-11-07,213,bisleri,6,15,9,1,00217,India
131368,2023-11-07,212,amul cheese,250,315,65,1,00029,India
131368,2023-11-07,210,mountain dew,75,100,25,1,00029,India
777057,2023-11-07,206,yakult,360,400,40,1,00125,India
580681,2023-11-07,210,mountain dew,75,100,25,1,00428,India
580681,2023-11-07,204,strawberry yogurt,50,60,10,1,00428,India
580681,2023-11-07,213,bisleri,6,15,9,1,00428,India
923763,2023-11-07,213,bisleri,6,15,9,1,00376,India
923763,2023-11-07,201,paneer,210,340,130,1,00376,India
923763,2023-11-07,203,mango yogurt,50,60,10,1,00376,India
923763,2023-11-07,212,amul cheese,250,315,65,1,00376,India
781635,2023-11-07,201,paneer,210,340,130,1,00251,India
781635,2023-11-07,206,yakult,360,400,40,1,00251,India
781635,2023-11-07,207,coca cola,75,100,25,1,00251,India
781635,2023-11-07,212,amul cheese,250,315,65,1,00251,India
775535,2023-11-08,206,yakult,360,400,40,1,00137,India
775535,2023-11-08,213,bisleri,6,15,9,1,00137,India
547658,2023-11-08,202,milk,12,27,15,1,00454,India
547658,2023-11-08,204,strawberry yogurt,50,60,10,1,00454,India
547658,2023-11-08,207,coca cola,75,100,25,1,00454,India
547658,2023-11-08,213,bisleri,6,15,9,1,00454,India
955046,2023-11-08,211,red bull,90,125,35,1,00498,India
115983,2023-11-08,210,mountain dew,75,100,25,1,00425,India
115983,2023-11-08,208,sprite,75,100,25,1,00425,India
115983,2023-11-08,206,yakult,360,400,40,1,00425,India
565979,2023-11-08,209,pepsi,75,100,25,1,00045,India
565979,2023-11-08,207,coca cola,75,100,25,1,00045,India
942105,2023-11-08,204,strawberry yogurt,50,60,10,1,00409,India
942105,2023-11-08,205,classic yogurt,45,60,15,1,00409,India
421004,2023-11-08,211,red bull,90,125,35,1,00327,India
421004,2023-11-08,205,classic yogurt,45,60,15,1,00327,India
421004,2023-11-08,213,bisleri,6,15,9,1,00327,India
212871,2023-11-08,207,coca cola,75,100,25,1,00225,India
212871,2023-11-08,204,strawberry yogurt,50,60,10,1,00225,India
212871,2023-11-08,213,bisleri,6,15,9,1,00225,India
212871,2023-11-08,205,classic yogurt,45,60,15,1,00225,India
460220,2023-11-08,209,pepsi,75,100,25,1,00321,India
767996,2023-11-08,202,milk,12,27,15,1,00090,India
767996,2023-11-08,208,sprite,75,100,25,1,00090,India
596497,2023-11-08,209,pepsi,75,100,25,1,00138,India
596497,2023-11-08,201,paneer,210,340,130,1,00138,India
596497,2023-11-08,210,mountain dew,75,100,25,1,00138,India
297739,2023-11-08,201,paneer,210,340,130,1,00101,India
297739,2023-11-08,202,milk,12,27,15,1,00101,India
297739,2023-11-08,203,mango yogurt,50,60,10,1,00101,India
297739,2023-11-08,210,mountain dew,75,100,25,1,00101,India
393334,2023-11-08,203,mango yogurt,50,60,10,1,00218,India
393334,2023-11-08,204,strawberry yogurt,50,60,10,1,00218,India
393334,2023-11-08,211,red bull,90,125,35,1,00218,India
216624,2023-11-08,204,strawberry yogurt,50,60,10,1,00482,India
504545,2023-11-08,201,paneer,210,340,130,1,00385,India
878089,2023-11-08,207,coca cola,75,100,25,1,00181,India
878089,2023-11-08,213,bisleri,6,15,9,1,00181,India
878089,2023-11-08,202,milk,12,27,15,1,00181,India
607096,2023-11-08,212,amul cheese,250,315,65,1,00271,India
452052,2023-11-08,202,milk,12,27,15,1,00295,India
348217,2023-11-08,203,mango yogurt,50,60,10,1,00406,India
732495,2023-11-08,206,yakult,360,400,40,1,00270,India
732495,2023-11-08,213,bisleri,6,15,9,1,00270,India
732495,2023-11-08,205,classic yogurt,45,60,15,1,00270,India
868349,2023-11-08,204,strawberry yogurt,50,60,10,1,00381,India
317807,2023-11-08,212,amul cheese,250,315,65,1,00113,India
317807,2023-11-08,203,mango yogurt,50,60,10,1,00113,India
838407,2023-11-08,205,classic yogurt,45,60,15,1,00386,India
566004,2023-11-08,202,milk,12,27,15,1,00414,India
566004,2023-11-08,205,classic yogurt,45,60,15,1,00414,India
566004,2023-11-08,210,mountain dew,75,100,25,1,00414,India
566004,2023-11-08,212,amul cheese,250,315,65,1,00414,India
696264,2023-11-08,213,bisleri,6,15,9,1,00311,India
696264,2023-11-08,203,mango yogurt,50,60,10,1,00311,India
841131,2023-11-08,204,strawberry yogurt,50,60,10,1,00435,India
432224,2023-11-08,201,paneer,210,340,130,1,00029,India
704581,2023-11-08,211,red bull,90,125,35,1,00005,India
175496,2023-11-08,208,sprite,75,100,25,1,00415,India
175496,2023-11-08,201,paneer,210,340,130,1,00415,India
175496,2023-11-08,202,milk,12,27,15,1,00415,India
534418,2023-11-08,207,coca cola,75,100,25,1,00393,India
534418,2023-11-08,208,sprite,75,100,25,1,00393,India
534418,2023-11-08,205,classic yogurt,45,60,15,1,00393,India
534418,2023-11-08,202,milk,12,27,15,1,00393,India
475387,2023-11-08,212,amul cheese,250,315,65,1,00274,India
475387,2023-11-08,210,mountain dew,75,100,25,1,00274,India
475387,2023-11-08,213,bisleri,6,15,9,1,00274,India
475387,2023-11-08,202,milk,12,27,15,1,00274,India
503077,2023-11-08,203,mango yogurt,50,60,10,1,00138,India
503077,2023-11-08,207,coca cola,75,100,25,1,00138,India
503077,2023-11-08,213,bisleri,6,15,9,1,00138,India
503077,2023-11-08,212,amul cheese,250,315,65,1,00138,India
503077,2023-11-08,206,yakult,360,400,40,1,00138,India
904814,2023-11-08,203,mango yogurt,50,60,10,1,00378,India
904814,2023-11-08,202,milk,12,27,15,1,00378,India
904814,2023-11-08,205,classic yogurt,45,60,15,1,00378,India
904814,2023-11-08,204,strawberry yogurt,50,60,10,1,00378,India
219550,2023-11-08,208,sprite,75,100,25,1,00015,India
219550,2023-11-08,207,coca cola,75,100,25,1,00015,India
736081,2023-11-08,211,red bull,90,125,35,1,00206,India
736081,2023-11-08,210,mountain dew,75,100,25,1,00206,India
777329,2023-11-08,206,yakult,360,400,40,1,00478,India
777329,2023-11-08,210,mountain dew,75,100,25,1,00478,India
777329,2023-11-08,208,sprite,75,100,25,1,00478,India
777329,2023-11-08,204,strawberry yogurt,50,60,10,1,00478,India
963136,2023-11-08,208,sprite,75,100,25,1,00457,India
963136,2023-11-08,203,mango yogurt,50,60,10,1,00457,India
963136,2023-11-08,201,paneer,210,340,130,1,00457,India
963136,2023-11-08,205,classic yogurt,45,60,15,1,00457,India
963136,2023-11-08,211,red bull,90,125,35,1,00457,India
933967,2023-11-08,212,amul cheese,250,315,65,1,00135,India
933967,2023-11-08,203,mango yogurt,50,60,10,1,00135,India
933967,2023-11-08,213,bisleri,6,15,9,1,00135,India
933967,2023-11-08,211,red bull,90,125,35,1,00135,India
654023,2023-11-08,203,mango yogurt,50,60,10,1,00023,India
654023,2023-11-08,211,red bull,90,125,35,1,00023,India
654023,2023-11-08,210,mountain dew,75,100,25,1,00023,India
577753,2023-11-08,203,mango yogurt,50,60,10,1,00021,India
577753,2023-11-08,208,sprite,75,100,25,1,00021,India
577753,2023-11-08,213,bisleri,6,15,9,1,00021,India
577753,2023-11-08,211,red bull,90,125,35,1,00021,India
577753,2023-11-08,201,paneer,210,340,130,1,00021,India
621737,2023-11-08,202,milk,12,27,15,1,00103,India
621737,2023-11-08,207,coca cola,75,100,25,1,00103,India
621737,2023-11-08,208,sprite,75,100,25,1,00103,India
621737,2023-11-08,206,yakult,360,400,40,1,00103,India
220729,2023-11-08,202,milk,12,27,15,1,00219,India
685492,2023-11-08,205,classic yogurt,45,60,15,1,00471,India
685492,2023-11-08,206,yakult,360,400,40,1,00471,India
685492,2023-11-08,211,red bull,90,125,35,1,00471,India
685492,2023-11-08,209,pepsi,75,100,25,1,00471,India
431380,2023-11-08,207,coca cola,75,100,25,1,00470,India
431380,2023-11-08,208,sprite,75,100,25,1,00470,India
431380,2023-11-08,213,bisleri,6,15,9,1,00470,India
224060,2023-11-08,204,strawberry yogurt,50,60,10,1,00366,India
224060,2023-11-08,209,pepsi,75,100,25,1,00366,India
416789,2023-11-08,208,sprite,75,100,25,1,00381,India
416789,2023-11-08,206,yakult,360,400,40,1,00381,India
416789,2023-11-08,205,classic yogurt,45,60,15,1,00381,India
416789,2023-11-08,213,bisleri,6,15,9,1,00381,India
972788,2023-11-08,211,red bull,90,125,35,1,00068,India
972788,2023-11-08,203,mango yogurt,50,60,10,1,00068,India
665034,2023-11-08,207,coca cola,75,100,25,1,00411,India
668890,2023-11-08,203,mango yogurt,50,60,10,1,00108,India
668890,2023-11-08,204,strawberry yogurt,50,60,10,1,00108,India
736432,2023-11-08,207,coca cola,75,100,25,1,00036,India
448523,2023-11-08,206,yakult,360,400,40,1,00179,India
448523,2023-11-08,210,mountain dew,75,100,25,1,00179,India
729856,2023-11-08,202,milk,12,27,15,1,00192,India
729856,2023-11-08,204,strawberry yogurt,50,60,10,1,00192,India
729856,2023-11-08,206,yakult,360,400,40,1,00192,India
729856,2023-11-08,209,pepsi,75,100,25,1,00192,India
447255,2023-11-08,205,classic yogurt,45,60,15,1,00308,India
447255,2023-11-08,213,bisleri,6,15,9,1,00308,India
447255,2023-11-08,211,red bull,90,125,35,1,00308,India
447255,2023-11-08,208,sprite,75,100,25,1,00308,India
846256,2023-11-08,208,sprite,75,100,25,1,00192,India
846256,2023-11-08,203,mango yogurt,50,60,10,1,00192,India
846256,2023-11-08,201,paneer,210,340,130,1,00192,India
753405,2023-11-08,202,milk,12,27,15,1,00372,India
753405,2023-11-08,204,strawberry yogurt,50,60,10,1,00372,India
889414,2023-11-08,202,milk,12,27,15,1,00361,India
474204,2023-11-08,204,strawberry yogurt,50,60,10,1,00403,India
474204,2023-11-08,202,milk,12,27,15,1,00403,India
474204,2023-11-08,205,classic yogurt,45,60,15,1,00403,India
911916,2023-11-08,211,red bull,90,125,35,1,00134,India
911916,2023-11-08,206,yakult,360,400,40,1,00134,India
729576,2023-11-08,208,sprite,75,100,25,1,00480,India
729576,2023-11-08,212,amul cheese,250,315,65,1,00480,India
729576,2023-11-08,203,mango yogurt,50,60,10,1,00480,India
729576,2023-11-08,209,pepsi,75,100,25,1,00480,India
822224,2023-11-08,207,coca cola,75,100,25,1,00052,India
822224,2023-11-08,211,red bull,90,125,35,1,00052,India
822224,2023-11-08,201,paneer,210,340,130,1,00052,India
822224,2023-11-08,206,yakult,360,400,40,1,00052,India
860068,2023-11-08,209,pepsi,75,100,25,1,00440,India
860068,2023-11-08,206,yakult,360,400,40,1,00440,India
860068,2023-11-08,205,classic yogurt,45,60,15,1,00440,India
860068,2023-11-08,213,bisleri,6,15,9,1,00440,India
296441,2023-11-08,211,red bull,90,125,35,1,00003,India
600957,2023-11-08,213,bisleri,6,15,9,1,00344,India
717236,2023-11-08,209,pepsi,75,100,25,1,00137,India
717236,2023-11-08,203,mango yogurt,50,60,10,1,00137,India
607637,2023-11-08,207,coca cola,75,100,25,1,00430,India
607637,2023-11-08,204,strawberry yogurt,50,60,10,1,00430,India
754421,2023-11-08,209,pepsi,75,100,25,1,00496,India
754421,2023-11-08,205,classic yogurt,45,60,15,1,00496,India
754421,2023-11-08,206,yakult,360,400,40,1,00496,India
754421,2023-11-08,210,mountain dew,75,100,25,1,00496,India
754421,2023-11-08,202,milk,12,27,15,1,00496,India
313861,2023-11-08,213,bisleri,6,15,9,1,00085,India
313861,2023-11-08,204,strawberry yogurt,50,60,10,1,00085,India
313861,2023-11-08,211,red bull,90,125,35,1,00085,India
313861,2023-11-08,205,classic yogurt,45,60,15,1,00085,India
187439,2023-11-08,202,milk,12,27,15,1,00208,India
187439,2023-11-08,207,coca cola,75,100,25,1,00208,India
187439,2023-11-08,208,sprite,75,100,25,1,00208,India
661971,2023-11-08,207,coca cola,75,100,25,1,00038,India
661971,2023-11-08,205,classic yogurt,45,60,15,1,00038,India
661971,2023-11-08,203,mango yogurt,50,60,10,1,00038,India
661971,2023-11-08,201,paneer,210,340,130,1,00038,India
661971,2023-11-08,211,red bull,90,125,35,1,00038,India
255169,2023-11-08,208,sprite,75,100,25,1,00134,India
800281,2023-11-08,202,milk,12,27,15,1,00222,India
800281,2023-11-08,209,pepsi,75,100,25,1,00222,India
800281,2023-11-08,208,sprite,75,100,25,1,00222,India
963583,2023-11-08,210,mountain dew,75,100,25,1,00036,India
963583,2023-11-08,213,bisleri,6,15,9,1,00036,India
963583,2023-11-08,206,yakult,360,400,40,1,00036,India
963583,2023-11-08,203,mango yogurt,50,60,10,1,00036,India
904784,2023-11-08,204,strawberry yogurt,50,60,10,1,00234,India
904784,2023-11-08,207,coca cola,75,100,25,1,00234,India
906130,2023-11-08,209,pepsi,75,100,25,1,00415,India
237872,2023-11-08,213,bisleri,6,15,9,1,00156,India
413513,2023-11-08,206,yakult,360,400,40,1,00458,India
413513,2023-11-08,203,mango yogurt,50,60,10,1,00458,India
261101,2023-11-08,211,red bull,90,125,35,1,00298,India
261101,2023-11-08,207,coca cola,75,100,25,1,00298,India
643386,2023-11-08,211,red bull,90,125,35,1,00279,India
643386,2023-11-08,202,milk,12,27,15,1,00279,India
643386,2023-11-08,210,mountain dew,75,100,25,1,00279,India
643386,2023-11-08,207,coca cola,75,100,25,1,00279,India
643386,2023-11-08,209,pepsi,75,100,25,1,00279,India
147710,2023-11-08,206,yakult,360,400,40,1,00205,India
147710,2023-11-08,211,red bull,90,125,35,1,00205,India
147710,2023-11-08,205,classic yogurt,45,60,15,1,00205,India
147710,2023-11-08,207,coca cola,75,100,25,1,00205,India
176044,2023-11-08,212,amul cheese,250,315,65,1,00316,India
176044,2023-11-08,205,classic yogurt,45,60,15,1,00316,India
176044,2023-11-08,204,strawberry yogurt,50,60,10,1,00316,India
176044,2023-11-08,210,mountain dew,75,100,25,1,00316,India
320615,2023-11-08,204,strawberry yogurt,50,60,10,1,00018,India
320615,2023-11-08,213,bisleri,6,15,9,1,00018,India
377167,2023-11-08,210,mountain dew,75,100,25,1,00263,India
377167,2023-11-08,209,pepsi,75,100,25,1,00263,India
377167,2023-11-08,208,sprite,75,100,25,1,00263,India
597595,2023-11-08,208,sprite,75,100,25,1,00007,India
597595,2023-11-08,205,classic yogurt,45,60,15,1,00007,India
597595,2023-11-08,202,milk,12,27,15,1,00007,India
420568,2023-11-08,209,pepsi,75,100,25,1,00476,India
420568,2023-11-08,203,mango yogurt,50,60,10,1,00476,India
420568,2023-11-08,207,coca cola,75,100,25,1,00476,India
657363,2023-11-08,213,bisleri,6,15,9,1,00453,India
657363,2023-11-08,205,classic yogurt,45,60,15,1,00453,India
657363,2023-11-08,210,mountain dew,75,100,25,1,00453,India
657363,2023-11-08,202,milk,12,27,15,1,00453,India
941483,2023-11-08,210,mountain dew,75,100,25,1,00021,India
941483,2023-11-08,209,pepsi,75,100,25,1,00021,India
514891,2023-11-08,206,yakult,360,400,40,1,00148,India
514891,2023-11-08,203,mango yogurt,50,60,10,1,00148,India
790573,2023-11-08,202,milk,12,27,15,1,00362,India
790573,2023-11-08,204,strawberry yogurt,50,60,10,1,00362,India
790573,2023-11-08,207,coca cola,75,100,25,1,00362,India
349808,2023-11-08,205,classic yogurt,45,60,15,1,00372,India
349808,2023-11-08,207,coca cola,75,100,25,1,00372,India
349808,2023-11-08,213,bisleri,6,15,9,1,00372,India
967931,2023-11-08,203,mango yogurt,50,60,10,1,00172,India
952799,2023-11-08,206,yakult,360,400,40,1,00203,India
952799,2023-11-08,213,bisleri,6,15,9,1,00203,India
952799,2023-11-08,210,mountain dew,75,100,25,1,00203,India
952799,2023-11-08,209,pepsi,75,100,25,1,00203,India
952799,2023-11-08,207,coca cola,75,100,25,1,00203,India
865211,2023-11-08,202,milk,12,27,15,1,00250,India
865211,2023-11-08,201,paneer,210,340,130,1,00250,India
865211,2023-11-08,205,classic yogurt,45,60,15,1,00250,India
865211,2023-11-08,207,coca cola,75,100,25,1,00250,India
371691,2023-11-08,207,coca cola,75,100,25,1,00155,India
359698,2023-11-08,201,paneer,210,340,130,1,00159,India
692129,2023-11-08,204,strawberry yogurt,50,60,10,1,00060,India
692129,2023-11-08,205,classic yogurt,45,60,15,1,00060,India
458326,2023-11-08,211,red bull,90,125,35,1,00367,India
458326,2023-11-08,212,amul cheese,250,315,65,1,00367,India
458326,2023-11-08,210,mountain dew,75,100,25,1,00367,India
458326,2023-11-08,213,bisleri,6,15,9,1,00367,India
458326,2023-11-08,203,mango yogurt,50,60,10,1,00367,India
752101,2023-11-09,212,amul cheese,250,315,65,1,00411,India
752101,2023-11-09,209,pepsi,75,100,25,1,00411,India
752101,2023-11-09,210,mountain dew,75,100,25,1,00411,India
244495,2023-11-09,213,bisleri,6,15,9,1,00386,India
244495,2023-11-09,208,sprite,75,100,25,1,00386,India
985781,2023-11-09,211,red bull,90,125,35,1,00177,India
985781,2023-11-09,210,mountain dew,75,100,25,1,00177,India
342572,2023-11-09,206,yakult,360,400,40,1,00210,India
729883,2023-11-09,201,paneer,210,340,130,1,00399,India
729883,2023-11-09,213,bisleri,6,15,9,1,00399,India
750432,2023-11-09,211,red bull,90,125,35,1,00043,India
750432,2023-11-09,205,classic yogurt,45,60,15,1,00043,India
750432,2023-11-09,203,mango yogurt,50,60,10,1,00043,India
750432,2023-11-09,208,sprite,75,100,25,1,00043,India
666474,2023-11-09,203,mango yogurt,50,60,10,1,00019,India
666474,2023-11-09,207,coca cola,75,100,25,1,00019,India
666474,2023-11-09,213,bisleri,6,15,9,1,00019,India
677304,2023-11-09,211,red bull,90,125,35,1,00051,India
677304,2023-11-09,201,paneer,210,340,130,1,00051,India
677304,2023-11-09,208,sprite,75,100,25,1,00051,India
528630,2023-11-09,203,mango yogurt,50,60,10,1,00006,India
528630,2023-11-09,204,strawberry yogurt,50,60,10,1,00006,India
126611,2023-11-09,204,strawberry yogurt,50,60,10,1,00234,India
126611,2023-11-09,201,paneer,210,340,130,1,00234,India
126611,2023-11-09,209,pepsi,75,100,25,1,00234,India
126611,2023-11-09,205,classic yogurt,45,60,15,1,00234,India
516376,2023-11-09,209,pepsi,75,100,25,1,00236,India
516376,2023-11-09,202,milk,12,27,15,1,00236,India
516376,2023-11-09,208,sprite,75,100,25,1,00236,India
516376,2023-11-09,206,yakult,360,400,40,1,00236,India
516376,2023-11-09,203,mango yogurt,50,60,10,1,00236,India
824697,2023-11-09,203,mango yogurt,50,60,10,1,00198,India
269904,2023-11-09,211,red bull,90,125,35,1,00174,India
269904,2023-11-09,206,yakult,360,400,40,1,00174,India
536965,2023-11-09,208,sprite,75,100,25,1,00225,India
536965,2023-11-09,203,mango yogurt,50,60,10,1,00225,India
187426,2023-11-09,213,bisleri,6,15,9,1,00204,India
187426,2023-11-09,204,strawberry yogurt,50,60,10,1,00204,India
187426,2023-11-09,206,yakult,360,400,40,1,00204,India
165878,2023-11-09,202,milk,12,27,15,1,00218,India
235637,2023-11-09,202,milk,12,27,15,1,00052,India
235637,2023-11-09,210,mountain dew,75,100,25,1,00052,India
188563,2023-11-09,210,mountain dew,75,100,25,1,00404,India
188563,2023-11-09,201,paneer,210,340,130,1,00404,India
568429,2023-11-09,204,strawberry yogurt,50,60,10,1,00371,India
568429,2023-11-09,207,coca cola,75,100,25,1,00371,India
568429,2023-11-09,201,paneer,210,340,130,1,00371,India
568429,2023-11-09,211,red bull,90,125,35,1,00371,India
548116,2023-11-09,210,mountain dew,75,100,25,1,00393,India
812615,2023-11-09,208,sprite,75,100,25,1,00442,India
812615,2023-11-09,211,red bull,90,125,35,1,00442,India
812615,2023-11-09,207,coca cola,75,100,25,1,00442,India
812615,2023-11-09,205,classic yogurt,45,60,15,1,00442,India
812615,2023-11-09,201,paneer,210,340,130,1,00442,India
196891,2023-11-09,206,yakult,360,400,40,1,00353,India
196891,2023-11-09,202,milk,12,27,15,1,00353,India
553569,2023-11-09,205,classic yogurt,45,60,15,1,00370,India
553569,2023-11-09,201,paneer,210,340,130,1,00370,India
553569,2023-11-09,208,sprite,75,100,25,1,00370,India
333154,2023-11-09,203,mango yogurt,50,60,10,1,00268,India
333154,2023-11-09,212,amul cheese,250,315,65,1,00268,India
333154,2023-11-09,206,yakult,360,400,40,1,00268,India
333154,2023-11-09,209,pepsi,75,100,25,1,00268,India
257848,2023-11-09,205,classic yogurt,45,60,15,1,00043,India
257848,2023-11-09,210,mountain dew,75,100,25,1,00043,India
257848,2023-11-09,204,strawberry yogurt,50,60,10,1,00043,India
257848,2023-11-09,212,amul cheese,250,315,65,1,00043,India
913350,2023-11-09,205,classic yogurt,45,60,15,1,00166,India
913350,2023-11-09,210,mountain dew,75,100,25,1,00166,India
913350,2023-11-09,211,red bull,90,125,35,1,00166,India
913350,2023-11-09,201,paneer,210,340,130,1,00166,India
913350,2023-11-09,213,bisleri,6,15,9,1,00166,India
275756,2023-11-09,202,milk,12,27,15,1,00429,India
148125,2023-11-09,210,mountain dew,75,100,25,1,00059,India
148125,2023-11-09,213,bisleri,6,15,9,1,00059,India
501196,2023-11-09,205,classic yogurt,45,60,15,1,00489,India
501196,2023-11-09,204,strawberry yogurt,50,60,10,1,00489,India
787639,2023-11-09,206,yakult,360,400,40,1,00438,India
787639,2023-11-09,210,mountain dew,75,100,25,1,00438,India
787639,2023-11-09,205,classic yogurt,45,60,15,1,00438,India
627725,2023-11-09,209,pepsi,75,100,25,1,00237,India
627725,2023-11-09,201,paneer,210,340,130,1,00237,India
627725,2023-11-09,208,sprite,75,100,25,1,00237,India
498928,2023-11-09,207,coca cola,75,100,25,1,00097,India
498928,2023-11-09,206,yakult,360,400,40,1,00097,India
498928,2023-11-09,205,classic yogurt,45,60,15,1,00097,India
772214,2023-11-09,210,mountain dew,75,100,25,1,00268,India
772214,2023-11-09,204,strawberry yogurt,50,60,10,1,00268,India
772214,2023-11-09,213,bisleri,6,15,9,1,00268,India
772214,2023-11-09,201,paneer,210,340,130,1,00268,India
772214,2023-11-09,208,sprite,75,100,25,1,00268,India
121296,2023-11-09,210,mountain dew,75,100,25,1,00439,India
121296,2023-11-09,206,yakult,360,400,40,1,00439,India
242325,2023-11-09,203,mango yogurt,50,60,10,1,00406,India
242325,2023-11-09,207,coca cola,75,100,25,1,00406,India
242325,2023-11-09,210,mountain dew,75,100,25,1,00406,India
684615,2023-11-09,209,pepsi,75,100,25,1,00491,India
294948,2023-11-09,201,paneer,210,340,130,1,00128,India
367980,2023-11-09,201,paneer,210,340,130,1,00308,India
956212,2023-11-09,208,sprite,75,100,25,1,00280,India
956212,2023-11-09,206,yakult,360,400,40,1,00280,India
956212,2023-11-09,204,strawberry yogurt,50,60,10,1,00280,India
956212,2023-11-09,213,bisleri,6,15,9,1,00280,India
481919,2023-11-09,209,pepsi,75,100,25,1,00278,India
481919,2023-11-09,202,milk,12,27,15,1,00278,India
481919,2023-11-09,207,coca cola,75,100,25,1,00278,India
481919,2023-11-09,210,mountain dew,75,100,25,1,00278,India
481919,2023-11-09,213,bisleri,6,15,9,1,00278,India
352506,2023-11-09,209,pepsi,75,100,25,1,00144,India
195078,2023-11-09,204,strawberry yogurt,50,60,10,1,00466,India
195078,2023-11-09,201,paneer,210,340,130,1,00466,India
895350,2023-11-09,207,coca cola,75,100,25,1,00128,India
895350,2023-11-09,213,bisleri,6,15,9,1,00128,India
895350,2023-11-09,204,strawberry yogurt,50,60,10,1,00128,India
951830,2023-11-09,205,classic yogurt,45,60,15,1,00198,India
951830,2023-11-09,202,milk,12,27,15,1,00198,India
951830,2023-11-09,209,pepsi,75,100,25,1,00198,India
951830,2023-11-09,213,bisleri,6,15,9,1,00198,India
951830,2023-11-09,212,amul cheese,250,315,65,1,00198,India
701862,2023-11-09,206,yakult,360,400,40,1,00020,India
701862,2023-11-09,211,red bull,90,125,35,1,00020,India
333688,2023-11-09,212,amul cheese,250,315,65,1,00184,India
333688,2023-11-09,206,yakult,360,400,40,1,00184,India
333688,2023-11-09,202,milk,12,27,15,1,00184,India
171643,2023-11-09,207,coca cola,75,100,25,1,00281,India
171643,2023-11-09,202,milk,12,27,15,1,00281,India
422406,2023-11-09,206,yakult,360,400,40,1,00129,India
422406,2023-11-09,212,amul cheese,250,315,65,1,00129,India
173387,2023-11-09,201,paneer,210,340,130,1,00362,India
173387,2023-11-09,203,mango yogurt,50,60,10,1,00362,India
569588,2023-11-09,204,strawberry yogurt,50,60,10,1,00242,India
569588,2023-11-09,209,pepsi,75,100,25,1,00242,India
988622,2023-11-09,209,pepsi,75,100,25,1,00155,India
988622,2023-11-09,213,bisleri,6,15,9,1,00155,India
145076,2023-11-09,207,coca cola,75,100,25,1,00210,India
145076,2023-11-09,208,sprite,75,100,25,1,00210,India
345678,2023-11-09,210,mountain dew,75,100,25,1,00336,India
345678,2023-11-09,209,pepsi,75,100,25,1,00336,India
345678,2023-11-09,208,sprite,75,100,25,1,00336,India
345678,2023-11-09,206,yakult,360,400,40,1,00336,India
900933,2023-11-09,204,strawberry yogurt,50,60,10,1,00247,India
900933,2023-11-09,206,yakult,360,400,40,1,00247,India
988484,2023-11-09,209,pepsi,75,100,25,1,00240,India
988484,2023-11-09,206,yakult,360,400,40,1,00240,India
942432,2023-11-09,207,coca cola,75,100,25,1,00351,India
942432,2023-11-09,202,milk,12,27,15,1,00351,India
942432,2023-11-09,205,classic yogurt,45,60,15,1,00351,India
950185,2023-11-09,211,red bull,90,125,35,1,00128,India
950185,2023-11-09,201,paneer,210,340,130,1,00128,India
950185,2023-11-09,204,strawberry yogurt,50,60,10,1,00128,India
247407,2023-11-09,213,bisleri,6,15,9,1,00237,India
247407,2023-11-09,205,classic yogurt,45,60,15,1,00237,India
247407,2023-11-09,211,red bull,90,125,35,1,00237,India
247407,2023-11-09,204,strawberry yogurt,50,60,10,1,00237,India
501740,2023-11-09,210,mountain dew,75,100,25,1,00220,India
501740,2023-11-09,203,mango yogurt,50,60,10,1,00220,India
680416,2023-11-09,209,pepsi,75,100,25,1,00373,India
680416,2023-11-09,211,red bull,90,125,35,1,00373,India
680416,2023-11-09,201,paneer,210,340,130,1,00373,India
440592,2023-11-09,210,mountain dew,75,100,25,1,00477,India
440592,2023-11-09,206,yakult,360,400,40,1,00477,India
440592,2023-11-09,213,bisleri,6,15,9,1,00477,India
428725,2023-11-09,207,coca cola,75,100,25,1,00382,India
428725,2023-11-09,210,mountain dew,75,100,25,1,00382,India
428725,2023-11-09,209,pepsi,75,100,25,1,00382,India
428725,2023-11-09,211,red bull,90,125,35,1,00382,India
428725,2023-11-09,213,bisleri,6,15,9,1,00382,India
861965,2023-11-09,205,classic yogurt,45,60,15,1,00411,India
861965,2023-11-09,213,bisleri,6,15,9,1,00411,India
813311,2023-11-09,201,paneer,210,340,130,1,00490,India
813311,2023-11-09,212,amul cheese,250,315,65,1,00490,India
813311,2023-11-09,202,milk,12,27,15,1,00490,India
813311,2023-11-09,205,classic yogurt,45,60,15,1,00490,India
813311,2023-11-09,211,red bull,90,125,35,1,00490,India
515717,2023-11-09,212,amul cheese,250,315,65,1,00455,India
515717,2023-11-09,207,coca cola,75,100,25,1,00455,India
515717,2023-11-09,213,bisleri,6,15,9,1,00455,India
515717,2023-11-09,206,yakult,360,400,40,1,00455,India
856705,2023-11-09,207,coca cola,75,100,25,1,00198,India
856705,2023-11-09,213,bisleri,6,15,9,1,00198,India
710756,2023-11-09,209,pepsi,75,100,25,1,00061,India
458954,2023-11-09,211,red bull,90,125,35,1,00268,India
662898,2023-11-09,211,red bull,90,125,35,1,00450,India
662898,2023-11-09,201,paneer,210,340,130,1,00450,India
185872,2023-11-09,204,strawberry yogurt,50,60,10,1,00354,India
185872,2023-11-09,211,red bull,90,125,35,1,00354,India
185872,2023-11-09,205,classic yogurt,45,60,15,1,00354,India
339938,2023-11-09,213,bisleri,6,15,9,1,00190,India
812892,2023-11-10,212,amul cheese,250,315,65,1,00184,India
812892,2023-11-10,210,mountain dew,75,100,25,1,00184,India
812892,2023-11-10,202,milk,12,27,15,1,00184,India
812892,2023-11-10,201,paneer,210,340,130,1,00184,India
202823,2023-11-10,204,strawberry yogurt,50,60,10,1,00334,India
202823,2023-11-10,206,yakult,360,400,40,1,00334,India
202823,2023-11-10,208,sprite,75,100,25,1,00334,India
319835,2023-11-10,203,mango yogurt,50,60,10,1,00475,India
319835,2023-11-10,213,bisleri,6,15,9,1,00475,India
319835,2023-11-10,212,amul cheese,250,315,65,1,00475,India
999738,2023-11-10,203,mango yogurt,50,60,10,1,00177,India
999738,2023-11-10,202,milk,12,27,15,1,00177,India
999738,2023-11-10,206,yakult,360,400,40,1,00177,India
999738,2023-11-10,211,red bull,90,125,35,1,00177,India
711661,2023-11-10,209,pepsi,75,100,25,1,00016,India
282422,2023-11-10,207,coca cola,75,100,25,1,00371,India
282422,2023-11-10,213,bisleri,6,15,9,1,00371,India
904025,2023-11-10,202,milk,12,27,15,1,00381,India
425012,2023-11-10,205,classic yogurt,45,60,15,1,00019,India
425012,2023-11-10,206,yakult,360,400,40,1,00019,India
425012,2023-11-10,213,bisleri,6,15,9,1,00019,India
425012,2023-11-10,203,mango yogurt,50,60,10,1,00019,India
425012,2023-11-10,210,mountain dew,75,100,25,1,00019,India
751000,2023-11-10,206,yakult,360,400,40,1,00001,India
751000,2023-11-10,209,pepsi,75,100,25,1,00001,India
404399,2023-11-10,207,coca cola,75,100,25,1,00192,India
404399,2023-11-10,213,bisleri,6,15,9,1,00192,India
404399,2023-11-10,211,red bull,90,125,35,1,00192,India
404399,2023-11-10,202,milk,12,27,15,1,00192,India
404399,2023-11-10,204,strawberry yogurt,50,60,10,1,00192,India
612607,2023-11-10,207,coca cola,75,100,25,1,00356,India
612607,2023-11-10,206,yakult,360,400,40,1,00356,India
677626,2023-11-10,211,red bull,90,125,35,1,00341,India
677626,2023-11-10,205,classic yogurt,45,60,15,1,00341,India
677626,2023-11-10,201,paneer,210,340,130,1,00341,India
677626,2023-11-10,206,yakult,360,400,40,1,00341,India
902883,2023-11-10,212,amul cheese,250,315,65,1,00318,India
902883,2023-11-10,204,strawberry yogurt,50,60,10,1,00318,India
902883,2023-11-10,206,yakult,360,400,40,1,00318,India
199279,2023-11-10,213,bisleri,6,15,9,1,00469,India
199279,2023-11-10,211,red bull,90,125,35,1,00469,India
287582,2023-11-10,207,coca cola,75,100,25,1,00386,India
462148,2023-11-10,206,yakult,360,400,40,1,00390,India
462148,2023-11-10,208,sprite,75,100,25,1,00390,India
462148,2023-11-10,211,red bull,90,125,35,1,00390,India
701621,2023-11-10,212,amul cheese,250,315,65,1,00128,India
701621,2023-11-10,204,strawberry yogurt,50,60,10,1,00128,India
701621,2023-11-10,203,mango yogurt,50,60,10,1,00128,India
604184,2023-11-10,213,bisleri,6,15,9,1,00401,India
604184,2023-11-10,207,coca cola,75,100,25,1,00401,India
604184,2023-11-10,205,classic yogurt,45,60,15,1,00401,India
604184,2023-11-10,202,milk,12,27,15,1,00401,India
712704,2023-11-10,202,milk,12,27,15,1,00046,India
712704,2023-11-10,208,sprite,75,100,25,1,00046,India
712704,2023-11-10,201,paneer,210,340,130,1,00046,India
675775,2023-11-10,207,coca cola,75,100,25,1,00050,India
675775,2023-11-10,205,classic yogurt,45,60,15,1,00050,India
675775,2023-11-10,208,sprite,75,100,25,1,00050,India
573356,2023-11-10,207,coca cola,75,100,25,1,00099,India
573356,2023-11-10,206,yakult,360,400,40,1,00099,India
444659,2023-11-10,211,red bull,90,125,35,1,00204,India
444659,2023-11-10,208,sprite,75,100,25,1,00204,India
444659,2023-11-10,209,pepsi,75,100,25,1,00204,India
470406,2023-11-10,212,amul cheese,250,315,65,1,00249,India
470406,2023-11-10,205,classic yogurt,45,60,15,1,00249,India
763134,2023-11-10,212,amul cheese,250,315,65,1,00470,India
318093,2023-11-10,201,paneer,210,340,130,1,00359,India
318093,2023-11-10,212,amul cheese,250,315,65,1,00359,India
318093,2023-11-10,206,yakult,360,400,40,1,00359,India
318093,2023-11-10,207,coca cola,75,100,25,1,00359,India
941271,2023-11-10,209,pepsi,75,100,25,1,00016,India
941271,2023-11-10,204,strawberry yogurt,50,60,10,1,00016,India
941271,2023-11-10,207,coca cola,75,100,25,1,00016,India
554147,2023-11-10,213,bisleri,6,15,9,1,00095,India
554147,2023-11-10,209,pepsi,75,100,25,1,00095,India
554147,2023-11-10,210,mountain dew,75,100,25,1,00095,India
132635,2023-11-10,205,classic yogurt,45,60,15,1,00454,India
762938,2023-11-10,212,amul cheese,250,315,65,1,00414,India
762938,2023-11-10,205,classic yogurt,45,60,15,1,00414,India
991813,2023-11-10,201,paneer,210,340,130,1,00447,India
991813,2023-11-10,210,mountain dew,75,100,25,1,00447,India
991813,2023-11-10,204,strawberry yogurt,50,60,10,1,00447,India
991813,2023-11-10,208,sprite,75,100,25,1,00447,India
991813,2023-11-10,213,bisleri,6,15,9,1,00447,India
232061,2023-11-10,205,classic yogurt,45,60,15,1,00159,India
232061,2023-11-10,212,amul cheese,250,315,65,1,00159,India
845540,2023-11-10,209,pepsi,75,100,25,1,00275,India
845540,2023-11-10,206,yakult,360,400,40,1,00275,India
523068,2023-11-10,212,amul cheese,250,315,65,1,00338,India
523068,2023-11-10,211,red bull,90,125,35,1,00338,India
523068,2023-11-10,213,bisleri,6,15,9,1,00338,India
523068,2023-11-10,202,milk,12,27,15,1,00338,India
889586,2023-11-10,209,pepsi,75,100,25,1,00444,India
889586,2023-11-10,207,coca cola,75,100,25,1,00444,India
589703,2023-11-10,202,milk,12,27,15,1,00340,India
820225,2023-11-10,206,yakult,360,400,40,1,00416,India
820225,2023-11-10,205,classic yogurt,45,60,15,1,00416,India
820225,2023-11-10,210,mountain dew,75,100,25,1,00416,India
820225,2023-11-10,203,mango yogurt,50,60,10,1,00416,India
875826,2023-11-10,203,mango yogurt,50,60,10,1,00499,India
875826,2023-11-10,210,mountain dew,75,100,25,1,00499,India
875826,2023-11-10,212,amul cheese,250,315,65,1,00499,India
875826,2023-11-10,204,strawberry yogurt,50,60,10,1,00499,India
875826,2023-11-10,205,classic yogurt,45,60,15,1,00499,India
818955,2023-11-10,208,sprite,75,100,25,1,00292,India
818955,2023-11-10,213,bisleri,6,15,9,1,00292,India
818955,2023-11-10,209,pepsi,75,100,25,1,00292,India
818955,2023-11-10,211,red bull,90,125,35,1,00292,India
989756,2023-11-10,206,yakult,360,400,40,1,00376,India
989756,2023-11-10,205,classic yogurt,45,60,15,1,00376,India
124460,2023-11-10,203,mango yogurt,50,60,10,1,00474,India
124460,2023-11-10,204,strawberry yogurt,50,60,10,1,00474,India
124460,2023-11-10,201,paneer,210,340,130,1,00474,India
124460,2023-11-10,213,bisleri,6,15,9,1,00474,India
698035,2023-11-10,212,amul cheese,250,315,65,1,00322,India
698035,2023-11-10,210,mountain dew,75,100,25,1,00322,India
698035,2023-11-10,213,bisleri,6,15,9,1,00322,India
265226,2023-11-10,212,amul cheese,250,315,65,1,00083,India
242763,2023-11-10,211,red bull,90,125,35,1,00074,India
242763,2023-11-10,203,mango yogurt,50,60,10,1,00074,India
188850,2023-11-10,209,pepsi,75,100,25,1,00353,India
188850,2023-11-10,201,paneer,210,340,130,1,00353,India
188850,2023-11-10,204,strawberry yogurt,50,60,10,1,00353,India
188850,2023-11-10,211,red bull,90,125,35,1,00353,India
188850,2023-11-10,202,milk,12,27,15,1,00353,India
779956,2023-11-10,210,mountain dew,75,100,25,1,00101,India
906141,2023-11-10,201,paneer,210,340,130,1,00331,India
906141,2023-11-10,212,amul cheese,250,315,65,1,00331,India
906141,2023-11-10,210,mountain dew,75,100,25,1,00331,India
551931,2023-11-10,213,bisleri,6,15,9,1,00363,India
551931,2023-11-10,201,paneer,210,340,130,1,00363,India
551931,2023-11-10,209,pepsi,75,100,25,1,00363,India
929672,2023-11-10,204,strawberry yogurt,50,60,10,1,00414,India
929672,2023-11-10,213,bisleri,6,15,9,1,00414,India
189343,2023-11-10,212,amul cheese,250,315,65,1,00401,India
189343,2023-11-10,202,milk,12,27,15,1,00401,India
189343,2023-11-10,210,mountain dew,75,100,25,1,00401,India
189343,2023-11-10,205,classic yogurt,45,60,15,1,00401,India
835953,2023-11-10,209,pepsi,75,100,25,1,00240,India
835953,2023-11-10,205,classic yogurt,45,60,15,1,00240,India
835953,2023-11-10,202,milk,12,27,15,1,00240,India
835953,2023-11-10,211,red bull,90,125,35,1,00240,India
835953,2023-11-10,210,mountain dew,75,100,25,1,00240,India
732052,2023-11-10,208,sprite,75,100,25,1,00322,India
732052,2023-11-10,209,pepsi,75,100,25,1,00322,India
732052,2023-11-10,213,bisleri,6,15,9,1,00322,India
732052,2023-11-10,204,strawberry yogurt,50,60,10,1,00322,India
105007,2023-11-10,212,amul cheese,250,315,65,1,00485,India
105007,2023-11-10,213,bisleri,6,15,9,1,00485,India
105007,2023-11-10,204,strawberry yogurt,50,60,10,1,00485,India
105825,2023-11-10,207,coca cola,75,100,25,1,00135,India
105825,2023-11-10,210,mountain dew,75,100,25,1,00135,India
105825,2023-11-10,213,bisleri,6,15,9,1,00135,India
105825,2023-11-10,209,pepsi,75,100,25,1,00135,India
498112,2023-11-11,210,mountain dew,75,100,25,1,00339,India
498112,2023-11-11,212,amul cheese,250,315,65,1,00339,India
307331,2023-11-11,204,strawberry yogurt,50,60,10,1,00260,India
307331,2023-11-11,208,sprite,75,100,25,1,00260,India
307331,2023-11-11,213,bisleri,6,15,9,1,00260,India
307331,2023-11-11,206,yakult,360,400,40,1,00260,India
466381,2023-11-11,210,mountain dew,75,100,25,1,00004,India
418019,2023-11-11,208,sprite,75,100,25,1,00424,India
418019,2023-11-11,202,milk,12,27,15,1,00424,India
418019,2023-11-11,207,coca cola,75,100,25,1,00424,India
602959,2023-11-11,212,amul cheese,250,315,65,1,00048,India
920511,2023-11-11,201,paneer,210,340,130,1,00343,India
920511,2023-11-11,210,mountain dew,75,100,25,1,00343,India
920511,2023-11-11,209,pepsi,75,100,25,1,00343,India
920511,2023-11-11,208,sprite,75,100,25,1,00343,India
142938,2023-11-11,205,classic yogurt,45,60,15,1,00491,India
829204,2023-11-11,213,bisleri,6,15,9,1,00066,India
829204,2023-11-11,204,strawberry yogurt,50,60,10,1,00066,India
724303,2023-11-11,206,yakult,360,400,40,1,00205,India
724303,2023-11-11,202,milk,12,27,15,1,00205,India
724303,2023-11-11,211,red bull,90,125,35,1,00205,India
492821,2023-11-11,211,red bull,90,125,35,1,00166,India
492821,2023-11-11,206,yakult,360,400,40,1,00166,India
624065,2023-11-11,207,coca cola,75,100,25,1,00240,India
624065,2023-11-11,208,sprite,75,100,25,1,00240,India
624065,2023-11-11,201,paneer,210,340,130,1,00240,India
624065,2023-11-11,206,yakult,360,400,40,1,00240,India
977819,2023-11-11,205,classic yogurt,45,60,15,1,00209,India
977819,2023-11-11,204,strawberry yogurt,50,60,10,1,00209,India
977819,2023-11-11,213,bisleri,6,15,9,1,00209,India
977819,2023-11-11,209,pepsi,75,100,25,1,00209,India
977819,2023-11-11,210,mountain dew,75,100,25,1,00209,India
306969,2023-11-11,204,strawberry yogurt,50,60,10,1,00064,India
306969,2023-11-11,210,mountain dew,75,100,25,1,00064,India
306969,2023-11-11,201,paneer,210,340,130,1,00064,India
782403,2023-11-11,212,amul cheese,250,315,65,1,00462,India
782403,2023-11-11,208,sprite,75,100,25,1,00462,India
782403,2023-11-11,209,pepsi,75,100,25,1,00462,India
677499,2023-11-11,202,milk,12,27,15,1,00212,India
677499,2023-11-11,205,classic yogurt,45,60,15,1,00212,India
668601,2023-11-11,210,mountain dew,75,100,25,1,00195,India
683652,2023-11-11,210,mountain dew,75,100,25,1,00424,India
683652,2023-11-11,205,classic yogurt,45,60,15,1,00424,India
683652,2023-11-11,212,amul cheese,250,315,65,1,00424,India
683652,2023-11-11,208,sprite,75,100,25,1,00424,India
311139,2023-11-11,208,sprite,75,100,25,1,00201,India
311139,2023-11-11,209,pepsi,75,100,25,1,00201,India
311139,2023-11-11,206,yakult,360,400,40,1,00201,India
430602,2023-11-11,210,mountain dew,75,100,25,1,00181,India
430602,2023-11-11,202,milk,12,27,15,1,00181,India
430602,2023-11-11,207,coca cola,75,100,25,1,00181,India
430602,2023-11-11,201,paneer,210,340,130,1,00181,India
411495,2023-11-11,203,mango yogurt,50,60,10,1,00210,India
411495,2023-11-11,202,milk,12,27,15,1,00210,India
411495,2023-11-11,204,strawberry yogurt,50,60,10,1,00210,India
411495,2023-11-11,208,sprite,75,100,25,1,00210,India
411495,2023-11-11,210,mountain dew,75,100,25,1,00210,India
853383,2023-11-11,205,classic yogurt,45,60,15,1,00318,India
853383,2023-11-11,208,sprite,75,100,25,1,00318,India
853383,2023-11-11,201,paneer,210,340,130,1,00318,India
853383,2023-11-11,204,strawberry yogurt,50,60,10,1,00318,India
702880,2023-11-11,209,pepsi,75,100,25,1,00456,India
702880,2023-11-11,211,red bull,90,125,35,1,00456,India
567639,2023-11-11,210,mountain dew,75,100,25,1,00016,India
567639,2023-11-11,207,coca cola,75,100,25,1,00016,India
802524,2023-11-11,204,strawberry yogurt,50,60,10,1,00283,India
802524,2023-11-11,210,mountain dew,75,100,25,1,00283,India
802524,2023-11-11,203,mango yogurt,50,60,10,1,00283,India
787799,2023-11-11,203,mango yogurt,50,60,10,1,00487,India
787799,2023-11-11,209,pepsi,75,100,25,1,00487,India
787799,2023-11-11,205,classic yogurt,45,60,15,1,00487,India
787799,2023-11-11,206,yakult,360,400,40,1,00487,India
787799,2023-11-11,204,strawberry yogurt,50,60,10,1,00487,India
860817,2023-11-11,202,milk,12,27,15,1,00037,India
180935,2023-11-11,202,milk,12,27,15,1,00246,India
180935,2023-11-11,213,bisleri,6,15,9,1,00246,India
180935,2023-11-11,205,classic yogurt,45,60,15,1,00246,India
180935,2023-11-11,207,coca cola,75,100,25,1,00246,India
180935,2023-11-11,212,amul cheese,250,315,65,1,00246,India
509981,2023-11-11,206,yakult,360,400,40,1,00326,India
147681,2023-11-11,210,mountain dew,75,100,25,1,00438,India
394202,2023-11-11,211,red bull,90,125,35,1,00135,India
218797,2023-11-11,207,coca cola,75,100,25,1,00402,India
218797,2023-11-11,201,paneer,210,340,130,1,00402,India
218797,2023-11-11,208,sprite,75,100,25,1,00402,India
580200,2023-11-11,211,red bull,90,125,35,1,00322,India
580200,2023-11-11,208,sprite,75,100,25,1,00322,India
580200,2023-11-11,202,milk,12,27,15,1,00322,India
580200,2023-11-11,205,classic yogurt,45,60,15,1,00322,India
929445,2023-11-11,206,yakult,360,400,40,1,00388,India
929445,2023-11-11,208,sprite,75,100,25,1,00388,India
929445,2023-11-11,210,mountain dew,75,100,25,1,00388,India
929445,2023-11-11,201,paneer,210,340,130,1,00388,India
847032,2023-11-11,202,milk,12,27,15,1,00473,India
847032,2023-11-11,212,amul cheese,250,315,65,1,00473,India
847032,2023-11-11,207,coca cola,75,100,25,1,00473,India
847032,2023-11-11,205,classic yogurt,45,60,15,1,00473,India
575733,2023-11-11,207,coca cola,75,100,25,1,00344,India
575733,2023-11-11,202,milk,12,27,15,1,00344,India
575733,2023-11-11,206,yakult,360,400,40,1,00344,India
701077,2023-11-11,202,milk,12,27,15,1,00176,India
701077,2023-11-11,212,amul cheese,250,315,65,1,00176,India
701077,2023-11-11,211,red bull,90,125,35,1,00176,India
701077,2023-11-11,207,coca cola,75,100,25,1,00176,India
701077,2023-11-11,206,yakult,360,400,40,1,00176,India
876671,2023-11-11,209,pepsi,75,100,25,1,00414,India
348584,2023-11-11,205,classic yogurt,45,60,15,1,00366,India
348584,2023-11-11,203,mango yogurt,50,60,10,1,00366,India
666631,2023-11-11,202,milk,12,27,15,1,00362,India
199254,2023-11-11,212,amul cheese,250,315,65,1,00147,India
943039,2023-11-11,201,paneer,210,340,130,1,00458,India
943039,2023-11-11,205,classic yogurt,45,60,15,1,00458,India
335104,2023-11-11,213,bisleri,6,15,9,1,00123,India
335104,2023-11-11,203,mango yogurt,50,60,10,1,00123,India
449651,2023-11-11,207,coca cola,75,100,25,1,00368,India
449651,2023-11-11,208,sprite,75,100,25,1,00368,India
449651,2023-11-11,201,paneer,210,340,130,1,00368,India
449651,2023-11-11,211,red bull,90,125,35,1,00368,India
323970,2023-11-11,207,coca cola,75,100,25,1,00421,India
323970,2023-11-11,212,amul cheese,250,315,65,1,00421,India
323970,2023-11-11,213,bisleri,6,15,9,1,00421,India
140301,2023-11-11,207,coca cola,75,100,25,1,00136,India
140301,2023-11-11,206,yakult,360,400,40,1,00136,India
399261,2023-11-11,202,milk,12,27,15,1,00060,India
399261,2023-11-11,208,sprite,75,100,25,1,00060,India
399261,2023-11-11,210,mountain dew,75,100,25,1,00060,India
399261,2023-11-11,205,classic yogurt,45,60,15,1,00060,India
990164,2023-11-11,208,sprite,75,100,25,1,00442,India
712255,2023-11-11,203,mango yogurt,50,60,10,1,00164,India
712255,2023-11-11,213,bisleri,6,15,9,1,00164,India
712255,2023-11-11,209,pepsi,75,100,25,1,00164,India
712255,2023-11-11,205,classic yogurt,45,60,15,1,00164,India
130228,2023-11-11,201,paneer,210,340,130,1,00179,India
130228,2023-11-11,202,milk,12,27,15,1,00179,India
130228,2023-11-11,207,coca cola,75,100,25,1,00179,India
130228,2023-11-11,203,mango yogurt,50,60,10,1,00179,India
130228,2023-11-11,212,amul cheese,250,315,65,1,00179,India
845413,2023-11-11,206,yakult,360,400,40,1,00228,India
845413,2023-11-11,201,paneer,210,340,130,1,00228,India
845413,2023-11-11,208,sprite,75,100,25,1,00228,India
424941,2023-11-11,205,classic yogurt,45,60,15,1,00008,India
424941,2023-11-11,207,coca cola,75,100,25,1,00008,India
424941,2023-11-11,201,paneer,210,340,130,1,00008,India
424941,2023-11-11,206,yakult,360,400,40,1,00008,India
424941,2023-11-11,210,mountain dew,75,100,25,1,00008,India
456814,2023-11-11,205,classic yogurt,45,60,15,1,00213,India
405195,2023-11-11,201,paneer,210,340,130,1,00494,India
405195,2023-11-11,207,coca cola,75,100,25,1,00494,India
405195,2023-11-11,208,sprite,75,100,25,1,00494,India
405195,2023-11-11,204,strawberry yogurt,50,60,10,1,00494,India
843144,2023-11-11,202,milk,12,27,15,1,00420,India
843144,2023-11-11,212,amul cheese,250,315,65,1,00420,India
843144,2023-11-11,208,sprite,75,100,25,1,00420,India
843144,2023-11-11,210,mountain dew,75,100,25,1,00420,India
843144,2023-11-11,204,strawberry yogurt,50,60,10,1,00420,India
284712,2023-11-11,212,amul cheese,250,315,65,1,00452,India
284712,2023-11-11,210,mountain dew,75,100,25,1,00452,India
284712,2023-11-11,211,red bull,90,125,35,1,00452,India
430272,2023-11-11,203,mango yogurt,50,60,10,1,00438,India
221067,2023-11-11,204,strawberry yogurt,50,60,10,1,00001,India
221067,2023-11-11,210,mountain dew,75,100,25,1,00001,India
221067,2023-11-11,213,bisleri,6,15,9,1,00001,India
769393,2023-11-11,213,bisleri,6,15,9,1,00401,India
769393,2023-11-11,204,strawberry yogurt,50,60,10,1,00401,India
769393,2023-11-11,203,mango yogurt,50,60,10,1,00401,India
511367,2023-11-11,213,bisleri,6,15,9,1,00025,India
511367,2023-11-11,202,milk,12,27,15,1,00025,India
511367,2023-11-11,203,mango yogurt,50,60,10,1,00025,India
511367,2023-11-11,211,red bull,90,125,35,1,00025,India
978704,2023-11-11,210,mountain dew,75,100,25,1,00305,India
978704,2023-11-11,207,coca cola,75,100,25,1,00305,India
978704,2023-11-11,205,classic yogurt,45,60,15,1,00305,India
439959,2023-11-11,202,milk,12,27,15,1,00089,India
439959,2023-11-11,208,sprite,75,100,25,1,00089,India
315957,2023-11-11,201,paneer,210,340,130,1,00436,India
315957,2023-11-11,203,mango yogurt,50,60,10,1,00436,India
315957,2023-11-11,208,sprite,75,100,25,1,00436,India
315957,2023-11-11,211,red bull,90,125,35,1,00436,India
315957,2023-11-11,213,bisleri,6,15,9,1,00436,India
908994,2023-11-11,209,pepsi,75,100,25,1,00115,India
908994,2023-11-11,203,mango yogurt,50,60,10,1,00115,India
908994,2023-11-11,207,coca cola,75,100,25,1,00115,India
908994,2023-11-11,204,strawberry yogurt,50,60,10,1,00115,India
152089,2023-11-11,207,coca cola,75,100,25,1,00429,India
382049,2023-11-11,207,coca cola,75,100,25,1,00416,India
382049,2023-11-11,209,pepsi,75,100,25,1,00416,India
382049,2023-11-11,202,milk,12,27,15,1,00416,India
382049,2023-11-11,205,classic yogurt,45,60,15,1,00416,India
842276,2023-11-11,204,strawberry yogurt,50,60,10,1,00227,India
842276,2023-11-11,213,bisleri,6,15,9,1,00227,India
842276,2023-11-11,208,sprite,75,100,25,1,00227,India
842276,2023-11-11,201,paneer,210,340,130,1,00227,India
685958,2023-11-11,213,bisleri,6,15,9,1,00239,India
415675,2023-11-11,202,milk,12,27,15,1,00163,India
415675,2023-11-11,206,yakult,360,400,40,1,00163,India
415675,2023-11-11,208,sprite,75,100,25,1,00163,India
327973,2023-11-11,212,amul cheese,250,315,65,1,00397,India
327973,2023-11-11,203,mango yogurt,50,60,10,1,00397,India
327973,2023-11-11,202,milk,12,27,15,1,00397,India
728991,2023-11-11,201,paneer,210,340,130,1,00057,India
728991,2023-11-11,210,mountain dew,75,100,25,1,00057,India
728991,2023-11-11,206,yakult,360,400,40,1,00057,India
728991,2023-11-11,212,amul cheese,250,315,65,1,00057,India
475078,2023-11-11,204,strawberry yogurt,50,60,10,1,00045,India
475078,2023-11-11,201,paneer,210,340,130,1,00045,India
475078,2023-11-11,202,milk,12,27,15,1,00045,India
439244,2023-11-11,202,milk,12,27,15,1,00195,India
439244,2023-11-11,212,amul cheese,250,315,65,1,00195,India
439244,2023-11-11,209,pepsi,75,100,25,1,00195,India
322287,2023-11-11,205,classic yogurt,45,60,15,1,00020,India
322287,2023-11-11,208,sprite,75,100,25,1,00020,India
155120,2023-11-11,202,milk,12,27,15,1,00184,India
990177,2023-11-11,206,yakult,360,400,40,1,00471,India
990177,2023-11-11,213,bisleri,6,15,9,1,00471,India
983910,2023-11-11,211,red bull,90,125,35,1,00328,India
983910,2023-11-11,213,bisleri,6,15,9,1,00328,India
983910,2023-11-11,202,milk,12,27,15,1,00328,India
669480,2023-11-11,206,yakult,360,400,40,1,00400,India
669480,2023-11-11,202,milk,12,27,15,1,00400,India
669480,2023-11-11,209,pepsi,75,100,25,1,00400,India
669480,2023-11-11,203,mango yogurt,50,60,10,1,00400,India
457966,2023-11-11,201,paneer,210,340,130,1,00221,India
457966,2023-11-11,210,mountain dew,75,100,25,1,00221,India
457966,2023-11-11,204,strawberry yogurt,50,60,10,1,00221,India
457966,2023-11-11,205,classic yogurt,45,60,15,1,00221,India
124695,2023-11-11,213,bisleri,6,15,9,1,00434,India
124695,2023-11-11,209,pepsi,75,100,25,1,00434,India
124695,2023-11-11,211,red bull,90,125,35,1,00434,India
124695,2023-11-11,210,mountain dew,75,100,25,1,00434,India
922627,2023-11-11,212,amul cheese,250,315,65,1,00087,India
549492,2023-11-11,210,mountain dew,75,100,25,1,00311,India
549492,2023-11-11,205,classic yogurt,45,60,15,1,00311,India
265158,2023-11-11,207,coca cola,75,100,25,1,00439,India
253260,2023-11-11,209,pepsi,75,100,25,1,00270,India
253260,2023-11-11,211,red bull,90,125,35,1,00270,India
253260,2023-11-11,203,mango yogurt,50,60,10,1,00270,India
253260,2023-11-11,206,yakult,360,400,40,1,00270,India
322745,2023-11-11,209,pepsi,75,100,25,1,00473,India
131945,2023-11-12,211,red bull,90,125,35,1,00401,India
565088,2023-11-12,211,red bull,90,125,35,1,00362,India
846616,2023-11-12,212,amul cheese,250,315,65,1,00151,India
846616,2023-11-12,207,coca cola,75,100,25,1,00151,India
846616,2023-11-12,201,paneer,210,340,130,1,00151,India
524235,2023-11-12,205,classic yogurt,45,60,15,1,00362,India
524235,2023-11-12,202,milk,12,27,15,1,00362,India
297324,2023-11-12,206,yakult,360,400,40,1,00411,India
297324,2023-11-12,207,coca cola,75,100,25,1,00411,India
297324,2023-11-12,202,milk,12,27,15,1,00411,India
297324,2023-11-12,208,sprite,75,100,25,1,00411,India
971939,2023-11-12,212,amul cheese,250,315,65,1,00133,India
971939,2023-11-12,207,coca cola,75,100,25,1,00133,India
971939,2023-11-12,205,classic yogurt,45,60,15,1,00133,India
971939,2023-11-12,203,mango yogurt,50,60,10,1,00133,India
226921,2023-11-12,208,sprite,75,100,25,1,00209,India
226921,2023-11-12,211,red bull,90,125,35,1,00209,India
226921,2023-11-12,204,strawberry yogurt,50,60,10,1,00209,India
689811,2023-11-12,210,mountain dew,75,100,25,1,00456,India
689811,2023-11-12,201,paneer,210,340,130,1,00456,India
689811,2023-11-12,206,yakult,360,400,40,1,00456,India
153030,2023-11-12,211,red bull,90,125,35,1,00064,India
511714,2023-11-12,202,milk,12,27,15,1,00216,India
511714,2023-11-12,201,paneer,210,340,130,1,00216,India
827990,2023-11-12,207,coca cola,75,100,25,1,00014,India
827990,2023-11-12,208,sprite,75,100,25,1,00014,India
827990,2023-11-12,210,mountain dew,75,100,25,1,00014,India
585938,2023-11-12,213,bisleri,6,15,9,1,00075,India
585938,2023-11-12,209,pepsi,75,100,25,1,00075,India
585938,2023-11-12,201,paneer,210,340,130,1,00075,India
585938,2023-11-12,212,amul cheese,250,315,65,1,00075,India
661602,2023-11-12,210,mountain dew,75,100,25,1,00480,India
661602,2023-11-12,209,pepsi,75,100,25,1,00480,India
989186,2023-11-12,201,paneer,210,340,130,1,00422,India
989186,2023-11-12,204,strawberry yogurt,50,60,10,1,00422,India
989186,2023-11-12,206,yakult,360,400,40,1,00422,India
989186,2023-11-12,211,red bull,90,125,35,1,00422,India
850601,2023-11-12,211,red bull,90,125,35,1,00321,India
850601,2023-11-12,210,mountain dew,75,100,25,1,00321,India
850601,2023-11-12,209,pepsi,75,100,25,1,00321,India
850601,2023-11-12,207,coca cola,75,100,25,1,00321,India
246482,2023-11-12,204,strawberry yogurt,50,60,10,1,00414,India
246482,2023-11-12,210,mountain dew,75,100,25,1,00414,India
246482,2023-11-12,202,milk,12,27,15,1,00414,India
246482,2023-11-12,201,paneer,210,340,130,1,00414,India
773869,2023-11-12,209,pepsi,75,100,25,1,00346,India
977908,2023-11-12,208,sprite,75,100,25,1,00224,India
631332,2023-11-12,212,amul cheese,250,315,65,1,00061,India
631332,2023-11-12,209,pepsi,75,100,25,1,00061,India
631332,2023-11-12,201,paneer,210,340,130,1,00061,India
525290,2023-11-12,211,red bull,90,125,35,1,00159,India
525290,2023-11-12,208,sprite,75,100,25,1,00159,India
477533,2023-11-12,207,coca cola,75,100,25,1,00302,India
477533,2023-11-12,205,classic yogurt,45,60,15,1,00302,India
477533,2023-11-12,211,red bull,90,125,35,1,00302,India
471974,2023-11-12,209,pepsi,75,100,25,1,00477,India
471974,2023-11-12,212,amul cheese,250,315,65,1,00477,India
471974,2023-11-12,211,red bull,90,125,35,1,00477,India
802421,2023-11-12,206,yakult,360,400,40,1,00097,India
802421,2023-11-12,210,mountain dew,75,100,25,1,00097,India
560509,2023-11-12,211,red bull,90,125,35,1,00130,India
963493,2023-11-12,208,sprite,75,100,25,1,00096,India
963493,2023-11-12,207,coca cola,75,100,25,1,00096,India
963493,2023-11-12,206,yakult,360,400,40,1,00096,India
963493,2023-11-12,213,bisleri,6,15,9,1,00096,India
468882,2023-11-12,208,sprite,75,100,25,1,00475,India
468882,2023-11-12,213,bisleri,6,15,9,1,00475,India
600539,2023-11-12,206,yakult,360,400,40,1,00225,India
600539,2023-11-12,202,milk,12,27,15,1,00225,India
600539,2023-11-12,204,strawberry yogurt,50,60,10,1,00225,India
581924,2023-11-12,208,sprite,75,100,25,1,00211,India
437198,2023-11-12,208,sprite,75,100,25,1,00097,India
437198,2023-11-12,212,amul cheese,250,315,65,1,00097,India
296116,2023-11-12,209,pepsi,75,100,25,1,00038,India
296116,2023-11-12,208,sprite,75,100,25,1,00038,India
296116,2023-11-12,201,paneer,210,340,130,1,00038,India
195693,2023-11-12,212,amul cheese,250,315,65,1,00147,India
195693,2023-11-12,213,bisleri,6,15,9,1,00147,India
195693,2023-11-12,206,yakult,360,400,40,1,00147,India
195693,2023-11-12,204,strawberry yogurt,50,60,10,1,00147,India
538825,2023-11-12,211,red bull,90,125,35,1,00012,India
195327,2023-11-12,208,sprite,75,100,25,1,00065,India
195327,2023-11-12,207,coca cola,75,100,25,1,00065,India
195327,2023-11-12,202,milk,12,27,15,1,00065,India
195327,2023-11-12,209,pepsi,75,100,25,1,00065,India
443685,2023-11-12,204,strawberry yogurt,50,60,10,1,00089,India
906158,2023-11-12,203,mango yogurt,50,60,10,1,00324,India
790360,2023-11-12,210,mountain dew,75,100,25,1,00276,India
790360,2023-11-12,202,milk,12,27,15,1,00276,India
790360,2023-11-12,204,strawberry yogurt,50,60,10,1,00276,India
790360,2023-11-12,211,red bull,90,125,35,1,00276,India
790360,2023-11-12,201,paneer,210,340,130,1,00276,India
322593,2023-11-12,201,paneer,210,340,130,1,00344,India
322593,2023-11-12,211,red bull,90,125,35,1,00344,India
322593,2023-11-12,205,classic yogurt,45,60,15,1,00344,India
322593,2023-11-12,208,sprite,75,100,25,1,00344,India
708234,2023-11-12,205,classic yogurt,45,60,15,1,00304,India
708234,2023-11-12,213,bisleri,6,15,9,1,00304,India
473846,2023-11-12,212,amul cheese,250,315,65,1,00365,India
772981,2023-11-12,204,strawberry yogurt,50,60,10,1,00381,India
772981,2023-11-12,212,amul cheese,250,315,65,1,00381,India
772981,2023-11-12,205,classic yogurt,45,60,15,1,00381,India
772981,2023-11-12,209,pepsi,75,100,25,1,00381,India
772981,2023-11-12,213,bisleri,6,15,9,1,00381,India
572059,2023-11-12,204,strawberry yogurt,50,60,10,1,00483,India
784853,2023-11-12,208,sprite,75,100,25,1,00474,India
784853,2023-11-12,205,classic yogurt,45,60,15,1,00474,India
784853,2023-11-12,209,pepsi,75,100,25,1,00474,India
525877,2023-11-12,207,coca cola,75,100,25,1,00260,India
323882,2023-11-12,206,yakult,360,400,40,1,00016,India
323882,2023-11-12,203,mango yogurt,50,60,10,1,00016,India
323882,2023-11-12,211,red bull,90,125,35,1,00016,India
323882,2023-11-12,208,sprite,75,100,25,1,00016,India
120874,2023-11-12,207,coca cola,75,100,25,1,00426,India
120874,2023-11-12,202,milk,12,27,15,1,00426,India
120874,2023-11-12,201,paneer,210,340,130,1,00426,India
120874,2023-11-12,204,strawberry yogurt,50,60,10,1,00426,India
882823,2023-11-12,210,mountain dew,75,100,25,1,00374,India
882823,2023-11-12,208,sprite,75,100,25,1,00374,India
145957,2023-11-12,201,paneer,210,340,130,1,00057,India
145957,2023-11-12,205,classic yogurt,45,60,15,1,00057,India
145957,2023-11-12,206,yakult,360,400,40,1,00057,India
188387,2023-11-12,207,coca cola,75,100,25,1,00238,India
188387,2023-11-12,211,red bull,90,125,35,1,00238,India
111894,2023-11-12,202,milk,12,27,15,1,00362,India
111894,2023-11-12,201,paneer,210,340,130,1,00362,India
111894,2023-11-12,205,classic yogurt,45,60,15,1,00362,India
434133,2023-11-12,204,strawberry yogurt,50,60,10,1,00099,India
434133,2023-11-12,207,coca cola,75,100,25,1,00099,India
434133,2023-11-12,202,milk,12,27,15,1,00099,India
434133,2023-11-12,212,amul cheese,250,315,65,1,00099,India
434133,2023-11-12,213,bisleri,6,15,9,1,00099,India
804991,2023-11-12,204,strawberry yogurt,50,60,10,1,00330,India
804991,2023-11-12,212,amul cheese,250,315,65,1,00330,India
339274,2023-11-12,206,yakult,360,400,40,1,00107,India
339274,2023-11-12,202,milk,12,27,15,1,00107,India
283306,2023-11-12,208,sprite,75,100,25,1,00226,India
283306,2023-11-12,205,classic yogurt,45,60,15,1,00226,India
283306,2023-11-12,201,paneer,210,340,130,1,00226,India
283306,2023-11-12,207,coca cola,75,100,25,1,00226,India
330827,2023-11-12,206,yakult,360,400,40,1,00389,India
330827,2023-11-12,211,red bull,90,125,35,1,00389,India
330827,2023-11-12,203,mango yogurt,50,60,10,1,00389,India
542831,2023-11-12,212,amul cheese,250,315,65,1,00041,India
542831,2023-11-12,202,milk,12,27,15,1,00041,India
303180,2023-11-12,205,classic yogurt,45,60,15,1,00498,India
303180,2023-11-12,213,bisleri,6,15,9,1,00498,India
793072,2023-11-12,205,classic yogurt,45,60,15,1,00468,India
793072,2023-11-12,211,red bull,90,125,35,1,00468,India
793072,2023-11-12,203,mango yogurt,50,60,10,1,00468,India
624093,2023-11-12,208,sprite,75,100,25,1,00160,India
837816,2023-11-12,210,mountain dew,75,100,25,1,00039,India
837816,2023-11-12,202,milk,12,27,15,1,00039,India
837816,2023-11-12,205,classic yogurt,45,60,15,1,00039,India
969253,2023-11-12,204,strawberry yogurt,50,60,10,1,00303,India
945022,2023-11-12,203,mango yogurt,50,60,10,1,00472,India
945022,2023-11-12,211,red bull,90,125,35,1,00472,India
945022,2023-11-12,205,classic yogurt,45,60,15,1,00472,India
945022,2023-11-12,208,sprite,75,100,25,1,00472,India
667267,2023-11-12,208,sprite,75,100,25,1,00461,India
667267,2023-11-12,207,coca cola,75,100,25,1,00461,India
770799,2023-11-12,207,coca cola,75,100,25,1,00357,India
770799,2023-11-12,206,yakult,360,400,40,1,00357,India
442945,2023-11-12,202,milk,12,27,15,1,00358,India
442945,2023-11-12,213,bisleri,6,15,9,1,00358,India
442945,2023-11-12,210,mountain dew,75,100,25,1,00358,India
901341,2023-11-12,203,mango yogurt,50,60,10,1,00437,India
901341,2023-11-12,201,paneer,210,340,130,1,00437,India
901341,2023-11-12,211,red bull,90,125,35,1,00437,India
692650,2023-11-12,209,pepsi,75,100,25,1,00495,India
692650,2023-11-12,213,bisleri,6,15,9,1,00495,India
692650,2023-11-12,208,sprite,75,100,25,1,00495,India
692650,2023-11-12,204,strawberry yogurt,50,60,10,1,00495,India
692650,2023-11-12,207,coca cola,75,100,25,1,00495,India
268671,2023-11-13,201,paneer,210,340,130,1,00134,India
268671,2023-11-13,202,milk,12,27,15,1,00134,India
222056,2023-11-13,204,strawberry yogurt,50,60,10,1,00430,India
222056,2023-11-13,212,amul cheese,250,315,65,1,00430,India
355974,2023-11-13,209,pepsi,75,100,25,1,00145,India
355974,2023-11-13,207,coca cola,75,100,25,1,00145,India
355974,2023-11-13,203,mango yogurt,50,60,10,1,00145,India
355974,2023-11-13,208,sprite,75,100,25,1,00145,India
749593,2023-11-13,201,paneer,210,340,130,1,00215,India
749593,2023-11-13,202,milk,12,27,15,1,00215,India
749593,2023-11-13,204,strawberry yogurt,50,60,10,1,00215,India
749593,2023-11-13,207,coca cola,75,100,25,1,00215,India
247911,2023-11-13,208,sprite,75,100,25,1,00078,India
355881,2023-11-13,212,amul cheese,250,315,65,1,00416,India
355881,2023-11-13,204,strawberry yogurt,50,60,10,1,00416,India
117909,2023-11-13,202,milk,12,27,15,1,00317,India
117909,2023-11-13,211,red bull,90,125,35,1,00317,India
117909,2023-11-13,206,yakult,360,400,40,1,00317,India
436089,2023-11-13,207,coca cola,75,100,25,1,00048,India
436089,2023-11-13,205,classic yogurt,45,60,15,1,00048,India
436089,2023-11-13,209,pepsi,75,100,25,1,00048,India
996237,2023-11-13,212,amul cheese,250,315,65,1,00255,India
996237,2023-11-13,208,sprite,75,100,25,1,00255,India
996237,2023-11-13,213,bisleri,6,15,9,1,00255,India
979896,2023-11-13,211,red bull,90,125,35,1,00203,India
979896,2023-11-13,206,yakult,360,400,40,1,00203,India
796820,2023-11-13,206,yakult,360,400,40,1,00373,India
796820,2023-11-13,204,strawberry yogurt,50,60,10,1,00373,India
796820,2023-11-13,205,classic yogurt,45,60,15,1,00373,India
796820,2023-11-13,203,mango yogurt,50,60,10,1,00373,India
421755,2023-11-13,213,bisleri,6,15,9,1,00124,India
421755,2023-11-13,201,paneer,210,340,130,1,00124,India
421755,2023-11-13,210,mountain dew,75,100,25,1,00124,India
984608,2023-11-13,206,yakult,360,400,40,1,00405,India
984608,2023-11-13,210,mountain dew,75,100,25,1,00405,India
984608,2023-11-13,207,coca cola,75,100,25,1,00405,India
473023,2023-11-13,210,mountain dew,75,100,25,1,00388,India
473023,2023-11-13,203,mango yogurt,50,60,10,1,00388,India
473023,2023-11-13,205,classic yogurt,45,60,15,1,00388,India
473023,2023-11-13,213,bisleri,6,15,9,1,00388,India
473023,2023-11-13,209,pepsi,75,100,25,1,00388,India
185077,2023-11-13,205,classic yogurt,45,60,15,1,00248,India
185077,2023-11-13,206,yakult,360,400,40,1,00248,India
185077,2023-11-13,210,mountain dew,75,100,25,1,00248,India
545842,2023-11-13,208,sprite,75,100,25,1,00146,India
545842,2023-11-13,206,yakult,360,400,40,1,00146,India
326327,2023-11-13,211,red bull,90,125,35,1,00115,India
326327,2023-11-13,202,milk,12,27,15,1,00115,India
326327,2023-11-13,206,yakult,360,400,40,1,00115,India
326327,2023-11-13,208,sprite,75,100,25,1,00115,India
326327,2023-11-13,205,classic yogurt,45,60,15,1,00115,India
318468,2023-11-13,209,pepsi,75,100,25,1,00303,India
318468,2023-11-13,211,red bull,90,125,35,1,00303,India
318468,2023-11-13,203,mango yogurt,50,60,10,1,00303,India
318468,2023-11-13,207,coca cola,75,100,25,1,00303,India
689097,2023-11-13,204,strawberry yogurt,50,60,10,1,00131,India
689097,2023-11-13,209,pepsi,75,100,25,1,00131,India
689097,2023-11-13,205,classic yogurt,45,60,15,1,00131,India
933581,2023-11-13,201,paneer,210,340,130,1,00321,India
933581,2023-11-13,204,strawberry yogurt,50,60,10,1,00321,India
933581,2023-11-13,207,coca cola,75,100,25,1,00321,India
933581,2023-11-13,212,amul cheese,250,315,65,1,00321,India
933581,2023-11-13,211,red bull,90,125,35,1,00321,India
363351,2023-11-13,202,milk,12,27,15,1,00016,India
363351,2023-11-13,213,bisleri,6,15,9,1,00016,India
363351,2023-11-13,203,mango yogurt,50,60,10,1,00016,India
406926,2023-11-13,201,paneer,210,340,130,1,00368,India
406926,2023-11-13,208,sprite,75,100,25,1,00368,India
406926,2023-11-13,205,classic yogurt,45,60,15,1,00368,India
406926,2023-11-13,213,bisleri,6,15,9,1,00368,India
645645,2023-11-13,209,pepsi,75,100,25,1,00382,India
645645,2023-11-13,211,red bull,90,125,35,1,00382,India
302810,2023-11-13,211,red bull,90,125,35,1,00491,India
226156,2023-11-13,207,coca cola,75,100,25,1,00141,India
226156,2023-11-13,208,sprite,75,100,25,1,00141,India
226156,2023-11-13,201,paneer,210,340,130,1,00141,India
434383,2023-11-13,204,strawberry yogurt,50,60,10,1,00350,India
434383,2023-11-13,212,amul cheese,250,315,65,1,00350,India
434383,2023-11-13,208,sprite,75,100,25,1,00350,India
434383,2023-11-13,203,mango yogurt,50,60,10,1,00350,India
297048,2023-11-13,211,red bull,90,125,35,1,00437,India
297048,2023-11-13,206,yakult,360,400,40,1,00437,India
297048,2023-11-13,207,coca cola,75,100,25,1,00437,India
442292,2023-11-13,201,paneer,210,340,130,1,00344,India
830139,2023-11-13,201,paneer,210,340,130,1,00003,India
830139,2023-11-13,207,coca cola,75,100,25,1,00003,India
830139,2023-11-13,209,pepsi,75,100,25,1,00003,India
830139,2023-11-13,204,strawberry yogurt,50,60,10,1,00003,India
430250,2023-11-13,209,pepsi,75,100,25,1,00003,India
430250,2023-11-13,204,strawberry yogurt,50,60,10,1,00003,India
430250,2023-11-13,211,red bull,90,125,35,1,00003,India
430250,2023-11-13,207,coca cola,75,100,25,1,00003,India
977675,2023-11-13,204,strawberry yogurt,50,60,10,1,00066,India
977675,2023-11-13,211,red bull,90,125,35,1,00066,India
201997,2023-11-13,211,red bull,90,125,35,1,00191,India
201997,2023-11-13,202,milk,12,27,15,1,00191,India
390352,2023-11-13,207,coca cola,75,100,25,1,00233,India
390352,2023-11-13,208,sprite,75,100,25,1,00233,India
785133,2023-11-13,213,bisleri,6,15,9,1,00259,India
561093,2023-11-13,204,strawberry yogurt,50,60,10,1,00353,India
561093,2023-11-13,203,mango yogurt,50,60,10,1,00353,India
561093,2023-11-13,209,pepsi,75,100,25,1,00353,India
561093,2023-11-13,212,amul cheese,250,315,65,1,00353,India
387716,2023-11-13,202,milk,12,27,15,1,00133,India
387716,2023-11-13,209,pepsi,75,100,25,1,00133,India
387716,2023-11-13,213,bisleri,6,15,9,1,00133,India
387716,2023-11-13,205,classic yogurt,45,60,15,1,00133,India
387716,2023-11-13,207,coca cola,75,100,25,1,00133,India
961128,2023-11-13,202,milk,12,27,15,1,00148,India
961128,2023-11-13,204,strawberry yogurt,50,60,10,1,00148,India
961128,2023-11-13,203,mango yogurt,50,60,10,1,00148,India
845724,2023-11-13,205,classic yogurt,45,60,15,1,00274,India
845724,2023-11-13,206,yakult,360,400,40,1,00274,India
845724,2023-11-13,210,mountain dew,75,100,25,1,00274,India
629151,2023-11-13,204,strawberry yogurt,50,60,10,1,00289,India
629151,2023-11-13,207,coca cola,75,100,25,1,00289,India
629151,2023-11-13,205,classic yogurt,45,60,15,1,00289,India
629151,2023-11-13,203,mango yogurt,50,60,10,1,00289,India
450713,2023-11-13,206,yakult,360,400,40,1,00491,India
450713,2023-11-13,205,classic yogurt,45,60,15,1,00491,India
450713,2023-11-13,204,strawberry yogurt,50,60,10,1,00491,India
220413,2023-11-13,204,strawberry yogurt,50,60,10,1,00312,India
135463,2023-11-13,201,paneer,210,340,130,1,00121,India
135463,2023-11-13,203,mango yogurt,50,60,10,1,00121,India
291257,2023-11-13,204,strawberry yogurt,50,60,10,1,00397,India
291257,2023-11-13,201,paneer,210,340,130,1,00397,India
291257,2023-11-13,211,red bull,90,125,35,1,00397,India
291257,2023-11-13,212,amul cheese,250,315,65,1,00397,India
291257,2023-11-13,209,pepsi,75,100,25,1,00397,India
948926,2023-11-13,206,yakult,360,400,40,1,00322,India
948926,2023-11-13,211,red bull,90,125,35,1,00322,India
948926,2023-11-13,201,paneer,210,340,130,1,00322,India
886990,2023-11-13,213,bisleri,6,15,9,1,00388,India
886990,2023-11-13,209,pepsi,75,100,25,1,00388,India
886990,2023-11-13,204,strawberry yogurt,50,60,10,1,00388,India
527022,2023-11-13,204,strawberry yogurt,50,60,10,1,00316,India
527022,2023-11-13,205,classic yogurt,45,60,15,1,00316,India
527022,2023-11-13,212,amul cheese,250,315,65,1,00316,India
527022,2023-11-13,208,sprite,75,100,25,1,00316,India
518372,2023-11-13,209,pepsi,75,100,25,1,00122,India
518372,2023-11-13,202,milk,12,27,15,1,00122,India
518372,2023-11-13,213,bisleri,6,15,9,1,00122,India
939641,2023-11-13,208,sprite,75,100,25,1,00355,India
759440,2023-11-13,206,yakult,360,400,40,1,00184,India
759440,2023-11-13,208,sprite,75,100,25,1,00184,India
759440,2023-11-13,211,red bull,90,125,35,1,00184,India
759440,2023-11-13,201,paneer,210,340,130,1,00184,India
370787,2023-11-13,210,mountain dew,75,100,25,1,00295,India
370787,2023-11-13,206,yakult,360,400,40,1,00295,India
370787,2023-11-13,212,amul cheese,250,315,65,1,00295,India
325801,2023-11-13,213,bisleri,6,15,9,1,00351,India
325801,2023-11-13,202,milk,12,27,15,1,00351,India
325801,2023-11-13,209,pepsi,75,100,25,1,00351,India
325801,2023-11-13,205,classic yogurt,45,60,15,1,00351,India
436100,2023-11-13,212,amul cheese,250,315,65,1,00489,India
436100,2023-11-13,207,coca cola,75,100,25,1,00489,India
436100,2023-11-13,206,yakult,360,400,40,1,00489,India
436100,2023-11-13,208,sprite,75,100,25,1,00489,India
324997,2023-11-13,201,paneer,210,340,130,1,00213,India
324997,2023-11-13,203,mango yogurt,50,60,10,1,00213,India
324997,2023-11-13,213,bisleri,6,15,9,1,00213,India
324997,2023-11-13,212,amul cheese,250,315,65,1,00213,India
789305,2023-11-13,209,pepsi,75,100,25,1,00389,India
789305,2023-11-13,203,mango yogurt,50,60,10,1,00389,India
789305,2023-11-13,204,strawberry yogurt,50,60,10,1,00389,India
733965,2023-11-13,206,yakult,360,400,40,1,00273,India
733965,2023-11-13,213,bisleri,6,15,9,1,00273,India
733965,2023-11-13,205,classic yogurt,45,60,15,1,00273,India
274354,2023-11-13,211,red bull,90,125,35,1,00066,India
274354,2023-11-13,205,classic yogurt,45,60,15,1,00066,India
274354,2023-11-13,201,paneer,210,340,130,1,00066,India
274354,2023-11-13,204,strawberry yogurt,50,60,10,1,00066,India
714090,2023-11-13,208,sprite,75,100,25,1,00400,India
714090,2023-11-13,210,mountain dew,75,100,25,1,00400,India
714090,2023-11-13,207,coca cola,75,100,25,1,00400,India
714090,2023-11-13,206,yakult,360,400,40,1,00400,India
681647,2023-11-13,202,milk,12,27,15,1,00300,India
681647,2023-11-13,213,bisleri,6,15,9,1,00300,India
681647,2023-11-13,205,classic yogurt,45,60,15,1,00300,India
762130,2023-11-13,202,milk,12,27,15,1,00206,India
762130,2023-11-13,210,mountain dew,75,100,25,1,00206,India
762130,2023-11-13,204,strawberry yogurt,50,60,10,1,00206,India
351162,2023-11-14,212,amul cheese,250,315,65,1,00173,India
351162,2023-11-14,204,strawberry yogurt,50,60,10,1,00173,India
835982,2023-11-14,206,yakult,360,400,40,1,00124,India
835982,2023-11-14,208,sprite,75,100,25,1,00124,India
275590,2023-11-14,206,yakult,360,400,40,1,00290,India
275590,2023-11-14,205,classic yogurt,45,60,15,1,00290,India
275590,2023-11-14,208,sprite,75,100,25,1,00290,India
275590,2023-11-14,209,pepsi,75,100,25,1,00290,India
275590,2023-11-14,207,coca cola,75,100,25,1,00290,India
199432,2023-11-14,204,strawberry yogurt,50,60,10,1,00403,India
199432,2023-11-14,211,red bull,90,125,35,1,00403,India
199432,2023-11-14,205,classic yogurt,45,60,15,1,00403,India
199432,2023-11-14,208,sprite,75,100,25,1,00403,India
335860,2023-11-14,205,classic yogurt,45,60,15,1,00082,India
335860,2023-11-14,208,sprite,75,100,25,1,00082,India
335860,2023-11-14,212,amul cheese,250,315,65,1,00082,India
544043,2023-11-14,205,classic yogurt,45,60,15,1,00055,India
544043,2023-11-14,210,mountain dew,75,100,25,1,00055,India
544043,2023-11-14,202,milk,12,27,15,1,00055,India
369819,2023-11-14,203,mango yogurt,50,60,10,1,00382,India
369819,2023-11-14,212,amul cheese,250,315,65,1,00382,India
369819,2023-11-14,201,paneer,210,340,130,1,00382,India
636676,2023-11-14,208,sprite,75,100,25,1,00465,India
636676,2023-11-14,212,amul cheese,250,315,65,1,00465,India
636676,2023-11-14,205,classic yogurt,45,60,15,1,00465,India
636676,2023-11-14,210,mountain dew,75,100,25,1,00465,India
636676,2023-11-14,207,coca cola,75,100,25,1,00465,India
528940,2023-11-14,211,red bull,90,125,35,1,00108,India
528940,2023-11-14,209,pepsi,75,100,25,1,00108,India
528940,2023-11-14,205,classic yogurt,45,60,15,1,00108,India
582067,2023-11-14,209,pepsi,75,100,25,1,00456,India
582067,2023-11-14,201,paneer,210,340,130,1,00456,India
582067,2023-11-14,203,mango yogurt,50,60,10,1,00456,India
582067,2023-11-14,213,bisleri,6,15,9,1,00456,India
895940,2023-11-14,201,paneer,210,340,130,1,00095,India
895940,2023-11-14,206,yakult,360,400,40,1,00095,India
895940,2023-11-14,213,bisleri,6,15,9,1,00095,India
895940,2023-11-14,202,milk,12,27,15,1,00095,India
986167,2023-11-14,208,sprite,75,100,25,1,00251,India
986167,2023-11-14,212,amul cheese,250,315,65,1,00251,India
986167,2023-11-14,205,classic yogurt,45,60,15,1,00251,India
122250,2023-11-14,201,paneer,210,340,130,1,00207,India
122250,2023-11-14,211,red bull,90,125,35,1,00207,India
122250,2023-11-14,206,yakult,360,400,40,1,00207,India
122250,2023-11-14,203,mango yogurt,50,60,10,1,00207,India
988516,2023-11-14,213,bisleri,6,15,9,1,00288,India
988516,2023-11-14,202,milk,12,27,15,1,00288,India
988516,2023-11-14,207,coca cola,75,100,25,1,00288,India
988516,2023-11-14,208,sprite,75,100,25,1,00288,India
685798,2023-11-14,211,red bull,90,125,35,1,00291,India
685798,2023-11-14,201,paneer,210,340,130,1,00291,India
685798,2023-11-14,210,mountain dew,75,100,25,1,00291,India
685798,2023-11-14,209,pepsi,75,100,25,1,00291,India
460782,2023-11-14,202,milk,12,27,15,1,00333,India
460782,2023-11-14,207,coca cola,75,100,25,1,00333,India
460782,2023-11-14,211,red bull,90,125,35,1,00333,India
460782,2023-11-14,204,strawberry yogurt,50,60,10,1,00333,India
903652,2023-11-14,205,classic yogurt,45,60,15,1,00371,India
903652,2023-11-14,210,mountain dew,75,100,25,1,00371,India
903652,2023-11-14,206,yakult,360,400,40,1,00371,India
903652,2023-11-14,207,coca cola,75,100,25,1,00371,India
866213,2023-11-14,205,classic yogurt,45,60,15,1,00281,India
866213,2023-11-14,211,red bull,90,125,35,1,00281,India
866213,2023-11-14,203,mango yogurt,50,60,10,1,00281,India
866213,2023-11-14,208,sprite,75,100,25,1,00281,India
342268,2023-11-14,202,milk,12,27,15,1,00183,India
342268,2023-11-14,209,pepsi,75,100,25,1,00183,India
342268,2023-11-14,206,yakult,360,400,40,1,00183,India
181004,2023-11-14,207,coca cola,75,100,25,1,00482,India
558640,2023-11-14,209,pepsi,75,100,25,1,00397,India
558640,2023-11-14,212,amul cheese,250,315,65,1,00397,India
558640,2023-11-14,204,strawberry yogurt,50,60,10,1,00397,India
855944,2023-11-14,206,yakult,360,400,40,1,00148,India
855944,2023-11-14,202,milk,12,27,15,1,00148,India
855944,2023-11-14,212,amul cheese,250,315,65,1,00148,India
855944,2023-11-14,201,paneer,210,340,130,1,00148,India
806509,2023-11-14,212,amul cheese,250,315,65,1,00409,India
806509,2023-11-14,213,bisleri,6,15,9,1,00409,India
277182,2023-11-14,206,yakult,360,400,40,1,00423,India
277182,2023-11-14,204,strawberry yogurt,50,60,10,1,00423,India
597486,2023-11-14,206,yakult,360,400,40,1,00116,India
597486,2023-11-14,212,amul cheese,250,315,65,1,00116,India
597486,2023-11-14,213,bisleri,6,15,9,1,00116,India
641279,2023-11-14,208,sprite,75,100,25,1,00436,India
641279,2023-11-14,202,milk,12,27,15,1,00436,India
641279,2023-11-14,213,bisleri,6,15,9,1,00436,India
753908,2023-11-14,205,classic yogurt,45,60,15,1,00179,India
753908,2023-11-14,204,strawberry yogurt,50,60,10,1,00179,India
753908,2023-11-14,213,bisleri,6,15,9,1,00179,India
753908,2023-11-14,212,amul cheese,250,315,65,1,00179,India
328824,2023-11-14,207,coca cola,75,100,25,1,00366,India
328824,2023-11-14,208,sprite,75,100,25,1,00366,India
506298,2023-11-14,213,bisleri,6,15,9,1,00361,India
167014,2023-11-14,203,mango yogurt,50,60,10,1,00373,India
167014,2023-11-14,213,bisleri,6,15,9,1,00373,India
284298,2023-11-14,206,yakult,360,400,40,1,00080,India
284298,2023-11-14,212,amul cheese,250,315,65,1,00080,India
284298,2023-11-14,203,mango yogurt,50,60,10,1,00080,India
831071,2023-11-14,203,mango yogurt,50,60,10,1,00006,India
831071,2023-11-14,209,pepsi,75,100,25,1,00006,India
831071,2023-11-14,204,strawberry yogurt,50,60,10,1,00006,India
831071,2023-11-14,201,paneer,210,340,130,1,00006,India
852382,2023-11-14,203,mango yogurt,50,60,10,1,00155,India
628505,2023-11-14,209,pepsi,75,100,25,1,00391,India
608435,2023-11-14,204,strawberry yogurt,50,60,10,1,00267,India
608435,2023-11-14,202,milk,12,27,15,1,00267,India
608435,2023-11-14,201,paneer,210,340,130,1,00267,India
608435,2023-11-14,206,yakult,360,400,40,1,00267,India
762224,2023-11-14,202,milk,12,27,15,1,00085,India
762224,2023-11-14,211,red bull,90,125,35,1,00085,India
762224,2023-11-14,209,pepsi,75,100,25,1,00085,India
762224,2023-11-14,208,sprite,75,100,25,1,00085,India
762224,2023-11-14,204,strawberry yogurt,50,60,10,1,00085,India
734319,2023-11-14,206,yakult,360,400,40,1,00458,India
734319,2023-11-14,209,pepsi,75,100,25,1,00458,India
734319,2023-11-14,203,mango yogurt,50,60,10,1,00458,India
734319,2023-11-14,213,bisleri,6,15,9,1,00458,India
682817,2023-11-14,201,paneer,210,340,130,1,00391,India
682817,2023-11-14,204,strawberry yogurt,50,60,10,1,00391,India
682817,2023-11-14,208,sprite,75,100,25,1,00391,India
682817,2023-11-14,210,mountain dew,75,100,25,1,00391,India
187831,2023-11-14,209,pepsi,75,100,25,1,00076,India
187831,2023-11-14,210,mountain dew,75,100,25,1,00076,India
187831,2023-11-14,206,yakult,360,400,40,1,00076,India
187831,2023-11-14,207,coca cola,75,100,25,1,00076,India
198515,2023-11-14,204,strawberry yogurt,50,60,10,1,00329,India
198515,2023-11-14,211,red bull,90,125,35,1,00329,India
198515,2023-11-14,202,milk,12,27,15,1,00329,India
988940,2023-11-14,202,milk,12,27,15,1,00251,India
522494,2023-11-14,211,red bull,90,125,35,1,00330,India
522494,2023-11-14,206,yakult,360,400,40,1,00330,India
959607,2023-11-14,212,amul cheese,250,315,65,1,00054,India
959607,2023-11-14,206,yakult,360,400,40,1,00054,India
807292,2023-11-14,206,yakult,360,400,40,1,00465,India
807292,2023-11-14,212,amul cheese,250,315,65,1,00465,India
807292,2023-11-14,207,coca cola,75,100,25,1,00465,India
807292,2023-11-14,213,bisleri,6,15,9,1,00465,India
318101,2023-11-14,209,pepsi,75,100,25,1,00292,India
318101,2023-11-14,202,milk,12,27,15,1,00292,India
495645,2023-11-14,202,milk,12,27,15,1,00405,India
495645,2023-11-14,212,amul cheese,250,315,65,1,00405,India
495645,2023-11-14,210,mountain dew,75,100,25,1,00405,India
116114,2023-11-14,204,strawberry yogurt,50,60,10,1,00439,India
116114,2023-11-14,212,amul cheese,250,315,65,1,00439,India
116114,2023-11-14,207,coca cola,75,100,25,1,00439,India
713005,2023-11-14,202,milk,12,27,15,1,00491,India
713005,2023-11-14,213,bisleri,6,15,9,1,00491,India
713005,2023-11-14,205,classic yogurt,45,60,15,1,00491,India
665406,2023-11-14,208,sprite,75,100,25,1,00027,India
665406,2023-11-14,207,coca cola,75,100,25,1,00027,India
677288,2023-11-14,203,mango yogurt,50,60,10,1,00012,India
677288,2023-11-14,208,sprite,75,100,25,1,00012,India
577525,2023-11-14,211,red bull,90,125,35,1,00391,India
577525,2023-11-14,208,sprite,75,100,25,1,00391,India
937730,2023-11-14,205,classic yogurt,45,60,15,1,00105,India
937730,2023-11-14,208,sprite,75,100,25,1,00105,India
571882,2023-11-14,213,bisleri,6,15,9,1,00008,India
571882,2023-11-14,209,pepsi,75,100,25,1,00008,India
269058,2023-11-14,209,pepsi,75,100,25,1,00382,India
136539,2023-11-14,207,coca cola,75,100,25,1,00421,India
136539,2023-11-14,203,mango yogurt,50,60,10,1,00421,India
999736,2023-11-14,203,mango yogurt,50,60,10,1,00422,India
999736,2023-11-14,211,red bull,90,125,35,1,00422,India
999736,2023-11-14,206,yakult,360,400,40,1,00422,India
999736,2023-11-14,204,strawberry yogurt,50,60,10,1,00422,India
606477,2023-11-14,207,coca cola,75,100,25,1,00345,India
606477,2023-11-14,210,mountain dew,75,100,25,1,00345,India
606477,2023-11-14,213,bisleri,6,15,9,1,00345,India
606477,2023-11-14,202,milk,12,27,15,1,00345,India
790502,2023-11-14,210,mountain dew,75,100,25,1,00431,India
790502,2023-11-14,207,coca cola,75,100,25,1,00431,India
790502,2023-11-14,201,paneer,210,340,130,1,00431,India
790502,2023-11-14,203,mango yogurt,50,60,10,1,00431,India
114781,2023-11-14,212,amul cheese,250,315,65,1,00068,India
114781,2023-11-14,203,mango yogurt,50,60,10,1,00068,India
108371,2023-11-14,201,paneer,210,340,130,1,00191,India
665765,2023-11-14,210,mountain dew,75,100,25,1,00003,India
665765,2023-11-14,213,bisleri,6,15,9,1,00003,India
665765,2023-11-14,202,milk,12,27,15,1,00003,India
616504,2023-11-14,208,sprite,75,100,25,1,00318,India
616504,2023-11-14,205,classic yogurt,45,60,15,1,00318,India
616504,2023-11-14,213,bisleri,6,15,9,1,00318,India
317172,2023-11-14,202,milk,12,27,15,1,00425,India
317172,2023-11-14,212,amul cheese,250,315,65,1,00425,India
317172,2023-11-14,210,mountain dew,75,100,25,1,00425,India
428202,2023-11-14,213,bisleri,6,15,9,1,00337,India
544334,2023-11-14,210,mountain dew,75,100,25,1,00211,India
709643,2023-11-14,213,bisleri,6,15,9,1,00353,India
258869,2023-11-14,205,classic yogurt,45,60,15,1,00435,India
898907,2023-11-14,208,sprite,75,100,25,1,00176,India
898907,2023-11-14,209,pepsi,75,100,25,1,00176,India
898907,2023-11-14,207,coca cola,75,100,25,1,00176,India
506752,2023-11-14,204,strawberry yogurt,50,60,10,1,00454,India
506752,2023-11-14,212,amul cheese,250,315,65,1,00454,India
506752,2023-11-14,205,classic yogurt,45,60,15,1,00454,India
506752,2023-11-14,207,coca cola,75,100,25,1,00454,India
451109,2023-11-14,206,yakult,360,400,40,1,00469,India
192235,2023-11-14,206,yakult,360,400,40,1,00411,India
192235,2023-11-14,209,pepsi,75,100,25,1,00411,India
192235,2023-11-14,208,sprite,75,100,25,1,00411,India
879400,2023-11-14,204,strawberry yogurt,50,60,10,1,00054,India
857681,2023-11-14,213,bisleri,6,15,9,1,00200,India
857681,2023-11-14,210,mountain dew,75,100,25,1,00200,India
857681,2023-11-14,203,mango yogurt,50,60,10,1,00200,India
483961,2023-11-14,209,pepsi,75,100,25,1,00358,India
483961,2023-11-14,202,milk,12,27,15,1,00358,India
483961,2023-11-14,204,strawberry yogurt,50,60,10,1,00358,India
891843,2023-11-14,212,amul cheese,250,315,65,1,00114,India
891843,2023-11-14,208,sprite,75,100,25,1,00114,India
891843,2023-11-14,205,classic yogurt,45,60,15,1,00114,India
820679,2023-11-14,203,mango yogurt,50,60,10,1,00420,India
820679,2023-11-14,211,red bull,90,125,35,1,00420,India
820679,2023-11-14,212,amul cheese,250,315,65,1,00420,India
820679,2023-11-14,213,bisleri,6,15,9,1,00420,India
820679,2023-11-14,204,strawberry yogurt,50,60,10,1,00420,India
731354,2023-11-14,203,mango yogurt,50,60,10,1,00354,India
731354,2023-11-14,201,paneer,210,340,130,1,00354,India
731354,2023-11-14,210,mountain dew,75,100,25,1,00354,India
796569,2023-11-14,201,paneer,210,340,130,1,00417,India
527221,2023-11-14,208,sprite,75,100,25,1,00008,India
527221,2023-11-14,211,red bull,90,125,35,1,00008,India
527221,2023-11-14,210,mountain dew,75,100,25,1,00008,India
183801,2023-11-14,202,milk,12,27,15,1,00487,India
183801,2023-11-14,206,yakult,360,400,40,1,00487,India
183801,2023-11-14,203,mango yogurt,50,60,10,1,00487,India
951792,2023-11-14,203,mango yogurt,50,60,10,1,00156,India
558014,2023-11-15,203,mango yogurt,50,60,10,1,00452,India
558014,2023-11-15,212,amul cheese,250,315,65,1,00452,India
558014,2023-11-15,205,classic yogurt,45,60,15,1,00452,India
321581,2023-11-15,209,pepsi,75,100,25,1,00093,India
321581,2023-11-15,201,paneer,210,340,130,1,00093,India
321581,2023-11-15,204,strawberry yogurt,50,60,10,1,00093,India
444666,2023-11-15,208,sprite,75,100,25,1,00229,India
444666,2023-11-15,205,classic yogurt,45,60,15,1,00229,India
444666,2023-11-15,201,paneer,210,340,130,1,00229,India
453380,2023-11-15,211,red bull,90,125,35,1,00058,India
453380,2023-11-15,212,amul cheese,250,315,65,1,00058,India
453380,2023-11-15,201,paneer,210,340,130,1,00058,India
453380,2023-11-15,203,mango yogurt,50,60,10,1,00058,India
180924,2023-11-15,210,mountain dew,75,100,25,1,00310,India
180924,2023-11-15,212,amul cheese,250,315,65,1,00310,India
180924,2023-11-15,209,pepsi,75,100,25,1,00310,India
629462,2023-11-15,212,amul cheese,250,315,65,1,00059,India
629462,2023-11-15,204,strawberry yogurt,50,60,10,1,00059,India
143669,2023-11-15,205,classic yogurt,45,60,15,1,00127,India
143669,2023-11-15,207,coca cola,75,100,25,1,00127,India
160954,2023-11-15,208,sprite,75,100,25,1,00010,India
160954,2023-11-15,211,red bull,90,125,35,1,00010,India
160954,2023-11-15,207,coca cola,75,100,25,1,00010,India
600681,2023-11-15,205,classic yogurt,45,60,15,1,00011,India
940713,2023-11-15,213,bisleri,6,15,9,1,00344,India
940713,2023-11-15,209,pepsi,75,100,25,1,00344,India
940713,2023-11-15,211,red bull,90,125,35,1,00344,India
211978,2023-11-15,204,strawberry yogurt,50,60,10,1,00489,India
211978,2023-11-15,209,pepsi,75,100,25,1,00489,India
211978,2023-11-15,210,mountain dew,75,100,25,1,00489,India
262754,2023-11-15,205,classic yogurt,45,60,15,1,00210,India
496080,2023-11-15,213,bisleri,6,15,9,1,00395,India
496080,2023-11-15,209,pepsi,75,100,25,1,00395,India
496080,2023-11-15,203,mango yogurt,50,60,10,1,00395,India
496080,2023-11-15,202,milk,12,27,15,1,00395,India
150719,2023-11-15,211,red bull,90,125,35,1,00213,India
150719,2023-11-15,204,strawberry yogurt,50,60,10,1,00213,India
150719,2023-11-15,212,amul cheese,250,315,65,1,00213,India
233837,2023-11-15,212,amul cheese,250,315,65,1,00407,India
945513,2023-11-15,208,sprite,75,100,25,1,00182,India
945513,2023-11-15,203,mango yogurt,50,60,10,1,00182,India
382518,2023-11-15,210,mountain dew,75,100,25,1,00265,India
382518,2023-11-15,208,sprite,75,100,25,1,00265,India
382518,2023-11-15,207,coca cola,75,100,25,1,00265,India
302007,2023-11-15,212,amul cheese,250,315,65,1,00419,India
302007,2023-11-15,201,paneer,210,340,130,1,00419,India
302007,2023-11-15,213,bisleri,6,15,9,1,00419,India
557224,2023-11-15,211,red bull,90,125,35,1,00205,India
557224,2023-11-15,210,mountain dew,75,100,25,1,00205,India
302613,2023-11-15,210,mountain dew,75,100,25,1,00280,India
745049,2023-11-15,210,mountain dew,75,100,25,1,00188,India
745049,2023-11-15,213,bisleri,6,15,9,1,00188,India
745049,2023-11-15,212,amul cheese,250,315,65,1,00188,India
516254,2023-11-15,203,mango yogurt,50,60,10,1,00330,India
753454,2023-11-15,207,coca cola,75,100,25,1,00309,India
753454,2023-11-15,202,milk,12,27,15,1,00309,India
753454,2023-11-15,203,mango yogurt,50,60,10,1,00309,India
753454,2023-11-15,210,mountain dew,75,100,25,1,00309,India
458722,2023-11-15,204,strawberry yogurt,50,60,10,1,00224,India
327229,2023-11-15,211,red bull,90,125,35,1,00249,India
327229,2023-11-15,210,mountain dew,75,100,25,1,00249,India
327229,2023-11-15,207,coca cola,75,100,25,1,00249,India
685159,2023-11-15,205,classic yogurt,45,60,15,1,00404,India
685159,2023-11-15,209,pepsi,75,100,25,1,00404,India
685159,2023-11-15,201,paneer,210,340,130,1,00404,India
685159,2023-11-15,203,mango yogurt,50,60,10,1,00404,India
766806,2023-11-15,213,bisleri,6,15,9,1,00228,India
346237,2023-11-15,211,red bull,90,125,35,1,00046,India
280875,2023-11-15,203,mango yogurt,50,60,10,1,00266,India
280875,2023-11-15,212,amul cheese,250,315,65,1,00266,India
280875,2023-11-15,213,bisleri,6,15,9,1,00266,India
280875,2023-11-15,202,milk,12,27,15,1,00266,India
280875,2023-11-15,209,pepsi,75,100,25,1,00266,India
861866,2023-11-15,207,coca cola,75,100,25,1,00279,India
861866,2023-11-15,205,classic yogurt,45,60,15,1,00279,India
861866,2023-11-15,202,milk,12,27,15,1,00279,India
861866,2023-11-15,211,red bull,90,125,35,1,00279,India
858648,2023-11-15,207,coca cola,75,100,25,1,00461,India
858648,2023-11-15,206,yakult,360,400,40,1,00461,India
220955,2023-11-15,202,milk,12,27,15,1,00050,India
220955,2023-11-15,210,mountain dew,75,100,25,1,00050,India
220955,2023-11-15,213,bisleri,6,15,9,1,00050,India
220955,2023-11-15,206,yakult,360,400,40,1,00050,India
324221,2023-11-15,205,classic yogurt,45,60,15,1,00439,India
109325,2023-11-15,201,paneer,210,340,130,1,00458,India
109325,2023-11-15,202,milk,12,27,15,1,00458,India
109325,2023-11-15,206,yakult,360,400,40,1,00458,India
109325,2023-11-15,212,amul cheese,250,315,65,1,00458,India
450755,2023-11-15,207,coca cola,75,100,25,1,00140,India
450755,2023-11-15,208,sprite,75,100,25,1,00140,India
450755,2023-11-15,210,mountain dew,75,100,25,1,00140,India
450755,2023-11-15,203,mango yogurt,50,60,10,1,00140,India
912904,2023-11-15,206,yakult,360,400,40,1,00321,India
125643,2023-11-15,201,paneer,210,340,130,1,00231,India
297786,2023-11-15,213,bisleri,6,15,9,1,00169,India
297786,2023-11-15,209,pepsi,75,100,25,1,00169,India
297786,2023-11-15,204,strawberry yogurt,50,60,10,1,00169,India
262693,2023-11-15,202,milk,12,27,15,1,00440,India
262693,2023-11-15,205,classic yogurt,45,60,15,1,00440,India
183589,2023-11-15,213,bisleri,6,15,9,1,00198,India
183589,2023-11-15,203,mango yogurt,50,60,10,1,00198,India
183589,2023-11-15,201,paneer,210,340,130,1,00198,India
450462,2023-11-15,209,pepsi,75,100,25,1,00438,India
450462,2023-11-15,208,sprite,75,100,25,1,00438,India
343277,2023-11-15,213,bisleri,6,15,9,1,00259,India
343277,2023-11-15,204,strawberry yogurt,50,60,10,1,00259,India
541633,2023-11-15,209,pepsi,75,100,25,1,00219,India
541633,2023-11-15,213,bisleri,6,15,9,1,00219,India
831523,2023-11-15,207,coca cola,75,100,25,1,00302,India
831523,2023-11-15,206,yakult,360,400,40,1,00302,India
831523,2023-11-15,204,strawberry yogurt,50,60,10,1,00302,India
831523,2023-11-15,210,mountain dew,75,100,25,1,00302,India
207123,2023-11-15,207,coca cola,75,100,25,1,00342,India
207123,2023-11-15,201,paneer,210,340,130,1,00342,India
207123,2023-11-15,206,yakult,360,400,40,1,00342,India
207123,2023-11-15,213,bisleri,6,15,9,1,00342,India
896845,2023-11-15,211,red bull,90,125,35,1,00464,India
896845,2023-11-15,212,amul cheese,250,315,65,1,00464,India
268232,2023-11-15,204,strawberry yogurt,50,60,10,1,00486,India
118272,2023-11-15,205,classic yogurt,45,60,15,1,00474,India
118272,2023-11-15,211,red bull,90,125,35,1,00474,India
118272,2023-11-15,206,yakult,360,400,40,1,00474,India
535709,2023-11-15,211,red bull,90,125,35,1,00459,India
535709,2023-11-15,205,classic yogurt,45,60,15,1,00459,India
535709,2023-11-15,201,paneer,210,340,130,1,00459,India
358642,2023-11-15,208,sprite,75,100,25,1,00421,India
358642,2023-11-15,206,yakult,360,400,40,1,00421,India
145303,2023-11-16,202,milk,12,27,15,1,00276,India
145303,2023-11-16,210,mountain dew,75,100,25,1,00276,India
145303,2023-11-16,205,classic yogurt,45,60,15,1,00276,India
145303,2023-11-16,211,red bull,90,125,35,1,00276,India
473390,2023-11-16,205,classic yogurt,45,60,15,1,00381,India
473390,2023-11-16,203,mango yogurt,50,60,10,1,00381,India
473390,2023-11-16,206,yakult,360,400,40,1,00381,India
473390,2023-11-16,210,mountain dew,75,100,25,1,00381,India
473390,2023-11-16,213,bisleri,6,15,9,1,00381,India
203204,2023-11-16,210,mountain dew,75,100,25,1,00417,India
203204,2023-11-16,204,strawberry yogurt,50,60,10,1,00417,India
203204,2023-11-16,202,milk,12,27,15,1,00417,India
203204,2023-11-16,211,red bull,90,125,35,1,00417,India
657280,2023-11-16,212,amul cheese,250,315,65,1,00023,India
657280,2023-11-16,210,mountain dew,75,100,25,1,00023,India
657280,2023-11-16,204,strawberry yogurt,50,60,10,1,00023,India
581708,2023-11-16,207,coca cola,75,100,25,1,00266,India
581708,2023-11-16,202,milk,12,27,15,1,00266,India
581708,2023-11-16,208,sprite,75,100,25,1,00266,India
731487,2023-11-16,204,strawberry yogurt,50,60,10,1,00048,India
731487,2023-11-16,201,paneer,210,340,130,1,00048,India
731487,2023-11-16,211,red bull,90,125,35,1,00048,India
769794,2023-11-16,203,mango yogurt,50,60,10,1,00240,India
769794,2023-11-16,206,yakult,360,400,40,1,00240,India
329453,2023-11-16,201,paneer,210,340,130,1,00178,India
658616,2023-11-16,204,strawberry yogurt,50,60,10,1,00428,India
658616,2023-11-16,202,milk,12,27,15,1,00428,India
658616,2023-11-16,206,yakult,360,400,40,1,00428,India
658616,2023-11-16,208,sprite,75,100,25,1,00428,India
759991,2023-11-16,207,coca cola,75,100,25,1,00094,India
759991,2023-11-16,209,pepsi,75,100,25,1,00094,India
532710,2023-11-16,206,yakult,360,400,40,1,00117,India
532710,2023-11-16,212,amul cheese,250,315,65,1,00117,India
532710,2023-11-16,204,strawberry yogurt,50,60,10,1,00117,India
468029,2023-11-16,204,strawberry yogurt,50,60,10,1,00219,India
468029,2023-11-16,203,mango yogurt,50,60,10,1,00219,India
363687,2023-11-16,203,mango yogurt,50,60,10,1,00303,India
363687,2023-11-16,208,sprite,75,100,25,1,00303,India
879000,2023-11-16,211,red bull,90,125,35,1,00223,India
889057,2023-11-16,201,paneer,210,340,130,1,00109,India
889057,2023-11-16,205,classic yogurt,45,60,15,1,00109,India
889057,2023-11-16,204,strawberry yogurt,50,60,10,1,00109,India
727184,2023-11-16,211,red bull,90,125,35,1,00113,India
727184,2023-11-16,206,yakult,360,400,40,1,00113,India
727184,2023-11-16,213,bisleri,6,15,9,1,00113,India
256045,2023-11-16,204,strawberry yogurt,50,60,10,1,00492,India
811069,2023-11-16,210,mountain dew,75,100,25,1,00417,India
811069,2023-11-16,202,milk,12,27,15,1,00417,India
811069,2023-11-16,209,pepsi,75,100,25,1,00417,India
811069,2023-11-16,204,strawberry yogurt,50,60,10,1,00417,India
811069,2023-11-16,207,coca cola,75,100,25,1,00417,India
836113,2023-11-16,209,pepsi,75,100,25,1,00294,India
733543,2023-11-16,202,milk,12,27,15,1,00133,India
622030,2023-11-16,204,strawberry yogurt,50,60,10,1,00422,India
870049,2023-11-16,207,coca cola,75,100,25,1,00175,India
869008,2023-11-16,206,yakult,360,400,40,1,00462,India
869008,2023-11-16,207,coca cola,75,100,25,1,00462,India
869008,2023-11-16,204,strawberry yogurt,50,60,10,1,00462,India
869008,2023-11-16,203,mango yogurt,50,60,10,1,00462,India
954118,2023-11-16,212,amul cheese,250,315,65,1,00112,India
507510,2023-11-16,203,mango yogurt,50,60,10,1,00149,India
717659,2023-11-16,207,coca cola,75,100,25,1,00150,India
717659,2023-11-16,202,milk,12,27,15,1,00150,India
977584,2023-11-16,203,mango yogurt,50,60,10,1,00404,India
977584,2023-11-16,202,milk,12,27,15,1,00404,India
977584,2023-11-16,210,mountain dew,75,100,25,1,00404,India
741504,2023-11-16,212,amul cheese,250,315,65,1,00266,India
741504,2023-11-16,202,milk,12,27,15,1,00266,India
314773,2023-11-16,209,pepsi,75,100,25,1,00416,India
314773,2023-11-16,205,classic yogurt,45,60,15,1,00416,India
314773,2023-11-16,202,milk,12,27,15,1,00416,India
386046,2023-11-16,205,classic yogurt,45,60,15,1,00466,India
386046,2023-11-16,211,red bull,90,125,35,1,00466,India
386046,2023-11-16,208,sprite,75,100,25,1,00466,India
569853,2023-11-16,210,mountain dew,75,100,25,1,00189,India
592985,2023-11-16,208,sprite,75,100,25,1,00294,India
592985,2023-11-16,211,red bull,90,125,35,1,00294,India
592985,2023-11-16,203,mango yogurt,50,60,10,1,00294,India
592985,2023-11-16,209,pepsi,75,100,25,1,00294,India
592985,2023-11-16,207,coca cola,75,100,25,1,00294,India
529654,2023-11-16,209,pepsi,75,100,25,1,00075,India
529654,2023-11-16,212,amul cheese,250,315,65,1,00075,India
529654,2023-11-16,208,sprite,75,100,25,1,00075,India
237255,2023-11-16,211,red bull,90,125,35,1,00470,India
529569,2023-11-16,207,coca cola,75,100,25,1,00396,India
529569,2023-11-16,206,yakult,360,400,40,1,00396,India
496147,2023-11-16,209,pepsi,75,100,25,1,00474,India
496147,2023-11-16,201,paneer,210,340,130,1,00474,India
496147,2023-11-16,208,sprite,75,100,25,1,00474,India
563086,2023-11-16,205,classic yogurt,45,60,15,1,00316,India
159405,2023-11-16,211,red bull,90,125,35,1,00175,India
159405,2023-11-16,205,classic yogurt,45,60,15,1,00175,India
159405,2023-11-16,203,mango yogurt,50,60,10,1,00175,India
159405,2023-11-16,207,coca cola,75,100,25,1,00175,India
431233,2023-11-16,210,mountain dew,75,100,25,1,00253,India
431233,2023-11-16,206,yakult,360,400,40,1,00253,India
431233,2023-11-16,203,mango yogurt,50,60,10,1,00253,India
431233,2023-11-16,211,red bull,90,125,35,1,00253,India
958466,2023-11-16,208,sprite,75,100,25,1,00122,India
320694,2023-11-16,208,sprite,75,100,25,1,00146,India
947132,2023-11-16,202,milk,12,27,15,1,00128,India
947132,2023-11-16,203,mango yogurt,50,60,10,1,00128,India
522693,2023-11-16,203,mango yogurt,50,60,10,1,00086,India
522693,2023-11-16,204,strawberry yogurt,50,60,10,1,00086,India
522693,2023-11-16,201,paneer,210,340,130,1,00086,India
522693,2023-11-16,208,sprite,75,100,25,1,00086,India
423284,2023-11-16,205,classic yogurt,45,60,15,1,00289,India
693888,2023-11-16,210,mountain dew,75,100,25,1,00146,India
693888,2023-11-16,208,sprite,75,100,25,1,00146,India
693888,2023-11-16,206,yakult,360,400,40,1,00146,India
693888,2023-11-16,201,paneer,210,340,130,1,00146,India
693888,2023-11-16,204,strawberry yogurt,50,60,10,1,00146,India
624603,2023-11-16,205,classic yogurt,45,60,15,1,00100,India
624603,2023-11-16,202,milk,12,27,15,1,00100,India
624603,2023-11-16,207,coca cola,75,100,25,1,00100,India
624603,2023-11-16,201,paneer,210,340,130,1,00100,India
697836,2023-11-16,202,milk,12,27,15,1,00209,India
697836,2023-11-16,205,classic yogurt,45,60,15,1,00209,India
697836,2023-11-16,207,coca cola,75,100,25,1,00209,India
479423,2023-11-16,203,mango yogurt,50,60,10,1,00317,India
479423,2023-11-16,212,amul cheese,250,315,65,1,00317,India
479423,2023-11-16,210,mountain dew,75,100,25,1,00317,India
479423,2023-11-16,209,pepsi,75,100,25,1,00317,India
479423,2023-11-16,204,strawberry yogurt,50,60,10,1,00317,India
148825,2023-11-16,210,mountain dew,75,100,25,1,00212,India
148825,2023-11-16,211,red bull,90,125,35,1,00212,India
383126,2023-11-16,206,yakult,360,400,40,1,00404,India
383126,2023-11-16,211,red bull,90,125,35,1,00404,India
138212,2023-11-16,203,mango yogurt,50,60,10,1,00251,India
138212,2023-11-16,201,paneer,210,340,130,1,00251,India
138212,2023-11-16,213,bisleri,6,15,9,1,00251,India
408875,2023-11-16,210,mountain dew,75,100,25,1,00399,India
856940,2023-11-16,212,amul cheese,250,315,65,1,00109,India
856940,2023-11-16,210,mountain dew,75,100,25,1,00109,India
856940,2023-11-16,208,sprite,75,100,25,1,00109,India
832520,2023-11-16,213,bisleri,6,15,9,1,00028,India
662290,2023-11-16,209,pepsi,75,100,25,1,00025,India
662290,2023-11-16,212,amul cheese,250,315,65,1,00025,India
662290,2023-11-16,207,coca cola,75,100,25,1,00025,India
281850,2023-11-16,210,mountain dew,75,100,25,1,00034,India
281850,2023-11-16,206,yakult,360,400,40,1,00034,India
281850,2023-11-16,213,bisleri,6,15,9,1,00034,India
281850,2023-11-16,205,classic yogurt,45,60,15,1,00034,India
969086,2023-11-16,202,milk,12,27,15,1,00173,India
969086,2023-11-16,206,yakult,360,400,40,1,00173,India
969086,2023-11-16,203,mango yogurt,50,60,10,1,00173,India
410500,2023-11-16,204,strawberry yogurt,50,60,10,1,00051,India
410500,2023-11-16,206,yakult,360,400,40,1,00051,India
410500,2023-11-16,207,coca cola,75,100,25,1,00051,India
410500,2023-11-16,202,milk,12,27,15,1,00051,India
388046,2023-11-16,212,amul cheese,250,315,65,1,00285,India
388046,2023-11-16,208,sprite,75,100,25,1,00285,India
388046,2023-11-16,206,yakult,360,400,40,1,00285,India
552512,2023-11-16,210,mountain dew,75,100,25,1,00099,India
552512,2023-11-16,205,classic yogurt,45,60,15,1,00099,India
552512,2023-11-16,202,milk,12,27,15,1,00099,India
648470,2023-11-16,202,milk,12,27,15,1,00294,India
449261,2023-11-16,211,red bull,90,125,35,1,00107,India
293974,2023-11-16,207,coca cola,75,100,25,1,00313,India
293974,2023-11-16,206,yakult,360,400,40,1,00313,India
293974,2023-11-16,202,milk,12,27,15,1,00313,India
311671,2023-11-16,204,strawberry yogurt,50,60,10,1,00124,India
311671,2023-11-16,207,coca cola,75,100,25,1,00124,India
311671,2023-11-16,209,pepsi,75,100,25,1,00124,India
232400,2023-11-16,208,sprite,75,100,25,1,00206,India
232400,2023-11-16,207,coca cola,75,100,25,1,00206,India
232400,2023-11-16,202,milk,12,27,15,1,00206,India
232400,2023-11-16,203,mango yogurt,50,60,10,1,00206,India
389168,2023-11-16,203,mango yogurt,50,60,10,1,00289,India
389168,2023-11-16,208,sprite,75,100,25,1,00289,India
445863,2023-11-16,209,pepsi,75,100,25,1,00262,India
445863,2023-11-16,210,mountain dew,75,100,25,1,00262,India
445863,2023-11-16,201,paneer,210,340,130,1,00262,India
110164,2023-11-16,207,coca cola,75,100,25,1,00437,India
498127,2023-11-16,212,amul cheese,250,315,65,1,00087,India
498127,2023-11-16,202,milk,12,27,15,1,00087,India
498127,2023-11-16,211,red bull,90,125,35,1,00087,India
128909,2023-11-16,207,coca cola,75,100,25,1,00306,India
128909,2023-11-16,201,paneer,210,340,130,1,00306,India
128909,2023-11-16,202,milk,12,27,15,1,00306,India
818694,2023-11-16,207,coca cola,75,100,25,1,00309,India
818694,2023-11-16,205,classic yogurt,45,60,15,1,00309,India
818694,2023-11-16,209,pepsi,75,100,25,1,00309,India
818694,2023-11-16,211,red bull,90,125,35,1,00309,India
591368,2023-11-16,208,sprite,75,100,25,1,00476,India
591368,2023-11-16,213,bisleri,6,15,9,1,00476,India
591368,2023-11-16,201,paneer,210,340,130,1,00476,India
344838,2023-11-16,202,milk,12,27,15,1,00019,India
344838,2023-11-16,206,yakult,360,400,40,1,00019,India
344838,2023-11-16,208,sprite,75,100,25,1,00019,India
344838,2023-11-16,201,paneer,210,340,130,1,00019,India
560852,2023-11-16,211,red bull,90,125,35,1,00136,India
560852,2023-11-16,209,pepsi,75,100,25,1,00136,India
988352,2023-11-16,210,mountain dew,75,100,25,1,00035,India
445907,2023-11-16,203,mango yogurt,50,60,10,1,00122,India
445907,2023-11-16,201,paneer,210,340,130,1,00122,India
946847,2023-11-16,211,red bull,90,125,35,1,00367,India
946847,2023-11-16,203,mango yogurt,50,60,10,1,00367,India
946847,2023-11-16,207,coca cola,75,100,25,1,00367,India
946847,2023-11-16,213,bisleri,6,15,9,1,00367,India
819257,2023-11-17,204,strawberry yogurt,50,60,10,1,00054,India
819257,2023-11-17,207,coca cola,75,100,25,1,00054,India
961460,2023-11-17,203,mango yogurt,50,60,10,1,00142,India
843658,2023-11-17,212,amul cheese,250,315,65,1,00389,India
843658,2023-11-17,203,mango yogurt,50,60,10,1,00389,India
843658,2023-11-17,206,yakult,360,400,40,1,00389,India
843658,2023-11-17,209,pepsi,75,100,25,1,00389,India
843658,2023-11-17,208,sprite,75,100,25,1,00389,India
236373,2023-11-17,205,classic yogurt,45,60,15,1,00049,India
236373,2023-11-17,207,coca cola,75,100,25,1,00049,India
236373,2023-11-17,209,pepsi,75,100,25,1,00049,India
236373,2023-11-17,204,strawberry yogurt,50,60,10,1,00049,India
236373,2023-11-17,202,milk,12,27,15,1,00049,India
422599,2023-11-17,210,mountain dew,75,100,25,1,00458,India
422599,2023-11-17,212,amul cheese,250,315,65,1,00458,India
422599,2023-11-17,213,bisleri,6,15,9,1,00458,India
422599,2023-11-17,206,yakult,360,400,40,1,00458,India
763410,2023-11-17,209,pepsi,75,100,25,1,00125,India
763410,2023-11-17,206,yakult,360,400,40,1,00125,India
763410,2023-11-17,204,strawberry yogurt,50,60,10,1,00125,India
155905,2023-11-17,203,mango yogurt,50,60,10,1,00137,India
155905,2023-11-17,209,pepsi,75,100,25,1,00137,India
155905,2023-11-17,211,red bull,90,125,35,1,00137,India
155905,2023-11-17,206,yakult,360,400,40,1,00137,India
770322,2023-11-17,201,paneer,210,340,130,1,00378,India
770322,2023-11-17,211,red bull,90,125,35,1,00378,India
770322,2023-11-17,210,mountain dew,75,100,25,1,00378,India
770322,2023-11-17,212,amul cheese,250,315,65,1,00378,India
726233,2023-11-17,209,pepsi,75,100,25,1,00404,India
788051,2023-11-17,205,classic yogurt,45,60,15,1,00298,India
788051,2023-11-17,212,amul cheese,250,315,65,1,00298,India
788051,2023-11-17,203,mango yogurt,50,60,10,1,00298,India
788051,2023-11-17,204,strawberry yogurt,50,60,10,1,00298,India
893200,2023-11-17,212,amul cheese,250,315,65,1,00026,India
893200,2023-11-17,206,yakult,360,400,40,1,00026,India
968243,2023-11-17,203,mango yogurt,50,60,10,1,00115,India
968243,2023-11-17,204,strawberry yogurt,50,60,10,1,00115,India
758702,2023-11-17,208,sprite,75,100,25,1,00498,India
758702,2023-11-17,211,red bull,90,125,35,1,00498,India
521009,2023-11-17,210,mountain dew,75,100,25,1,00359,India
625340,2023-11-17,208,sprite,75,100,25,1,00170,India
625340,2023-11-17,210,mountain dew,75,100,25,1,00170,India
625340,2023-11-17,213,bisleri,6,15,9,1,00170,India
625340,2023-11-17,212,amul cheese,250,315,65,1,00170,India
825700,2023-11-17,205,classic yogurt,45,60,15,1,00048,India
825700,2023-11-17,201,paneer,210,340,130,1,00048,India
377064,2023-11-17,212,amul cheese,250,315,65,1,00313,India
377064,2023-11-17,205,classic yogurt,45,60,15,1,00313,India
377064,2023-11-17,209,pepsi,75,100,25,1,00313,India
377064,2023-11-17,202,milk,12,27,15,1,00313,India
455491,2023-11-17,202,milk,12,27,15,1,00319,India
756456,2023-11-17,201,paneer,210,340,130,1,00416,India
338932,2023-11-17,201,paneer,210,340,130,1,00333,India
338932,2023-11-17,203,mango yogurt,50,60,10,1,00333,India
338932,2023-11-17,213,bisleri,6,15,9,1,00333,India
338932,2023-11-17,207,coca cola,75,100,25,1,00333,India
777575,2023-11-17,205,classic yogurt,45,60,15,1,00331,India
777575,2023-11-17,203,mango yogurt,50,60,10,1,00331,India
521747,2023-11-17,202,milk,12,27,15,1,00411,India
521747,2023-11-17,213,bisleri,6,15,9,1,00411,India
521747,2023-11-17,211,red bull,90,125,35,1,00411,India
506392,2023-11-17,211,red bull,90,125,35,1,00104,India
506392,2023-11-17,213,bisleri,6,15,9,1,00104,India
530176,2023-11-17,206,yakult,360,400,40,1,00124,India
530176,2023-11-17,201,paneer,210,340,130,1,00124,India
530176,2023-11-17,208,sprite,75,100,25,1,00124,India
530176,2023-11-17,202,milk,12,27,15,1,00124,India
530176,2023-11-17,213,bisleri,6,15,9,1,00124,India
816934,2023-11-17,211,red bull,90,125,35,1,00113,India
816934,2023-11-17,202,milk,12,27,15,1,00113,India
816934,2023-11-17,206,yakult,360,400,40,1,00113,India
808061,2023-11-17,201,paneer,210,340,130,1,00481,India
625624,2023-11-17,212,amul cheese,250,315,65,1,00068,India
553393,2023-11-17,202,milk,12,27,15,1,00447,India
553393,2023-11-17,207,coca cola,75,100,25,1,00447,India
553393,2023-11-17,204,strawberry yogurt,50,60,10,1,00447,India
538958,2023-11-17,207,coca cola,75,100,25,1,00145,India
492274,2023-11-17,202,milk,12,27,15,1,00085,India
507590,2023-11-17,205,classic yogurt,45,60,15,1,00339,India
236745,2023-11-17,202,milk,12,27,15,1,00390,India
318586,2023-11-17,211,red bull,90,125,35,1,00153,India
318586,2023-11-17,206,yakult,360,400,40,1,00153,India
855818,2023-11-17,207,coca cola,75,100,25,1,00486,India
855818,2023-11-17,206,yakult,360,400,40,1,00486,India
855818,2023-11-17,208,sprite,75,100,25,1,00486,India
753959,2023-11-17,201,paneer,210,340,130,1,00097,India
753959,2023-11-17,208,sprite,75,100,25,1,00097,India
753959,2023-11-17,207,coca cola,75,100,25,1,00097,India
713086,2023-11-17,201,paneer,210,340,130,1,00030,India
803956,2023-11-17,211,red bull,90,125,35,1,00389,India
803956,2023-11-17,201,paneer,210,340,130,1,00389,India
803956,2023-11-17,205,classic yogurt,45,60,15,1,00389,India
102913,2023-11-17,207,coca cola,75,100,25,1,00456,India
846605,2023-11-17,207,coca cola,75,100,25,1,00262,India
846605,2023-11-17,209,pepsi,75,100,25,1,00262,India
846605,2023-11-17,211,red bull,90,125,35,1,00262,India
846605,2023-11-17,213,bisleri,6,15,9,1,00262,India
890812,2023-11-17,206,yakult,360,400,40,1,00407,India
890812,2023-11-17,201,paneer,210,340,130,1,00407,India
878387,2023-11-17,206,yakult,360,400,40,1,00005,India
878387,2023-11-17,204,strawberry yogurt,50,60,10,1,00005,India
878387,2023-11-17,210,mountain dew,75,100,25,1,00005,India
878387,2023-11-17,203,mango yogurt,50,60,10,1,00005,India
878387,2023-11-17,202,milk,12,27,15,1,00005,India
298542,2023-11-17,212,amul cheese,250,315,65,1,00058,India
719665,2023-11-17,201,paneer,210,340,130,1,00040,India
719665,2023-11-17,206,yakult,360,400,40,1,00040,India
719665,2023-11-17,209,pepsi,75,100,25,1,00040,India
719665,2023-11-17,203,mango yogurt,50,60,10,1,00040,India
719665,2023-11-17,204,strawberry yogurt,50,60,10,1,00040,India
701693,2023-11-17,203,mango yogurt,50,60,10,1,00352,India
701693,2023-11-17,208,sprite,75,100,25,1,00352,India
701693,2023-11-17,207,coca cola,75,100,25,1,00352,India
547447,2023-11-17,212,amul cheese,250,315,65,1,00396,India
975722,2023-11-17,202,milk,12,27,15,1,00186,India
599412,2023-11-17,206,yakult,360,400,40,1,00144,India
599412,2023-11-17,211,red bull,90,125,35,1,00144,India
599412,2023-11-17,201,paneer,210,340,130,1,00144,India
199808,2023-11-17,211,red bull,90,125,35,1,00141,India
796276,2023-11-17,205,classic yogurt,45,60,15,1,00057,India
796276,2023-11-17,210,mountain dew,75,100,25,1,00057,India
796276,2023-11-17,203,mango yogurt,50,60,10,1,00057,India
796276,2023-11-17,207,coca cola,75,100,25,1,00057,India
460787,2023-11-17,202,milk,12,27,15,1,00093,India
460787,2023-11-17,209,pepsi,75,100,25,1,00093,India
460787,2023-11-17,205,classic yogurt,45,60,15,1,00093,India
177162,2023-11-17,212,amul cheese,250,315,65,1,00498,India
177162,2023-11-17,205,classic yogurt,45,60,15,1,00498,India
177162,2023-11-17,213,bisleri,6,15,9,1,00498,India
392260,2023-11-17,203,mango yogurt,50,60,10,1,00459,India
392260,2023-11-17,204,strawberry yogurt,50,60,10,1,00459,India
392260,2023-11-17,213,bisleri,6,15,9,1,00459,India
392260,2023-11-17,212,amul cheese,250,315,65,1,00459,India
392260,2023-11-17,202,milk,12,27,15,1,00459,India
400192,2023-11-17,202,milk,12,27,15,1,00356,India
400192,2023-11-17,206,yakult,360,400,40,1,00356,India
400192,2023-11-17,203,mango yogurt,50,60,10,1,00356,India
866882,2023-11-17,212,amul cheese,250,315,65,1,00373,India
866882,2023-11-17,202,milk,12,27,15,1,00373,India
866882,2023-11-17,209,pepsi,75,100,25,1,00373,India
866882,2023-11-17,206,yakult,360,400,40,1,00373,India
145259,2023-11-17,212,amul cheese,250,315,65,1,00386,India
507963,2023-11-17,207,coca cola,75,100,25,1,00268,India
507963,2023-11-17,204,strawberry yogurt,50,60,10,1,00268,India
507963,2023-11-17,202,milk,12,27,15,1,00268,India
507963,2023-11-17,206,yakult,360,400,40,1,00268,India
359016,2023-11-17,206,yakult,360,400,40,1,00317,India
359016,2023-11-17,203,mango yogurt,50,60,10,1,00317,India
359016,2023-11-17,204,strawberry yogurt,50,60,10,1,00317,India
224860,2023-11-17,203,mango yogurt,50,60,10,1,00454,India
224860,2023-11-17,211,red bull,90,125,35,1,00454,India
224860,2023-11-17,206,yakult,360,400,40,1,00454,India
792221,2023-11-17,212,amul cheese,250,315,65,1,00241,India
792221,2023-11-17,213,bisleri,6,15,9,1,00241,India
159302,2023-11-17,205,classic yogurt,45,60,15,1,00354,India
159302,2023-11-17,206,yakult,360,400,40,1,00354,India
159302,2023-11-17,204,strawberry yogurt,50,60,10,1,00354,India
450271,2023-11-17,203,mango yogurt,50,60,10,1,00328,India
563226,2023-11-17,212,amul cheese,250,315,65,1,00195,India
981058,2023-11-17,207,coca cola,75,100,25,1,00332,India
981058,2023-11-17,203,mango yogurt,50,60,10,1,00332,India
990396,2023-11-17,213,bisleri,6,15,9,1,00484,India
824017,2023-11-17,212,amul cheese,250,315,65,1,00150,India
824017,2023-11-17,201,paneer,210,340,130,1,00150,India
807899,2023-11-17,201,paneer,210,340,130,1,00317,India
807899,2023-11-17,210,mountain dew,75,100,25,1,00317,India
807899,2023-11-17,212,amul cheese,250,315,65,1,00317,India
212533,2023-11-17,212,amul cheese,250,315,65,1,00294,India
212533,2023-11-17,208,sprite,75,100,25,1,00294,India
212533,2023-11-17,210,mountain dew,75,100,25,1,00294,India
212533,2023-11-17,204,strawberry yogurt,50,60,10,1,00294,India
491257,2023-11-17,213,bisleri,6,15,9,1,00472,India
265816,2023-11-17,205,classic yogurt,45,60,15,1,00342,India
265816,2023-11-17,202,milk,12,27,15,1,00342,India
161965,2023-11-17,204,strawberry yogurt,50,60,10,1,00135,India
161965,2023-11-17,209,pepsi,75,100,25,1,00135,India
794214,2023-11-17,206,yakult,360,400,40,1,00223,India
794214,2023-11-17,209,pepsi,75,100,25,1,00223,India
794214,2023-11-17,212,amul cheese,250,315,65,1,00223,India
794214,2023-11-17,202,milk,12,27,15,1,00223,India
794214,2023-11-17,204,strawberry yogurt,50,60,10,1,00223,India
681622,2023-11-17,213,bisleri,6,15,9,1,00365,India
681622,2023-11-17,205,classic yogurt,45,60,15,1,00365,India
681622,2023-11-17,202,milk,12,27,15,1,00365,India
101992,2023-11-17,210,mountain dew,75,100,25,1,00045,India
101992,2023-11-17,212,amul cheese,250,315,65,1,00045,India
101992,2023-11-17,211,red bull,90,125,35,1,00045,India
101992,2023-11-17,206,yakult,360,400,40,1,00045,India
393703,2023-11-17,202,milk,12,27,15,1,00296,India
821895,2023-11-17,204,strawberry yogurt,50,60,10,1,00124,India
821895,2023-11-17,208,sprite,75,100,25,1,00124,India
821895,2023-11-17,212,amul cheese,250,315,65,1,00124,India
132144,2023-11-17,212,amul cheese,250,315,65,1,00024,India
132144,2023-11-17,210,mountain dew,75,100,25,1,00024,India
132144,2023-11-17,213,bisleri,6,15,9,1,00024,India
926098,2023-11-17,201,paneer,210,340,130,1,00211,India
926098,2023-11-17,207,coca cola,75,100,25,1,00211,India
608209,2023-11-17,211,red bull,90,125,35,1,00163,India
608209,2023-11-17,210,mountain dew,75,100,25,1,00163,India
211979,2023-11-17,201,paneer,210,340,130,1,00140,India
211979,2023-11-17,209,pepsi,75,100,25,1,00140,India
450306,2023-11-17,207,coca cola,75,100,25,1,00471,India
450306,2023-11-17,205,classic yogurt,45,60,15,1,00471,India
903856,2023-11-17,206,yakult,360,400,40,1,00304,India
903856,2023-11-17,211,red bull,90,125,35,1,00304,India
903856,2023-11-17,202,milk,12,27,15,1,00304,India
903856,2023-11-17,205,classic yogurt,45,60,15,1,00304,India
747866,2023-11-17,203,mango yogurt,50,60,10,1,00086,India
747866,2023-11-17,201,paneer,210,340,130,1,00086,India
747866,2023-11-17,212,amul cheese,250,315,65,1,00086,India
463891,2023-11-17,209,pepsi,75,100,25,1,00469,India
463891,2023-11-17,206,yakult,360,400,40,1,00469,India
463891,2023-11-17,208,sprite,75,100,25,1,00469,India
463891,2023-11-17,207,coca cola,75,100,25,1,00469,India
715306,2023-11-17,208,sprite,75,100,25,1,00014,India
715306,2023-11-17,207,coca cola,75,100,25,1,00014,India
715306,2023-11-17,201,paneer,210,340,130,1,00014,India
140140,2023-11-17,206,yakult,360,400,40,1,00417,India
498714,2023-11-17,207,coca cola,75,100,25,1,00425,India
498714,2023-11-17,202,milk,12,27,15,1,00425,India
168455,2023-11-17,204,strawberry yogurt,50,60,10,1,00214,India
168455,2023-11-17,213,bisleri,6,15,9,1,00214,India
379012,2023-11-17,208,sprite,75,100,25,1,00488,India
379012,2023-11-17,212,amul cheese,250,315,65,1,00488,India
394919,2023-11-17,207,coca cola,75,100,25,1,00204,India
916610,2023-11-17,213,bisleri,6,15,9,1,00106,India
916610,2023-11-17,202,milk,12,27,15,1,00106,India
738825,2023-11-17,211,red bull,90,125,35,1,00173,India
738972,2023-11-17,211,red bull,90,125,35,1,00102,India
738972,2023-11-17,202,milk,12,27,15,1,00102,India
738972,2023-11-17,210,mountain dew,75,100,25,1,00102,India
738972,2023-11-17,205,classic yogurt,45,60,15,1,00102,India
738972,2023-11-17,201,paneer,210,340,130,1,00102,India
526291,2023-11-17,206,yakult,360,400,40,1,00354,India
526291,2023-11-17,212,amul cheese,250,315,65,1,00354,India
526291,2023-11-17,213,bisleri,6,15,9,1,00354,India
526291,2023-11-17,203,mango yogurt,50,60,10,1,00354,India
111189,2023-11-17,210,mountain dew,75,100,25,1,00158,India
111189,2023-11-17,203,mango yogurt,50,60,10,1,00158,India
111189,2023-11-17,201,paneer,210,340,130,1,00158,India
111189,2023-11-17,211,red bull,90,125,35,1,00158,India
750324,2023-11-17,204,strawberry yogurt,50,60,10,1,00404,India
750324,2023-11-17,203,mango yogurt,50,60,10,1,00404,India
750324,2023-11-17,209,pepsi,75,100,25,1,00404,India
813996,2023-11-18,207,coca cola,75,100,25,1,00413,India
813996,2023-11-18,202,milk,12,27,15,1,00413,India
813996,2023-11-18,204,strawberry yogurt,50,60,10,1,00413,India
813996,2023-11-18,208,sprite,75,100,25,1,00413,India
550081,2023-11-18,202,milk,12,27,15,1,00084,India
550081,2023-11-18,204,strawberry yogurt,50,60,10,1,00084,India
739450,2023-11-18,211,red bull,90,125,35,1,00124,India
344724,2023-11-18,208,sprite,75,100,25,1,00019,India
781604,2023-11-18,208,sprite,75,100,25,1,00214,India
393472,2023-11-18,203,mango yogurt,50,60,10,1,00387,India
393472,2023-11-18,206,yakult,360,400,40,1,00387,India
393472,2023-11-18,209,pepsi,75,100,25,1,00387,India
638410,2023-11-18,213,bisleri,6,15,9,1,00291,India
177096,2023-11-18,211,red bull,90,125,35,1,00478,India
177096,2023-11-18,203,mango yogurt,50,60,10,1,00478,India
652868,2023-11-18,206,yakult,360,400,40,1,00185,India
652868,2023-11-18,208,sprite,75,100,25,1,00185,India
652868,2023-11-18,207,coca cola,75,100,25,1,00185,India
652868,2023-11-18,211,red bull,90,125,35,1,00185,India
652868,2023-11-18,212,amul cheese,250,315,65,1,00185,India
986653,2023-11-18,206,yakult,360,400,40,1,00336,India
134374,2023-11-18,208,sprite,75,100,25,1,00193,India
134374,2023-11-18,213,bisleri,6,15,9,1,00193,India
134374,2023-11-18,207,coca cola,75,100,25,1,00193,India
134374,2023-11-18,203,mango yogurt,50,60,10,1,00193,India
193963,2023-11-18,213,bisleri,6,15,9,1,00498,India
365256,2023-11-18,203,mango yogurt,50,60,10,1,00144,India
390489,2023-11-18,212,amul cheese,250,315,65,1,00255,India
839735,2023-11-18,201,paneer,210,340,130,1,00456,India
859886,2023-11-18,204,strawberry yogurt,50,60,10,1,00341,India
859886,2023-11-18,208,sprite,75,100,25,1,00341,India
859886,2023-11-18,213,bisleri,6,15,9,1,00341,India
859886,2023-11-18,201,paneer,210,340,130,1,00341,India
123826,2023-11-18,209,pepsi,75,100,25,1,00145,India
123826,2023-11-18,202,milk,12,27,15,1,00145,India
123826,2023-11-18,206,yakult,360,400,40,1,00145,India
123826,2023-11-18,211,red bull,90,125,35,1,00145,India
325900,2023-11-18,201,paneer,210,340,130,1,00487,India
325900,2023-11-18,212,amul cheese,250,315,65,1,00487,India
325900,2023-11-18,206,yakult,360,400,40,1,00487,India
313166,2023-11-18,211,red bull,90,125,35,1,00069,India
313166,2023-11-18,203,mango yogurt,50,60,10,1,00069,India
550338,2023-11-18,209,pepsi,75,100,25,1,00134,India
550338,2023-11-18,205,classic yogurt,45,60,15,1,00134,India
550338,2023-11-18,202,milk,12,27,15,1,00134,India
550338,2023-11-18,212,amul cheese,250,315,65,1,00134,India
468238,2023-11-18,203,mango yogurt,50,60,10,1,00005,India
468238,2023-11-18,205,classic yogurt,45,60,15,1,00005,India
222806,2023-11-18,201,paneer,210,340,130,1,00451,India
718580,2023-11-18,209,pepsi,75,100,25,1,00046,India
718580,2023-11-18,208,sprite,75,100,25,1,00046,India
718580,2023-11-18,212,amul cheese,250,315,65,1,00046,India
724701,2023-11-18,212,amul cheese,250,315,65,1,00022,India
724701,2023-11-18,208,sprite,75,100,25,1,00022,India
904216,2023-11-18,205,classic yogurt,45,60,15,1,00025,India
492971,2023-11-18,213,bisleri,6,15,9,1,00466,India
492971,2023-11-18,211,red bull,90,125,35,1,00466,India
524147,2023-11-18,211,red bull,90,125,35,1,00066,India
524147,2023-11-18,209,pepsi,75,100,25,1,00066,India
524147,2023-11-18,213,bisleri,6,15,9,1,00066,India
524147,2023-11-18,206,yakult,360,400,40,1,00066,India
674124,2023-11-18,208,sprite,75,100,25,1,00447,India
674124,2023-11-18,209,pepsi,75,100,25,1,00447,India
674124,2023-11-18,207,coca cola,75,100,25,1,00447,India
674124,2023-11-18,210,mountain dew,75,100,25,1,00447,India
480710,2023-11-18,202,milk,12,27,15,1,00449,India
420324,2023-11-18,201,paneer,210,340,130,1,00378,India
420324,2023-11-18,206,yakult,360,400,40,1,00378,India
875745,2023-11-18,209,pepsi,75,100,25,1,00054,India
875745,2023-11-18,207,coca cola,75,100,25,1,00054,India
875745,2023-11-18,213,bisleri,6,15,9,1,00054,India
289482,2023-11-18,212,amul cheese,250,315,65,1,00347,India
289482,2023-11-18,201,paneer,210,340,130,1,00347,India
303613,2023-11-18,212,amul cheese,250,315,65,1,00289,India
303613,2023-11-18,201,paneer,210,340,130,1,00289,India
138135,2023-11-18,201,paneer,210,340,130,1,00153,India
138135,2023-11-18,212,amul cheese,250,315,65,1,00153,India
138135,2023-11-18,210,mountain dew,75,100,25,1,00153,India
138135,2023-11-18,213,bisleri,6,15,9,1,00153,India
628456,2023-11-18,213,bisleri,6,15,9,1,00232,India
628456,2023-11-18,212,amul cheese,250,315,65,1,00232,India
628456,2023-11-18,201,paneer,210,340,130,1,00232,India
197783,2023-11-18,209,pepsi,75,100,25,1,00319,India
197783,2023-11-18,207,coca cola,75,100,25,1,00319,India
197783,2023-11-18,205,classic yogurt,45,60,15,1,00319,India
754912,2023-11-18,206,yakult,360,400,40,1,00251,India
801382,2023-11-18,211,red bull,90,125,35,1,00002,India
801382,2023-11-18,206,yakult,360,400,40,1,00002,India
278425,2023-11-18,207,coca cola,75,100,25,1,00491,India
278425,2023-11-18,211,red bull,90,125,35,1,00491,India
115162,2023-11-18,213,bisleri,6,15,9,1,00374,India
115162,2023-11-18,209,pepsi,75,100,25,1,00374,India
792038,2023-11-18,201,paneer,210,340,130,1,00219,India
944657,2023-11-18,208,sprite,75,100,25,1,00410,India
944657,2023-11-18,211,red bull,90,125,35,1,00410,India
511738,2023-11-18,209,pepsi,75,100,25,1,00127,India
511738,2023-11-18,206,yakult,360,400,40,1,00127,India
252607,2023-11-18,201,paneer,210,340,130,1,00175,India
252607,2023-11-18,202,milk,12,27,15,1,00175,India
252607,2023-11-18,212,amul cheese,250,315,65,1,00175,India
252607,2023-11-18,203,mango yogurt,50,60,10,1,00175,India
142518,2023-11-18,212,amul cheese,250,315,65,1,00340,India
142518,2023-11-18,209,pepsi,75,100,25,1,00340,India
142518,2023-11-18,202,milk,12,27,15,1,00340,India
142518,2023-11-18,204,strawberry yogurt,50,60,10,1,00340,India
540166,2023-11-18,208,sprite,75,100,25,1,00306,India
678226,2023-11-18,213,bisleri,6,15,9,1,00438,India
678226,2023-11-18,210,mountain dew,75,100,25,1,00438,India
678226,2023-11-18,211,red bull,90,125,35,1,00438,India
728840,2023-11-18,206,yakult,360,400,40,1,00495,India
728840,2023-11-18,203,mango yogurt,50,60,10,1,00495,India
269821,2023-11-18,212,amul cheese,250,315,65,1,00092,India
884148,2023-11-18,213,bisleri,6,15,9,1,00185,India
884148,2023-11-18,210,mountain dew,75,100,25,1,00185,India
272506,2023-11-18,205,classic yogurt,45,60,15,1,00152,India
272506,2023-11-18,201,paneer,210,340,130,1,00152,India
272506,2023-11-18,209,pepsi,75,100,25,1,00152,India
272506,2023-11-18,210,mountain dew,75,100,25,1,00152,India
272506,2023-11-18,207,coca cola,75,100,25,1,00152,India
751578,2023-11-18,213,bisleri,6,15,9,1,00487,India
751578,2023-11-18,212,amul cheese,250,315,65,1,00487,India
751578,2023-11-18,207,coca cola,75,100,25,1,00487,India
751578,2023-11-18,211,red bull,90,125,35,1,00487,India
200811,2023-11-18,208,sprite,75,100,25,1,00019,India
320571,2023-11-18,212,amul cheese,250,315,65,1,00239,India
238801,2023-11-18,206,yakult,360,400,40,1,00175,India
238801,2023-11-18,212,amul cheese,250,315,65,1,00175,India
444862,2023-11-18,210,mountain dew,75,100,25,1,00408,India
444862,2023-11-18,202,milk,12,27,15,1,00408,India
809338,2023-11-18,211,red bull,90,125,35,1,00128,India
809338,2023-11-18,213,bisleri,6,15,9,1,00128,India
219671,2023-11-18,209,pepsi,75,100,25,1,00499,India
219671,2023-11-18,202,milk,12,27,15,1,00499,India
219671,2023-11-18,212,amul cheese,250,315,65,1,00499,India
219671,2023-11-18,201,paneer,210,340,130,1,00499,India
805198,2023-11-18,205,classic yogurt,45,60,15,1,00284,India
323575,2023-11-18,206,yakult,360,400,40,1,00359,India
323575,2023-11-18,213,bisleri,6,15,9,1,00359,India
323575,2023-11-18,202,milk,12,27,15,1,00359,India
323575,2023-11-18,210,mountain dew,75,100,25,1,00359,India
323575,2023-11-18,203,mango yogurt,50,60,10,1,00359,India
741364,2023-11-18,204,strawberry yogurt,50,60,10,1,00027,India
293737,2023-11-18,203,mango yogurt,50,60,10,1,00198,India
293737,2023-11-18,204,strawberry yogurt,50,60,10,1,00198,India
293737,2023-11-18,207,coca cola,75,100,25,1,00198,India
781139,2023-11-18,205,classic yogurt,45,60,15,1,00193,India
781139,2023-11-18,213,bisleri,6,15,9,1,00193,India
781139,2023-11-18,204,strawberry yogurt,50,60,10,1,00193,India
781139,2023-11-18,211,red bull,90,125,35,1,00193,India
781139,2023-11-18,206,yakult,360,400,40,1,00193,India
578740,2023-11-18,213,bisleri,6,15,9,1,00017,India
578740,2023-11-18,202,milk,12,27,15,1,00017,India
578740,2023-11-18,206,yakult,360,400,40,1,00017,India
578740,2023-11-18,212,amul cheese,250,315,65,1,00017,India
858475,2023-11-18,205,classic yogurt,45,60,15,1,00297,India
858475,2023-11-18,203,mango yogurt,50,60,10,1,00297,India
534065,2023-11-19,203,mango yogurt,50,60,10,1,00354,India
534065,2023-11-19,209,pepsi,75,100,25,1,00354,India
353449,2023-11-19,201,paneer,210,340,130,1,00316,India
353449,2023-11-19,211,red bull,90,125,35,1,00316,India
460440,2023-11-19,207,coca cola,75,100,25,1,00062,India
460440,2023-11-19,202,milk,12,27,15,1,00062,India
460440,2023-11-19,203,mango yogurt,50,60,10,1,00062,India
929202,2023-11-19,201,paneer,210,340,130,1,00200,India
929202,2023-11-19,207,coca cola,75,100,25,1,00200,India
239268,2023-11-19,207,coca cola,75,100,25,1,00315,India
239268,2023-11-19,212,amul cheese,250,315,65,1,00315,India
239268,2023-11-19,202,milk,12,27,15,1,00315,India
276394,2023-11-19,202,milk,12,27,15,1,00250,India
276394,2023-11-19,207,coca cola,75,100,25,1,00250,India
276394,2023-11-19,210,mountain dew,75,100,25,1,00250,India
276394,2023-11-19,206,yakult,360,400,40,1,00250,India
622226,2023-11-19,207,coca cola,75,100,25,1,00306,India
622226,2023-11-19,202,milk,12,27,15,1,00306,India
622226,2023-11-19,204,strawberry yogurt,50,60,10,1,00306,India
622226,2023-11-19,210,mountain dew,75,100,25,1,00306,India
179694,2023-11-19,209,pepsi,75,100,25,1,00368,India
179694,2023-11-19,202,milk,12,27,15,1,00368,India
179694,2023-11-19,211,red bull,90,125,35,1,00368,India
295691,2023-11-19,202,milk,12,27,15,1,00368,India
244465,2023-11-19,205,classic yogurt,45,60,15,1,00486,India
244465,2023-11-19,204,strawberry yogurt,50,60,10,1,00486,India
284964,2023-11-19,201,paneer,210,340,130,1,00443,India
804112,2023-11-19,209,pepsi,75,100,25,1,00181,India
804112,2023-11-19,213,bisleri,6,15,9,1,00181,India
804112,2023-11-19,202,milk,12,27,15,1,00181,India
412597,2023-11-19,205,classic yogurt,45,60,15,1,00332,India
412597,2023-11-19,207,coca cola,75,100,25,1,00332,India
412597,2023-11-19,206,yakult,360,400,40,1,00332,India
582297,2023-11-19,202,milk,12,27,15,1,00302,India
582297,2023-11-19,207,coca cola,75,100,25,1,00302,India
582297,2023-11-19,213,bisleri,6,15,9,1,00302,India
718643,2023-11-19,213,bisleri,6,15,9,1,00132,India
718643,2023-11-19,207,coca cola,75,100,25,1,00132,India
718643,2023-11-19,212,amul cheese,250,315,65,1,00132,India
898431,2023-11-19,208,sprite,75,100,25,1,00105,India
898431,2023-11-19,207,coca cola,75,100,25,1,00105,India
792178,2023-11-19,212,amul cheese,250,315,65,1,00388,India
792178,2023-11-19,202,milk,12,27,15,1,00388,India
792178,2023-11-19,206,yakult,360,400,40,1,00388,India
792178,2023-11-19,207,coca cola,75,100,25,1,00388,India
249473,2023-11-19,211,red bull,90,125,35,1,00273,India
249473,2023-11-19,202,milk,12,27,15,1,00273,India
249473,2023-11-19,210,mountain dew,75,100,25,1,00273,India
249473,2023-11-19,213,bisleri,6,15,9,1,00273,India
840979,2023-11-19,210,mountain dew,75,100,25,1,00226,India
840979,2023-11-19,205,classic yogurt,45,60,15,1,00226,India
306029,2023-11-19,209,pepsi,75,100,25,1,00349,India
306029,2023-11-19,204,strawberry yogurt,50,60,10,1,00349,India
306029,2023-11-19,211,red bull,90,125,35,1,00349,India
306029,2023-11-19,202,milk,12,27,15,1,00349,India
612306,2023-11-19,208,sprite,75,100,25,1,00133,India
108493,2023-11-19,206,yakult,360,400,40,1,00169,India
108493,2023-11-19,210,mountain dew,75,100,25,1,00169,India
108493,2023-11-19,201,paneer,210,340,130,1,00169,India
793125,2023-11-19,209,pepsi,75,100,25,1,00328,India
378449,2023-11-19,205,classic yogurt,45,60,15,1,00277,India
378449,2023-11-19,212,amul cheese,250,315,65,1,00277,India
378449,2023-11-19,211,red bull,90,125,35,1,00277,India
659907,2023-11-19,201,paneer,210,340,130,1,00333,India
512229,2023-11-19,207,coca cola,75,100,25,1,00105,India
512229,2023-11-19,204,strawberry yogurt,50,60,10,1,00105,India
512229,2023-11-19,211,red bull,90,125,35,1,00105,India
551810,2023-11-19,212,amul cheese,250,315,65,1,00189,India
551810,2023-11-19,208,sprite,75,100,25,1,00189,India
551810,2023-11-19,210,mountain dew,75,100,25,1,00189,India
757936,2023-11-19,206,yakult,360,400,40,1,00379,India
525590,2023-11-19,213,bisleri,6,15,9,1,00066,India
646667,2023-11-19,210,mountain dew,75,100,25,1,00123,India
646667,2023-11-19,208,sprite,75,100,25,1,00123,India
646667,2023-11-19,207,coca cola,75,100,25,1,00123,India
414043,2023-11-19,204,strawberry yogurt,50,60,10,1,00367,India
414043,2023-11-19,202,milk,12,27,15,1,00367,India
414043,2023-11-19,213,bisleri,6,15,9,1,00367,India
725882,2023-11-19,210,mountain dew,75,100,25,1,00302,India
245797,2023-11-19,213,bisleri,6,15,9,1,00421,India
245797,2023-11-19,208,sprite,75,100,25,1,00421,India
247849,2023-11-19,207,coca cola,75,100,25,1,00150,India
738246,2023-11-19,211,red bull,90,125,35,1,00021,India
738246,2023-11-19,202,milk,12,27,15,1,00021,India
738246,2023-11-19,205,classic yogurt,45,60,15,1,00021,India
738246,2023-11-19,201,paneer,210,340,130,1,00021,India
955897,2023-11-19,204,strawberry yogurt,50,60,10,1,00347,India
955897,2023-11-19,206,yakult,360,400,40,1,00347,India
955897,2023-11-19,209,pepsi,75,100,25,1,00347,India
388436,2023-11-19,209,pepsi,75,100,25,1,00417,India
388436,2023-11-19,206,yakult,360,400,40,1,00417,India
904209,2023-11-19,211,red bull,90,125,35,1,00362,India
904209,2023-11-19,213,bisleri,6,15,9,1,00362,India
904209,2023-11-19,206,yakult,360,400,40,1,00362,India
329849,2023-11-19,201,paneer,210,340,130,1,00270,India
178651,2023-11-19,203,mango yogurt,50,60,10,1,00383,India
136100,2023-11-19,204,strawberry yogurt,50,60,10,1,00376,India
136100,2023-11-19,203,mango yogurt,50,60,10,1,00376,India
136100,2023-11-19,202,milk,12,27,15,1,00376,India
343606,2023-11-19,213,bisleri,6,15,9,1,00499,India
343606,2023-11-19,210,mountain dew,75,100,25,1,00499,India
343606,2023-11-19,207,coca cola,75,100,25,1,00499,India
970358,2023-11-19,212,amul cheese,250,315,65,1,00237,India
477884,2023-11-19,207,coca cola,75,100,25,1,00123,India
477884,2023-11-19,206,yakult,360,400,40,1,00123,India
905507,2023-11-19,209,pepsi,75,100,25,1,00147,India
905507,2023-11-19,202,milk,12,27,15,1,00147,India
905507,2023-11-19,201,paneer,210,340,130,1,00147,India
905507,2023-11-19,213,bisleri,6,15,9,1,00147,India
905507,2023-11-19,208,sprite,75,100,25,1,00147,India
631568,2023-11-19,202,milk,12,27,15,1,00377,India
631568,2023-11-19,209,pepsi,75,100,25,1,00377,India
726257,2023-11-19,211,red bull,90,125,35,1,00388,India
896171,2023-11-19,208,sprite,75,100,25,1,00236,India
896171,2023-11-19,201,paneer,210,340,130,1,00236,India
823883,2023-11-19,201,paneer,210,340,130,1,00445,India
823883,2023-11-19,213,bisleri,6,15,9,1,00445,India
823883,2023-11-19,209,pepsi,75,100,25,1,00445,India
823883,2023-11-19,202,milk,12,27,15,1,00445,India
484600,2023-11-19,209,pepsi,75,100,25,1,00148,India
484600,2023-11-19,204,strawberry yogurt,50,60,10,1,00148,India
484600,2023-11-19,201,paneer,210,340,130,1,00148,India
828127,2023-11-19,202,milk,12,27,15,1,00093,India
828127,2023-11-19,211,red bull,90,125,35,1,00093,India
828127,2023-11-19,212,amul cheese,250,315,65,1,00093,India
828127,2023-11-19,207,coca cola,75,100,25,1,00093,India
304480,2023-11-19,209,pepsi,75,100,25,1,00126,India
214011,2023-11-19,210,mountain dew,75,100,25,1,00199,India
214011,2023-11-19,202,milk,12,27,15,1,00199,India
214011,2023-11-19,206,yakult,360,400,40,1,00199,India
862172,2023-11-19,208,sprite,75,100,25,1,00370,India
862172,2023-11-19,206,yakult,360,400,40,1,00370,India
540220,2023-11-19,205,classic yogurt,45,60,15,1,00037,India
106038,2023-11-19,210,mountain dew,75,100,25,1,00414,India
106038,2023-11-19,206,yakult,360,400,40,1,00414,India
106038,2023-11-19,213,bisleri,6,15,9,1,00414,India
106038,2023-11-19,205,classic yogurt,45,60,15,1,00414,India
106038,2023-11-19,201,paneer,210,340,130,1,00414,India
874951,2023-11-19,208,sprite,75,100,25,1,00075,India
874951,2023-11-19,202,milk,12,27,15,1,00075,India
681773,2023-11-19,211,red bull,90,125,35,1,00353,India
681773,2023-11-19,203,mango yogurt,50,60,10,1,00353,India
681773,2023-11-19,204,strawberry yogurt,50,60,10,1,00353,India
895875,2023-11-19,210,mountain dew,75,100,25,1,00267,India
895875,2023-11-19,207,coca cola,75,100,25,1,00267,India
895875,2023-11-19,209,pepsi,75,100,25,1,00267,India
600469,2023-11-19,205,classic yogurt,45,60,15,1,00390,India
600469,2023-11-19,209,pepsi,75,100,25,1,00390,India
600469,2023-11-19,213,bisleri,6,15,9,1,00390,India
600469,2023-11-19,211,red bull,90,125,35,1,00390,India
557909,2023-11-19,208,sprite,75,100,25,1,00142,India
977344,2023-11-19,207,coca cola,75,100,25,1,00359,India
977344,2023-11-19,213,bisleri,6,15,9,1,00359,India
977344,2023-11-19,212,amul cheese,250,315,65,1,00359,India
252798,2023-11-19,211,red bull,90,125,35,1,00305,India
252798,2023-11-19,207,coca cola,75,100,25,1,00305,India
736082,2023-11-19,201,paneer,210,340,130,1,00106,India
736082,2023-11-19,207,coca cola,75,100,25,1,00106,India
736082,2023-11-19,211,red bull,90,125,35,1,00106,India
641568,2023-11-19,206,yakult,360,400,40,1,00100,India
484214,2023-11-19,206,yakult,360,400,40,1,00089,India
484214,2023-11-19,205,classic yogurt,45,60,15,1,00089,India
300219,2023-11-19,202,milk,12,27,15,1,00073,India
300219,2023-11-19,208,sprite,75,100,25,1,00073,India
300219,2023-11-19,209,pepsi,75,100,25,1,00073,India
300219,2023-11-19,210,mountain dew,75,100,25,1,00073,India
300219,2023-11-19,206,yakult,360,400,40,1,00073,India
107105,2023-11-20,213,bisleri,6,15,9,1,00437,India
107105,2023-11-20,207,coca cola,75,100,25,1,00437,India
107105,2023-11-20,210,mountain dew,75,100,25,1,00437,India
258699,2023-11-20,201,paneer,210,340,130,1,00404,India
258699,2023-11-20,208,sprite,75,100,25,1,00404,India
258699,2023-11-20,206,yakult,360,400,40,1,00404,India
132489,2023-11-20,209,pepsi,75,100,25,1,00245,India
132489,2023-11-20,201,paneer,210,340,130,1,00245,India
278057,2023-11-20,202,milk,12,27,15,1,00032,India
278057,2023-11-20,204,strawberry yogurt,50,60,10,1,00032,India
278057,2023-11-20,213,bisleri,6,15,9,1,00032,India
186658,2023-11-20,201,paneer,210,340,130,1,00292,India
186658,2023-11-20,211,red bull,90,125,35,1,00292,India
186658,2023-11-20,210,mountain dew,75,100,25,1,00292,India
116399,2023-11-20,203,mango yogurt,50,60,10,1,00498,India
227486,2023-11-20,207,coca cola,75,100,25,1,00467,India
227486,2023-11-20,205,classic yogurt,45,60,15,1,00467,India
227486,2023-11-20,202,milk,12,27,15,1,00467,India
151313,2023-11-20,203,mango yogurt,50,60,10,1,00489,India
151313,2023-11-20,201,paneer,210,340,130,1,00489,India
243659,2023-11-20,210,mountain dew,75,100,25,1,00405,India
243659,2023-11-20,205,classic yogurt,45,60,15,1,00405,India
830508,2023-11-20,210,mountain dew,75,100,25,1,00493,India
830508,2023-11-20,201,paneer,210,340,130,1,00493,India
830508,2023-11-20,205,classic yogurt,45,60,15,1,00493,India
810871,2023-11-20,206,yakult,360,400,40,1,00247,India
810871,2023-11-20,203,mango yogurt,50,60,10,1,00247,India
810871,2023-11-20,213,bisleri,6,15,9,1,00247,India
810871,2023-11-20,211,red bull,90,125,35,1,00247,India
730386,2023-11-20,207,coca cola,75,100,25,1,00424,India
730386,2023-11-20,204,strawberry yogurt,50,60,10,1,00424,India
730386,2023-11-20,209,pepsi,75,100,25,1,00424,India
730386,2023-11-20,206,yakult,360,400,40,1,00424,India
828044,2023-11-20,203,mango yogurt,50,60,10,1,00492,India
828044,2023-11-20,207,coca cola,75,100,25,1,00492,India
602069,2023-11-20,203,mango yogurt,50,60,10,1,00029,India
391919,2023-11-20,210,mountain dew,75,100,25,1,00484,India
391919,2023-11-20,208,sprite,75,100,25,1,00484,India
391919,2023-11-20,209,pepsi,75,100,25,1,00484,India
759717,2023-11-20,209,pepsi,75,100,25,1,00491,India
759717,2023-11-20,213,bisleri,6,15,9,1,00491,India
759717,2023-11-20,210,mountain dew,75,100,25,1,00491,India
759717,2023-11-20,211,red bull,90,125,35,1,00491,India
547088,2023-11-20,201,paneer,210,340,130,1,00379,India
547088,2023-11-20,206,yakult,360,400,40,1,00379,India
401026,2023-11-20,205,classic yogurt,45,60,15,1,00014,India
349390,2023-11-20,209,pepsi,75,100,25,1,00456,India
349390,2023-11-20,213,bisleri,6,15,9,1,00456,India
349390,2023-11-20,201,paneer,210,340,130,1,00456,India
637994,2023-11-20,212,amul cheese,250,315,65,1,00333,India
637994,2023-11-20,207,coca cola,75,100,25,1,00333,India
637994,2023-11-20,210,mountain dew,75,100,25,1,00333,India
637994,2023-11-20,206,yakult,360,400,40,1,00333,India
930842,2023-11-20,207,coca cola,75,100,25,1,00257,India
930842,2023-11-20,202,milk,12,27,15,1,00257,India
930842,2023-11-20,210,mountain dew,75,100,25,1,00257,India
211553,2023-11-20,204,strawberry yogurt,50,60,10,1,00225,India
211553,2023-11-20,206,yakult,360,400,40,1,00225,India
211553,2023-11-20,205,classic yogurt,45,60,15,1,00225,India
211553,2023-11-20,211,red bull,90,125,35,1,00225,India
168106,2023-11-20,208,sprite,75,100,25,1,00247,India
168106,2023-11-20,209,pepsi,75,100,25,1,00247,India
168106,2023-11-20,201,paneer,210,340,130,1,00247,India
536106,2023-11-20,212,amul cheese,250,315,65,1,00379,India
536106,2023-11-20,202,milk,12,27,15,1,00379,India
536106,2023-11-20,201,paneer,210,340,130,1,00379,India
536106,2023-11-20,203,mango yogurt,50,60,10,1,00379,India
536106,2023-11-20,209,pepsi,75,100,25,1,00379,India
528117,2023-11-20,202,milk,12,27,15,1,00284,India
528117,2023-11-20,210,mountain dew,75,100,25,1,00284,India
528117,2023-11-20,208,sprite,75,100,25,1,00284,India
528117,2023-11-20,207,coca cola,75,100,25,1,00284,India
926322,2023-11-20,210,mountain dew,75,100,25,1,00393,India
926322,2023-11-20,203,mango yogurt,50,60,10,1,00393,India
926322,2023-11-20,201,paneer,210,340,130,1,00393,India
926322,2023-11-20,212,amul cheese,250,315,65,1,00393,India
926322,2023-11-20,213,bisleri,6,15,9,1,00393,India
294289,2023-11-20,211,red bull,90,125,35,1,00321,India
294289,2023-11-20,204,strawberry yogurt,50,60,10,1,00321,India
294289,2023-11-20,205,classic yogurt,45,60,15,1,00321,India
719797,2023-11-20,208,sprite,75,100,25,1,00179,India
719797,2023-11-20,213,bisleri,6,15,9,1,00179,India
719797,2023-11-20,206,yakult,360,400,40,1,00179,India
719797,2023-11-20,212,amul cheese,250,315,65,1,00179,India
120469,2023-11-20,204,strawberry yogurt,50,60,10,1,00489,India
120469,2023-11-20,207,coca cola,75,100,25,1,00489,India
895169,2023-11-20,201,paneer,210,340,130,1,00316,India
632656,2023-11-20,208,sprite,75,100,25,1,00332,India
632656,2023-11-20,210,mountain dew,75,100,25,1,00332,India
632656,2023-11-20,213,bisleri,6,15,9,1,00332,India
163552,2023-11-20,204,strawberry yogurt,50,60,10,1,00324,India
163552,2023-11-20,209,pepsi,75,100,25,1,00324,India
163552,2023-11-20,206,yakult,360,400,40,1,00324,India
448973,2023-11-20,213,bisleri,6,15,9,1,00072,India
448973,2023-11-20,210,mountain dew,75,100,25,1,00072,India
244796,2023-11-20,210,mountain dew,75,100,25,1,00369,India
244796,2023-11-20,203,mango yogurt,50,60,10,1,00369,India
848809,2023-11-20,206,yakult,360,400,40,1,00075,India
848809,2023-11-20,203,mango yogurt,50,60,10,1,00075,India
848809,2023-11-20,213,bisleri,6,15,9,1,00075,India
848809,2023-11-20,202,milk,12,27,15,1,00075,India
140444,2023-11-20,209,pepsi,75,100,25,1,00311,India
140444,2023-11-20,208,sprite,75,100,25,1,00311,India
140444,2023-11-20,204,strawberry yogurt,50,60,10,1,00311,India
140444,2023-11-20,203,mango yogurt,50,60,10,1,00311,India
728538,2023-11-20,211,red bull,90,125,35,1,00170,India
568871,2023-11-20,213,bisleri,6,15,9,1,00114,India
568871,2023-11-20,207,coca cola,75,100,25,1,00114,India
568871,2023-11-20,202,milk,12,27,15,1,00114,India
764215,2023-11-20,201,paneer,210,340,130,1,00208,India
764215,2023-11-20,206,yakult,360,400,40,1,00208,India
764215,2023-11-20,212,amul cheese,250,315,65,1,00208,India
605850,2023-11-20,202,milk,12,27,15,1,00088,India
605850,2023-11-20,205,classic yogurt,45,60,15,1,00088,India
605850,2023-11-20,213,bisleri,6,15,9,1,00088,India
605850,2023-11-20,209,pepsi,75,100,25,1,00088,India
901143,2023-11-20,202,milk,12,27,15,1,00092,India
901143,2023-11-20,212,amul cheese,250,315,65,1,00092,India
901143,2023-11-20,206,yakult,360,400,40,1,00092,India
901143,2023-11-20,208,sprite,75,100,25,1,00092,India
718049,2023-11-20,208,sprite,75,100,25,1,00466,India
718049,2023-11-20,207,coca cola,75,100,25,1,00466,India
718049,2023-11-20,205,classic yogurt,45,60,15,1,00466,India
277624,2023-11-20,212,amul cheese,250,315,65,1,00381,India
277624,2023-11-20,207,coca cola,75,100,25,1,00381,India
277624,2023-11-20,206,yakult,360,400,40,1,00381,India
584159,2023-11-20,210,mountain dew,75,100,25,1,00048,India
584159,2023-11-20,206,yakult,360,400,40,1,00048,India
921720,2023-11-20,202,milk,12,27,15,1,00401,India
300793,2023-11-20,210,mountain dew,75,100,25,1,00185,India
300793,2023-11-20,201,paneer,210,340,130,1,00185,India
105759,2023-11-20,203,mango yogurt,50,60,10,1,00447,India
142283,2023-11-20,212,amul cheese,250,315,65,1,00320,India
142283,2023-11-20,204,strawberry yogurt,50,60,10,1,00320,India
142283,2023-11-20,201,paneer,210,340,130,1,00320,India
142283,2023-11-20,203,mango yogurt,50,60,10,1,00320,India
625262,2023-11-20,203,mango yogurt,50,60,10,1,00019,India
625262,2023-11-20,209,pepsi,75,100,25,1,00019,India
625262,2023-11-20,205,classic yogurt,45,60,15,1,00019,India
625262,2023-11-20,212,amul cheese,250,315,65,1,00019,India
262767,2023-11-20,202,milk,12,27,15,1,00390,India
500785,2023-11-20,209,pepsi,75,100,25,1,00301,India
500785,2023-11-20,204,strawberry yogurt,50,60,10,1,00301,India
396368,2023-11-20,205,classic yogurt,45,60,15,1,00055,India
396368,2023-11-20,213,bisleri,6,15,9,1,00055,India
396368,2023-11-20,202,milk,12,27,15,1,00055,India
199397,2023-11-20,210,mountain dew,75,100,25,1,00095,India
160214,2023-11-20,210,mountain dew,75,100,25,1,00333,India
160214,2023-11-20,206,yakult,360,400,40,1,00333,India
160214,2023-11-20,201,paneer,210,340,130,1,00333,India
836831,2023-11-20,201,paneer,210,340,130,1,00001,India
836831,2023-11-20,210,mountain dew,75,100,25,1,00001,India
836831,2023-11-20,209,pepsi,75,100,25,1,00001,India
836831,2023-11-20,206,yakult,360,400,40,1,00001,India
649769,2023-11-20,213,bisleri,6,15,9,1,00025,India
213665,2023-11-20,206,yakult,360,400,40,1,00372,India
301374,2023-11-20,210,mountain dew,75,100,25,1,00043,India
213387,2023-11-20,203,mango yogurt,50,60,10,1,00211,India
213387,2023-11-20,202,milk,12,27,15,1,00211,India
785989,2023-11-20,203,mango yogurt,50,60,10,1,00376,India
141829,2023-11-20,203,mango yogurt,50,60,10,1,00290,India
843424,2023-11-20,206,yakult,360,400,40,1,00040,India
843424,2023-11-20,211,red bull,90,125,35,1,00040,India
843424,2023-11-20,201,paneer,210,340,130,1,00040,India
843424,2023-11-20,210,mountain dew,75,100,25,1,00040,India
314009,2023-11-20,213,bisleri,6,15,9,1,00461,India
314009,2023-11-20,212,amul cheese,250,315,65,1,00461,India
314009,2023-11-20,202,milk,12,27,15,1,00461,India
189086,2023-11-20,206,yakult,360,400,40,1,00232,India
189086,2023-11-20,208,sprite,75,100,25,1,00232,India
189086,2023-11-20,213,bisleri,6,15,9,1,00232,India
189086,2023-11-20,204,strawberry yogurt,50,60,10,1,00232,India
190331,2023-11-20,209,pepsi,75,100,25,1,00081,India
190331,2023-11-20,204,strawberry yogurt,50,60,10,1,00081,India
190331,2023-11-20,213,bisleri,6,15,9,1,00081,India
190331,2023-11-20,205,classic yogurt,45,60,15,1,00081,India
287915,2023-11-20,207,coca cola,75,100,25,1,00494,India
287915,2023-11-20,213,bisleri,6,15,9,1,00494,India
287915,2023-11-20,209,pepsi,75,100,25,1,00494,India
813679,2023-11-20,212,amul cheese,250,315,65,1,00104,India
813679,2023-11-20,207,coca cola,75,100,25,1,00104,India
813679,2023-11-20,205,classic yogurt,45,60,15,1,00104,India
745996,2023-11-20,213,bisleri,6,15,9,1,00486,India
745996,2023-11-20,212,amul cheese,250,315,65,1,00486,India
745996,2023-11-20,211,red bull,90,125,35,1,00486,India
203963,2023-11-20,211,red bull,90,125,35,1,00165,India
203963,2023-11-20,207,coca cola,75,100,25,1,00165,India
203963,2023-11-20,212,amul cheese,250,315,65,1,00165,India
203963,2023-11-20,206,yakult,360,400,40,1,00165,India
860271,2023-11-20,212,amul cheese,250,315,65,1,00185,India
860271,2023-11-20,205,classic yogurt,45,60,15,1,00185,India
860271,2023-11-20,211,red bull,90,125,35,1,00185,India
570085,2023-11-20,205,classic yogurt,45,60,15,1,00192,India
570085,2023-11-20,209,pepsi,75,100,25,1,00192,India
570085,2023-11-20,206,yakult,360,400,40,1,00192,India
570085,2023-11-20,208,sprite,75,100,25,1,00192,India
628694,2023-11-20,205,classic yogurt,45,60,15,1,00383,India
628694,2023-11-20,208,sprite,75,100,25,1,00383,India
725532,2023-11-20,211,red bull,90,125,35,1,00447,India
147838,2023-11-20,211,red bull,90,125,35,1,00065,India
147838,2023-11-20,206,yakult,360,400,40,1,00065,India
404733,2023-11-20,209,pepsi,75,100,25,1,00027,India
404733,2023-11-20,212,amul cheese,250,315,65,1,00027,India
404733,2023-11-20,205,classic yogurt,45,60,15,1,00027,India
404733,2023-11-20,201,paneer,210,340,130,1,00027,India
164098,2023-11-20,208,sprite,75,100,25,1,00042,India
164098,2023-11-20,202,milk,12,27,15,1,00042,India
164098,2023-11-20,209,pepsi,75,100,25,1,00042,India
164098,2023-11-20,201,paneer,210,340,130,1,00042,India
857877,2023-11-21,205,classic yogurt,45,60,15,1,00410,India
239274,2023-11-21,213,bisleri,6,15,9,1,00155,India
239274,2023-11-21,202,milk,12,27,15,1,00155,India
239274,2023-11-21,201,paneer,210,340,130,1,00155,India
239274,2023-11-21,205,classic yogurt,45,60,15,1,00155,India
206616,2023-11-21,210,mountain dew,75,100,25,1,00109,India
949992,2023-11-21,211,red bull,90,125,35,1,00432,India
949992,2023-11-21,210,mountain dew,75,100,25,1,00432,India
949992,2023-11-21,213,bisleri,6,15,9,1,00432,India
150656,2023-11-21,208,sprite,75,100,25,1,00208,India
743259,2023-11-21,205,classic yogurt,45,60,15,1,00318,India
743259,2023-11-21,208,sprite,75,100,25,1,00318,India
743259,2023-11-21,211,red bull,90,125,35,1,00318,India
743259,2023-11-21,213,bisleri,6,15,9,1,00318,India
438133,2023-11-21,203,mango yogurt,50,60,10,1,00131,India
438133,2023-11-21,204,strawberry yogurt,50,60,10,1,00131,India
803866,2023-11-21,208,sprite,75,100,25,1,00111,India
342878,2023-11-21,210,mountain dew,75,100,25,1,00338,India
342878,2023-11-21,207,coca cola,75,100,25,1,00338,India
564143,2023-11-21,201,paneer,210,340,130,1,00022,India
564143,2023-11-21,206,yakult,360,400,40,1,00022,India
864529,2023-11-21,203,mango yogurt,50,60,10,1,00376,India
864529,2023-11-21,211,red bull,90,125,35,1,00376,India
864529,2023-11-21,204,strawberry yogurt,50,60,10,1,00376,India
864529,2023-11-21,213,bisleri,6,15,9,1,00376,India
864529,2023-11-21,206,yakult,360,400,40,1,00376,India
333058,2023-11-21,206,yakult,360,400,40,1,00070,India
904123,2023-11-21,212,amul cheese,250,315,65,1,00270,India
904123,2023-11-21,211,red bull,90,125,35,1,00270,India
904123,2023-11-21,209,pepsi,75,100,25,1,00270,India
904123,2023-11-21,210,mountain dew,75,100,25,1,00270,India
769090,2023-11-21,202,milk,12,27,15,1,00466,India
769090,2023-11-21,206,yakult,360,400,40,1,00466,India
937859,2023-11-21,202,milk,12,27,15,1,00121,India
937859,2023-11-21,203,mango yogurt,50,60,10,1,00121,India
937859,2023-11-21,210,mountain dew,75,100,25,1,00121,India
789959,2023-11-21,204,strawberry yogurt,50,60,10,1,00446,India
789959,2023-11-21,207,coca cola,75,100,25,1,00446,India
789959,2023-11-21,213,bisleri,6,15,9,1,00446,India
827517,2023-11-21,211,red bull,90,125,35,1,00466,India
827517,2023-11-21,201,paneer,210,340,130,1,00466,India
827517,2023-11-21,203,mango yogurt,50,60,10,1,00466,India
206585,2023-11-21,208,sprite,75,100,25,1,00314,India
206585,2023-11-21,207,coca cola,75,100,25,1,00314,India
474911,2023-11-21,202,milk,12,27,15,1,00161,India
474911,2023-11-21,201,paneer,210,340,130,1,00161,India
474911,2023-11-21,203,mango yogurt,50,60,10,1,00161,India
576352,2023-11-21,210,mountain dew,75,100,25,1,00107,India
576352,2023-11-21,209,pepsi,75,100,25,1,00107,India
576352,2023-11-21,207,coca cola,75,100,25,1,00107,India
689976,2023-11-21,210,mountain dew,75,100,25,1,00473,India
689976,2023-11-21,208,sprite,75,100,25,1,00473,India
689976,2023-11-21,213,bisleri,6,15,9,1,00473,India
255893,2023-11-21,202,milk,12,27,15,1,00084,India
774832,2023-11-21,203,mango yogurt,50,60,10,1,00225,India
774832,2023-11-21,212,amul cheese,250,315,65,1,00225,India
774832,2023-11-21,207,coca cola,75,100,25,1,00225,India
316997,2023-11-21,212,amul cheese,250,315,65,1,00080,India
851042,2023-11-21,211,red bull,90,125,35,1,00271,India
851042,2023-11-21,209,pepsi,75,100,25,1,00271,India
647506,2023-11-21,212,amul cheese,250,315,65,1,00255,India
257861,2023-11-21,208,sprite,75,100,25,1,00153,India
257861,2023-11-21,206,yakult,360,400,40,1,00153,India
257861,2023-11-21,212,amul cheese,250,315,65,1,00153,India
803693,2023-11-21,203,mango yogurt,50,60,10,1,00328,India
803693,2023-11-21,206,yakult,360,400,40,1,00328,India
803693,2023-11-21,201,paneer,210,340,130,1,00328,India
803693,2023-11-21,209,pepsi,75,100,25,1,00328,India
821977,2023-11-21,202,milk,12,27,15,1,00156,India
821977,2023-11-21,208,sprite,75,100,25,1,00156,India
124257,2023-11-21,212,amul cheese,250,315,65,1,00225,India
124257,2023-11-21,206,yakult,360,400,40,1,00225,India
823346,2023-11-21,211,red bull,90,125,35,1,00239,India
167323,2023-11-21,206,yakult,360,400,40,1,00182,India
777124,2023-11-21,207,coca cola,75,100,25,1,00098,India
777124,2023-11-21,203,mango yogurt,50,60,10,1,00098,India
777124,2023-11-21,211,red bull,90,125,35,1,00098,India
777124,2023-11-21,204,strawberry yogurt,50,60,10,1,00098,India
777124,2023-11-21,205,classic yogurt,45,60,15,1,00098,India
114243,2023-11-21,205,classic yogurt,45,60,15,1,00229,India
781283,2023-11-21,203,mango yogurt,50,60,10,1,00325,India
781283,2023-11-21,212,amul cheese,250,315,65,1,00325,India
781283,2023-11-21,204,strawberry yogurt,50,60,10,1,00325,India
268843,2023-11-21,202,milk,12,27,15,1,00408,India
205268,2023-11-21,202,milk,12,27,15,1,00436,India
205268,2023-11-21,206,yakult,360,400,40,1,00436,India
205268,2023-11-21,201,paneer,210,340,130,1,00436,India
205268,2023-11-21,203,mango yogurt,50,60,10,1,00436,India
333622,2023-11-21,206,yakult,360,400,40,1,00464,India
333622,2023-11-21,211,red bull,90,125,35,1,00464,India
333622,2023-11-21,204,strawberry yogurt,50,60,10,1,00464,India
252196,2023-11-21,213,bisleri,6,15,9,1,00484,India
252196,2023-11-21,210,mountain dew,75,100,25,1,00484,India
875345,2023-11-21,202,milk,12,27,15,1,00077,India
875345,2023-11-21,203,mango yogurt,50,60,10,1,00077,India
254502,2023-11-21,209,pepsi,75,100,25,1,00084,India
102518,2023-11-21,204,strawberry yogurt,50,60,10,1,00475,India
102518,2023-11-21,213,bisleri,6,15,9,1,00475,India
269893,2023-11-21,211,red bull,90,125,35,1,00290,India
269893,2023-11-21,201,paneer,210,340,130,1,00290,India
269893,2023-11-21,213,bisleri,6,15,9,1,00290,India
269893,2023-11-21,204,strawberry yogurt,50,60,10,1,00290,India
269893,2023-11-21,209,pepsi,75,100,25,1,00290,India
346468,2023-11-21,201,paneer,210,340,130,1,00092,India
346468,2023-11-21,212,amul cheese,250,315,65,1,00092,India
346468,2023-11-21,211,red bull,90,125,35,1,00092,India
844334,2023-11-21,203,mango yogurt,50,60,10,1,00408,India
506927,2023-11-21,207,coca cola,75,100,25,1,00202,India
506927,2023-11-21,213,bisleri,6,15,9,1,00202,India
506927,2023-11-21,212,amul cheese,250,315,65,1,00202,India
506927,2023-11-21,201,paneer,210,340,130,1,00202,India
284161,2023-11-21,205,classic yogurt,45,60,15,1,00239,India
284161,2023-11-21,204,strawberry yogurt,50,60,10,1,00239,India
915326,2023-11-21,213,bisleri,6,15,9,1,00457,India
915326,2023-11-21,210,mountain dew,75,100,25,1,00457,India
915326,2023-11-21,201,paneer,210,340,130,1,00457,India
915326,2023-11-21,207,coca cola,75,100,25,1,00457,India
814495,2023-11-21,202,milk,12,27,15,1,00193,India
814495,2023-11-21,210,mountain dew,75,100,25,1,00193,India
142720,2023-11-21,209,pepsi,75,100,25,1,00218,India
142720,2023-11-21,210,mountain dew,75,100,25,1,00218,India
562598,2023-11-21,213,bisleri,6,15,9,1,00403,India
562598,2023-11-21,212,amul cheese,250,315,65,1,00403,India
255185,2023-11-21,203,mango yogurt,50,60,10,1,00332,India
255185,2023-11-21,207,coca cola,75,100,25,1,00332,India
906069,2023-11-21,208,sprite,75,100,25,1,00468,India
906069,2023-11-21,212,amul cheese,250,315,65,1,00468,India
906069,2023-11-21,210,mountain dew,75,100,25,1,00468,India
318886,2023-11-21,213,bisleri,6,15,9,1,00204,India
318886,2023-11-21,204,strawberry yogurt,50,60,10,1,00204,India
738992,2023-11-21,213,bisleri,6,15,9,1,00437,India
738992,2023-11-21,201,paneer,210,340,130,1,00437,India
738992,2023-11-21,208,sprite,75,100,25,1,00437,India
738992,2023-11-21,203,mango yogurt,50,60,10,1,00437,India
805036,2023-11-21,213,bisleri,6,15,9,1,00385,India
376454,2023-11-21,202,milk,12,27,15,1,00067,India
391413,2023-11-21,208,sprite,75,100,25,1,00178,India
391413,2023-11-21,201,paneer,210,340,130,1,00178,India
391413,2023-11-21,211,red bull,90,125,35,1,00178,India
872988,2023-11-21,201,paneer,210,340,130,1,00441,India
872988,2023-11-21,212,amul cheese,250,315,65,1,00441,India
705980,2023-11-21,204,strawberry yogurt,50,60,10,1,00246,India
705980,2023-11-21,201,paneer,210,340,130,1,00246,India
555023,2023-11-21,203,mango yogurt,50,60,10,1,00207,India
555023,2023-11-21,206,yakult,360,400,40,1,00207,India
546248,2023-11-21,210,mountain dew,75,100,25,1,00123,India
546248,2023-11-21,203,mango yogurt,50,60,10,1,00123,India
546248,2023-11-21,211,red bull,90,125,35,1,00123,India
929545,2023-11-21,202,milk,12,27,15,1,00324,India
929545,2023-11-21,201,paneer,210,340,130,1,00324,India
929545,2023-11-21,210,mountain dew,75,100,25,1,00324,India
367041,2023-11-21,201,paneer,210,340,130,1,00057,India
367041,2023-11-21,208,sprite,75,100,25,1,00057,India
367041,2023-11-21,211,red bull,90,125,35,1,00057,India
367041,2023-11-21,202,milk,12,27,15,1,00057,India
625561,2023-11-21,202,milk,12,27,15,1,00433,India
625561,2023-11-21,211,red bull,90,125,35,1,00433,India
625561,2023-11-21,204,strawberry yogurt,50,60,10,1,00433,India
306337,2023-11-21,204,strawberry yogurt,50,60,10,1,00483,India
306337,2023-11-21,211,red bull,90,125,35,1,00483,India
815776,2023-11-21,208,sprite,75,100,25,1,00490,India
815776,2023-11-21,207,coca cola,75,100,25,1,00490,India
815776,2023-11-21,209,pepsi,75,100,25,1,00490,India
942942,2023-11-21,202,milk,12,27,15,1,00287,India
942942,2023-11-21,208,sprite,75,100,25,1,00287,India
942942,2023-11-21,205,classic yogurt,45,60,15,1,00287,India
641304,2023-11-21,207,coca cola,75,100,25,1,00282,India
446082,2023-11-21,201,paneer,210,340,130,1,00173,India
446082,2023-11-21,205,classic yogurt,45,60,15,1,00173,India
446082,2023-11-21,212,amul cheese,250,315,65,1,00173,India
446082,2023-11-21,209,pepsi,75,100,25,1,00173,India
970646,2023-11-21,202,milk,12,27,15,1,00301,India
970646,2023-11-21,205,classic yogurt,45,60,15,1,00301,India
677575,2023-11-21,206,yakult,360,400,40,1,00350,India
677575,2023-11-21,208,sprite,75,100,25,1,00350,India
677575,2023-11-21,204,strawberry yogurt,50,60,10,1,00350,India
677575,2023-11-21,209,pepsi,75,100,25,1,00350,India
846351,2023-11-21,205,classic yogurt,45,60,15,1,00433,India
846351,2023-11-21,203,mango yogurt,50,60,10,1,00433,India
846351,2023-11-21,210,mountain dew,75,100,25,1,00433,India
499276,2023-11-21,212,amul cheese,250,315,65,1,00375,India
926121,2023-11-21,211,red bull,90,125,35,1,00250,India
136939,2023-11-21,207,coca cola,75,100,25,1,00443,India
127134,2023-11-21,211,red bull,90,125,35,1,00243,India
127134,2023-11-21,202,milk,12,27,15,1,00243,India
127134,2023-11-21,205,classic yogurt,45,60,15,1,00243,India
867810,2023-11-21,206,yakult,360,400,40,1,00301,India
867810,2023-11-21,212,amul cheese,250,315,65,1,00301,India
866880,2023-11-21,204,strawberry yogurt,50,60,10,1,00279,India
866880,2023-11-21,210,mountain dew,75,100,25,1,00279,India
908306,2023-11-21,204,strawberry yogurt,50,60,10,1,00245,India
908306,2023-11-21,213,bisleri,6,15,9,1,00245,India
908306,2023-11-21,206,yakult,360,400,40,1,00245,India
908306,2023-11-21,210,mountain dew,75,100,25,1,00245,India
454972,2023-11-21,205,classic yogurt,45,60,15,1,00244,India
111604,2023-11-21,209,pepsi,75,100,25,1,00343,India
111604,2023-11-21,208,sprite,75,100,25,1,00343,India
894815,2023-11-21,208,sprite,75,100,25,1,00307,India
894815,2023-11-21,202,milk,12,27,15,1,00307,India
894815,2023-11-21,212,amul cheese,250,315,65,1,00307,India
894815,2023-11-21,203,mango yogurt,50,60,10,1,00307,India
894815,2023-11-21,205,classic yogurt,45,60,15,1,00307,India
275739,2023-11-21,211,red bull,90,125,35,1,00426,India
275739,2023-11-21,212,amul cheese,250,315,65,1,00426,India
275739,2023-11-21,208,sprite,75,100,25,1,00426,India
275739,2023-11-21,203,mango yogurt,50,60,10,1,00426,India
964110,2023-11-21,212,amul cheese,250,315,65,1,00205,India
350866,2023-11-21,207,coca cola,75,100,25,1,00315,India
350866,2023-11-21,206,yakult,360,400,40,1,00315,India
350866,2023-11-21,205,classic yogurt,45,60,15,1,00315,India
350866,2023-11-21,208,sprite,75,100,25,1,00315,India
350866,2023-11-21,203,mango yogurt,50,60,10,1,00315,India
297532,2023-11-21,212,amul cheese,250,315,65,1,00304,India
297532,2023-11-21,209,pepsi,75,100,25,1,00304,India
297532,2023-11-21,202,milk,12,27,15,1,00304,India
195349,2023-11-21,208,sprite,75,100,25,1,00451,India
195349,2023-11-21,205,classic yogurt,45,60,15,1,00451,India
195349,2023-11-21,203,mango yogurt,50,60,10,1,00451,India
549310,2023-11-21,202,milk,12,27,15,1,00403,India
549310,2023-11-21,209,pepsi,75,100,25,1,00403,India
719488,2023-11-21,206,yakult,360,400,40,1,00112,India
719488,2023-11-21,213,bisleri,6,15,9,1,00112,India
931477,2023-11-21,208,sprite,75,100,25,1,00071,India
334933,2023-11-21,212,amul cheese,250,315,65,1,00227,India
334933,2023-11-21,206,yakult,360,400,40,1,00227,India
671685,2023-11-21,203,mango yogurt,50,60,10,1,00297,India
671685,2023-11-21,210,mountain dew,75,100,25,1,00297,India
876382,2023-11-21,201,paneer,210,340,130,1,00001,India
876382,2023-11-21,212,amul cheese,250,315,65,1,00001,India
791334,2023-11-21,205,classic yogurt,45,60,15,1,00324,India
791334,2023-11-21,213,bisleri,6,15,9,1,00324,India
791334,2023-11-21,201,paneer,210,340,130,1,00324,India
805858,2023-11-21,203,mango yogurt,50,60,10,1,00340,India
805858,2023-11-21,210,mountain dew,75,100,25,1,00340,India
805858,2023-11-21,204,strawberry yogurt,50,60,10,1,00340,India
388044,2023-11-21,209,pepsi,75,100,25,1,00066,India
388044,2023-11-21,206,yakult,360,400,40,1,00066,India
388044,2023-11-21,202,milk,12,27,15,1,00066,India
557310,2023-11-21,212,amul cheese,250,315,65,1,00292,India
557310,2023-11-21,205,classic yogurt,45,60,15,1,00292,India
557310,2023-11-21,207,coca cola,75,100,25,1,00292,India
123905,2023-11-22,213,bisleri,6,15,9,1,00282,India
123905,2023-11-22,209,pepsi,75,100,25,1,00282,India
123905,2023-11-22,208,sprite,75,100,25,1,00282,India
123905,2023-11-22,210,mountain dew,75,100,25,1,00282,India
954498,2023-11-22,205,classic yogurt,45,60,15,1,00020,India
954498,2023-11-22,202,milk,12,27,15,1,00020,India
954498,2023-11-22,213,bisleri,6,15,9,1,00020,India
954498,2023-11-22,201,paneer,210,340,130,1,00020,India
716072,2023-11-22,213,bisleri,6,15,9,1,00190,India
716072,2023-11-22,205,classic yogurt,45,60,15,1,00190,India
716072,2023-11-22,204,strawberry yogurt,50,60,10,1,00190,India
716072,2023-11-22,212,amul cheese,250,315,65,1,00190,India
716072,2023-11-22,206,yakult,360,400,40,1,00190,India
951852,2023-11-22,213,bisleri,6,15,9,1,00478,India
603349,2023-11-22,208,sprite,75,100,25,1,00111,India
603349,2023-11-22,210,mountain dew,75,100,25,1,00111,India
603349,2023-11-22,203,mango yogurt,50,60,10,1,00111,India
603349,2023-11-22,209,pepsi,75,100,25,1,00111,India
673098,2023-11-22,204,strawberry yogurt,50,60,10,1,00158,India
673098,2023-11-22,211,red bull,90,125,35,1,00158,India
673098,2023-11-22,209,pepsi,75,100,25,1,00158,India
155065,2023-11-22,207,coca cola,75,100,25,1,00079,India
155065,2023-11-22,206,yakult,360,400,40,1,00079,India
155065,2023-11-22,210,mountain dew,75,100,25,1,00079,India
161922,2023-11-22,204,strawberry yogurt,50,60,10,1,00490,India
161922,2023-11-22,201,paneer,210,340,130,1,00490,India
586340,2023-11-22,202,milk,12,27,15,1,00336,India
586340,2023-11-22,201,paneer,210,340,130,1,00336,India
518573,2023-11-22,213,bisleri,6,15,9,1,00147,India
518573,2023-11-22,210,mountain dew,75,100,25,1,00147,India
518573,2023-11-22,203,mango yogurt,50,60,10,1,00147,India
518573,2023-11-22,204,strawberry yogurt,50,60,10,1,00147,India
518573,2023-11-22,201,paneer,210,340,130,1,00147,India
159786,2023-11-22,207,coca cola,75,100,25,1,00474,India
159786,2023-11-22,205,classic yogurt,45,60,15,1,00474,India
159786,2023-11-22,204,strawberry yogurt,50,60,10,1,00474,India
480379,2023-11-22,209,pepsi,75,100,25,1,00116,India
480379,2023-11-22,210,mountain dew,75,100,25,1,00116,India
480379,2023-11-22,207,coca cola,75,100,25,1,00116,India
701828,2023-11-22,207,coca cola,75,100,25,1,00045,India
701828,2023-11-22,205,classic yogurt,45,60,15,1,00045,India
701828,2023-11-22,213,bisleri,6,15,9,1,00045,India
701828,2023-11-22,212,amul cheese,250,315,65,1,00045,India
356253,2023-11-22,204,strawberry yogurt,50,60,10,1,00040,India
356253,2023-11-22,210,mountain dew,75,100,25,1,00040,India
421582,2023-11-22,201,paneer,210,340,130,1,00017,India
421582,2023-11-22,208,sprite,75,100,25,1,00017,India
421582,2023-11-22,204,strawberry yogurt,50,60,10,1,00017,India
421582,2023-11-22,206,yakult,360,400,40,1,00017,India
489925,2023-11-22,213,bisleri,6,15,9,1,00198,India
489925,2023-11-22,205,classic yogurt,45,60,15,1,00198,India
128489,2023-11-22,201,paneer,210,340,130,1,00285,India
128489,2023-11-22,213,bisleri,6,15,9,1,00285,India
248531,2023-11-22,206,yakult,360,400,40,1,00184,India
248531,2023-11-22,202,milk,12,27,15,1,00184,India
248531,2023-11-22,210,mountain dew,75,100,25,1,00184,India
248531,2023-11-22,212,amul cheese,250,315,65,1,00184,India
218175,2023-11-22,201,paneer,210,340,130,1,00423,India
218175,2023-11-22,202,milk,12,27,15,1,00423,India
178023,2023-11-22,211,red bull,90,125,35,1,00402,India
178023,2023-11-22,201,paneer,210,340,130,1,00402,India
178023,2023-11-22,213,bisleri,6,15,9,1,00402,India
178023,2023-11-22,206,yakult,360,400,40,1,00402,India
961566,2023-11-22,201,paneer,210,340,130,1,00313,India
961566,2023-11-22,211,red bull,90,125,35,1,00313,India
961566,2023-11-22,205,classic yogurt,45,60,15,1,00313,India
256203,2023-11-22,206,yakult,360,400,40,1,00314,India
256203,2023-11-22,205,classic yogurt,45,60,15,1,00314,India
256203,2023-11-22,210,mountain dew,75,100,25,1,00314,India
256203,2023-11-22,204,strawberry yogurt,50,60,10,1,00314,India
224983,2023-11-22,201,paneer,210,340,130,1,00052,India
224983,2023-11-22,207,coca cola,75,100,25,1,00052,India
224983,2023-11-22,208,sprite,75,100,25,1,00052,India
224983,2023-11-22,206,yakult,360,400,40,1,00052,India
224983,2023-11-22,213,bisleri,6,15,9,1,00052,India
338434,2023-11-22,210,mountain dew,75,100,25,1,00484,India
338434,2023-11-22,201,paneer,210,340,130,1,00484,India
338434,2023-11-22,206,yakult,360,400,40,1,00484,India
865000,2023-11-22,203,mango yogurt,50,60,10,1,00216,India
865000,2023-11-22,202,milk,12,27,15,1,00216,India
940674,2023-11-22,211,red bull,90,125,35,1,00301,India
238760,2023-11-22,202,milk,12,27,15,1,00500,India
238760,2023-11-22,207,coca cola,75,100,25,1,00500,India
238760,2023-11-22,210,mountain dew,75,100,25,1,00500,India
238760,2023-11-22,206,yakult,360,400,40,1,00500,India
832548,2023-11-22,213,bisleri,6,15,9,1,00188,India
832548,2023-11-22,208,sprite,75,100,25,1,00188,India
832548,2023-11-22,206,yakult,360,400,40,1,00188,India
832548,2023-11-22,211,red bull,90,125,35,1,00188,India
832548,2023-11-22,210,mountain dew,75,100,25,1,00188,India
655471,2023-11-22,211,red bull,90,125,35,1,00303,India
655471,2023-11-22,213,bisleri,6,15,9,1,00303,India
655471,2023-11-22,209,pepsi,75,100,25,1,00303,India
639095,2023-11-22,213,bisleri,6,15,9,1,00455,India
639095,2023-11-22,201,paneer,210,340,130,1,00455,India
800463,2023-11-22,203,mango yogurt,50,60,10,1,00297,India
800463,2023-11-22,210,mountain dew,75,100,25,1,00297,India
800463,2023-11-22,208,sprite,75,100,25,1,00297,India
800463,2023-11-22,201,paneer,210,340,130,1,00297,India
800463,2023-11-22,206,yakult,360,400,40,1,00297,India
530611,2023-11-22,205,classic yogurt,45,60,15,1,00036,India
530611,2023-11-22,206,yakult,360,400,40,1,00036,India
530611,2023-11-22,212,amul cheese,250,315,65,1,00036,India
917929,2023-11-22,204,strawberry yogurt,50,60,10,1,00039,India
370597,2023-11-22,208,sprite,75,100,25,1,00408,India
370597,2023-11-22,207,coca cola,75,100,25,1,00408,India
311218,2023-11-22,204,strawberry yogurt,50,60,10,1,00452,India
929182,2023-11-22,204,strawberry yogurt,50,60,10,1,00456,India
929182,2023-11-22,212,amul cheese,250,315,65,1,00456,India
514405,2023-11-22,201,paneer,210,340,130,1,00437,India
514405,2023-11-22,211,red bull,90,125,35,1,00437,India
514405,2023-11-22,203,mango yogurt,50,60,10,1,00437,India
890609,2023-11-22,209,pepsi,75,100,25,1,00102,India
890609,2023-11-22,203,mango yogurt,50,60,10,1,00102,India
890609,2023-11-22,206,yakult,360,400,40,1,00102,India
630246,2023-11-22,207,coca cola,75,100,25,1,00441,India
630246,2023-11-22,201,paneer,210,340,130,1,00441,India
630246,2023-11-22,205,classic yogurt,45,60,15,1,00441,India
112060,2023-11-22,211,red bull,90,125,35,1,00070,India
112060,2023-11-22,212,amul cheese,250,315,65,1,00070,India
112060,2023-11-22,203,mango yogurt,50,60,10,1,00070,India
112060,2023-11-22,204,strawberry yogurt,50,60,10,1,00070,India
112060,2023-11-22,205,classic yogurt,45,60,15,1,00070,India
603671,2023-11-22,206,yakult,360,400,40,1,00212,India
603671,2023-11-22,204,strawberry yogurt,50,60,10,1,00212,India
603671,2023-11-22,209,pepsi,75,100,25,1,00212,India
603671,2023-11-22,208,sprite,75,100,25,1,00212,India
603671,2023-11-22,201,paneer,210,340,130,1,00212,India
443731,2023-11-22,202,milk,12,27,15,1,00046,India
443731,2023-11-22,203,mango yogurt,50,60,10,1,00046,India
443731,2023-11-22,204,strawberry yogurt,50,60,10,1,00046,India
863709,2023-11-22,205,classic yogurt,45,60,15,1,00189,India
863709,2023-11-22,201,paneer,210,340,130,1,00189,India
863709,2023-11-22,211,red bull,90,125,35,1,00189,India
863709,2023-11-22,210,mountain dew,75,100,25,1,00189,India
863709,2023-11-22,203,mango yogurt,50,60,10,1,00189,India
217703,2023-11-22,206,yakult,360,400,40,1,00432,India
371313,2023-11-22,212,amul cheese,250,315,65,1,00390,India
371313,2023-11-22,204,strawberry yogurt,50,60,10,1,00390,India
187598,2023-11-22,203,mango yogurt,50,60,10,1,00365,India
187598,2023-11-22,204,strawberry yogurt,50,60,10,1,00365,India
811689,2023-11-22,210,mountain dew,75,100,25,1,00272,India
195408,2023-11-22,212,amul cheese,250,315,65,1,00481,India
195408,2023-11-22,206,yakult,360,400,40,1,00481,India
195408,2023-11-22,201,paneer,210,340,130,1,00481,India
195408,2023-11-22,205,classic yogurt,45,60,15,1,00481,India
186417,2023-11-22,211,red bull,90,125,35,1,00383,India
186417,2023-11-22,203,mango yogurt,50,60,10,1,00383,India
186417,2023-11-22,206,yakult,360,400,40,1,00383,India
516796,2023-11-22,208,sprite,75,100,25,1,00404,India
516796,2023-11-22,206,yakult,360,400,40,1,00404,India
516796,2023-11-22,205,classic yogurt,45,60,15,1,00404,India
516796,2023-11-22,209,pepsi,75,100,25,1,00404,India
238666,2023-11-22,209,pepsi,75,100,25,1,00279,India
222000,2023-11-22,201,paneer,210,340,130,1,00498,India
222000,2023-11-22,211,red bull,90,125,35,1,00498,India
222000,2023-11-22,213,bisleri,6,15,9,1,00498,India
222000,2023-11-22,203,mango yogurt,50,60,10,1,00498,India
985110,2023-11-22,209,pepsi,75,100,25,1,00364,India
985110,2023-11-22,208,sprite,75,100,25,1,00364,India
985110,2023-11-22,212,amul cheese,250,315,65,1,00364,India
442364,2023-11-22,213,bisleri,6,15,9,1,00157,India
442364,2023-11-22,211,red bull,90,125,35,1,00157,India
228001,2023-11-22,205,classic yogurt,45,60,15,1,00058,India
228001,2023-11-22,203,mango yogurt,50,60,10,1,00058,India
228001,2023-11-22,207,coca cola,75,100,25,1,00058,India
228001,2023-11-22,213,bisleri,6,15,9,1,00058,India
228001,2023-11-22,209,pepsi,75,100,25,1,00058,India
425566,2023-11-22,202,milk,12,27,15,1,00342,India
425566,2023-11-22,210,mountain dew,75,100,25,1,00342,India
425566,2023-11-22,203,mango yogurt,50,60,10,1,00342,India
425566,2023-11-22,207,coca cola,75,100,25,1,00342,India
795290,2023-11-22,204,strawberry yogurt,50,60,10,1,00051,India
795290,2023-11-22,202,milk,12,27,15,1,00051,India
795290,2023-11-22,211,red bull,90,125,35,1,00051,India
293193,2023-11-22,206,yakult,360,400,40,1,00018,India
835630,2023-11-22,209,pepsi,75,100,25,1,00490,India
835630,2023-11-22,201,paneer,210,340,130,1,00490,India
835630,2023-11-22,212,amul cheese,250,315,65,1,00490,India
991943,2023-11-22,204,strawberry yogurt,50,60,10,1,00406,India
991943,2023-11-22,213,bisleri,6,15,9,1,00406,India
991943,2023-11-22,209,pepsi,75,100,25,1,00406,India
338645,2023-11-22,206,yakult,360,400,40,1,00500,India
338645,2023-11-22,201,paneer,210,340,130,1,00500,India
306946,2023-11-22,203,mango yogurt,50,60,10,1,00179,India
306946,2023-11-22,202,milk,12,27,15,1,00179,India
767185,2023-11-22,205,classic yogurt,45,60,15,1,00499,India
767185,2023-11-22,212,amul cheese,250,315,65,1,00499,India
767185,2023-11-22,210,mountain dew,75,100,25,1,00499,India
426331,2023-11-22,207,coca cola,75,100,25,1,00293,India
426331,2023-11-22,201,paneer,210,340,130,1,00293,India
426331,2023-11-22,202,milk,12,27,15,1,00293,India
426331,2023-11-22,209,pepsi,75,100,25,1,00293,India
426331,2023-11-22,204,strawberry yogurt,50,60,10,1,00293,India
116985,2023-11-22,206,yakult,360,400,40,1,00475,India
420991,2023-11-22,211,red bull,90,125,35,1,00414,India
420991,2023-11-22,204,strawberry yogurt,50,60,10,1,00414,India
660753,2023-11-22,203,mango yogurt,50,60,10,1,00212,India
660753,2023-11-22,204,strawberry yogurt,50,60,10,1,00212,India
522699,2023-11-22,207,coca cola,75,100,25,1,00205,India
522699,2023-11-22,206,yakult,360,400,40,1,00205,India
522699,2023-11-22,205,classic yogurt,45,60,15,1,00205,India
522699,2023-11-22,212,amul cheese,250,315,65,1,00205,India
433405,2023-11-22,203,mango yogurt,50,60,10,1,00382,India
433405,2023-11-22,211,red bull,90,125,35,1,00382,India
230698,2023-11-22,201,paneer,210,340,130,1,00445,India
230698,2023-11-22,213,bisleri,6,15,9,1,00445,India
230698,2023-11-22,211,red bull,90,125,35,1,00445,India
230698,2023-11-22,208,sprite,75,100,25,1,00445,India
230698,2023-11-22,202,milk,12,27,15,1,00445,India
574826,2023-11-22,201,paneer,210,340,130,1,00303,India
574826,2023-11-22,211,red bull,90,125,35,1,00303,India
574826,2023-11-22,204,strawberry yogurt,50,60,10,1,00303,India
101841,2023-11-22,210,mountain dew,75,100,25,1,00379,India
101841,2023-11-22,202,milk,12,27,15,1,00379,India
567552,2023-11-22,210,mountain dew,75,100,25,1,00311,India
567552,2023-11-22,209,pepsi,75,100,25,1,00311,India
567552,2023-11-22,211,red bull,90,125,35,1,00311,India
567552,2023-11-22,208,sprite,75,100,25,1,00311,India
737308,2023-11-22,207,coca cola,75,100,25,1,00258,India
737308,2023-11-22,202,milk,12,27,15,1,00258,India
563862,2023-11-22,203,mango yogurt,50,60,10,1,00148,India
563862,2023-11-22,201,paneer,210,340,130,1,00148,India
563862,2023-11-22,208,sprite,75,100,25,1,00148,India
714373,2023-11-22,213,bisleri,6,15,9,1,00159,India
714373,2023-11-22,206,yakult,360,400,40,1,00159,India
212263,2023-11-23,213,bisleri,6,15,9,1,00043,India
212263,2023-11-23,203,mango yogurt,50,60,10,1,00043,India
212263,2023-11-23,212,amul cheese,250,315,65,1,00043,India
212263,2023-11-23,207,coca cola,75,100,25,1,00043,India
673963,2023-11-23,202,milk,12,27,15,1,00375,India
232409,2023-11-23,209,pepsi,75,100,25,1,00038,India
232409,2023-11-23,204,strawberry yogurt,50,60,10,1,00038,India
232409,2023-11-23,207,coca cola,75,100,25,1,00038,India
658296,2023-11-23,206,yakult,360,400,40,1,00102,India
658296,2023-11-23,202,milk,12,27,15,1,00102,India
658296,2023-11-23,204,strawberry yogurt,50,60,10,1,00102,India
658296,2023-11-23,203,mango yogurt,50,60,10,1,00102,India
208197,2023-11-23,210,mountain dew,75,100,25,1,00112,India
202387,2023-11-23,206,yakult,360,400,40,1,00495,India
202387,2023-11-23,209,pepsi,75,100,25,1,00495,India
202387,2023-11-23,204,strawberry yogurt,50,60,10,1,00495,India
202387,2023-11-23,207,coca cola,75,100,25,1,00495,India
403882,2023-11-23,203,mango yogurt,50,60,10,1,00281,India
926694,2023-11-23,206,yakult,360,400,40,1,00471,India
926694,2023-11-23,210,mountain dew,75,100,25,1,00471,India
926694,2023-11-23,201,paneer,210,340,130,1,00471,India
926694,2023-11-23,208,sprite,75,100,25,1,00471,India
926694,2023-11-23,209,pepsi,75,100,25,1,00471,India
963741,2023-11-23,204,strawberry yogurt,50,60,10,1,00276,India
963741,2023-11-23,210,mountain dew,75,100,25,1,00276,India
963741,2023-11-23,205,classic yogurt,45,60,15,1,00276,India
963741,2023-11-23,212,amul cheese,250,315,65,1,00276,India
963741,2023-11-23,209,pepsi,75,100,25,1,00276,India
787082,2023-11-23,210,mountain dew,75,100,25,1,00288,India
787082,2023-11-23,201,paneer,210,340,130,1,00288,India
424573,2023-11-23,208,sprite,75,100,25,1,00126,India
424573,2023-11-23,206,yakult,360,400,40,1,00126,India
424573,2023-11-23,207,coca cola,75,100,25,1,00126,India
424573,2023-11-23,205,classic yogurt,45,60,15,1,00126,India
424573,2023-11-23,211,red bull,90,125,35,1,00126,India
665874,2023-11-23,206,yakult,360,400,40,1,00058,India
665874,2023-11-23,205,classic yogurt,45,60,15,1,00058,India
927340,2023-11-23,212,amul cheese,250,315,65,1,00102,India
927340,2023-11-23,213,bisleri,6,15,9,1,00102,India
927340,2023-11-23,210,mountain dew,75,100,25,1,00102,India
927340,2023-11-23,205,classic yogurt,45,60,15,1,00102,India
927340,2023-11-23,207,coca cola,75,100,25,1,00102,India
224139,2023-11-23,203,mango yogurt,50,60,10,1,00048,India
224139,2023-11-23,205,classic yogurt,45,60,15,1,00048,India
411286,2023-11-23,202,milk,12,27,15,1,00089,India
411286,2023-11-23,206,yakult,360,400,40,1,00089,India
411286,2023-11-23,210,mountain dew,75,100,25,1,00089,India
386765,2023-11-23,203,mango yogurt,50,60,10,1,00070,India
386765,2023-11-23,201,paneer,210,340,130,1,00070,India
386765,2023-11-23,212,amul cheese,250,315,65,1,00070,India
386765,2023-11-23,208,sprite,75,100,25,1,00070,India
386765,2023-11-23,206,yakult,360,400,40,1,00070,India
118445,2023-11-23,212,amul cheese,250,315,65,1,00224,India
719738,2023-11-23,201,paneer,210,340,130,1,00413,India
719738,2023-11-23,204,strawberry yogurt,50,60,10,1,00413,India
719738,2023-11-23,211,red bull,90,125,35,1,00413,India
719738,2023-11-23,213,bisleri,6,15,9,1,00413,India
900228,2023-11-23,213,bisleri,6,15,9,1,00430,India
900228,2023-11-23,209,pepsi,75,100,25,1,00430,India
900228,2023-11-23,207,coca cola,75,100,25,1,00430,India
900228,2023-11-23,204,strawberry yogurt,50,60,10,1,00430,India
678821,2023-11-23,208,sprite,75,100,25,1,00154,India
678821,2023-11-23,209,pepsi,75,100,25,1,00154,India
542087,2023-11-23,210,mountain dew,75,100,25,1,00450,India
542087,2023-11-23,204,strawberry yogurt,50,60,10,1,00450,India
542087,2023-11-23,211,red bull,90,125,35,1,00450,India
160575,2023-11-23,203,mango yogurt,50,60,10,1,00167,India
160575,2023-11-23,207,coca cola,75,100,25,1,00167,India
160575,2023-11-23,211,red bull,90,125,35,1,00167,India
564748,2023-11-23,206,yakult,360,400,40,1,00473,India
564748,2023-11-23,201,paneer,210,340,130,1,00473,India
564748,2023-11-23,207,coca cola,75,100,25,1,00473,India
564748,2023-11-23,210,mountain dew,75,100,25,1,00473,India
133061,2023-11-23,205,classic yogurt,45,60,15,1,00416,India
133061,2023-11-23,206,yakult,360,400,40,1,00416,India
133061,2023-11-23,201,paneer,210,340,130,1,00416,India
133061,2023-11-23,202,milk,12,27,15,1,00416,India
243978,2023-11-23,201,paneer,210,340,130,1,00110,India
243978,2023-11-23,210,mountain dew,75,100,25,1,00110,India
243978,2023-11-23,212,amul cheese,250,315,65,1,00110,India
609341,2023-11-23,202,milk,12,27,15,1,00192,India
609341,2023-11-23,210,mountain dew,75,100,25,1,00192,India
609341,2023-11-23,212,amul cheese,250,315,65,1,00192,India
609341,2023-11-23,208,sprite,75,100,25,1,00192,India
734891,2023-11-23,205,classic yogurt,45,60,15,1,00020,India
734891,2023-11-23,207,coca cola,75,100,25,1,00020,India
910200,2023-11-23,202,milk,12,27,15,1,00276,India
910200,2023-11-23,213,bisleri,6,15,9,1,00276,India
910200,2023-11-23,210,mountain dew,75,100,25,1,00276,India
910200,2023-11-23,209,pepsi,75,100,25,1,00276,India
910200,2023-11-23,203,mango yogurt,50,60,10,1,00276,India
991298,2023-11-23,203,mango yogurt,50,60,10,1,00348,India
991298,2023-11-23,209,pepsi,75,100,25,1,00348,India
991298,2023-11-23,212,amul cheese,250,315,65,1,00348,India
991298,2023-11-23,205,classic yogurt,45,60,15,1,00348,India
991298,2023-11-23,208,sprite,75,100,25,1,00348,India
365346,2023-11-23,205,classic yogurt,45,60,15,1,00003,India
365346,2023-11-23,211,red bull,90,125,35,1,00003,India
365346,2023-11-23,202,milk,12,27,15,1,00003,India
365346,2023-11-23,201,paneer,210,340,130,1,00003,India
431629,2023-11-23,206,yakult,360,400,40,1,00276,India
431629,2023-11-23,209,pepsi,75,100,25,1,00276,India
431629,2023-11-23,210,mountain dew,75,100,25,1,00276,India
431629,2023-11-23,205,classic yogurt,45,60,15,1,00276,India
431629,2023-11-23,202,milk,12,27,15,1,00276,India
769799,2023-11-23,210,mountain dew,75,100,25,1,00082,India
769799,2023-11-23,213,bisleri,6,15,9,1,00082,India
121154,2023-11-23,209,pepsi,75,100,25,1,00305,India
121154,2023-11-23,204,strawberry yogurt,50,60,10,1,00305,India
121154,2023-11-23,210,mountain dew,75,100,25,1,00305,India
121154,2023-11-23,211,red bull,90,125,35,1,00305,India
121154,2023-11-23,203,mango yogurt,50,60,10,1,00305,India
982491,2023-11-23,208,sprite,75,100,25,1,00372,India
982491,2023-11-23,212,amul cheese,250,315,65,1,00372,India
982491,2023-11-23,206,yakult,360,400,40,1,00372,India
982491,2023-11-23,202,milk,12,27,15,1,00372,India
306794,2023-11-23,208,sprite,75,100,25,1,00287,India
306794,2023-11-23,212,amul cheese,250,315,65,1,00287,India
306794,2023-11-23,201,paneer,210,340,130,1,00287,India
252350,2023-11-23,211,red bull,90,125,35,1,00047,India
252350,2023-11-23,204,strawberry yogurt,50,60,10,1,00047,India
252350,2023-11-23,205,classic yogurt,45,60,15,1,00047,India
991889,2023-11-23,209,pepsi,75,100,25,1,00011,India
519442,2023-11-23,212,amul cheese,250,315,65,1,00452,India
563342,2023-11-23,202,milk,12,27,15,1,00288,India
563342,2023-11-23,211,red bull,90,125,35,1,00288,India
563342,2023-11-23,209,pepsi,75,100,25,1,00288,India
563342,2023-11-23,207,coca cola,75,100,25,1,00288,India
802409,2023-11-23,207,coca cola,75,100,25,1,00460,India
366158,2023-11-23,209,pepsi,75,100,25,1,00078,India
787627,2023-11-23,202,milk,12,27,15,1,00333,India
787627,2023-11-23,208,sprite,75,100,25,1,00333,India
955554,2023-11-23,203,mango yogurt,50,60,10,1,00309,India
955554,2023-11-23,213,bisleri,6,15,9,1,00309,India
955554,2023-11-23,209,pepsi,75,100,25,1,00309,India
392657,2023-11-23,205,classic yogurt,45,60,15,1,00414,India
392657,2023-11-23,210,mountain dew,75,100,25,1,00414,India
392657,2023-11-23,213,bisleri,6,15,9,1,00414,India
392657,2023-11-23,209,pepsi,75,100,25,1,00414,India
392657,2023-11-23,212,amul cheese,250,315,65,1,00414,India
903489,2023-11-23,212,amul cheese,250,315,65,1,00053,India
903489,2023-11-23,210,mountain dew,75,100,25,1,00053,India
958123,2023-11-23,204,strawberry yogurt,50,60,10,1,00269,India
914453,2023-11-23,212,amul cheese,250,315,65,1,00159,India
914453,2023-11-23,206,yakult,360,400,40,1,00159,India
914453,2023-11-23,207,coca cola,75,100,25,1,00159,India
914453,2023-11-23,202,milk,12,27,15,1,00159,India
914453,2023-11-23,213,bisleri,6,15,9,1,00159,India
570982,2023-11-23,206,yakult,360,400,40,1,00494,India
967763,2023-11-23,212,amul cheese,250,315,65,1,00302,India
967763,2023-11-23,204,strawberry yogurt,50,60,10,1,00302,India
967763,2023-11-23,202,milk,12,27,15,1,00302,India
317249,2023-11-23,202,milk,12,27,15,1,00129,India
317249,2023-11-23,206,yakult,360,400,40,1,00129,India
317249,2023-11-23,205,classic yogurt,45,60,15,1,00129,India
317249,2023-11-23,203,mango yogurt,50,60,10,1,00129,India
340542,2023-11-23,201,paneer,210,340,130,1,00306,India
340542,2023-11-23,209,pepsi,75,100,25,1,00306,India
340542,2023-11-23,208,sprite,75,100,25,1,00306,India
847997,2023-11-23,204,strawberry yogurt,50,60,10,1,00278,India
847997,2023-11-23,208,sprite,75,100,25,1,00278,India
704813,2023-11-23,209,pepsi,75,100,25,1,00051,India
704813,2023-11-23,203,mango yogurt,50,60,10,1,00051,India
728789,2023-11-23,203,mango yogurt,50,60,10,1,00399,India
728789,2023-11-23,213,bisleri,6,15,9,1,00399,India
728789,2023-11-23,202,milk,12,27,15,1,00399,India
728789,2023-11-23,208,sprite,75,100,25,1,00399,India
266629,2023-11-24,211,red bull,90,125,35,1,00247,India
266629,2023-11-24,210,mountain dew,75,100,25,1,00247,India
266629,2023-11-24,206,yakult,360,400,40,1,00247,India
266629,2023-11-24,209,pepsi,75,100,25,1,00247,India
522238,2023-11-24,207,coca cola,75,100,25,1,00011,India
522238,2023-11-24,209,pepsi,75,100,25,1,00011,India
522238,2023-11-24,202,milk,12,27,15,1,00011,India
522238,2023-11-24,203,mango yogurt,50,60,10,1,00011,India
570224,2023-11-24,213,bisleri,6,15,9,1,00169,India
512601,2023-11-24,210,mountain dew,75,100,25,1,00359,India
512601,2023-11-24,211,red bull,90,125,35,1,00359,India
512601,2023-11-24,202,milk,12,27,15,1,00359,India
851992,2023-11-24,205,classic yogurt,45,60,15,1,00397,India
851992,2023-11-24,212,amul cheese,250,315,65,1,00397,India
851992,2023-11-24,209,pepsi,75,100,25,1,00397,India
451345,2023-11-24,205,classic yogurt,45,60,15,1,00153,India
451345,2023-11-24,211,red bull,90,125,35,1,00153,India
451345,2023-11-24,209,pepsi,75,100,25,1,00153,India
451345,2023-11-24,212,amul cheese,250,315,65,1,00153,India
117166,2023-11-24,213,bisleri,6,15,9,1,00108,India
875139,2023-11-24,208,sprite,75,100,25,1,00444,India
875139,2023-11-24,206,yakult,360,400,40,1,00444,India
875139,2023-11-24,204,strawberry yogurt,50,60,10,1,00444,India
875139,2023-11-24,202,milk,12,27,15,1,00444,India
763024,2023-11-24,206,yakult,360,400,40,1,00474,India
763024,2023-11-24,212,amul cheese,250,315,65,1,00474,India
763024,2023-11-24,202,milk,12,27,15,1,00474,India
763024,2023-11-24,211,red bull,90,125,35,1,00474,India
258361,2023-11-24,205,classic yogurt,45,60,15,1,00452,India
720976,2023-11-24,206,yakult,360,400,40,1,00208,India
720976,2023-11-24,203,mango yogurt,50,60,10,1,00208,India
720976,2023-11-24,209,pepsi,75,100,25,1,00208,India
720976,2023-11-24,210,mountain dew,75,100,25,1,00208,India
212209,2023-11-24,201,paneer,210,340,130,1,00217,India
212209,2023-11-24,213,bisleri,6,15,9,1,00217,India
212209,2023-11-24,207,coca cola,75,100,25,1,00217,India
816204,2023-11-24,201,paneer,210,340,130,1,00440,India
816204,2023-11-24,212,amul cheese,250,315,65,1,00440,India
588642,2023-11-24,202,milk,12,27,15,1,00303,India
386728,2023-11-24,205,classic yogurt,45,60,15,1,00116,India
386728,2023-11-24,206,yakult,360,400,40,1,00116,India
386728,2023-11-24,212,amul cheese,250,315,65,1,00116,India
386728,2023-11-24,202,milk,12,27,15,1,00116,India
386728,2023-11-24,208,sprite,75,100,25,1,00116,India
112106,2023-11-24,212,amul cheese,250,315,65,1,00068,India
112106,2023-11-24,211,red bull,90,125,35,1,00068,India
448296,2023-11-24,208,sprite,75,100,25,1,00336,India
448296,2023-11-24,212,amul cheese,250,315,65,1,00336,India
200926,2023-11-24,213,bisleri,6,15,9,1,00415,India
290453,2023-11-24,213,bisleri,6,15,9,1,00079,India
290453,2023-11-24,208,sprite,75,100,25,1,00079,India
469607,2023-11-24,211,red bull,90,125,35,1,00376,India
342085,2023-11-24,201,paneer,210,340,130,1,00087,India
342085,2023-11-24,202,milk,12,27,15,1,00087,India
720865,2023-11-24,202,milk,12,27,15,1,00349,India
720865,2023-11-24,213,bisleri,6,15,9,1,00349,India
720865,2023-11-24,205,classic yogurt,45,60,15,1,00349,India
238823,2023-11-24,213,bisleri,6,15,9,1,00044,India
238823,2023-11-24,207,coca cola,75,100,25,1,00044,India
238823,2023-11-24,209,pepsi,75,100,25,1,00044,India
238823,2023-11-24,210,mountain dew,75,100,25,1,00044,India
238823,2023-11-24,203,mango yogurt,50,60,10,1,00044,India
859766,2023-11-24,202,milk,12,27,15,1,00222,India
859766,2023-11-24,207,coca cola,75,100,25,1,00222,India
859766,2023-11-24,208,sprite,75,100,25,1,00222,India
456450,2023-11-24,211,red bull,90,125,35,1,00403,India
456450,2023-11-24,202,milk,12,27,15,1,00403,India
456450,2023-11-24,206,yakult,360,400,40,1,00403,India
456450,2023-11-24,213,bisleri,6,15,9,1,00403,India
416641,2023-11-24,206,yakult,360,400,40,1,00328,India
416641,2023-11-24,204,strawberry yogurt,50,60,10,1,00328,India
505809,2023-11-24,202,milk,12,27,15,1,00217,India
605136,2023-11-24,204,strawberry yogurt,50,60,10,1,00266,India
418469,2023-11-24,205,classic yogurt,45,60,15,1,00057,India
418469,2023-11-24,213,bisleri,6,15,9,1,00057,India
418469,2023-11-24,208,sprite,75,100,25,1,00057,India
418469,2023-11-24,204,strawberry yogurt,50,60,10,1,00057,India
692288,2023-11-24,212,amul cheese,250,315,65,1,00075,India
692288,2023-11-24,213,bisleri,6,15,9,1,00075,India
692288,2023-11-24,206,yakult,360,400,40,1,00075,India
692288,2023-11-24,204,strawberry yogurt,50,60,10,1,00075,India
692288,2023-11-24,209,pepsi,75,100,25,1,00075,India
205347,2023-11-24,206,yakult,360,400,40,1,00219,India
205347,2023-11-24,203,mango yogurt,50,60,10,1,00219,India
205347,2023-11-24,212,amul cheese,250,315,65,1,00219,India
205347,2023-11-24,205,classic yogurt,45,60,15,1,00219,India
322459,2023-11-24,201,paneer,210,340,130,1,00483,India
504138,2023-11-24,201,paneer,210,340,130,1,00450,India
504138,2023-11-24,206,yakult,360,400,40,1,00450,India
586849,2023-11-24,206,yakult,360,400,40,1,00017,India
586849,2023-11-24,205,classic yogurt,45,60,15,1,00017,India
586849,2023-11-24,212,amul cheese,250,315,65,1,00017,India
705497,2023-11-24,209,pepsi,75,100,25,1,00202,India
705497,2023-11-24,208,sprite,75,100,25,1,00202,India
705497,2023-11-24,213,bisleri,6,15,9,1,00202,India
459357,2023-11-24,213,bisleri,6,15,9,1,00150,India
150252,2023-11-24,201,paneer,210,340,130,1,00431,India
150252,2023-11-24,204,strawberry yogurt,50,60,10,1,00431,India
150252,2023-11-24,208,sprite,75,100,25,1,00431,India
150252,2023-11-24,209,pepsi,75,100,25,1,00431,India
111150,2023-11-24,211,red bull,90,125,35,1,00070,India
111150,2023-11-24,208,sprite,75,100,25,1,00070,India
111150,2023-11-24,203,mango yogurt,50,60,10,1,00070,India
633216,2023-11-24,208,sprite,75,100,25,1,00006,India
815529,2023-11-24,210,mountain dew,75,100,25,1,00029,India
578101,2023-11-24,209,pepsi,75,100,25,1,00321,India
578101,2023-11-24,202,milk,12,27,15,1,00321,India
151946,2023-11-24,213,bisleri,6,15,9,1,00356,India
151946,2023-11-24,208,sprite,75,100,25,1,00356,India
151946,2023-11-24,205,classic yogurt,45,60,15,1,00356,India
151946,2023-11-24,201,paneer,210,340,130,1,00356,India
965464,2023-11-24,207,coca cola,75,100,25,1,00428,India
965464,2023-11-24,208,sprite,75,100,25,1,00428,India
101402,2023-11-24,201,paneer,210,340,130,1,00443,India
101402,2023-11-24,213,bisleri,6,15,9,1,00443,India
637021,2023-11-24,201,paneer,210,340,130,1,00329,India
637021,2023-11-24,208,sprite,75,100,25,1,00329,India
637021,2023-11-24,209,pepsi,75,100,25,1,00329,India
879922,2023-11-24,207,coca cola,75,100,25,1,00014,India
879922,2023-11-24,209,pepsi,75,100,25,1,00014,India
879922,2023-11-24,208,sprite,75,100,25,1,00014,India
802041,2023-11-24,210,mountain dew,75,100,25,1,00464,India
802041,2023-11-24,205,classic yogurt,45,60,15,1,00464,India
802041,2023-11-24,208,sprite,75,100,25,1,00464,India
872256,2023-11-24,208,sprite,75,100,25,1,00071,India
872256,2023-11-24,205,classic yogurt,45,60,15,1,00071,India
872256,2023-11-24,202,milk,12,27,15,1,00071,India
872256,2023-11-24,206,yakult,360,400,40,1,00071,India
845129,2023-11-24,211,red bull,90,125,35,1,00271,India
845129,2023-11-24,212,amul cheese,250,315,65,1,00271,India
845129,2023-11-24,204,strawberry yogurt,50,60,10,1,00271,India
845129,2023-11-24,206,yakult,360,400,40,1,00271,India
845129,2023-11-24,207,coca cola,75,100,25,1,00271,India
356385,2023-11-24,210,mountain dew,75,100,25,1,00032,India
631418,2023-11-24,204,strawberry yogurt,50,60,10,1,00336,India
631418,2023-11-24,201,paneer,210,340,130,1,00336,India
631418,2023-11-24,205,classic yogurt,45,60,15,1,00336,India
631418,2023-11-24,212,amul cheese,250,315,65,1,00336,India
631418,2023-11-24,203,mango yogurt,50,60,10,1,00336,India
617865,2023-11-24,204,strawberry yogurt,50,60,10,1,00375,India
617865,2023-11-24,201,paneer,210,340,130,1,00375,India
617865,2023-11-24,203,mango yogurt,50,60,10,1,00375,India
617865,2023-11-24,213,bisleri,6,15,9,1,00375,India
384030,2023-11-24,211,red bull,90,125,35,1,00488,India
384030,2023-11-24,213,bisleri,6,15,9,1,00488,India
532087,2023-11-24,212,amul cheese,250,315,65,1,00390,India
532087,2023-11-24,202,milk,12,27,15,1,00390,India
330585,2023-11-24,212,amul cheese,250,315,65,1,00034,India
330585,2023-11-24,213,bisleri,6,15,9,1,00034,India
330585,2023-11-24,204,strawberry yogurt,50,60,10,1,00034,India
104887,2023-11-24,201,paneer,210,340,130,1,00244,India
104887,2023-11-24,209,pepsi,75,100,25,1,00244,India
104887,2023-11-24,213,bisleri,6,15,9,1,00244,India
104887,2023-11-24,206,yakult,360,400,40,1,00244,India
426029,2023-11-24,205,classic yogurt,45,60,15,1,00444,India
192706,2023-11-24,210,mountain dew,75,100,25,1,00368,India
192706,2023-11-24,205,classic yogurt,45,60,15,1,00368,India
765206,2023-11-24,210,mountain dew,75,100,25,1,00454,India
765206,2023-11-24,208,sprite,75,100,25,1,00454,India
890033,2023-11-24,213,bisleri,6,15,9,1,00128,India
312761,2023-11-24,201,paneer,210,340,130,1,00199,India
433448,2023-11-24,209,pepsi,75,100,25,1,00495,India
433448,2023-11-24,212,amul cheese,250,315,65,1,00495,India
433448,2023-11-24,204,strawberry yogurt,50,60,10,1,00495,India
266299,2023-11-24,205,classic yogurt,45,60,15,1,00346,India
266299,2023-11-24,207,coca cola,75,100,25,1,00346,India
266299,2023-11-24,201,paneer,210,340,130,1,00346,India
744759,2023-11-24,205,classic yogurt,45,60,15,1,00055,India
695172,2023-11-24,206,yakult,360,400,40,1,00346,India
767428,2023-11-24,207,coca cola,75,100,25,1,00289,India
767428,2023-11-24,213,bisleri,6,15,9,1,00289,India
767428,2023-11-24,210,mountain dew,75,100,25,1,00289,India
767428,2023-11-24,208,sprite,75,100,25,1,00289,India
566371,2023-11-24,213,bisleri,6,15,9,1,00436,India
215753,2023-11-24,205,classic yogurt,45,60,15,1,00126,India
215753,2023-11-24,207,coca cola,75,100,25,1,00126,India
215753,2023-11-24,204,strawberry yogurt,50,60,10,1,00126,India
215753,2023-11-24,210,mountain dew,75,100,25,1,00126,India
215753,2023-11-24,201,paneer,210,340,130,1,00126,India
983327,2023-11-24,210,mountain dew,75,100,25,1,00360,India
983327,2023-11-24,212,amul cheese,250,315,65,1,00360,India
983327,2023-11-24,201,paneer,210,340,130,1,00360,India
248431,2023-11-24,210,mountain dew,75,100,25,1,00357,India
248431,2023-11-24,204,strawberry yogurt,50,60,10,1,00357,India
268712,2023-11-24,210,mountain dew,75,100,25,1,00217,India
268712,2023-11-24,208,sprite,75,100,25,1,00217,India
268712,2023-11-24,213,bisleri,6,15,9,1,00217,India
268712,2023-11-24,211,red bull,90,125,35,1,00217,India
268712,2023-11-24,206,yakult,360,400,40,1,00217,India
915137,2023-11-24,201,paneer,210,340,130,1,00424,India
842268,2023-11-24,213,bisleri,6,15,9,1,00179,India
842268,2023-11-24,205,classic yogurt,45,60,15,1,00179,India
842268,2023-11-24,204,strawberry yogurt,50,60,10,1,00179,India
842268,2023-11-24,202,milk,12,27,15,1,00179,India
842268,2023-11-24,206,yakult,360,400,40,1,00179,India
796576,2023-11-24,207,coca cola,75,100,25,1,00243,India
430984,2023-11-24,203,mango yogurt,50,60,10,1,00261,India
430984,2023-11-24,201,paneer,210,340,130,1,00261,India
430984,2023-11-24,202,milk,12,27,15,1,00261,India
749029,2023-11-24,210,mountain dew,75,100,25,1,00390,India
749029,2023-11-24,206,yakult,360,400,40,1,00390,India
749029,2023-11-24,212,amul cheese,250,315,65,1,00390,India
831350,2023-11-24,213,bisleri,6,15,9,1,00103,India
751910,2023-11-24,205,classic yogurt,45,60,15,1,00132,India
751910,2023-11-24,201,paneer,210,340,130,1,00132,India
751910,2023-11-24,208,sprite,75,100,25,1,00132,India
751910,2023-11-24,211,red bull,90,125,35,1,00132,India
697473,2023-11-24,206,yakult,360,400,40,1,00427,India
697473,2023-11-24,208,sprite,75,100,25,1,00427,India
697473,2023-11-24,202,milk,12,27,15,1,00427,India
503366,2023-11-24,209,pepsi,75,100,25,1,00094,India
503366,2023-11-24,213,bisleri,6,15,9,1,00094,India
290797,2023-11-24,211,red bull,90,125,35,1,00055,India
290797,2023-11-24,208,sprite,75,100,25,1,00055,India
877363,2023-11-24,207,coca cola,75,100,25,1,00209,India
877363,2023-11-24,210,mountain dew,75,100,25,1,00209,India
432917,2023-11-24,211,red bull,90,125,35,1,00309,India
432917,2023-11-24,213,bisleri,6,15,9,1,00309,India
432917,2023-11-24,210,mountain dew,75,100,25,1,00309,India
360558,2023-11-24,212,amul cheese,250,315,65,1,00072,India
360558,2023-11-24,201,paneer,210,340,130,1,00072,India
360558,2023-11-24,205,classic yogurt,45,60,15,1,00072,India
360558,2023-11-24,207,coca cola,75,100,25,1,00072,India
669728,2023-11-24,211,red bull,90,125,35,1,00414,India
669728,2023-11-24,204,strawberry yogurt,50,60,10,1,00414,India
692776,2023-11-24,208,sprite,75,100,25,1,00111,India
692776,2023-11-24,204,strawberry yogurt,50,60,10,1,00111,India
692776,2023-11-24,210,mountain dew,75,100,25,1,00111,India
486973,2023-11-24,202,milk,12,27,15,1,00097,India
486973,2023-11-24,209,pepsi,75,100,25,1,00097,India
486973,2023-11-24,212,amul cheese,250,315,65,1,00097,India
486973,2023-11-24,206,yakult,360,400,40,1,00097,India
486973,2023-11-24,213,bisleri,6,15,9,1,00097,India
779025,2023-11-24,208,sprite,75,100,25,1,00262,India
779025,2023-11-24,209,pepsi,75,100,25,1,00262,India
779025,2023-11-24,213,bisleri,6,15,9,1,00262,India
779025,2023-11-24,207,coca cola,75,100,25,1,00262,India
891463,2023-11-24,209,pepsi,75,100,25,1,00041,India
891463,2023-11-24,210,mountain dew,75,100,25,1,00041,India
130228,2023-11-24,207,coca cola,75,100,25,1,00179,India
130228,2023-11-24,211,red bull,90,125,35,1,00179,India
753353,2023-11-24,211,red bull,90,125,35,1,00190,India
405814,2023-11-24,201,paneer,210,340,130,1,00153,India
344462,2023-11-24,209,pepsi,75,100,25,1,00044,India
344462,2023-11-24,202,milk,12,27,15,1,00044,India
344462,2023-11-24,212,amul cheese,250,315,65,1,00044,India
111389,2023-11-25,203,mango yogurt,50,60,10,1,00156,India
111389,2023-11-25,202,milk,12,27,15,1,00156,India
111389,2023-11-25,213,bisleri,6,15,9,1,00156,India
111389,2023-11-25,204,strawberry yogurt,50,60,10,1,00156,India
111389,2023-11-25,211,red bull,90,125,35,1,00156,India
342919,2023-11-25,206,yakult,360,400,40,1,00059,India
760894,2023-11-25,207,coca cola,75,100,25,1,00279,India
760894,2023-11-25,210,mountain dew,75,100,25,1,00279,India
542138,2023-11-25,205,classic yogurt,45,60,15,1,00248,India
542138,2023-11-25,207,coca cola,75,100,25,1,00248,India
191352,2023-11-25,210,mountain dew,75,100,25,1,00484,India
191352,2023-11-25,204,strawberry yogurt,50,60,10,1,00484,India
117224,2023-11-25,204,strawberry yogurt,50,60,10,1,00167,India
117224,2023-11-25,209,pepsi,75,100,25,1,00167,India
117224,2023-11-25,202,milk,12,27,15,1,00167,India
117224,2023-11-25,203,mango yogurt,50,60,10,1,00167,India
117224,2023-11-25,207,coca cola,75,100,25,1,00167,India
953876,2023-11-25,209,pepsi,75,100,25,1,00086,India
953876,2023-11-25,210,mountain dew,75,100,25,1,00086,India
953876,2023-11-25,201,paneer,210,340,130,1,00086,India
953876,2023-11-25,205,classic yogurt,45,60,15,1,00086,India
728894,2023-11-25,202,milk,12,27,15,1,00251,India
728894,2023-11-25,203,mango yogurt,50,60,10,1,00251,India
692996,2023-11-25,211,red bull,90,125,35,1,00388,India
692996,2023-11-25,206,yakult,360,400,40,1,00388,India
692996,2023-11-25,207,coca cola,75,100,25,1,00388,India
646398,2023-11-25,211,red bull,90,125,35,1,00481,India
792089,2023-11-25,210,mountain dew,75,100,25,1,00282,India
792089,2023-11-25,212,amul cheese,250,315,65,1,00282,India
928733,2023-11-25,201,paneer,210,340,130,1,00282,India
627264,2023-11-25,202,milk,12,27,15,1,00041,India
627264,2023-11-25,204,strawberry yogurt,50,60,10,1,00041,India
627264,2023-11-25,211,red bull,90,125,35,1,00041,India
435839,2023-11-25,203,mango yogurt,50,60,10,1,00432,India
435839,2023-11-25,212,amul cheese,250,315,65,1,00432,India
435839,2023-11-25,202,milk,12,27,15,1,00432,India
435839,2023-11-25,208,sprite,75,100,25,1,00432,India
860963,2023-11-25,213,bisleri,6,15,9,1,00461,India
464665,2023-11-25,212,amul cheese,250,315,65,1,00115,India
464665,2023-11-25,209,pepsi,75,100,25,1,00115,India
464665,2023-11-25,207,coca cola,75,100,25,1,00115,India
574006,2023-11-25,206,yakult,360,400,40,1,00158,India
574006,2023-11-25,202,milk,12,27,15,1,00158,India
574006,2023-11-25,205,classic yogurt,45,60,15,1,00158,India
574006,2023-11-25,203,mango yogurt,50,60,10,1,00158,India
574006,2023-11-25,207,coca cola,75,100,25,1,00158,India
683480,2023-11-25,212,amul cheese,250,315,65,1,00366,India
683480,2023-11-25,209,pepsi,75,100,25,1,00366,India
683480,2023-11-25,204,strawberry yogurt,50,60,10,1,00366,India
937608,2023-11-25,210,mountain dew,75,100,25,1,00062,India
937608,2023-11-25,206,yakult,360,400,40,1,00062,India
185830,2023-11-25,206,yakult,360,400,40,1,00179,India
185830,2023-11-25,211,red bull,90,125,35,1,00179,India
902740,2023-11-25,203,mango yogurt,50,60,10,1,00230,India
465055,2023-11-25,211,red bull,90,125,35,1,00330,India
465055,2023-11-25,205,classic yogurt,45,60,15,1,00330,India
628425,2023-11-25,205,classic yogurt,45,60,15,1,00297,India
628425,2023-11-25,207,coca cola,75,100,25,1,00297,India
586934,2023-11-25,201,paneer,210,340,130,1,00217,India
586934,2023-11-25,202,milk,12,27,15,1,00217,India
284968,2023-11-25,204,strawberry yogurt,50,60,10,1,00012,India
284968,2023-11-25,209,pepsi,75,100,25,1,00012,India
284968,2023-11-25,202,milk,12,27,15,1,00012,India
698064,2023-11-25,205,classic yogurt,45,60,15,1,00260,India
698064,2023-11-25,202,milk,12,27,15,1,00260,India
236296,2023-11-25,213,bisleri,6,15,9,1,00080,India
236296,2023-11-25,210,mountain dew,75,100,25,1,00080,India
780940,2023-11-25,207,coca cola,75,100,25,1,00387,India
761864,2023-11-25,210,mountain dew,75,100,25,1,00156,India
761864,2023-11-25,203,mango yogurt,50,60,10,1,00156,India
761864,2023-11-25,205,classic yogurt,45,60,15,1,00156,India
761864,2023-11-25,204,strawberry yogurt,50,60,10,1,00156,India
435907,2023-11-25,211,red bull,90,125,35,1,00487,India
451146,2023-11-25,207,coca cola,75,100,25,1,00414,India
451146,2023-11-25,205,classic yogurt,45,60,15,1,00414,India
451146,2023-11-25,210,mountain dew,75,100,25,1,00414,India
451146,2023-11-25,211,red bull,90,125,35,1,00414,India
830533,2023-11-25,210,mountain dew,75,100,25,1,00367,India
455386,2023-11-25,201,paneer,210,340,130,1,00347,India
851312,2023-11-25,202,milk,12,27,15,1,00358,India
851312,2023-11-25,205,classic yogurt,45,60,15,1,00358,India
851312,2023-11-25,207,coca cola,75,100,25,1,00358,India
836165,2023-11-25,208,sprite,75,100,25,1,00046,India
836165,2023-11-25,206,yakult,360,400,40,1,00046,India
836165,2023-11-25,210,mountain dew,75,100,25,1,00046,India
836165,2023-11-25,209,pepsi,75,100,25,1,00046,India
174644,2023-11-25,208,sprite,75,100,25,1,00347,India
174644,2023-11-25,203,mango yogurt,50,60,10,1,00347,India
174644,2023-11-25,209,pepsi,75,100,25,1,00347,India
174644,2023-11-25,202,milk,12,27,15,1,00347,India
220892,2023-11-25,212,amul cheese,250,315,65,1,00166,India
220892,2023-11-25,201,paneer,210,340,130,1,00166,India
220892,2023-11-25,202,milk,12,27,15,1,00166,India
220892,2023-11-25,209,pepsi,75,100,25,1,00166,India
351003,2023-11-25,212,amul cheese,250,315,65,1,00123,India
351003,2023-11-25,202,milk,12,27,15,1,00123,India
351003,2023-11-25,211,red bull,90,125,35,1,00123,India
919747,2023-11-25,211,red bull,90,125,35,1,00350,India
919747,2023-11-25,207,coca cola,75,100,25,1,00350,India
660289,2023-11-25,211,red bull,90,125,35,1,00280,India
660289,2023-11-25,207,coca cola,75,100,25,1,00280,India
660289,2023-11-25,206,yakult,360,400,40,1,00280,India
660289,2023-11-25,202,milk,12,27,15,1,00280,India
518390,2023-11-25,201,paneer,210,340,130,1,00021,India
518390,2023-11-25,208,sprite,75,100,25,1,00021,India
718565,2023-11-25,203,mango yogurt,50,60,10,1,00161,India
718565,2023-11-25,212,amul cheese,250,315,65,1,00161,India
718565,2023-11-25,205,classic yogurt,45,60,15,1,00161,India
718565,2023-11-25,201,paneer,210,340,130,1,00161,India
327689,2023-11-25,208,sprite,75,100,25,1,00404,India
327689,2023-11-25,202,milk,12,27,15,1,00404,India
327689,2023-11-25,206,yakult,360,400,40,1,00404,India
327689,2023-11-25,209,pepsi,75,100,25,1,00404,India
327689,2023-11-25,204,strawberry yogurt,50,60,10,1,00404,India
399746,2023-11-25,208,sprite,75,100,25,1,00270,India
399746,2023-11-25,206,yakult,360,400,40,1,00270,India
399746,2023-11-25,203,mango yogurt,50,60,10,1,00270,India
399746,2023-11-25,213,bisleri,6,15,9,1,00270,India
255415,2023-11-25,209,pepsi,75,100,25,1,00061,India
255415,2023-11-25,205,classic yogurt,45,60,15,1,00061,India
766405,2023-11-25,210,mountain dew,75,100,25,1,00284,India
766405,2023-11-25,205,classic yogurt,45,60,15,1,00284,India
509587,2023-11-25,209,pepsi,75,100,25,1,00389,India
509587,2023-11-25,204,strawberry yogurt,50,60,10,1,00389,India
509587,2023-11-25,212,amul cheese,250,315,65,1,00389,India
519251,2023-11-25,209,pepsi,75,100,25,1,00474,India
549935,2023-11-25,209,pepsi,75,100,25,1,00367,India
273321,2023-11-25,209,pepsi,75,100,25,1,00382,India
273321,2023-11-25,210,mountain dew,75,100,25,1,00382,India
273321,2023-11-25,213,bisleri,6,15,9,1,00382,India
576524,2023-11-26,213,bisleri,6,15,9,1,00092,India
175348,2023-11-26,206,yakult,360,400,40,1,00052,India
175348,2023-11-26,208,sprite,75,100,25,1,00052,India
175348,2023-11-26,211,red bull,90,125,35,1,00052,India
175348,2023-11-26,212,amul cheese,250,315,65,1,00052,India
475452,2023-11-26,208,sprite,75,100,25,1,00008,India
898146,2023-11-26,204,strawberry yogurt,50,60,10,1,00498,India
896437,2023-11-26,205,classic yogurt,45,60,15,1,00007,India
896437,2023-11-26,211,red bull,90,125,35,1,00007,India
896437,2023-11-26,208,sprite,75,100,25,1,00007,India
190986,2023-11-26,206,yakult,360,400,40,1,00285,India
190986,2023-11-26,211,red bull,90,125,35,1,00285,India
136131,2023-11-26,203,mango yogurt,50,60,10,1,00319,India
136131,2023-11-26,212,amul cheese,250,315,65,1,00319,India
136131,2023-11-26,202,milk,12,27,15,1,00319,India
908076,2023-11-26,203,mango yogurt,50,60,10,1,00429,India
908076,2023-11-26,204,strawberry yogurt,50,60,10,1,00429,India
908076,2023-11-26,208,sprite,75,100,25,1,00429,India
908076,2023-11-26,206,yakult,360,400,40,1,00429,India
908076,2023-11-26,212,amul cheese,250,315,65,1,00429,India
442672,2023-11-26,205,classic yogurt,45,60,15,1,00133,India
442672,2023-11-26,212,amul cheese,250,315,65,1,00133,India
512570,2023-11-26,207,coca cola,75,100,25,1,00088,India
512570,2023-11-26,209,pepsi,75,100,25,1,00088,India
512570,2023-11-26,213,bisleri,6,15,9,1,00088,India
512570,2023-11-26,212,amul cheese,250,315,65,1,00088,India
498400,2023-11-26,204,strawberry yogurt,50,60,10,1,00054,India
498400,2023-11-26,208,sprite,75,100,25,1,00054,India
498400,2023-11-26,201,paneer,210,340,130,1,00054,India
498400,2023-11-26,210,mountain dew,75,100,25,1,00054,India
498400,2023-11-26,202,milk,12,27,15,1,00054,India
842846,2023-11-26,201,paneer,210,340,130,1,00358,India
842846,2023-11-26,209,pepsi,75,100,25,1,00358,India
842846,2023-11-26,203,mango yogurt,50,60,10,1,00358,India
842846,2023-11-26,205,classic yogurt,45,60,15,1,00358,India
711366,2023-11-26,205,classic yogurt,45,60,15,1,00215,India
711366,2023-11-26,204,strawberry yogurt,50,60,10,1,00215,India
297472,2023-11-26,207,coca cola,75,100,25,1,00136,India
297472,2023-11-26,213,bisleri,6,15,9,1,00136,India
297472,2023-11-26,211,red bull,90,125,35,1,00136,India
946649,2023-11-26,204,strawberry yogurt,50,60,10,1,00179,India
946649,2023-11-26,203,mango yogurt,50,60,10,1,00179,India
946649,2023-11-26,210,mountain dew,75,100,25,1,00179,India
497484,2023-11-26,206,yakult,360,400,40,1,00178,India
869489,2023-11-26,204,strawberry yogurt,50,60,10,1,00113,India
869489,2023-11-26,212,amul cheese,250,315,65,1,00113,India
869489,2023-11-26,206,yakult,360,400,40,1,00113,India
869489,2023-11-26,203,mango yogurt,50,60,10,1,00113,India
869489,2023-11-26,213,bisleri,6,15,9,1,00113,India
386816,2023-11-26,213,bisleri,6,15,9,1,00189,India
793212,2023-11-26,209,pepsi,75,100,25,1,00015,India
793212,2023-11-26,213,bisleri,6,15,9,1,00015,India
793212,2023-11-26,205,classic yogurt,45,60,15,1,00015,India
179561,2023-11-26,212,amul cheese,250,315,65,1,00256,India
179561,2023-11-26,201,paneer,210,340,130,1,00256,India
179561,2023-11-26,210,mountain dew,75,100,25,1,00256,India
179561,2023-11-26,204,strawberry yogurt,50,60,10,1,00256,India
992115,2023-11-26,201,paneer,210,340,130,1,00162,India
992115,2023-11-26,203,mango yogurt,50,60,10,1,00162,India
992115,2023-11-26,211,red bull,90,125,35,1,00162,India
992115,2023-11-26,205,classic yogurt,45,60,15,1,00162,India
809898,2023-11-26,206,yakult,360,400,40,1,00042,India
809898,2023-11-26,203,mango yogurt,50,60,10,1,00042,India
809898,2023-11-26,204,strawberry yogurt,50,60,10,1,00042,India
809898,2023-11-26,211,red bull,90,125,35,1,00042,India
984215,2023-11-26,203,mango yogurt,50,60,10,1,00141,India
984215,2023-11-26,209,pepsi,75,100,25,1,00141,India
984215,2023-11-26,212,amul cheese,250,315,65,1,00141,India
984215,2023-11-26,207,coca cola,75,100,25,1,00141,India
103824,2023-11-26,204,strawberry yogurt,50,60,10,1,00040,India
103824,2023-11-26,201,paneer,210,340,130,1,00040,India
103824,2023-11-26,206,yakult,360,400,40,1,00040,India
103824,2023-11-26,202,milk,12,27,15,1,00040,India
718980,2023-11-26,202,milk,12,27,15,1,00423,India
718980,2023-11-26,213,bisleri,6,15,9,1,00423,India
718980,2023-11-26,201,paneer,210,340,130,1,00423,India
718980,2023-11-26,211,red bull,90,125,35,1,00423,India
718980,2023-11-26,209,pepsi,75,100,25,1,00423,India
947027,2023-11-26,209,pepsi,75,100,25,1,00100,India
697064,2023-11-26,203,mango yogurt,50,60,10,1,00135,India
697064,2023-11-26,211,red bull,90,125,35,1,00135,India
697064,2023-11-26,209,pepsi,75,100,25,1,00135,India
982091,2023-11-26,212,amul cheese,250,315,65,1,00230,India
775709,2023-11-26,201,paneer,210,340,130,1,00450,India
380977,2023-11-26,212,amul cheese,250,315,65,1,00438,India
380977,2023-11-26,210,mountain dew,75,100,25,1,00438,India
380977,2023-11-26,201,paneer,210,340,130,1,00438,India
380977,2023-11-26,203,mango yogurt,50,60,10,1,00438,India
857985,2023-11-26,206,yakult,360,400,40,1,00034,India
857985,2023-11-26,212,amul cheese,250,315,65,1,00034,India
857985,2023-11-26,202,milk,12,27,15,1,00034,India
492723,2023-11-26,201,paneer,210,340,130,1,00005,India
492723,2023-11-26,202,milk,12,27,15,1,00005,India
492723,2023-11-26,204,strawberry yogurt,50,60,10,1,00005,India
492723,2023-11-26,211,red bull,90,125,35,1,00005,India
911754,2023-11-26,206,yakult,360,400,40,1,00131,India
911754,2023-11-26,207,coca cola,75,100,25,1,00131,India
911754,2023-11-26,205,classic yogurt,45,60,15,1,00131,India
911754,2023-11-26,212,amul cheese,250,315,65,1,00131,India
993737,2023-11-26,208,sprite,75,100,25,1,00261,India
109917,2023-11-26,209,pepsi,75,100,25,1,00017,India
109917,2023-11-26,210,mountain dew,75,100,25,1,00017,India
109917,2023-11-26,201,paneer,210,340,130,1,00017,India
109917,2023-11-26,207,coca cola,75,100,25,1,00017,India
845714,2023-11-26,206,yakult,360,400,40,1,00477,India
845714,2023-11-26,207,coca cola,75,100,25,1,00477,India
845714,2023-11-26,213,bisleri,6,15,9,1,00477,India
845714,2023-11-26,203,mango yogurt,50,60,10,1,00477,India
216931,2023-11-26,210,mountain dew,75,100,25,1,00201,India
216931,2023-11-26,204,strawberry yogurt,50,60,10,1,00201,India
216931,2023-11-26,212,amul cheese,250,315,65,1,00201,India
216931,2023-11-26,202,milk,12,27,15,1,00201,India
353404,2023-11-26,213,bisleri,6,15,9,1,00259,India
353404,2023-11-26,209,pepsi,75,100,25,1,00259,India
353404,2023-11-26,210,mountain dew,75,100,25,1,00259,India
401823,2023-11-26,204,strawberry yogurt,50,60,10,1,00065,India
401823,2023-11-26,210,mountain dew,75,100,25,1,00065,India
401823,2023-11-26,202,milk,12,27,15,1,00065,India
348612,2023-11-26,207,coca cola,75,100,25,1,00006,India
348612,2023-11-26,201,paneer,210,340,130,1,00006,India
348612,2023-11-26,208,sprite,75,100,25,1,00006,India
348612,2023-11-26,205,classic yogurt,45,60,15,1,00006,India
106825,2023-11-26,202,milk,12,27,15,1,00154,India
106825,2023-11-26,212,amul cheese,250,315,65,1,00154,India
106825,2023-11-26,201,paneer,210,340,130,1,00154,India
106825,2023-11-26,204,strawberry yogurt,50,60,10,1,00154,India
833518,2023-11-26,212,amul cheese,250,315,65,1,00374,India
112292,2023-11-26,208,sprite,75,100,25,1,00255,India
112292,2023-11-26,212,amul cheese,250,315,65,1,00255,India
112292,2023-11-26,201,paneer,210,340,130,1,00255,India
511218,2023-11-26,211,red bull,90,125,35,1,00499,India
511218,2023-11-26,210,mountain dew,75,100,25,1,00499,India
511218,2023-11-26,202,milk,12,27,15,1,00499,India
511218,2023-11-26,209,pepsi,75,100,25,1,00499,India
616226,2023-11-26,209,pepsi,75,100,25,1,00023,India
616226,2023-11-26,205,classic yogurt,45,60,15,1,00023,India
616226,2023-11-26,207,coca cola,75,100,25,1,00023,India
616226,2023-11-26,202,milk,12,27,15,1,00023,India
662059,2023-11-26,210,mountain dew,75,100,25,1,00054,India
662059,2023-11-26,203,mango yogurt,50,60,10,1,00054,India
221155,2023-11-26,206,yakult,360,400,40,1,00123,India
221155,2023-11-26,203,mango yogurt,50,60,10,1,00123,India
377140,2023-11-26,205,classic yogurt,45,60,15,1,00143,India
377140,2023-11-26,211,red bull,90,125,35,1,00143,India
377140,2023-11-26,202,milk,12,27,15,1,00143,India
377140,2023-11-26,210,mountain dew,75,100,25,1,00143,India
659432,2023-11-26,211,red bull,90,125,35,1,00317,India
473808,2023-11-26,212,amul cheese,250,315,65,1,00329,India
786308,2023-11-26,206,yakult,360,400,40,1,00186,India
786308,2023-11-26,212,amul cheese,250,315,65,1,00186,India
786308,2023-11-26,201,paneer,210,340,130,1,00186,India
134432,2023-11-26,206,yakult,360,400,40,1,00194,India
134432,2023-11-26,207,coca cola,75,100,25,1,00194,India
134432,2023-11-26,213,bisleri,6,15,9,1,00194,India
134432,2023-11-26,210,mountain dew,75,100,25,1,00194,India
561604,2023-11-26,205,classic yogurt,45,60,15,1,00460,India
980221,2023-11-26,208,sprite,75,100,25,1,00030,India
980221,2023-11-26,201,paneer,210,340,130,1,00030,India
980221,2023-11-26,210,mountain dew,75,100,25,1,00030,India
634551,2023-11-26,207,coca cola,75,100,25,1,00145,India
634551,2023-11-26,205,classic yogurt,45,60,15,1,00145,India
848523,2023-11-26,201,paneer,210,340,130,1,00346,India
848523,2023-11-26,206,yakult,360,400,40,1,00346,India
848523,2023-11-26,207,coca cola,75,100,25,1,00346,India
848523,2023-11-26,209,pepsi,75,100,25,1,00346,India
848523,2023-11-26,212,amul cheese,250,315,65,1,00346,India
248210,2023-11-26,203,mango yogurt,50,60,10,1,00052,India
248210,2023-11-26,206,yakult,360,400,40,1,00052,India
248210,2023-11-26,207,coca cola,75,100,25,1,00052,India
248210,2023-11-26,213,bisleri,6,15,9,1,00052,India
248210,2023-11-26,204,strawberry yogurt,50,60,10,1,00052,India
211846,2023-11-26,203,mango yogurt,50,60,10,1,00242,India
211846,2023-11-26,206,yakult,360,400,40,1,00242,India
305983,2023-11-26,201,paneer,210,340,130,1,00155,India
305983,2023-11-26,207,coca cola,75,100,25,1,00155,India
875800,2023-11-26,208,sprite,75,100,25,1,00175,India
875800,2023-11-26,202,milk,12,27,15,1,00175,India
875800,2023-11-26,203,mango yogurt,50,60,10,1,00175,India
899696,2023-11-26,209,pepsi,75,100,25,1,00086,India
899696,2023-11-26,210,mountain dew,75,100,25,1,00086,India
973149,2023-11-26,213,bisleri,6,15,9,1,00099,India
131984,2023-11-26,212,amul cheese,250,315,65,1,00255,India
131984,2023-11-26,208,sprite,75,100,25,1,00255,India
131984,2023-11-26,202,milk,12,27,15,1,00255,India
131984,2023-11-26,206,yakult,360,400,40,1,00255,India
131984,2023-11-26,210,mountain dew,75,100,25,1,00255,India
904962,2023-11-26,211,red bull,90,125,35,1,00130,India
904962,2023-11-26,213,bisleri,6,15,9,1,00130,India
108489,2023-11-26,205,classic yogurt,45,60,15,1,00134,India
707893,2023-11-26,206,yakult,360,400,40,1,00267,India
707893,2023-11-26,205,classic yogurt,45,60,15,1,00267,India
917976,2023-11-26,212,amul cheese,250,315,65,1,00351,India
917976,2023-11-26,203,mango yogurt,50,60,10,1,00351,India
917976,2023-11-26,207,coca cola,75,100,25,1,00351,India
987268,2023-11-26,205,classic yogurt,45,60,15,1,00250,India
987268,2023-11-26,208,sprite,75,100,25,1,00250,India
987268,2023-11-26,203,mango yogurt,50,60,10,1,00250,India
335485,2023-11-26,213,bisleri,6,15,9,1,00276,India
335485,2023-11-26,203,mango yogurt,50,60,10,1,00276,India
335485,2023-11-26,202,milk,12,27,15,1,00276,India
565310,2023-11-26,206,yakult,360,400,40,1,00115,India
565310,2023-11-26,211,red bull,90,125,35,1,00115,India
565310,2023-11-26,204,strawberry yogurt,50,60,10,1,00115,India
565310,2023-11-26,202,milk,12,27,15,1,00115,India
595825,2023-11-26,207,coca cola,75,100,25,1,00118,India
595825,2023-11-26,211,red bull,90,125,35,1,00118,India
595825,2023-11-26,210,mountain dew,75,100,25,1,00118,India
823123,2023-11-26,213,bisleri,6,15,9,1,00259,India
111410,2023-11-26,210,mountain dew,75,100,25,1,00116,India
111410,2023-11-26,213,bisleri,6,15,9,1,00116,India
956862,2023-11-26,213,bisleri,6,15,9,1,00203,India
956862,2023-11-26,201,paneer,210,340,130,1,00203,India
956862,2023-11-26,202,milk,12,27,15,1,00203,India
956862,2023-11-26,212,amul cheese,250,315,65,1,00203,India
142927,2023-11-26,203,mango yogurt,50,60,10,1,00174,India
142927,2023-11-26,201,paneer,210,340,130,1,00174,India
892942,2023-11-26,207,coca cola,75,100,25,1,00246,India
201545,2023-11-26,201,paneer,210,340,130,1,00355,India
902798,2023-11-26,210,mountain dew,75,100,25,1,00094,India
902798,2023-11-26,201,paneer,210,340,130,1,00094,India
902798,2023-11-26,207,coca cola,75,100,25,1,00094,India
823337,2023-11-26,213,bisleri,6,15,9,1,00047,India
506873,2023-11-26,205,classic yogurt,45,60,15,1,00247,India
506873,2023-11-26,213,bisleri,6,15,9,1,00247,India
649779,2023-11-27,209,pepsi,75,100,25,1,00463,India
749369,2023-11-27,211,red bull,90,125,35,1,00244,India
749369,2023-11-27,202,milk,12,27,15,1,00244,India
303587,2023-11-27,205,classic yogurt,45,60,15,1,00300,India
995463,2023-11-27,213,bisleri,6,15,9,1,00116,India
370281,2023-11-27,212,amul cheese,250,315,65,1,00062,India
260142,2023-11-27,209,pepsi,75,100,25,1,00189,India
185769,2023-11-27,203,mango yogurt,50,60,10,1,00059,India
185769,2023-11-27,213,bisleri,6,15,9,1,00059,India
104955,2023-11-27,208,sprite,75,100,25,1,00316,India
104955,2023-11-27,209,pepsi,75,100,25,1,00316,India
104955,2023-11-27,205,classic yogurt,45,60,15,1,00316,India
104955,2023-11-27,202,milk,12,27,15,1,00316,India
104955,2023-11-27,213,bisleri,6,15,9,1,00316,India
301014,2023-11-27,205,classic yogurt,45,60,15,1,00110,India
669226,2023-11-27,209,pepsi,75,100,25,1,00369,India
669226,2023-11-27,212,amul cheese,250,315,65,1,00369,India
328235,2023-11-27,213,bisleri,6,15,9,1,00359,India
328235,2023-11-27,211,red bull,90,125,35,1,00359,India
141980,2023-11-27,208,sprite,75,100,25,1,00482,India
141980,2023-11-27,201,paneer,210,340,130,1,00482,India
141980,2023-11-27,211,red bull,90,125,35,1,00482,India
841250,2023-11-27,211,red bull,90,125,35,1,00394,India
841250,2023-11-27,205,classic yogurt,45,60,15,1,00394,India
841250,2023-11-27,204,strawberry yogurt,50,60,10,1,00394,India
393494,2023-11-27,205,classic yogurt,45,60,15,1,00109,India
247315,2023-11-27,209,pepsi,75,100,25,1,00100,India
247315,2023-11-27,213,bisleri,6,15,9,1,00100,India
247315,2023-11-27,211,red bull,90,125,35,1,00100,India
632359,2023-11-27,213,bisleri,6,15,9,1,00463,India
632359,2023-11-27,202,milk,12,27,15,1,00463,India
238870,2023-11-27,201,paneer,210,340,130,1,00413,India
238870,2023-11-27,210,mountain dew,75,100,25,1,00413,India
238870,2023-11-27,211,red bull,90,125,35,1,00413,India
238870,2023-11-27,203,mango yogurt,50,60,10,1,00413,India
238870,2023-11-27,206,yakult,360,400,40,1,00413,India
406767,2023-11-27,202,milk,12,27,15,1,00241,India
406767,2023-11-27,203,mango yogurt,50,60,10,1,00241,India
406767,2023-11-27,208,sprite,75,100,25,1,00241,India
406767,2023-11-27,205,classic yogurt,45,60,15,1,00241,India
595711,2023-11-27,206,yakult,360,400,40,1,00499,India
595711,2023-11-27,207,coca cola,75,100,25,1,00499,India
595711,2023-11-27,212,amul cheese,250,315,65,1,00499,India
595711,2023-11-27,203,mango yogurt,50,60,10,1,00499,India
595711,2023-11-27,204,strawberry yogurt,50,60,10,1,00499,India
644571,2023-11-27,201,paneer,210,340,130,1,00433,India
644571,2023-11-27,204,strawberry yogurt,50,60,10,1,00433,India
443580,2023-11-27,210,mountain dew,75,100,25,1,00393,India
443580,2023-11-27,207,coca cola,75,100,25,1,00393,India
261580,2023-11-27,205,classic yogurt,45,60,15,1,00011,India
261580,2023-11-27,209,pepsi,75,100,25,1,00011,India
261580,2023-11-27,210,mountain dew,75,100,25,1,00011,India
261580,2023-11-27,213,bisleri,6,15,9,1,00011,India
261580,2023-11-27,204,strawberry yogurt,50,60,10,1,00011,India
581570,2023-11-27,202,milk,12,27,15,1,00462,India
192070,2023-11-27,208,sprite,75,100,25,1,00427,India
211168,2023-11-27,213,bisleri,6,15,9,1,00134,India
211168,2023-11-27,207,coca cola,75,100,25,1,00134,India
211168,2023-11-27,204,strawberry yogurt,50,60,10,1,00134,India
211168,2023-11-27,208,sprite,75,100,25,1,00134,India
211168,2023-11-27,210,mountain dew,75,100,25,1,00134,India
512379,2023-11-27,209,pepsi,75,100,25,1,00266,India
512379,2023-11-27,212,amul cheese,250,315,65,1,00266,India
512379,2023-11-27,201,paneer,210,340,130,1,00266,India
512379,2023-11-27,210,mountain dew,75,100,25,1,00266,India
822916,2023-11-27,202,milk,12,27,15,1,00092,India
822916,2023-11-27,206,yakult,360,400,40,1,00092,India
822916,2023-11-27,207,coca cola,75,100,25,1,00092,India
822916,2023-11-27,208,sprite,75,100,25,1,00092,India
923593,2023-11-27,201,paneer,210,340,130,1,00281,India
923593,2023-11-27,208,sprite,75,100,25,1,00281,India
923593,2023-11-27,204,strawberry yogurt,50,60,10,1,00281,India
575201,2023-11-27,212,amul cheese,250,315,65,1,00007,India
606214,2023-11-27,202,milk,12,27,15,1,00201,India
690404,2023-11-27,206,yakult,360,400,40,1,00082,India
252117,2023-11-27,210,mountain dew,75,100,25,1,00074,India
252117,2023-11-27,201,paneer,210,340,130,1,00074,India
551602,2023-11-27,207,coca cola,75,100,25,1,00142,India
551602,2023-11-27,213,bisleri,6,15,9,1,00142,India
551602,2023-11-27,201,paneer,210,340,130,1,00142,India
150428,2023-11-27,208,sprite,75,100,25,1,00097,India
150428,2023-11-27,202,milk,12,27,15,1,00097,India
150428,2023-11-27,212,amul cheese,250,315,65,1,00097,India
629980,2023-11-27,203,mango yogurt,50,60,10,1,00430,India
629980,2023-11-27,202,milk,12,27,15,1,00430,India
629980,2023-11-27,211,red bull,90,125,35,1,00430,India
896306,2023-11-27,207,coca cola,75,100,25,1,00121,India
896306,2023-11-27,203,mango yogurt,50,60,10,1,00121,India
896306,2023-11-27,204,strawberry yogurt,50,60,10,1,00121,India
582296,2023-11-27,205,classic yogurt,45,60,15,1,00207,India
582296,2023-11-27,209,pepsi,75,100,25,1,00207,India
582296,2023-11-27,207,coca cola,75,100,25,1,00207,India
582296,2023-11-27,201,paneer,210,340,130,1,00207,India
600223,2023-11-27,203,mango yogurt,50,60,10,1,00231,India
600223,2023-11-27,205,classic yogurt,45,60,15,1,00231,India
600223,2023-11-27,204,strawberry yogurt,50,60,10,1,00231,India
600223,2023-11-27,208,sprite,75,100,25,1,00231,India
148226,2023-11-27,210,mountain dew,75,100,25,1,00491,India
148226,2023-11-27,205,classic yogurt,45,60,15,1,00491,India
148226,2023-11-27,209,pepsi,75,100,25,1,00491,India
148226,2023-11-27,203,mango yogurt,50,60,10,1,00491,India
269305,2023-11-27,211,red bull,90,125,35,1,00148,India
269305,2023-11-27,205,classic yogurt,45,60,15,1,00148,India
269305,2023-11-27,207,coca cola,75,100,25,1,00148,India
269305,2023-11-27,202,milk,12,27,15,1,00148,India
269305,2023-11-27,209,pepsi,75,100,25,1,00148,India
986250,2023-11-27,202,milk,12,27,15,1,00181,India
986250,2023-11-27,211,red bull,90,125,35,1,00181,India
986250,2023-11-27,210,mountain dew,75,100,25,1,00181,India
986250,2023-11-27,205,classic yogurt,45,60,15,1,00181,India
668791,2023-11-27,213,bisleri,6,15,9,1,00417,India
668791,2023-11-27,204,strawberry yogurt,50,60,10,1,00417,India
671563,2023-11-27,204,strawberry yogurt,50,60,10,1,00475,India
671563,2023-11-27,210,mountain dew,75,100,25,1,00475,India
134174,2023-11-27,209,pepsi,75,100,25,1,00273,India
134174,2023-11-27,210,mountain dew,75,100,25,1,00273,India
995972,2023-11-27,203,mango yogurt,50,60,10,1,00228,India
995972,2023-11-27,209,pepsi,75,100,25,1,00228,India
995972,2023-11-27,206,yakult,360,400,40,1,00228,India
448209,2023-11-27,211,red bull,90,125,35,1,00451,India
816812,2023-11-27,212,amul cheese,250,315,65,1,00377,India
816812,2023-11-27,202,milk,12,27,15,1,00377,India
816812,2023-11-27,203,mango yogurt,50,60,10,1,00377,India
816812,2023-11-27,208,sprite,75,100,25,1,00377,India
680454,2023-11-27,206,yakult,360,400,40,1,00024,India
680454,2023-11-27,201,paneer,210,340,130,1,00024,India
787698,2023-11-27,205,classic yogurt,45,60,15,1,00486,India
164724,2023-11-27,203,mango yogurt,50,60,10,1,00136,India
164724,2023-11-27,206,yakult,360,400,40,1,00136,India
886681,2023-11-27,207,coca cola,75,100,25,1,00095,India
886681,2023-11-27,210,mountain dew,75,100,25,1,00095,India
886681,2023-11-27,201,paneer,210,340,130,1,00095,India
886681,2023-11-27,212,amul cheese,250,315,65,1,00095,India
948285,2023-11-27,208,sprite,75,100,25,1,00191,India
948285,2023-11-27,206,yakult,360,400,40,1,00191,India
948285,2023-11-27,203,mango yogurt,50,60,10,1,00191,India
948285,2023-11-27,209,pepsi,75,100,25,1,00191,India
728528,2023-11-27,207,coca cola,75,100,25,1,00226,India
728528,2023-11-27,204,strawberry yogurt,50,60,10,1,00226,India
728528,2023-11-27,201,paneer,210,340,130,1,00226,India
965476,2023-11-27,210,mountain dew,75,100,25,1,00200,India
965476,2023-11-27,213,bisleri,6,15,9,1,00200,India
726326,2023-11-27,212,amul cheese,250,315,65,1,00494,India
726326,2023-11-27,206,yakult,360,400,40,1,00494,India
726326,2023-11-27,213,bisleri,6,15,9,1,00494,India
838347,2023-11-27,203,mango yogurt,50,60,10,1,00389,India
773558,2023-11-27,209,pepsi,75,100,25,1,00422,India
773558,2023-11-27,212,amul cheese,250,315,65,1,00422,India
773558,2023-11-27,203,mango yogurt,50,60,10,1,00422,India
773558,2023-11-27,210,mountain dew,75,100,25,1,00422,India
336128,2023-11-27,204,strawberry yogurt,50,60,10,1,00299,India
336128,2023-11-27,201,paneer,210,340,130,1,00299,India
671470,2023-11-28,208,sprite,75,100,25,1,00281,India
671470,2023-11-28,211,red bull,90,125,35,1,00281,India
671470,2023-11-28,206,yakult,360,400,40,1,00281,India
205879,2023-11-28,201,paneer,210,340,130,1,00275,India
205879,2023-11-28,206,yakult,360,400,40,1,00275,India
963376,2023-11-28,201,paneer,210,340,130,1,00487,India
721627,2023-11-28,205,classic yogurt,45,60,15,1,00460,India
721627,2023-11-28,207,coca cola,75,100,25,1,00460,India
721627,2023-11-28,202,milk,12,27,15,1,00460,India
721627,2023-11-28,211,red bull,90,125,35,1,00460,India
721627,2023-11-28,203,mango yogurt,50,60,10,1,00460,India
804752,2023-11-28,207,coca cola,75,100,25,1,00376,India
804752,2023-11-28,211,red bull,90,125,35,1,00376,India
804752,2023-11-28,208,sprite,75,100,25,1,00376,India
804752,2023-11-28,206,yakult,360,400,40,1,00376,India
155681,2023-11-28,208,sprite,75,100,25,1,00011,India
155681,2023-11-28,205,classic yogurt,45,60,15,1,00011,India
155681,2023-11-28,209,pepsi,75,100,25,1,00011,India
155681,2023-11-28,207,coca cola,75,100,25,1,00011,India
155681,2023-11-28,202,milk,12,27,15,1,00011,India
511502,2023-11-28,206,yakult,360,400,40,1,00429,India
511502,2023-11-28,210,mountain dew,75,100,25,1,00429,India
511502,2023-11-28,211,red bull,90,125,35,1,00429,India
794325,2023-11-28,202,milk,12,27,15,1,00415,India
794325,2023-11-28,203,mango yogurt,50,60,10,1,00415,India
778485,2023-11-28,213,bisleri,6,15,9,1,00358,India
442367,2023-11-28,207,coca cola,75,100,25,1,00232,India
442367,2023-11-28,213,bisleri,6,15,9,1,00232,India
442367,2023-11-28,204,strawberry yogurt,50,60,10,1,00232,India
442367,2023-11-28,210,mountain dew,75,100,25,1,00232,India
349365,2023-11-28,210,mountain dew,75,100,25,1,00092,India
707084,2023-11-28,204,strawberry yogurt,50,60,10,1,00424,India
507617,2023-11-28,202,milk,12,27,15,1,00314,India
507617,2023-11-28,208,sprite,75,100,25,1,00314,India
507617,2023-11-28,213,bisleri,6,15,9,1,00314,India
853996,2023-11-28,204,strawberry yogurt,50,60,10,1,00009,India
107731,2023-11-28,209,pepsi,75,100,25,1,00471,India
630815,2023-11-28,205,classic yogurt,45,60,15,1,00211,India
948756,2023-11-28,203,mango yogurt,50,60,10,1,00413,India
948756,2023-11-28,207,coca cola,75,100,25,1,00413,India
948756,2023-11-28,212,amul cheese,250,315,65,1,00413,India
948756,2023-11-28,206,yakult,360,400,40,1,00413,India
633851,2023-11-28,211,red bull,90,125,35,1,00336,India
114267,2023-11-28,210,mountain dew,75,100,25,1,00436,India
770895,2023-11-28,212,amul cheese,250,315,65,1,00464,India
770895,2023-11-28,208,sprite,75,100,25,1,00464,India
770895,2023-11-28,204,strawberry yogurt,50,60,10,1,00464,India
994929,2023-11-28,210,mountain dew,75,100,25,1,00017,India
994929,2023-11-28,212,amul cheese,250,315,65,1,00017,India
994929,2023-11-28,209,pepsi,75,100,25,1,00017,India
753214,2023-11-28,204,strawberry yogurt,50,60,10,1,00060,India
753214,2023-11-28,202,milk,12,27,15,1,00060,India
848931,2023-11-28,206,yakult,360,400,40,1,00204,India
848931,2023-11-28,204,strawberry yogurt,50,60,10,1,00204,India
106050,2023-11-28,205,classic yogurt,45,60,15,1,00457,India
106050,2023-11-28,206,yakult,360,400,40,1,00457,India
106050,2023-11-28,204,strawberry yogurt,50,60,10,1,00457,India
106050,2023-11-28,201,paneer,210,340,130,1,00457,India
106050,2023-11-28,203,mango yogurt,50,60,10,1,00457,India
963337,2023-11-28,203,mango yogurt,50,60,10,1,00151,India
963337,2023-11-28,201,paneer,210,340,130,1,00151,India
963337,2023-11-28,211,red bull,90,125,35,1,00151,India
963337,2023-11-28,208,sprite,75,100,25,1,00151,India
793232,2023-11-28,203,mango yogurt,50,60,10,1,00007,India
793232,2023-11-28,208,sprite,75,100,25,1,00007,India
793232,2023-11-28,205,classic yogurt,45,60,15,1,00007,India
790991,2023-11-28,204,strawberry yogurt,50,60,10,1,00028,India
790991,2023-11-28,202,milk,12,27,15,1,00028,India
790991,2023-11-28,206,yakult,360,400,40,1,00028,India
904453,2023-11-28,209,pepsi,75,100,25,1,00335,India
904453,2023-11-28,213,bisleri,6,15,9,1,00335,India
904453,2023-11-28,203,mango yogurt,50,60,10,1,00335,India
806310,2023-11-28,203,mango yogurt,50,60,10,1,00360,India
806310,2023-11-28,209,pepsi,75,100,25,1,00360,India
806310,2023-11-28,201,paneer,210,340,130,1,00360,India
806310,2023-11-28,204,strawberry yogurt,50,60,10,1,00360,India
811718,2023-11-28,207,coca cola,75,100,25,1,00254,India
811718,2023-11-28,205,classic yogurt,45,60,15,1,00254,India
811718,2023-11-28,208,sprite,75,100,25,1,00254,India
223752,2023-11-28,212,amul cheese,250,315,65,1,00035,India
223752,2023-11-28,204,strawberry yogurt,50,60,10,1,00035,India
223752,2023-11-28,202,milk,12,27,15,1,00035,India
804841,2023-11-28,209,pepsi,75,100,25,1,00212,India
634611,2023-11-28,204,strawberry yogurt,50,60,10,1,00083,India
322354,2023-11-28,202,milk,12,27,15,1,00055,India
322354,2023-11-28,206,yakult,360,400,40,1,00055,India
322354,2023-11-28,212,amul cheese,250,315,65,1,00055,India
322354,2023-11-28,210,mountain dew,75,100,25,1,00055,India
598288,2023-11-28,203,mango yogurt,50,60,10,1,00336,India
654277,2023-11-28,211,red bull,90,125,35,1,00430,India
654277,2023-11-28,204,strawberry yogurt,50,60,10,1,00430,India
654277,2023-11-28,212,amul cheese,250,315,65,1,00430,India
426209,2023-11-28,211,red bull,90,125,35,1,00157,India
426209,2023-11-28,209,pepsi,75,100,25,1,00157,India
426209,2023-11-28,212,amul cheese,250,315,65,1,00157,India
486229,2023-11-28,201,paneer,210,340,130,1,00249,India
486229,2023-11-28,210,mountain dew,75,100,25,1,00249,India
486229,2023-11-28,207,coca cola,75,100,25,1,00249,India
604440,2023-11-28,203,mango yogurt,50,60,10,1,00243,India
604440,2023-11-28,213,bisleri,6,15,9,1,00243,India
604440,2023-11-28,209,pepsi,75,100,25,1,00243,India
400495,2023-11-28,202,milk,12,27,15,1,00062,India
400495,2023-11-28,211,red bull,90,125,35,1,00062,India
400495,2023-11-28,204,strawberry yogurt,50,60,10,1,00062,India
625823,2023-11-28,213,bisleri,6,15,9,1,00270,India
625823,2023-11-28,212,amul cheese,250,315,65,1,00270,India
428484,2023-11-28,210,mountain dew,75,100,25,1,00450,India
135292,2023-11-28,209,pepsi,75,100,25,1,00382,India
135292,2023-11-28,203,mango yogurt,50,60,10,1,00382,India
135292,2023-11-28,211,red bull,90,125,35,1,00382,India
135292,2023-11-28,212,amul cheese,250,315,65,1,00382,India
806841,2023-11-28,213,bisleri,6,15,9,1,00376,India
566105,2023-11-28,203,mango yogurt,50,60,10,1,00223,India
566105,2023-11-28,207,coca cola,75,100,25,1,00223,India
566105,2023-11-28,210,mountain dew,75,100,25,1,00223,India
675612,2023-11-28,204,strawberry yogurt,50,60,10,1,00222,India
404392,2023-11-28,211,red bull,90,125,35,1,00010,India
404392,2023-11-28,201,paneer,210,340,130,1,00010,India
195691,2023-11-28,201,paneer,210,340,130,1,00497,India
195691,2023-11-28,204,strawberry yogurt,50,60,10,1,00497,India
195691,2023-11-28,210,mountain dew,75,100,25,1,00497,India
889851,2023-11-28,202,milk,12,27,15,1,00374,India
889851,2023-11-28,212,amul cheese,250,315,65,1,00374,India
793718,2023-11-28,207,coca cola,75,100,25,1,00080,India
793718,2023-11-28,213,bisleri,6,15,9,1,00080,India
793718,2023-11-28,205,classic yogurt,45,60,15,1,00080,India
793718,2023-11-28,209,pepsi,75,100,25,1,00080,India
793718,2023-11-28,210,mountain dew,75,100,25,1,00080,India
179320,2023-11-28,206,yakult,360,400,40,1,00290,India
179320,2023-11-28,211,red bull,90,125,35,1,00290,India
179320,2023-11-28,212,amul cheese,250,315,65,1,00290,India
179320,2023-11-28,205,classic yogurt,45,60,15,1,00290,India
568131,2023-11-28,205,classic yogurt,45,60,15,1,00233,India
787093,2023-11-28,203,mango yogurt,50,60,10,1,00279,India
787093,2023-11-28,207,coca cola,75,100,25,1,00279,India
235180,2023-11-28,204,strawberry yogurt,50,60,10,1,00315,India
235180,2023-11-28,203,mango yogurt,50,60,10,1,00315,India
235180,2023-11-28,208,sprite,75,100,25,1,00315,India
450352,2023-11-28,204,strawberry yogurt,50,60,10,1,00034,India
237177,2023-11-28,208,sprite,75,100,25,1,00097,India
429572,2023-11-28,210,mountain dew,75,100,25,1,00491,India
429572,2023-11-28,202,milk,12,27,15,1,00491,India
429572,2023-11-28,212,amul cheese,250,315,65,1,00491,India
429572,2023-11-28,211,red bull,90,125,35,1,00491,India
429572,2023-11-28,209,pepsi,75,100,25,1,00491,India
844174,2023-11-28,208,sprite,75,100,25,1,00188,India
844174,2023-11-28,212,amul cheese,250,315,65,1,00188,India
844174,2023-11-28,213,bisleri,6,15,9,1,00188,India
825441,2023-11-28,201,paneer,210,340,130,1,00072,India
825441,2023-11-28,208,sprite,75,100,25,1,00072,India
825441,2023-11-28,213,bisleri,6,15,9,1,00072,India
825441,2023-11-28,202,milk,12,27,15,1,00072,India
349640,2023-11-28,210,mountain dew,75,100,25,1,00241,India
349640,2023-11-28,211,red bull,90,125,35,1,00241,India
349640,2023-11-28,205,classic yogurt,45,60,15,1,00241,India
349640,2023-11-28,209,pepsi,75,100,25,1,00241,India
349640,2023-11-28,203,mango yogurt,50,60,10,1,00241,India
970845,2023-11-28,209,pepsi,75,100,25,1,00189,India
970845,2023-11-28,212,amul cheese,250,315,65,1,00189,India
970845,2023-11-28,202,milk,12,27,15,1,00189,India
970845,2023-11-28,208,sprite,75,100,25,1,00189,India
664640,2023-11-28,207,coca cola,75,100,25,1,00260,India
664640,2023-11-28,210,mountain dew,75,100,25,1,00260,India
664640,2023-11-28,206,yakult,360,400,40,1,00260,India
664640,2023-11-28,203,mango yogurt,50,60,10,1,00260,India
896659,2023-11-28,213,bisleri,6,15,9,1,00308,India
896659,2023-11-28,202,milk,12,27,15,1,00308,India
495803,2023-11-28,207,coca cola,75,100,25,1,00129,India
495803,2023-11-28,210,mountain dew,75,100,25,1,00129,India
495803,2023-11-28,205,classic yogurt,45,60,15,1,00129,India
941868,2023-11-28,209,pepsi,75,100,25,1,00133,India
941868,2023-11-28,208,sprite,75,100,25,1,00133,India
941868,2023-11-28,202,milk,12,27,15,1,00133,India
941868,2023-11-28,204,strawberry yogurt,50,60,10,1,00133,India
941868,2023-11-28,206,yakult,360,400,40,1,00133,India
697442,2023-11-28,202,milk,12,27,15,1,00027,India
697442,2023-11-28,210,mountain dew,75,100,25,1,00027,India
166898,2023-11-28,213,bisleri,6,15,9,1,00180,India
325232,2023-11-28,203,mango yogurt,50,60,10,1,00399,India
325232,2023-11-28,205,classic yogurt,45,60,15,1,00399,India
325232,2023-11-28,208,sprite,75,100,25,1,00399,India
486588,2023-11-28,208,sprite,75,100,25,1,00378,India
486588,2023-11-28,202,milk,12,27,15,1,00378,India
341950,2023-11-28,212,amul cheese,250,315,65,1,00019,India
341950,2023-11-28,213,bisleri,6,15,9,1,00019,India
341950,2023-11-28,210,mountain dew,75,100,25,1,00019,India
826249,2023-11-28,201,paneer,210,340,130,1,00218,India
826249,2023-11-28,210,mountain dew,75,100,25,1,00218,India
826249,2023-11-28,209,pepsi,75,100,25,1,00218,India
826249,2023-11-28,202,milk,12,27,15,1,00218,India
164423,2023-11-28,201,paneer,210,340,130,1,00024,India
164423,2023-11-28,213,bisleri,6,15,9,1,00024,India
164423,2023-11-28,203,mango yogurt,50,60,10,1,00024,India
164423,2023-11-28,207,coca cola,75,100,25,1,00024,India
266758,2023-11-28,207,coca cola,75,100,25,1,00350,India
266758,2023-11-28,211,red bull,90,125,35,1,00350,India
266758,2023-11-28,210,mountain dew,75,100,25,1,00350,India
834960,2023-11-28,205,classic yogurt,45,60,15,1,00126,India
339398,2023-11-28,201,paneer,210,340,130,1,00176,India
339398,2023-11-28,208,sprite,75,100,25,1,00176,India
339398,2023-11-28,205,classic yogurt,45,60,15,1,00176,India
339398,2023-11-28,210,mountain dew,75,100,25,1,00176,India
339398,2023-11-28,213,bisleri,6,15,9,1,00176,India
587061,2023-11-28,213,bisleri,6,15,9,1,00077,India
587061,2023-11-28,204,strawberry yogurt,50,60,10,1,00077,India
443212,2023-11-28,202,milk,12,27,15,1,00476,India
443212,2023-11-28,211,red bull,90,125,35,1,00476,India
754415,2023-11-28,204,strawberry yogurt,50,60,10,1,00366,India
754415,2023-11-28,206,yakult,360,400,40,1,00366,India
754415,2023-11-28,205,classic yogurt,45,60,15,1,00366,India
754415,2023-11-28,213,bisleri,6,15,9,1,00366,India
145746,2023-11-29,213,bisleri,6,15,9,1,00082,India
145746,2023-11-29,210,mountain dew,75,100,25,1,00082,India
804530,2023-11-29,211,red bull,90,125,35,1,00496,India
804530,2023-11-29,205,classic yogurt,45,60,15,1,00496,India
253494,2023-11-29,204,strawberry yogurt,50,60,10,1,00060,India
566394,2023-11-29,204,strawberry yogurt,50,60,10,1,00400,India
566394,2023-11-29,208,sprite,75,100,25,1,00400,India
566394,2023-11-29,209,pepsi,75,100,25,1,00400,India
566394,2023-11-29,201,paneer,210,340,130,1,00400,India
566394,2023-11-29,207,coca cola,75,100,25,1,00400,India
296800,2023-11-29,205,classic yogurt,45,60,15,1,00357,India
733443,2023-11-29,202,milk,12,27,15,1,00438,India
485337,2023-11-29,205,classic yogurt,45,60,15,1,00016,India
485337,2023-11-29,209,pepsi,75,100,25,1,00016,India
485337,2023-11-29,211,red bull,90,125,35,1,00016,India
496701,2023-11-29,208,sprite,75,100,25,1,00303,India
496701,2023-11-29,212,amul cheese,250,315,65,1,00303,India
496701,2023-11-29,204,strawberry yogurt,50,60,10,1,00303,India
185613,2023-11-29,202,milk,12,27,15,1,00198,India
185613,2023-11-29,211,red bull,90,125,35,1,00198,India
157785,2023-11-29,205,classic yogurt,45,60,15,1,00148,India
157785,2023-11-29,208,sprite,75,100,25,1,00148,India
149835,2023-11-29,202,milk,12,27,15,1,00434,India
149835,2023-11-29,211,red bull,90,125,35,1,00434,India
924085,2023-11-29,212,amul cheese,250,315,65,1,00453,India
321099,2023-11-29,205,classic yogurt,45,60,15,1,00307,India
321099,2023-11-29,206,yakult,360,400,40,1,00307,India
321099,2023-11-29,208,sprite,75,100,25,1,00307,India
464278,2023-11-29,209,pepsi,75,100,25,1,00291,India
464278,2023-11-29,201,paneer,210,340,130,1,00291,India
284343,2023-11-29,208,sprite,75,100,25,1,00036,India
284343,2023-11-29,205,classic yogurt,45,60,15,1,00036,India
284343,2023-11-29,210,mountain dew,75,100,25,1,00036,India
314604,2023-11-29,210,mountain dew,75,100,25,1,00027,India
204863,2023-11-29,205,classic yogurt,45,60,15,1,00270,India
204863,2023-11-29,206,yakult,360,400,40,1,00270,India
204863,2023-11-29,204,strawberry yogurt,50,60,10,1,00270,India
204863,2023-11-29,202,milk,12,27,15,1,00270,India
495083,2023-11-29,202,milk,12,27,15,1,00463,India
495083,2023-11-29,213,bisleri,6,15,9,1,00463,India
495083,2023-11-29,203,mango yogurt,50,60,10,1,00463,India
495083,2023-11-29,210,mountain dew,75,100,25,1,00463,India
990948,2023-11-29,204,strawberry yogurt,50,60,10,1,00335,India
990948,2023-11-29,212,amul cheese,250,315,65,1,00335,India
990948,2023-11-29,202,milk,12,27,15,1,00335,India
990948,2023-11-29,206,yakult,360,400,40,1,00335,India
152543,2023-11-29,208,sprite,75,100,25,1,00065,India
152543,2023-11-29,212,amul cheese,250,315,65,1,00065,India
152543,2023-11-29,210,mountain dew,75,100,25,1,00065,India
371205,2023-11-29,203,mango yogurt,50,60,10,1,00013,India
371205,2023-11-29,212,amul cheese,250,315,65,1,00013,India
371205,2023-11-29,202,milk,12,27,15,1,00013,India
371205,2023-11-29,209,pepsi,75,100,25,1,00013,India
981947,2023-11-29,201,paneer,210,340,130,1,00051,India
250736,2023-11-29,202,milk,12,27,15,1,00053,India
250736,2023-11-29,211,red bull,90,125,35,1,00053,India
250736,2023-11-29,207,coca cola,75,100,25,1,00053,India
250736,2023-11-29,205,classic yogurt,45,60,15,1,00053,India
114630,2023-11-29,203,mango yogurt,50,60,10,1,00430,India
114630,2023-11-29,208,sprite,75,100,25,1,00430,India
114630,2023-11-29,210,mountain dew,75,100,25,1,00430,India
114630,2023-11-29,202,milk,12,27,15,1,00430,India
524897,2023-11-29,213,bisleri,6,15,9,1,00076,India
524897,2023-11-29,204,strawberry yogurt,50,60,10,1,00076,India
524897,2023-11-29,210,mountain dew,75,100,25,1,00076,India
241270,2023-11-29,207,coca cola,75,100,25,1,00251,India
241270,2023-11-29,208,sprite,75,100,25,1,00251,India
241270,2023-11-29,211,red bull,90,125,35,1,00251,India
241270,2023-11-29,213,bisleri,6,15,9,1,00251,India
533918,2023-11-29,213,bisleri,6,15,9,1,00453,India
533918,2023-11-29,202,milk,12,27,15,1,00453,India
563619,2023-11-29,212,amul cheese,250,315,65,1,00360,India
158486,2023-11-29,209,pepsi,75,100,25,1,00384,India
158486,2023-11-29,212,amul cheese,250,315,65,1,00384,India
158486,2023-11-29,208,sprite,75,100,25,1,00384,India
507165,2023-11-29,212,amul cheese,250,315,65,1,00020,India
507165,2023-11-29,207,coca cola,75,100,25,1,00020,India
840166,2023-11-29,201,paneer,210,340,130,1,00381,India
840166,2023-11-29,204,strawberry yogurt,50,60,10,1,00381,India
840166,2023-11-29,208,sprite,75,100,25,1,00381,India
840166,2023-11-29,205,classic yogurt,45,60,15,1,00381,India
630888,2023-11-29,201,paneer,210,340,130,1,00090,India
630888,2023-11-29,203,mango yogurt,50,60,10,1,00090,India
231279,2023-11-29,212,amul cheese,250,315,65,1,00361,India
231279,2023-11-29,202,milk,12,27,15,1,00361,India
635817,2023-11-29,209,pepsi,75,100,25,1,00266,India
635817,2023-11-29,201,paneer,210,340,130,1,00266,India
635817,2023-11-29,213,bisleri,6,15,9,1,00266,India
635817,2023-11-29,205,classic yogurt,45,60,15,1,00266,India
905451,2023-11-29,212,amul cheese,250,315,65,1,00439,India
905451,2023-11-29,204,strawberry yogurt,50,60,10,1,00439,India
905451,2023-11-29,207,coca cola,75,100,25,1,00439,India
905451,2023-11-29,202,milk,12,27,15,1,00439,India
471253,2023-11-29,207,coca cola,75,100,25,1,00294,India
471253,2023-11-29,206,yakult,360,400,40,1,00294,India
471253,2023-11-29,205,classic yogurt,45,60,15,1,00294,India
471253,2023-11-29,209,pepsi,75,100,25,1,00294,India
714784,2023-11-29,202,milk,12,27,15,1,00345,India
714784,2023-11-29,203,mango yogurt,50,60,10,1,00345,India
714784,2023-11-29,211,red bull,90,125,35,1,00345,India
313063,2023-11-29,201,paneer,210,340,130,1,00373,India
199231,2023-11-29,212,amul cheese,250,315,65,1,00047,India
199231,2023-11-29,213,bisleri,6,15,9,1,00047,India
199231,2023-11-29,207,coca cola,75,100,25,1,00047,India
199231,2023-11-29,208,sprite,75,100,25,1,00047,India
744518,2023-11-29,213,bisleri,6,15,9,1,00237,India
370232,2023-11-29,208,sprite,75,100,25,1,00380,India
370232,2023-11-29,202,milk,12,27,15,1,00380,India
370232,2023-11-29,201,paneer,210,340,130,1,00380,India
370232,2023-11-29,205,classic yogurt,45,60,15,1,00380,India
874514,2023-11-29,202,milk,12,27,15,1,00201,India
196551,2023-11-29,209,pepsi,75,100,25,1,00430,India
196551,2023-11-29,207,coca cola,75,100,25,1,00430,India
606211,2023-11-29,205,classic yogurt,45,60,15,1,00206,India
606211,2023-11-29,206,yakult,360,400,40,1,00206,India
606211,2023-11-29,212,amul cheese,250,315,65,1,00206,India
115741,2023-11-29,207,coca cola,75,100,25,1,00106,India
115741,2023-11-29,204,strawberry yogurt,50,60,10,1,00106,India
115741,2023-11-29,202,milk,12,27,15,1,00106,India
765104,2023-11-29,210,mountain dew,75,100,25,1,00175,India
765104,2023-11-29,204,strawberry yogurt,50,60,10,1,00175,India
765104,2023-11-29,207,coca cola,75,100,25,1,00175,India
765104,2023-11-29,209,pepsi,75,100,25,1,00175,India
765104,2023-11-29,203,mango yogurt,50,60,10,1,00175,India
923500,2023-11-29,210,mountain dew,75,100,25,1,00387,India
923500,2023-11-29,208,sprite,75,100,25,1,00387,India
923500,2023-11-29,211,red bull,90,125,35,1,00387,India
255508,2023-11-29,202,milk,12,27,15,1,00006,India
255508,2023-11-29,207,coca cola,75,100,25,1,00006,India
768272,2023-11-29,213,bisleri,6,15,9,1,00072,India
768272,2023-11-29,201,paneer,210,340,130,1,00072,India
814728,2023-11-29,202,milk,12,27,15,1,00394,India
572375,2023-11-29,205,classic yogurt,45,60,15,1,00419,India
572375,2023-11-29,208,sprite,75,100,25,1,00419,India
356381,2023-11-29,211,red bull,90,125,35,1,00318,India
356381,2023-11-29,213,bisleri,6,15,9,1,00318,India
356381,2023-11-29,203,mango yogurt,50,60,10,1,00318,India
356381,2023-11-29,210,mountain dew,75,100,25,1,00318,India
356381,2023-11-29,209,pepsi,75,100,25,1,00318,India
434657,2023-11-29,212,amul cheese,250,315,65,1,00169,India
434657,2023-11-29,211,red bull,90,125,35,1,00169,India
434657,2023-11-29,210,mountain dew,75,100,25,1,00169,India
698713,2023-11-29,210,mountain dew,75,100,25,1,00135,India
698713,2023-11-29,207,coca cola,75,100,25,1,00135,India
528832,2023-11-29,208,sprite,75,100,25,1,00034,India
528832,2023-11-29,202,milk,12,27,15,1,00034,India
959989,2023-11-29,202,milk,12,27,15,1,00043,India
959989,2023-11-29,210,mountain dew,75,100,25,1,00043,India
959989,2023-11-29,203,mango yogurt,50,60,10,1,00043,India
463566,2023-11-29,205,classic yogurt,45,60,15,1,00216,India
463566,2023-11-29,203,mango yogurt,50,60,10,1,00216,India
463566,2023-11-29,206,yakult,360,400,40,1,00216,India
463566,2023-11-29,211,red bull,90,125,35,1,00216,India
133237,2023-11-29,210,mountain dew,75,100,25,1,00076,India
233850,2023-11-29,204,strawberry yogurt,50,60,10,1,00224,India
233850,2023-11-29,209,pepsi,75,100,25,1,00224,India
233850,2023-11-29,212,amul cheese,250,315,65,1,00224,India
233850,2023-11-29,206,yakult,360,400,40,1,00224,India
139558,2023-11-29,210,mountain dew,75,100,25,1,00217,India
280177,2023-11-29,208,sprite,75,100,25,1,00487,India
795443,2023-11-29,204,strawberry yogurt,50,60,10,1,00327,India
795443,2023-11-29,207,coca cola,75,100,25,1,00327,India
795443,2023-11-29,213,bisleri,6,15,9,1,00327,India
795443,2023-11-29,205,classic yogurt,45,60,15,1,00327,India
536858,2023-11-29,208,sprite,75,100,25,1,00333,India
536858,2023-11-29,210,mountain dew,75,100,25,1,00333,India
536858,2023-11-29,209,pepsi,75,100,25,1,00333,India
536858,2023-11-29,202,milk,12,27,15,1,00333,India
660437,2023-11-29,213,bisleri,6,15,9,1,00353,India
183832,2023-11-29,213,bisleri,6,15,9,1,00399,India
183832,2023-11-29,203,mango yogurt,50,60,10,1,00399,India
183832,2023-11-29,204,strawberry yogurt,50,60,10,1,00399,India
456456,2023-11-29,212,amul cheese,250,315,65,1,00163,India
806224,2023-11-29,205,classic yogurt,45,60,15,1,00420,India
806224,2023-11-29,207,coca cola,75,100,25,1,00420,India
806224,2023-11-29,211,red bull,90,125,35,1,00420,India
806224,2023-11-29,213,bisleri,6,15,9,1,00420,India
165046,2023-11-29,208,sprite,75,100,25,1,00064,India
165046,2023-11-29,203,mango yogurt,50,60,10,1,00064,India
165046,2023-11-29,210,mountain dew,75,100,25,1,00064,India
165046,2023-11-29,202,milk,12,27,15,1,00064,India
941333,2023-11-29,212,amul cheese,250,315,65,1,00289,India
741550,2023-11-29,213,bisleri,6,15,9,1,00491,India
741550,2023-11-29,209,pepsi,75,100,25,1,00491,India
741550,2023-11-29,206,yakult,360,400,40,1,00491,India
741550,2023-11-29,204,strawberry yogurt,50,60,10,1,00491,India
334150,2023-11-29,201,paneer,210,340,130,1,00261,India
334150,2023-11-29,202,milk,12,27,15,1,00261,India
334150,2023-11-29,205,classic yogurt,45,60,15,1,00261,India
399169,2023-11-30,205,classic yogurt,45,60,15,1,00381,India
399169,2023-11-30,202,milk,12,27,15,1,00381,India
399169,2023-11-30,210,mountain dew,75,100,25,1,00381,India
399169,2023-11-30,204,strawberry yogurt,50,60,10,1,00381,India
399169,2023-11-30,209,pepsi,75,100,25,1,00381,India
228555,2023-11-30,202,milk,12,27,15,1,00002,India
538639,2023-11-30,201,paneer,210,340,130,1,00173,India
538639,2023-11-30,213,bisleri,6,15,9,1,00173,India
538639,2023-11-30,202,milk,12,27,15,1,00173,India
902404,2023-11-30,204,strawberry yogurt,50,60,10,1,00363,India
902404,2023-11-30,209,pepsi,75,100,25,1,00363,India
902404,2023-11-30,208,sprite,75,100,25,1,00363,India
902404,2023-11-30,203,mango yogurt,50,60,10,1,00363,India
902404,2023-11-30,207,coca cola,75,100,25,1,00363,India
545650,2023-11-30,201,paneer,210,340,130,1,00144,India
545650,2023-11-30,210,mountain dew,75,100,25,1,00144,India
230238,2023-11-30,211,red bull,90,125,35,1,00452,India
230238,2023-11-30,213,bisleri,6,15,9,1,00452,India
484448,2023-11-30,210,mountain dew,75,100,25,1,00081,India
484448,2023-11-30,206,yakult,360,400,40,1,00081,India
484448,2023-11-30,204,strawberry yogurt,50,60,10,1,00081,India
538140,2023-11-30,208,sprite,75,100,25,1,00016,India
538140,2023-11-30,212,amul cheese,250,315,65,1,00016,India
538140,2023-11-30,202,milk,12,27,15,1,00016,India
408965,2023-11-30,212,amul cheese,250,315,65,1,00119,India
408965,2023-11-30,204,strawberry yogurt,50,60,10,1,00119,India
408965,2023-11-30,210,mountain dew,75,100,25,1,00119,India
982457,2023-11-30,210,mountain dew,75,100,25,1,00084,India
982457,2023-11-30,205,classic yogurt,45,60,15,1,00084,India
982457,2023-11-30,211,red bull,90,125,35,1,00084,India
982457,2023-11-30,212,amul cheese,250,315,65,1,00084,India
908304,2023-11-30,209,pepsi,75,100,25,1,00183,India
908304,2023-11-30,210,mountain dew,75,100,25,1,00183,India
908304,2023-11-30,211,red bull,90,125,35,1,00183,India
703938,2023-11-30,210,mountain dew,75,100,25,1,00056,India
703938,2023-11-30,201,paneer,210,340,130,1,00056,India
703938,2023-11-30,202,milk,12,27,15,1,00056,India
124708,2023-11-30,203,mango yogurt,50,60,10,1,00412,India
124708,2023-11-30,205,classic yogurt,45,60,15,1,00412,India
480689,2023-11-30,212,amul cheese,250,315,65,1,00280,India
480689,2023-11-30,210,mountain dew,75,100,25,1,00280,India
480689,2023-11-30,205,classic yogurt,45,60,15,1,00280,India
657989,2023-11-30,204,strawberry yogurt,50,60,10,1,00466,India
657989,2023-11-30,203,mango yogurt,50,60,10,1,00466,India
657989,2023-11-30,212,amul cheese,250,315,65,1,00466,India
760539,2023-11-30,204,strawberry yogurt,50,60,10,1,00271,India
561318,2023-11-30,203,mango yogurt,50,60,10,1,00446,India
561318,2023-11-30,210,mountain dew,75,100,25,1,00446,India
328694,2023-11-30,207,coca cola,75,100,25,1,00463,India
328694,2023-11-30,203,mango yogurt,50,60,10,1,00463,India
328694,2023-11-30,205,classic yogurt,45,60,15,1,00463,India
328694,2023-11-30,201,paneer,210,340,130,1,00463,India
328694,2023-11-30,204,strawberry yogurt,50,60,10,1,00463,India
676915,2023-11-30,204,strawberry yogurt,50,60,10,1,00354,India
676915,2023-11-30,202,milk,12,27,15,1,00354,India
676915,2023-11-30,203,mango yogurt,50,60,10,1,00354,India
396416,2023-11-30,213,bisleri,6,15,9,1,00006,India
948638,2023-11-30,210,mountain dew,75,100,25,1,00138,India
948638,2023-11-30,212,amul cheese,250,315,65,1,00138,India
948638,2023-11-30,201,paneer,210,340,130,1,00138,India
948638,2023-11-30,208,sprite,75,100,25,1,00138,India
948638,2023-11-30,203,mango yogurt,50,60,10,1,00138,India
837392,2023-11-30,209,pepsi,75,100,25,1,00067,India
837392,2023-11-30,212,amul cheese,250,315,65,1,00067,India
837392,2023-11-30,202,milk,12,27,15,1,00067,India
837392,2023-11-30,206,yakult,360,400,40,1,00067,India
434669,2023-11-30,204,strawberry yogurt,50,60,10,1,00254,India
434669,2023-11-30,206,yakult,360,400,40,1,00254,India
507558,2023-11-30,212,amul cheese,250,315,65,1,00499,India
779045,2023-11-30,201,paneer,210,340,130,1,00419,India
779045,2023-11-30,208,sprite,75,100,25,1,00419,India
779045,2023-11-30,203,mango yogurt,50,60,10,1,00419,India
826492,2023-11-30,210,mountain dew,75,100,25,1,00103,India
506335,2023-11-30,213,bisleri,6,15,9,1,00230,India
363844,2023-11-30,206,yakult,360,400,40,1,00010,India
363844,2023-11-30,204,strawberry yogurt,50,60,10,1,00010,India
363844,2023-11-30,207,coca cola,75,100,25,1,00010,India
363844,2023-11-30,213,bisleri,6,15,9,1,00010,India
631566,2023-11-30,203,mango yogurt,50,60,10,1,00171,India
631566,2023-11-30,208,sprite,75,100,25,1,00171,India
630633,2023-11-30,213,bisleri,6,15,9,1,00493,India
630633,2023-11-30,207,coca cola,75,100,25,1,00493,India
630633,2023-11-30,203,mango yogurt,50,60,10,1,00493,India
627856,2023-11-30,207,coca cola,75,100,25,1,00131,India
627856,2023-11-30,204,strawberry yogurt,50,60,10,1,00131,India
627856,2023-11-30,212,amul cheese,250,315,65,1,00131,India
602414,2023-11-30,205,classic yogurt,45,60,15,1,00201,India
602414,2023-11-30,202,milk,12,27,15,1,00201,India
675962,2023-11-30,209,pepsi,75,100,25,1,00412,India
675962,2023-11-30,206,yakult,360,400,40,1,00412,India
675962,2023-11-30,203,mango yogurt,50,60,10,1,00412,India
675962,2023-11-30,202,milk,12,27,15,1,00412,India
887050,2023-11-30,212,amul cheese,250,315,65,1,00205,India
887050,2023-11-30,202,milk,12,27,15,1,00205,India
301415,2023-11-30,207,coca cola,75,100,25,1,00087,India
301415,2023-11-30,213,bisleri,6,15,9,1,00087,India
301415,2023-11-30,206,yakult,360,400,40,1,00087,India
993701,2023-11-30,211,red bull,90,125,35,1,00218,India
993701,2023-11-30,208,sprite,75,100,25,1,00218,India
993701,2023-11-30,207,coca cola,75,100,25,1,00218,India
930538,2023-11-30,203,mango yogurt,50,60,10,1,00305,India
930538,2023-11-30,204,strawberry yogurt,50,60,10,1,00305,India
930538,2023-11-30,205,classic yogurt,45,60,15,1,00305,India
711090,2023-11-30,201,paneer,210,340,130,1,00386,India
711090,2023-11-30,205,classic yogurt,45,60,15,1,00386,India
711090,2023-11-30,213,bisleri,6,15,9,1,00386,India
967963,2023-11-30,212,amul cheese,250,315,65,1,00171,India
967963,2023-11-30,202,milk,12,27,15,1,00171,India
967963,2023-11-30,203,mango yogurt,50,60,10,1,00171,India
293821,2023-11-30,207,coca cola,75,100,25,1,00067,India
293821,2023-11-30,205,classic yogurt,45,60,15,1,00067,India
898828,2023-11-30,208,sprite,75,100,25,1,00197,India
898828,2023-11-30,213,bisleri,6,15,9,1,00197,India
898828,2023-11-30,212,amul cheese,250,315,65,1,00197,India
898828,2023-11-30,202,milk,12,27,15,1,00197,India
449409,2023-11-30,204,strawberry yogurt,50,60,10,1,00369,India
490078,2023-11-30,206,yakult,360,400,40,1,00175,India
490078,2023-11-30,204,strawberry yogurt,50,60,10,1,00175,India
490078,2023-11-30,210,mountain dew,75,100,25,1,00175,India
490078,2023-11-30,208,sprite,75,100,25,1,00175,India
853284,2023-11-30,201,paneer,210,340,130,1,00020,India
853284,2023-11-30,213,bisleri,6,15,9,1,00020,India
853284,2023-11-30,209,pepsi,75,100,25,1,00020,India
853284,2023-11-30,207,coca cola,75,100,25,1,00020,India
817898,2023-11-30,203,mango yogurt,50,60,10,1,00463,India
143641,2023-11-30,207,coca cola,75,100,25,1,00223,India
143641,2023-11-30,208,sprite,75,100,25,1,00223,India
983288,2023-11-30,209,pepsi,75,100,25,1,00114,India
983288,2023-11-30,210,mountain dew,75,100,25,1,00114,India
983288,2023-11-30,212,amul cheese,250,315,65,1,00114,India
983288,2023-11-30,213,bisleri,6,15,9,1,00114,India
965165,2023-11-30,213,bisleri,6,15,9,1,00376,India
965165,2023-11-30,211,red bull,90,125,35,1,00376,India
358942,2023-11-30,208,sprite,75,100,25,1,00337,India
358942,2023-11-30,202,milk,12,27,15,1,00337,India
554484,2023-11-30,211,red bull,90,125,35,1,00162,India
554484,2023-11-30,204,strawberry yogurt,50,60,10,1,00162,India
554484,2023-11-30,208,sprite,75,100,25,1,00162,India
174035,2023-11-30,204,strawberry yogurt,50,60,10,1,00164,India
174035,2023-11-30,210,mountain dew,75,100,25,1,00164,India
174035,2023-11-30,206,yakult,360,400,40,1,00164,India
174035,2023-11-30,213,bisleri,6,15,9,1,00164,India
585237,2023-11-30,201,paneer,210,340,130,1,00084,India
585237,2023-11-30,206,yakult,360,400,40,1,00084,India
585237,2023-11-30,202,milk,12,27,15,1,00084,India
615327,2023-11-30,207,coca cola,75,100,25,1,00113,India
615327,2023-11-30,210,mountain dew,75,100,25,1,00113,India
615327,2023-11-30,206,yakult,360,400,40,1,00113,India
206983,2023-11-30,205,classic yogurt,45,60,15,1,00452,India
219387,2023-11-30,205,classic yogurt,45,60,15,1,00282,India
219387,2023-11-30,209,pepsi,75,100,25,1,00282,India
216207,2023-11-30,202,milk,12,27,15,1,00023,India
216207,2023-11-30,208,sprite,75,100,25,1,00023,India
216207,2023-11-30,201,paneer,210,340,130,1,00023,India
216207,2023-11-30,209,pepsi,75,100,25,1,00023,India
978913,2023-11-30,207,coca cola,75,100,25,1,00341,India
978913,2023-11-30,213,bisleri,6,15,9,1,00341,India
978913,2023-11-30,210,mountain dew,75,100,25,1,00341,India
978913,2023-11-30,212,amul cheese,250,315,65,1,00341,India
978913,2023-11-30,205,classic yogurt,45,60,15,1,00341,India
843990,2023-11-30,210,mountain dew,75,100,25,1,00162,India
558081,2023-11-30,206,yakult,360,400,40,1,00194,India
558081,2023-11-30,205,classic yogurt,45,60,15,1,00194,India
558081,2023-11-30,204,strawberry yogurt,50,60,10,1,00194,India
558081,2023-11-30,202,milk,12,27,15,1,00194,India
597222,2023-11-30,204,strawberry yogurt,50,60,10,1,00182,India
597222,2023-11-30,209,pepsi,75,100,25,1,00182,India
597222,2023-11-30,213,bisleri,6,15,9,1,00182,India
597222,2023-11-30,211,red bull,90,125,35,1,00182,India
597222,2023-11-30,202,milk,12,27,15,1,00182,India
229622,2023-11-30,208,sprite,75,100,25,1,00255,India
770147,2023-11-30,209,pepsi,75,100,25,1,00108,India
770147,2023-11-30,206,yakult,360,400,40,1,00108,India
770147,2023-11-30,212,amul cheese,250,315,65,1,00108,India
608773,2023-11-30,211,red bull,90,125,35,1,00252,India
608773,2023-11-30,206,yakult,360,400,40,1,00252,India
608773,2023-11-30,207,coca cola,75,100,25,1,00252,India
608773,2023-11-30,208,sprite,75,100,25,1,00252,India
608773,2023-11-30,205,classic yogurt,45,60,15,1,00252,India
270389,2023-11-30,213,bisleri,6,15,9,1,00456,India
270389,2023-11-30,203,mango yogurt,50,60,10,1,00456,India
270389,2023-11-30,212,amul cheese,250,315,65,1,00456,India
606422,2023-11-30,201,paneer,210,340,130,1,00181,India
606422,2023-11-30,210,mountain dew,75,100,25,1,00181,India
581953,2023-11-30,213,bisleri,6,15,9,1,00153,India
581953,2023-11-30,211,red bull,90,125,35,1,00153,India
127686,2023-11-30,206,yakult,360,400,40,1,00231,India
127686,2023-11-30,212,amul cheese,250,315,65,1,00231,India
127686,2023-11-30,204,strawberry yogurt,50,60,10,1,00231,India
236086,2023-11-30,209,pepsi,75,100,25,1,00093,India
236086,2023-11-30,203,mango yogurt,50,60,10,1,00093,India
236086,2023-11-30,211,red bull,90,125,35,1,00093,India
463249,2023-11-30,213,bisleri,6,15,9,1,00300,India
463249,2023-11-30,202,milk,12,27,15,1,00300,India
463249,2023-11-30,201,paneer,210,340,130,1,00300,India
463249,2023-11-30,209,pepsi,75,100,25,1,00300,India
328959,2023-11-30,203,mango yogurt,50,60,10,1,00479,India
328959,2023-11-30,205,classic yogurt,45,60,15,1,00479,India
328959,2023-11-30,212,amul cheese,250,315,65,1,00479,India
521798,2023-12-01,203,mango yogurt,50,60,10,1,00296,India
521798,2023-12-01,208,sprite,75,100,25,1,00296,India
566004,2023-12-01,211,red bull,90,125,35,1,00414,India
684030,2023-12-01,205,classic yogurt,45,60,15,1,00416,India
684030,2023-12-01,211,red bull,90,125,35,1,00416,India
684030,2023-12-01,213,bisleri,6,15,9,1,00416,India
577315,2023-12-01,210,mountain dew,75,100,25,1,00120,India
577315,2023-12-01,206,yakult,360,400,40,1,00120,India
577315,2023-12-01,208,sprite,75,100,25,1,00120,India
629274,2023-12-01,208,sprite,75,100,25,1,00013,India
629274,2023-12-01,202,milk,12,27,15,1,00013,India
629274,2023-12-01,203,mango yogurt,50,60,10,1,00013,India
629274,2023-12-01,211,red bull,90,125,35,1,00013,India
333661,2023-12-01,203,mango yogurt,50,60,10,1,00203,India
333661,2023-12-01,206,yakult,360,400,40,1,00203,India
333661,2023-12-01,207,coca cola,75,100,25,1,00203,India
371638,2023-12-01,207,coca cola,75,100,25,1,00248,India
371638,2023-12-01,208,sprite,75,100,25,1,00248,India
716905,2023-12-01,204,strawberry yogurt,50,60,10,1,00438,India
716905,2023-12-01,208,sprite,75,100,25,1,00438,India
716905,2023-12-01,207,coca cola,75,100,25,1,00438,India
716905,2023-12-01,206,yakult,360,400,40,1,00438,India
371940,2023-12-01,211,red bull,90,125,35,1,00047,India
371940,2023-12-01,213,bisleri,6,15,9,1,00047,India
371940,2023-12-01,207,coca cola,75,100,25,1,00047,India
371940,2023-12-01,208,sprite,75,100,25,1,00047,India
899923,2023-12-01,210,mountain dew,75,100,25,1,00447,India
342046,2023-12-01,205,classic yogurt,45,60,15,1,00489,India
342046,2023-12-01,207,coca cola,75,100,25,1,00489,India
342046,2023-12-01,204,strawberry yogurt,50,60,10,1,00489,India
422711,2023-12-01,209,pepsi,75,100,25,1,00426,India
422711,2023-12-01,201,paneer,210,340,130,1,00426,India
422711,2023-12-01,202,milk,12,27,15,1,00426,India
422711,2023-12-01,213,bisleri,6,15,9,1,00426,India
422711,2023-12-01,206,yakult,360,400,40,1,00426,India
788881,2023-12-01,206,yakult,360,400,40,1,00154,India
788881,2023-12-01,212,amul cheese,250,315,65,1,00154,India
788881,2023-12-01,207,coca cola,75,100,25,1,00154,India
986490,2023-12-01,202,milk,12,27,15,1,00104,India
986490,2023-12-01,204,strawberry yogurt,50,60,10,1,00104,India
843253,2023-12-01,209,pepsi,75,100,25,1,00427,India
843253,2023-12-01,203,mango yogurt,50,60,10,1,00427,India
843253,2023-12-01,202,milk,12,27,15,1,00427,India
597991,2023-12-01,204,strawberry yogurt,50,60,10,1,00338,India
398937,2023-12-01,206,yakult,360,400,40,1,00091,India
262166,2023-12-01,208,sprite,75,100,25,1,00018,India
262166,2023-12-01,213,bisleri,6,15,9,1,00018,India
262166,2023-12-01,202,milk,12,27,15,1,00018,India
415154,2023-12-01,204,strawberry yogurt,50,60,10,1,00327,India
142841,2023-12-01,204,strawberry yogurt,50,60,10,1,00062,India
142841,2023-12-01,212,amul cheese,250,315,65,1,00062,India
142841,2023-12-01,209,pepsi,75,100,25,1,00062,India
142841,2023-12-01,205,classic yogurt,45,60,15,1,00062,India
544951,2023-12-01,207,coca cola,75,100,25,1,00113,India
544951,2023-12-01,205,classic yogurt,45,60,15,1,00113,India
544951,2023-12-01,201,paneer,210,340,130,1,00113,India
534433,2023-12-01,205,classic yogurt,45,60,15,1,00367,India
534433,2023-12-01,207,coca cola,75,100,25,1,00367,India
534433,2023-12-01,204,strawberry yogurt,50,60,10,1,00367,India
493344,2023-12-01,201,paneer,210,340,130,1,00411,India
493344,2023-12-01,210,mountain dew,75,100,25,1,00411,India
493344,2023-12-01,208,sprite,75,100,25,1,00411,India
493344,2023-12-01,207,coca cola,75,100,25,1,00411,India
567415,2023-12-01,204,strawberry yogurt,50,60,10,1,00325,India
567415,2023-12-01,209,pepsi,75,100,25,1,00325,India
567415,2023-12-01,210,mountain dew,75,100,25,1,00325,India
158039,2023-12-01,210,mountain dew,75,100,25,1,00205,India
158039,2023-12-01,208,sprite,75,100,25,1,00205,India
158039,2023-12-01,212,amul cheese,250,315,65,1,00205,India
283031,2023-12-01,212,amul cheese,250,315,65,1,00244,India
283031,2023-12-01,213,bisleri,6,15,9,1,00244,India
283031,2023-12-01,201,paneer,210,340,130,1,00244,India
283031,2023-12-01,205,classic yogurt,45,60,15,1,00244,India
283031,2023-12-01,207,coca cola,75,100,25,1,00244,India
572771,2023-12-01,203,mango yogurt,50,60,10,1,00046,India
572771,2023-12-01,209,pepsi,75,100,25,1,00046,India
572771,2023-12-01,212,amul cheese,250,315,65,1,00046,India
572771,2023-12-01,211,red bull,90,125,35,1,00046,India
447452,2023-12-01,212,amul cheese,250,315,65,1,00416,India
447452,2023-12-01,209,pepsi,75,100,25,1,00416,India
447452,2023-12-01,205,classic yogurt,45,60,15,1,00416,India
417830,2023-12-01,210,mountain dew,75,100,25,1,00134,India
417830,2023-12-01,203,mango yogurt,50,60,10,1,00134,India
417830,2023-12-01,209,pepsi,75,100,25,1,00134,India
414103,2023-12-01,207,coca cola,75,100,25,1,00491,India
414103,2023-12-01,201,paneer,210,340,130,1,00491,India
414103,2023-12-01,205,classic yogurt,45,60,15,1,00491,India
414103,2023-12-01,211,red bull,90,125,35,1,00491,India
131494,2023-12-01,212,amul cheese,250,315,65,1,00440,India
131494,2023-12-01,204,strawberry yogurt,50,60,10,1,00440,India
375913,2023-12-01,205,classic yogurt,45,60,15,1,00019,India
375913,2023-12-01,204,strawberry yogurt,50,60,10,1,00019,India
549089,2023-12-01,202,milk,12,27,15,1,00430,India
549089,2023-12-01,201,paneer,210,340,130,1,00430,India
549089,2023-12-01,206,yakult,360,400,40,1,00430,India
549089,2023-12-01,205,classic yogurt,45,60,15,1,00430,India
100264,2023-12-01,207,coca cola,75,100,25,1,00276,India
100264,2023-12-01,204,strawberry yogurt,50,60,10,1,00276,India
100264,2023-12-01,210,mountain dew,75,100,25,1,00276,India
100264,2023-12-01,203,mango yogurt,50,60,10,1,00276,India
912852,2023-12-01,213,bisleri,6,15,9,1,00060,India
912852,2023-12-01,211,red bull,90,125,35,1,00060,India
912852,2023-12-01,202,milk,12,27,15,1,00060,India
912852,2023-12-01,206,yakult,360,400,40,1,00060,India
912852,2023-12-01,207,coca cola,75,100,25,1,00060,India
663175,2023-12-01,206,yakult,360,400,40,1,00213,India
745499,2023-12-01,211,red bull,90,125,35,1,00353,India
745499,2023-12-01,207,coca cola,75,100,25,1,00353,India
405661,2023-12-01,211,red bull,90,125,35,1,00347,India
405661,2023-12-01,204,strawberry yogurt,50,60,10,1,00347,India
405661,2023-12-01,210,mountain dew,75,100,25,1,00347,India
405661,2023-12-01,213,bisleri,6,15,9,1,00347,India
943942,2023-12-01,209,pepsi,75,100,25,1,00177,India
943942,2023-12-01,212,amul cheese,250,315,65,1,00177,India
943942,2023-12-01,203,mango yogurt,50,60,10,1,00177,India
943942,2023-12-01,206,yakult,360,400,40,1,00177,India
105060,2023-12-01,204,strawberry yogurt,50,60,10,1,00090,India
105060,2023-12-01,212,amul cheese,250,315,65,1,00090,India
105060,2023-12-01,201,paneer,210,340,130,1,00090,India
931547,2023-12-01,211,red bull,90,125,35,1,00191,India
931547,2023-12-01,205,classic yogurt,45,60,15,1,00191,India
931547,2023-12-01,202,milk,12,27,15,1,00191,India
931547,2023-12-01,208,sprite,75,100,25,1,00191,India
193980,2023-12-01,201,paneer,210,340,130,1,00255,India
193980,2023-12-01,212,amul cheese,250,315,65,1,00255,India
193980,2023-12-01,209,pepsi,75,100,25,1,00255,India
871245,2023-12-01,213,bisleri,6,15,9,1,00193,India
871245,2023-12-01,209,pepsi,75,100,25,1,00193,India
871245,2023-12-01,212,amul cheese,250,315,65,1,00193,India
871245,2023-12-01,205,classic yogurt,45,60,15,1,00193,India
148498,2023-12-01,212,amul cheese,250,315,65,1,00205,India
999499,2023-12-01,204,strawberry yogurt,50,60,10,1,00120,India
999499,2023-12-01,212,amul cheese,250,315,65,1,00120,India
999499,2023-12-01,203,mango yogurt,50,60,10,1,00120,India
460075,2023-12-01,212,amul cheese,250,315,65,1,00486,India
460075,2023-12-01,208,sprite,75,100,25,1,00486,India
460075,2023-12-01,201,paneer,210,340,130,1,00486,India
460075,2023-12-01,206,yakult,360,400,40,1,00486,India
973923,2023-12-01,205,classic yogurt,45,60,15,1,00135,India
973923,2023-12-01,210,mountain dew,75,100,25,1,00135,India
973923,2023-12-01,209,pepsi,75,100,25,1,00135,India
973923,2023-12-01,213,bisleri,6,15,9,1,00135,India
973923,2023-12-01,211,red bull,90,125,35,1,00135,India
105267,2023-12-01,201,paneer,210,340,130,1,00432,India
105267,2023-12-01,212,amul cheese,250,315,65,1,00432,India
105267,2023-12-01,203,mango yogurt,50,60,10,1,00432,India
105267,2023-12-01,208,sprite,75,100,25,1,00432,India
280198,2023-12-01,212,amul cheese,250,315,65,1,00363,India
349581,2023-12-01,201,paneer,210,340,130,1,00290,India
349581,2023-12-01,206,yakult,360,400,40,1,00290,India
349581,2023-12-01,202,milk,12,27,15,1,00290,India
349581,2023-12-01,210,mountain dew,75,100,25,1,00290,India
815059,2023-12-01,209,pepsi,75,100,25,1,00458,India
815059,2023-12-01,208,sprite,75,100,25,1,00458,India
285062,2023-12-01,204,strawberry yogurt,50,60,10,1,00256,India
285062,2023-12-01,210,mountain dew,75,100,25,1,00256,India
692178,2023-12-01,202,milk,12,27,15,1,00337,India
692178,2023-12-01,203,mango yogurt,50,60,10,1,00337,India
692178,2023-12-01,205,classic yogurt,45,60,15,1,00337,India
692178,2023-12-01,213,bisleri,6,15,9,1,00337,India
692178,2023-12-01,211,red bull,90,125,35,1,00337,India
541452,2023-12-01,201,paneer,210,340,130,1,00403,India
541452,2023-12-01,203,mango yogurt,50,60,10,1,00403,India
541452,2023-12-01,213,bisleri,6,15,9,1,00403,India
541452,2023-12-01,210,mountain dew,75,100,25,1,00403,India
521306,2023-12-01,213,bisleri,6,15,9,1,00022,India
993289,2023-12-01,207,coca cola,75,100,25,1,00107,India
993289,2023-12-01,212,amul cheese,250,315,65,1,00107,India
830765,2023-12-01,211,red bull,90,125,35,1,00341,India
830765,2023-12-01,209,pepsi,75,100,25,1,00341,India
830765,2023-12-01,201,paneer,210,340,130,1,00341,India
830765,2023-12-01,203,mango yogurt,50,60,10,1,00341,India
772484,2023-12-01,203,mango yogurt,50,60,10,1,00392,India
377014,2023-12-01,208,sprite,75,100,25,1,00023,India
377014,2023-12-01,207,coca cola,75,100,25,1,00023,India
700347,2023-12-01,210,mountain dew,75,100,25,1,00155,India
700347,2023-12-01,202,milk,12,27,15,1,00155,India
700347,2023-12-01,209,pepsi,75,100,25,1,00155,India
700347,2023-12-01,203,mango yogurt,50,60,10,1,00155,India
227545,2023-12-01,206,yakult,360,400,40,1,00069,India
227545,2023-12-01,203,mango yogurt,50,60,10,1,00069,India
227545,2023-12-01,213,bisleri,6,15,9,1,00069,India
227545,2023-12-01,212,amul cheese,250,315,65,1,00069,India
459937,2023-12-01,209,pepsi,75,100,25,1,00292,India
459937,2023-12-01,207,coca cola,75,100,25,1,00292,India
459937,2023-12-01,206,yakult,360,400,40,1,00292,India
459937,2023-12-01,212,amul cheese,250,315,65,1,00292,India
251744,2023-12-01,211,red bull,90,125,35,1,00256,India
672067,2023-12-01,208,sprite,75,100,25,1,00170,India
672067,2023-12-01,207,coca cola,75,100,25,1,00170,India
195920,2023-12-01,210,mountain dew,75,100,25,1,00140,India
195920,2023-12-01,206,yakult,360,400,40,1,00140,India
195920,2023-12-01,201,paneer,210,340,130,1,00140,India
336729,2023-12-01,212,amul cheese,250,315,65,1,00009,India
336729,2023-12-01,205,classic yogurt,45,60,15,1,00009,India
383614,2023-12-01,213,bisleri,6,15,9,1,00233,India
383614,2023-12-01,204,strawberry yogurt,50,60,10,1,00233,India
548410,2023-12-01,213,bisleri,6,15,9,1,00492,India
548410,2023-12-01,209,pepsi,75,100,25,1,00492,India
548410,2023-12-01,201,paneer,210,340,130,1,00492,India
588939,2023-12-01,212,amul cheese,250,315,65,1,00405,India
588939,2023-12-01,201,paneer,210,340,130,1,00405,India
165723,2023-12-01,212,amul cheese,250,315,65,1,00244,India
165723,2023-12-01,207,coca cola,75,100,25,1,00244,India
165723,2023-12-01,201,paneer,210,340,130,1,00244,India
165723,2023-12-01,204,strawberry yogurt,50,60,10,1,00244,India
524637,2023-12-01,201,paneer,210,340,130,1,00149,India
524637,2023-12-01,209,pepsi,75,100,25,1,00149,India
447961,2023-12-01,207,coca cola,75,100,25,1,00134,India
447961,2023-12-01,210,mountain dew,75,100,25,1,00134,India
497661,2023-12-01,203,mango yogurt,50,60,10,1,00458,India
497661,2023-12-01,208,sprite,75,100,25,1,00458,India
967084,2023-12-01,213,bisleri,6,15,9,1,00052,India
967084,2023-12-01,210,mountain dew,75,100,25,1,00052,India
967084,2023-12-01,204,strawberry yogurt,50,60,10,1,00052,India
967084,2023-12-01,209,pepsi,75,100,25,1,00052,India
967084,2023-12-01,211,red bull,90,125,35,1,00052,India
895892,2023-12-01,202,milk,12,27,15,1,00082,India
895892,2023-12-01,209,pepsi,75,100,25,1,00082,India
277560,2023-12-01,209,pepsi,75,100,25,1,00259,India
277560,2023-12-01,201,paneer,210,340,130,1,00259,India
277560,2023-12-01,210,mountain dew,75,100,25,1,00259,India
255044,2023-12-01,211,red bull,90,125,35,1,00470,India
194671,2023-12-02,204,strawberry yogurt,50,60,10,1,00306,India
194671,2023-12-02,210,mountain dew,75,100,25,1,00306,India
194671,2023-12-02,201,paneer,210,340,130,1,00306,India
194671,2023-12-02,206,yakult,360,400,40,1,00306,India
128349,2023-12-02,210,mountain dew,75,100,25,1,00088,India
128349,2023-12-02,203,mango yogurt,50,60,10,1,00088,India
128349,2023-12-02,208,sprite,75,100,25,1,00088,India
128349,2023-12-02,212,amul cheese,250,315,65,1,00088,India
716448,2023-12-02,205,classic yogurt,45,60,15,1,00101,India
716448,2023-12-02,211,red bull,90,125,35,1,00101,India
116792,2023-12-02,208,sprite,75,100,25,1,00172,India
116792,2023-12-02,207,coca cola,75,100,25,1,00172,India
116792,2023-12-02,211,red bull,90,125,35,1,00172,India
116792,2023-12-02,202,milk,12,27,15,1,00172,India
969962,2023-12-02,211,red bull,90,125,35,1,00257,India
969962,2023-12-02,213,bisleri,6,15,9,1,00257,India
969962,2023-12-02,205,classic yogurt,45,60,15,1,00257,India
969962,2023-12-02,202,milk,12,27,15,1,00257,India
461217,2023-12-02,208,sprite,75,100,25,1,00075,India
461217,2023-12-02,212,amul cheese,250,315,65,1,00075,India
461217,2023-12-02,206,yakult,360,400,40,1,00075,India
163525,2023-12-02,201,paneer,210,340,130,1,00268,India
324204,2023-12-02,213,bisleri,6,15,9,1,00215,India
324204,2023-12-02,210,mountain dew,75,100,25,1,00215,India
324204,2023-12-02,202,milk,12,27,15,1,00215,India
324204,2023-12-02,201,paneer,210,340,130,1,00215,India
324204,2023-12-02,205,classic yogurt,45,60,15,1,00215,India
554868,2023-12-02,203,mango yogurt,50,60,10,1,00292,India
554868,2023-12-02,206,yakult,360,400,40,1,00292,India
554868,2023-12-02,204,strawberry yogurt,50,60,10,1,00292,India
554868,2023-12-02,209,pepsi,75,100,25,1,00292,India
688891,2023-12-02,204,strawberry yogurt,50,60,10,1,00447,India
688891,2023-12-02,208,sprite,75,100,25,1,00447,India
509756,2023-12-02,213,bisleri,6,15,9,1,00395,India
509756,2023-12-02,203,mango yogurt,50,60,10,1,00395,India
509756,2023-12-02,211,red bull,90,125,35,1,00395,India
185018,2023-12-02,206,yakult,360,400,40,1,00425,India
185018,2023-12-02,208,sprite,75,100,25,1,00425,India
185018,2023-12-02,212,amul cheese,250,315,65,1,00425,India
490225,2023-12-02,210,mountain dew,75,100,25,1,00432,India
379917,2023-12-02,201,paneer,210,340,130,1,00048,India
379917,2023-12-02,202,milk,12,27,15,1,00048,India
379917,2023-12-02,208,sprite,75,100,25,1,00048,India
379917,2023-12-02,210,mountain dew,75,100,25,1,00048,India
379917,2023-12-02,206,yakult,360,400,40,1,00048,India
235882,2023-12-02,209,pepsi,75,100,25,1,00492,India
796978,2023-12-02,201,paneer,210,340,130,1,00474,India
796978,2023-12-02,202,milk,12,27,15,1,00474,India
796978,2023-12-02,210,mountain dew,75,100,25,1,00474,India
156935,2023-12-02,206,yakult,360,400,40,1,00150,India
744462,2023-12-02,209,pepsi,75,100,25,1,00248,India
744462,2023-12-02,203,mango yogurt,50,60,10,1,00248,India
744462,2023-12-02,208,sprite,75,100,25,1,00248,India
744462,2023-12-02,205,classic yogurt,45,60,15,1,00248,India
763030,2023-12-02,211,red bull,90,125,35,1,00295,India
763030,2023-12-02,201,paneer,210,340,130,1,00295,India
763030,2023-12-02,206,yakult,360,400,40,1,00295,India
763030,2023-12-02,210,mountain dew,75,100,25,1,00295,India
257001,2023-12-02,207,coca cola,75,100,25,1,00166,India
257001,2023-12-02,208,sprite,75,100,25,1,00166,India
898249,2023-12-02,204,strawberry yogurt,50,60,10,1,00229,India
898249,2023-12-02,205,classic yogurt,45,60,15,1,00229,India
898249,2023-12-02,202,milk,12,27,15,1,00229,India
212756,2023-12-02,208,sprite,75,100,25,1,00181,India
212756,2023-12-02,206,yakult,360,400,40,1,00181,India
212756,2023-12-02,209,pepsi,75,100,25,1,00181,India
212756,2023-12-02,213,bisleri,6,15,9,1,00181,India
643052,2023-12-02,213,bisleri,6,15,9,1,00428,India
643052,2023-12-02,204,strawberry yogurt,50,60,10,1,00428,India
643052,2023-12-02,202,milk,12,27,15,1,00428,India
680038,2023-12-02,213,bisleri,6,15,9,1,00372,India
714840,2023-12-02,201,paneer,210,340,130,1,00226,India
714840,2023-12-02,209,pepsi,75,100,25,1,00226,India
714840,2023-12-02,212,amul cheese,250,315,65,1,00226,India
714840,2023-12-02,208,sprite,75,100,25,1,00226,India
655514,2023-12-02,202,milk,12,27,15,1,00005,India
655514,2023-12-02,205,classic yogurt,45,60,15,1,00005,India
655514,2023-12-02,211,red bull,90,125,35,1,00005,India
655514,2023-12-02,207,coca cola,75,100,25,1,00005,India
436005,2023-12-02,211,red bull,90,125,35,1,00267,India
436005,2023-12-02,206,yakult,360,400,40,1,00267,India
596394,2023-12-02,212,amul cheese,250,315,65,1,00366,India
596394,2023-12-02,202,milk,12,27,15,1,00366,India
596394,2023-12-02,207,coca cola,75,100,25,1,00366,India
596394,2023-12-02,201,paneer,210,340,130,1,00366,India
271215,2023-12-02,203,mango yogurt,50,60,10,1,00127,India
271215,2023-12-02,204,strawberry yogurt,50,60,10,1,00127,India
271215,2023-12-02,211,red bull,90,125,35,1,00127,India
271215,2023-12-02,206,yakult,360,400,40,1,00127,India
179865,2023-12-02,207,coca cola,75,100,25,1,00420,India
179865,2023-12-02,213,bisleri,6,15,9,1,00420,India
248199,2023-12-02,202,milk,12,27,15,1,00297,India
248199,2023-12-02,210,mountain dew,75,100,25,1,00297,India
903984,2023-12-02,205,classic yogurt,45,60,15,1,00382,India
903984,2023-12-02,208,sprite,75,100,25,1,00382,India
903984,2023-12-02,202,milk,12,27,15,1,00382,India
575818,2023-12-02,212,amul cheese,250,315,65,1,00460,India
575818,2023-12-02,205,classic yogurt,45,60,15,1,00460,India
575818,2023-12-02,209,pepsi,75,100,25,1,00460,India
634479,2023-12-02,205,classic yogurt,45,60,15,1,00261,India
858811,2023-12-02,206,yakult,360,400,40,1,00241,India
858811,2023-12-02,209,pepsi,75,100,25,1,00241,India
737784,2023-12-02,207,coca cola,75,100,25,1,00362,India
737784,2023-12-02,202,milk,12,27,15,1,00362,India
670749,2023-12-02,212,amul cheese,250,315,65,1,00411,India
670749,2023-12-02,201,paneer,210,340,130,1,00411,India
670749,2023-12-02,210,mountain dew,75,100,25,1,00411,India
727249,2023-12-02,202,milk,12,27,15,1,00273,India
727249,2023-12-02,208,sprite,75,100,25,1,00273,India
727249,2023-12-02,205,classic yogurt,45,60,15,1,00273,India
939537,2023-12-02,205,classic yogurt,45,60,15,1,00282,India
939537,2023-12-02,203,mango yogurt,50,60,10,1,00282,India
939537,2023-12-02,208,sprite,75,100,25,1,00282,India
704753,2023-12-02,202,milk,12,27,15,1,00384,India
111644,2023-12-02,210,mountain dew,75,100,25,1,00428,India
164919,2023-12-02,213,bisleri,6,15,9,1,00314,India
164919,2023-12-02,208,sprite,75,100,25,1,00314,India
811663,2023-12-02,208,sprite,75,100,25,1,00285,India
811663,2023-12-02,204,strawberry yogurt,50,60,10,1,00285,India
811663,2023-12-02,202,milk,12,27,15,1,00285,India
811663,2023-12-02,210,mountain dew,75,100,25,1,00285,India
811663,2023-12-02,209,pepsi,75,100,25,1,00285,India
396794,2023-12-02,202,milk,12,27,15,1,00444,India
396794,2023-12-02,211,red bull,90,125,35,1,00444,India
891096,2023-12-02,212,amul cheese,250,315,65,1,00154,India
891096,2023-12-02,210,mountain dew,75,100,25,1,00154,India
891096,2023-12-02,206,yakult,360,400,40,1,00154,India
891096,2023-12-02,203,mango yogurt,50,60,10,1,00154,India
543166,2023-12-02,209,pepsi,75,100,25,1,00310,India
135180,2023-12-02,203,mango yogurt,50,60,10,1,00456,India
135180,2023-12-02,212,amul cheese,250,315,65,1,00456,India
135180,2023-12-02,207,coca cola,75,100,25,1,00456,India
221812,2023-12-02,203,mango yogurt,50,60,10,1,00125,India
221812,2023-12-02,207,coca cola,75,100,25,1,00125,India
572060,2023-12-02,201,paneer,210,340,130,1,00463,India
572060,2023-12-02,213,bisleri,6,15,9,1,00463,India
559096,2023-12-02,210,mountain dew,75,100,25,1,00361,India
559096,2023-12-02,202,milk,12,27,15,1,00361,India
664670,2023-12-02,210,mountain dew,75,100,25,1,00339,India
664670,2023-12-02,212,amul cheese,250,315,65,1,00339,India
654094,2023-12-02,206,yakult,360,400,40,1,00229,India
654094,2023-12-02,201,paneer,210,340,130,1,00229,India
993598,2023-12-02,203,mango yogurt,50,60,10,1,00346,India
993598,2023-12-02,201,paneer,210,340,130,1,00346,India
993598,2023-12-02,202,milk,12,27,15,1,00346,India
211976,2023-12-02,213,bisleri,6,15,9,1,00123,India
211976,2023-12-02,209,pepsi,75,100,25,1,00123,India
828883,2023-12-02,204,strawberry yogurt,50,60,10,1,00100,India
828883,2023-12-02,210,mountain dew,75,100,25,1,00100,India
828883,2023-12-02,213,bisleri,6,15,9,1,00100,India
828883,2023-12-02,207,coca cola,75,100,25,1,00100,India
140679,2023-12-02,202,milk,12,27,15,1,00179,India
140679,2023-12-02,201,paneer,210,340,130,1,00179,India
140679,2023-12-02,212,amul cheese,250,315,65,1,00179,India
671260,2023-12-02,213,bisleri,6,15,9,1,00347,India
671260,2023-12-02,210,mountain dew,75,100,25,1,00347,India
671260,2023-12-02,211,red bull,90,125,35,1,00347,India
843354,2023-12-02,203,mango yogurt,50,60,10,1,00192,India
843354,2023-12-02,210,mountain dew,75,100,25,1,00192,India
843354,2023-12-02,204,strawberry yogurt,50,60,10,1,00192,India
554833,2023-12-03,213,bisleri,6,15,9,1,00003,India
554833,2023-12-03,204,strawberry yogurt,50,60,10,1,00003,India
588557,2023-12-03,212,amul cheese,250,315,65,1,00480,India
588557,2023-12-03,210,mountain dew,75,100,25,1,00480,India
588557,2023-12-03,207,coca cola,75,100,25,1,00480,India
588557,2023-12-03,208,sprite,75,100,25,1,00480,India
529163,2023-12-03,206,yakult,360,400,40,1,00257,India
529163,2023-12-03,211,red bull,90,125,35,1,00257,India
582789,2023-12-03,203,mango yogurt,50,60,10,1,00404,India
582789,2023-12-03,211,red bull,90,125,35,1,00404,India
582789,2023-12-03,213,bisleri,6,15,9,1,00404,India
521385,2023-12-03,203,mango yogurt,50,60,10,1,00262,India
521385,2023-12-03,207,coca cola,75,100,25,1,00262,India
521385,2023-12-03,202,milk,12,27,15,1,00262,India
521385,2023-12-03,206,yakult,360,400,40,1,00262,India
671376,2023-12-03,201,paneer,210,340,130,1,00371,India
671376,2023-12-03,205,classic yogurt,45,60,15,1,00371,India
671376,2023-12-03,206,yakult,360,400,40,1,00371,India
671376,2023-12-03,208,sprite,75,100,25,1,00371,India
851967,2023-12-03,212,amul cheese,250,315,65,1,00052,India
611105,2023-12-03,202,milk,12,27,15,1,00325,India
611105,2023-12-03,213,bisleri,6,15,9,1,00325,India
935226,2023-12-03,213,bisleri,6,15,9,1,00126,India
816516,2023-12-03,202,milk,12,27,15,1,00068,India
727215,2023-12-03,213,bisleri,6,15,9,1,00385,India
727215,2023-12-03,210,mountain dew,75,100,25,1,00385,India
727215,2023-12-03,212,amul cheese,250,315,65,1,00385,India
727215,2023-12-03,205,classic yogurt,45,60,15,1,00385,India
727215,2023-12-03,206,yakult,360,400,40,1,00385,India
979527,2023-12-03,201,paneer,210,340,130,1,00048,India
979527,2023-12-03,205,classic yogurt,45,60,15,1,00048,India
798668,2023-12-03,208,sprite,75,100,25,1,00347,India
798668,2023-12-03,201,paneer,210,340,130,1,00347,India
798668,2023-12-03,204,strawberry yogurt,50,60,10,1,00347,India
798668,2023-12-03,212,amul cheese,250,315,65,1,00347,India
310907,2023-12-03,211,red bull,90,125,35,1,00078,India
310907,2023-12-03,202,milk,12,27,15,1,00078,India
828432,2023-12-03,209,pepsi,75,100,25,1,00050,India
828432,2023-12-03,203,mango yogurt,50,60,10,1,00050,India
828432,2023-12-03,208,sprite,75,100,25,1,00050,India
828432,2023-12-03,205,classic yogurt,45,60,15,1,00050,India
796377,2023-12-03,206,yakult,360,400,40,1,00064,India
796377,2023-12-03,209,pepsi,75,100,25,1,00064,India
823531,2023-12-03,210,mountain dew,75,100,25,1,00218,India
823531,2023-12-03,209,pepsi,75,100,25,1,00218,India
823531,2023-12-03,203,mango yogurt,50,60,10,1,00218,India
127417,2023-12-03,209,pepsi,75,100,25,1,00430,India
127417,2023-12-03,202,milk,12,27,15,1,00430,India
127417,2023-12-03,213,bisleri,6,15,9,1,00430,India
676070,2023-12-03,209,pepsi,75,100,25,1,00238,India
676070,2023-12-03,206,yakult,360,400,40,1,00238,India
722110,2023-12-03,208,sprite,75,100,25,1,00138,India
722110,2023-12-03,205,classic yogurt,45,60,15,1,00138,India
722110,2023-12-03,211,red bull,90,125,35,1,00138,India
722110,2023-12-03,213,bisleri,6,15,9,1,00138,India
339131,2023-12-03,206,yakult,360,400,40,1,00215,India
339131,2023-12-03,212,amul cheese,250,315,65,1,00215,India
339131,2023-12-03,208,sprite,75,100,25,1,00215,India
339131,2023-12-03,201,paneer,210,340,130,1,00215,India
424058,2023-12-03,204,strawberry yogurt,50,60,10,1,00202,India
424058,2023-12-03,209,pepsi,75,100,25,1,00202,India
424058,2023-12-03,208,sprite,75,100,25,1,00202,India
922592,2023-12-03,211,red bull,90,125,35,1,00117,India
922592,2023-12-03,210,mountain dew,75,100,25,1,00117,India
922592,2023-12-03,207,coca cola,75,100,25,1,00117,India
717230,2023-12-03,203,mango yogurt,50,60,10,1,00082,India
717230,2023-12-03,204,strawberry yogurt,50,60,10,1,00082,India
717230,2023-12-03,202,milk,12,27,15,1,00082,India
717230,2023-12-03,205,classic yogurt,45,60,15,1,00082,India
265618,2023-12-03,202,milk,12,27,15,1,00054,India
500919,2023-12-03,203,mango yogurt,50,60,10,1,00271,India
500919,2023-12-03,206,yakult,360,400,40,1,00271,India
500919,2023-12-03,204,strawberry yogurt,50,60,10,1,00271,India
500919,2023-12-03,212,amul cheese,250,315,65,1,00271,India
219545,2023-12-03,202,milk,12,27,15,1,00325,India
219545,2023-12-03,213,bisleri,6,15,9,1,00325,India
219545,2023-12-03,210,mountain dew,75,100,25,1,00325,India
219545,2023-12-03,211,red bull,90,125,35,1,00325,India
267439,2023-12-03,210,mountain dew,75,100,25,1,00287,India
267439,2023-12-03,205,classic yogurt,45,60,15,1,00287,India
775676,2023-12-03,208,sprite,75,100,25,1,00247,India
170881,2023-12-03,208,sprite,75,100,25,1,00111,India
170881,2023-12-03,211,red bull,90,125,35,1,00111,India
170881,2023-12-03,205,classic yogurt,45,60,15,1,00111,India
170881,2023-12-03,209,pepsi,75,100,25,1,00111,India
887696,2023-12-03,206,yakult,360,400,40,1,00194,India
926758,2023-12-03,208,sprite,75,100,25,1,00051,India
926758,2023-12-03,213,bisleri,6,15,9,1,00051,India
926758,2023-12-03,203,mango yogurt,50,60,10,1,00051,India
936229,2023-12-03,205,classic yogurt,45,60,15,1,00297,India
936229,2023-12-03,207,coca cola,75,100,25,1,00297,India
936229,2023-12-03,204,strawberry yogurt,50,60,10,1,00297,India
936229,2023-12-03,202,milk,12,27,15,1,00297,India
936229,2023-12-03,208,sprite,75,100,25,1,00297,India
186980,2023-12-03,212,amul cheese,250,315,65,1,00483,India
186980,2023-12-03,207,coca cola,75,100,25,1,00483,India
469471,2023-12-03,206,yakult,360,400,40,1,00125,India
895703,2023-12-03,201,paneer,210,340,130,1,00090,India
895703,2023-12-03,203,mango yogurt,50,60,10,1,00090,India
895703,2023-12-03,202,milk,12,27,15,1,00090,India
867312,2023-12-03,209,pepsi,75,100,25,1,00366,India
825121,2023-12-03,211,red bull,90,125,35,1,00387,India
825121,2023-12-03,205,classic yogurt,45,60,15,1,00387,India
478112,2023-12-03,212,amul cheese,250,315,65,1,00094,India
915534,2023-12-03,210,mountain dew,75,100,25,1,00213,India
915534,2023-12-03,202,milk,12,27,15,1,00213,India
915534,2023-12-03,207,coca cola,75,100,25,1,00213,India
544672,2023-12-03,210,mountain dew,75,100,25,1,00409,India
544672,2023-12-03,208,sprite,75,100,25,1,00409,India
544672,2023-12-03,203,mango yogurt,50,60,10,1,00409,India
999505,2023-12-03,201,paneer,210,340,130,1,00336,India
999505,2023-12-03,211,red bull,90,125,35,1,00336,India
374109,2023-12-03,204,strawberry yogurt,50,60,10,1,00125,India
374109,2023-12-03,208,sprite,75,100,25,1,00125,India
374109,2023-12-03,201,paneer,210,340,130,1,00125,India
965204,2023-12-03,201,paneer,210,340,130,1,00447,India
965204,2023-12-03,210,mountain dew,75,100,25,1,00447,India
965204,2023-12-03,204,strawberry yogurt,50,60,10,1,00447,India
965204,2023-12-03,206,yakult,360,400,40,1,00447,India
965204,2023-12-03,203,mango yogurt,50,60,10,1,00447,India
818258,2023-12-03,202,milk,12,27,15,1,00370,India
818258,2023-12-03,206,yakult,360,400,40,1,00370,India
818258,2023-12-03,208,sprite,75,100,25,1,00370,India
818258,2023-12-03,211,red bull,90,125,35,1,00370,India
199569,2023-12-03,203,mango yogurt,50,60,10,1,00452,India
773319,2023-12-03,209,pepsi,75,100,25,1,00067,India
773319,2023-12-03,203,mango yogurt,50,60,10,1,00067,India
773319,2023-12-03,202,milk,12,27,15,1,00067,India
773319,2023-12-03,201,paneer,210,340,130,1,00067,India
294067,2023-12-03,201,paneer,210,340,130,1,00389,India
294067,2023-12-03,203,mango yogurt,50,60,10,1,00389,India
243727,2023-12-03,208,sprite,75,100,25,1,00084,India
243727,2023-12-03,210,mountain dew,75,100,25,1,00084,India
243727,2023-12-03,209,pepsi,75,100,25,1,00084,India
378858,2023-12-03,203,mango yogurt,50,60,10,1,00105,India
378858,2023-12-03,210,mountain dew,75,100,25,1,00105,India
231146,2023-12-03,205,classic yogurt,45,60,15,1,00006,India
231146,2023-12-03,207,coca cola,75,100,25,1,00006,India
231146,2023-12-03,202,milk,12,27,15,1,00006,India
231146,2023-12-03,209,pepsi,75,100,25,1,00006,India
402446,2023-12-03,209,pepsi,75,100,25,1,00269,India
326802,2023-12-03,202,milk,12,27,15,1,00042,India
326802,2023-12-03,209,pepsi,75,100,25,1,00042,India
485864,2023-12-03,211,red bull,90,125,35,1,00101,India
903473,2023-12-03,205,classic yogurt,45,60,15,1,00163,India
933580,2023-12-03,202,milk,12,27,15,1,00007,India
933580,2023-12-03,209,pepsi,75,100,25,1,00007,India
933580,2023-12-03,212,amul cheese,250,315,65,1,00007,India
561675,2023-12-03,205,classic yogurt,45,60,15,1,00418,India
561675,2023-12-03,212,amul cheese,250,315,65,1,00418,India
679884,2023-12-03,208,sprite,75,100,25,1,00272,India
679884,2023-12-03,211,red bull,90,125,35,1,00272,India
679884,2023-12-03,203,mango yogurt,50,60,10,1,00272,India
905420,2023-12-03,211,red bull,90,125,35,1,00376,India
755733,2023-12-03,205,classic yogurt,45,60,15,1,00401,India
755733,2023-12-03,209,pepsi,75,100,25,1,00401,India
755733,2023-12-03,202,milk,12,27,15,1,00401,India
755733,2023-12-03,208,sprite,75,100,25,1,00401,India
584967,2023-12-03,206,yakult,360,400,40,1,00175,India
584967,2023-12-03,213,bisleri,6,15,9,1,00175,India
972655,2023-12-03,202,milk,12,27,15,1,00416,India
972655,2023-12-03,208,sprite,75,100,25,1,00416,India
972655,2023-12-03,203,mango yogurt,50,60,10,1,00416,India
972655,2023-12-03,209,pepsi,75,100,25,1,00416,India
419014,2023-12-03,206,yakult,360,400,40,1,00128,India
419014,2023-12-03,203,mango yogurt,50,60,10,1,00128,India
419014,2023-12-03,207,coca cola,75,100,25,1,00128,India
419014,2023-12-03,213,bisleri,6,15,9,1,00128,India
419014,2023-12-03,212,amul cheese,250,315,65,1,00128,India
246778,2023-12-03,205,classic yogurt,45,60,15,1,00474,India
246778,2023-12-03,207,coca cola,75,100,25,1,00474,India
946722,2023-12-03,210,mountain dew,75,100,25,1,00331,India
946722,2023-12-03,202,milk,12,27,15,1,00331,India
132921,2023-12-03,213,bisleri,6,15,9,1,00485,India
132921,2023-12-03,212,amul cheese,250,315,65,1,00485,India
132921,2023-12-03,201,paneer,210,340,130,1,00485,India
132921,2023-12-03,204,strawberry yogurt,50,60,10,1,00485,India
132921,2023-12-03,211,red bull,90,125,35,1,00485,India
378129,2023-12-03,209,pepsi,75,100,25,1,00331,India
139436,2023-12-03,206,yakult,360,400,40,1,00002,India
139436,2023-12-03,208,sprite,75,100,25,1,00002,India
712072,2023-12-03,202,milk,12,27,15,1,00443,India
712072,2023-12-03,209,pepsi,75,100,25,1,00443,India
712072,2023-12-03,212,amul cheese,250,315,65,1,00443,India
430679,2023-12-03,205,classic yogurt,45,60,15,1,00102,India
430679,2023-12-03,207,coca cola,75,100,25,1,00102,India
386397,2023-12-03,204,strawberry yogurt,50,60,10,1,00497,India
386397,2023-12-03,205,classic yogurt,45,60,15,1,00497,India
433425,2023-12-03,203,mango yogurt,50,60,10,1,00162,India
433425,2023-12-03,213,bisleri,6,15,9,1,00162,India
433425,2023-12-03,204,strawberry yogurt,50,60,10,1,00162,India
433425,2023-12-03,211,red bull,90,125,35,1,00162,India
433425,2023-12-03,202,milk,12,27,15,1,00162,India
961371,2023-12-03,213,bisleri,6,15,9,1,00020,India
765602,2023-12-03,208,sprite,75,100,25,1,00162,India
765602,2023-12-03,212,amul cheese,250,315,65,1,00162,India
765602,2023-12-03,204,strawberry yogurt,50,60,10,1,00162,India
651817,2023-12-03,206,yakult,360,400,40,1,00377,India
651817,2023-12-03,213,bisleri,6,15,9,1,00377,India
651817,2023-12-03,201,paneer,210,340,130,1,00377,India
547655,2023-12-03,207,coca cola,75,100,25,1,00431,India
547655,2023-12-03,211,red bull,90,125,35,1,00431,India
547655,2023-12-03,206,yakult,360,400,40,1,00431,India
457241,2023-12-03,209,pepsi,75,100,25,1,00067,India
457241,2023-12-03,204,strawberry yogurt,50,60,10,1,00067,India
457241,2023-12-03,205,classic yogurt,45,60,15,1,00067,India
457241,2023-12-03,206,yakult,360,400,40,1,00067,India
552562,2023-12-03,213,bisleri,6,15,9,1,00386,India
552562,2023-12-03,210,mountain dew,75,100,25,1,00386,India
552562,2023-12-03,208,sprite,75,100,25,1,00386,India
552562,2023-12-03,212,amul cheese,250,315,65,1,00386,India
137827,2023-12-03,211,red bull,90,125,35,1,00216,India
258841,2023-12-04,207,coca cola,75,100,25,1,00252,India
258841,2023-12-04,202,milk,12,27,15,1,00252,India
258841,2023-12-04,210,mountain dew,75,100,25,1,00252,India
805164,2023-12-04,213,bisleri,6,15,9,1,00139,India
805164,2023-12-04,212,amul cheese,250,315,65,1,00139,India
722024,2023-12-04,206,yakult,360,400,40,1,00417,India
722024,2023-12-04,207,coca cola,75,100,25,1,00417,India
722024,2023-12-04,209,pepsi,75,100,25,1,00417,India
722024,2023-12-04,212,amul cheese,250,315,65,1,00417,India
744790,2023-12-04,208,sprite,75,100,25,1,00172,India
744790,2023-12-04,211,red bull,90,125,35,1,00172,India
744790,2023-12-04,202,milk,12,27,15,1,00172,India
526958,2023-12-04,201,paneer,210,340,130,1,00473,India
526958,2023-12-04,208,sprite,75,100,25,1,00473,India
526958,2023-12-04,211,red bull,90,125,35,1,00473,India
289936,2023-12-04,205,classic yogurt,45,60,15,1,00325,India
289936,2023-12-04,213,bisleri,6,15,9,1,00325,India
289936,2023-12-04,208,sprite,75,100,25,1,00325,India
289936,2023-12-04,202,milk,12,27,15,1,00325,India
580714,2023-12-04,212,amul cheese,250,315,65,1,00050,India
580714,2023-12-04,207,coca cola,75,100,25,1,00050,India
580714,2023-12-04,210,mountain dew,75,100,25,1,00050,India
580714,2023-12-04,211,red bull,90,125,35,1,00050,India
580714,2023-12-04,202,milk,12,27,15,1,00050,India
795545,2023-12-04,213,bisleri,6,15,9,1,00497,India
795545,2023-12-04,211,red bull,90,125,35,1,00497,India
795545,2023-12-04,203,mango yogurt,50,60,10,1,00497,India
795545,2023-12-04,209,pepsi,75,100,25,1,00497,India
795545,2023-12-04,204,strawberry yogurt,50,60,10,1,00497,India
267014,2023-12-04,211,red bull,90,125,35,1,00308,India
267014,2023-12-04,208,sprite,75,100,25,1,00308,India
267014,2023-12-04,212,amul cheese,250,315,65,1,00308,India
267014,2023-12-04,205,classic yogurt,45,60,15,1,00308,India
267014,2023-12-04,202,milk,12,27,15,1,00308,India
863703,2023-12-04,212,amul cheese,250,315,65,1,00078,India
863703,2023-12-04,201,paneer,210,340,130,1,00078,India
863703,2023-12-04,208,sprite,75,100,25,1,00078,India
863703,2023-12-04,203,mango yogurt,50,60,10,1,00078,India
822701,2023-12-04,201,paneer,210,340,130,1,00152,India
469440,2023-12-04,205,classic yogurt,45,60,15,1,00376,India
469440,2023-12-04,206,yakult,360,400,40,1,00376,India
187893,2023-12-04,207,coca cola,75,100,25,1,00216,India
458762,2023-12-04,210,mountain dew,75,100,25,1,00094,India
458762,2023-12-04,211,red bull,90,125,35,1,00094,India
356380,2023-12-04,207,coca cola,75,100,25,1,00079,India
224085,2023-12-04,210,mountain dew,75,100,25,1,00266,India
224085,2023-12-04,202,milk,12,27,15,1,00266,India
224085,2023-12-04,205,classic yogurt,45,60,15,1,00266,India
224085,2023-12-04,201,paneer,210,340,130,1,00266,India
309084,2023-12-04,204,strawberry yogurt,50,60,10,1,00436,India
309084,2023-12-04,210,mountain dew,75,100,25,1,00436,India
309084,2023-12-04,212,amul cheese,250,315,65,1,00436,India
309084,2023-12-04,206,yakult,360,400,40,1,00436,India
167022,2023-12-04,204,strawberry yogurt,50,60,10,1,00139,India
167022,2023-12-04,206,yakult,360,400,40,1,00139,India
167022,2023-12-04,209,pepsi,75,100,25,1,00139,India
167022,2023-12-04,211,red bull,90,125,35,1,00139,India
909748,2023-12-04,213,bisleri,6,15,9,1,00174,India
909748,2023-12-04,206,yakult,360,400,40,1,00174,India
319975,2023-12-04,201,paneer,210,340,130,1,00335,India
319975,2023-12-04,207,coca cola,75,100,25,1,00335,India
749413,2023-12-04,202,milk,12,27,15,1,00192,India
749413,2023-12-04,204,strawberry yogurt,50,60,10,1,00192,India
749413,2023-12-04,213,bisleri,6,15,9,1,00192,India
319056,2023-12-04,207,coca cola,75,100,25,1,00369,India
319056,2023-12-04,201,paneer,210,340,130,1,00369,India
319056,2023-12-04,203,mango yogurt,50,60,10,1,00369,India
174850,2023-12-04,207,coca cola,75,100,25,1,00402,India
174850,2023-12-04,203,mango yogurt,50,60,10,1,00402,India
174850,2023-12-04,205,classic yogurt,45,60,15,1,00402,India
174850,2023-12-04,213,bisleri,6,15,9,1,00402,India
413099,2023-12-04,208,sprite,75,100,25,1,00135,India
413099,2023-12-04,202,milk,12,27,15,1,00135,India
720652,2023-12-04,211,red bull,90,125,35,1,00355,India
720652,2023-12-04,208,sprite,75,100,25,1,00355,India
720652,2023-12-04,212,amul cheese,250,315,65,1,00355,India
170870,2023-12-04,213,bisleri,6,15,9,1,00247,India
259740,2023-12-04,207,coca cola,75,100,25,1,00092,India
259740,2023-12-04,206,yakult,360,400,40,1,00092,India
259740,2023-12-04,201,paneer,210,340,130,1,00092,India
700939,2023-12-04,201,paneer,210,340,130,1,00134,India
518339,2023-12-04,207,coca cola,75,100,25,1,00326,India
518339,2023-12-04,204,strawberry yogurt,50,60,10,1,00326,India
518339,2023-12-04,201,paneer,210,340,130,1,00326,India
421337,2023-12-04,213,bisleri,6,15,9,1,00419,India
421337,2023-12-04,208,sprite,75,100,25,1,00419,India
421337,2023-12-04,202,milk,12,27,15,1,00419,India
926862,2023-12-04,203,mango yogurt,50,60,10,1,00011,India
926862,2023-12-04,213,bisleri,6,15,9,1,00011,India
926862,2023-12-04,212,amul cheese,250,315,65,1,00011,India
926862,2023-12-04,211,red bull,90,125,35,1,00011,India
926862,2023-12-04,204,strawberry yogurt,50,60,10,1,00011,India
469086,2023-12-04,211,red bull,90,125,35,1,00141,India
271408,2023-12-04,206,yakult,360,400,40,1,00013,India
271408,2023-12-04,208,sprite,75,100,25,1,00013,India
271408,2023-12-04,211,red bull,90,125,35,1,00013,India
271408,2023-12-04,204,strawberry yogurt,50,60,10,1,00013,India
598220,2023-12-04,202,milk,12,27,15,1,00432,India
598220,2023-12-04,213,bisleri,6,15,9,1,00432,India
373903,2023-12-04,211,red bull,90,125,35,1,00412,India
373903,2023-12-04,210,mountain dew,75,100,25,1,00412,India
373903,2023-12-04,205,classic yogurt,45,60,15,1,00412,India
802897,2023-12-04,207,coca cola,75,100,25,1,00155,India
802897,2023-12-04,204,strawberry yogurt,50,60,10,1,00155,India
802897,2023-12-04,209,pepsi,75,100,25,1,00155,India
802897,2023-12-04,205,classic yogurt,45,60,15,1,00155,India
180118,2023-12-04,213,bisleri,6,15,9,1,00136,India
180118,2023-12-04,205,classic yogurt,45,60,15,1,00136,India
180118,2023-12-04,209,pepsi,75,100,25,1,00136,India
180118,2023-12-04,204,strawberry yogurt,50,60,10,1,00136,India
619763,2023-12-04,213,bisleri,6,15,9,1,00366,India
619763,2023-12-04,205,classic yogurt,45,60,15,1,00366,India
619763,2023-12-04,212,amul cheese,250,315,65,1,00366,India
619763,2023-12-04,203,mango yogurt,50,60,10,1,00366,India
991453,2023-12-04,206,yakult,360,400,40,1,00343,India
991453,2023-12-04,204,strawberry yogurt,50,60,10,1,00343,India
593358,2023-12-04,207,coca cola,75,100,25,1,00471,India
434275,2023-12-04,212,amul cheese,250,315,65,1,00178,India
434275,2023-12-04,205,classic yogurt,45,60,15,1,00178,India
434275,2023-12-04,213,bisleri,6,15,9,1,00178,India
434275,2023-12-04,206,yakult,360,400,40,1,00178,India
106611,2023-12-04,207,coca cola,75,100,25,1,00308,India
176689,2023-12-04,213,bisleri,6,15,9,1,00391,India
134440,2023-12-04,213,bisleri,6,15,9,1,00029,India
134440,2023-12-04,202,milk,12,27,15,1,00029,India
241920,2023-12-04,201,paneer,210,340,130,1,00102,India
241920,2023-12-04,206,yakult,360,400,40,1,00102,India
231563,2023-12-04,209,pepsi,75,100,25,1,00069,India
231563,2023-12-04,205,classic yogurt,45,60,15,1,00069,India
900008,2023-12-04,209,pepsi,75,100,25,1,00340,India
900008,2023-12-04,210,mountain dew,75,100,25,1,00340,India
900008,2023-12-04,212,amul cheese,250,315,65,1,00340,India
465595,2023-12-04,212,amul cheese,250,315,65,1,00165,India
465595,2023-12-04,210,mountain dew,75,100,25,1,00165,India
826000,2023-12-04,212,amul cheese,250,315,65,1,00325,India
826000,2023-12-04,208,sprite,75,100,25,1,00325,India
826000,2023-12-04,205,classic yogurt,45,60,15,1,00325,India
901332,2023-12-04,206,yakult,360,400,40,1,00222,India
564405,2023-12-04,211,red bull,90,125,35,1,00341,India
564405,2023-12-04,213,bisleri,6,15,9,1,00341,India
564405,2023-12-04,210,mountain dew,75,100,25,1,00341,India
387858,2023-12-04,202,milk,12,27,15,1,00459,India
387858,2023-12-04,211,red bull,90,125,35,1,00459,India
387858,2023-12-04,208,sprite,75,100,25,1,00459,India
387858,2023-12-04,203,mango yogurt,50,60,10,1,00459,India
131537,2023-12-04,212,amul cheese,250,315,65,1,00035,India
131537,2023-12-04,205,classic yogurt,45,60,15,1,00035,India
424747,2023-12-04,212,amul cheese,250,315,65,1,00100,India
764506,2023-12-04,201,paneer,210,340,130,1,00328,India
764506,2023-12-04,212,amul cheese,250,315,65,1,00328,India
764506,2023-12-04,202,milk,12,27,15,1,00328,India
764506,2023-12-04,203,mango yogurt,50,60,10,1,00328,India
432196,2023-12-04,201,paneer,210,340,130,1,00489,India
432413,2023-12-04,201,paneer,210,340,130,1,00400,India
432413,2023-12-04,213,bisleri,6,15,9,1,00400,India
432413,2023-12-04,212,amul cheese,250,315,65,1,00400,India
539612,2023-12-04,206,yakult,360,400,40,1,00393,India
539612,2023-12-04,205,classic yogurt,45,60,15,1,00393,India
452445,2023-12-04,212,amul cheese,250,315,65,1,00398,India
561058,2023-12-04,213,bisleri,6,15,9,1,00371,India
561058,2023-12-04,210,mountain dew,75,100,25,1,00371,India
561058,2023-12-04,209,pepsi,75,100,25,1,00371,India
561058,2023-12-04,201,paneer,210,340,130,1,00371,India
222261,2023-12-04,211,red bull,90,125,35,1,00377,India
222261,2023-12-04,202,milk,12,27,15,1,00377,India
222261,2023-12-04,203,mango yogurt,50,60,10,1,00377,India
222261,2023-12-04,204,strawberry yogurt,50,60,10,1,00377,India
427402,2023-12-04,201,paneer,210,340,130,1,00451,India
427402,2023-12-04,205,classic yogurt,45,60,15,1,00451,India
427402,2023-12-04,204,strawberry yogurt,50,60,10,1,00451,India
427402,2023-12-04,211,red bull,90,125,35,1,00451,India
427402,2023-12-04,202,milk,12,27,15,1,00451,India
925228,2023-12-04,206,yakult,360,400,40,1,00319,India
925228,2023-12-04,209,pepsi,75,100,25,1,00319,India
925228,2023-12-04,211,red bull,90,125,35,1,00319,India
925228,2023-12-04,212,amul cheese,250,315,65,1,00319,India
942983,2023-12-04,205,classic yogurt,45,60,15,1,00176,India
331549,2023-12-04,204,strawberry yogurt,50,60,10,1,00279,India
331549,2023-12-04,213,bisleri,6,15,9,1,00279,India
520565,2023-12-04,204,strawberry yogurt,50,60,10,1,00094,India
520565,2023-12-04,202,milk,12,27,15,1,00094,India
762173,2023-12-04,203,mango yogurt,50,60,10,1,00284,India
762173,2023-12-04,213,bisleri,6,15,9,1,00284,India
341992,2023-12-04,209,pepsi,75,100,25,1,00054,India
341992,2023-12-04,207,coca cola,75,100,25,1,00054,India
341992,2023-12-04,203,mango yogurt,50,60,10,1,00054,India
341992,2023-12-04,213,bisleri,6,15,9,1,00054,India
640001,2023-12-04,203,mango yogurt,50,60,10,1,00458,India
640001,2023-12-04,204,strawberry yogurt,50,60,10,1,00458,India
640001,2023-12-04,210,mountain dew,75,100,25,1,00458,India
737703,2023-12-04,202,milk,12,27,15,1,00126,India
737703,2023-12-04,213,bisleri,6,15,9,1,00126,India
666352,2023-12-04,210,mountain dew,75,100,25,1,00242,India
666352,2023-12-04,206,yakult,360,400,40,1,00242,India
666352,2023-12-04,212,amul cheese,250,315,65,1,00242,India
649017,2023-12-04,201,paneer,210,340,130,1,00396,India
733184,2023-12-04,213,bisleri,6,15,9,1,00416,India
733184,2023-12-04,205,classic yogurt,45,60,15,1,00416,India
733184,2023-12-04,204,strawberry yogurt,50,60,10,1,00416,India
733184,2023-12-04,209,pepsi,75,100,25,1,00416,India
385325,2023-12-04,208,sprite,75,100,25,1,00216,India
385325,2023-12-04,209,pepsi,75,100,25,1,00216,India
385325,2023-12-04,212,amul cheese,250,315,65,1,00216,India
554220,2023-12-04,202,milk,12,27,15,1,00257,India
554220,2023-12-04,207,coca cola,75,100,25,1,00257,India
554220,2023-12-04,212,amul cheese,250,315,65,1,00257,India
554220,2023-12-04,210,mountain dew,75,100,25,1,00257,India
887608,2023-12-04,208,sprite,75,100,25,1,00037,India
887608,2023-12-04,206,yakult,360,400,40,1,00037,India
991270,2023-12-04,204,strawberry yogurt,50,60,10,1,00482,India
991270,2023-12-04,205,classic yogurt,45,60,15,1,00482,India
898394,2023-12-04,202,milk,12,27,15,1,00233,India
898394,2023-12-04,207,coca cola,75,100,25,1,00233,India
898394,2023-12-04,210,mountain dew,75,100,25,1,00233,India
898394,2023-12-04,208,sprite,75,100,25,1,00233,India
898394,2023-12-04,211,red bull,90,125,35,1,00233,India
848796,2023-12-04,205,classic yogurt,45,60,15,1,00486,India
848796,2023-12-04,209,pepsi,75,100,25,1,00486,India
848796,2023-12-04,204,strawberry yogurt,50,60,10,1,00486,India
848796,2023-12-04,206,yakult,360,400,40,1,00486,India
275416,2023-12-04,202,milk,12,27,15,1,00056,India
275416,2023-12-04,205,classic yogurt,45,60,15,1,00056,India
275416,2023-12-04,209,pepsi,75,100,25,1,00056,India
885633,2023-12-04,210,mountain dew,75,100,25,1,00169,India
885633,2023-12-04,201,paneer,210,340,130,1,00169,India
885633,2023-12-04,204,strawberry yogurt,50,60,10,1,00169,India
885633,2023-12-04,208,sprite,75,100,25,1,00169,India
977844,2023-12-04,212,amul cheese,250,315,65,1,00013,India
977844,2023-12-04,206,yakult,360,400,40,1,00013,India
516872,2023-12-04,206,yakult,360,400,40,1,00277,India
972200,2023-12-04,209,pepsi,75,100,25,1,00282,India
972200,2023-12-04,211,red bull,90,125,35,1,00282,India
972200,2023-12-04,210,mountain dew,75,100,25,1,00282,India
213343,2023-12-04,212,amul cheese,250,315,65,1,00383,India
213343,2023-12-04,202,milk,12,27,15,1,00383,India
213343,2023-12-04,211,red bull,90,125,35,1,00383,India
213343,2023-12-04,205,classic yogurt,45,60,15,1,00383,India
531781,2023-12-04,211,red bull,90,125,35,1,00385,India
531781,2023-12-04,204,strawberry yogurt,50,60,10,1,00385,India
531781,2023-12-04,202,milk,12,27,15,1,00385,India
969990,2023-12-04,202,milk,12,27,15,1,00176,India
467133,2023-12-04,213,bisleri,6,15,9,1,00399,India
467133,2023-12-04,206,yakult,360,400,40,1,00399,India
467133,2023-12-04,210,mountain dew,75,100,25,1,00399,India
467133,2023-12-04,211,red bull,90,125,35,1,00399,India
103030,2023-12-04,210,mountain dew,75,100,25,1,00177,India
103030,2023-12-04,211,red bull,90,125,35,1,00177,India
103030,2023-12-04,206,yakult,360,400,40,1,00177,India
103030,2023-12-04,208,sprite,75,100,25,1,00177,India
268432,2023-12-04,202,milk,12,27,15,1,00257,India
413591,2023-12-04,205,classic yogurt,45,60,15,1,00365,India
316176,2023-12-05,205,classic yogurt,45,60,15,1,00260,India
236501,2023-12-05,212,amul cheese,250,315,65,1,00166,India
236501,2023-12-05,208,sprite,75,100,25,1,00166,India
989413,2023-12-05,203,mango yogurt,50,60,10,1,00091,India
989413,2023-12-05,201,paneer,210,340,130,1,00091,India
989413,2023-12-05,211,red bull,90,125,35,1,00091,India
702978,2023-12-05,208,sprite,75,100,25,1,00365,India
702978,2023-12-05,201,paneer,210,340,130,1,00365,India
187904,2023-12-05,201,paneer,210,340,130,1,00292,India
187904,2023-12-05,204,strawberry yogurt,50,60,10,1,00292,India
992183,2023-12-05,212,amul cheese,250,315,65,1,00149,India
992183,2023-12-05,207,coca cola,75,100,25,1,00149,India
992183,2023-12-05,208,sprite,75,100,25,1,00149,India
992183,2023-12-05,211,red bull,90,125,35,1,00149,India
198242,2023-12-05,210,mountain dew,75,100,25,1,00438,India
759003,2023-12-05,208,sprite,75,100,25,1,00161,India
606852,2023-12-05,204,strawberry yogurt,50,60,10,1,00072,India
606852,2023-12-05,207,coca cola,75,100,25,1,00072,India
606852,2023-12-05,211,red bull,90,125,35,1,00072,India
249076,2023-12-05,203,mango yogurt,50,60,10,1,00085,India
249076,2023-12-05,213,bisleri,6,15,9,1,00085,India
249076,2023-12-05,209,pepsi,75,100,25,1,00085,India
249076,2023-12-05,202,milk,12,27,15,1,00085,India
330463,2023-12-05,201,paneer,210,340,130,1,00348,India
330463,2023-12-05,213,bisleri,6,15,9,1,00348,India
316954,2023-12-05,210,mountain dew,75,100,25,1,00107,India
316954,2023-12-05,213,bisleri,6,15,9,1,00107,India
316954,2023-12-05,212,amul cheese,250,315,65,1,00107,India
652841,2023-12-05,210,mountain dew,75,100,25,1,00122,India
617576,2023-12-05,201,paneer,210,340,130,1,00154,India
617576,2023-12-05,209,pepsi,75,100,25,1,00154,India
617576,2023-12-05,213,bisleri,6,15,9,1,00154,India
617576,2023-12-05,211,red bull,90,125,35,1,00154,India
187437,2023-12-05,205,classic yogurt,45,60,15,1,00041,India
187437,2023-12-05,204,strawberry yogurt,50,60,10,1,00041,India
368671,2023-12-05,212,amul cheese,250,315,65,1,00299,India
368671,2023-12-05,202,milk,12,27,15,1,00299,India
368671,2023-12-05,206,yakult,360,400,40,1,00299,India
368671,2023-12-05,210,mountain dew,75,100,25,1,00299,India
425439,2023-12-05,206,yakult,360,400,40,1,00404,India
425439,2023-12-05,202,milk,12,27,15,1,00404,India
158179,2023-12-05,203,mango yogurt,50,60,10,1,00030,India
158179,2023-12-05,209,pepsi,75,100,25,1,00030,India
196902,2023-12-05,201,paneer,210,340,130,1,00283,India
196902,2023-12-05,203,mango yogurt,50,60,10,1,00283,India
196902,2023-12-05,207,coca cola,75,100,25,1,00283,India
196902,2023-12-05,205,classic yogurt,45,60,15,1,00283,India
196902,2023-12-05,206,yakult,360,400,40,1,00283,India
241468,2023-12-05,213,bisleri,6,15,9,1,00212,India
241468,2023-12-05,209,pepsi,75,100,25,1,00212,India
241468,2023-12-05,204,strawberry yogurt,50,60,10,1,00212,India
434038,2023-12-05,207,coca cola,75,100,25,1,00482,India
434038,2023-12-05,201,paneer,210,340,130,1,00482,India
147523,2023-12-05,201,paneer,210,340,130,1,00198,India
147523,2023-12-05,206,yakult,360,400,40,1,00198,India
147523,2023-12-05,212,amul cheese,250,315,65,1,00198,India
524849,2023-12-05,208,sprite,75,100,25,1,00301,India
596061,2023-12-05,211,red bull,90,125,35,1,00397,India
766069,2023-12-05,210,mountain dew,75,100,25,1,00124,India
766069,2023-12-05,213,bisleri,6,15,9,1,00124,India
766069,2023-12-05,211,red bull,90,125,35,1,00124,India
891528,2023-12-05,202,milk,12,27,15,1,00233,India
382968,2023-12-05,207,coca cola,75,100,25,1,00108,India
382968,2023-12-05,201,paneer,210,340,130,1,00108,India
382968,2023-12-05,211,red bull,90,125,35,1,00108,India
382968,2023-12-05,209,pepsi,75,100,25,1,00108,India
606865,2023-12-05,205,classic yogurt,45,60,15,1,00043,India
499966,2023-12-05,201,paneer,210,340,130,1,00480,India
570812,2023-12-05,209,pepsi,75,100,25,1,00328,India
850508,2023-12-05,209,pepsi,75,100,25,1,00231,India
850508,2023-12-05,208,sprite,75,100,25,1,00231,India
850508,2023-12-05,211,red bull,90,125,35,1,00231,India
886652,2023-12-05,207,coca cola,75,100,25,1,00371,India
886652,2023-12-05,202,milk,12,27,15,1,00371,India
886652,2023-12-05,209,pepsi,75,100,25,1,00371,India
253750,2023-12-05,207,coca cola,75,100,25,1,00180,India
253750,2023-12-05,211,red bull,90,125,35,1,00180,India
253750,2023-12-05,204,strawberry yogurt,50,60,10,1,00180,India
253750,2023-12-05,210,mountain dew,75,100,25,1,00180,India
650826,2023-12-05,209,pepsi,75,100,25,1,00278,India
650826,2023-12-05,213,bisleri,6,15,9,1,00278,India
740312,2023-12-05,209,pepsi,75,100,25,1,00343,India
740312,2023-12-05,203,mango yogurt,50,60,10,1,00343,India
740312,2023-12-05,210,mountain dew,75,100,25,1,00343,India
143426,2023-12-05,201,paneer,210,340,130,1,00411,India
143426,2023-12-05,208,sprite,75,100,25,1,00411,India
143426,2023-12-05,211,red bull,90,125,35,1,00411,India
143426,2023-12-05,205,classic yogurt,45,60,15,1,00411,India
143426,2023-12-05,212,amul cheese,250,315,65,1,00411,India
133042,2023-12-05,206,yakult,360,400,40,1,00449,India
133042,2023-12-05,208,sprite,75,100,25,1,00449,India
133042,2023-12-05,210,mountain dew,75,100,25,1,00449,India
762786,2023-12-05,207,coca cola,75,100,25,1,00039,India
481669,2023-12-05,202,milk,12,27,15,1,00263,India
481669,2023-12-05,203,mango yogurt,50,60,10,1,00263,India
441341,2023-12-05,201,paneer,210,340,130,1,00285,India
820115,2023-12-05,202,milk,12,27,15,1,00477,India
416383,2023-12-05,205,classic yogurt,45,60,15,1,00497,India
416383,2023-12-05,206,yakult,360,400,40,1,00497,India
416383,2023-12-05,208,sprite,75,100,25,1,00497,India
416383,2023-12-05,213,bisleri,6,15,9,1,00497,India
114896,2023-12-05,205,classic yogurt,45,60,15,1,00259,India
114896,2023-12-05,204,strawberry yogurt,50,60,10,1,00259,India
452062,2023-12-05,213,bisleri,6,15,9,1,00104,India
732488,2023-12-05,212,amul cheese,250,315,65,1,00472,India
659552,2023-12-05,206,yakult,360,400,40,1,00058,India
659552,2023-12-05,210,mountain dew,75,100,25,1,00058,India
659552,2023-12-05,209,pepsi,75,100,25,1,00058,India
998909,2023-12-05,207,coca cola,75,100,25,1,00454,India
998909,2023-12-05,201,paneer,210,340,130,1,00454,India
998909,2023-12-05,203,mango yogurt,50,60,10,1,00454,India
142438,2023-12-05,205,classic yogurt,45,60,15,1,00424,India
142438,2023-12-05,210,mountain dew,75,100,25,1,00424,India
142438,2023-12-05,204,strawberry yogurt,50,60,10,1,00424,India
142438,2023-12-05,207,coca cola,75,100,25,1,00424,India
297260,2023-12-05,201,paneer,210,340,130,1,00222,India
297260,2023-12-05,208,sprite,75,100,25,1,00222,India
297260,2023-12-05,207,coca cola,75,100,25,1,00222,India
297260,2023-12-05,213,bisleri,6,15,9,1,00222,India
297260,2023-12-05,210,mountain dew,75,100,25,1,00222,India
696274,2023-12-05,202,milk,12,27,15,1,00206,India
696274,2023-12-05,207,coca cola,75,100,25,1,00206,India
696274,2023-12-05,206,yakult,360,400,40,1,00206,India
696274,2023-12-05,203,mango yogurt,50,60,10,1,00206,India
827202,2023-12-05,207,coca cola,75,100,25,1,00277,India
827202,2023-12-05,204,strawberry yogurt,50,60,10,1,00277,India
827202,2023-12-05,203,mango yogurt,50,60,10,1,00277,India
827202,2023-12-05,208,sprite,75,100,25,1,00277,India
576497,2023-12-05,205,classic yogurt,45,60,15,1,00029,India
576497,2023-12-05,204,strawberry yogurt,50,60,10,1,00029,India
576497,2023-12-05,211,red bull,90,125,35,1,00029,India
576497,2023-12-05,202,milk,12,27,15,1,00029,India
703098,2023-12-05,203,mango yogurt,50,60,10,1,00253,India
276421,2023-12-05,201,paneer,210,340,130,1,00344,India
276421,2023-12-05,212,amul cheese,250,315,65,1,00344,India
456689,2023-12-05,211,red bull,90,125,35,1,00137,India
456689,2023-12-05,205,classic yogurt,45,60,15,1,00137,India
456689,2023-12-05,208,sprite,75,100,25,1,00137,India
456689,2023-12-05,204,strawberry yogurt,50,60,10,1,00137,India
662946,2023-12-05,205,classic yogurt,45,60,15,1,00098,India
662946,2023-12-05,209,pepsi,75,100,25,1,00098,India
662946,2023-12-05,208,sprite,75,100,25,1,00098,India
794873,2023-12-05,203,mango yogurt,50,60,10,1,00339,India
794873,2023-12-05,212,amul cheese,250,315,65,1,00339,India
903135,2023-12-05,210,mountain dew,75,100,25,1,00037,India
903135,2023-12-05,204,strawberry yogurt,50,60,10,1,00037,India
903135,2023-12-05,213,bisleri,6,15,9,1,00037,India
886067,2023-12-05,202,milk,12,27,15,1,00339,India
886067,2023-12-05,212,amul cheese,250,315,65,1,00339,India
886067,2023-12-05,201,paneer,210,340,130,1,00339,India
886067,2023-12-05,206,yakult,360,400,40,1,00339,India
102376,2023-12-05,202,milk,12,27,15,1,00390,India
102376,2023-12-05,207,coca cola,75,100,25,1,00390,India
102376,2023-12-05,206,yakult,360,400,40,1,00390,India
502724,2023-12-05,203,mango yogurt,50,60,10,1,00132,India
433156,2023-12-05,204,strawberry yogurt,50,60,10,1,00106,India
433156,2023-12-05,201,paneer,210,340,130,1,00106,India
579951,2023-12-05,212,amul cheese,250,315,65,1,00003,India
579951,2023-12-05,202,milk,12,27,15,1,00003,India
579951,2023-12-05,206,yakult,360,400,40,1,00003,India
579951,2023-12-05,211,red bull,90,125,35,1,00003,India
369058,2023-12-05,212,amul cheese,250,315,65,1,00231,India
369058,2023-12-05,201,paneer,210,340,130,1,00231,India
369058,2023-12-05,213,bisleri,6,15,9,1,00231,India
369058,2023-12-05,204,strawberry yogurt,50,60,10,1,00231,India
369058,2023-12-05,202,milk,12,27,15,1,00231,India
633086,2023-12-05,206,yakult,360,400,40,1,00107,India
530393,2023-12-05,201,paneer,210,340,130,1,00233,India
530393,2023-12-05,206,yakult,360,400,40,1,00233,India
295220,2023-12-05,203,mango yogurt,50,60,10,1,00441,India
107067,2023-12-05,201,paneer,210,340,130,1,00310,India
107067,2023-12-05,204,strawberry yogurt,50,60,10,1,00310,India
107067,2023-12-05,208,sprite,75,100,25,1,00310,India
107067,2023-12-05,212,amul cheese,250,315,65,1,00310,India
119791,2023-12-05,212,amul cheese,250,315,65,1,00272,India
119791,2023-12-05,206,yakult,360,400,40,1,00272,India
119791,2023-12-05,210,mountain dew,75,100,25,1,00272,India
597978,2023-12-05,204,strawberry yogurt,50,60,10,1,00423,India
220877,2023-12-05,209,pepsi,75,100,25,1,00490,India
220877,2023-12-05,205,classic yogurt,45,60,15,1,00490,India
220877,2023-12-05,206,yakult,360,400,40,1,00490,India
750468,2023-12-05,202,milk,12,27,15,1,00446,India
750468,2023-12-05,210,mountain dew,75,100,25,1,00446,India
750468,2023-12-05,201,paneer,210,340,130,1,00446,India
861326,2023-12-05,206,yakult,360,400,40,1,00193,India
111079,2023-12-05,207,coca cola,75,100,25,1,00401,India
111079,2023-12-05,209,pepsi,75,100,25,1,00401,India
111079,2023-12-05,212,amul cheese,250,315,65,1,00401,India
873903,2023-12-05,212,amul cheese,250,315,65,1,00288,India
873903,2023-12-05,206,yakult,360,400,40,1,00288,India
873903,2023-12-05,203,mango yogurt,50,60,10,1,00288,India
873903,2023-12-05,207,coca cola,75,100,25,1,00288,India
238510,2023-12-05,207,coca cola,75,100,25,1,00288,India
238510,2023-12-05,212,amul cheese,250,315,65,1,00288,India
238510,2023-12-05,201,paneer,210,340,130,1,00288,India
238510,2023-12-05,213,bisleri,6,15,9,1,00288,India
238510,2023-12-05,204,strawberry yogurt,50,60,10,1,00288,India
643775,2023-12-05,206,yakult,360,400,40,1,00470,India
643775,2023-12-05,213,bisleri,6,15,9,1,00470,India
643775,2023-12-05,212,amul cheese,250,315,65,1,00470,India
449855,2023-12-05,213,bisleri,6,15,9,1,00258,India
449855,2023-12-05,209,pepsi,75,100,25,1,00258,India
449855,2023-12-05,212,amul cheese,250,315,65,1,00258,India
787214,2023-12-05,210,mountain dew,75,100,25,1,00073,India
787214,2023-12-05,212,amul cheese,250,315,65,1,00073,India
489313,2023-12-05,209,pepsi,75,100,25,1,00190,India
489313,2023-12-05,205,classic yogurt,45,60,15,1,00190,India
962005,2023-12-05,203,mango yogurt,50,60,10,1,00498,India
962005,2023-12-05,206,yakult,360,400,40,1,00498,India
962005,2023-12-05,204,strawberry yogurt,50,60,10,1,00498,India
962005,2023-12-05,211,red bull,90,125,35,1,00498,India
796533,2023-12-05,201,paneer,210,340,130,1,00106,India
796533,2023-12-05,202,milk,12,27,15,1,00106,India
796533,2023-12-05,203,mango yogurt,50,60,10,1,00106,India
796533,2023-12-05,213,bisleri,6,15,9,1,00106,India
370756,2023-12-05,209,pepsi,75,100,25,1,00082,India
110462,2023-12-05,201,paneer,210,340,130,1,00172,India
110462,2023-12-05,208,sprite,75,100,25,1,00172,India
793932,2023-12-05,205,classic yogurt,45,60,15,1,00298,India
793932,2023-12-05,209,pepsi,75,100,25,1,00298,India
947399,2023-12-05,203,mango yogurt,50,60,10,1,00295,India
947399,2023-12-05,201,paneer,210,340,130,1,00295,India
947399,2023-12-05,213,bisleri,6,15,9,1,00295,India
300854,2023-12-05,212,amul cheese,250,315,65,1,00240,India
300854,2023-12-05,207,coca cola,75,100,25,1,00240,India
300854,2023-12-05,210,mountain dew,75,100,25,1,00240,India
300854,2023-12-05,209,pepsi,75,100,25,1,00240,India
648289,2023-12-05,204,strawberry yogurt,50,60,10,1,00331,India
648289,2023-12-05,201,paneer,210,340,130,1,00331,India
648289,2023-12-05,211,red bull,90,125,35,1,00331,India
648289,2023-12-05,209,pepsi,75,100,25,1,00331,India
368339,2023-12-05,212,amul cheese,250,315,65,1,00081,India
368339,2023-12-05,209,pepsi,75,100,25,1,00081,India
368339,2023-12-05,201,paneer,210,340,130,1,00081,India
368339,2023-12-05,203,mango yogurt,50,60,10,1,00081,India
200748,2023-12-06,210,mountain dew,75,100,25,1,00344,India
200748,2023-12-06,207,coca cola,75,100,25,1,00344,India
853081,2023-12-06,205,classic yogurt,45,60,15,1,00036,India
853081,2023-12-06,209,pepsi,75,100,25,1,00036,India
169716,2023-12-06,205,classic yogurt,45,60,15,1,00388,India
169716,2023-12-06,212,amul cheese,250,315,65,1,00388,India
677133,2023-12-06,203,mango yogurt,50,60,10,1,00118,India
677133,2023-12-06,201,paneer,210,340,130,1,00118,India
677133,2023-12-06,212,amul cheese,250,315,65,1,00118,India
796855,2023-12-06,206,yakult,360,400,40,1,00490,India
796855,2023-12-06,204,strawberry yogurt,50,60,10,1,00490,India
796855,2023-12-06,207,coca cola,75,100,25,1,00490,India
129169,2023-12-06,209,pepsi,75,100,25,1,00390,India
129169,2023-12-06,213,bisleri,6,15,9,1,00390,India
431357,2023-12-06,208,sprite,75,100,25,1,00175,India
431357,2023-12-06,209,pepsi,75,100,25,1,00175,India
431357,2023-12-06,207,coca cola,75,100,25,1,00175,India
448374,2023-12-06,208,sprite,75,100,25,1,00207,India
448374,2023-12-06,210,mountain dew,75,100,25,1,00207,India
983084,2023-12-06,212,amul cheese,250,315,65,1,00199,India
983084,2023-12-06,204,strawberry yogurt,50,60,10,1,00199,India
195869,2023-12-06,206,yakult,360,400,40,1,00426,India
195869,2023-12-06,212,amul cheese,250,315,65,1,00426,India
875157,2023-12-06,208,sprite,75,100,25,1,00465,India
875157,2023-12-06,202,milk,12,27,15,1,00465,India
652910,2023-12-06,213,bisleri,6,15,9,1,00498,India
217095,2023-12-06,201,paneer,210,340,130,1,00324,India
217095,2023-12-06,210,mountain dew,75,100,25,1,00324,India
217095,2023-12-06,203,mango yogurt,50,60,10,1,00324,India
545059,2023-12-06,211,red bull,90,125,35,1,00402,India
545059,2023-12-06,209,pepsi,75,100,25,1,00402,India
545059,2023-12-06,206,yakult,360,400,40,1,00402,India
245807,2023-12-06,203,mango yogurt,50,60,10,1,00043,India
245807,2023-12-06,208,sprite,75,100,25,1,00043,India
152431,2023-12-06,211,red bull,90,125,35,1,00367,India
152431,2023-12-06,208,sprite,75,100,25,1,00367,India
726545,2023-12-06,213,bisleri,6,15,9,1,00188,India
726545,2023-12-06,212,amul cheese,250,315,65,1,00188,India
726545,2023-12-06,208,sprite,75,100,25,1,00188,India
147882,2023-12-06,206,yakult,360,400,40,1,00395,India
920163,2023-12-06,210,mountain dew,75,100,25,1,00175,India
920163,2023-12-06,211,red bull,90,125,35,1,00175,India
920163,2023-12-06,203,mango yogurt,50,60,10,1,00175,India
738423,2023-12-06,212,amul cheese,250,315,65,1,00417,India
208384,2023-12-06,207,coca cola,75,100,25,1,00087,India
208384,2023-12-06,213,bisleri,6,15,9,1,00087,India
132001,2023-12-06,213,bisleri,6,15,9,1,00068,India
132001,2023-12-06,203,mango yogurt,50,60,10,1,00068,India
183680,2023-12-06,207,coca cola,75,100,25,1,00485,India
183680,2023-12-06,211,red bull,90,125,35,1,00485,India
183680,2023-12-06,205,classic yogurt,45,60,15,1,00485,India
706652,2023-12-06,206,yakult,360,400,40,1,00086,India
706652,2023-12-06,204,strawberry yogurt,50,60,10,1,00086,India
706652,2023-12-06,209,pepsi,75,100,25,1,00086,India
706652,2023-12-06,201,paneer,210,340,130,1,00086,India
532524,2023-12-06,211,red bull,90,125,35,1,00463,India
532524,2023-12-06,201,paneer,210,340,130,1,00463,India
349222,2023-12-06,205,classic yogurt,45,60,15,1,00037,India
349222,2023-12-06,201,paneer,210,340,130,1,00037,India
349222,2023-12-06,207,coca cola,75,100,25,1,00037,India
625181,2023-12-06,201,paneer,210,340,130,1,00203,India
625181,2023-12-06,213,bisleri,6,15,9,1,00203,India
639253,2023-12-06,202,milk,12,27,15,1,00303,India
639253,2023-12-06,209,pepsi,75,100,25,1,00303,India
639253,2023-12-06,204,strawberry yogurt,50,60,10,1,00303,India
639253,2023-12-06,213,bisleri,6,15,9,1,00303,India
130526,2023-12-06,203,mango yogurt,50,60,10,1,00438,India
130526,2023-12-06,205,classic yogurt,45,60,15,1,00438,India
130526,2023-12-06,211,red bull,90,125,35,1,00438,India
130526,2023-12-06,202,milk,12,27,15,1,00438,India
130526,2023-12-06,213,bisleri,6,15,9,1,00438,India
584545,2023-12-06,210,mountain dew,75,100,25,1,00256,India
584545,2023-12-06,207,coca cola,75,100,25,1,00256,India
427853,2023-12-06,202,milk,12,27,15,1,00498,India
427853,2023-12-06,206,yakult,360,400,40,1,00498,India
427853,2023-12-06,210,mountain dew,75,100,25,1,00498,India
676578,2023-12-06,201,paneer,210,340,130,1,00132,India
676578,2023-12-06,207,coca cola,75,100,25,1,00132,India
676578,2023-12-06,205,classic yogurt,45,60,15,1,00132,India
676578,2023-12-06,209,pepsi,75,100,25,1,00132,India
846295,2023-12-06,202,milk,12,27,15,1,00123,India
846295,2023-12-06,205,classic yogurt,45,60,15,1,00123,India
840787,2023-12-06,202,milk,12,27,15,1,00169,India
899603,2023-12-06,209,pepsi,75,100,25,1,00099,India
899603,2023-12-06,207,coca cola,75,100,25,1,00099,India
899603,2023-12-06,203,mango yogurt,50,60,10,1,00099,India
899603,2023-12-06,201,paneer,210,340,130,1,00099,India
716139,2023-12-06,210,mountain dew,75,100,25,1,00313,India
716139,2023-12-06,203,mango yogurt,50,60,10,1,00313,India
364359,2023-12-06,208,sprite,75,100,25,1,00165,India
364359,2023-12-06,211,red bull,90,125,35,1,00165,India
364359,2023-12-06,204,strawberry yogurt,50,60,10,1,00165,India
166185,2023-12-06,201,paneer,210,340,130,1,00146,India
166185,2023-12-06,206,yakult,360,400,40,1,00146,India
918901,2023-12-06,207,coca cola,75,100,25,1,00433,India
439291,2023-12-06,209,pepsi,75,100,25,1,00319,India
439291,2023-12-06,211,red bull,90,125,35,1,00319,India
439291,2023-12-06,203,mango yogurt,50,60,10,1,00319,India
439291,2023-12-06,213,bisleri,6,15,9,1,00319,India
485281,2023-12-06,202,milk,12,27,15,1,00217,India
485281,2023-12-06,213,bisleri,6,15,9,1,00217,India
485281,2023-12-06,210,mountain dew,75,100,25,1,00217,India
485281,2023-12-06,205,classic yogurt,45,60,15,1,00217,India
622718,2023-12-06,201,paneer,210,340,130,1,00422,India
622718,2023-12-06,203,mango yogurt,50,60,10,1,00422,India
622718,2023-12-06,211,red bull,90,125,35,1,00422,India
622718,2023-12-06,204,strawberry yogurt,50,60,10,1,00422,India
622718,2023-12-06,209,pepsi,75,100,25,1,00422,India
421042,2023-12-06,203,mango yogurt,50,60,10,1,00339,India
155990,2023-12-06,201,paneer,210,340,130,1,00422,India
155990,2023-12-06,202,milk,12,27,15,1,00422,India
798073,2023-12-06,204,strawberry yogurt,50,60,10,1,00072,India
798073,2023-12-06,212,amul cheese,250,315,65,1,00072,India
742179,2023-12-06,205,classic yogurt,45,60,15,1,00166,India
742179,2023-12-06,208,sprite,75,100,25,1,00166,India
742179,2023-12-06,210,mountain dew,75,100,25,1,00166,India
742179,2023-12-06,206,yakult,360,400,40,1,00166,India
903577,2023-12-06,204,strawberry yogurt,50,60,10,1,00290,India
643434,2023-12-06,201,paneer,210,340,130,1,00220,India
643434,2023-12-06,212,amul cheese,250,315,65,1,00220,India
564367,2023-12-06,208,sprite,75,100,25,1,00075,India
564367,2023-12-06,212,amul cheese,250,315,65,1,00075,India
564367,2023-12-06,209,pepsi,75,100,25,1,00075,India
836521,2023-12-06,205,classic yogurt,45,60,15,1,00410,India
836521,2023-12-06,202,milk,12,27,15,1,00410,India
937066,2023-12-06,204,strawberry yogurt,50,60,10,1,00065,India
937066,2023-12-06,211,red bull,90,125,35,1,00065,India
110613,2023-12-06,207,coca cola,75,100,25,1,00443,India
110613,2023-12-06,202,milk,12,27,15,1,00443,India
110613,2023-12-06,205,classic yogurt,45,60,15,1,00443,India
110613,2023-12-06,208,sprite,75,100,25,1,00443,India
891827,2023-12-06,213,bisleri,6,15,9,1,00115,India
891827,2023-12-06,205,classic yogurt,45,60,15,1,00115,India
891827,2023-12-06,210,mountain dew,75,100,25,1,00115,India
891827,2023-12-06,202,milk,12,27,15,1,00115,India
486635,2023-12-06,213,bisleri,6,15,9,1,00252,India
486635,2023-12-06,205,classic yogurt,45,60,15,1,00252,India
386997,2023-12-06,204,strawberry yogurt,50,60,10,1,00413,India
386997,2023-12-06,211,red bull,90,125,35,1,00413,India
297701,2023-12-06,211,red bull,90,125,35,1,00145,India
635849,2023-12-06,204,strawberry yogurt,50,60,10,1,00256,India
635849,2023-12-06,202,milk,12,27,15,1,00256,India
635849,2023-12-06,206,yakult,360,400,40,1,00256,India
635849,2023-12-06,205,classic yogurt,45,60,15,1,00256,India
914101,2023-12-06,209,pepsi,75,100,25,1,00330,India
914101,2023-12-06,210,mountain dew,75,100,25,1,00330,India
914101,2023-12-06,212,amul cheese,250,315,65,1,00330,India
914101,2023-12-06,205,classic yogurt,45,60,15,1,00330,India
762000,2023-12-06,207,coca cola,75,100,25,1,00411,India
862372,2023-12-06,207,coca cola,75,100,25,1,00079,India
862372,2023-12-06,209,pepsi,75,100,25,1,00079,India
862372,2023-12-06,201,paneer,210,340,130,1,00079,India
862372,2023-12-06,206,yakult,360,400,40,1,00079,India
631742,2023-12-06,203,mango yogurt,50,60,10,1,00133,India
631742,2023-12-06,202,milk,12,27,15,1,00133,India
631742,2023-12-06,211,red bull,90,125,35,1,00133,India
983266,2023-12-06,208,sprite,75,100,25,1,00192,India
983266,2023-12-06,209,pepsi,75,100,25,1,00192,India
983266,2023-12-06,211,red bull,90,125,35,1,00192,India
217945,2023-12-06,202,milk,12,27,15,1,00334,India
217945,2023-12-06,205,classic yogurt,45,60,15,1,00334,India
214010,2023-12-06,204,strawberry yogurt,50,60,10,1,00288,India
214010,2023-12-06,208,sprite,75,100,25,1,00288,India
214010,2023-12-06,206,yakult,360,400,40,1,00288,India
724191,2023-12-06,210,mountain dew,75,100,25,1,00414,India
724191,2023-12-06,201,paneer,210,340,130,1,00414,India
591940,2023-12-06,206,yakult,360,400,40,1,00184,India
591940,2023-12-06,213,bisleri,6,15,9,1,00184,India
591940,2023-12-06,203,mango yogurt,50,60,10,1,00184,India
591940,2023-12-06,210,mountain dew,75,100,25,1,00184,India
951911,2023-12-06,205,classic yogurt,45,60,15,1,00111,India
951911,2023-12-06,211,red bull,90,125,35,1,00111,India
467548,2023-12-06,210,mountain dew,75,100,25,1,00496,India
467548,2023-12-06,204,strawberry yogurt,50,60,10,1,00496,India
467548,2023-12-06,207,coca cola,75,100,25,1,00496,India
467548,2023-12-06,202,milk,12,27,15,1,00496,India
353070,2023-12-06,203,mango yogurt,50,60,10,1,00016,India
353070,2023-12-06,204,strawberry yogurt,50,60,10,1,00016,India
353070,2023-12-06,208,sprite,75,100,25,1,00016,India
353070,2023-12-06,211,red bull,90,125,35,1,00016,India
783447,2023-12-06,202,milk,12,27,15,1,00434,India
783447,2023-12-06,205,classic yogurt,45,60,15,1,00434,India
169365,2023-12-06,207,coca cola,75,100,25,1,00015,India
169365,2023-12-06,208,sprite,75,100,25,1,00015,India
169365,2023-12-06,209,pepsi,75,100,25,1,00015,India
845980,2023-12-06,204,strawberry yogurt,50,60,10,1,00224,India
845980,2023-12-06,207,coca cola,75,100,25,1,00224,India
845980,2023-12-06,211,red bull,90,125,35,1,00224,India
845980,2023-12-06,210,mountain dew,75,100,25,1,00224,India
845980,2023-12-06,213,bisleri,6,15,9,1,00224,India
553991,2023-12-06,210,mountain dew,75,100,25,1,00223,India
553991,2023-12-06,202,milk,12,27,15,1,00223,India
553991,2023-12-06,213,bisleri,6,15,9,1,00223,India
553991,2023-12-06,211,red bull,90,125,35,1,00223,India
864499,2023-12-06,212,amul cheese,250,315,65,1,00252,India
864499,2023-12-06,206,yakult,360,400,40,1,00252,India
864499,2023-12-06,205,classic yogurt,45,60,15,1,00252,India
864499,2023-12-06,204,strawberry yogurt,50,60,10,1,00252,India
139796,2023-12-06,211,red bull,90,125,35,1,00289,India
139796,2023-12-06,202,milk,12,27,15,1,00289,India
744029,2023-12-06,210,mountain dew,75,100,25,1,00375,India
744029,2023-12-06,211,red bull,90,125,35,1,00375,India
744029,2023-12-06,201,paneer,210,340,130,1,00375,India
880145,2023-12-06,205,classic yogurt,45,60,15,1,00245,India
880145,2023-12-06,202,milk,12,27,15,1,00245,India
256646,2023-12-06,201,paneer,210,340,130,1,00047,India
256646,2023-12-06,205,classic yogurt,45,60,15,1,00047,India
256646,2023-12-06,203,mango yogurt,50,60,10,1,00047,India
892986,2023-12-06,212,amul cheese,250,315,65,1,00371,India
892986,2023-12-06,201,paneer,210,340,130,1,00371,India
892986,2023-12-06,210,mountain dew,75,100,25,1,00371,India
892986,2023-12-06,203,mango yogurt,50,60,10,1,00371,India
577218,2023-12-06,208,sprite,75,100,25,1,00422,India
577218,2023-12-06,210,mountain dew,75,100,25,1,00422,India
577218,2023-12-06,205,classic yogurt,45,60,15,1,00422,India
256170,2023-12-06,209,pepsi,75,100,25,1,00297,India
256170,2023-12-06,211,red bull,90,125,35,1,00297,India
256170,2023-12-06,203,mango yogurt,50,60,10,1,00297,India
574815,2023-12-06,202,milk,12,27,15,1,00123,India
574815,2023-12-06,206,yakult,360,400,40,1,00123,India
574815,2023-12-06,212,amul cheese,250,315,65,1,00123,India
345289,2023-12-06,206,yakult,360,400,40,1,00322,India
345289,2023-12-06,210,mountain dew,75,100,25,1,00322,India
345289,2023-12-06,202,milk,12,27,15,1,00322,India
345289,2023-12-06,204,strawberry yogurt,50,60,10,1,00322,India
345289,2023-12-06,211,red bull,90,125,35,1,00322,India
396409,2023-12-06,212,amul cheese,250,315,65,1,00179,India
396409,2023-12-06,202,milk,12,27,15,1,00179,India
396409,2023-12-06,203,mango yogurt,50,60,10,1,00179,India
620367,2023-12-06,206,yakult,360,400,40,1,00428,India
620367,2023-12-06,212,amul cheese,250,315,65,1,00428,India
620367,2023-12-06,211,red bull,90,125,35,1,00428,India
319424,2023-12-06,208,sprite,75,100,25,1,00228,India
319424,2023-12-06,211,red bull,90,125,35,1,00228,India
516268,2023-12-06,212,amul cheese,250,315,65,1,00332,India
516268,2023-12-06,203,mango yogurt,50,60,10,1,00332,India
516268,2023-12-06,209,pepsi,75,100,25,1,00332,India
621348,2023-12-06,209,pepsi,75,100,25,1,00359,India
621348,2023-12-06,207,coca cola,75,100,25,1,00359,India
621348,2023-12-06,201,paneer,210,340,130,1,00359,India
621348,2023-12-06,206,yakult,360,400,40,1,00359,India
503037,2023-12-06,207,coca cola,75,100,25,1,00287,India
503037,2023-12-06,205,classic yogurt,45,60,15,1,00287,India
503037,2023-12-06,212,amul cheese,250,315,65,1,00287,India
207758,2023-12-06,205,classic yogurt,45,60,15,1,00298,India
207758,2023-12-06,211,red bull,90,125,35,1,00298,India
207758,2023-12-06,213,bisleri,6,15,9,1,00298,India
941326,2023-12-06,203,mango yogurt,50,60,10,1,00066,India
941326,2023-12-06,209,pepsi,75,100,25,1,00066,India
760046,2023-12-06,209,pepsi,75,100,25,1,00078,India
760046,2023-12-06,208,sprite,75,100,25,1,00078,India
760046,2023-12-06,202,milk,12,27,15,1,00078,India
921806,2023-12-06,206,yakult,360,400,40,1,00466,India
921806,2023-12-06,213,bisleri,6,15,9,1,00466,India
910799,2023-12-07,211,red bull,90,125,35,1,00285,India
910799,2023-12-07,206,yakult,360,400,40,1,00285,India
910799,2023-12-07,205,classic yogurt,45,60,15,1,00285,India
910799,2023-12-07,208,sprite,75,100,25,1,00285,India
995976,2023-12-07,203,mango yogurt,50,60,10,1,00128,India
795125,2023-12-07,203,mango yogurt,50,60,10,1,00212,India
795125,2023-12-07,207,coca cola,75,100,25,1,00212,India
792955,2023-12-07,204,strawberry yogurt,50,60,10,1,00063,India
792955,2023-12-07,205,classic yogurt,45,60,15,1,00063,India
792955,2023-12-07,203,mango yogurt,50,60,10,1,00063,India
971801,2023-12-07,211,red bull,90,125,35,1,00336,India
971801,2023-12-07,210,mountain dew,75,100,25,1,00336,India
971801,2023-12-07,202,milk,12,27,15,1,00336,India
692527,2023-12-07,206,yakult,360,400,40,1,00307,India
692527,2023-12-07,205,classic yogurt,45,60,15,1,00307,India
908064,2023-12-07,212,amul cheese,250,315,65,1,00071,India
908064,2023-12-07,202,milk,12,27,15,1,00071,India
908064,2023-12-07,209,pepsi,75,100,25,1,00071,India
156053,2023-12-07,201,paneer,210,340,130,1,00054,India
156053,2023-12-07,206,yakult,360,400,40,1,00054,India
156053,2023-12-07,202,milk,12,27,15,1,00054,India
231045,2023-12-07,206,yakult,360,400,40,1,00370,India
231045,2023-12-07,210,mountain dew,75,100,25,1,00370,India
231045,2023-12-07,204,strawberry yogurt,50,60,10,1,00370,India
991079,2023-12-07,208,sprite,75,100,25,1,00236,India
991079,2023-12-07,209,pepsi,75,100,25,1,00236,India
991079,2023-12-07,213,bisleri,6,15,9,1,00236,India
991079,2023-12-07,212,amul cheese,250,315,65,1,00236,India
984839,2023-12-07,210,mountain dew,75,100,25,1,00386,India
883465,2023-12-07,210,mountain dew,75,100,25,1,00153,India
431658,2023-12-07,202,milk,12,27,15,1,00199,India
431658,2023-12-07,204,strawberry yogurt,50,60,10,1,00199,India
431658,2023-12-07,207,coca cola,75,100,25,1,00199,India
431658,2023-12-07,212,amul cheese,250,315,65,1,00199,India
431658,2023-12-07,201,paneer,210,340,130,1,00199,India
808705,2023-12-07,208,sprite,75,100,25,1,00261,India
808705,2023-12-07,205,classic yogurt,45,60,15,1,00261,India
808705,2023-12-07,202,milk,12,27,15,1,00261,India
230946,2023-12-07,206,yakult,360,400,40,1,00468,India
322787,2023-12-07,210,mountain dew,75,100,25,1,00110,India
322787,2023-12-07,203,mango yogurt,50,60,10,1,00110,India
322787,2023-12-07,209,pepsi,75,100,25,1,00110,India
111823,2023-12-07,203,mango yogurt,50,60,10,1,00002,India
836866,2023-12-07,205,classic yogurt,45,60,15,1,00416,India
836866,2023-12-07,212,amul cheese,250,315,65,1,00416,India
836866,2023-12-07,206,yakult,360,400,40,1,00416,India
709812,2023-12-07,207,coca cola,75,100,25,1,00027,India
709812,2023-12-07,209,pepsi,75,100,25,1,00027,India
709812,2023-12-07,201,paneer,210,340,130,1,00027,India
709812,2023-12-07,208,sprite,75,100,25,1,00027,India
928098,2023-12-07,209,pepsi,75,100,25,1,00443,India
928098,2023-12-07,211,red bull,90,125,35,1,00443,India
928098,2023-12-07,204,strawberry yogurt,50,60,10,1,00443,India
928098,2023-12-07,203,mango yogurt,50,60,10,1,00443,India
928098,2023-12-07,212,amul cheese,250,315,65,1,00443,India
569733,2023-12-07,210,mountain dew,75,100,25,1,00234,India
569733,2023-12-07,212,amul cheese,250,315,65,1,00234,India
569733,2023-12-07,213,bisleri,6,15,9,1,00234,India
181562,2023-12-07,210,mountain dew,75,100,25,1,00079,India
930782,2023-12-07,208,sprite,75,100,25,1,00123,India
930782,2023-12-07,205,classic yogurt,45,60,15,1,00123,India
930782,2023-12-07,209,pepsi,75,100,25,1,00123,India
702869,2023-12-07,202,milk,12,27,15,1,00466,India
249271,2023-12-07,203,mango yogurt,50,60,10,1,00204,India
249271,2023-12-07,201,paneer,210,340,130,1,00204,India
249271,2023-12-07,212,amul cheese,250,315,65,1,00204,India
669212,2023-12-07,208,sprite,75,100,25,1,00071,India
500469,2023-12-07,209,pepsi,75,100,25,1,00222,India
500469,2023-12-07,211,red bull,90,125,35,1,00222,India
209076,2023-12-07,213,bisleri,6,15,9,1,00387,India
209076,2023-12-07,205,classic yogurt,45,60,15,1,00387,India
209076,2023-12-07,204,strawberry yogurt,50,60,10,1,00387,India
209076,2023-12-07,209,pepsi,75,100,25,1,00387,India
975455,2023-12-07,207,coca cola,75,100,25,1,00127,India
975455,2023-12-07,211,red bull,90,125,35,1,00127,India
708895,2023-12-07,209,pepsi,75,100,25,1,00412,India
479445,2023-12-07,204,strawberry yogurt,50,60,10,1,00109,India
479445,2023-12-07,205,classic yogurt,45,60,15,1,00109,India
155291,2023-12-07,209,pepsi,75,100,25,1,00095,India
155291,2023-12-07,207,coca cola,75,100,25,1,00095,India
155291,2023-12-07,206,yakult,360,400,40,1,00095,India
462401,2023-12-07,208,sprite,75,100,25,1,00324,India
462401,2023-12-07,207,coca cola,75,100,25,1,00324,India
462401,2023-12-07,212,amul cheese,250,315,65,1,00324,India
667362,2023-12-07,203,mango yogurt,50,60,10,1,00281,India
667362,2023-12-07,208,sprite,75,100,25,1,00281,India
667362,2023-12-07,213,bisleri,6,15,9,1,00281,India
667362,2023-12-07,205,classic yogurt,45,60,15,1,00281,India
980566,2023-12-07,205,classic yogurt,45,60,15,1,00464,India
980566,2023-12-07,212,amul cheese,250,315,65,1,00464,India
980566,2023-12-07,208,sprite,75,100,25,1,00464,India
980566,2023-12-07,201,paneer,210,340,130,1,00464,India
514735,2023-12-07,206,yakult,360,400,40,1,00326,India
792266,2023-12-07,205,classic yogurt,45,60,15,1,00374,India
792266,2023-12-07,212,amul cheese,250,315,65,1,00374,India
400245,2023-12-07,202,milk,12,27,15,1,00048,India
400245,2023-12-07,203,mango yogurt,50,60,10,1,00048,India
400245,2023-12-07,206,yakult,360,400,40,1,00048,India
400245,2023-12-07,204,strawberry yogurt,50,60,10,1,00048,India
936397,2023-12-07,212,amul cheese,250,315,65,1,00193,India
936397,2023-12-07,204,strawberry yogurt,50,60,10,1,00193,India
936397,2023-12-07,203,mango yogurt,50,60,10,1,00193,India
936397,2023-12-07,207,coca cola,75,100,25,1,00193,India
779324,2023-12-07,206,yakult,360,400,40,1,00310,India
779324,2023-12-07,202,milk,12,27,15,1,00310,India
627184,2023-12-07,203,mango yogurt,50,60,10,1,00423,India
627184,2023-12-07,209,pepsi,75,100,25,1,00423,India
627184,2023-12-07,205,classic yogurt,45,60,15,1,00423,India
627184,2023-12-07,211,red bull,90,125,35,1,00423,India
144187,2023-12-07,202,milk,12,27,15,1,00377,India
144187,2023-12-07,201,paneer,210,340,130,1,00377,India
144187,2023-12-07,205,classic yogurt,45,60,15,1,00377,India
582400,2023-12-07,209,pepsi,75,100,25,1,00014,India
582400,2023-12-07,203,mango yogurt,50,60,10,1,00014,India
582400,2023-12-07,213,bisleri,6,15,9,1,00014,India
582400,2023-12-07,211,red bull,90,125,35,1,00014,India
582400,2023-12-07,208,sprite,75,100,25,1,00014,India
951703,2023-12-07,205,classic yogurt,45,60,15,1,00054,India
951703,2023-12-07,208,sprite,75,100,25,1,00054,India
951703,2023-12-07,203,mango yogurt,50,60,10,1,00054,India
113136,2023-12-07,204,strawberry yogurt,50,60,10,1,00135,India
113136,2023-12-07,205,classic yogurt,45,60,15,1,00135,India
113136,2023-12-07,208,sprite,75,100,25,1,00135,India
113136,2023-12-07,211,red bull,90,125,35,1,00135,India
713843,2023-12-07,201,paneer,210,340,130,1,00063,India
713843,2023-12-07,210,mountain dew,75,100,25,1,00063,India
713843,2023-12-07,206,yakult,360,400,40,1,00063,India
186593,2023-12-07,210,mountain dew,75,100,25,1,00176,India
186593,2023-12-07,201,paneer,210,340,130,1,00176,India
318909,2023-12-07,213,bisleri,6,15,9,1,00207,India
318909,2023-12-07,210,mountain dew,75,100,25,1,00207,India
822778,2023-12-07,209,pepsi,75,100,25,1,00495,India
822778,2023-12-07,206,yakult,360,400,40,1,00495,India
822778,2023-12-07,213,bisleri,6,15,9,1,00495,India
822778,2023-12-07,202,milk,12,27,15,1,00495,India
815624,2023-12-07,204,strawberry yogurt,50,60,10,1,00334,India
119017,2023-12-07,210,mountain dew,75,100,25,1,00246,India
119017,2023-12-07,212,amul cheese,250,315,65,1,00246,India
119017,2023-12-07,202,milk,12,27,15,1,00246,India
119017,2023-12-07,211,red bull,90,125,35,1,00246,India
345083,2023-12-07,204,strawberry yogurt,50,60,10,1,00361,India
345083,2023-12-07,210,mountain dew,75,100,25,1,00361,India
345083,2023-12-07,208,sprite,75,100,25,1,00361,India
252154,2023-12-07,202,milk,12,27,15,1,00092,India
252154,2023-12-07,201,paneer,210,340,130,1,00092,India
252154,2023-12-07,210,mountain dew,75,100,25,1,00092,India
252154,2023-12-07,204,strawberry yogurt,50,60,10,1,00092,India
252154,2023-12-07,203,mango yogurt,50,60,10,1,00092,India
345373,2023-12-07,204,strawberry yogurt,50,60,10,1,00118,India
576531,2023-12-07,211,red bull,90,125,35,1,00145,India
576531,2023-12-07,209,pepsi,75,100,25,1,00145,India
576531,2023-12-07,202,milk,12,27,15,1,00145,India
576531,2023-12-07,206,yakult,360,400,40,1,00145,India
576531,2023-12-07,203,mango yogurt,50,60,10,1,00145,India
252046,2023-12-07,202,milk,12,27,15,1,00046,India
252046,2023-12-07,201,paneer,210,340,130,1,00046,India
252046,2023-12-07,210,mountain dew,75,100,25,1,00046,India
757839,2023-12-07,213,bisleri,6,15,9,1,00356,India
757839,2023-12-07,212,amul cheese,250,315,65,1,00356,India
116211,2023-12-07,211,red bull,90,125,35,1,00146,India
116211,2023-12-07,203,mango yogurt,50,60,10,1,00146,India
116211,2023-12-07,202,milk,12,27,15,1,00146,India
116211,2023-12-07,209,pepsi,75,100,25,1,00146,India
116211,2023-12-07,208,sprite,75,100,25,1,00146,India
744326,2023-12-07,210,mountain dew,75,100,25,1,00431,India
744326,2023-12-07,205,classic yogurt,45,60,15,1,00431,India
744326,2023-12-07,211,red bull,90,125,35,1,00431,India
103247,2023-12-07,201,paneer,210,340,130,1,00025,India
103247,2023-12-07,203,mango yogurt,50,60,10,1,00025,India
456174,2023-12-07,204,strawberry yogurt,50,60,10,1,00098,India
294658,2023-12-07,212,amul cheese,250,315,65,1,00436,India
294658,2023-12-07,203,mango yogurt,50,60,10,1,00436,India
980290,2023-12-07,208,sprite,75,100,25,1,00121,India
980290,2023-12-07,207,coca cola,75,100,25,1,00121,India
980290,2023-12-07,206,yakult,360,400,40,1,00121,India
141060,2023-12-07,208,sprite,75,100,25,1,00206,India
141060,2023-12-07,206,yakult,360,400,40,1,00206,India
141060,2023-12-07,212,amul cheese,250,315,65,1,00206,India
622132,2023-12-07,207,coca cola,75,100,25,1,00292,India
230395,2023-12-07,206,yakult,360,400,40,1,00421,India
230395,2023-12-07,203,mango yogurt,50,60,10,1,00421,India
230395,2023-12-07,201,paneer,210,340,130,1,00421,India
230395,2023-12-07,205,classic yogurt,45,60,15,1,00421,India
579369,2023-12-07,206,yakult,360,400,40,1,00106,India
579369,2023-12-07,210,mountain dew,75,100,25,1,00106,India
579369,2023-12-07,204,strawberry yogurt,50,60,10,1,00106,India
579369,2023-12-07,209,pepsi,75,100,25,1,00106,India
956171,2023-12-07,211,red bull,90,125,35,1,00307,India
956171,2023-12-07,201,paneer,210,340,130,1,00307,India
956171,2023-12-07,210,mountain dew,75,100,25,1,00307,India
983996,2023-12-07,201,paneer,210,340,130,1,00405,India
983996,2023-12-07,209,pepsi,75,100,25,1,00405,India
983996,2023-12-07,207,coca cola,75,100,25,1,00405,India
983996,2023-12-07,206,yakult,360,400,40,1,00405,India
983996,2023-12-07,211,red bull,90,125,35,1,00405,India
383581,2023-12-07,206,yakult,360,400,40,1,00451,India
383581,2023-12-07,201,paneer,210,340,130,1,00451,India
383581,2023-12-07,211,red bull,90,125,35,1,00451,India
383581,2023-12-07,202,milk,12,27,15,1,00451,India
632933,2023-12-07,210,mountain dew,75,100,25,1,00359,India
632933,2023-12-07,212,amul cheese,250,315,65,1,00359,India
632933,2023-12-07,208,sprite,75,100,25,1,00359,India
907615,2023-12-07,201,paneer,210,340,130,1,00332,India
407067,2023-12-07,207,coca cola,75,100,25,1,00158,India
242771,2023-12-07,204,strawberry yogurt,50,60,10,1,00397,India
242771,2023-12-07,202,milk,12,27,15,1,00397,India
242771,2023-12-07,205,classic yogurt,45,60,15,1,00397,India
982953,2023-12-07,203,mango yogurt,50,60,10,1,00121,India
982953,2023-12-07,205,classic yogurt,45,60,15,1,00121,India
713951,2023-12-07,205,classic yogurt,45,60,15,1,00273,India
864179,2023-12-07,206,yakult,360,400,40,1,00082,India
864179,2023-12-07,211,red bull,90,125,35,1,00082,India
864179,2023-12-07,202,milk,12,27,15,1,00082,India
296911,2023-12-07,202,milk,12,27,15,1,00077,India
296911,2023-12-07,210,mountain dew,75,100,25,1,00077,India
489324,2023-12-07,206,yakult,360,400,40,1,00409,India
489324,2023-12-07,210,mountain dew,75,100,25,1,00409,India
489324,2023-12-07,201,paneer,210,340,130,1,00409,India
489324,2023-12-07,213,bisleri,6,15,9,1,00409,India
489324,2023-12-07,203,mango yogurt,50,60,10,1,00409,India
161745,2023-12-07,208,sprite,75,100,25,1,00272,India
161745,2023-12-07,203,mango yogurt,50,60,10,1,00272,India
449651,2023-12-07,213,bisleri,6,15,9,1,00368,India
449651,2023-12-07,212,amul cheese,250,315,65,1,00368,India
449651,2023-12-07,206,yakult,360,400,40,1,00368,India
207840,2023-12-07,207,coca cola,75,100,25,1,00024,India
568879,2023-12-07,208,sprite,75,100,25,1,00019,India
568879,2023-12-07,206,yakult,360,400,40,1,00019,India
568879,2023-12-07,202,milk,12,27,15,1,00019,India
568879,2023-12-07,210,mountain dew,75,100,25,1,00019,India
844226,2023-12-07,211,red bull,90,125,35,1,00267,India
844226,2023-12-07,209,pepsi,75,100,25,1,00267,India
218589,2023-12-08,201,paneer,210,340,130,1,00111,India
218589,2023-12-08,204,strawberry yogurt,50,60,10,1,00111,India
959905,2023-12-08,207,coca cola,75,100,25,1,00456,India
959905,2023-12-08,213,bisleri,6,15,9,1,00456,India
800259,2023-12-08,207,coca cola,75,100,25,1,00078,India
493225,2023-12-08,204,strawberry yogurt,50,60,10,1,00368,India
746298,2023-12-08,206,yakult,360,400,40,1,00466,India
746298,2023-12-08,211,red bull,90,125,35,1,00466,India
746298,2023-12-08,212,amul cheese,250,315,65,1,00466,India
746298,2023-12-08,207,coca cola,75,100,25,1,00466,India
746298,2023-12-08,204,strawberry yogurt,50,60,10,1,00466,India
340624,2023-12-08,210,mountain dew,75,100,25,1,00043,India
598540,2023-12-08,204,strawberry yogurt,50,60,10,1,00030,India
598540,2023-12-08,202,milk,12,27,15,1,00030,India
598540,2023-12-08,206,yakult,360,400,40,1,00030,India
614678,2023-12-08,201,paneer,210,340,130,1,00029,India
614678,2023-12-08,207,coca cola,75,100,25,1,00029,India
614678,2023-12-08,209,pepsi,75,100,25,1,00029,India
614678,2023-12-08,211,red bull,90,125,35,1,00029,India
780811,2023-12-08,204,strawberry yogurt,50,60,10,1,00366,India
780811,2023-12-08,212,amul cheese,250,315,65,1,00366,India
691309,2023-12-08,206,yakult,360,400,40,1,00009,India
691309,2023-12-08,205,classic yogurt,45,60,15,1,00009,India
691309,2023-12-08,204,strawberry yogurt,50,60,10,1,00009,India
691309,2023-12-08,209,pepsi,75,100,25,1,00009,India
667112,2023-12-08,212,amul cheese,250,315,65,1,00004,India
667112,2023-12-08,211,red bull,90,125,35,1,00004,India
818728,2023-12-08,205,classic yogurt,45,60,15,1,00101,India
818728,2023-12-08,210,mountain dew,75,100,25,1,00101,India
818728,2023-12-08,213,bisleri,6,15,9,1,00101,India
818728,2023-12-08,202,milk,12,27,15,1,00101,India
818728,2023-12-08,209,pepsi,75,100,25,1,00101,India
955265,2023-12-08,208,sprite,75,100,25,1,00312,India
955265,2023-12-08,212,amul cheese,250,315,65,1,00312,India
955265,2023-12-08,210,mountain dew,75,100,25,1,00312,India
955265,2023-12-08,204,strawberry yogurt,50,60,10,1,00312,India
760795,2023-12-08,212,amul cheese,250,315,65,1,00428,India
760795,2023-12-08,211,red bull,90,125,35,1,00428,India
190735,2023-12-08,207,coca cola,75,100,25,1,00274,India
190735,2023-12-08,208,sprite,75,100,25,1,00274,India
805720,2023-12-08,211,red bull,90,125,35,1,00236,India
805720,2023-12-08,207,coca cola,75,100,25,1,00236,India
805720,2023-12-08,209,pepsi,75,100,25,1,00236,India
805720,2023-12-08,210,mountain dew,75,100,25,1,00236,India
805720,2023-12-08,202,milk,12,27,15,1,00236,India
893975,2023-12-08,210,mountain dew,75,100,25,1,00066,India
893975,2023-12-08,202,milk,12,27,15,1,00066,India
701254,2023-12-08,210,mountain dew,75,100,25,1,00184,India
701254,2023-12-08,206,yakult,360,400,40,1,00184,India
701254,2023-12-08,207,coca cola,75,100,25,1,00184,India
701254,2023-12-08,213,bisleri,6,15,9,1,00184,India
194116,2023-12-08,209,pepsi,75,100,25,1,00364,India
194116,2023-12-08,211,red bull,90,125,35,1,00364,India
194116,2023-12-08,212,amul cheese,250,315,65,1,00364,India
194116,2023-12-08,206,yakult,360,400,40,1,00364,India
194116,2023-12-08,202,milk,12,27,15,1,00364,India
302334,2023-12-08,202,milk,12,27,15,1,00188,India
302334,2023-12-08,213,bisleri,6,15,9,1,00188,India
302334,2023-12-08,212,amul cheese,250,315,65,1,00188,India
302334,2023-12-08,208,sprite,75,100,25,1,00188,India
673799,2023-12-08,210,mountain dew,75,100,25,1,00354,India
871488,2023-12-08,207,coca cola,75,100,25,1,00092,India
433537,2023-12-08,213,bisleri,6,15,9,1,00323,India
433537,2023-12-08,204,strawberry yogurt,50,60,10,1,00323,India
433537,2023-12-08,210,mountain dew,75,100,25,1,00323,India
385028,2023-12-08,201,paneer,210,340,130,1,00035,India
385028,2023-12-08,209,pepsi,75,100,25,1,00035,India
385028,2023-12-08,206,yakult,360,400,40,1,00035,India
385028,2023-12-08,212,amul cheese,250,315,65,1,00035,India
385028,2023-12-08,203,mango yogurt,50,60,10,1,00035,India
286625,2023-12-08,210,mountain dew,75,100,25,1,00266,India
380452,2023-12-08,207,coca cola,75,100,25,1,00400,India
653327,2023-12-08,206,yakult,360,400,40,1,00263,India
156391,2023-12-08,213,bisleri,6,15,9,1,00386,India
156391,2023-12-08,202,milk,12,27,15,1,00386,India
156391,2023-12-08,203,mango yogurt,50,60,10,1,00386,India
156391,2023-12-08,211,red bull,90,125,35,1,00386,India
841669,2023-12-08,208,sprite,75,100,25,1,00096,India
841669,2023-12-08,212,amul cheese,250,315,65,1,00096,India
347321,2023-12-08,204,strawberry yogurt,50,60,10,1,00290,India
347321,2023-12-08,203,mango yogurt,50,60,10,1,00290,India
347321,2023-12-08,211,red bull,90,125,35,1,00290,India
860571,2023-12-08,206,yakult,360,400,40,1,00254,India
860571,2023-12-08,212,amul cheese,250,315,65,1,00254,India
860571,2023-12-08,207,coca cola,75,100,25,1,00254,India
860571,2023-12-08,211,red bull,90,125,35,1,00254,India
102158,2023-12-08,205,classic yogurt,45,60,15,1,00158,India
570280,2023-12-08,202,milk,12,27,15,1,00051,India
570280,2023-12-08,210,mountain dew,75,100,25,1,00051,India
538316,2023-12-08,209,pepsi,75,100,25,1,00311,India
151114,2023-12-08,211,red bull,90,125,35,1,00032,India
808270,2023-12-08,201,paneer,210,340,130,1,00020,India
808270,2023-12-08,203,mango yogurt,50,60,10,1,00020,India
808270,2023-12-08,209,pepsi,75,100,25,1,00020,India
808270,2023-12-08,202,milk,12,27,15,1,00020,India
969152,2023-12-08,211,red bull,90,125,35,1,00164,India
969152,2023-12-08,203,mango yogurt,50,60,10,1,00164,India
969152,2023-12-08,212,amul cheese,250,315,65,1,00164,India
982734,2023-12-08,205,classic yogurt,45,60,15,1,00258,India
982734,2023-12-08,206,yakult,360,400,40,1,00258,India
982734,2023-12-08,212,amul cheese,250,315,65,1,00258,India
982734,2023-12-08,201,paneer,210,340,130,1,00258,India
729292,2023-12-08,204,strawberry yogurt,50,60,10,1,00462,India
729292,2023-12-08,212,amul cheese,250,315,65,1,00462,India
729292,2023-12-08,205,classic yogurt,45,60,15,1,00462,India
729292,2023-12-08,213,bisleri,6,15,9,1,00462,India
729292,2023-12-08,203,mango yogurt,50,60,10,1,00462,India
983595,2023-12-08,210,mountain dew,75,100,25,1,00096,India
983595,2023-12-08,201,paneer,210,340,130,1,00096,India
174642,2023-12-08,204,strawberry yogurt,50,60,10,1,00112,India
273605,2023-12-08,210,mountain dew,75,100,25,1,00472,India
561131,2023-12-08,206,yakult,360,400,40,1,00018,India
561131,2023-12-08,213,bisleri,6,15,9,1,00018,India
566098,2023-12-08,201,paneer,210,340,130,1,00175,India
566098,2023-12-08,206,yakult,360,400,40,1,00175,India
566098,2023-12-08,209,pepsi,75,100,25,1,00175,India
566098,2023-12-08,211,red bull,90,125,35,1,00175,India
290272,2023-12-08,208,sprite,75,100,25,1,00334,India
290272,2023-12-08,207,coca cola,75,100,25,1,00334,India
290272,2023-12-08,209,pepsi,75,100,25,1,00334,India
290272,2023-12-08,210,mountain dew,75,100,25,1,00334,India
290272,2023-12-08,201,paneer,210,340,130,1,00334,India
761009,2023-12-08,209,pepsi,75,100,25,1,00441,India
761009,2023-12-08,207,coca cola,75,100,25,1,00441,India
761009,2023-12-08,201,paneer,210,340,130,1,00441,India
761009,2023-12-08,210,mountain dew,75,100,25,1,00441,India
174723,2023-12-08,204,strawberry yogurt,50,60,10,1,00207,India
174723,2023-12-08,210,mountain dew,75,100,25,1,00207,India
174723,2023-12-08,203,mango yogurt,50,60,10,1,00207,India
791469,2023-12-08,205,classic yogurt,45,60,15,1,00268,India
791469,2023-12-08,203,mango yogurt,50,60,10,1,00268,India
791469,2023-12-08,201,paneer,210,340,130,1,00268,India
791469,2023-12-08,213,bisleri,6,15,9,1,00268,India
879604,2023-12-08,210,mountain dew,75,100,25,1,00089,India
879604,2023-12-08,203,mango yogurt,50,60,10,1,00089,India
247085,2023-12-08,207,coca cola,75,100,25,1,00161,India
183367,2023-12-08,207,coca cola,75,100,25,1,00352,India
183367,2023-12-08,201,paneer,210,340,130,1,00352,India
183367,2023-12-08,202,milk,12,27,15,1,00352,India
183367,2023-12-08,205,classic yogurt,45,60,15,1,00352,India
535634,2023-12-08,201,paneer,210,340,130,1,00328,India
535634,2023-12-08,202,milk,12,27,15,1,00328,India
535634,2023-12-08,210,mountain dew,75,100,25,1,00328,India
535634,2023-12-08,209,pepsi,75,100,25,1,00328,India
535634,2023-12-08,205,classic yogurt,45,60,15,1,00328,India
924879,2023-12-08,212,amul cheese,250,315,65,1,00181,India
924879,2023-12-08,209,pepsi,75,100,25,1,00181,India
924879,2023-12-08,207,coca cola,75,100,25,1,00181,India
600031,2023-12-08,212,amul cheese,250,315,65,1,00320,India
600031,2023-12-08,209,pepsi,75,100,25,1,00320,India
600031,2023-12-08,205,classic yogurt,45,60,15,1,00320,India
690895,2023-12-08,206,yakult,360,400,40,1,00357,India
690895,2023-12-08,204,strawberry yogurt,50,60,10,1,00357,India
702079,2023-12-08,201,paneer,210,340,130,1,00151,India
702079,2023-12-08,210,mountain dew,75,100,25,1,00151,India
702079,2023-12-08,212,amul cheese,250,315,65,1,00151,India
702079,2023-12-08,213,bisleri,6,15,9,1,00151,India
374694,2023-12-08,202,milk,12,27,15,1,00072,India
374694,2023-12-08,204,strawberry yogurt,50,60,10,1,00072,India
374694,2023-12-08,201,paneer,210,340,130,1,00072,India
318539,2023-12-08,212,amul cheese,250,315,65,1,00120,India
318539,2023-12-08,210,mountain dew,75,100,25,1,00120,India
318539,2023-12-08,209,pepsi,75,100,25,1,00120,India
657056,2023-12-08,207,coca cola,75,100,25,1,00103,India
860345,2023-12-08,205,classic yogurt,45,60,15,1,00201,India
105830,2023-12-08,202,milk,12,27,15,1,00129,India
955786,2023-12-08,202,milk,12,27,15,1,00495,India
955786,2023-12-08,210,mountain dew,75,100,25,1,00495,India
955786,2023-12-08,209,pepsi,75,100,25,1,00495,India
175804,2023-12-08,208,sprite,75,100,25,1,00235,India
175804,2023-12-08,206,yakult,360,400,40,1,00235,India
175804,2023-12-08,205,classic yogurt,45,60,15,1,00235,India
749856,2023-12-08,211,red bull,90,125,35,1,00185,India
652183,2023-12-08,210,mountain dew,75,100,25,1,00178,India
155556,2023-12-08,203,mango yogurt,50,60,10,1,00313,India
155556,2023-12-08,207,coca cola,75,100,25,1,00313,India
155556,2023-12-08,204,strawberry yogurt,50,60,10,1,00313,India
746677,2023-12-08,202,milk,12,27,15,1,00418,India
746677,2023-12-08,208,sprite,75,100,25,1,00418,India
746677,2023-12-08,203,mango yogurt,50,60,10,1,00418,India
746677,2023-12-08,201,paneer,210,340,130,1,00418,India
746677,2023-12-08,211,red bull,90,125,35,1,00418,India
801024,2023-12-08,204,strawberry yogurt,50,60,10,1,00443,India
801024,2023-12-08,206,yakult,360,400,40,1,00443,India
801024,2023-12-08,203,mango yogurt,50,60,10,1,00443,India
801024,2023-12-08,201,paneer,210,340,130,1,00443,India
151938,2023-12-08,201,paneer,210,340,130,1,00231,India
151938,2023-12-08,204,strawberry yogurt,50,60,10,1,00231,India
151938,2023-12-08,209,pepsi,75,100,25,1,00231,India
151938,2023-12-08,210,mountain dew,75,100,25,1,00231,India
914623,2023-12-08,208,sprite,75,100,25,1,00134,India
914623,2023-12-08,205,classic yogurt,45,60,15,1,00134,India
941612,2023-12-08,209,pepsi,75,100,25,1,00433,India
941612,2023-12-08,210,mountain dew,75,100,25,1,00433,India
941612,2023-12-08,202,milk,12,27,15,1,00433,India
941612,2023-12-08,213,bisleri,6,15,9,1,00433,India
941612,2023-12-08,207,coca cola,75,100,25,1,00433,India
965270,2023-12-08,206,yakult,360,400,40,1,00224,India
965270,2023-12-08,208,sprite,75,100,25,1,00224,India
965270,2023-12-08,212,amul cheese,250,315,65,1,00224,India
330129,2023-12-08,211,red bull,90,125,35,1,00275,India
330129,2023-12-08,202,milk,12,27,15,1,00275,India
330129,2023-12-08,208,sprite,75,100,25,1,00275,India
717509,2023-12-08,211,red bull,90,125,35,1,00423,India
717509,2023-12-08,207,coca cola,75,100,25,1,00423,India
116767,2023-12-08,209,pepsi,75,100,25,1,00333,India
116767,2023-12-08,213,bisleri,6,15,9,1,00333,India
116767,2023-12-08,202,milk,12,27,15,1,00333,India
187484,2023-12-08,203,mango yogurt,50,60,10,1,00129,India
187484,2023-12-08,208,sprite,75,100,25,1,00129,India
288607,2023-12-08,205,classic yogurt,45,60,15,1,00351,India
288607,2023-12-08,213,bisleri,6,15,9,1,00351,India
288607,2023-12-08,212,amul cheese,250,315,65,1,00351,India
288607,2023-12-08,206,yakult,360,400,40,1,00351,India
739399,2023-12-08,213,bisleri,6,15,9,1,00194,India
739399,2023-12-08,208,sprite,75,100,25,1,00194,India
291941,2023-12-08,213,bisleri,6,15,9,1,00047,India
291941,2023-12-08,203,mango yogurt,50,60,10,1,00047,India
291941,2023-12-08,209,pepsi,75,100,25,1,00047,India
523179,2023-12-08,213,bisleri,6,15,9,1,00146,India
523179,2023-12-08,202,milk,12,27,15,1,00146,India
850026,2023-12-08,204,strawberry yogurt,50,60,10,1,00364,India
434581,2023-12-08,202,milk,12,27,15,1,00002,India
434581,2023-12-08,204,strawberry yogurt,50,60,10,1,00002,India
434581,2023-12-08,213,bisleri,6,15,9,1,00002,India
434581,2023-12-08,201,paneer,210,340,130,1,00002,India
610386,2023-12-08,202,milk,12,27,15,1,00456,India
610386,2023-12-08,209,pepsi,75,100,25,1,00456,India
280088,2023-12-08,208,sprite,75,100,25,1,00107,India
280088,2023-12-08,204,strawberry yogurt,50,60,10,1,00107,India
314443,2023-12-09,206,yakult,360,400,40,1,00342,India
371331,2023-12-09,209,pepsi,75,100,25,1,00338,India
237930,2023-12-09,203,mango yogurt,50,60,10,1,00371,India
237930,2023-12-09,201,paneer,210,340,130,1,00371,India
237930,2023-12-09,212,amul cheese,250,315,65,1,00371,India
358168,2023-12-09,204,strawberry yogurt,50,60,10,1,00119,India
358168,2023-12-09,207,coca cola,75,100,25,1,00119,India
407846,2023-12-09,209,pepsi,75,100,25,1,00093,India
407846,2023-12-09,206,yakult,360,400,40,1,00093,India
407846,2023-12-09,212,amul cheese,250,315,65,1,00093,India
407846,2023-12-09,203,mango yogurt,50,60,10,1,00093,India
609766,2023-12-09,213,bisleri,6,15,9,1,00406,India
609766,2023-12-09,209,pepsi,75,100,25,1,00406,India
609766,2023-12-09,206,yakult,360,400,40,1,00406,India
772784,2023-12-09,205,classic yogurt,45,60,15,1,00099,India
772784,2023-12-09,203,mango yogurt,50,60,10,1,00099,India
311652,2023-12-09,202,milk,12,27,15,1,00104,India
311652,2023-12-09,206,yakult,360,400,40,1,00104,India
311652,2023-12-09,205,classic yogurt,45,60,15,1,00104,India
311652,2023-12-09,209,pepsi,75,100,25,1,00104,India
510632,2023-12-09,213,bisleri,6,15,9,1,00453,India
637688,2023-12-09,202,milk,12,27,15,1,00442,India
637688,2023-12-09,211,red bull,90,125,35,1,00442,India
567388,2023-12-09,212,amul cheese,250,315,65,1,00394,India
567388,2023-12-09,205,classic yogurt,45,60,15,1,00394,India
893331,2023-12-09,211,red bull,90,125,35,1,00223,India
893331,2023-12-09,212,amul cheese,250,315,65,1,00223,India
893331,2023-12-09,204,strawberry yogurt,50,60,10,1,00223,India
855458,2023-12-09,209,pepsi,75,100,25,1,00173,India
855458,2023-12-09,212,amul cheese,250,315,65,1,00173,India
296197,2023-12-09,212,amul cheese,250,315,65,1,00289,India
296197,2023-12-09,201,paneer,210,340,130,1,00289,India
800203,2023-12-09,208,sprite,75,100,25,1,00283,India
844388,2023-12-09,201,paneer,210,340,130,1,00327,India
434593,2023-12-09,206,yakult,360,400,40,1,00469,India
744489,2023-12-09,205,classic yogurt,45,60,15,1,00166,India
744489,2023-12-09,211,red bull,90,125,35,1,00166,India
744489,2023-12-09,206,yakult,360,400,40,1,00166,India
744489,2023-12-09,207,coca cola,75,100,25,1,00166,India
744489,2023-12-09,212,amul cheese,250,315,65,1,00166,India
415786,2023-12-09,206,yakult,360,400,40,1,00166,India
415786,2023-12-09,211,red bull,90,125,35,1,00166,India
415786,2023-12-09,210,mountain dew,75,100,25,1,00166,India
238131,2023-12-09,204,strawberry yogurt,50,60,10,1,00372,India
238131,2023-12-09,201,paneer,210,340,130,1,00372,India
369388,2023-12-09,210,mountain dew,75,100,25,1,00300,India
309324,2023-12-09,201,paneer,210,340,130,1,00349,India
309324,2023-12-09,211,red bull,90,125,35,1,00349,India
384514,2023-12-09,207,coca cola,75,100,25,1,00297,India
817200,2023-12-09,211,red bull,90,125,35,1,00182,India
817200,2023-12-09,202,milk,12,27,15,1,00182,India
817200,2023-12-09,206,yakult,360,400,40,1,00182,India
817200,2023-12-09,207,coca cola,75,100,25,1,00182,India
531466,2023-12-09,210,mountain dew,75,100,25,1,00489,India
531466,2023-12-09,202,milk,12,27,15,1,00489,India
531466,2023-12-09,206,yakult,360,400,40,1,00489,India
531466,2023-12-09,205,classic yogurt,45,60,15,1,00489,India
908966,2023-12-09,201,paneer,210,340,130,1,00167,India
908966,2023-12-09,209,pepsi,75,100,25,1,00167,India
908966,2023-12-09,213,bisleri,6,15,9,1,00167,India
908966,2023-12-09,204,strawberry yogurt,50,60,10,1,00167,India
908966,2023-12-09,206,yakult,360,400,40,1,00167,India
719286,2023-12-09,210,mountain dew,75,100,25,1,00028,India
719286,2023-12-09,203,mango yogurt,50,60,10,1,00028,India
719286,2023-12-09,211,red bull,90,125,35,1,00028,India
719286,2023-12-09,208,sprite,75,100,25,1,00028,India
719286,2023-12-09,213,bisleri,6,15,9,1,00028,India
470358,2023-12-09,213,bisleri,6,15,9,1,00500,India
470358,2023-12-09,208,sprite,75,100,25,1,00500,India
470358,2023-12-09,206,yakult,360,400,40,1,00500,India
470358,2023-12-09,205,classic yogurt,45,60,15,1,00500,India
675642,2023-12-09,201,paneer,210,340,130,1,00041,India
675642,2023-12-09,202,milk,12,27,15,1,00041,India
675642,2023-12-09,203,mango yogurt,50,60,10,1,00041,India
287706,2023-12-09,208,sprite,75,100,25,1,00310,India
287706,2023-12-09,209,pepsi,75,100,25,1,00310,India
287706,2023-12-09,202,milk,12,27,15,1,00310,India
909299,2023-12-09,207,coca cola,75,100,25,1,00473,India
907631,2023-12-09,211,red bull,90,125,35,1,00025,India
907631,2023-12-09,205,classic yogurt,45,60,15,1,00025,India
780814,2023-12-09,204,strawberry yogurt,50,60,10,1,00121,India
780814,2023-12-09,203,mango yogurt,50,60,10,1,00121,India
780814,2023-12-09,207,coca cola,75,100,25,1,00121,India
194386,2023-12-09,213,bisleri,6,15,9,1,00028,India
194386,2023-12-09,201,paneer,210,340,130,1,00028,India
982142,2023-12-09,205,classic yogurt,45,60,15,1,00051,India
982142,2023-12-09,204,strawberry yogurt,50,60,10,1,00051,India
982142,2023-12-09,209,pepsi,75,100,25,1,00051,India
296969,2023-12-09,213,bisleri,6,15,9,1,00355,India
573985,2023-12-09,211,red bull,90,125,35,1,00364,India
573985,2023-12-09,204,strawberry yogurt,50,60,10,1,00364,India
796434,2023-12-09,212,amul cheese,250,315,65,1,00165,India
796434,2023-12-09,202,milk,12,27,15,1,00165,India
482495,2023-12-09,209,pepsi,75,100,25,1,00334,India
482495,2023-12-09,207,coca cola,75,100,25,1,00334,India
536734,2023-12-09,211,red bull,90,125,35,1,00499,India
797326,2023-12-09,213,bisleri,6,15,9,1,00393,India
797326,2023-12-09,208,sprite,75,100,25,1,00393,India
252132,2023-12-09,202,milk,12,27,15,1,00081,India
252132,2023-12-09,204,strawberry yogurt,50,60,10,1,00081,India
982369,2023-12-09,205,classic yogurt,45,60,15,1,00045,India
982369,2023-12-09,211,red bull,90,125,35,1,00045,India
589569,2023-12-09,207,coca cola,75,100,25,1,00432,India
589569,2023-12-09,202,milk,12,27,15,1,00432,India
589569,2023-12-09,213,bisleri,6,15,9,1,00432,India
589569,2023-12-09,211,red bull,90,125,35,1,00432,India
589569,2023-12-09,210,mountain dew,75,100,25,1,00432,India
734985,2023-12-09,209,pepsi,75,100,25,1,00119,India
734985,2023-12-09,210,mountain dew,75,100,25,1,00119,India
734985,2023-12-09,208,sprite,75,100,25,1,00119,India
734985,2023-12-09,207,coca cola,75,100,25,1,00119,India
734985,2023-12-09,213,bisleri,6,15,9,1,00119,India
771365,2023-12-09,211,red bull,90,125,35,1,00322,India
262453,2023-12-09,204,strawberry yogurt,50,60,10,1,00271,India
454330,2023-12-09,209,pepsi,75,100,25,1,00040,India
454330,2023-12-09,207,coca cola,75,100,25,1,00040,India
454330,2023-12-09,211,red bull,90,125,35,1,00040,India
960119,2023-12-09,206,yakult,360,400,40,1,00010,India
960119,2023-12-09,203,mango yogurt,50,60,10,1,00010,India
960119,2023-12-09,205,classic yogurt,45,60,15,1,00010,India
960119,2023-12-09,208,sprite,75,100,25,1,00010,India
908491,2023-12-09,213,bisleri,6,15,9,1,00091,India
908491,2023-12-09,209,pepsi,75,100,25,1,00091,India
908491,2023-12-09,205,classic yogurt,45,60,15,1,00091,India
225084,2023-12-09,208,sprite,75,100,25,1,00221,India
225084,2023-12-09,209,pepsi,75,100,25,1,00221,India
682592,2023-12-09,202,milk,12,27,15,1,00029,India
682592,2023-12-09,212,amul cheese,250,315,65,1,00029,India
682592,2023-12-09,207,coca cola,75,100,25,1,00029,India
638341,2023-12-09,203,mango yogurt,50,60,10,1,00100,India
540011,2023-12-09,206,yakult,360,400,40,1,00203,India
540011,2023-12-09,209,pepsi,75,100,25,1,00203,India
540011,2023-12-09,203,mango yogurt,50,60,10,1,00203,India
540011,2023-12-09,207,coca cola,75,100,25,1,00203,India
596332,2023-12-09,203,mango yogurt,50,60,10,1,00494,India
596332,2023-12-09,206,yakult,360,400,40,1,00494,India
596332,2023-12-09,213,bisleri,6,15,9,1,00494,India
793979,2023-12-09,211,red bull,90,125,35,1,00226,India
793979,2023-12-09,210,mountain dew,75,100,25,1,00226,India
312589,2023-12-09,206,yakult,360,400,40,1,00072,India
312589,2023-12-09,207,coca cola,75,100,25,1,00072,India
312589,2023-12-09,212,amul cheese,250,315,65,1,00072,India
248084,2023-12-09,205,classic yogurt,45,60,15,1,00004,India
248084,2023-12-09,209,pepsi,75,100,25,1,00004,India
248084,2023-12-09,211,red bull,90,125,35,1,00004,India
572342,2023-12-09,202,milk,12,27,15,1,00041,India
572342,2023-12-09,201,paneer,210,340,130,1,00041,India
640345,2023-12-09,207,coca cola,75,100,25,1,00494,India
640345,2023-12-09,205,classic yogurt,45,60,15,1,00494,India
640345,2023-12-09,213,bisleri,6,15,9,1,00494,India
764217,2023-12-09,206,yakult,360,400,40,1,00325,India
764217,2023-12-09,209,pepsi,75,100,25,1,00325,India
764217,2023-12-09,207,coca cola,75,100,25,1,00325,India
764217,2023-12-09,212,amul cheese,250,315,65,1,00325,India
584609,2023-12-09,208,sprite,75,100,25,1,00305,India
305341,2023-12-09,201,paneer,210,340,130,1,00450,India
305341,2023-12-09,205,classic yogurt,45,60,15,1,00450,India
305341,2023-12-09,212,amul cheese,250,315,65,1,00450,India
618438,2023-12-09,212,amul cheese,250,315,65,1,00362,India
618438,2023-12-09,205,classic yogurt,45,60,15,1,00362,India
618438,2023-12-09,202,milk,12,27,15,1,00362,India
618438,2023-12-09,208,sprite,75,100,25,1,00362,India
618438,2023-12-09,209,pepsi,75,100,25,1,00362,India
853400,2023-12-09,201,paneer,210,340,130,1,00265,India
853400,2023-12-09,208,sprite,75,100,25,1,00265,India
853400,2023-12-09,212,amul cheese,250,315,65,1,00265,India
687100,2023-12-09,212,amul cheese,250,315,65,1,00497,India
523481,2023-12-09,211,red bull,90,125,35,1,00220,India
523481,2023-12-09,205,classic yogurt,45,60,15,1,00220,India
523481,2023-12-09,206,yakult,360,400,40,1,00220,India
523481,2023-12-09,202,milk,12,27,15,1,00220,India
678611,2023-12-09,213,bisleri,6,15,9,1,00091,India
678611,2023-12-09,209,pepsi,75,100,25,1,00091,India
336183,2023-12-09,207,coca cola,75,100,25,1,00264,India
336183,2023-12-09,212,amul cheese,250,315,65,1,00264,India
871672,2023-12-09,212,amul cheese,250,315,65,1,00361,India
871672,2023-12-09,207,coca cola,75,100,25,1,00361,India
734127,2023-12-09,204,strawberry yogurt,50,60,10,1,00010,India
734127,2023-12-09,203,mango yogurt,50,60,10,1,00010,India
734127,2023-12-09,202,milk,12,27,15,1,00010,India
734127,2023-12-09,201,paneer,210,340,130,1,00010,India
583132,2023-12-09,203,mango yogurt,50,60,10,1,00055,India
583132,2023-12-09,206,yakult,360,400,40,1,00055,India
502278,2023-12-09,208,sprite,75,100,25,1,00005,India
502278,2023-12-09,212,amul cheese,250,315,65,1,00005,India
502278,2023-12-09,203,mango yogurt,50,60,10,1,00005,India
502278,2023-12-09,202,milk,12,27,15,1,00005,India
989138,2023-12-09,206,yakult,360,400,40,1,00057,India
989138,2023-12-09,211,red bull,90,125,35,1,00057,India
989138,2023-12-09,205,classic yogurt,45,60,15,1,00057,India
764463,2023-12-09,213,bisleri,6,15,9,1,00449,India
764463,2023-12-09,211,red bull,90,125,35,1,00449,India
764463,2023-12-09,208,sprite,75,100,25,1,00449,India
346126,2023-12-09,205,classic yogurt,45,60,15,1,00091,India
346126,2023-12-09,207,coca cola,75,100,25,1,00091,India
346126,2023-12-09,203,mango yogurt,50,60,10,1,00091,India
448481,2023-12-09,209,pepsi,75,100,25,1,00087,India
448481,2023-12-09,205,classic yogurt,45,60,15,1,00087,India
448481,2023-12-09,211,red bull,90,125,35,1,00087,India
448481,2023-12-09,213,bisleri,6,15,9,1,00087,India
590032,2023-12-09,205,classic yogurt,45,60,15,1,00268,India
590032,2023-12-09,201,paneer,210,340,130,1,00268,India
481208,2023-12-09,212,amul cheese,250,315,65,1,00491,India
126111,2023-12-09,213,bisleri,6,15,9,1,00358,India
126111,2023-12-09,203,mango yogurt,50,60,10,1,00358,India
126111,2023-12-09,205,classic yogurt,45,60,15,1,00358,India
126111,2023-12-09,206,yakult,360,400,40,1,00358,India
126111,2023-12-09,209,pepsi,75,100,25,1,00358,India
918784,2023-12-09,203,mango yogurt,50,60,10,1,00332,India
918784,2023-12-09,209,pepsi,75,100,25,1,00332,India
918784,2023-12-09,204,strawberry yogurt,50,60,10,1,00332,India
657954,2023-12-09,213,bisleri,6,15,9,1,00125,India
911914,2023-12-09,208,sprite,75,100,25,1,00281,India
911914,2023-12-09,213,bisleri,6,15,9,1,00281,India
911914,2023-12-09,206,yakult,360,400,40,1,00281,India
810307,2023-12-09,213,bisleri,6,15,9,1,00248,India
810307,2023-12-09,210,mountain dew,75,100,25,1,00248,India
810307,2023-12-09,204,strawberry yogurt,50,60,10,1,00248,India
810307,2023-12-09,207,coca cola,75,100,25,1,00248,India
493828,2023-12-09,212,amul cheese,250,315,65,1,00403,India
493828,2023-12-09,202,milk,12,27,15,1,00403,India
493828,2023-12-09,207,coca cola,75,100,25,1,00403,India
391975,2023-12-09,205,classic yogurt,45,60,15,1,00449,India
391975,2023-12-09,213,bisleri,6,15,9,1,00449,India
391975,2023-12-09,210,mountain dew,75,100,25,1,00449,India
885142,2023-12-09,201,paneer,210,340,130,1,00226,India
426282,2023-12-09,201,paneer,210,340,130,1,00269,India
820847,2023-12-09,213,bisleri,6,15,9,1,00051,India
636166,2023-12-10,210,mountain dew,75,100,25,1,00082,India
522809,2023-12-10,203,mango yogurt,50,60,10,1,00277,India
522809,2023-12-10,202,milk,12,27,15,1,00277,India
405889,2023-12-10,211,red bull,90,125,35,1,00127,India
501261,2023-12-10,206,yakult,360,400,40,1,00177,India
252467,2023-12-10,202,milk,12,27,15,1,00304,India
252467,2023-12-10,213,bisleri,6,15,9,1,00304,India
252467,2023-12-10,204,strawberry yogurt,50,60,10,1,00304,India
252467,2023-12-10,212,amul cheese,250,315,65,1,00304,India
146922,2023-12-10,205,classic yogurt,45,60,15,1,00240,India
146922,2023-12-10,204,strawberry yogurt,50,60,10,1,00240,India
146922,2023-12-10,207,coca cola,75,100,25,1,00240,India
146922,2023-12-10,201,paneer,210,340,130,1,00240,India
756458,2023-12-10,208,sprite,75,100,25,1,00182,India
280886,2023-12-10,210,mountain dew,75,100,25,1,00053,India
280886,2023-12-10,213,bisleri,6,15,9,1,00053,India
528150,2023-12-10,202,milk,12,27,15,1,00257,India
528150,2023-12-10,213,bisleri,6,15,9,1,00257,India
528150,2023-12-10,207,coca cola,75,100,25,1,00257,India
528150,2023-12-10,209,pepsi,75,100,25,1,00257,India
397129,2023-12-10,211,red bull,90,125,35,1,00442,India
397129,2023-12-10,210,mountain dew,75,100,25,1,00442,India
397129,2023-12-10,203,mango yogurt,50,60,10,1,00442,India
482184,2023-12-10,209,pepsi,75,100,25,1,00440,India
482184,2023-12-10,207,coca cola,75,100,25,1,00440,India
482184,2023-12-10,210,mountain dew,75,100,25,1,00440,India
286683,2023-12-10,207,coca cola,75,100,25,1,00370,India
286683,2023-12-10,209,pepsi,75,100,25,1,00370,India
436565,2023-12-10,205,classic yogurt,45,60,15,1,00253,India
499434,2023-12-10,204,strawberry yogurt,50,60,10,1,00021,India
499434,2023-12-10,209,pepsi,75,100,25,1,00021,India
499434,2023-12-10,211,red bull,90,125,35,1,00021,India
243206,2023-12-10,213,bisleri,6,15,9,1,00081,India
243206,2023-12-10,208,sprite,75,100,25,1,00081,India
243206,2023-12-10,204,strawberry yogurt,50,60,10,1,00081,India
876031,2023-12-10,206,yakult,360,400,40,1,00249,India
876031,2023-12-10,211,red bull,90,125,35,1,00249,India
876031,2023-12-10,208,sprite,75,100,25,1,00249,India
643949,2023-12-10,206,yakult,360,400,40,1,00088,India
643949,2023-12-10,201,paneer,210,340,130,1,00088,India
643949,2023-12-10,213,bisleri,6,15,9,1,00088,India
643949,2023-12-10,209,pepsi,75,100,25,1,00088,India
489663,2023-12-10,208,sprite,75,100,25,1,00497,India
882039,2023-12-10,204,strawberry yogurt,50,60,10,1,00356,India
882039,2023-12-10,207,coca cola,75,100,25,1,00356,India
882039,2023-12-10,212,amul cheese,250,315,65,1,00356,India
929514,2023-12-10,203,mango yogurt,50,60,10,1,00380,India
929514,2023-12-10,201,paneer,210,340,130,1,00380,India
241287,2023-12-10,205,classic yogurt,45,60,15,1,00372,India
334794,2023-12-10,201,paneer,210,340,130,1,00291,India
334794,2023-12-10,207,coca cola,75,100,25,1,00291,India
295176,2023-12-10,207,coca cola,75,100,25,1,00145,India
295176,2023-12-10,203,mango yogurt,50,60,10,1,00145,India
295176,2023-12-10,201,paneer,210,340,130,1,00145,India
295176,2023-12-10,212,amul cheese,250,315,65,1,00145,India
295176,2023-12-10,205,classic yogurt,45,60,15,1,00145,India
737724,2023-12-10,210,mountain dew,75,100,25,1,00128,India
737724,2023-12-10,205,classic yogurt,45,60,15,1,00128,India
737724,2023-12-10,202,milk,12,27,15,1,00128,India
737724,2023-12-10,207,coca cola,75,100,25,1,00128,India
737724,2023-12-10,206,yakult,360,400,40,1,00128,India
274791,2023-12-10,213,bisleri,6,15,9,1,00014,India
630393,2023-12-10,203,mango yogurt,50,60,10,1,00359,India
630393,2023-12-10,207,coca cola,75,100,25,1,00359,India
630393,2023-12-10,208,sprite,75,100,25,1,00359,India
836735,2023-12-10,210,mountain dew,75,100,25,1,00267,India
836735,2023-12-10,204,strawberry yogurt,50,60,10,1,00267,India
879327,2023-12-10,211,red bull,90,125,35,1,00293,India
879327,2023-12-10,205,classic yogurt,45,60,15,1,00293,India
879327,2023-12-10,204,strawberry yogurt,50,60,10,1,00293,India
589431,2023-12-10,205,classic yogurt,45,60,15,1,00206,India
189933,2023-12-10,206,yakult,360,400,40,1,00074,India
189933,2023-12-10,205,classic yogurt,45,60,15,1,00074,India
956253,2023-12-10,211,red bull,90,125,35,1,00251,India
956253,2023-12-10,206,yakult,360,400,40,1,00251,India
956253,2023-12-10,205,classic yogurt,45,60,15,1,00251,India
956253,2023-12-10,203,mango yogurt,50,60,10,1,00251,India
670975,2023-12-10,203,mango yogurt,50,60,10,1,00184,India
670975,2023-12-10,211,red bull,90,125,35,1,00184,India
670975,2023-12-10,210,mountain dew,75,100,25,1,00184,India
424953,2023-12-10,213,bisleri,6,15,9,1,00417,India
424953,2023-12-10,205,classic yogurt,45,60,15,1,00417,India
424953,2023-12-10,212,amul cheese,250,315,65,1,00417,India
923049,2023-12-10,211,red bull,90,125,35,1,00246,India
923049,2023-12-10,208,sprite,75,100,25,1,00246,India
923049,2023-12-10,201,paneer,210,340,130,1,00246,India
923049,2023-12-10,207,coca cola,75,100,25,1,00246,India
457010,2023-12-10,213,bisleri,6,15,9,1,00200,India
457010,2023-12-10,207,coca cola,75,100,25,1,00200,India
457010,2023-12-10,201,paneer,210,340,130,1,00200,India
457010,2023-12-10,208,sprite,75,100,25,1,00200,India
457010,2023-12-10,212,amul cheese,250,315,65,1,00200,India
147181,2023-12-10,209,pepsi,75,100,25,1,00377,India
147181,2023-12-10,212,amul cheese,250,315,65,1,00377,India
147181,2023-12-10,202,milk,12,27,15,1,00377,India
147181,2023-12-10,203,mango yogurt,50,60,10,1,00377,India
147181,2023-12-10,211,red bull,90,125,35,1,00377,India
406895,2023-12-10,206,yakult,360,400,40,1,00415,India
406895,2023-12-10,204,strawberry yogurt,50,60,10,1,00415,India
406895,2023-12-10,201,paneer,210,340,130,1,00415,India
922988,2023-12-10,213,bisleri,6,15,9,1,00366,India
922988,2023-12-10,208,sprite,75,100,25,1,00366,India
922988,2023-12-10,205,classic yogurt,45,60,15,1,00366,India
872087,2023-12-10,205,classic yogurt,45,60,15,1,00084,India
872087,2023-12-10,203,mango yogurt,50,60,10,1,00084,India
872087,2023-12-10,206,yakult,360,400,40,1,00084,India
369379,2023-12-10,208,sprite,75,100,25,1,00281,India
369379,2023-12-10,206,yakult,360,400,40,1,00281,India
369379,2023-12-10,205,classic yogurt,45,60,15,1,00281,India
369379,2023-12-10,212,amul cheese,250,315,65,1,00281,India
560578,2023-12-10,211,red bull,90,125,35,1,00325,India
578632,2023-12-10,202,milk,12,27,15,1,00013,India
578632,2023-12-10,213,bisleri,6,15,9,1,00013,India
578632,2023-12-10,212,amul cheese,250,315,65,1,00013,India
578632,2023-12-10,206,yakult,360,400,40,1,00013,India
690937,2023-12-10,208,sprite,75,100,25,1,00259,India
690937,2023-12-10,203,mango yogurt,50,60,10,1,00259,India
690937,2023-12-10,211,red bull,90,125,35,1,00259,India
690937,2023-12-10,210,mountain dew,75,100,25,1,00259,India
690937,2023-12-10,202,milk,12,27,15,1,00259,India
139333,2023-12-10,202,milk,12,27,15,1,00163,India
246573,2023-12-10,204,strawberry yogurt,50,60,10,1,00157,India
246573,2023-12-10,205,classic yogurt,45,60,15,1,00157,India
246573,2023-12-10,213,bisleri,6,15,9,1,00157,India
491475,2023-12-10,210,mountain dew,75,100,25,1,00388,India
491475,2023-12-10,201,paneer,210,340,130,1,00388,India
491475,2023-12-10,204,strawberry yogurt,50,60,10,1,00388,India
491475,2023-12-10,211,red bull,90,125,35,1,00388,India
583883,2023-12-10,210,mountain dew,75,100,25,1,00117,India
609570,2023-12-10,207,coca cola,75,100,25,1,00369,India
609570,2023-12-10,204,strawberry yogurt,50,60,10,1,00369,India
347826,2023-12-10,207,coca cola,75,100,25,1,00375,India
347826,2023-12-10,213,bisleri,6,15,9,1,00375,India
347826,2023-12-10,203,mango yogurt,50,60,10,1,00375,India
347826,2023-12-10,209,pepsi,75,100,25,1,00375,India
347826,2023-12-10,210,mountain dew,75,100,25,1,00375,India
977882,2023-12-10,207,coca cola,75,100,25,1,00010,India
977882,2023-12-10,201,paneer,210,340,130,1,00010,India
977882,2023-12-10,209,pepsi,75,100,25,1,00010,India
977882,2023-12-10,202,milk,12,27,15,1,00010,India
535445,2023-12-10,209,pepsi,75,100,25,1,00333,India
535445,2023-12-10,211,red bull,90,125,35,1,00333,India
726681,2023-12-10,205,classic yogurt,45,60,15,1,00146,India
726681,2023-12-10,211,red bull,90,125,35,1,00146,India
414368,2023-12-10,209,pepsi,75,100,25,1,00384,India
414368,2023-12-10,201,paneer,210,340,130,1,00384,India
414368,2023-12-10,203,mango yogurt,50,60,10,1,00384,India
414368,2023-12-10,212,amul cheese,250,315,65,1,00384,India
666072,2023-12-10,212,amul cheese,250,315,65,1,00451,India
666072,2023-12-10,208,sprite,75,100,25,1,00451,India
666072,2023-12-10,201,paneer,210,340,130,1,00451,India
418510,2023-12-10,207,coca cola,75,100,25,1,00267,India
418510,2023-12-10,212,amul cheese,250,315,65,1,00267,India
178332,2023-12-10,202,milk,12,27,15,1,00071,India
178332,2023-12-10,211,red bull,90,125,35,1,00071,India
178332,2023-12-10,209,pepsi,75,100,25,1,00071,India
178332,2023-12-10,212,amul cheese,250,315,65,1,00071,India
178332,2023-12-10,204,strawberry yogurt,50,60,10,1,00071,India
755252,2023-12-10,208,sprite,75,100,25,1,00364,India
755252,2023-12-10,212,amul cheese,250,315,65,1,00364,India
677264,2023-12-10,208,sprite,75,100,25,1,00004,India
677264,2023-12-10,209,pepsi,75,100,25,1,00004,India
677264,2023-12-10,213,bisleri,6,15,9,1,00004,India
677264,2023-12-10,202,milk,12,27,15,1,00004,India
307794,2023-12-10,204,strawberry yogurt,50,60,10,1,00042,India
299201,2023-12-10,212,amul cheese,250,315,65,1,00212,India
299201,2023-12-10,207,coca cola,75,100,25,1,00212,India
284016,2023-12-10,213,bisleri,6,15,9,1,00064,India
284016,2023-12-10,204,strawberry yogurt,50,60,10,1,00064,India
284016,2023-12-10,212,amul cheese,250,315,65,1,00064,India
368063,2023-12-10,203,mango yogurt,50,60,10,1,00280,India
577595,2023-12-10,209,pepsi,75,100,25,1,00249,India
577595,2023-12-10,202,milk,12,27,15,1,00249,India
577595,2023-12-10,211,red bull,90,125,35,1,00249,India
577595,2023-12-10,212,amul cheese,250,315,65,1,00249,India
452022,2023-12-10,203,mango yogurt,50,60,10,1,00305,India
452022,2023-12-10,208,sprite,75,100,25,1,00305,India
452022,2023-12-10,202,milk,12,27,15,1,00305,India
452022,2023-12-10,206,yakult,360,400,40,1,00305,India
165985,2023-12-10,208,sprite,75,100,25,1,00413,India
165985,2023-12-10,203,mango yogurt,50,60,10,1,00413,India
165985,2023-12-10,211,red bull,90,125,35,1,00413,India
165985,2023-12-10,210,mountain dew,75,100,25,1,00413,India
874540,2023-12-10,201,paneer,210,340,130,1,00010,India
874540,2023-12-10,204,strawberry yogurt,50,60,10,1,00010,India
378090,2023-12-10,209,pepsi,75,100,25,1,00052,India
169430,2023-12-10,211,red bull,90,125,35,1,00392,India
459473,2023-12-10,203,mango yogurt,50,60,10,1,00234,India
459473,2023-12-10,208,sprite,75,100,25,1,00234,India
459473,2023-12-10,204,strawberry yogurt,50,60,10,1,00234,India
424041,2023-12-10,203,mango yogurt,50,60,10,1,00042,India
214123,2023-12-10,205,classic yogurt,45,60,15,1,00488,India
214123,2023-12-10,207,coca cola,75,100,25,1,00488,India
214123,2023-12-10,206,yakult,360,400,40,1,00488,India
659810,2023-12-10,207,coca cola,75,100,25,1,00359,India
659810,2023-12-10,205,classic yogurt,45,60,15,1,00359,India
659810,2023-12-10,202,milk,12,27,15,1,00359,India
659810,2023-12-10,204,strawberry yogurt,50,60,10,1,00359,India
659810,2023-12-10,201,paneer,210,340,130,1,00359,India
858442,2023-12-10,201,paneer,210,340,130,1,00425,India
858442,2023-12-10,204,strawberry yogurt,50,60,10,1,00425,India
858442,2023-12-10,206,yakult,360,400,40,1,00425,India
858442,2023-12-10,205,classic yogurt,45,60,15,1,00425,India
361466,2023-12-10,209,pepsi,75,100,25,1,00212,India
296057,2023-12-10,211,red bull,90,125,35,1,00025,India
296057,2023-12-10,201,paneer,210,340,130,1,00025,India
547775,2023-12-10,211,red bull,90,125,35,1,00048,India
168017,2023-12-10,208,sprite,75,100,25,1,00054,India
168017,2023-12-10,203,mango yogurt,50,60,10,1,00054,India
168017,2023-12-10,205,classic yogurt,45,60,15,1,00054,India
168017,2023-12-10,209,pepsi,75,100,25,1,00054,India
290924,2023-12-10,209,pepsi,75,100,25,1,00243,India
290924,2023-12-10,206,yakult,360,400,40,1,00243,India
290924,2023-12-10,210,mountain dew,75,100,25,1,00243,India
508425,2023-12-10,208,sprite,75,100,25,1,00188,India
105123,2023-12-10,209,pepsi,75,100,25,1,00414,India
105123,2023-12-10,203,mango yogurt,50,60,10,1,00414,India
105123,2023-12-10,207,coca cola,75,100,25,1,00414,India
955887,2023-12-10,203,mango yogurt,50,60,10,1,00470,India
955887,2023-12-10,201,paneer,210,340,130,1,00470,India
955887,2023-12-10,212,amul cheese,250,315,65,1,00470,India
955887,2023-12-10,204,strawberry yogurt,50,60,10,1,00470,India
319215,2023-12-10,208,sprite,75,100,25,1,00463,India
426674,2023-12-10,210,mountain dew,75,100,25,1,00266,India
426674,2023-12-10,201,paneer,210,340,130,1,00266,India
426674,2023-12-10,212,amul cheese,250,315,65,1,00266,India
801323,2023-12-10,212,amul cheese,250,315,65,1,00160,India
444043,2023-12-10,204,strawberry yogurt,50,60,10,1,00246,India
444043,2023-12-10,205,classic yogurt,45,60,15,1,00246,India
444043,2023-12-10,213,bisleri,6,15,9,1,00246,India
773943,2023-12-10,201,paneer,210,340,130,1,00386,India
773943,2023-12-10,202,milk,12,27,15,1,00386,India
773943,2023-12-10,205,classic yogurt,45,60,15,1,00386,India
773943,2023-12-10,209,pepsi,75,100,25,1,00386,India
442555,2023-12-10,210,mountain dew,75,100,25,1,00325,India
187246,2023-12-10,210,mountain dew,75,100,25,1,00285,India
187246,2023-12-10,206,yakult,360,400,40,1,00285,India
950452,2023-12-10,213,bisleri,6,15,9,1,00118,India
950452,2023-12-10,205,classic yogurt,45,60,15,1,00118,India
950452,2023-12-10,209,pepsi,75,100,25,1,00118,India
254272,2023-12-10,203,mango yogurt,50,60,10,1,00301,India
254272,2023-12-10,211,red bull,90,125,35,1,00301,India
815565,2023-12-11,202,milk,12,27,15,1,00329,India
815565,2023-12-11,205,classic yogurt,45,60,15,1,00329,India
449533,2023-12-11,208,sprite,75,100,25,1,00325,India
449533,2023-12-11,205,classic yogurt,45,60,15,1,00325,India
449533,2023-12-11,207,coca cola,75,100,25,1,00325,India
694575,2023-12-11,210,mountain dew,75,100,25,1,00167,India
694575,2023-12-11,204,strawberry yogurt,50,60,10,1,00167,India
694575,2023-12-11,201,paneer,210,340,130,1,00167,India
954175,2023-12-11,205,classic yogurt,45,60,15,1,00097,India
954175,2023-12-11,209,pepsi,75,100,25,1,00097,India
950108,2023-12-11,206,yakult,360,400,40,1,00156,India
346364,2023-12-11,203,mango yogurt,50,60,10,1,00138,India
346364,2023-12-11,205,classic yogurt,45,60,15,1,00138,India
346364,2023-12-11,211,red bull,90,125,35,1,00138,India
658947,2023-12-11,206,yakult,360,400,40,1,00401,India
323932,2023-12-11,210,mountain dew,75,100,25,1,00398,India
323932,2023-12-11,202,milk,12,27,15,1,00398,India
323932,2023-12-11,208,sprite,75,100,25,1,00398,India
323932,2023-12-11,213,bisleri,6,15,9,1,00398,India
825535,2023-12-11,210,mountain dew,75,100,25,1,00235,India
667264,2023-12-11,207,coca cola,75,100,25,1,00078,India
667264,2023-12-11,205,classic yogurt,45,60,15,1,00078,India
667264,2023-12-11,203,mango yogurt,50,60,10,1,00078,India
667264,2023-12-11,202,milk,12,27,15,1,00078,India
251752,2023-12-11,206,yakult,360,400,40,1,00236,India
251752,2023-12-11,204,strawberry yogurt,50,60,10,1,00236,India
251752,2023-12-11,209,pepsi,75,100,25,1,00236,India
831376,2023-12-11,202,milk,12,27,15,1,00272,India
831376,2023-12-11,208,sprite,75,100,25,1,00272,India
831376,2023-12-11,201,paneer,210,340,130,1,00272,India
831376,2023-12-11,212,amul cheese,250,315,65,1,00272,India
757530,2023-12-11,201,paneer,210,340,130,1,00332,India
757530,2023-12-11,211,red bull,90,125,35,1,00332,India
104908,2023-12-11,207,coca cola,75,100,25,1,00443,India
104908,2023-12-11,209,pepsi,75,100,25,1,00443,India
470375,2023-12-11,202,milk,12,27,15,1,00233,India
495720,2023-12-11,201,paneer,210,340,130,1,00362,India
495720,2023-12-11,211,red bull,90,125,35,1,00362,India
495720,2023-12-11,205,classic yogurt,45,60,15,1,00362,India
495720,2023-12-11,210,mountain dew,75,100,25,1,00362,India
495720,2023-12-11,208,sprite,75,100,25,1,00362,India
551805,2023-12-11,204,strawberry yogurt,50,60,10,1,00188,India
551805,2023-12-11,202,milk,12,27,15,1,00188,India
551805,2023-12-11,205,classic yogurt,45,60,15,1,00188,India
551805,2023-12-11,212,amul cheese,250,315,65,1,00188,India
620262,2023-12-11,209,pepsi,75,100,25,1,00450,India
620262,2023-12-11,207,coca cola,75,100,25,1,00450,India
620262,2023-12-11,204,strawberry yogurt,50,60,10,1,00450,India
620262,2023-12-11,205,classic yogurt,45,60,15,1,00450,India
132135,2023-12-11,206,yakult,360,400,40,1,00006,India
577335,2023-12-11,211,red bull,90,125,35,1,00107,India
577335,2023-12-11,203,mango yogurt,50,60,10,1,00107,India
322593,2023-12-11,212,amul cheese,250,315,65,1,00344,India
684240,2023-12-11,210,mountain dew,75,100,25,1,00085,India
658663,2023-12-11,202,milk,12,27,15,1,00187,India
658663,2023-12-11,205,classic yogurt,45,60,15,1,00187,India
658663,2023-12-11,210,mountain dew,75,100,25,1,00187,India
239479,2023-12-11,212,amul cheese,250,315,65,1,00283,India
239479,2023-12-11,201,paneer,210,340,130,1,00283,India
239479,2023-12-11,203,mango yogurt,50,60,10,1,00283,India
239479,2023-12-11,205,classic yogurt,45,60,15,1,00283,India
814961,2023-12-11,212,amul cheese,250,315,65,1,00305,India
814961,2023-12-11,208,sprite,75,100,25,1,00305,India
814961,2023-12-11,213,bisleri,6,15,9,1,00305,India
501360,2023-12-11,210,mountain dew,75,100,25,1,00371,India
501360,2023-12-11,209,pepsi,75,100,25,1,00371,India
501360,2023-12-11,203,mango yogurt,50,60,10,1,00371,India
501360,2023-12-11,213,bisleri,6,15,9,1,00371,India
253204,2023-12-11,210,mountain dew,75,100,25,1,00449,India
107725,2023-12-11,205,classic yogurt,45,60,15,1,00433,India
107725,2023-12-11,211,red bull,90,125,35,1,00433,India
107725,2023-12-11,208,sprite,75,100,25,1,00433,India
107725,2023-12-11,204,strawberry yogurt,50,60,10,1,00433,India
391799,2023-12-11,208,sprite,75,100,25,1,00418,India
391799,2023-12-11,207,coca cola,75,100,25,1,00418,India
391799,2023-12-11,210,mountain dew,75,100,25,1,00418,India
942739,2023-12-11,210,mountain dew,75,100,25,1,00144,India
718034,2023-12-11,211,red bull,90,125,35,1,00463,India
718034,2023-12-11,209,pepsi,75,100,25,1,00463,India
718034,2023-12-11,201,paneer,210,340,130,1,00463,India
718034,2023-12-11,203,mango yogurt,50,60,10,1,00463,India
861385,2023-12-11,202,milk,12,27,15,1,00210,India
653467,2023-12-11,211,red bull,90,125,35,1,00063,India
653467,2023-12-11,206,yakult,360,400,40,1,00063,India
653467,2023-12-11,204,strawberry yogurt,50,60,10,1,00063,India
653467,2023-12-11,208,sprite,75,100,25,1,00063,India
882198,2023-12-11,212,amul cheese,250,315,65,1,00070,India
882198,2023-12-11,207,coca cola,75,100,25,1,00070,India
882198,2023-12-11,205,classic yogurt,45,60,15,1,00070,India
882198,2023-12-11,209,pepsi,75,100,25,1,00070,India
882198,2023-12-11,211,red bull,90,125,35,1,00070,India
140810,2023-12-11,208,sprite,75,100,25,1,00077,India
140810,2023-12-11,209,pepsi,75,100,25,1,00077,India
360801,2023-12-11,201,paneer,210,340,130,1,00367,India
360801,2023-12-11,205,classic yogurt,45,60,15,1,00367,India
880037,2023-12-11,213,bisleri,6,15,9,1,00301,India
880037,2023-12-11,211,red bull,90,125,35,1,00301,India
880037,2023-12-11,204,strawberry yogurt,50,60,10,1,00301,India
206763,2023-12-11,209,pepsi,75,100,25,1,00223,India
206763,2023-12-11,205,classic yogurt,45,60,15,1,00223,India
206763,2023-12-11,210,mountain dew,75,100,25,1,00223,India
968445,2023-12-11,201,paneer,210,340,130,1,00315,India
968445,2023-12-11,206,yakult,360,400,40,1,00315,India
962661,2023-12-11,212,amul cheese,250,315,65,1,00382,India
962661,2023-12-11,210,mountain dew,75,100,25,1,00382,India
962661,2023-12-11,207,coca cola,75,100,25,1,00382,India
874452,2023-12-11,211,red bull,90,125,35,1,00091,India
874452,2023-12-11,212,amul cheese,250,315,65,1,00091,India
637052,2023-12-11,208,sprite,75,100,25,1,00391,India
637052,2023-12-11,202,milk,12,27,15,1,00391,India
637052,2023-12-11,213,bisleri,6,15,9,1,00391,India
983756,2023-12-11,212,amul cheese,250,315,65,1,00057,India
983756,2023-12-11,205,classic yogurt,45,60,15,1,00057,India
983756,2023-12-11,202,milk,12,27,15,1,00057,India
983756,2023-12-11,210,mountain dew,75,100,25,1,00057,India
983756,2023-12-11,208,sprite,75,100,25,1,00057,India
170210,2023-12-11,207,coca cola,75,100,25,1,00312,India
170210,2023-12-11,202,milk,12,27,15,1,00312,India
297368,2023-12-11,213,bisleri,6,15,9,1,00261,India
297368,2023-12-11,208,sprite,75,100,25,1,00261,India
297368,2023-12-11,205,classic yogurt,45,60,15,1,00261,India
148573,2023-12-11,209,pepsi,75,100,25,1,00232,India
148573,2023-12-11,213,bisleri,6,15,9,1,00232,India
711795,2023-12-11,209,pepsi,75,100,25,1,00023,India
711795,2023-12-11,203,mango yogurt,50,60,10,1,00023,India
711795,2023-12-11,212,amul cheese,250,315,65,1,00023,India
420661,2023-12-11,201,paneer,210,340,130,1,00492,India
420661,2023-12-11,213,bisleri,6,15,9,1,00492,India
420661,2023-12-11,209,pepsi,75,100,25,1,00492,India
420661,2023-12-11,203,mango yogurt,50,60,10,1,00492,India
897162,2023-12-11,204,strawberry yogurt,50,60,10,1,00028,India
897162,2023-12-11,208,sprite,75,100,25,1,00028,India
897162,2023-12-11,201,paneer,210,340,130,1,00028,India
897162,2023-12-11,207,coca cola,75,100,25,1,00028,India
455088,2023-12-11,202,milk,12,27,15,1,00327,India
455088,2023-12-11,213,bisleri,6,15,9,1,00327,India
403078,2023-12-11,205,classic yogurt,45,60,15,1,00377,India
403078,2023-12-11,203,mango yogurt,50,60,10,1,00377,India
405502,2023-12-11,207,coca cola,75,100,25,1,00160,India
405502,2023-12-11,211,red bull,90,125,35,1,00160,India
405502,2023-12-11,210,mountain dew,75,100,25,1,00160,India
405502,2023-12-11,201,paneer,210,340,130,1,00160,India
405502,2023-12-11,206,yakult,360,400,40,1,00160,India
906588,2023-12-11,207,coca cola,75,100,25,1,00173,India
922325,2023-12-11,212,amul cheese,250,315,65,1,00216,India
541121,2023-12-11,209,pepsi,75,100,25,1,00179,India
541121,2023-12-11,201,paneer,210,340,130,1,00179,India
541121,2023-12-11,203,mango yogurt,50,60,10,1,00179,India
541121,2023-12-11,211,red bull,90,125,35,1,00179,India
737884,2023-12-11,204,strawberry yogurt,50,60,10,1,00475,India
737884,2023-12-11,208,sprite,75,100,25,1,00475,India
737884,2023-12-11,202,milk,12,27,15,1,00475,India
758716,2023-12-11,207,coca cola,75,100,25,1,00115,India
758716,2023-12-11,208,sprite,75,100,25,1,00115,India
931571,2023-12-11,205,classic yogurt,45,60,15,1,00209,India
145907,2023-12-11,205,classic yogurt,45,60,15,1,00325,India
398359,2023-12-11,211,red bull,90,125,35,1,00448,India
398359,2023-12-11,203,mango yogurt,50,60,10,1,00448,India
398359,2023-12-11,202,milk,12,27,15,1,00448,India
304386,2023-12-11,208,sprite,75,100,25,1,00356,India
304386,2023-12-11,201,paneer,210,340,130,1,00356,India
304386,2023-12-11,211,red bull,90,125,35,1,00356,India
550743,2023-12-11,211,red bull,90,125,35,1,00286,India
550743,2023-12-11,202,milk,12,27,15,1,00286,India
811056,2023-12-11,208,sprite,75,100,25,1,00426,India
811056,2023-12-11,202,milk,12,27,15,1,00426,India
811056,2023-12-11,211,red bull,90,125,35,1,00426,India
750916,2023-12-11,208,sprite,75,100,25,1,00342,India
750916,2023-12-11,203,mango yogurt,50,60,10,1,00342,India
750916,2023-12-11,205,classic yogurt,45,60,15,1,00342,India
750916,2023-12-11,202,milk,12,27,15,1,00342,India
750916,2023-12-11,212,amul cheese,250,315,65,1,00342,India
994600,2023-12-11,207,coca cola,75,100,25,1,00060,India
289764,2023-12-11,206,yakult,360,400,40,1,00386,India
289764,2023-12-11,201,paneer,210,340,130,1,00386,India
289764,2023-12-11,211,red bull,90,125,35,1,00386,India
289764,2023-12-11,212,amul cheese,250,315,65,1,00386,India
634286,2023-12-11,203,mango yogurt,50,60,10,1,00218,India
634286,2023-12-11,201,paneer,210,340,130,1,00218,India
957732,2023-12-11,207,coca cola,75,100,25,1,00468,India
957732,2023-12-11,211,red bull,90,125,35,1,00468,India
701726,2023-12-11,213,bisleri,6,15,9,1,00131,India
701726,2023-12-11,206,yakult,360,400,40,1,00131,India
701726,2023-12-11,207,coca cola,75,100,25,1,00131,India
701726,2023-12-11,211,red bull,90,125,35,1,00131,India
321911,2023-12-11,208,sprite,75,100,25,1,00066,India
321911,2023-12-11,210,mountain dew,75,100,25,1,00066,India
321911,2023-12-11,206,yakult,360,400,40,1,00066,India
321911,2023-12-11,205,classic yogurt,45,60,15,1,00066,India
834659,2023-12-11,202,milk,12,27,15,1,00236,India
834659,2023-12-11,210,mountain dew,75,100,25,1,00236,India
834659,2023-12-11,207,coca cola,75,100,25,1,00236,India
367103,2023-12-11,203,mango yogurt,50,60,10,1,00391,India
367103,2023-12-11,213,bisleri,6,15,9,1,00391,India
788186,2023-12-11,205,classic yogurt,45,60,15,1,00193,India
788186,2023-12-11,204,strawberry yogurt,50,60,10,1,00193,India
788186,2023-12-11,209,pepsi,75,100,25,1,00193,India
788186,2023-12-11,212,amul cheese,250,315,65,1,00193,India
788186,2023-12-11,211,red bull,90,125,35,1,00193,India
486449,2023-12-11,211,red bull,90,125,35,1,00498,India
698059,2023-12-11,201,paneer,210,340,130,1,00234,India
698059,2023-12-11,203,mango yogurt,50,60,10,1,00234,India
698059,2023-12-11,209,pepsi,75,100,25,1,00234,India
698059,2023-12-11,211,red bull,90,125,35,1,00234,India
249714,2023-12-11,213,bisleri,6,15,9,1,00428,India
249714,2023-12-11,211,red bull,90,125,35,1,00428,India
249714,2023-12-11,209,pepsi,75,100,25,1,00428,India
223949,2023-12-12,203,mango yogurt,50,60,10,1,00308,India
163073,2023-12-12,210,mountain dew,75,100,25,1,00491,India
163073,2023-12-12,205,classic yogurt,45,60,15,1,00491,India
163073,2023-12-12,208,sprite,75,100,25,1,00491,India
993446,2023-12-12,202,milk,12,27,15,1,00327,India
993446,2023-12-12,211,red bull,90,125,35,1,00327,India
993446,2023-12-12,204,strawberry yogurt,50,60,10,1,00327,India
846629,2023-12-12,206,yakult,360,400,40,1,00377,India
846629,2023-12-12,209,pepsi,75,100,25,1,00377,India
846629,2023-12-12,213,bisleri,6,15,9,1,00377,India
846629,2023-12-12,202,milk,12,27,15,1,00377,India
600450,2023-12-12,206,yakult,360,400,40,1,00157,India
600450,2023-12-12,204,strawberry yogurt,50,60,10,1,00157,India
600450,2023-12-12,205,classic yogurt,45,60,15,1,00157,India
600450,2023-12-12,212,amul cheese,250,315,65,1,00157,India
160926,2023-12-12,202,milk,12,27,15,1,00491,India
160926,2023-12-12,201,paneer,210,340,130,1,00491,India
160926,2023-12-12,204,strawberry yogurt,50,60,10,1,00491,India
551238,2023-12-12,204,strawberry yogurt,50,60,10,1,00348,India
551238,2023-12-12,205,classic yogurt,45,60,15,1,00348,India
551238,2023-12-12,208,sprite,75,100,25,1,00348,India
291856,2023-12-12,212,amul cheese,250,315,65,1,00041,India
291856,2023-12-12,201,paneer,210,340,130,1,00041,India
291856,2023-12-12,211,red bull,90,125,35,1,00041,India
291856,2023-12-12,209,pepsi,75,100,25,1,00041,India
611442,2023-12-12,211,red bull,90,125,35,1,00375,India
611442,2023-12-12,206,yakult,360,400,40,1,00375,India
776980,2023-12-12,208,sprite,75,100,25,1,00073,India
243050,2023-12-12,201,paneer,210,340,130,1,00352,India
243050,2023-12-12,203,mango yogurt,50,60,10,1,00352,India
747910,2023-12-12,212,amul cheese,250,315,65,1,00439,India
747910,2023-12-12,210,mountain dew,75,100,25,1,00439,India
747910,2023-12-12,203,mango yogurt,50,60,10,1,00439,India
515869,2023-12-12,205,classic yogurt,45,60,15,1,00492,India
515869,2023-12-12,206,yakult,360,400,40,1,00492,India
649776,2023-12-12,206,yakult,360,400,40,1,00443,India
649776,2023-12-12,210,mountain dew,75,100,25,1,00443,India
913192,2023-12-12,208,sprite,75,100,25,1,00131,India
913192,2023-12-12,207,coca cola,75,100,25,1,00131,India
913192,2023-12-12,204,strawberry yogurt,50,60,10,1,00131,India
913192,2023-12-12,202,milk,12,27,15,1,00131,India
252398,2023-12-12,206,yakult,360,400,40,1,00139,India
252398,2023-12-12,201,paneer,210,340,130,1,00139,India
252398,2023-12-12,205,classic yogurt,45,60,15,1,00139,India
252398,2023-12-12,203,mango yogurt,50,60,10,1,00139,India
252398,2023-12-12,209,pepsi,75,100,25,1,00139,India
550335,2023-12-12,207,coca cola,75,100,25,1,00483,India
550335,2023-12-12,201,paneer,210,340,130,1,00483,India
633476,2023-12-12,208,sprite,75,100,25,1,00092,India
633476,2023-12-12,203,mango yogurt,50,60,10,1,00092,India
633476,2023-12-12,213,bisleri,6,15,9,1,00092,India
633476,2023-12-12,205,classic yogurt,45,60,15,1,00092,India
633476,2023-12-12,210,mountain dew,75,100,25,1,00092,India
325904,2023-12-12,205,classic yogurt,45,60,15,1,00398,India
325904,2023-12-12,207,coca cola,75,100,25,1,00398,India
325904,2023-12-12,206,yakult,360,400,40,1,00398,India
986303,2023-12-12,209,pepsi,75,100,25,1,00284,India
986303,2023-12-12,207,coca cola,75,100,25,1,00284,India
964113,2023-12-12,206,yakult,360,400,40,1,00409,India
964113,2023-12-12,207,coca cola,75,100,25,1,00409,India
822193,2023-12-12,202,milk,12,27,15,1,00361,India
822193,2023-12-12,201,paneer,210,340,130,1,00361,India
822193,2023-12-12,207,coca cola,75,100,25,1,00361,India
820390,2023-12-12,207,coca cola,75,100,25,1,00483,India
820390,2023-12-12,201,paneer,210,340,130,1,00483,India
872806,2023-12-12,210,mountain dew,75,100,25,1,00257,India
872806,2023-12-12,205,classic yogurt,45,60,15,1,00257,India
872806,2023-12-12,206,yakult,360,400,40,1,00257,India
440759,2023-12-12,213,bisleri,6,15,9,1,00438,India
440759,2023-12-12,202,milk,12,27,15,1,00438,India
440759,2023-12-12,205,classic yogurt,45,60,15,1,00438,India
425669,2023-12-12,203,mango yogurt,50,60,10,1,00393,India
425669,2023-12-12,212,amul cheese,250,315,65,1,00393,India
564358,2023-12-12,204,strawberry yogurt,50,60,10,1,00148,India
213970,2023-12-12,211,red bull,90,125,35,1,00376,India
648023,2023-12-12,207,coca cola,75,100,25,1,00334,India
648023,2023-12-12,206,yakult,360,400,40,1,00334,India
648023,2023-12-12,203,mango yogurt,50,60,10,1,00334,India
648023,2023-12-12,213,bisleri,6,15,9,1,00334,India
383400,2023-12-12,210,mountain dew,75,100,25,1,00497,India
383400,2023-12-12,202,milk,12,27,15,1,00497,India
383400,2023-12-12,212,amul cheese,250,315,65,1,00497,India
717762,2023-12-12,212,amul cheese,250,315,65,1,00313,India
717762,2023-12-12,201,paneer,210,340,130,1,00313,India
717762,2023-12-12,209,pepsi,75,100,25,1,00313,India
520475,2023-12-12,212,amul cheese,250,315,65,1,00320,India
520475,2023-12-12,211,red bull,90,125,35,1,00320,India
520475,2023-12-12,204,strawberry yogurt,50,60,10,1,00320,India
951297,2023-12-12,204,strawberry yogurt,50,60,10,1,00232,India
951297,2023-12-12,211,red bull,90,125,35,1,00232,India
951297,2023-12-12,203,mango yogurt,50,60,10,1,00232,India
475241,2023-12-12,203,mango yogurt,50,60,10,1,00393,India
475241,2023-12-12,209,pepsi,75,100,25,1,00393,India
475241,2023-12-12,205,classic yogurt,45,60,15,1,00393,India
475241,2023-12-12,208,sprite,75,100,25,1,00393,India
277143,2023-12-12,209,pepsi,75,100,25,1,00068,India
277143,2023-12-12,211,red bull,90,125,35,1,00068,India
277143,2023-12-12,206,yakult,360,400,40,1,00068,India
466655,2023-12-12,201,paneer,210,340,130,1,00358,India
411504,2023-12-12,213,bisleri,6,15,9,1,00420,India
460153,2023-12-12,209,pepsi,75,100,25,1,00190,India
460153,2023-12-12,205,classic yogurt,45,60,15,1,00190,India
460153,2023-12-12,211,red bull,90,125,35,1,00190,India
460153,2023-12-12,203,mango yogurt,50,60,10,1,00190,India
161941,2023-12-12,209,pepsi,75,100,25,1,00048,India
161941,2023-12-12,204,strawberry yogurt,50,60,10,1,00048,India
161941,2023-12-12,211,red bull,90,125,35,1,00048,India
161941,2023-12-12,202,milk,12,27,15,1,00048,India
265409,2023-12-12,206,yakult,360,400,40,1,00408,India
265409,2023-12-12,204,strawberry yogurt,50,60,10,1,00408,India
145966,2023-12-12,205,classic yogurt,45,60,15,1,00319,India
145966,2023-12-12,211,red bull,90,125,35,1,00319,India
145966,2023-12-12,212,amul cheese,250,315,65,1,00319,India
434809,2023-12-12,205,classic yogurt,45,60,15,1,00255,India
434809,2023-12-12,208,sprite,75,100,25,1,00255,India
434809,2023-12-12,209,pepsi,75,100,25,1,00255,India
434809,2023-12-12,202,milk,12,27,15,1,00255,India
813887,2023-12-12,210,mountain dew,75,100,25,1,00460,India
813887,2023-12-12,204,strawberry yogurt,50,60,10,1,00460,India
813887,2023-12-12,212,amul cheese,250,315,65,1,00460,India
407300,2023-12-12,212,amul cheese,250,315,65,1,00028,India
407300,2023-12-12,204,strawberry yogurt,50,60,10,1,00028,India
407300,2023-12-12,202,milk,12,27,15,1,00028,India
407300,2023-12-12,210,mountain dew,75,100,25,1,00028,India
407300,2023-12-12,208,sprite,75,100,25,1,00028,India
216514,2023-12-12,212,amul cheese,250,315,65,1,00139,India
623263,2023-12-12,209,pepsi,75,100,25,1,00040,India
623263,2023-12-12,211,red bull,90,125,35,1,00040,India
623263,2023-12-12,202,milk,12,27,15,1,00040,India
623263,2023-12-12,208,sprite,75,100,25,1,00040,India
623263,2023-12-12,207,coca cola,75,100,25,1,00040,India
786699,2023-12-12,201,paneer,210,340,130,1,00377,India
786699,2023-12-12,203,mango yogurt,50,60,10,1,00377,India
786699,2023-12-12,204,strawberry yogurt,50,60,10,1,00377,India
532995,2023-12-12,211,red bull,90,125,35,1,00311,India
532995,2023-12-12,203,mango yogurt,50,60,10,1,00311,India
532995,2023-12-12,209,pepsi,75,100,25,1,00311,India
457679,2023-12-12,209,pepsi,75,100,25,1,00452,India
457679,2023-12-12,205,classic yogurt,45,60,15,1,00452,India
457679,2023-12-12,213,bisleri,6,15,9,1,00452,India
457679,2023-12-12,203,mango yogurt,50,60,10,1,00452,India
457679,2023-12-12,210,mountain dew,75,100,25,1,00452,India
144792,2023-12-12,208,sprite,75,100,25,1,00203,India
144792,2023-12-12,204,strawberry yogurt,50,60,10,1,00203,India
754405,2023-12-12,207,coca cola,75,100,25,1,00420,India
754405,2023-12-12,205,classic yogurt,45,60,15,1,00420,India
754405,2023-12-12,202,milk,12,27,15,1,00420,India
189734,2023-12-12,206,yakult,360,400,40,1,00009,India
189734,2023-12-12,212,amul cheese,250,315,65,1,00009,India
103630,2023-12-12,204,strawberry yogurt,50,60,10,1,00129,India
103630,2023-12-12,208,sprite,75,100,25,1,00129,India
103630,2023-12-12,202,milk,12,27,15,1,00129,India
554998,2023-12-12,205,classic yogurt,45,60,15,1,00176,India
554998,2023-12-12,204,strawberry yogurt,50,60,10,1,00176,India
672179,2023-12-12,205,classic yogurt,45,60,15,1,00146,India
672179,2023-12-12,213,bisleri,6,15,9,1,00146,India
422284,2023-12-12,212,amul cheese,250,315,65,1,00188,India
171043,2023-12-12,211,red bull,90,125,35,1,00387,India
171043,2023-12-12,203,mango yogurt,50,60,10,1,00387,India
171043,2023-12-12,206,yakult,360,400,40,1,00387,India
749424,2023-12-12,209,pepsi,75,100,25,1,00021,India
749424,2023-12-12,201,paneer,210,340,130,1,00021,India
749424,2023-12-12,206,yakult,360,400,40,1,00021,India
368046,2023-12-12,206,yakult,360,400,40,1,00150,India
360139,2023-12-12,207,coca cola,75,100,25,1,00349,India
360139,2023-12-12,205,classic yogurt,45,60,15,1,00349,India
421211,2023-12-12,208,sprite,75,100,25,1,00051,India
603613,2023-12-12,205,classic yogurt,45,60,15,1,00129,India
603613,2023-12-12,203,mango yogurt,50,60,10,1,00129,India
603613,2023-12-12,212,amul cheese,250,315,65,1,00129,India
822036,2023-12-12,205,classic yogurt,45,60,15,1,00373,India
822036,2023-12-12,211,red bull,90,125,35,1,00373,India
604612,2023-12-12,201,paneer,210,340,130,1,00146,India
604612,2023-12-12,206,yakult,360,400,40,1,00146,India
604612,2023-12-12,202,milk,12,27,15,1,00146,India
604612,2023-12-12,203,mango yogurt,50,60,10,1,00146,India
739236,2023-12-12,206,yakult,360,400,40,1,00132,India
739236,2023-12-12,201,paneer,210,340,130,1,00132,India
536994,2023-12-12,208,sprite,75,100,25,1,00299,India
536994,2023-12-12,213,bisleri,6,15,9,1,00299,India
573739,2023-12-12,211,red bull,90,125,35,1,00100,India
573739,2023-12-12,206,yakult,360,400,40,1,00100,India
573739,2023-12-12,213,bisleri,6,15,9,1,00100,India
878954,2023-12-12,208,sprite,75,100,25,1,00364,India
878954,2023-12-12,205,classic yogurt,45,60,15,1,00364,India
343533,2023-12-12,213,bisleri,6,15,9,1,00245,India
343533,2023-12-12,201,paneer,210,340,130,1,00245,India
343533,2023-12-12,203,mango yogurt,50,60,10,1,00245,India
979441,2023-12-12,205,classic yogurt,45,60,15,1,00030,India
979441,2023-12-12,210,mountain dew,75,100,25,1,00030,India
877196,2023-12-12,203,mango yogurt,50,60,10,1,00180,India
877196,2023-12-12,210,mountain dew,75,100,25,1,00180,India
318994,2023-12-12,206,yakult,360,400,40,1,00249,India
318994,2023-12-12,202,milk,12,27,15,1,00249,India
318994,2023-12-12,207,coca cola,75,100,25,1,00249,India
318994,2023-12-12,205,classic yogurt,45,60,15,1,00249,India
318994,2023-12-12,210,mountain dew,75,100,25,1,00249,India
544916,2023-12-12,210,mountain dew,75,100,25,1,00089,India
544916,2023-12-12,206,yakult,360,400,40,1,00089,India
544916,2023-12-12,209,pepsi,75,100,25,1,00089,India
828155,2023-12-12,213,bisleri,6,15,9,1,00423,India
828155,2023-12-12,212,amul cheese,250,315,65,1,00423,India
245662,2023-12-12,213,bisleri,6,15,9,1,00086,India
805398,2023-12-12,207,coca cola,75,100,25,1,00430,India
805398,2023-12-12,205,classic yogurt,45,60,15,1,00430,India
805398,2023-12-12,213,bisleri,6,15,9,1,00430,India
235695,2023-12-12,206,yakult,360,400,40,1,00119,India
235695,2023-12-12,207,coca cola,75,100,25,1,00119,India
235695,2023-12-12,210,mountain dew,75,100,25,1,00119,India
235695,2023-12-12,213,bisleri,6,15,9,1,00119,India
468173,2023-12-12,211,red bull,90,125,35,1,00487,India
468173,2023-12-12,202,milk,12,27,15,1,00487,India
468173,2023-12-12,212,amul cheese,250,315,65,1,00487,India
434130,2023-12-12,207,coca cola,75,100,25,1,00350,India
434130,2023-12-12,206,yakult,360,400,40,1,00350,India
434130,2023-12-12,210,mountain dew,75,100,25,1,00350,India
434130,2023-12-12,202,milk,12,27,15,1,00350,India
324123,2023-12-12,212,amul cheese,250,315,65,1,00244,India
324123,2023-12-12,210,mountain dew,75,100,25,1,00244,India
324123,2023-12-12,206,yakult,360,400,40,1,00244,India
324123,2023-12-12,209,pepsi,75,100,25,1,00244,India
324123,2023-12-12,207,coca cola,75,100,25,1,00244,India
325648,2023-12-12,207,coca cola,75,100,25,1,00046,India
325648,2023-12-12,213,bisleri,6,15,9,1,00046,India
325648,2023-12-12,202,milk,12,27,15,1,00046,India
325648,2023-12-12,211,red bull,90,125,35,1,00046,India
738569,2023-12-12,209,pepsi,75,100,25,1,00325,India
738569,2023-12-12,205,classic yogurt,45,60,15,1,00325,India
738569,2023-12-12,204,strawberry yogurt,50,60,10,1,00325,India
738569,2023-12-12,210,mountain dew,75,100,25,1,00325,India
166718,2023-12-12,207,coca cola,75,100,25,1,00475,India
166718,2023-12-12,201,paneer,210,340,130,1,00475,India
365018,2023-12-12,209,pepsi,75,100,25,1,00292,India
365018,2023-12-12,202,milk,12,27,15,1,00292,India
394544,2023-12-12,202,milk,12,27,15,1,00310,India
848452,2023-12-12,208,sprite,75,100,25,1,00258,India
953008,2023-12-13,204,strawberry yogurt,50,60,10,1,00095,India
953008,2023-12-13,203,mango yogurt,50,60,10,1,00095,India
953008,2023-12-13,211,red bull,90,125,35,1,00095,India
762645,2023-12-13,203,mango yogurt,50,60,10,1,00430,India
762645,2023-12-13,213,bisleri,6,15,9,1,00430,India
762645,2023-12-13,207,coca cola,75,100,25,1,00430,India
762645,2023-12-13,204,strawberry yogurt,50,60,10,1,00430,India
951616,2023-12-13,209,pepsi,75,100,25,1,00027,India
951616,2023-12-13,212,amul cheese,250,315,65,1,00027,India
951616,2023-12-13,205,classic yogurt,45,60,15,1,00027,India
951966,2023-12-13,201,paneer,210,340,130,1,00165,India
951966,2023-12-13,213,bisleri,6,15,9,1,00165,India
951966,2023-12-13,207,coca cola,75,100,25,1,00165,India
951966,2023-12-13,208,sprite,75,100,25,1,00165,India
872205,2023-12-13,211,red bull,90,125,35,1,00444,India
872205,2023-12-13,212,amul cheese,250,315,65,1,00444,India
491646,2023-12-13,212,amul cheese,250,315,65,1,00246,India
491646,2023-12-13,213,bisleri,6,15,9,1,00246,India
491646,2023-12-13,204,strawberry yogurt,50,60,10,1,00246,India
491646,2023-12-13,211,red bull,90,125,35,1,00246,India
988625,2023-12-13,202,milk,12,27,15,1,00494,India
988625,2023-12-13,209,pepsi,75,100,25,1,00494,India
439652,2023-12-13,212,amul cheese,250,315,65,1,00129,India
439652,2023-12-13,211,red bull,90,125,35,1,00129,India
439652,2023-12-13,208,sprite,75,100,25,1,00129,India
439652,2023-12-13,202,milk,12,27,15,1,00129,India
595171,2023-12-13,211,red bull,90,125,35,1,00482,India
595171,2023-12-13,210,mountain dew,75,100,25,1,00482,India
595171,2023-12-13,207,coca cola,75,100,25,1,00482,India
595171,2023-12-13,209,pepsi,75,100,25,1,00482,India
595171,2023-12-13,204,strawberry yogurt,50,60,10,1,00482,India
514049,2023-12-13,208,sprite,75,100,25,1,00468,India
514049,2023-12-13,211,red bull,90,125,35,1,00468,India
514049,2023-12-13,210,mountain dew,75,100,25,1,00468,India
514049,2023-12-13,202,milk,12,27,15,1,00468,India
107410,2023-12-13,203,mango yogurt,50,60,10,1,00396,India
107410,2023-12-13,207,coca cola,75,100,25,1,00396,India
107410,2023-12-13,212,amul cheese,250,315,65,1,00396,India
107410,2023-12-13,211,red bull,90,125,35,1,00396,India
627936,2023-12-13,204,strawberry yogurt,50,60,10,1,00053,India
627936,2023-12-13,201,paneer,210,340,130,1,00053,India
388788,2023-12-13,203,mango yogurt,50,60,10,1,00453,India
388788,2023-12-13,209,pepsi,75,100,25,1,00453,India
683502,2023-12-13,205,classic yogurt,45,60,15,1,00076,India
124775,2023-12-13,208,sprite,75,100,25,1,00422,India
124775,2023-12-13,205,classic yogurt,45,60,15,1,00422,India
124775,2023-12-13,209,pepsi,75,100,25,1,00422,India
124775,2023-12-13,211,red bull,90,125,35,1,00422,India
968481,2023-12-13,204,strawberry yogurt,50,60,10,1,00095,India
968481,2023-12-13,209,pepsi,75,100,25,1,00095,India
968481,2023-12-13,201,paneer,210,340,130,1,00095,India
996890,2023-12-13,210,mountain dew,75,100,25,1,00380,India
996890,2023-12-13,211,red bull,90,125,35,1,00380,India
510774,2023-12-13,211,red bull,90,125,35,1,00150,India
565810,2023-12-13,204,strawberry yogurt,50,60,10,1,00142,India
612520,2023-12-13,202,milk,12,27,15,1,00369,India
612520,2023-12-13,205,classic yogurt,45,60,15,1,00369,India
612520,2023-12-13,203,mango yogurt,50,60,10,1,00369,India
801289,2023-12-13,210,mountain dew,75,100,25,1,00248,India
801289,2023-12-13,211,red bull,90,125,35,1,00248,India
801289,2023-12-13,201,paneer,210,340,130,1,00248,India
801289,2023-12-13,206,yakult,360,400,40,1,00248,India
801289,2023-12-13,212,amul cheese,250,315,65,1,00248,India
540737,2023-12-13,211,red bull,90,125,35,1,00390,India
540737,2023-12-13,205,classic yogurt,45,60,15,1,00390,India
676940,2023-12-13,205,classic yogurt,45,60,15,1,00305,India
600049,2023-12-13,207,coca cola,75,100,25,1,00163,India
600049,2023-12-13,204,strawberry yogurt,50,60,10,1,00163,India
920034,2023-12-13,211,red bull,90,125,35,1,00445,India
920034,2023-12-13,203,mango yogurt,50,60,10,1,00445,India
920034,2023-12-13,209,pepsi,75,100,25,1,00445,India
920034,2023-12-13,206,yakult,360,400,40,1,00445,India
617318,2023-12-13,206,yakult,360,400,40,1,00441,India
617318,2023-12-13,210,mountain dew,75,100,25,1,00441,India
617318,2023-12-13,201,paneer,210,340,130,1,00441,India
617318,2023-12-13,208,sprite,75,100,25,1,00441,India
224043,2023-12-13,208,sprite,75,100,25,1,00290,India
161829,2023-12-13,206,yakult,360,400,40,1,00183,India
161829,2023-12-13,204,strawberry yogurt,50,60,10,1,00183,India
161829,2023-12-13,211,red bull,90,125,35,1,00183,India
356092,2023-12-13,212,amul cheese,250,315,65,1,00320,India
356092,2023-12-13,211,red bull,90,125,35,1,00320,India
317193,2023-12-13,208,sprite,75,100,25,1,00169,India
317193,2023-12-13,206,yakult,360,400,40,1,00169,India
317193,2023-12-13,202,milk,12,27,15,1,00169,India
305070,2023-12-13,207,coca cola,75,100,25,1,00420,India
305070,2023-12-13,206,yakult,360,400,40,1,00420,India
305070,2023-12-13,203,mango yogurt,50,60,10,1,00420,India
349626,2023-12-13,203,mango yogurt,50,60,10,1,00204,India
349626,2023-12-13,206,yakult,360,400,40,1,00204,India
349626,2023-12-13,208,sprite,75,100,25,1,00204,India
349626,2023-12-13,212,amul cheese,250,315,65,1,00204,India
487700,2023-12-13,212,amul cheese,250,315,65,1,00069,India
487700,2023-12-13,207,coca cola,75,100,25,1,00069,India
288227,2023-12-13,209,pepsi,75,100,25,1,00015,India
288227,2023-12-13,211,red bull,90,125,35,1,00015,India
288227,2023-12-13,206,yakult,360,400,40,1,00015,India
562798,2023-12-13,201,paneer,210,340,130,1,00254,India
562798,2023-12-13,203,mango yogurt,50,60,10,1,00254,India
562798,2023-12-13,204,strawberry yogurt,50,60,10,1,00254,India
562798,2023-12-13,211,red bull,90,125,35,1,00254,India
121309,2023-12-13,207,coca cola,75,100,25,1,00167,India
121309,2023-12-13,206,yakult,360,400,40,1,00167,India
121309,2023-12-13,213,bisleri,6,15,9,1,00167,India
421456,2023-12-13,210,mountain dew,75,100,25,1,00302,India
482877,2023-12-13,201,paneer,210,340,130,1,00226,India
774144,2023-12-13,208,sprite,75,100,25,1,00303,India
774144,2023-12-13,205,classic yogurt,45,60,15,1,00303,India
817101,2023-12-13,211,red bull,90,125,35,1,00378,India
817101,2023-12-13,213,bisleri,6,15,9,1,00378,India
914946,2023-12-13,207,coca cola,75,100,25,1,00357,India
467349,2023-12-13,208,sprite,75,100,25,1,00062,India
122321,2023-12-13,211,red bull,90,125,35,1,00110,India
305332,2023-12-13,212,amul cheese,250,315,65,1,00397,India
305332,2023-12-13,210,mountain dew,75,100,25,1,00397,India
305332,2023-12-13,208,sprite,75,100,25,1,00397,India
945574,2023-12-13,202,milk,12,27,15,1,00338,India
365572,2023-12-13,212,amul cheese,250,315,65,1,00195,India
365572,2023-12-13,204,strawberry yogurt,50,60,10,1,00195,India
365572,2023-12-13,210,mountain dew,75,100,25,1,00195,India
597326,2023-12-13,212,amul cheese,250,315,65,1,00323,India
597326,2023-12-13,213,bisleri,6,15,9,1,00323,India
825818,2023-12-13,206,yakult,360,400,40,1,00216,India
825818,2023-12-13,213,bisleri,6,15,9,1,00216,India
758320,2023-12-13,208,sprite,75,100,25,1,00167,India
810344,2023-12-13,201,paneer,210,340,130,1,00305,India
810344,2023-12-13,209,pepsi,75,100,25,1,00305,India
976756,2023-12-13,209,pepsi,75,100,25,1,00203,India
976756,2023-12-13,210,mountain dew,75,100,25,1,00203,India
920833,2023-12-13,209,pepsi,75,100,25,1,00165,India
920833,2023-12-13,211,red bull,90,125,35,1,00165,India
440531,2023-12-13,213,bisleri,6,15,9,1,00014,India
440531,2023-12-13,210,mountain dew,75,100,25,1,00014,India
440531,2023-12-13,209,pepsi,75,100,25,1,00014,India
872531,2023-12-13,212,amul cheese,250,315,65,1,00375,India
872531,2023-12-13,208,sprite,75,100,25,1,00375,India
872531,2023-12-13,205,classic yogurt,45,60,15,1,00375,India
872531,2023-12-13,204,strawberry yogurt,50,60,10,1,00375,India
872531,2023-12-13,210,mountain dew,75,100,25,1,00375,India
862378,2023-12-13,213,bisleri,6,15,9,1,00009,India
862378,2023-12-13,206,yakult,360,400,40,1,00009,India
873018,2023-12-13,204,strawberry yogurt,50,60,10,1,00141,India
873018,2023-12-13,206,yakult,360,400,40,1,00141,India
873018,2023-12-13,205,classic yogurt,45,60,15,1,00141,India
775601,2023-12-13,211,red bull,90,125,35,1,00405,India
677905,2023-12-13,204,strawberry yogurt,50,60,10,1,00098,India
127855,2023-12-13,204,strawberry yogurt,50,60,10,1,00026,India
127855,2023-12-13,206,yakult,360,400,40,1,00026,India
127855,2023-12-13,207,coca cola,75,100,25,1,00026,India
350386,2023-12-13,210,mountain dew,75,100,25,1,00453,India
350386,2023-12-13,204,strawberry yogurt,50,60,10,1,00453,India
830668,2023-12-13,211,red bull,90,125,35,1,00121,India
242970,2023-12-13,210,mountain dew,75,100,25,1,00182,India
242970,2023-12-13,204,strawberry yogurt,50,60,10,1,00182,India
242970,2023-12-13,212,amul cheese,250,315,65,1,00182,India
242970,2023-12-13,208,sprite,75,100,25,1,00182,India
242970,2023-12-13,205,classic yogurt,45,60,15,1,00182,India
145977,2023-12-13,209,pepsi,75,100,25,1,00383,India
145977,2023-12-13,207,coca cola,75,100,25,1,00383,India
145977,2023-12-13,208,sprite,75,100,25,1,00383,India
195640,2023-12-13,208,sprite,75,100,25,1,00232,India
195640,2023-12-13,203,mango yogurt,50,60,10,1,00232,India
447483,2023-12-13,209,pepsi,75,100,25,1,00131,India
447483,2023-12-13,208,sprite,75,100,25,1,00131,India
447483,2023-12-13,205,classic yogurt,45,60,15,1,00131,India
447483,2023-12-13,204,strawberry yogurt,50,60,10,1,00131,India
447483,2023-12-13,207,coca cola,75,100,25,1,00131,India
731402,2023-12-13,209,pepsi,75,100,25,1,00340,India
731402,2023-12-13,213,bisleri,6,15,9,1,00340,India
109063,2023-12-14,213,bisleri,6,15,9,1,00411,India
109063,2023-12-14,211,red bull,90,125,35,1,00411,India
109063,2023-12-14,204,strawberry yogurt,50,60,10,1,00411,India
109063,2023-12-14,201,paneer,210,340,130,1,00411,India
147480,2023-12-14,207,coca cola,75,100,25,1,00294,India
147480,2023-12-14,206,yakult,360,400,40,1,00294,India
147480,2023-12-14,210,mountain dew,75,100,25,1,00294,India
871110,2023-12-14,206,yakult,360,400,40,1,00343,India
871110,2023-12-14,205,classic yogurt,45,60,15,1,00343,India
399119,2023-12-14,210,mountain dew,75,100,25,1,00298,India
399119,2023-12-14,205,classic yogurt,45,60,15,1,00298,India
399119,2023-12-14,209,pepsi,75,100,25,1,00298,India
922084,2023-12-14,212,amul cheese,250,315,65,1,00106,India
624762,2023-12-14,208,sprite,75,100,25,1,00113,India
579713,2023-12-14,213,bisleri,6,15,9,1,00228,India
579713,2023-12-14,202,milk,12,27,15,1,00228,India
579713,2023-12-14,204,strawberry yogurt,50,60,10,1,00228,India
479100,2023-12-14,212,amul cheese,250,315,65,1,00025,India
479100,2023-12-14,203,mango yogurt,50,60,10,1,00025,India
479100,2023-12-14,208,sprite,75,100,25,1,00025,India
479100,2023-12-14,201,paneer,210,340,130,1,00025,India
682866,2023-12-14,208,sprite,75,100,25,1,00134,India
781822,2023-12-14,212,amul cheese,250,315,65,1,00206,India
781822,2023-12-14,202,milk,12,27,15,1,00206,India
781822,2023-12-14,210,mountain dew,75,100,25,1,00206,India
519976,2023-12-14,207,coca cola,75,100,25,1,00129,India
519976,2023-12-14,201,paneer,210,340,130,1,00129,India
519976,2023-12-14,204,strawberry yogurt,50,60,10,1,00129,India
931586,2023-12-14,208,sprite,75,100,25,1,00438,India
164559,2023-12-14,201,paneer,210,340,130,1,00029,India
164559,2023-12-14,211,red bull,90,125,35,1,00029,India
251598,2023-12-14,201,paneer,210,340,130,1,00177,India
251598,2023-12-14,203,mango yogurt,50,60,10,1,00177,India
251598,2023-12-14,212,amul cheese,250,315,65,1,00177,India
182094,2023-12-14,210,mountain dew,75,100,25,1,00162,India
182094,2023-12-14,207,coca cola,75,100,25,1,00162,India
182094,2023-12-14,208,sprite,75,100,25,1,00162,India
182094,2023-12-14,204,strawberry yogurt,50,60,10,1,00162,India
501049,2023-12-14,204,strawberry yogurt,50,60,10,1,00307,India
611763,2023-12-14,213,bisleri,6,15,9,1,00309,India
589705,2023-12-14,204,strawberry yogurt,50,60,10,1,00200,India
589705,2023-12-14,208,sprite,75,100,25,1,00200,India
589705,2023-12-14,203,mango yogurt,50,60,10,1,00200,India
934579,2023-12-14,212,amul cheese,250,315,65,1,00422,India
934579,2023-12-14,202,milk,12,27,15,1,00422,India
934579,2023-12-14,203,mango yogurt,50,60,10,1,00422,India
114728,2023-12-14,212,amul cheese,250,315,65,1,00020,India
114728,2023-12-14,211,red bull,90,125,35,1,00020,India
114728,2023-12-14,207,coca cola,75,100,25,1,00020,India
591729,2023-12-14,213,bisleri,6,15,9,1,00102,India
591729,2023-12-14,204,strawberry yogurt,50,60,10,1,00102,India
591729,2023-12-14,207,coca cola,75,100,25,1,00102,India
502505,2023-12-14,208,sprite,75,100,25,1,00435,India
502505,2023-12-14,204,strawberry yogurt,50,60,10,1,00435,India
502505,2023-12-14,206,yakult,360,400,40,1,00435,India
398555,2023-12-14,212,amul cheese,250,315,65,1,00408,India
116382,2023-12-14,205,classic yogurt,45,60,15,1,00114,India
116382,2023-12-14,202,milk,12,27,15,1,00114,India
512342,2023-12-14,201,paneer,210,340,130,1,00454,India
385185,2023-12-14,213,bisleri,6,15,9,1,00141,India
285779,2023-12-14,204,strawberry yogurt,50,60,10,1,00428,India
285779,2023-12-14,207,coca cola,75,100,25,1,00428,India
709981,2023-12-14,209,pepsi,75,100,25,1,00120,India
709981,2023-12-14,203,mango yogurt,50,60,10,1,00120,India
709981,2023-12-14,204,strawberry yogurt,50,60,10,1,00120,India
579349,2023-12-14,203,mango yogurt,50,60,10,1,00100,India
579349,2023-12-14,211,red bull,90,125,35,1,00100,India
352729,2023-12-14,206,yakult,360,400,40,1,00293,India
352729,2023-12-14,202,milk,12,27,15,1,00293,India
352729,2023-12-14,201,paneer,210,340,130,1,00293,India
352729,2023-12-14,203,mango yogurt,50,60,10,1,00293,India
326172,2023-12-14,205,classic yogurt,45,60,15,1,00357,India
740997,2023-12-14,210,mountain dew,75,100,25,1,00067,India
740997,2023-12-14,202,milk,12,27,15,1,00067,India
903338,2023-12-14,208,sprite,75,100,25,1,00236,India
903338,2023-12-14,213,bisleri,6,15,9,1,00236,India
903338,2023-12-14,206,yakult,360,400,40,1,00236,India
903338,2023-12-14,209,pepsi,75,100,25,1,00236,India
305023,2023-12-14,207,coca cola,75,100,25,1,00298,India
305023,2023-12-14,205,classic yogurt,45,60,15,1,00298,India
305023,2023-12-14,212,amul cheese,250,315,65,1,00298,India
305023,2023-12-14,211,red bull,90,125,35,1,00298,India
958251,2023-12-14,203,mango yogurt,50,60,10,1,00242,India
958251,2023-12-14,204,strawberry yogurt,50,60,10,1,00242,India
958251,2023-12-14,202,milk,12,27,15,1,00242,India
958251,2023-12-14,207,coca cola,75,100,25,1,00242,India
958251,2023-12-14,205,classic yogurt,45,60,15,1,00242,India
238550,2023-12-14,201,paneer,210,340,130,1,00118,India
238550,2023-12-14,203,mango yogurt,50,60,10,1,00118,India
133206,2023-12-14,207,coca cola,75,100,25,1,00363,India
613684,2023-12-14,210,mountain dew,75,100,25,1,00287,India
613684,2023-12-14,212,amul cheese,250,315,65,1,00287,India
613684,2023-12-14,204,strawberry yogurt,50,60,10,1,00287,India
613684,2023-12-14,201,paneer,210,340,130,1,00287,India
854593,2023-12-14,210,mountain dew,75,100,25,1,00073,India
651050,2023-12-14,207,coca cola,75,100,25,1,00417,India
651050,2023-12-14,208,sprite,75,100,25,1,00417,India
840828,2023-12-14,213,bisleri,6,15,9,1,00099,India
840828,2023-12-14,204,strawberry yogurt,50,60,10,1,00099,India
840828,2023-12-14,212,amul cheese,250,315,65,1,00099,India
551218,2023-12-14,201,paneer,210,340,130,1,00169,India
551218,2023-12-14,211,red bull,90,125,35,1,00169,India
707567,2023-12-14,206,yakult,360,400,40,1,00186,India
256212,2023-12-14,205,classic yogurt,45,60,15,1,00210,India
256212,2023-12-14,202,milk,12,27,15,1,00210,India
419088,2023-12-14,201,paneer,210,340,130,1,00118,India
736014,2023-12-14,206,yakult,360,400,40,1,00210,India
736014,2023-12-14,213,bisleri,6,15,9,1,00210,India
798843,2023-12-14,204,strawberry yogurt,50,60,10,1,00264,India
798843,2023-12-14,206,yakult,360,400,40,1,00264,India
731634,2023-12-14,203,mango yogurt,50,60,10,1,00093,India
731634,2023-12-14,211,red bull,90,125,35,1,00093,India
731634,2023-12-14,210,mountain dew,75,100,25,1,00093,India
731634,2023-12-14,202,milk,12,27,15,1,00093,India
557817,2023-12-14,211,red bull,90,125,35,1,00080,India
259238,2023-12-14,202,milk,12,27,15,1,00493,India
631600,2023-12-14,207,coca cola,75,100,25,1,00083,India
631600,2023-12-14,211,red bull,90,125,35,1,00083,India
631600,2023-12-14,206,yakult,360,400,40,1,00083,India
631600,2023-12-14,212,amul cheese,250,315,65,1,00083,India
310442,2023-12-14,213,bisleri,6,15,9,1,00168,India
795874,2023-12-14,201,paneer,210,340,130,1,00013,India
795874,2023-12-14,211,red bull,90,125,35,1,00013,India
795874,2023-12-14,205,classic yogurt,45,60,15,1,00013,India
795874,2023-12-14,213,bisleri,6,15,9,1,00013,India
795874,2023-12-14,206,yakult,360,400,40,1,00013,India
157479,2023-12-14,211,red bull,90,125,35,1,00171,India
157479,2023-12-14,203,mango yogurt,50,60,10,1,00171,India
157479,2023-12-14,209,pepsi,75,100,25,1,00171,India
192150,2023-12-14,209,pepsi,75,100,25,1,00413,India
684082,2023-12-14,212,amul cheese,250,315,65,1,00438,India
684082,2023-12-14,203,mango yogurt,50,60,10,1,00438,India
684082,2023-12-14,206,yakult,360,400,40,1,00438,India
665728,2023-12-14,213,bisleri,6,15,9,1,00184,India
665728,2023-12-14,204,strawberry yogurt,50,60,10,1,00184,India
665728,2023-12-14,209,pepsi,75,100,25,1,00184,India
665728,2023-12-14,210,mountain dew,75,100,25,1,00184,India
533240,2023-12-14,212,amul cheese,250,315,65,1,00191,India
533240,2023-12-14,201,paneer,210,340,130,1,00191,India
409761,2023-12-14,206,yakult,360,400,40,1,00097,India
409761,2023-12-14,201,paneer,210,340,130,1,00097,India
409761,2023-12-14,212,amul cheese,250,315,65,1,00097,India
409761,2023-12-14,213,bisleri,6,15,9,1,00097,India
409761,2023-12-14,211,red bull,90,125,35,1,00097,India
550515,2023-12-14,204,strawberry yogurt,50,60,10,1,00183,India
550515,2023-12-14,202,milk,12,27,15,1,00183,India
550515,2023-12-14,205,classic yogurt,45,60,15,1,00183,India
889822,2023-12-14,206,yakult,360,400,40,1,00392,India
889822,2023-12-14,210,mountain dew,75,100,25,1,00392,India
889822,2023-12-14,208,sprite,75,100,25,1,00392,India
889822,2023-12-14,204,strawberry yogurt,50,60,10,1,00392,India
304657,2023-12-14,213,bisleri,6,15,9,1,00355,India
304657,2023-12-14,203,mango yogurt,50,60,10,1,00355,India
304657,2023-12-14,204,strawberry yogurt,50,60,10,1,00355,India
659299,2023-12-14,213,bisleri,6,15,9,1,00240,India
659299,2023-12-14,209,pepsi,75,100,25,1,00240,India
659299,2023-12-14,212,amul cheese,250,315,65,1,00240,India
396013,2023-12-14,210,mountain dew,75,100,25,1,00485,India
396013,2023-12-14,207,coca cola,75,100,25,1,00485,India
520234,2023-12-14,202,milk,12,27,15,1,00338,India
520234,2023-12-14,207,coca cola,75,100,25,1,00338,India
520234,2023-12-14,212,amul cheese,250,315,65,1,00338,India
785139,2023-12-14,204,strawberry yogurt,50,60,10,1,00494,India
785139,2023-12-14,201,paneer,210,340,130,1,00494,India
978360,2023-12-14,205,classic yogurt,45,60,15,1,00316,India
978360,2023-12-14,203,mango yogurt,50,60,10,1,00316,India
602179,2023-12-14,206,yakult,360,400,40,1,00173,India
602179,2023-12-14,205,classic yogurt,45,60,15,1,00173,India
602179,2023-12-14,213,bisleri,6,15,9,1,00173,India
602179,2023-12-14,201,paneer,210,340,130,1,00173,India
602179,2023-12-14,211,red bull,90,125,35,1,00173,India
157399,2023-12-14,203,mango yogurt,50,60,10,1,00374,India
157399,2023-12-14,205,classic yogurt,45,60,15,1,00374,India
157399,2023-12-14,202,milk,12,27,15,1,00374,India
157399,2023-12-14,213,bisleri,6,15,9,1,00374,India
157399,2023-12-14,209,pepsi,75,100,25,1,00374,India
874133,2023-12-14,208,sprite,75,100,25,1,00304,India
874133,2023-12-14,209,pepsi,75,100,25,1,00304,India
874133,2023-12-14,205,classic yogurt,45,60,15,1,00304,India
874133,2023-12-14,213,bisleri,6,15,9,1,00304,India
310918,2023-12-14,210,mountain dew,75,100,25,1,00201,India
310918,2023-12-14,205,classic yogurt,45,60,15,1,00201,India
310918,2023-12-14,207,coca cola,75,100,25,1,00201,India
288523,2023-12-14,208,sprite,75,100,25,1,00159,India
288523,2023-12-14,211,red bull,90,125,35,1,00159,India
212213,2023-12-14,209,pepsi,75,100,25,1,00091,India
212213,2023-12-14,212,amul cheese,250,315,65,1,00091,India
212213,2023-12-14,211,red bull,90,125,35,1,00091,India
491381,2023-12-14,203,mango yogurt,50,60,10,1,00063,India
491381,2023-12-14,205,classic yogurt,45,60,15,1,00063,India
491381,2023-12-14,204,strawberry yogurt,50,60,10,1,00063,India
491381,2023-12-14,213,bisleri,6,15,9,1,00063,India
491381,2023-12-14,210,mountain dew,75,100,25,1,00063,India
108633,2023-12-14,206,yakult,360,400,40,1,00353,India
108633,2023-12-14,209,pepsi,75,100,25,1,00353,India
108633,2023-12-14,204,strawberry yogurt,50,60,10,1,00353,India
108633,2023-12-14,208,sprite,75,100,25,1,00353,India
493226,2023-12-14,210,mountain dew,75,100,25,1,00352,India
493226,2023-12-14,209,pepsi,75,100,25,1,00352,India
493226,2023-12-14,212,amul cheese,250,315,65,1,00352,India
227498,2023-12-14,213,bisleri,6,15,9,1,00279,India
227498,2023-12-14,211,red bull,90,125,35,1,00279,India
227498,2023-12-14,204,strawberry yogurt,50,60,10,1,00279,India
227498,2023-12-14,203,mango yogurt,50,60,10,1,00279,India
155399,2023-12-14,206,yakult,360,400,40,1,00202,India
155399,2023-12-14,210,mountain dew,75,100,25,1,00202,India
155399,2023-12-14,211,red bull,90,125,35,1,00202,India
334288,2023-12-14,206,yakult,360,400,40,1,00268,India
213774,2023-12-14,211,red bull,90,125,35,1,00481,India
213774,2023-12-14,205,classic yogurt,45,60,15,1,00481,India
213774,2023-12-14,208,sprite,75,100,25,1,00481,India
380582,2023-12-14,213,bisleri,6,15,9,1,00343,India
254851,2023-12-14,209,pepsi,75,100,25,1,00381,India
254851,2023-12-14,203,mango yogurt,50,60,10,1,00381,India
254851,2023-12-14,201,paneer,210,340,130,1,00381,India
368345,2023-12-14,205,classic yogurt,45,60,15,1,00498,India
368345,2023-12-14,213,bisleri,6,15,9,1,00498,India
187131,2023-12-14,202,milk,12,27,15,1,00304,India
187131,2023-12-14,205,classic yogurt,45,60,15,1,00304,India
187131,2023-12-14,204,strawberry yogurt,50,60,10,1,00304,India
180860,2023-12-14,213,bisleri,6,15,9,1,00347,India
180860,2023-12-14,208,sprite,75,100,25,1,00347,India
786142,2023-12-14,204,strawberry yogurt,50,60,10,1,00235,India
461418,2023-12-14,202,milk,12,27,15,1,00253,India
461418,2023-12-14,211,red bull,90,125,35,1,00253,India
461418,2023-12-14,212,amul cheese,250,315,65,1,00253,India
461418,2023-12-14,206,yakult,360,400,40,1,00253,India
852701,2023-12-14,207,coca cola,75,100,25,1,00231,India
852701,2023-12-14,208,sprite,75,100,25,1,00231,India
439858,2023-12-14,207,coca cola,75,100,25,1,00234,India
439858,2023-12-14,201,paneer,210,340,130,1,00234,India
439858,2023-12-14,209,pepsi,75,100,25,1,00234,India
439858,2023-12-14,205,classic yogurt,45,60,15,1,00234,India
439858,2023-12-14,202,milk,12,27,15,1,00234,India
820975,2023-12-14,211,red bull,90,125,35,1,00004,India
541873,2023-12-14,207,coca cola,75,100,25,1,00484,India
854636,2023-12-14,202,milk,12,27,15,1,00476,India
835736,2023-12-15,205,classic yogurt,45,60,15,1,00408,India
835736,2023-12-15,211,red bull,90,125,35,1,00408,India
835736,2023-12-15,209,pepsi,75,100,25,1,00408,India
835736,2023-12-15,212,amul cheese,250,315,65,1,00408,India
269359,2023-12-15,208,sprite,75,100,25,1,00264,India
269359,2023-12-15,209,pepsi,75,100,25,1,00264,India
269359,2023-12-15,212,amul cheese,250,315,65,1,00264,India
269359,2023-12-15,207,coca cola,75,100,25,1,00264,India
269359,2023-12-15,206,yakult,360,400,40,1,00264,India
447912,2023-12-15,209,pepsi,75,100,25,1,00026,India
223754,2023-12-15,204,strawberry yogurt,50,60,10,1,00386,India
412328,2023-12-15,212,amul cheese,250,315,65,1,00203,India
412328,2023-12-15,213,bisleri,6,15,9,1,00203,India
412328,2023-12-15,205,classic yogurt,45,60,15,1,00203,India
412328,2023-12-15,206,yakult,360,400,40,1,00203,India
412328,2023-12-15,211,red bull,90,125,35,1,00203,India
489903,2023-12-15,206,yakult,360,400,40,1,00385,India
489903,2023-12-15,207,coca cola,75,100,25,1,00385,India
807156,2023-12-15,213,bisleri,6,15,9,1,00205,India
474967,2023-12-15,206,yakult,360,400,40,1,00417,India
474967,2023-12-15,211,red bull,90,125,35,1,00417,India
474967,2023-12-15,208,sprite,75,100,25,1,00417,India
474967,2023-12-15,202,milk,12,27,15,1,00417,India
609868,2023-12-15,208,sprite,75,100,25,1,00317,India
609868,2023-12-15,209,pepsi,75,100,25,1,00317,India
609868,2023-12-15,210,mountain dew,75,100,25,1,00317,India
508895,2023-12-15,203,mango yogurt,50,60,10,1,00442,India
508895,2023-12-15,207,coca cola,75,100,25,1,00442,India
508895,2023-12-15,208,sprite,75,100,25,1,00442,India
508895,2023-12-15,206,yakult,360,400,40,1,00442,India
514416,2023-12-15,201,paneer,210,340,130,1,00051,India
514416,2023-12-15,205,classic yogurt,45,60,15,1,00051,India
514416,2023-12-15,210,mountain dew,75,100,25,1,00051,India
514416,2023-12-15,202,milk,12,27,15,1,00051,India
514416,2023-12-15,203,mango yogurt,50,60,10,1,00051,India
507747,2023-12-15,209,pepsi,75,100,25,1,00399,India
507747,2023-12-15,203,mango yogurt,50,60,10,1,00399,India
507747,2023-12-15,204,strawberry yogurt,50,60,10,1,00399,India
471688,2023-12-15,207,coca cola,75,100,25,1,00037,India
331382,2023-12-15,208,sprite,75,100,25,1,00403,India
331382,2023-12-15,213,bisleri,6,15,9,1,00403,India
134737,2023-12-15,205,classic yogurt,45,60,15,1,00120,India
134737,2023-12-15,203,mango yogurt,50,60,10,1,00120,India
134737,2023-12-15,209,pepsi,75,100,25,1,00120,India
400724,2023-12-15,205,classic yogurt,45,60,15,1,00030,India
400724,2023-12-15,203,mango yogurt,50,60,10,1,00030,India
400724,2023-12-15,201,paneer,210,340,130,1,00030,India
830926,2023-12-15,213,bisleri,6,15,9,1,00408,India
830926,2023-12-15,208,sprite,75,100,25,1,00408,India
830926,2023-12-15,204,strawberry yogurt,50,60,10,1,00408,India
615440,2023-12-15,201,paneer,210,340,130,1,00359,India
615440,2023-12-15,203,mango yogurt,50,60,10,1,00359,India
615440,2023-12-15,213,bisleri,6,15,9,1,00359,India
287056,2023-12-15,208,sprite,75,100,25,1,00103,India
379656,2023-12-15,203,mango yogurt,50,60,10,1,00075,India
379656,2023-12-15,205,classic yogurt,45,60,15,1,00075,India
379656,2023-12-15,204,strawberry yogurt,50,60,10,1,00075,India
379656,2023-12-15,213,bisleri,6,15,9,1,00075,India
506251,2023-12-15,208,sprite,75,100,25,1,00408,India
506251,2023-12-15,210,mountain dew,75,100,25,1,00408,India
800800,2023-12-15,211,red bull,90,125,35,1,00141,India
800800,2023-12-15,206,yakult,360,400,40,1,00141,India
861155,2023-12-15,204,strawberry yogurt,50,60,10,1,00221,India
578339,2023-12-15,210,mountain dew,75,100,25,1,00276,India
578339,2023-12-15,212,amul cheese,250,315,65,1,00276,India
578339,2023-12-15,206,yakult,360,400,40,1,00276,India
578339,2023-12-15,204,strawberry yogurt,50,60,10,1,00276,India
582628,2023-12-15,211,red bull,90,125,35,1,00382,India
582628,2023-12-15,204,strawberry yogurt,50,60,10,1,00382,India
582628,2023-12-15,203,mango yogurt,50,60,10,1,00382,India
582628,2023-12-15,213,bisleri,6,15,9,1,00382,India
683092,2023-12-15,202,milk,12,27,15,1,00067,India
683092,2023-12-15,205,classic yogurt,45,60,15,1,00067,India
683092,2023-12-15,212,amul cheese,250,315,65,1,00067,India
296763,2023-12-15,208,sprite,75,100,25,1,00264,India
296763,2023-12-15,211,red bull,90,125,35,1,00264,India
296763,2023-12-15,204,strawberry yogurt,50,60,10,1,00264,India
800257,2023-12-15,211,red bull,90,125,35,1,00047,India
800257,2023-12-15,203,mango yogurt,50,60,10,1,00047,India
800257,2023-12-15,213,bisleri,6,15,9,1,00047,India
800257,2023-12-15,209,pepsi,75,100,25,1,00047,India
204978,2023-12-15,208,sprite,75,100,25,1,00467,India
500434,2023-12-15,201,paneer,210,340,130,1,00165,India
500434,2023-12-15,212,amul cheese,250,315,65,1,00165,India
500434,2023-12-15,205,classic yogurt,45,60,15,1,00165,India
967364,2023-12-15,209,pepsi,75,100,25,1,00101,India
967364,2023-12-15,205,classic yogurt,45,60,15,1,00101,India
967364,2023-12-15,207,coca cola,75,100,25,1,00101,India
579974,2023-12-15,210,mountain dew,75,100,25,1,00413,India
579974,2023-12-15,202,milk,12,27,15,1,00413,India
579974,2023-12-15,205,classic yogurt,45,60,15,1,00413,India
916739,2023-12-15,207,coca cola,75,100,25,1,00351,India
980725,2023-12-15,204,strawberry yogurt,50,60,10,1,00495,India
219106,2023-12-15,210,mountain dew,75,100,25,1,00280,India
219106,2023-12-15,211,red bull,90,125,35,1,00280,India
219106,2023-12-15,208,sprite,75,100,25,1,00280,India
219106,2023-12-15,203,mango yogurt,50,60,10,1,00280,India
219106,2023-12-15,205,classic yogurt,45,60,15,1,00280,India
692136,2023-12-15,208,sprite,75,100,25,1,00331,India
692136,2023-12-15,201,paneer,210,340,130,1,00331,India
992557,2023-12-15,201,paneer,210,340,130,1,00334,India
293977,2023-12-15,201,paneer,210,340,130,1,00335,India
293977,2023-12-15,212,amul cheese,250,315,65,1,00335,India
293977,2023-12-15,202,milk,12,27,15,1,00335,India
386746,2023-12-15,210,mountain dew,75,100,25,1,00299,India
386746,2023-12-15,209,pepsi,75,100,25,1,00299,India
386746,2023-12-15,205,classic yogurt,45,60,15,1,00299,India
386746,2023-12-15,212,amul cheese,250,315,65,1,00299,India
843943,2023-12-15,203,mango yogurt,50,60,10,1,00142,India
843943,2023-12-15,208,sprite,75,100,25,1,00142,India
843943,2023-12-15,209,pepsi,75,100,25,1,00142,India
358296,2023-12-15,212,amul cheese,250,315,65,1,00120,India
358296,2023-12-15,204,strawberry yogurt,50,60,10,1,00120,India
358296,2023-12-15,202,milk,12,27,15,1,00120,India
863915,2023-12-15,208,sprite,75,100,25,1,00195,India
863915,2023-12-15,213,bisleri,6,15,9,1,00195,India
863915,2023-12-15,209,pepsi,75,100,25,1,00195,India
863915,2023-12-15,206,yakult,360,400,40,1,00195,India
245555,2023-12-15,204,strawberry yogurt,50,60,10,1,00376,India
245555,2023-12-15,203,mango yogurt,50,60,10,1,00376,India
245555,2023-12-15,207,coca cola,75,100,25,1,00376,India
245555,2023-12-15,208,sprite,75,100,25,1,00376,India
192683,2023-12-15,201,paneer,210,340,130,1,00224,India
192683,2023-12-15,209,pepsi,75,100,25,1,00224,India
192683,2023-12-15,205,classic yogurt,45,60,15,1,00224,India
799115,2023-12-15,203,mango yogurt,50,60,10,1,00384,India
799115,2023-12-15,208,sprite,75,100,25,1,00384,India
799115,2023-12-15,210,mountain dew,75,100,25,1,00384,India
439583,2023-12-15,207,coca cola,75,100,25,1,00114,India
439583,2023-12-15,213,bisleri,6,15,9,1,00114,India
439583,2023-12-15,210,mountain dew,75,100,25,1,00114,India
439583,2023-12-15,202,milk,12,27,15,1,00114,India
123145,2023-12-15,203,mango yogurt,50,60,10,1,00433,India
398960,2023-12-15,211,red bull,90,125,35,1,00417,India
398960,2023-12-15,210,mountain dew,75,100,25,1,00417,India
398960,2023-12-15,207,coca cola,75,100,25,1,00417,India
521688,2023-12-15,201,paneer,210,340,130,1,00067,India
521688,2023-12-15,204,strawberry yogurt,50,60,10,1,00067,India
521688,2023-12-15,203,mango yogurt,50,60,10,1,00067,India
521688,2023-12-15,206,yakult,360,400,40,1,00067,India
959423,2023-12-15,209,pepsi,75,100,25,1,00247,India
959423,2023-12-15,212,amul cheese,250,315,65,1,00247,India
959423,2023-12-15,208,sprite,75,100,25,1,00247,India
529465,2023-12-15,207,coca cola,75,100,25,1,00388,India
529465,2023-12-15,206,yakult,360,400,40,1,00388,India
529465,2023-12-15,202,milk,12,27,15,1,00388,India
529465,2023-12-15,211,red bull,90,125,35,1,00388,India
529465,2023-12-15,209,pepsi,75,100,25,1,00388,India
638547,2023-12-15,205,classic yogurt,45,60,15,1,00008,India
638547,2023-12-15,213,bisleri,6,15,9,1,00008,India
638547,2023-12-15,206,yakult,360,400,40,1,00008,India
638547,2023-12-15,210,mountain dew,75,100,25,1,00008,India
179237,2023-12-15,212,amul cheese,250,315,65,1,00285,India
179237,2023-12-15,211,red bull,90,125,35,1,00285,India
179237,2023-12-15,213,bisleri,6,15,9,1,00285,India
815707,2023-12-15,204,strawberry yogurt,50,60,10,1,00027,India
815707,2023-12-15,205,classic yogurt,45,60,15,1,00027,India
815707,2023-12-15,209,pepsi,75,100,25,1,00027,India
867357,2023-12-16,209,pepsi,75,100,25,1,00395,India
867357,2023-12-16,213,bisleri,6,15,9,1,00395,India
867357,2023-12-16,205,classic yogurt,45,60,15,1,00395,India
867357,2023-12-16,204,strawberry yogurt,50,60,10,1,00395,India
902246,2023-12-16,206,yakult,360,400,40,1,00353,India
902246,2023-12-16,210,mountain dew,75,100,25,1,00353,India
902246,2023-12-16,203,mango yogurt,50,60,10,1,00353,India
853945,2023-12-16,207,coca cola,75,100,25,1,00176,India
853945,2023-12-16,201,paneer,210,340,130,1,00176,India
853945,2023-12-16,209,pepsi,75,100,25,1,00176,India
230307,2023-12-16,207,coca cola,75,100,25,1,00423,India
230307,2023-12-16,209,pepsi,75,100,25,1,00423,India
230307,2023-12-16,211,red bull,90,125,35,1,00423,India
230307,2023-12-16,212,amul cheese,250,315,65,1,00423,India
230307,2023-12-16,203,mango yogurt,50,60,10,1,00423,India
559368,2023-12-16,208,sprite,75,100,25,1,00074,India
559368,2023-12-16,207,coca cola,75,100,25,1,00074,India
172927,2023-12-16,209,pepsi,75,100,25,1,00495,India
172927,2023-12-16,211,red bull,90,125,35,1,00495,India
714398,2023-12-16,209,pepsi,75,100,25,1,00088,India
714398,2023-12-16,202,milk,12,27,15,1,00088,India
714398,2023-12-16,213,bisleri,6,15,9,1,00088,India
714398,2023-12-16,206,yakult,360,400,40,1,00088,India
944387,2023-12-16,203,mango yogurt,50,60,10,1,00411,India
944387,2023-12-16,213,bisleri,6,15,9,1,00411,India
944387,2023-12-16,211,red bull,90,125,35,1,00411,India
469864,2023-12-16,205,classic yogurt,45,60,15,1,00189,India
469864,2023-12-16,203,mango yogurt,50,60,10,1,00189,India
469864,2023-12-16,204,strawberry yogurt,50,60,10,1,00189,India
469864,2023-12-16,206,yakult,360,400,40,1,00189,India
469864,2023-12-16,213,bisleri,6,15,9,1,00189,India
151814,2023-12-16,204,strawberry yogurt,50,60,10,1,00138,India
473010,2023-12-16,206,yakult,360,400,40,1,00304,India
473010,2023-12-16,204,strawberry yogurt,50,60,10,1,00304,India
473010,2023-12-16,212,amul cheese,250,315,65,1,00304,India
986643,2023-12-16,213,bisleri,6,15,9,1,00497,India
986643,2023-12-16,208,sprite,75,100,25,1,00497,India
986643,2023-12-16,201,paneer,210,340,130,1,00497,India
986643,2023-12-16,205,classic yogurt,45,60,15,1,00497,India
986643,2023-12-16,204,strawberry yogurt,50,60,10,1,00497,India
567745,2023-12-16,204,strawberry yogurt,50,60,10,1,00124,India
567745,2023-12-16,208,sprite,75,100,25,1,00124,India
185308,2023-12-16,213,bisleri,6,15,9,1,00080,India
185308,2023-12-16,201,paneer,210,340,130,1,00080,India
185308,2023-12-16,202,milk,12,27,15,1,00080,India
185308,2023-12-16,207,coca cola,75,100,25,1,00080,India
988110,2023-12-16,205,classic yogurt,45,60,15,1,00266,India
988110,2023-12-16,213,bisleri,6,15,9,1,00266,India
988110,2023-12-16,206,yakult,360,400,40,1,00266,India
471950,2023-12-16,203,mango yogurt,50,60,10,1,00002,India
471950,2023-12-16,207,coca cola,75,100,25,1,00002,India
471950,2023-12-16,211,red bull,90,125,35,1,00002,India
471950,2023-12-16,209,pepsi,75,100,25,1,00002,India
471950,2023-12-16,205,classic yogurt,45,60,15,1,00002,India
880631,2023-12-16,213,bisleri,6,15,9,1,00337,India
880631,2023-12-16,212,amul cheese,250,315,65,1,00337,India
747554,2023-12-16,204,strawberry yogurt,50,60,10,1,00092,India
747554,2023-12-16,206,yakult,360,400,40,1,00092,India
336891,2023-12-16,208,sprite,75,100,25,1,00378,India
336891,2023-12-16,211,red bull,90,125,35,1,00378,India
336891,2023-12-16,210,mountain dew,75,100,25,1,00378,India
336891,2023-12-16,213,bisleri,6,15,9,1,00378,India
306586,2023-12-16,208,sprite,75,100,25,1,00476,India
306586,2023-12-16,206,yakult,360,400,40,1,00476,India
306586,2023-12-16,203,mango yogurt,50,60,10,1,00476,India
306586,2023-12-16,202,milk,12,27,15,1,00476,India
878109,2023-12-16,212,amul cheese,250,315,65,1,00338,India
878109,2023-12-16,213,bisleri,6,15,9,1,00338,India
389201,2023-12-16,209,pepsi,75,100,25,1,00346,India
389201,2023-12-16,201,paneer,210,340,130,1,00346,India
389201,2023-12-16,208,sprite,75,100,25,1,00346,India
802858,2023-12-16,202,milk,12,27,15,1,00284,India
802858,2023-12-16,207,coca cola,75,100,25,1,00284,India
802858,2023-12-16,206,yakult,360,400,40,1,00284,India
802858,2023-12-16,213,bisleri,6,15,9,1,00284,India
460915,2023-12-16,207,coca cola,75,100,25,1,00030,India
460915,2023-12-16,201,paneer,210,340,130,1,00030,India
351809,2023-12-16,208,sprite,75,100,25,1,00045,India
351809,2023-12-16,209,pepsi,75,100,25,1,00045,India
351809,2023-12-16,207,coca cola,75,100,25,1,00045,India
351809,2023-12-16,210,mountain dew,75,100,25,1,00045,India
639017,2023-12-16,204,strawberry yogurt,50,60,10,1,00196,India
639017,2023-12-16,208,sprite,75,100,25,1,00196,India
639017,2023-12-16,209,pepsi,75,100,25,1,00196,India
965518,2023-12-16,208,sprite,75,100,25,1,00038,India
335491,2023-12-16,209,pepsi,75,100,25,1,00022,India
335491,2023-12-16,203,mango yogurt,50,60,10,1,00022,India
335491,2023-12-16,210,mountain dew,75,100,25,1,00022,India
335491,2023-12-16,208,sprite,75,100,25,1,00022,India
335491,2023-12-16,207,coca cola,75,100,25,1,00022,India
941240,2023-12-16,202,milk,12,27,15,1,00034,India
594302,2023-12-16,209,pepsi,75,100,25,1,00064,India
594302,2023-12-16,204,strawberry yogurt,50,60,10,1,00064,India
594302,2023-12-16,201,paneer,210,340,130,1,00064,India
594302,2023-12-16,212,amul cheese,250,315,65,1,00064,India
594302,2023-12-16,203,mango yogurt,50,60,10,1,00064,India
520481,2023-12-16,204,strawberry yogurt,50,60,10,1,00278,India
520481,2023-12-16,213,bisleri,6,15,9,1,00278,India
459387,2023-12-16,210,mountain dew,75,100,25,1,00467,India
459387,2023-12-16,206,yakult,360,400,40,1,00467,India
459387,2023-12-16,212,amul cheese,250,315,65,1,00467,India
855228,2023-12-16,210,mountain dew,75,100,25,1,00311,India
855228,2023-12-16,207,coca cola,75,100,25,1,00311,India
855228,2023-12-16,212,amul cheese,250,315,65,1,00311,India
855228,2023-12-16,211,red bull,90,125,35,1,00311,India
722006,2023-12-16,210,mountain dew,75,100,25,1,00038,India
722006,2023-12-16,208,sprite,75,100,25,1,00038,India
722006,2023-12-16,211,red bull,90,125,35,1,00038,India
982055,2023-12-16,205,classic yogurt,45,60,15,1,00223,India
448060,2023-12-16,206,yakult,360,400,40,1,00278,India
714757,2023-12-16,212,amul cheese,250,315,65,1,00100,India
714757,2023-12-16,207,coca cola,75,100,25,1,00100,India
714757,2023-12-16,209,pepsi,75,100,25,1,00100,India
857756,2023-12-16,209,pepsi,75,100,25,1,00331,India
857756,2023-12-16,201,paneer,210,340,130,1,00331,India
150038,2023-12-16,213,bisleri,6,15,9,1,00028,India
150038,2023-12-16,208,sprite,75,100,25,1,00028,India
150038,2023-12-16,202,milk,12,27,15,1,00028,India
150038,2023-12-16,207,coca cola,75,100,25,1,00028,India
703615,2023-12-16,203,mango yogurt,50,60,10,1,00370,India
703615,2023-12-16,204,strawberry yogurt,50,60,10,1,00370,India
955209,2023-12-16,207,coca cola,75,100,25,1,00484,India
955209,2023-12-16,208,sprite,75,100,25,1,00484,India
776282,2023-12-16,201,paneer,210,340,130,1,00174,India
776282,2023-12-16,208,sprite,75,100,25,1,00174,India
467222,2023-12-16,202,milk,12,27,15,1,00010,India
467222,2023-12-16,208,sprite,75,100,25,1,00010,India
467222,2023-12-16,207,coca cola,75,100,25,1,00010,India
161989,2023-12-16,206,yakult,360,400,40,1,00488,India
161989,2023-12-16,207,coca cola,75,100,25,1,00488,India
161989,2023-12-16,204,strawberry yogurt,50,60,10,1,00488,India
958593,2023-12-16,203,mango yogurt,50,60,10,1,00062,India
958593,2023-12-16,206,yakult,360,400,40,1,00062,India
861756,2023-12-16,205,classic yogurt,45,60,15,1,00109,India
861756,2023-12-16,207,coca cola,75,100,25,1,00109,India
861756,2023-12-16,201,paneer,210,340,130,1,00109,India
861756,2023-12-16,204,strawberry yogurt,50,60,10,1,00109,India
288474,2023-12-16,205,classic yogurt,45,60,15,1,00168,India
288474,2023-12-16,211,red bull,90,125,35,1,00168,India
707499,2023-12-16,202,milk,12,27,15,1,00318,India
707499,2023-12-16,209,pepsi,75,100,25,1,00318,India
707499,2023-12-16,213,bisleri,6,15,9,1,00318,India
404202,2023-12-16,212,amul cheese,250,315,65,1,00292,India
404202,2023-12-16,206,yakult,360,400,40,1,00292,India
144954,2023-12-16,202,milk,12,27,15,1,00378,India
144954,2023-12-16,201,paneer,210,340,130,1,00378,India
144954,2023-12-16,213,bisleri,6,15,9,1,00378,India
207916,2023-12-16,206,yakult,360,400,40,1,00333,India
609129,2023-12-16,212,amul cheese,250,315,65,1,00370,India
609129,2023-12-16,208,sprite,75,100,25,1,00370,India
609129,2023-12-16,210,mountain dew,75,100,25,1,00370,India
609129,2023-12-16,201,paneer,210,340,130,1,00370,India
673245,2023-12-16,202,milk,12,27,15,1,00110,India
673245,2023-12-16,207,coca cola,75,100,25,1,00110,India
673245,2023-12-16,213,bisleri,6,15,9,1,00110,India
673245,2023-12-16,211,red bull,90,125,35,1,00110,India
829084,2023-12-16,201,paneer,210,340,130,1,00403,India
829084,2023-12-16,207,coca cola,75,100,25,1,00403,India
829084,2023-12-16,210,mountain dew,75,100,25,1,00403,India
829084,2023-12-16,202,milk,12,27,15,1,00403,India
829084,2023-12-16,203,mango yogurt,50,60,10,1,00403,India
177678,2023-12-16,212,amul cheese,250,315,65,1,00232,India
793636,2023-12-16,207,coca cola,75,100,25,1,00334,India
793636,2023-12-16,212,amul cheese,250,315,65,1,00334,India
793636,2023-12-16,205,classic yogurt,45,60,15,1,00334,India
793636,2023-12-16,201,paneer,210,340,130,1,00334,India
351209,2023-12-16,211,red bull,90,125,35,1,00276,India
351209,2023-12-16,203,mango yogurt,50,60,10,1,00276,India
351209,2023-12-16,201,paneer,210,340,130,1,00276,India
351209,2023-12-16,207,coca cola,75,100,25,1,00276,India
550799,2023-12-16,204,strawberry yogurt,50,60,10,1,00136,India
550799,2023-12-16,205,classic yogurt,45,60,15,1,00136,India
550799,2023-12-16,207,coca cola,75,100,25,1,00136,India
550799,2023-12-16,209,pepsi,75,100,25,1,00136,India
361421,2023-12-16,212,amul cheese,250,315,65,1,00271,India
361421,2023-12-16,209,pepsi,75,100,25,1,00271,India
361421,2023-12-16,203,mango yogurt,50,60,10,1,00271,India
508845,2023-12-16,210,mountain dew,75,100,25,1,00302,India
508845,2023-12-16,209,pepsi,75,100,25,1,00302,India
508845,2023-12-16,203,mango yogurt,50,60,10,1,00302,India
508845,2023-12-16,212,amul cheese,250,315,65,1,00302,India
789431,2023-12-16,213,bisleri,6,15,9,1,00264,India
789431,2023-12-16,211,red bull,90,125,35,1,00264,India
789431,2023-12-16,206,yakult,360,400,40,1,00264,India
789431,2023-12-16,212,amul cheese,250,315,65,1,00264,India
789431,2023-12-16,201,paneer,210,340,130,1,00264,India
889671,2023-12-16,210,mountain dew,75,100,25,1,00309,India
889671,2023-12-16,201,paneer,210,340,130,1,00309,India
889671,2023-12-16,209,pepsi,75,100,25,1,00309,India
889671,2023-12-16,206,yakult,360,400,40,1,00309,India
877313,2023-12-16,211,red bull,90,125,35,1,00022,India
702028,2023-12-16,207,coca cola,75,100,25,1,00297,India
702028,2023-12-16,201,paneer,210,340,130,1,00297,India
702028,2023-12-16,213,bisleri,6,15,9,1,00297,India
702028,2023-12-16,212,amul cheese,250,315,65,1,00297,India
929539,2023-12-16,202,milk,12,27,15,1,00142,India
929539,2023-12-16,208,sprite,75,100,25,1,00142,India
929539,2023-12-16,209,pepsi,75,100,25,1,00142,India
929539,2023-12-16,211,red bull,90,125,35,1,00142,India
318873,2023-12-16,202,milk,12,27,15,1,00412,India
318873,2023-12-16,208,sprite,75,100,25,1,00412,India
738462,2023-12-16,207,coca cola,75,100,25,1,00471,India
738462,2023-12-16,202,milk,12,27,15,1,00471,India
738462,2023-12-16,201,paneer,210,340,130,1,00471,India
452525,2023-12-16,207,coca cola,75,100,25,1,00361,India
452525,2023-12-16,202,milk,12,27,15,1,00361,India
733678,2023-12-16,207,coca cola,75,100,25,1,00315,India
733678,2023-12-16,212,amul cheese,250,315,65,1,00315,India
733678,2023-12-16,210,mountain dew,75,100,25,1,00315,India
378557,2023-12-16,213,bisleri,6,15,9,1,00174,India
378557,2023-12-16,204,strawberry yogurt,50,60,10,1,00174,India
378557,2023-12-16,209,pepsi,75,100,25,1,00174,India
378557,2023-12-16,201,paneer,210,340,130,1,00174,India
378557,2023-12-16,210,mountain dew,75,100,25,1,00174,India
824807,2023-12-16,209,pepsi,75,100,25,1,00058,India
824807,2023-12-16,211,red bull,90,125,35,1,00058,India
824807,2023-12-16,204,strawberry yogurt,50,60,10,1,00058,India
824807,2023-12-16,203,mango yogurt,50,60,10,1,00058,India
186799,2023-12-16,212,amul cheese,250,315,65,1,00261,India
186799,2023-12-16,211,red bull,90,125,35,1,00261,India
186799,2023-12-16,207,coca cola,75,100,25,1,00261,India
186799,2023-12-16,205,classic yogurt,45,60,15,1,00261,India
605977,2023-12-17,211,red bull,90,125,35,1,00182,India
605977,2023-12-17,209,pepsi,75,100,25,1,00182,India
605977,2023-12-17,206,yakult,360,400,40,1,00182,India
907388,2023-12-17,209,pepsi,75,100,25,1,00450,India
907388,2023-12-17,212,amul cheese,250,315,65,1,00450,India
907388,2023-12-17,208,sprite,75,100,25,1,00450,India
907388,2023-12-17,213,bisleri,6,15,9,1,00450,India
907388,2023-12-17,203,mango yogurt,50,60,10,1,00450,India
589567,2023-12-17,213,bisleri,6,15,9,1,00466,India
589567,2023-12-17,206,yakult,360,400,40,1,00466,India
589567,2023-12-17,205,classic yogurt,45,60,15,1,00466,India
589567,2023-12-17,211,red bull,90,125,35,1,00466,India
589567,2023-12-17,208,sprite,75,100,25,1,00466,India
237444,2023-12-17,205,classic yogurt,45,60,15,1,00244,India
237444,2023-12-17,212,amul cheese,250,315,65,1,00244,India
237444,2023-12-17,201,paneer,210,340,130,1,00244,India
589409,2023-12-17,213,bisleri,6,15,9,1,00338,India
589409,2023-12-17,204,strawberry yogurt,50,60,10,1,00338,India
589409,2023-12-17,207,coca cola,75,100,25,1,00338,India
589409,2023-12-17,201,paneer,210,340,130,1,00338,India
242659,2023-12-17,207,coca cola,75,100,25,1,00268,India
242659,2023-12-17,201,paneer,210,340,130,1,00268,India
242659,2023-12-17,210,mountain dew,75,100,25,1,00268,India
698817,2023-12-17,201,paneer,210,340,130,1,00151,India
698817,2023-12-17,211,red bull,90,125,35,1,00151,India
698817,2023-12-17,213,bisleri,6,15,9,1,00151,India
304797,2023-12-17,201,paneer,210,340,130,1,00042,India
304797,2023-12-17,213,bisleri,6,15,9,1,00042,India
304797,2023-12-17,205,classic yogurt,45,60,15,1,00042,India
506872,2023-12-17,203,mango yogurt,50,60,10,1,00144,India
506872,2023-12-17,204,strawberry yogurt,50,60,10,1,00144,India
506872,2023-12-17,210,mountain dew,75,100,25,1,00144,India
506872,2023-12-17,207,coca cola,75,100,25,1,00144,India
838616,2023-12-17,203,mango yogurt,50,60,10,1,00033,India
856327,2023-12-17,203,mango yogurt,50,60,10,1,00372,India
856327,2023-12-17,210,mountain dew,75,100,25,1,00372,India
856327,2023-12-17,213,bisleri,6,15,9,1,00372,India
856327,2023-12-17,206,yakult,360,400,40,1,00372,India
371113,2023-12-17,204,strawberry yogurt,50,60,10,1,00031,India
104116,2023-12-17,205,classic yogurt,45,60,15,1,00040,India
399490,2023-12-17,202,milk,12,27,15,1,00118,India
399490,2023-12-17,212,amul cheese,250,315,65,1,00118,India
399490,2023-12-17,213,bisleri,6,15,9,1,00118,India
121457,2023-12-17,213,bisleri,6,15,9,1,00104,India
121457,2023-12-17,201,paneer,210,340,130,1,00104,India
121457,2023-12-17,212,amul cheese,250,315,65,1,00104,India
121457,2023-12-17,210,mountain dew,75,100,25,1,00104,India
913490,2023-12-17,208,sprite,75,100,25,1,00318,India
913490,2023-12-17,211,red bull,90,125,35,1,00318,India
524050,2023-12-17,203,mango yogurt,50,60,10,1,00002,India
524050,2023-12-17,209,pepsi,75,100,25,1,00002,India
217775,2023-12-17,207,coca cola,75,100,25,1,00076,India
217775,2023-12-17,210,mountain dew,75,100,25,1,00076,India
217775,2023-12-17,213,bisleri,6,15,9,1,00076,India
217775,2023-12-17,211,red bull,90,125,35,1,00076,India
360813,2023-12-17,209,pepsi,75,100,25,1,00166,India
360813,2023-12-17,213,bisleri,6,15,9,1,00166,India
360813,2023-12-17,210,mountain dew,75,100,25,1,00166,India
360813,2023-12-17,207,coca cola,75,100,25,1,00166,India
823634,2023-12-17,212,amul cheese,250,315,65,1,00023,India
823634,2023-12-17,209,pepsi,75,100,25,1,00023,India
823634,2023-12-17,210,mountain dew,75,100,25,1,00023,India
823634,2023-12-17,207,coca cola,75,100,25,1,00023,India
980408,2023-12-17,207,coca cola,75,100,25,1,00407,India
980408,2023-12-17,212,amul cheese,250,315,65,1,00407,India
980408,2023-12-17,206,yakult,360,400,40,1,00407,India
980408,2023-12-17,204,strawberry yogurt,50,60,10,1,00407,India
959972,2023-12-17,203,mango yogurt,50,60,10,1,00118,India
959972,2023-12-17,213,bisleri,6,15,9,1,00118,India
959972,2023-12-17,201,paneer,210,340,130,1,00118,India
594373,2023-12-17,204,strawberry yogurt,50,60,10,1,00485,India
594373,2023-12-17,203,mango yogurt,50,60,10,1,00485,India
131300,2023-12-17,201,paneer,210,340,130,1,00471,India
889991,2023-12-17,204,strawberry yogurt,50,60,10,1,00337,India
889991,2023-12-17,206,yakult,360,400,40,1,00337,India
975568,2023-12-17,203,mango yogurt,50,60,10,1,00340,India
975568,2023-12-17,202,milk,12,27,15,1,00340,India
975568,2023-12-17,204,strawberry yogurt,50,60,10,1,00340,India
216054,2023-12-17,207,coca cola,75,100,25,1,00437,India
216054,2023-12-17,209,pepsi,75,100,25,1,00437,India
216054,2023-12-17,202,milk,12,27,15,1,00437,India
216054,2023-12-17,213,bisleri,6,15,9,1,00437,India
634022,2023-12-17,211,red bull,90,125,35,1,00013,India
634022,2023-12-17,212,amul cheese,250,315,65,1,00013,India
634022,2023-12-17,213,bisleri,6,15,9,1,00013,India
387840,2023-12-17,202,milk,12,27,15,1,00323,India
845299,2023-12-17,207,coca cola,75,100,25,1,00298,India
845299,2023-12-17,204,strawberry yogurt,50,60,10,1,00298,India
845299,2023-12-17,212,amul cheese,250,315,65,1,00298,India
845299,2023-12-17,201,paneer,210,340,130,1,00298,India
262337,2023-12-17,209,pepsi,75,100,25,1,00155,India
262337,2023-12-17,205,classic yogurt,45,60,15,1,00155,India
262337,2023-12-17,204,strawberry yogurt,50,60,10,1,00155,India
262337,2023-12-17,202,milk,12,27,15,1,00155,India
262337,2023-12-17,206,yakult,360,400,40,1,00155,India
548176,2023-12-17,204,strawberry yogurt,50,60,10,1,00389,India
548176,2023-12-17,206,yakult,360,400,40,1,00389,India
548176,2023-12-17,202,milk,12,27,15,1,00389,India
110612,2023-12-17,203,mango yogurt,50,60,10,1,00255,India
110612,2023-12-17,206,yakult,360,400,40,1,00255,India
755420,2023-12-17,204,strawberry yogurt,50,60,10,1,00335,India
755420,2023-12-17,201,paneer,210,340,130,1,00335,India
479899,2023-12-17,205,classic yogurt,45,60,15,1,00327,India
434928,2023-12-17,206,yakult,360,400,40,1,00028,India
538457,2023-12-17,205,classic yogurt,45,60,15,1,00093,India
538457,2023-12-17,206,yakult,360,400,40,1,00093,India
538457,2023-12-17,201,paneer,210,340,130,1,00093,India
538457,2023-12-17,211,red bull,90,125,35,1,00093,India
281384,2023-12-17,205,classic yogurt,45,60,15,1,00222,India
281384,2023-12-17,208,sprite,75,100,25,1,00222,India
281384,2023-12-17,203,mango yogurt,50,60,10,1,00222,India
281384,2023-12-17,202,milk,12,27,15,1,00222,India
281384,2023-12-17,204,strawberry yogurt,50,60,10,1,00222,India
331289,2023-12-17,213,bisleri,6,15,9,1,00353,India
401796,2023-12-17,207,coca cola,75,100,25,1,00466,India
401796,2023-12-17,201,paneer,210,340,130,1,00466,India
401796,2023-12-17,206,yakult,360,400,40,1,00466,India
401796,2023-12-17,211,red bull,90,125,35,1,00466,India
100181,2023-12-17,204,strawberry yogurt,50,60,10,1,00494,India
323192,2023-12-17,205,classic yogurt,45,60,15,1,00083,India
469997,2023-12-17,213,bisleri,6,15,9,1,00366,India
469997,2023-12-17,206,yakult,360,400,40,1,00366,India
469997,2023-12-17,209,pepsi,75,100,25,1,00366,India
469997,2023-12-17,201,paneer,210,340,130,1,00366,India
469997,2023-12-17,211,red bull,90,125,35,1,00366,India
496412,2023-12-17,213,bisleri,6,15,9,1,00012,India
558592,2023-12-17,213,bisleri,6,15,9,1,00475,India
558592,2023-12-17,210,mountain dew,75,100,25,1,00475,India
558592,2023-12-17,202,milk,12,27,15,1,00475,India
558592,2023-12-17,206,yakult,360,400,40,1,00475,India
606925,2023-12-17,201,paneer,210,340,130,1,00226,India
606925,2023-12-17,211,red bull,90,125,35,1,00226,India
606925,2023-12-17,205,classic yogurt,45,60,15,1,00226,India
946318,2023-12-17,207,coca cola,75,100,25,1,00041,India
386835,2023-12-17,209,pepsi,75,100,25,1,00121,India
317085,2023-12-17,205,classic yogurt,45,60,15,1,00298,India
643364,2023-12-17,202,milk,12,27,15,1,00469,India
643364,2023-12-17,209,pepsi,75,100,25,1,00469,India
643364,2023-12-17,213,bisleri,6,15,9,1,00469,India
643364,2023-12-17,211,red bull,90,125,35,1,00469,India
564821,2023-12-17,208,sprite,75,100,25,1,00026,India
564821,2023-12-17,211,red bull,90,125,35,1,00026,India
564821,2023-12-17,212,amul cheese,250,315,65,1,00026,India
969916,2023-12-17,202,milk,12,27,15,1,00307,India
969916,2023-12-17,201,paneer,210,340,130,1,00307,India
969916,2023-12-17,211,red bull,90,125,35,1,00307,India
969916,2023-12-17,209,pepsi,75,100,25,1,00307,India
523320,2023-12-17,203,mango yogurt,50,60,10,1,00419,India
523320,2023-12-17,211,red bull,90,125,35,1,00419,India
361812,2023-12-17,211,red bull,90,125,35,1,00029,India
543974,2023-12-17,209,pepsi,75,100,25,1,00363,India
543974,2023-12-17,210,mountain dew,75,100,25,1,00363,India
543974,2023-12-17,203,mango yogurt,50,60,10,1,00363,India
543974,2023-12-17,206,yakult,360,400,40,1,00363,India
543974,2023-12-17,204,strawberry yogurt,50,60,10,1,00363,India
657394,2023-12-17,209,pepsi,75,100,25,1,00468,India
822856,2023-12-17,204,strawberry yogurt,50,60,10,1,00309,India
301392,2023-12-17,207,coca cola,75,100,25,1,00392,India
475214,2023-12-18,203,mango yogurt,50,60,10,1,00445,India
475214,2023-12-18,212,amul cheese,250,315,65,1,00445,India
216335,2023-12-18,206,yakult,360,400,40,1,00355,India
216335,2023-12-18,209,pepsi,75,100,25,1,00355,India
216335,2023-12-18,207,coca cola,75,100,25,1,00355,India
411174,2023-12-18,203,mango yogurt,50,60,10,1,00039,India
411174,2023-12-18,206,yakult,360,400,40,1,00039,India
464795,2023-12-18,205,classic yogurt,45,60,15,1,00331,India
464795,2023-12-18,209,pepsi,75,100,25,1,00331,India
464795,2023-12-18,207,coca cola,75,100,25,1,00331,India
464795,2023-12-18,206,yakult,360,400,40,1,00331,India
394990,2023-12-18,202,milk,12,27,15,1,00060,India
394990,2023-12-18,208,sprite,75,100,25,1,00060,India
934341,2023-12-18,205,classic yogurt,45,60,15,1,00341,India
934341,2023-12-18,213,bisleri,6,15,9,1,00341,India
934341,2023-12-18,209,pepsi,75,100,25,1,00341,India
934341,2023-12-18,203,mango yogurt,50,60,10,1,00341,India
549703,2023-12-18,212,amul cheese,250,315,65,1,00414,India
978399,2023-12-18,213,bisleri,6,15,9,1,00065,India
978399,2023-12-18,203,mango yogurt,50,60,10,1,00065,India
978399,2023-12-18,210,mountain dew,75,100,25,1,00065,India
978399,2023-12-18,204,strawberry yogurt,50,60,10,1,00065,India
922835,2023-12-18,211,red bull,90,125,35,1,00476,India
922835,2023-12-18,208,sprite,75,100,25,1,00476,India
922835,2023-12-18,203,mango yogurt,50,60,10,1,00476,India
922835,2023-12-18,210,mountain dew,75,100,25,1,00476,India
922835,2023-12-18,213,bisleri,6,15,9,1,00476,India
871340,2023-12-18,209,pepsi,75,100,25,1,00275,India
871340,2023-12-18,205,classic yogurt,45,60,15,1,00275,India
736994,2023-12-18,210,mountain dew,75,100,25,1,00264,India
736994,2023-12-18,212,amul cheese,250,315,65,1,00264,India
736994,2023-12-18,213,bisleri,6,15,9,1,00264,India
736994,2023-12-18,202,milk,12,27,15,1,00264,India
757059,2023-12-18,208,sprite,75,100,25,1,00102,India
757059,2023-12-18,201,paneer,210,340,130,1,00102,India
757059,2023-12-18,210,mountain dew,75,100,25,1,00102,India
757059,2023-12-18,203,mango yogurt,50,60,10,1,00102,India
757059,2023-12-18,212,amul cheese,250,315,65,1,00102,India
663921,2023-12-18,206,yakult,360,400,40,1,00045,India
663921,2023-12-18,208,sprite,75,100,25,1,00045,India
663921,2023-12-18,207,coca cola,75,100,25,1,00045,India
663921,2023-12-18,213,bisleri,6,15,9,1,00045,India
374871,2023-12-18,211,red bull,90,125,35,1,00321,India
374871,2023-12-18,207,coca cola,75,100,25,1,00321,India
374871,2023-12-18,204,strawberry yogurt,50,60,10,1,00321,India
416869,2023-12-18,213,bisleri,6,15,9,1,00435,India
416869,2023-12-18,204,strawberry yogurt,50,60,10,1,00435,India
416869,2023-12-18,210,mountain dew,75,100,25,1,00435,India
416869,2023-12-18,203,mango yogurt,50,60,10,1,00435,India
757334,2023-12-18,211,red bull,90,125,35,1,00312,India
548997,2023-12-18,204,strawberry yogurt,50,60,10,1,00362,India
548997,2023-12-18,212,amul cheese,250,315,65,1,00362,India
548997,2023-12-18,208,sprite,75,100,25,1,00362,India
548997,2023-12-18,211,red bull,90,125,35,1,00362,India
548997,2023-12-18,202,milk,12,27,15,1,00362,India
857065,2023-12-18,202,milk,12,27,15,1,00426,India
857065,2023-12-18,213,bisleri,6,15,9,1,00426,India
293030,2023-12-18,210,mountain dew,75,100,25,1,00277,India
293030,2023-12-18,209,pepsi,75,100,25,1,00277,India
293030,2023-12-18,206,yakult,360,400,40,1,00277,India
128507,2023-12-18,210,mountain dew,75,100,25,1,00276,India
128507,2023-12-18,201,paneer,210,340,130,1,00276,India
357169,2023-12-18,210,mountain dew,75,100,25,1,00038,India
467653,2023-12-18,209,pepsi,75,100,25,1,00252,India
467653,2023-12-18,205,classic yogurt,45,60,15,1,00252,India
467653,2023-12-18,203,mango yogurt,50,60,10,1,00252,India
584635,2023-12-18,207,coca cola,75,100,25,1,00229,India
584635,2023-12-18,213,bisleri,6,15,9,1,00229,India
584635,2023-12-18,202,milk,12,27,15,1,00229,India
584635,2023-12-18,201,paneer,210,340,130,1,00229,India
584635,2023-12-18,210,mountain dew,75,100,25,1,00229,India
374766,2023-12-18,203,mango yogurt,50,60,10,1,00063,India
374766,2023-12-18,207,coca cola,75,100,25,1,00063,India
374766,2023-12-18,208,sprite,75,100,25,1,00063,India
374766,2023-12-18,211,red bull,90,125,35,1,00063,India
345106,2023-12-18,204,strawberry yogurt,50,60,10,1,00075,India
345106,2023-12-18,207,coca cola,75,100,25,1,00075,India
345106,2023-12-18,212,amul cheese,250,315,65,1,00075,India
306949,2023-12-18,207,coca cola,75,100,25,1,00129,India
533575,2023-12-18,213,bisleri,6,15,9,1,00034,India
533575,2023-12-18,212,amul cheese,250,315,65,1,00034,India
533575,2023-12-18,209,pepsi,75,100,25,1,00034,India
533575,2023-12-18,202,milk,12,27,15,1,00034,India
779946,2023-12-18,206,yakult,360,400,40,1,00024,India
779946,2023-12-18,212,amul cheese,250,315,65,1,00024,India
558356,2023-12-18,211,red bull,90,125,35,1,00237,India
558356,2023-12-18,201,paneer,210,340,130,1,00237,India
558356,2023-12-18,204,strawberry yogurt,50,60,10,1,00237,India
558356,2023-12-18,203,mango yogurt,50,60,10,1,00237,India
152422,2023-12-18,211,red bull,90,125,35,1,00084,India
152422,2023-12-18,213,bisleri,6,15,9,1,00084,India
152422,2023-12-18,209,pepsi,75,100,25,1,00084,India
152422,2023-12-18,207,coca cola,75,100,25,1,00084,India
848500,2023-12-18,205,classic yogurt,45,60,15,1,00227,India
848500,2023-12-18,201,paneer,210,340,130,1,00227,India
848500,2023-12-18,207,coca cola,75,100,25,1,00227,India
927793,2023-12-18,204,strawberry yogurt,50,60,10,1,00272,India
927793,2023-12-18,201,paneer,210,340,130,1,00272,India
558625,2023-12-18,212,amul cheese,250,315,65,1,00367,India
558625,2023-12-18,211,red bull,90,125,35,1,00367,India
558625,2023-12-18,201,paneer,210,340,130,1,00367,India
894147,2023-12-18,210,mountain dew,75,100,25,1,00246,India
894147,2023-12-18,213,bisleri,6,15,9,1,00246,India
287390,2023-12-18,202,milk,12,27,15,1,00035,India
287390,2023-12-18,208,sprite,75,100,25,1,00035,India
312076,2023-12-18,203,mango yogurt,50,60,10,1,00433,India
312076,2023-12-18,210,mountain dew,75,100,25,1,00433,India
312076,2023-12-18,208,sprite,75,100,25,1,00433,India
868625,2023-12-18,201,paneer,210,340,130,1,00010,India
868625,2023-12-18,202,milk,12,27,15,1,00010,India
868625,2023-12-18,203,mango yogurt,50,60,10,1,00010,India
868625,2023-12-18,208,sprite,75,100,25,1,00010,India
631992,2023-12-18,209,pepsi,75,100,25,1,00221,India
631992,2023-12-18,212,amul cheese,250,315,65,1,00221,India
561968,2023-12-18,205,classic yogurt,45,60,15,1,00313,India
561968,2023-12-18,204,strawberry yogurt,50,60,10,1,00313,India
325617,2023-12-18,208,sprite,75,100,25,1,00418,India
325617,2023-12-18,203,mango yogurt,50,60,10,1,00418,India
775349,2023-12-18,208,sprite,75,100,25,1,00454,India
775349,2023-12-18,211,red bull,90,125,35,1,00454,India
775349,2023-12-18,213,bisleri,6,15,9,1,00454,India
925077,2023-12-18,202,milk,12,27,15,1,00468,India
925077,2023-12-18,205,classic yogurt,45,60,15,1,00468,India
968324,2023-12-18,209,pepsi,75,100,25,1,00053,India
968324,2023-12-18,203,mango yogurt,50,60,10,1,00053,India
895970,2023-12-18,209,pepsi,75,100,25,1,00421,India
895970,2023-12-18,203,mango yogurt,50,60,10,1,00421,India
895970,2023-12-18,205,classic yogurt,45,60,15,1,00421,India
594951,2023-12-18,203,mango yogurt,50,60,10,1,00050,India
594951,2023-12-18,207,coca cola,75,100,25,1,00050,India
695998,2023-12-18,213,bisleri,6,15,9,1,00064,India
695998,2023-12-18,204,strawberry yogurt,50,60,10,1,00064,India
347618,2023-12-18,204,strawberry yogurt,50,60,10,1,00443,India
347618,2023-12-18,210,mountain dew,75,100,25,1,00443,India
347618,2023-12-18,206,yakult,360,400,40,1,00443,India
451042,2023-12-18,205,classic yogurt,45,60,15,1,00250,India
451042,2023-12-18,204,strawberry yogurt,50,60,10,1,00250,India
725775,2023-12-18,210,mountain dew,75,100,25,1,00446,India
725775,2023-12-18,204,strawberry yogurt,50,60,10,1,00446,India
725775,2023-12-18,207,coca cola,75,100,25,1,00446,India
597586,2023-12-18,203,mango yogurt,50,60,10,1,00347,India
597586,2023-12-18,211,red bull,90,125,35,1,00347,India
971926,2023-12-18,206,yakult,360,400,40,1,00371,India
255781,2023-12-18,209,pepsi,75,100,25,1,00007,India
255781,2023-12-18,207,coca cola,75,100,25,1,00007,India
474852,2023-12-18,208,sprite,75,100,25,1,00067,India
474852,2023-12-18,207,coca cola,75,100,25,1,00067,India
474852,2023-12-18,212,amul cheese,250,315,65,1,00067,India
474852,2023-12-18,202,milk,12,27,15,1,00067,India
474852,2023-12-18,204,strawberry yogurt,50,60,10,1,00067,India
167355,2023-12-18,209,pepsi,75,100,25,1,00483,India
447986,2023-12-18,213,bisleri,6,15,9,1,00254,India
447986,2023-12-18,211,red bull,90,125,35,1,00254,India
447986,2023-12-18,202,milk,12,27,15,1,00254,India
385511,2023-12-18,211,red bull,90,125,35,1,00470,India
385511,2023-12-18,207,coca cola,75,100,25,1,00470,India
385511,2023-12-18,210,mountain dew,75,100,25,1,00470,India
895793,2023-12-18,203,mango yogurt,50,60,10,1,00028,India
282924,2023-12-18,212,amul cheese,250,315,65,1,00121,India
282924,2023-12-18,208,sprite,75,100,25,1,00121,India
282924,2023-12-18,202,milk,12,27,15,1,00121,India
713185,2023-12-18,208,sprite,75,100,25,1,00058,India
713185,2023-12-18,209,pepsi,75,100,25,1,00058,India
657008,2023-12-18,213,bisleri,6,15,9,1,00129,India
657008,2023-12-18,207,coca cola,75,100,25,1,00129,India
657008,2023-12-18,206,yakult,360,400,40,1,00129,India
657008,2023-12-18,212,amul cheese,250,315,65,1,00129,India
483083,2023-12-18,207,coca cola,75,100,25,1,00189,India
483083,2023-12-18,208,sprite,75,100,25,1,00189,India
483083,2023-12-18,213,bisleri,6,15,9,1,00189,India
483083,2023-12-18,205,classic yogurt,45,60,15,1,00189,India
483083,2023-12-18,210,mountain dew,75,100,25,1,00189,India
876431,2023-12-18,206,yakult,360,400,40,1,00267,India
597431,2023-12-18,203,mango yogurt,50,60,10,1,00283,India
597431,2023-12-18,206,yakult,360,400,40,1,00283,India
930499,2023-12-18,208,sprite,75,100,25,1,00475,India
368722,2023-12-18,212,amul cheese,250,315,65,1,00156,India
368722,2023-12-18,201,paneer,210,340,130,1,00156,India
797242,2023-12-18,213,bisleri,6,15,9,1,00207,India
797242,2023-12-18,204,strawberry yogurt,50,60,10,1,00207,India
797242,2023-12-18,205,classic yogurt,45,60,15,1,00207,India
797242,2023-12-18,209,pepsi,75,100,25,1,00207,India
623655,2023-12-18,208,sprite,75,100,25,1,00043,India
623655,2023-12-18,203,mango yogurt,50,60,10,1,00043,India
623655,2023-12-18,212,amul cheese,250,315,65,1,00043,India
623655,2023-12-18,201,paneer,210,340,130,1,00043,India
473950,2023-12-18,201,paneer,210,340,130,1,00375,India
473950,2023-12-18,211,red bull,90,125,35,1,00375,India
473950,2023-12-18,204,strawberry yogurt,50,60,10,1,00375,India
473950,2023-12-18,206,yakult,360,400,40,1,00375,India
718654,2023-12-18,205,classic yogurt,45,60,15,1,00022,India
718654,2023-12-18,212,amul cheese,250,315,65,1,00022,India
718654,2023-12-18,201,paneer,210,340,130,1,00022,India
718654,2023-12-18,213,bisleri,6,15,9,1,00022,India
711756,2023-12-18,210,mountain dew,75,100,25,1,00023,India
711756,2023-12-18,205,classic yogurt,45,60,15,1,00023,India
711756,2023-12-18,202,milk,12,27,15,1,00023,India
857169,2023-12-18,205,classic yogurt,45,60,15,1,00450,India
857169,2023-12-18,211,red bull,90,125,35,1,00450,India
973560,2023-12-18,212,amul cheese,250,315,65,1,00258,India
973560,2023-12-18,209,pepsi,75,100,25,1,00258,India
973560,2023-12-18,211,red bull,90,125,35,1,00258,India
730280,2023-12-18,205,classic yogurt,45,60,15,1,00152,India
730280,2023-12-18,207,coca cola,75,100,25,1,00152,India
730280,2023-12-18,209,pepsi,75,100,25,1,00152,India
567969,2023-12-18,209,pepsi,75,100,25,1,00378,India
567969,2023-12-18,208,sprite,75,100,25,1,00378,India
567969,2023-12-18,202,milk,12,27,15,1,00378,India
567969,2023-12-18,206,yakult,360,400,40,1,00378,India
567969,2023-12-18,205,classic yogurt,45,60,15,1,00378,India
267401,2023-12-18,209,pepsi,75,100,25,1,00499,India
267401,2023-12-18,204,strawberry yogurt,50,60,10,1,00499,India
267401,2023-12-18,205,classic yogurt,45,60,15,1,00499,India
267401,2023-12-18,203,mango yogurt,50,60,10,1,00499,India
296056,2023-12-18,211,red bull,90,125,35,1,00168,India
687851,2023-12-18,204,strawberry yogurt,50,60,10,1,00009,India
687851,2023-12-18,212,amul cheese,250,315,65,1,00009,India
314926,2023-12-18,207,coca cola,75,100,25,1,00408,India
314926,2023-12-18,213,bisleri,6,15,9,1,00408,India
314926,2023-12-18,202,milk,12,27,15,1,00408,India
314926,2023-12-18,205,classic yogurt,45,60,15,1,00408,India
789346,2023-12-18,201,paneer,210,340,130,1,00329,India
789346,2023-12-18,202,milk,12,27,15,1,00329,India
789346,2023-12-18,203,mango yogurt,50,60,10,1,00329,India
789346,2023-12-18,210,mountain dew,75,100,25,1,00329,India
448583,2023-12-18,210,mountain dew,75,100,25,1,00166,India
448583,2023-12-18,203,mango yogurt,50,60,10,1,00166,India
448583,2023-12-18,204,strawberry yogurt,50,60,10,1,00166,India
448583,2023-12-18,201,paneer,210,340,130,1,00166,India
318828,2023-12-18,205,classic yogurt,45,60,15,1,00281,India
318828,2023-12-18,211,red bull,90,125,35,1,00281,India
318828,2023-12-18,208,sprite,75,100,25,1,00281,India
187251,2023-12-18,201,paneer,210,340,130,1,00337,India
356029,2023-12-18,206,yakult,360,400,40,1,00421,India
167646,2023-12-19,213,bisleri,6,15,9,1,00148,India
167646,2023-12-19,211,red bull,90,125,35,1,00148,India
371397,2023-12-19,205,classic yogurt,45,60,15,1,00104,India
371397,2023-12-19,204,strawberry yogurt,50,60,10,1,00104,India
371397,2023-12-19,208,sprite,75,100,25,1,00104,India
371397,2023-12-19,213,bisleri,6,15,9,1,00104,India
371397,2023-12-19,206,yakult,360,400,40,1,00104,India
733609,2023-12-19,209,pepsi,75,100,25,1,00078,India
733609,2023-12-19,204,strawberry yogurt,50,60,10,1,00078,India
121146,2023-12-19,206,yakult,360,400,40,1,00021,India
121146,2023-12-19,201,paneer,210,340,130,1,00021,India
121146,2023-12-19,203,mango yogurt,50,60,10,1,00021,India
121146,2023-12-19,205,classic yogurt,45,60,15,1,00021,India
442819,2023-12-19,204,strawberry yogurt,50,60,10,1,00437,India
442819,2023-12-19,203,mango yogurt,50,60,10,1,00437,India
442819,2023-12-19,206,yakult,360,400,40,1,00437,India
442819,2023-12-19,213,bisleri,6,15,9,1,00437,India
443103,2023-12-19,213,bisleri,6,15,9,1,00357,India
928757,2023-12-19,206,yakult,360,400,40,1,00195,India
928757,2023-12-19,212,amul cheese,250,315,65,1,00195,India
928757,2023-12-19,209,pepsi,75,100,25,1,00195,India
227334,2023-12-19,211,red bull,90,125,35,1,00117,India
227334,2023-12-19,212,amul cheese,250,315,65,1,00117,India
227334,2023-12-19,204,strawberry yogurt,50,60,10,1,00117,India
227334,2023-12-19,207,coca cola,75,100,25,1,00117,India
504321,2023-12-19,211,red bull,90,125,35,1,00225,India
504321,2023-12-19,208,sprite,75,100,25,1,00225,India
841194,2023-12-19,205,classic yogurt,45,60,15,1,00394,India
841194,2023-12-19,207,coca cola,75,100,25,1,00394,India
271737,2023-12-19,203,mango yogurt,50,60,10,1,00083,India
271737,2023-12-19,211,red bull,90,125,35,1,00083,India
271737,2023-12-19,204,strawberry yogurt,50,60,10,1,00083,India
271737,2023-12-19,206,yakult,360,400,40,1,00083,India
294797,2023-12-19,211,red bull,90,125,35,1,00165,India
118989,2023-12-19,211,red bull,90,125,35,1,00159,India
118989,2023-12-19,210,mountain dew,75,100,25,1,00159,India
118989,2023-12-19,212,amul cheese,250,315,65,1,00159,India
118989,2023-12-19,213,bisleri,6,15,9,1,00159,India
118989,2023-12-19,204,strawberry yogurt,50,60,10,1,00159,India
615825,2023-12-19,206,yakult,360,400,40,1,00119,India
615825,2023-12-19,204,strawberry yogurt,50,60,10,1,00119,India
615825,2023-12-19,202,milk,12,27,15,1,00119,India
615825,2023-12-19,213,bisleri,6,15,9,1,00119,India
552552,2023-12-19,212,amul cheese,250,315,65,1,00109,India
552552,2023-12-19,207,coca cola,75,100,25,1,00109,India
552552,2023-12-19,206,yakult,360,400,40,1,00109,India
982337,2023-12-19,201,paneer,210,340,130,1,00370,India
296756,2023-12-19,201,paneer,210,340,130,1,00151,India
296756,2023-12-19,210,mountain dew,75,100,25,1,00151,India
296756,2023-12-19,203,mango yogurt,50,60,10,1,00151,India
817069,2023-12-19,213,bisleri,6,15,9,1,00429,India
817069,2023-12-19,204,strawberry yogurt,50,60,10,1,00429,India
817069,2023-12-19,210,mountain dew,75,100,25,1,00429,India
817069,2023-12-19,203,mango yogurt,50,60,10,1,00429,India
762888,2023-12-19,212,amul cheese,250,315,65,1,00338,India
762888,2023-12-19,208,sprite,75,100,25,1,00338,India
762888,2023-12-19,207,coca cola,75,100,25,1,00338,India
490606,2023-12-19,208,sprite,75,100,25,1,00489,India
490606,2023-12-19,204,strawberry yogurt,50,60,10,1,00489,India
404849,2023-12-19,212,amul cheese,250,315,65,1,00480,India
404849,2023-12-19,203,mango yogurt,50,60,10,1,00480,India
404849,2023-12-19,202,milk,12,27,15,1,00480,India
443210,2023-12-19,206,yakult,360,400,40,1,00432,India
443210,2023-12-19,209,pepsi,75,100,25,1,00432,India
443210,2023-12-19,202,milk,12,27,15,1,00432,India
915717,2023-12-19,202,milk,12,27,15,1,00478,India
759747,2023-12-19,213,bisleri,6,15,9,1,00360,India
759747,2023-12-19,202,milk,12,27,15,1,00360,India
521451,2023-12-19,208,sprite,75,100,25,1,00309,India
521451,2023-12-19,203,mango yogurt,50,60,10,1,00309,India
521451,2023-12-19,206,yakult,360,400,40,1,00309,India
358389,2023-12-19,202,milk,12,27,15,1,00059,India
358389,2023-12-19,212,amul cheese,250,315,65,1,00059,India
358389,2023-12-19,203,mango yogurt,50,60,10,1,00059,India
358389,2023-12-19,210,mountain dew,75,100,25,1,00059,India
438332,2023-12-19,209,pepsi,75,100,25,1,00069,India
865881,2023-12-19,202,milk,12,27,15,1,00447,India
740129,2023-12-19,204,strawberry yogurt,50,60,10,1,00322,India
170109,2023-12-19,205,classic yogurt,45,60,15,1,00290,India
170109,2023-12-19,204,strawberry yogurt,50,60,10,1,00290,India
170109,2023-12-19,212,amul cheese,250,315,65,1,00290,India
964042,2023-12-19,211,red bull,90,125,35,1,00054,India
778878,2023-12-19,211,red bull,90,125,35,1,00151,India
778878,2023-12-19,205,classic yogurt,45,60,15,1,00151,India
778878,2023-12-19,201,paneer,210,340,130,1,00151,India
165718,2023-12-19,206,yakult,360,400,40,1,00352,India
165718,2023-12-19,209,pepsi,75,100,25,1,00352,India
165718,2023-12-19,204,strawberry yogurt,50,60,10,1,00352,India
134231,2023-12-19,205,classic yogurt,45,60,15,1,00231,India
134231,2023-12-19,201,paneer,210,340,130,1,00231,India
823254,2023-12-19,206,yakult,360,400,40,1,00270,India
823254,2023-12-19,213,bisleri,6,15,9,1,00270,India
234291,2023-12-19,209,pepsi,75,100,25,1,00084,India
234291,2023-12-19,206,yakult,360,400,40,1,00084,India
734170,2023-12-19,212,amul cheese,250,315,65,1,00341,India
734170,2023-12-19,205,classic yogurt,45,60,15,1,00341,India
734170,2023-12-19,213,bisleri,6,15,9,1,00341,India
734170,2023-12-19,206,yakult,360,400,40,1,00341,India
312515,2023-12-19,212,amul cheese,250,315,65,1,00440,India
560591,2023-12-19,206,yakult,360,400,40,1,00145,India
693361,2023-12-19,201,paneer,210,340,130,1,00248,India
693361,2023-12-19,203,mango yogurt,50,60,10,1,00248,India
337698,2023-12-19,210,mountain dew,75,100,25,1,00494,India
983266,2023-12-19,209,pepsi,75,100,25,1,00192,India
983266,2023-12-19,213,bisleri,6,15,9,1,00192,India
983266,2023-12-19,203,mango yogurt,50,60,10,1,00192,India
464919,2023-12-19,210,mountain dew,75,100,25,1,00175,India
464919,2023-12-19,204,strawberry yogurt,50,60,10,1,00175,India
464919,2023-12-19,207,coca cola,75,100,25,1,00175,India
464919,2023-12-19,211,red bull,90,125,35,1,00175,India
249592,2023-12-19,208,sprite,75,100,25,1,00251,India
663487,2023-12-19,208,sprite,75,100,25,1,00008,India
931286,2023-12-19,203,mango yogurt,50,60,10,1,00131,India
782500,2023-12-19,211,red bull,90,125,35,1,00087,India
782500,2023-12-19,205,classic yogurt,45,60,15,1,00087,India
782500,2023-12-19,212,amul cheese,250,315,65,1,00087,India
691014,2023-12-19,213,bisleri,6,15,9,1,00064,India
456440,2023-12-19,207,coca cola,75,100,25,1,00013,India
456440,2023-12-19,211,red bull,90,125,35,1,00013,India
456440,2023-12-19,205,classic yogurt,45,60,15,1,00013,India
456440,2023-12-19,209,pepsi,75,100,25,1,00013,India
887815,2023-12-19,202,milk,12,27,15,1,00061,India
887815,2023-12-19,209,pepsi,75,100,25,1,00061,India
887815,2023-12-19,204,strawberry yogurt,50,60,10,1,00061,India
887815,2023-12-19,206,yakult,360,400,40,1,00061,India
887815,2023-12-19,207,coca cola,75,100,25,1,00061,India
525600,2023-12-19,211,red bull,90,125,35,1,00397,India
525600,2023-12-19,209,pepsi,75,100,25,1,00397,India
525600,2023-12-19,207,coca cola,75,100,25,1,00397,India
525600,2023-12-19,210,mountain dew,75,100,25,1,00397,India
525600,2023-12-19,212,amul cheese,250,315,65,1,00397,India
923265,2023-12-19,205,classic yogurt,45,60,15,1,00210,India
923265,2023-12-19,210,mountain dew,75,100,25,1,00210,India
155280,2023-12-19,205,classic yogurt,45,60,15,1,00228,India
155280,2023-12-19,206,yakult,360,400,40,1,00228,India
155280,2023-12-19,203,mango yogurt,50,60,10,1,00228,India
588240,2023-12-19,202,milk,12,27,15,1,00284,India
588240,2023-12-19,201,paneer,210,340,130,1,00284,India
588240,2023-12-19,212,amul cheese,250,315,65,1,00284,India
843362,2023-12-19,211,red bull,90,125,35,1,00472,India
843362,2023-12-19,206,yakult,360,400,40,1,00472,India
843362,2023-12-19,208,sprite,75,100,25,1,00472,India
768587,2023-12-19,203,mango yogurt,50,60,10,1,00238,India
134147,2023-12-19,211,red bull,90,125,35,1,00184,India
242952,2023-12-20,208,sprite,75,100,25,1,00461,India
242952,2023-12-20,206,yakult,360,400,40,1,00461,India
499824,2023-12-20,202,milk,12,27,15,1,00368,India
499824,2023-12-20,210,mountain dew,75,100,25,1,00368,India
499824,2023-12-20,208,sprite,75,100,25,1,00368,India
864314,2023-12-20,210,mountain dew,75,100,25,1,00413,India
864314,2023-12-20,212,amul cheese,250,315,65,1,00413,India
807493,2023-12-20,203,mango yogurt,50,60,10,1,00396,India
423676,2023-12-20,201,paneer,210,340,130,1,00126,India
423676,2023-12-20,206,yakult,360,400,40,1,00126,India
423676,2023-12-20,213,bisleri,6,15,9,1,00126,India
831683,2023-12-20,202,milk,12,27,15,1,00364,India
673714,2023-12-20,202,milk,12,27,15,1,00064,India
673714,2023-12-20,204,strawberry yogurt,50,60,10,1,00064,India
673714,2023-12-20,208,sprite,75,100,25,1,00064,India
673714,2023-12-20,207,coca cola,75,100,25,1,00064,India
389595,2023-12-20,212,amul cheese,250,315,65,1,00201,India
389595,2023-12-20,210,mountain dew,75,100,25,1,00201,India
389595,2023-12-20,201,paneer,210,340,130,1,00201,India
214126,2023-12-20,212,amul cheese,250,315,65,1,00420,India
214126,2023-12-20,205,classic yogurt,45,60,15,1,00420,India
214126,2023-12-20,202,milk,12,27,15,1,00420,India
214126,2023-12-20,203,mango yogurt,50,60,10,1,00420,India
214126,2023-12-20,209,pepsi,75,100,25,1,00420,India
369424,2023-12-20,201,paneer,210,340,130,1,00026,India
369424,2023-12-20,212,amul cheese,250,315,65,1,00026,India
369424,2023-12-20,213,bisleri,6,15,9,1,00026,India
369424,2023-12-20,204,strawberry yogurt,50,60,10,1,00026,India
836471,2023-12-20,204,strawberry yogurt,50,60,10,1,00017,India
836471,2023-12-20,211,red bull,90,125,35,1,00017,India
938760,2023-12-20,213,bisleri,6,15,9,1,00311,India
938760,2023-12-20,209,pepsi,75,100,25,1,00311,India
938760,2023-12-20,211,red bull,90,125,35,1,00311,India
742512,2023-12-20,201,paneer,210,340,130,1,00465,India
742512,2023-12-20,202,milk,12,27,15,1,00465,India
742512,2023-12-20,207,coca cola,75,100,25,1,00465,India
742512,2023-12-20,211,red bull,90,125,35,1,00465,India
520219,2023-12-20,203,mango yogurt,50,60,10,1,00500,India
520219,2023-12-20,212,amul cheese,250,315,65,1,00500,India
520219,2023-12-20,206,yakult,360,400,40,1,00500,India
353261,2023-12-20,203,mango yogurt,50,60,10,1,00324,India
531042,2023-12-20,211,red bull,90,125,35,1,00276,India
531042,2023-12-20,212,amul cheese,250,315,65,1,00276,India
993605,2023-12-20,212,amul cheese,250,315,65,1,00233,India
771919,2023-12-20,204,strawberry yogurt,50,60,10,1,00303,India
771919,2023-12-20,213,bisleri,6,15,9,1,00303,India
771919,2023-12-20,207,coca cola,75,100,25,1,00303,India
468874,2023-12-20,210,mountain dew,75,100,25,1,00409,India
468874,2023-12-20,213,bisleri,6,15,9,1,00409,India
468874,2023-12-20,204,strawberry yogurt,50,60,10,1,00409,India
468874,2023-12-20,212,amul cheese,250,315,65,1,00409,India
468874,2023-12-20,205,classic yogurt,45,60,15,1,00409,India
461059,2023-12-20,208,sprite,75,100,25,1,00265,India
461059,2023-12-20,213,bisleri,6,15,9,1,00265,India
461059,2023-12-20,210,mountain dew,75,100,25,1,00265,India
461059,2023-12-20,212,amul cheese,250,315,65,1,00265,India
121693,2023-12-20,210,mountain dew,75,100,25,1,00173,India
121693,2023-12-20,203,mango yogurt,50,60,10,1,00173,India
121693,2023-12-20,201,paneer,210,340,130,1,00173,India
121693,2023-12-20,204,strawberry yogurt,50,60,10,1,00173,India
121693,2023-12-20,212,amul cheese,250,315,65,1,00173,India
822477,2023-12-20,208,sprite,75,100,25,1,00096,India
822477,2023-12-20,213,bisleri,6,15,9,1,00096,India
822477,2023-12-20,207,coca cola,75,100,25,1,00096,India
822477,2023-12-20,202,milk,12,27,15,1,00096,India
931626,2023-12-20,206,yakult,360,400,40,1,00138,India
374051,2023-12-20,213,bisleri,6,15,9,1,00232,India
834270,2023-12-20,210,mountain dew,75,100,25,1,00185,India
834270,2023-12-20,201,paneer,210,340,130,1,00185,India
834270,2023-12-20,207,coca cola,75,100,25,1,00185,India
834270,2023-12-20,202,milk,12,27,15,1,00185,India
834270,2023-12-20,208,sprite,75,100,25,1,00185,India
681446,2023-12-20,201,paneer,210,340,130,1,00015,India
681446,2023-12-20,212,amul cheese,250,315,65,1,00015,India
193133,2023-12-20,202,milk,12,27,15,1,00372,India
551077,2023-12-20,212,amul cheese,250,315,65,1,00450,India
551077,2023-12-20,206,yakult,360,400,40,1,00450,India
551077,2023-12-20,209,pepsi,75,100,25,1,00450,India
699320,2023-12-20,204,strawberry yogurt,50,60,10,1,00008,India
699320,2023-12-20,203,mango yogurt,50,60,10,1,00008,India
699320,2023-12-20,202,milk,12,27,15,1,00008,India
868595,2023-12-20,213,bisleri,6,15,9,1,00408,India
868595,2023-12-20,205,classic yogurt,45,60,15,1,00408,India
868595,2023-12-20,201,paneer,210,340,130,1,00408,India
320905,2023-12-20,211,red bull,90,125,35,1,00412,India
320905,2023-12-20,210,mountain dew,75,100,25,1,00412,India
853166,2023-12-20,210,mountain dew,75,100,25,1,00177,India
853166,2023-12-20,203,mango yogurt,50,60,10,1,00177,India
853166,2023-12-20,204,strawberry yogurt,50,60,10,1,00177,India
853166,2023-12-20,205,classic yogurt,45,60,15,1,00177,India
747786,2023-12-20,207,coca cola,75,100,25,1,00429,India
747786,2023-12-20,212,amul cheese,250,315,65,1,00429,India
479120,2023-12-20,212,amul cheese,250,315,65,1,00353,India
479120,2023-12-20,206,yakult,360,400,40,1,00353,India
479120,2023-12-20,207,coca cola,75,100,25,1,00353,India
479120,2023-12-20,211,red bull,90,125,35,1,00353,India
479120,2023-12-20,202,milk,12,27,15,1,00353,India
253360,2023-12-20,203,mango yogurt,50,60,10,1,00151,India
381121,2023-12-20,204,strawberry yogurt,50,60,10,1,00407,India
381121,2023-12-20,209,pepsi,75,100,25,1,00407,India
381121,2023-12-20,208,sprite,75,100,25,1,00407,India
381121,2023-12-20,213,bisleri,6,15,9,1,00407,India
364759,2023-12-20,202,milk,12,27,15,1,00275,India
779291,2023-12-20,209,pepsi,75,100,25,1,00392,India
877824,2023-12-20,209,pepsi,75,100,25,1,00406,India
877824,2023-12-20,211,red bull,90,125,35,1,00406,India
293235,2023-12-20,209,pepsi,75,100,25,1,00202,India
293235,2023-12-20,211,red bull,90,125,35,1,00202,India
167929,2023-12-20,204,strawberry yogurt,50,60,10,1,00421,India
167929,2023-12-20,210,mountain dew,75,100,25,1,00421,India
291855,2023-12-20,208,sprite,75,100,25,1,00305,India
291855,2023-12-20,201,paneer,210,340,130,1,00305,India
245411,2023-12-20,213,bisleri,6,15,9,1,00370,India
540841,2023-12-20,210,mountain dew,75,100,25,1,00007,India
540841,2023-12-20,208,sprite,75,100,25,1,00007,India
736890,2023-12-20,212,amul cheese,250,315,65,1,00084,India
736890,2023-12-20,211,red bull,90,125,35,1,00084,India
223398,2023-12-20,207,coca cola,75,100,25,1,00094,India
223398,2023-12-20,206,yakult,360,400,40,1,00094,India
223398,2023-12-20,201,paneer,210,340,130,1,00094,India
744421,2023-12-20,210,mountain dew,75,100,25,1,00415,India
744421,2023-12-20,213,bisleri,6,15,9,1,00415,India
165584,2023-12-20,205,classic yogurt,45,60,15,1,00323,India
165584,2023-12-20,202,milk,12,27,15,1,00323,India
912690,2023-12-20,208,sprite,75,100,25,1,00314,India
277782,2023-12-20,208,sprite,75,100,25,1,00166,India
277782,2023-12-20,205,classic yogurt,45,60,15,1,00166,India
272596,2023-12-20,206,yakult,360,400,40,1,00227,India
272596,2023-12-20,202,milk,12,27,15,1,00227,India
799826,2023-12-20,204,strawberry yogurt,50,60,10,1,00460,India
599931,2023-12-20,204,strawberry yogurt,50,60,10,1,00409,India
599931,2023-12-20,206,yakult,360,400,40,1,00409,India
599931,2023-12-20,213,bisleri,6,15,9,1,00409,India
599931,2023-12-20,212,amul cheese,250,315,65,1,00409,India
590504,2023-12-20,212,amul cheese,250,315,65,1,00039,India
590504,2023-12-20,205,classic yogurt,45,60,15,1,00039,India
355679,2023-12-20,204,strawberry yogurt,50,60,10,1,00406,India
355679,2023-12-20,205,classic yogurt,45,60,15,1,00406,India
355679,2023-12-20,207,coca cola,75,100,25,1,00406,India
102351,2023-12-20,204,strawberry yogurt,50,60,10,1,00013,India
753474,2023-12-21,210,mountain dew,75,100,25,1,00415,India
753474,2023-12-21,211,red bull,90,125,35,1,00415,India
825576,2023-12-21,209,pepsi,75,100,25,1,00310,India
825576,2023-12-21,207,coca cola,75,100,25,1,00310,India
825576,2023-12-21,211,red bull,90,125,35,1,00310,India
690510,2023-12-21,203,mango yogurt,50,60,10,1,00112,India
740206,2023-12-21,201,paneer,210,340,130,1,00300,India
740206,2023-12-21,212,amul cheese,250,315,65,1,00300,India
400726,2023-12-21,207,coca cola,75,100,25,1,00354,India
400726,2023-12-21,212,amul cheese,250,315,65,1,00354,India
400726,2023-12-21,202,milk,12,27,15,1,00354,India
508950,2023-12-21,206,yakult,360,400,40,1,00287,India
499470,2023-12-21,203,mango yogurt,50,60,10,1,00194,India
499470,2023-12-21,210,mountain dew,75,100,25,1,00194,India
499470,2023-12-21,212,amul cheese,250,315,65,1,00194,India
499470,2023-12-21,204,strawberry yogurt,50,60,10,1,00194,India
917148,2023-12-21,206,yakult,360,400,40,1,00431,India
917148,2023-12-21,211,red bull,90,125,35,1,00431,India
102390,2023-12-21,204,strawberry yogurt,50,60,10,1,00229,India
102390,2023-12-21,209,pepsi,75,100,25,1,00229,India
102390,2023-12-21,207,coca cola,75,100,25,1,00229,India
102390,2023-12-21,206,yakult,360,400,40,1,00229,India
574540,2023-12-21,202,milk,12,27,15,1,00365,India
574540,2023-12-21,213,bisleri,6,15,9,1,00365,India
574540,2023-12-21,206,yakult,360,400,40,1,00365,India
566641,2023-12-21,213,bisleri,6,15,9,1,00370,India
566641,2023-12-21,210,mountain dew,75,100,25,1,00370,India
744664,2023-12-21,209,pepsi,75,100,25,1,00222,India
585559,2023-12-21,204,strawberry yogurt,50,60,10,1,00150,India
585559,2023-12-21,205,classic yogurt,45,60,15,1,00150,India
585559,2023-12-21,206,yakult,360,400,40,1,00150,India
585559,2023-12-21,213,bisleri,6,15,9,1,00150,India
585559,2023-12-21,202,milk,12,27,15,1,00150,India
840991,2023-12-21,207,coca cola,75,100,25,1,00267,India
840991,2023-12-21,203,mango yogurt,50,60,10,1,00267,India
840991,2023-12-21,208,sprite,75,100,25,1,00267,India
840991,2023-12-21,213,bisleri,6,15,9,1,00267,India
313431,2023-12-21,203,mango yogurt,50,60,10,1,00100,India
198083,2023-12-21,212,amul cheese,250,315,65,1,00483,India
313700,2023-12-21,203,mango yogurt,50,60,10,1,00491,India
313700,2023-12-21,212,amul cheese,250,315,65,1,00491,India
313700,2023-12-21,202,milk,12,27,15,1,00491,India
313700,2023-12-21,210,mountain dew,75,100,25,1,00491,India
313700,2023-12-21,211,red bull,90,125,35,1,00491,India
294896,2023-12-21,209,pepsi,75,100,25,1,00409,India
294896,2023-12-21,213,bisleri,6,15,9,1,00409,India
294896,2023-12-21,212,amul cheese,250,315,65,1,00409,India
294896,2023-12-21,202,milk,12,27,15,1,00409,India
952620,2023-12-21,204,strawberry yogurt,50,60,10,1,00150,India
952620,2023-12-21,212,amul cheese,250,315,65,1,00150,India
952620,2023-12-21,210,mountain dew,75,100,25,1,00150,India
952620,2023-12-21,201,paneer,210,340,130,1,00150,India
568654,2023-12-21,206,yakult,360,400,40,1,00444,India
568654,2023-12-21,210,mountain dew,75,100,25,1,00444,India
568654,2023-12-21,212,amul cheese,250,315,65,1,00444,India
568654,2023-12-21,205,classic yogurt,45,60,15,1,00444,India
403598,2023-12-21,204,strawberry yogurt,50,60,10,1,00035,India
403598,2023-12-21,209,pepsi,75,100,25,1,00035,India
291597,2023-12-21,207,coca cola,75,100,25,1,00006,India
291597,2023-12-21,212,amul cheese,250,315,65,1,00006,India
994299,2023-12-21,201,paneer,210,340,130,1,00428,India
994299,2023-12-21,212,amul cheese,250,315,65,1,00428,India
994299,2023-12-21,204,strawberry yogurt,50,60,10,1,00428,India
994299,2023-12-21,211,red bull,90,125,35,1,00428,India
994299,2023-12-21,213,bisleri,6,15,9,1,00428,India
302372,2023-12-21,203,mango yogurt,50,60,10,1,00308,India
379848,2023-12-21,204,strawberry yogurt,50,60,10,1,00387,India
909985,2023-12-21,201,paneer,210,340,130,1,00094,India
909985,2023-12-21,202,milk,12,27,15,1,00094,India
408370,2023-12-21,212,amul cheese,250,315,65,1,00318,India
408370,2023-12-21,205,classic yogurt,45,60,15,1,00318,India
236101,2023-12-21,204,strawberry yogurt,50,60,10,1,00227,India
236101,2023-12-21,206,yakult,360,400,40,1,00227,India
236101,2023-12-21,207,coca cola,75,100,25,1,00227,India
236101,2023-12-21,202,milk,12,27,15,1,00227,India
236101,2023-12-21,210,mountain dew,75,100,25,1,00227,India
104471,2023-12-21,207,coca cola,75,100,25,1,00035,India
104471,2023-12-21,201,paneer,210,340,130,1,00035,India
104471,2023-12-21,213,bisleri,6,15,9,1,00035,India
759553,2023-12-21,206,yakult,360,400,40,1,00251,India
802243,2023-12-21,211,red bull,90,125,35,1,00117,India
940673,2023-12-21,206,yakult,360,400,40,1,00251,India
940673,2023-12-21,201,paneer,210,340,130,1,00251,India
940673,2023-12-21,210,mountain dew,75,100,25,1,00251,India
832887,2023-12-21,206,yakult,360,400,40,1,00181,India
832887,2023-12-21,205,classic yogurt,45,60,15,1,00181,India
754211,2023-12-21,206,yakult,360,400,40,1,00449,India
754211,2023-12-21,212,amul cheese,250,315,65,1,00449,India
754211,2023-12-21,213,bisleri,6,15,9,1,00449,India
754211,2023-12-21,201,paneer,210,340,130,1,00449,India
754211,2023-12-21,207,coca cola,75,100,25,1,00449,India
665125,2023-12-21,203,mango yogurt,50,60,10,1,00086,India
665125,2023-12-21,209,pepsi,75,100,25,1,00086,India
665125,2023-12-21,212,amul cheese,250,315,65,1,00086,India
584214,2023-12-21,210,mountain dew,75,100,25,1,00376,India
584214,2023-12-21,206,yakult,360,400,40,1,00376,India
691876,2023-12-21,211,red bull,90,125,35,1,00064,India
691876,2023-12-21,203,mango yogurt,50,60,10,1,00064,India
484117,2023-12-21,210,mountain dew,75,100,25,1,00118,India
538691,2023-12-21,210,mountain dew,75,100,25,1,00199,India
832051,2023-12-21,208,sprite,75,100,25,1,00007,India
357548,2023-12-21,209,pepsi,75,100,25,1,00428,India
357548,2023-12-21,208,sprite,75,100,25,1,00428,India
357548,2023-12-21,201,paneer,210,340,130,1,00428,India
282095,2023-12-21,209,pepsi,75,100,25,1,00494,India
724524,2023-12-21,207,coca cola,75,100,25,1,00340,India
322180,2023-12-21,202,milk,12,27,15,1,00082,India
322180,2023-12-21,211,red bull,90,125,35,1,00082,India
322180,2023-12-21,209,pepsi,75,100,25,1,00082,India
531140,2023-12-21,209,pepsi,75,100,25,1,00452,India
531140,2023-12-21,205,classic yogurt,45,60,15,1,00452,India
531140,2023-12-21,211,red bull,90,125,35,1,00452,India
215264,2023-12-21,203,mango yogurt,50,60,10,1,00104,India
215264,2023-12-21,210,mountain dew,75,100,25,1,00104,India
215264,2023-12-21,211,red bull,90,125,35,1,00104,India
215264,2023-12-21,201,paneer,210,340,130,1,00104,India
109917,2023-12-21,207,coca cola,75,100,25,1,00017,India
109917,2023-12-21,213,bisleri,6,15,9,1,00017,India
109917,2023-12-21,206,yakult,360,400,40,1,00017,India
109917,2023-12-21,211,red bull,90,125,35,1,00017,India
109917,2023-12-21,208,sprite,75,100,25,1,00017,India
384303,2023-12-21,205,classic yogurt,45,60,15,1,00093,India
384303,2023-12-21,204,strawberry yogurt,50,60,10,1,00093,India
384303,2023-12-21,211,red bull,90,125,35,1,00093,India
384303,2023-12-21,208,sprite,75,100,25,1,00093,India
598542,2023-12-21,212,amul cheese,250,315,65,1,00130,India
598542,2023-12-21,205,classic yogurt,45,60,15,1,00130,India
598542,2023-12-21,213,bisleri,6,15,9,1,00130,India
456110,2023-12-21,207,coca cola,75,100,25,1,00087,India
456110,2023-12-21,213,bisleri,6,15,9,1,00087,India
136908,2023-12-21,213,bisleri,6,15,9,1,00075,India
136908,2023-12-21,211,red bull,90,125,35,1,00075,India
136908,2023-12-21,202,milk,12,27,15,1,00075,India
136908,2023-12-21,205,classic yogurt,45,60,15,1,00075,India
473575,2023-12-21,204,strawberry yogurt,50,60,10,1,00387,India
473575,2023-12-21,208,sprite,75,100,25,1,00387,India
444965,2023-12-21,202,milk,12,27,15,1,00310,India
849312,2023-12-21,209,pepsi,75,100,25,1,00392,India
849312,2023-12-21,201,paneer,210,340,130,1,00392,India
849312,2023-12-21,206,yakult,360,400,40,1,00392,India
849312,2023-12-21,210,mountain dew,75,100,25,1,00392,India
920561,2023-12-21,208,sprite,75,100,25,1,00235,India
856718,2023-12-21,201,paneer,210,340,130,1,00373,India
856718,2023-12-21,204,strawberry yogurt,50,60,10,1,00373,India
856718,2023-12-21,206,yakult,360,400,40,1,00373,India
226516,2023-12-21,212,amul cheese,250,315,65,1,00356,India
226516,2023-12-21,202,milk,12,27,15,1,00356,India
468583,2023-12-21,204,strawberry yogurt,50,60,10,1,00289,India
468583,2023-12-21,209,pepsi,75,100,25,1,00289,India
468583,2023-12-21,201,paneer,210,340,130,1,00289,India
165827,2023-12-21,206,yakult,360,400,40,1,00106,India
165827,2023-12-21,202,milk,12,27,15,1,00106,India
341434,2023-12-21,208,sprite,75,100,25,1,00494,India
341434,2023-12-21,210,mountain dew,75,100,25,1,00494,India
341434,2023-12-21,211,red bull,90,125,35,1,00494,India
341434,2023-12-21,203,mango yogurt,50,60,10,1,00494,India
108930,2023-12-21,209,pepsi,75,100,25,1,00248,India
108930,2023-12-21,205,classic yogurt,45,60,15,1,00248,India
108930,2023-12-21,211,red bull,90,125,35,1,00248,India
123226,2023-12-21,211,red bull,90,125,35,1,00007,India
123226,2023-12-21,204,strawberry yogurt,50,60,10,1,00007,India
123226,2023-12-21,206,yakult,360,400,40,1,00007,India
252926,2023-12-21,203,mango yogurt,50,60,10,1,00394,India
252926,2023-12-21,208,sprite,75,100,25,1,00394,India
748310,2023-12-21,208,sprite,75,100,25,1,00214,India
748310,2023-12-21,206,yakult,360,400,40,1,00214,India
957356,2023-12-21,210,mountain dew,75,100,25,1,00464,India
957356,2023-12-21,202,milk,12,27,15,1,00464,India
957356,2023-12-21,211,red bull,90,125,35,1,00464,India
957356,2023-12-21,209,pepsi,75,100,25,1,00464,India
116015,2023-12-21,201,paneer,210,340,130,1,00425,India
116015,2023-12-21,206,yakult,360,400,40,1,00425,India
258025,2023-12-21,207,coca cola,75,100,25,1,00200,India
258025,2023-12-21,204,strawberry yogurt,50,60,10,1,00200,India
676352,2023-12-21,211,red bull,90,125,35,1,00313,India
676352,2023-12-21,213,bisleri,6,15,9,1,00313,India
676352,2023-12-21,210,mountain dew,75,100,25,1,00313,India
676352,2023-12-21,208,sprite,75,100,25,1,00313,India
379083,2023-12-21,210,mountain dew,75,100,25,1,00169,India
379083,2023-12-21,202,milk,12,27,15,1,00169,India
379083,2023-12-21,201,paneer,210,340,130,1,00169,India
379083,2023-12-21,203,mango yogurt,50,60,10,1,00169,India
588590,2023-12-21,204,strawberry yogurt,50,60,10,1,00442,India
588590,2023-12-21,201,paneer,210,340,130,1,00442,India
725948,2023-12-21,204,strawberry yogurt,50,60,10,1,00047,India
501249,2023-12-21,205,classic yogurt,45,60,15,1,00359,India
501249,2023-12-21,201,paneer,210,340,130,1,00359,India
501249,2023-12-21,207,coca cola,75,100,25,1,00359,India
501249,2023-12-21,206,yakult,360,400,40,1,00359,India
501249,2023-12-21,208,sprite,75,100,25,1,00359,India
214535,2023-12-21,209,pepsi,75,100,25,1,00473,India
731465,2023-12-21,206,yakult,360,400,40,1,00243,India
731465,2023-12-21,202,milk,12,27,15,1,00243,India
731465,2023-12-21,207,coca cola,75,100,25,1,00243,India
731465,2023-12-21,210,mountain dew,75,100,25,1,00243,India
580215,2023-12-21,207,coca cola,75,100,25,1,00190,India
580215,2023-12-21,209,pepsi,75,100,25,1,00190,India
580215,2023-12-21,202,milk,12,27,15,1,00190,India
127231,2023-12-21,206,yakult,360,400,40,1,00167,India
127231,2023-12-21,204,strawberry yogurt,50,60,10,1,00167,India
591806,2023-12-21,205,classic yogurt,45,60,15,1,00123,India
591806,2023-12-21,204,strawberry yogurt,50,60,10,1,00123,India
591806,2023-12-21,201,paneer,210,340,130,1,00123,India
591806,2023-12-21,212,amul cheese,250,315,65,1,00123,India
591806,2023-12-21,209,pepsi,75,100,25,1,00123,India
645396,2023-12-21,202,milk,12,27,15,1,00459,India
586890,2023-12-21,211,red bull,90,125,35,1,00026,India
586890,2023-12-21,202,milk,12,27,15,1,00026,India
986550,2023-12-21,207,coca cola,75,100,25,1,00094,India
986550,2023-12-21,210,mountain dew,75,100,25,1,00094,India
986550,2023-12-21,208,sprite,75,100,25,1,00094,India
419969,2023-12-21,213,bisleri,6,15,9,1,00316,India
419969,2023-12-21,211,red bull,90,125,35,1,00316,India
419969,2023-12-21,209,pepsi,75,100,25,1,00316,India
419969,2023-12-21,212,amul cheese,250,315,65,1,00316,India
305364,2023-12-21,212,amul cheese,250,315,65,1,00111,India
305364,2023-12-21,207,coca cola,75,100,25,1,00111,India
430201,2023-12-21,202,milk,12,27,15,1,00292,India
430201,2023-12-21,206,yakult,360,400,40,1,00292,India
430201,2023-12-21,207,coca cola,75,100,25,1,00292,India
122149,2023-12-21,211,red bull,90,125,35,1,00363,India
122149,2023-12-21,201,paneer,210,340,130,1,00363,India
402299,2023-12-21,202,milk,12,27,15,1,00178,India
873857,2023-12-21,202,milk,12,27,15,1,00363,India
873857,2023-12-21,205,classic yogurt,45,60,15,1,00363,India
873857,2023-12-21,207,coca cola,75,100,25,1,00363,India
216999,2023-12-21,203,mango yogurt,50,60,10,1,00477,India
566115,2023-12-21,210,mountain dew,75,100,25,1,00047,India
566115,2023-12-21,209,pepsi,75,100,25,1,00047,India
566115,2023-12-21,206,yakult,360,400,40,1,00047,India
855469,2023-12-21,208,sprite,75,100,25,1,00306,India
855469,2023-12-21,201,paneer,210,340,130,1,00306,India
855469,2023-12-21,207,coca cola,75,100,25,1,00306,India
146443,2023-12-21,210,mountain dew,75,100,25,1,00471,India
146443,2023-12-21,213,bisleri,6,15,9,1,00471,India
146443,2023-12-21,209,pepsi,75,100,25,1,00471,India
949835,2023-12-21,207,coca cola,75,100,25,1,00186,India
949835,2023-12-21,209,pepsi,75,100,25,1,00186,India
949835,2023-12-21,206,yakult,360,400,40,1,00186,India
949835,2023-12-21,203,mango yogurt,50,60,10,1,00186,India
848421,2023-12-21,203,mango yogurt,50,60,10,1,00394,India
848421,2023-12-21,202,milk,12,27,15,1,00394,India
848421,2023-12-21,210,mountain dew,75,100,25,1,00394,India
848421,2023-12-21,204,strawberry yogurt,50,60,10,1,00394,India
789691,2023-12-21,202,milk,12,27,15,1,00106,India
890687,2023-12-21,206,yakult,360,400,40,1,00312,India
890687,2023-12-21,204,strawberry yogurt,50,60,10,1,00312,India
919414,2023-12-22,209,pepsi,75,100,25,1,00140,India
919414,2023-12-22,202,milk,12,27,15,1,00140,India
919414,2023-12-22,208,sprite,75,100,25,1,00140,India
582100,2023-12-22,206,yakult,360,400,40,1,00384,India
582100,2023-12-22,208,sprite,75,100,25,1,00384,India
487990,2023-12-22,204,strawberry yogurt,50,60,10,1,00116,India
800345,2023-12-22,204,strawberry yogurt,50,60,10,1,00186,India
800345,2023-12-22,206,yakult,360,400,40,1,00186,India
523711,2023-12-22,202,milk,12,27,15,1,00066,India
521660,2023-12-22,211,red bull,90,125,35,1,00030,India
521660,2023-12-22,208,sprite,75,100,25,1,00030,India
521660,2023-12-22,204,strawberry yogurt,50,60,10,1,00030,India
521660,2023-12-22,201,paneer,210,340,130,1,00030,India
661893,2023-12-22,207,coca cola,75,100,25,1,00118,India
661893,2023-12-22,213,bisleri,6,15,9,1,00118,India
661893,2023-12-22,204,strawberry yogurt,50,60,10,1,00118,India
661893,2023-12-22,210,mountain dew,75,100,25,1,00118,India
653921,2023-12-22,202,milk,12,27,15,1,00043,India
653921,2023-12-22,206,yakult,360,400,40,1,00043,India
653921,2023-12-22,209,pepsi,75,100,25,1,00043,India
863765,2023-12-22,210,mountain dew,75,100,25,1,00070,India
863765,2023-12-22,206,yakult,360,400,40,1,00070,India
863765,2023-12-22,204,strawberry yogurt,50,60,10,1,00070,India
953224,2023-12-22,201,paneer,210,340,130,1,00165,India
953224,2023-12-22,205,classic yogurt,45,60,15,1,00165,India
953224,2023-12-22,202,milk,12,27,15,1,00165,India
953224,2023-12-22,203,mango yogurt,50,60,10,1,00165,India
356520,2023-12-22,211,red bull,90,125,35,1,00132,India
356520,2023-12-22,207,coca cola,75,100,25,1,00132,India
356520,2023-12-22,202,milk,12,27,15,1,00132,India
168325,2023-12-22,201,paneer,210,340,130,1,00050,India
168325,2023-12-22,211,red bull,90,125,35,1,00050,India
168325,2023-12-22,207,coca cola,75,100,25,1,00050,India
876679,2023-12-22,213,bisleri,6,15,9,1,00106,India
367603,2023-12-22,211,red bull,90,125,35,1,00314,India
367603,2023-12-22,213,bisleri,6,15,9,1,00314,India
367603,2023-12-22,204,strawberry yogurt,50,60,10,1,00314,India
367603,2023-12-22,208,sprite,75,100,25,1,00314,India
545543,2023-12-22,203,mango yogurt,50,60,10,1,00494,India
599904,2023-12-22,203,mango yogurt,50,60,10,1,00365,India
599904,2023-12-22,211,red bull,90,125,35,1,00365,India
364898,2023-12-22,212,amul cheese,250,315,65,1,00438,India
364898,2023-12-22,203,mango yogurt,50,60,10,1,00438,India
364898,2023-12-22,213,bisleri,6,15,9,1,00438,India
837671,2023-12-22,204,strawberry yogurt,50,60,10,1,00402,India
837671,2023-12-22,202,milk,12,27,15,1,00402,India
781395,2023-12-22,213,bisleri,6,15,9,1,00422,India
893390,2023-12-22,212,amul cheese,250,315,65,1,00395,India
893390,2023-12-22,209,pepsi,75,100,25,1,00395,India
850046,2023-12-22,207,coca cola,75,100,25,1,00066,India
850046,2023-12-22,213,bisleri,6,15,9,1,00066,India
792319,2023-12-22,208,sprite,75,100,25,1,00088,India
792319,2023-12-22,210,mountain dew,75,100,25,1,00088,India
792319,2023-12-22,206,yakult,360,400,40,1,00088,India
792319,2023-12-22,212,amul cheese,250,315,65,1,00088,India
638221,2023-12-22,213,bisleri,6,15,9,1,00395,India
510319,2023-12-22,211,red bull,90,125,35,1,00476,India
510319,2023-12-22,206,yakult,360,400,40,1,00476,India
510319,2023-12-22,201,paneer,210,340,130,1,00476,India
510319,2023-12-22,212,amul cheese,250,315,65,1,00476,India
925390,2023-12-22,206,yakult,360,400,40,1,00358,India
925390,2023-12-22,201,paneer,210,340,130,1,00358,India
925390,2023-12-22,202,milk,12,27,15,1,00358,India
240681,2023-12-22,212,amul cheese,250,315,65,1,00444,India
240681,2023-12-22,210,mountain dew,75,100,25,1,00444,India
340483,2023-12-22,207,coca cola,75,100,25,1,00003,India
340483,2023-12-22,213,bisleri,6,15,9,1,00003,India
340483,2023-12-22,210,mountain dew,75,100,25,1,00003,India
340483,2023-12-22,211,red bull,90,125,35,1,00003,India
602973,2023-12-22,210,mountain dew,75,100,25,1,00051,India
602973,2023-12-22,209,pepsi,75,100,25,1,00051,India
572075,2023-12-22,212,amul cheese,250,315,65,1,00342,India
572075,2023-12-22,209,pepsi,75,100,25,1,00342,India
303044,2023-12-22,213,bisleri,6,15,9,1,00072,India
303044,2023-12-22,201,paneer,210,340,130,1,00072,India
836002,2023-12-22,204,strawberry yogurt,50,60,10,1,00443,India
836002,2023-12-22,210,mountain dew,75,100,25,1,00443,India
490706,2023-12-22,210,mountain dew,75,100,25,1,00070,India
840068,2023-12-22,211,red bull,90,125,35,1,00472,India
840068,2023-12-22,212,amul cheese,250,315,65,1,00472,India
840068,2023-12-22,204,strawberry yogurt,50,60,10,1,00472,India
250906,2023-12-22,206,yakult,360,400,40,1,00202,India
253960,2023-12-22,205,classic yogurt,45,60,15,1,00393,India
253960,2023-12-22,203,mango yogurt,50,60,10,1,00393,India
492183,2023-12-22,213,bisleri,6,15,9,1,00424,India
492183,2023-12-22,209,pepsi,75,100,25,1,00424,India
492183,2023-12-22,204,strawberry yogurt,50,60,10,1,00424,India
492183,2023-12-22,205,classic yogurt,45,60,15,1,00424,India
492183,2023-12-22,207,coca cola,75,100,25,1,00424,India
890528,2023-12-22,207,coca cola,75,100,25,1,00294,India
890528,2023-12-22,201,paneer,210,340,130,1,00294,India
619407,2023-12-22,208,sprite,75,100,25,1,00106,India
619407,2023-12-22,212,amul cheese,250,315,65,1,00106,India
259955,2023-12-22,204,strawberry yogurt,50,60,10,1,00449,India
259955,2023-12-22,211,red bull,90,125,35,1,00449,India
713944,2023-12-22,203,mango yogurt,50,60,10,1,00477,India
713944,2023-12-22,207,coca cola,75,100,25,1,00477,India
713944,2023-12-22,206,yakult,360,400,40,1,00477,India
390013,2023-12-22,207,coca cola,75,100,25,1,00399,India
582102,2023-12-22,206,yakult,360,400,40,1,00097,India
582102,2023-12-22,204,strawberry yogurt,50,60,10,1,00097,India
582102,2023-12-22,207,coca cola,75,100,25,1,00097,India
582102,2023-12-22,211,red bull,90,125,35,1,00097,India
582102,2023-12-22,208,sprite,75,100,25,1,00097,India
414907,2023-12-22,201,paneer,210,340,130,1,00068,India
414907,2023-12-22,203,mango yogurt,50,60,10,1,00068,India
414907,2023-12-22,208,sprite,75,100,25,1,00068,India
414907,2023-12-22,213,bisleri,6,15,9,1,00068,India
414907,2023-12-22,204,strawberry yogurt,50,60,10,1,00068,India
506252,2023-12-22,209,pepsi,75,100,25,1,00253,India
506252,2023-12-22,203,mango yogurt,50,60,10,1,00253,India
506252,2023-12-22,212,amul cheese,250,315,65,1,00253,India
506252,2023-12-22,207,coca cola,75,100,25,1,00253,India
463096,2023-12-22,205,classic yogurt,45,60,15,1,00400,India
172387,2023-12-22,209,pepsi,75,100,25,1,00159,India
949121,2023-12-22,206,yakult,360,400,40,1,00339,India
943216,2023-12-22,203,mango yogurt,50,60,10,1,00371,India
943216,2023-12-22,210,mountain dew,75,100,25,1,00371,India
943216,2023-12-22,212,amul cheese,250,315,65,1,00371,India
943216,2023-12-22,204,strawberry yogurt,50,60,10,1,00371,India
699748,2023-12-22,202,milk,12,27,15,1,00322,India
699748,2023-12-22,212,amul cheese,250,315,65,1,00322,India
699748,2023-12-22,205,classic yogurt,45,60,15,1,00322,India
699748,2023-12-22,211,red bull,90,125,35,1,00322,India
244058,2023-12-22,206,yakult,360,400,40,1,00429,India
244058,2023-12-22,212,amul cheese,250,315,65,1,00429,India
244058,2023-12-22,207,coca cola,75,100,25,1,00429,India
225947,2023-12-22,212,amul cheese,250,315,65,1,00434,India
225947,2023-12-22,209,pepsi,75,100,25,1,00434,India
225947,2023-12-22,202,milk,12,27,15,1,00434,India
700345,2023-12-22,203,mango yogurt,50,60,10,1,00066,India
688104,2023-12-22,203,mango yogurt,50,60,10,1,00210,India
448919,2023-12-22,202,milk,12,27,15,1,00150,India
448919,2023-12-22,205,classic yogurt,45,60,15,1,00150,India
636466,2023-12-22,203,mango yogurt,50,60,10,1,00003,India
636466,2023-12-22,213,bisleri,6,15,9,1,00003,India
801467,2023-12-22,205,classic yogurt,45,60,15,1,00119,India
801467,2023-12-22,208,sprite,75,100,25,1,00119,India
801467,2023-12-22,204,strawberry yogurt,50,60,10,1,00119,India
513323,2023-12-22,202,milk,12,27,15,1,00391,India
513323,2023-12-22,207,coca cola,75,100,25,1,00391,India
506123,2023-12-22,204,strawberry yogurt,50,60,10,1,00332,India
506123,2023-12-22,202,milk,12,27,15,1,00332,India
769267,2023-12-22,202,milk,12,27,15,1,00159,India
813929,2023-12-22,213,bisleri,6,15,9,1,00254,India
813929,2023-12-22,206,yakult,360,400,40,1,00254,India
813929,2023-12-22,201,paneer,210,340,130,1,00254,India
813929,2023-12-22,202,milk,12,27,15,1,00254,India
625907,2023-12-22,207,coca cola,75,100,25,1,00114,India
625907,2023-12-22,212,amul cheese,250,315,65,1,00114,India
538701,2023-12-22,202,milk,12,27,15,1,00256,India
538701,2023-12-22,203,mango yogurt,50,60,10,1,00256,India
538701,2023-12-22,213,bisleri,6,15,9,1,00256,India
538701,2023-12-22,208,sprite,75,100,25,1,00256,India
201366,2023-12-22,213,bisleri,6,15,9,1,00348,India
201366,2023-12-22,204,strawberry yogurt,50,60,10,1,00348,India
201366,2023-12-22,208,sprite,75,100,25,1,00348,India
201366,2023-12-22,202,milk,12,27,15,1,00348,India
128180,2023-12-22,210,mountain dew,75,100,25,1,00282,India
128180,2023-12-22,202,milk,12,27,15,1,00282,India
100944,2023-12-22,207,coca cola,75,100,25,1,00346,India
100944,2023-12-22,204,strawberry yogurt,50,60,10,1,00346,India
100944,2023-12-22,202,milk,12,27,15,1,00346,India
188039,2023-12-22,211,red bull,90,125,35,1,00015,India
188039,2023-12-22,204,strawberry yogurt,50,60,10,1,00015,India
188039,2023-12-22,201,paneer,210,340,130,1,00015,India
188039,2023-12-22,208,sprite,75,100,25,1,00015,India
155827,2023-12-22,208,sprite,75,100,25,1,00290,India
155827,2023-12-22,204,strawberry yogurt,50,60,10,1,00290,India
110256,2023-12-22,207,coca cola,75,100,25,1,00423,India
110256,2023-12-22,211,red bull,90,125,35,1,00423,India
167820,2023-12-22,205,classic yogurt,45,60,15,1,00403,India
573134,2023-12-22,205,classic yogurt,45,60,15,1,00409,India
573134,2023-12-22,213,bisleri,6,15,9,1,00409,India
675194,2023-12-22,206,yakult,360,400,40,1,00281,India
675194,2023-12-22,202,milk,12,27,15,1,00281,India
843383,2023-12-22,205,classic yogurt,45,60,15,1,00473,India
843383,2023-12-22,207,coca cola,75,100,25,1,00473,India
843383,2023-12-22,204,strawberry yogurt,50,60,10,1,00473,India
401184,2023-12-22,201,paneer,210,340,130,1,00239,India
401184,2023-12-22,208,sprite,75,100,25,1,00239,India
687786,2023-12-22,209,pepsi,75,100,25,1,00231,India
687786,2023-12-22,201,paneer,210,340,130,1,00231,India
687786,2023-12-22,206,yakult,360,400,40,1,00231,India
687786,2023-12-22,204,strawberry yogurt,50,60,10,1,00231,India
182738,2023-12-22,213,bisleri,6,15,9,1,00467,India
182738,2023-12-22,205,classic yogurt,45,60,15,1,00467,India
182738,2023-12-22,208,sprite,75,100,25,1,00467,India
417760,2023-12-22,207,coca cola,75,100,25,1,00332,India
417760,2023-12-22,213,bisleri,6,15,9,1,00332,India
417760,2023-12-22,203,mango yogurt,50,60,10,1,00332,India
868275,2023-12-22,208,sprite,75,100,25,1,00044,India
868275,2023-12-22,206,yakult,360,400,40,1,00044,India
868275,2023-12-22,210,mountain dew,75,100,25,1,00044,India
868275,2023-12-22,213,bisleri,6,15,9,1,00044,India
232156,2023-12-22,201,paneer,210,340,130,1,00142,India
232156,2023-12-22,205,classic yogurt,45,60,15,1,00142,India
232156,2023-12-22,208,sprite,75,100,25,1,00142,India
623861,2023-12-22,212,amul cheese,250,315,65,1,00483,India
485522,2023-12-22,209,pepsi,75,100,25,1,00030,India
485522,2023-12-22,201,paneer,210,340,130,1,00030,India
485522,2023-12-22,206,yakult,360,400,40,1,00030,India
648257,2023-12-22,205,classic yogurt,45,60,15,1,00478,India
648257,2023-12-22,212,amul cheese,250,315,65,1,00478,India
648257,2023-12-22,209,pepsi,75,100,25,1,00478,India
648257,2023-12-22,210,mountain dew,75,100,25,1,00478,India
308055,2023-12-22,203,mango yogurt,50,60,10,1,00220,India
308055,2023-12-22,209,pepsi,75,100,25,1,00220,India
308055,2023-12-22,206,yakult,360,400,40,1,00220,India
476274,2023-12-22,212,amul cheese,250,315,65,1,00206,India
476274,2023-12-22,205,classic yogurt,45,60,15,1,00206,India
476274,2023-12-22,203,mango yogurt,50,60,10,1,00206,India
476274,2023-12-22,213,bisleri,6,15,9,1,00206,India
411410,2023-12-22,205,classic yogurt,45,60,15,1,00411,India
411410,2023-12-22,201,paneer,210,340,130,1,00411,India
411410,2023-12-22,213,bisleri,6,15,9,1,00411,India
294143,2023-12-22,208,sprite,75,100,25,1,00461,India
294143,2023-12-22,205,classic yogurt,45,60,15,1,00461,India
294143,2023-12-22,202,milk,12,27,15,1,00461,India
294143,2023-12-22,204,strawberry yogurt,50,60,10,1,00461,India
294143,2023-12-22,211,red bull,90,125,35,1,00461,India
924475,2023-12-22,207,coca cola,75,100,25,1,00122,India
924475,2023-12-22,202,milk,12,27,15,1,00122,India
924475,2023-12-22,211,red bull,90,125,35,1,00122,India
924475,2023-12-22,209,pepsi,75,100,25,1,00122,India
116501,2023-12-22,202,milk,12,27,15,1,00014,India
116501,2023-12-22,207,coca cola,75,100,25,1,00014,India
345945,2023-12-22,205,classic yogurt,45,60,15,1,00439,India
345945,2023-12-22,204,strawberry yogurt,50,60,10,1,00439,India
447927,2023-12-23,205,classic yogurt,45,60,15,1,00069,India
578163,2023-12-23,209,pepsi,75,100,25,1,00378,India
875529,2023-12-23,208,sprite,75,100,25,1,00377,India
875529,2023-12-23,212,amul cheese,250,315,65,1,00377,India
875529,2023-12-23,209,pepsi,75,100,25,1,00377,India
875529,2023-12-23,207,coca cola,75,100,25,1,00377,India
378016,2023-12-23,213,bisleri,6,15,9,1,00115,India
378016,2023-12-23,206,yakult,360,400,40,1,00115,India
378016,2023-12-23,212,amul cheese,250,315,65,1,00115,India
787753,2023-12-23,205,classic yogurt,45,60,15,1,00384,India
787753,2023-12-23,203,mango yogurt,50,60,10,1,00384,India
787753,2023-12-23,209,pepsi,75,100,25,1,00384,India
580475,2023-12-23,211,red bull,90,125,35,1,00331,India
580475,2023-12-23,206,yakult,360,400,40,1,00331,India
580475,2023-12-23,207,coca cola,75,100,25,1,00331,India
245201,2023-12-23,204,strawberry yogurt,50,60,10,1,00180,India
343728,2023-12-23,205,classic yogurt,45,60,15,1,00230,India
343728,2023-12-23,206,yakult,360,400,40,1,00230,India
343728,2023-12-23,204,strawberry yogurt,50,60,10,1,00230,India
343728,2023-12-23,212,amul cheese,250,315,65,1,00230,India
343728,2023-12-23,210,mountain dew,75,100,25,1,00230,India
648867,2023-12-23,207,coca cola,75,100,25,1,00463,India
840390,2023-12-23,209,pepsi,75,100,25,1,00095,India
600763,2023-12-23,205,classic yogurt,45,60,15,1,00056,India
600763,2023-12-23,210,mountain dew,75,100,25,1,00056,India
600763,2023-12-23,201,paneer,210,340,130,1,00056,India
600763,2023-12-23,206,yakult,360,400,40,1,00056,India
523617,2023-12-23,213,bisleri,6,15,9,1,00270,India
119505,2023-12-23,213,bisleri,6,15,9,1,00156,India
119505,2023-12-23,212,amul cheese,250,315,65,1,00156,India
160261,2023-12-23,211,red bull,90,125,35,1,00189,India
160261,2023-12-23,201,paneer,210,340,130,1,00189,India
160261,2023-12-23,202,milk,12,27,15,1,00189,India
344721,2023-12-23,202,milk,12,27,15,1,00261,India
344721,2023-12-23,211,red bull,90,125,35,1,00261,India
148751,2023-12-23,212,amul cheese,250,315,65,1,00029,India
148751,2023-12-23,206,yakult,360,400,40,1,00029,India
148751,2023-12-23,213,bisleri,6,15,9,1,00029,India
148751,2023-12-23,202,milk,12,27,15,1,00029,India
786536,2023-12-23,206,yakult,360,400,40,1,00295,India
786536,2023-12-23,203,mango yogurt,50,60,10,1,00295,India
786536,2023-12-23,211,red bull,90,125,35,1,00295,India
786536,2023-12-23,208,sprite,75,100,25,1,00295,India
831593,2023-12-23,206,yakult,360,400,40,1,00404,India
831593,2023-12-23,202,milk,12,27,15,1,00404,India
831593,2023-12-23,210,mountain dew,75,100,25,1,00404,India
792881,2023-12-23,209,pepsi,75,100,25,1,00200,India
792881,2023-12-23,206,yakult,360,400,40,1,00200,India
792881,2023-12-23,207,coca cola,75,100,25,1,00200,India
290901,2023-12-23,202,milk,12,27,15,1,00053,India
290901,2023-12-23,206,yakult,360,400,40,1,00053,India
323242,2023-12-23,201,paneer,210,340,130,1,00424,India
323242,2023-12-23,203,mango yogurt,50,60,10,1,00424,India
323242,2023-12-23,207,coca cola,75,100,25,1,00424,India
323242,2023-12-23,206,yakult,360,400,40,1,00424,India
323242,2023-12-23,210,mountain dew,75,100,25,1,00424,India
380791,2023-12-23,210,mountain dew,75,100,25,1,00442,India
380791,2023-12-23,205,classic yogurt,45,60,15,1,00442,India
380791,2023-12-23,209,pepsi,75,100,25,1,00442,India
380791,2023-12-23,212,amul cheese,250,315,65,1,00442,India
830345,2023-12-23,210,mountain dew,75,100,25,1,00351,India
918998,2023-12-23,213,bisleri,6,15,9,1,00463,India
918998,2023-12-23,202,milk,12,27,15,1,00463,India
918998,2023-12-23,201,paneer,210,340,130,1,00463,India
738314,2023-12-23,213,bisleri,6,15,9,1,00248,India
366972,2023-12-23,206,yakult,360,400,40,1,00467,India
366972,2023-12-23,205,classic yogurt,45,60,15,1,00467,India
366972,2023-12-23,202,milk,12,27,15,1,00467,India
279939,2023-12-23,204,strawberry yogurt,50,60,10,1,00272,India
279939,2023-12-23,203,mango yogurt,50,60,10,1,00272,India
357060,2023-12-23,210,mountain dew,75,100,25,1,00132,India
357060,2023-12-23,211,red bull,90,125,35,1,00132,India
357060,2023-12-23,202,milk,12,27,15,1,00132,India
674282,2023-12-23,210,mountain dew,75,100,25,1,00120,India
674282,2023-12-23,203,mango yogurt,50,60,10,1,00120,India
494292,2023-12-23,207,coca cola,75,100,25,1,00116,India
494292,2023-12-23,202,milk,12,27,15,1,00116,India
494292,2023-12-23,201,paneer,210,340,130,1,00116,India
494292,2023-12-23,212,amul cheese,250,315,65,1,00116,India
317227,2023-12-23,213,bisleri,6,15,9,1,00017,India
619479,2023-12-23,201,paneer,210,340,130,1,00482,India
619479,2023-12-23,213,bisleri,6,15,9,1,00482,India
619479,2023-12-23,202,milk,12,27,15,1,00482,India
667210,2023-12-23,209,pepsi,75,100,25,1,00204,India
667210,2023-12-23,210,mountain dew,75,100,25,1,00204,India
122339,2023-12-23,208,sprite,75,100,25,1,00293,India
129732,2023-12-23,207,coca cola,75,100,25,1,00307,India
129732,2023-12-23,203,mango yogurt,50,60,10,1,00307,India
762762,2023-12-23,202,milk,12,27,15,1,00120,India
762762,2023-12-23,208,sprite,75,100,25,1,00120,India
762762,2023-12-23,207,coca cola,75,100,25,1,00120,India
762762,2023-12-23,211,red bull,90,125,35,1,00120,India
936450,2023-12-23,202,milk,12,27,15,1,00302,India
936450,2023-12-23,207,coca cola,75,100,25,1,00302,India
992926,2023-12-23,207,coca cola,75,100,25,1,00071,India
148960,2023-12-23,206,yakult,360,400,40,1,00411,India
148960,2023-12-23,202,milk,12,27,15,1,00411,India
148960,2023-12-23,213,bisleri,6,15,9,1,00411,India
148960,2023-12-23,205,classic yogurt,45,60,15,1,00411,India
220177,2023-12-23,212,amul cheese,250,315,65,1,00362,India
220177,2023-12-23,202,milk,12,27,15,1,00362,India
220177,2023-12-23,207,coca cola,75,100,25,1,00362,India
220177,2023-12-23,211,red bull,90,125,35,1,00362,India
409214,2023-12-23,202,milk,12,27,15,1,00400,India
409214,2023-12-23,213,bisleri,6,15,9,1,00400,India
913134,2023-12-23,205,classic yogurt,45,60,15,1,00101,India
913134,2023-12-23,210,mountain dew,75,100,25,1,00101,India
913134,2023-12-23,202,milk,12,27,15,1,00101,India
913134,2023-12-23,212,amul cheese,250,315,65,1,00101,India
825539,2023-12-23,211,red bull,90,125,35,1,00471,India
198774,2023-12-23,208,sprite,75,100,25,1,00451,India
198774,2023-12-23,212,amul cheese,250,315,65,1,00451,India
198774,2023-12-23,210,mountain dew,75,100,25,1,00451,India
198774,2023-12-23,206,yakult,360,400,40,1,00451,India
198774,2023-12-23,207,coca cola,75,100,25,1,00451,India
255676,2023-12-23,205,classic yogurt,45,60,15,1,00464,India
255676,2023-12-23,202,milk,12,27,15,1,00464,India
103733,2023-12-23,204,strawberry yogurt,50,60,10,1,00172,India
103733,2023-12-23,208,sprite,75,100,25,1,00172,India
704222,2023-12-23,208,sprite,75,100,25,1,00083,India
704222,2023-12-23,213,bisleri,6,15,9,1,00083,India
704222,2023-12-23,210,mountain dew,75,100,25,1,00083,India
709761,2023-12-23,206,yakult,360,400,40,1,00264,India
709761,2023-12-23,201,paneer,210,340,130,1,00264,India
709761,2023-12-23,202,milk,12,27,15,1,00264,India
756880,2023-12-23,208,sprite,75,100,25,1,00022,India
520860,2023-12-23,201,paneer,210,340,130,1,00076,India
636990,2023-12-23,201,paneer,210,340,130,1,00464,India
636990,2023-12-23,205,classic yogurt,45,60,15,1,00464,India
636990,2023-12-23,207,coca cola,75,100,25,1,00464,India
636990,2023-12-23,211,red bull,90,125,35,1,00464,India
634352,2023-12-23,206,yakult,360,400,40,1,00494,India
566697,2023-12-23,211,red bull,90,125,35,1,00081,India
566697,2023-12-23,208,sprite,75,100,25,1,00081,India
566697,2023-12-23,204,strawberry yogurt,50,60,10,1,00081,India
194471,2023-12-23,206,yakult,360,400,40,1,00011,India
194471,2023-12-23,202,milk,12,27,15,1,00011,India
280147,2023-12-23,206,yakult,360,400,40,1,00194,India
280147,2023-12-23,213,bisleri,6,15,9,1,00194,India
280147,2023-12-23,204,strawberry yogurt,50,60,10,1,00194,India
228196,2023-12-23,201,paneer,210,340,130,1,00317,India
228196,2023-12-23,208,sprite,75,100,25,1,00317,India
228196,2023-12-23,209,pepsi,75,100,25,1,00317,India
228196,2023-12-23,203,mango yogurt,50,60,10,1,00317,India
348170,2023-12-23,207,coca cola,75,100,25,1,00166,India
348170,2023-12-23,202,milk,12,27,15,1,00166,India
330380,2023-12-23,201,paneer,210,340,130,1,00294,India
924701,2023-12-23,206,yakult,360,400,40,1,00436,India
924701,2023-12-23,202,milk,12,27,15,1,00436,India
924701,2023-12-23,204,strawberry yogurt,50,60,10,1,00436,India
924701,2023-12-23,203,mango yogurt,50,60,10,1,00436,India
318519,2023-12-23,205,classic yogurt,45,60,15,1,00153,India
318519,2023-12-23,213,bisleri,6,15,9,1,00153,India
240279,2023-12-23,211,red bull,90,125,35,1,00433,India
240279,2023-12-23,201,paneer,210,340,130,1,00433,India
240279,2023-12-23,205,classic yogurt,45,60,15,1,00433,India
240279,2023-12-23,210,mountain dew,75,100,25,1,00433,India
241567,2023-12-23,201,paneer,210,340,130,1,00181,India
214295,2023-12-23,206,yakult,360,400,40,1,00302,India
214295,2023-12-23,208,sprite,75,100,25,1,00302,India
214295,2023-12-23,204,strawberry yogurt,50,60,10,1,00302,India
214295,2023-12-23,202,milk,12,27,15,1,00302,India
110828,2023-12-24,205,classic yogurt,45,60,15,1,00095,India
110828,2023-12-24,208,sprite,75,100,25,1,00095,India
110828,2023-12-24,209,pepsi,75,100,25,1,00095,India
110828,2023-12-24,212,amul cheese,250,315,65,1,00095,India
287016,2023-12-24,205,classic yogurt,45,60,15,1,00258,India
287016,2023-12-24,209,pepsi,75,100,25,1,00258,India
287016,2023-12-24,201,paneer,210,340,130,1,00258,India
144535,2023-12-24,203,mango yogurt,50,60,10,1,00257,India
144535,2023-12-24,201,paneer,210,340,130,1,00257,India
144535,2023-12-24,206,yakult,360,400,40,1,00257,India
144535,2023-12-24,212,amul cheese,250,315,65,1,00257,India
623248,2023-12-24,212,amul cheese,250,315,65,1,00176,India
653914,2023-12-24,208,sprite,75,100,25,1,00057,India
653914,2023-12-24,210,mountain dew,75,100,25,1,00057,India
293316,2023-12-24,201,paneer,210,340,130,1,00337,India
293316,2023-12-24,209,pepsi,75,100,25,1,00337,India
293316,2023-12-24,206,yakult,360,400,40,1,00337,India
367322,2023-12-24,209,pepsi,75,100,25,1,00083,India
367322,2023-12-24,211,red bull,90,125,35,1,00083,India
367322,2023-12-24,206,yakult,360,400,40,1,00083,India
555953,2023-12-24,208,sprite,75,100,25,1,00107,India
555953,2023-12-24,209,pepsi,75,100,25,1,00107,India
555953,2023-12-24,203,mango yogurt,50,60,10,1,00107,India
358342,2023-12-24,203,mango yogurt,50,60,10,1,00328,India
358342,2023-12-24,210,mountain dew,75,100,25,1,00328,India
358342,2023-12-24,205,classic yogurt,45,60,15,1,00328,India
521249,2023-12-24,202,milk,12,27,15,1,00033,India
521249,2023-12-24,204,strawberry yogurt,50,60,10,1,00033,India
521249,2023-12-24,205,classic yogurt,45,60,15,1,00033,India
521249,2023-12-24,213,bisleri,6,15,9,1,00033,India
878820,2023-12-24,211,red bull,90,125,35,1,00485,India
878820,2023-12-24,212,amul cheese,250,315,65,1,00485,India
878820,2023-12-24,205,classic yogurt,45,60,15,1,00485,India
878820,2023-12-24,210,mountain dew,75,100,25,1,00485,India
448052,2023-12-24,212,amul cheese,250,315,65,1,00062,India
283846,2023-12-24,210,mountain dew,75,100,25,1,00354,India
830553,2023-12-24,213,bisleri,6,15,9,1,00298,India
830553,2023-12-24,201,paneer,210,340,130,1,00298,India
830553,2023-12-24,202,milk,12,27,15,1,00298,India
727478,2023-12-24,204,strawberry yogurt,50,60,10,1,00020,India
330220,2023-12-24,201,paneer,210,340,130,1,00139,India
330220,2023-12-24,202,milk,12,27,15,1,00139,India
518368,2023-12-24,205,classic yogurt,45,60,15,1,00214,India
518368,2023-12-24,202,milk,12,27,15,1,00214,India
411005,2023-12-24,209,pepsi,75,100,25,1,00148,India
411005,2023-12-24,207,coca cola,75,100,25,1,00148,India
411005,2023-12-24,211,red bull,90,125,35,1,00148,India
411005,2023-12-24,201,paneer,210,340,130,1,00148,India
769325,2023-12-24,205,classic yogurt,45,60,15,1,00471,India
769325,2023-12-24,208,sprite,75,100,25,1,00471,India
769325,2023-12-24,204,strawberry yogurt,50,60,10,1,00471,India
769325,2023-12-24,211,red bull,90,125,35,1,00471,India
612213,2023-12-24,212,amul cheese,250,315,65,1,00097,India
612213,2023-12-24,213,bisleri,6,15,9,1,00097,India
612213,2023-12-24,202,milk,12,27,15,1,00097,India
389512,2023-12-24,203,mango yogurt,50,60,10,1,00251,India
389512,2023-12-24,211,red bull,90,125,35,1,00251,India
389512,2023-12-24,210,mountain dew,75,100,25,1,00251,India
389512,2023-12-24,204,strawberry yogurt,50,60,10,1,00251,India
389512,2023-12-24,213,bisleri,6,15,9,1,00251,India
705843,2023-12-24,203,mango yogurt,50,60,10,1,00166,India
705843,2023-12-24,202,milk,12,27,15,1,00166,India
705843,2023-12-24,206,yakult,360,400,40,1,00166,India
705843,2023-12-24,205,classic yogurt,45,60,15,1,00166,India
507186,2023-12-24,208,sprite,75,100,25,1,00182,India
507186,2023-12-24,201,paneer,210,340,130,1,00182,India
675620,2023-12-24,212,amul cheese,250,315,65,1,00206,India
675620,2023-12-24,211,red bull,90,125,35,1,00206,India
675620,2023-12-24,207,coca cola,75,100,25,1,00206,India
675620,2023-12-24,201,paneer,210,340,130,1,00206,India
720286,2023-12-24,202,milk,12,27,15,1,00471,India
720286,2023-12-24,213,bisleri,6,15,9,1,00471,India
720286,2023-12-24,204,strawberry yogurt,50,60,10,1,00471,India
720286,2023-12-24,211,red bull,90,125,35,1,00471,India
823006,2023-12-24,212,amul cheese,250,315,65,1,00098,India
823006,2023-12-24,209,pepsi,75,100,25,1,00098,India
823006,2023-12-24,205,classic yogurt,45,60,15,1,00098,India
823006,2023-12-24,203,mango yogurt,50,60,10,1,00098,India
532754,2023-12-24,203,mango yogurt,50,60,10,1,00190,India
532754,2023-12-24,202,milk,12,27,15,1,00190,India
532754,2023-12-24,206,yakult,360,400,40,1,00190,India
532754,2023-12-24,211,red bull,90,125,35,1,00190,India
532754,2023-12-24,208,sprite,75,100,25,1,00190,India
301132,2023-12-24,205,classic yogurt,45,60,15,1,00465,India
301132,2023-12-24,204,strawberry yogurt,50,60,10,1,00465,India
301132,2023-12-24,201,paneer,210,340,130,1,00465,India
520061,2023-12-24,205,classic yogurt,45,60,15,1,00144,India
520061,2023-12-24,207,coca cola,75,100,25,1,00144,India
356372,2023-12-24,209,pepsi,75,100,25,1,00419,India
356372,2023-12-24,211,red bull,90,125,35,1,00419,India
767034,2023-12-24,209,pepsi,75,100,25,1,00356,India
469346,2023-12-24,211,red bull,90,125,35,1,00487,India
469346,2023-12-24,201,paneer,210,340,130,1,00487,India
469346,2023-12-24,202,milk,12,27,15,1,00487,India
129765,2023-12-24,209,pepsi,75,100,25,1,00321,India
129765,2023-12-24,203,mango yogurt,50,60,10,1,00321,India
129765,2023-12-24,213,bisleri,6,15,9,1,00321,India
378691,2023-12-24,211,red bull,90,125,35,1,00131,India
378691,2023-12-24,210,mountain dew,75,100,25,1,00131,India
541867,2023-12-24,212,amul cheese,250,315,65,1,00467,India
541867,2023-12-24,211,red bull,90,125,35,1,00467,India
915132,2023-12-24,206,yakult,360,400,40,1,00155,India
915132,2023-12-24,213,bisleri,6,15,9,1,00155,India
915132,2023-12-24,207,coca cola,75,100,25,1,00155,India
915132,2023-12-24,211,red bull,90,125,35,1,00155,India
394072,2023-12-24,211,red bull,90,125,35,1,00446,India
205797,2023-12-24,203,mango yogurt,50,60,10,1,00288,India
438261,2023-12-24,210,mountain dew,75,100,25,1,00278,India
438261,2023-12-24,205,classic yogurt,45,60,15,1,00278,India
891583,2023-12-24,205,classic yogurt,45,60,15,1,00185,India
111369,2023-12-24,205,classic yogurt,45,60,15,1,00461,India
111369,2023-12-24,206,yakult,360,400,40,1,00461,India
111369,2023-12-24,209,pepsi,75,100,25,1,00461,India
737874,2023-12-24,208,sprite,75,100,25,1,00373,India
737874,2023-12-24,211,red bull,90,125,35,1,00373,India
737874,2023-12-24,210,mountain dew,75,100,25,1,00373,India
743749,2023-12-24,202,milk,12,27,15,1,00366,India
743749,2023-12-24,210,mountain dew,75,100,25,1,00366,India
432148,2023-12-24,208,sprite,75,100,25,1,00044,India
432148,2023-12-24,203,mango yogurt,50,60,10,1,00044,India
856083,2023-12-24,203,mango yogurt,50,60,10,1,00191,India
856083,2023-12-24,202,milk,12,27,15,1,00191,India
821657,2023-12-24,212,amul cheese,250,315,65,1,00472,India
192989,2023-12-24,209,pepsi,75,100,25,1,00034,India
192989,2023-12-24,205,classic yogurt,45,60,15,1,00034,India
192989,2023-12-24,207,coca cola,75,100,25,1,00034,India
451440,2023-12-24,213,bisleri,6,15,9,1,00151,India
451440,2023-12-24,212,amul cheese,250,315,65,1,00151,India
432044,2023-12-24,202,milk,12,27,15,1,00481,India
760999,2023-12-24,205,classic yogurt,45,60,15,1,00431,India
760999,2023-12-24,202,milk,12,27,15,1,00431,India
796066,2023-12-24,212,amul cheese,250,315,65,1,00424,India
796066,2023-12-24,201,paneer,210,340,130,1,00424,India
796066,2023-12-24,205,classic yogurt,45,60,15,1,00424,India
859831,2023-12-24,210,mountain dew,75,100,25,1,00114,India
859831,2023-12-24,209,pepsi,75,100,25,1,00114,India
859831,2023-12-24,207,coca cola,75,100,25,1,00114,India
859831,2023-12-24,203,mango yogurt,50,60,10,1,00114,India
859831,2023-12-24,206,yakult,360,400,40,1,00114,India
567107,2023-12-24,204,strawberry yogurt,50,60,10,1,00449,India
567107,2023-12-24,207,coca cola,75,100,25,1,00449,India
567107,2023-12-24,210,mountain dew,75,100,25,1,00449,India
676428,2023-12-24,202,milk,12,27,15,1,00153,India
676428,2023-12-24,208,sprite,75,100,25,1,00153,India
676428,2023-12-24,205,classic yogurt,45,60,15,1,00153,India
676428,2023-12-24,212,amul cheese,250,315,65,1,00153,India
676428,2023-12-24,209,pepsi,75,100,25,1,00153,India
697203,2023-12-24,212,amul cheese,250,315,65,1,00016,India
697203,2023-12-24,210,mountain dew,75,100,25,1,00016,India
697203,2023-12-24,207,coca cola,75,100,25,1,00016,India
316398,2023-12-24,202,milk,12,27,15,1,00337,India
316398,2023-12-24,207,coca cola,75,100,25,1,00337,India
658863,2023-12-24,212,amul cheese,250,315,65,1,00092,India
658863,2023-12-24,210,mountain dew,75,100,25,1,00092,India
636458,2023-12-24,201,paneer,210,340,130,1,00091,India
727306,2023-12-24,206,yakult,360,400,40,1,00148,India
727306,2023-12-24,212,amul cheese,250,315,65,1,00148,India
447386,2023-12-24,211,red bull,90,125,35,1,00147,India
447386,2023-12-24,209,pepsi,75,100,25,1,00147,India
499308,2023-12-24,204,strawberry yogurt,50,60,10,1,00468,India
499308,2023-12-24,208,sprite,75,100,25,1,00468,India
499308,2023-12-24,201,paneer,210,340,130,1,00468,India
936148,2023-12-24,212,amul cheese,250,315,65,1,00493,India
936148,2023-12-24,203,mango yogurt,50,60,10,1,00493,India
936148,2023-12-24,205,classic yogurt,45,60,15,1,00493,India
936148,2023-12-24,209,pepsi,75,100,25,1,00493,India
547591,2023-12-24,208,sprite,75,100,25,1,00295,India
547591,2023-12-24,211,red bull,90,125,35,1,00295,India
547591,2023-12-24,209,pepsi,75,100,25,1,00295,India
547591,2023-12-24,201,paneer,210,340,130,1,00295,India
701052,2023-12-24,207,coca cola,75,100,25,1,00394,India
701052,2023-12-24,201,paneer,210,340,130,1,00394,India
519587,2023-12-24,209,pepsi,75,100,25,1,00346,India
753950,2023-12-24,212,amul cheese,250,315,65,1,00063,India
753950,2023-12-24,213,bisleri,6,15,9,1,00063,India
753950,2023-12-24,204,strawberry yogurt,50,60,10,1,00063,India
753950,2023-12-24,208,sprite,75,100,25,1,00063,India
284592,2023-12-24,209,pepsi,75,100,25,1,00012,India
111709,2023-12-24,206,yakult,360,400,40,1,00369,India
111709,2023-12-24,201,paneer,210,340,130,1,00369,India
111709,2023-12-24,210,mountain dew,75,100,25,1,00369,India
111709,2023-12-24,204,strawberry yogurt,50,60,10,1,00369,India
623598,2023-12-24,203,mango yogurt,50,60,10,1,00289,India
815322,2023-12-24,206,yakult,360,400,40,1,00451,India
815322,2023-12-24,207,coca cola,75,100,25,1,00451,India
815322,2023-12-24,201,paneer,210,340,130,1,00451,India
815322,2023-12-24,208,sprite,75,100,25,1,00451,India
998341,2023-12-24,208,sprite,75,100,25,1,00291,India
193152,2023-12-24,203,mango yogurt,50,60,10,1,00464,India
193152,2023-12-24,208,sprite,75,100,25,1,00464,India
193152,2023-12-24,206,yakult,360,400,40,1,00464,India
193152,2023-12-24,211,red bull,90,125,35,1,00464,India
610608,2023-12-24,205,classic yogurt,45,60,15,1,00423,India
610608,2023-12-24,213,bisleri,6,15,9,1,00423,India
849696,2023-12-24,205,classic yogurt,45,60,15,1,00412,India
930754,2023-12-24,201,paneer,210,340,130,1,00293,India
930754,2023-12-24,203,mango yogurt,50,60,10,1,00293,India
930754,2023-12-24,207,coca cola,75,100,25,1,00293,India
307039,2023-12-24,204,strawberry yogurt,50,60,10,1,00447,India
307039,2023-12-24,201,paneer,210,340,130,1,00447,India
307039,2023-12-24,203,mango yogurt,50,60,10,1,00447,India
307039,2023-12-24,207,coca cola,75,100,25,1,00447,India
273401,2023-12-24,204,strawberry yogurt,50,60,10,1,00147,India
273401,2023-12-24,202,milk,12,27,15,1,00147,India
273401,2023-12-24,213,bisleri,6,15,9,1,00147,India
108958,2023-12-24,213,bisleri,6,15,9,1,00303,India
108958,2023-12-24,203,mango yogurt,50,60,10,1,00303,India
108958,2023-12-24,208,sprite,75,100,25,1,00303,India
108958,2023-12-24,204,strawberry yogurt,50,60,10,1,00303,India
581095,2023-12-24,208,sprite,75,100,25,1,00149,India
581095,2023-12-24,211,red bull,90,125,35,1,00149,India
581095,2023-12-24,201,paneer,210,340,130,1,00149,India
581095,2023-12-24,204,strawberry yogurt,50,60,10,1,00149,India
376493,2023-12-24,213,bisleri,6,15,9,1,00337,India
376493,2023-12-24,210,mountain dew,75,100,25,1,00337,India
376493,2023-12-24,206,yakult,360,400,40,1,00337,India
376493,2023-12-24,208,sprite,75,100,25,1,00337,India
241304,2023-12-24,213,bisleri,6,15,9,1,00105,India
241304,2023-12-24,211,red bull,90,125,35,1,00105,India
564760,2023-12-24,213,bisleri,6,15,9,1,00120,India
564760,2023-12-24,206,yakult,360,400,40,1,00120,India
564760,2023-12-24,205,classic yogurt,45,60,15,1,00120,India
748824,2023-12-25,203,mango yogurt,50,60,10,1,00116,India
748824,2023-12-25,211,red bull,90,125,35,1,00116,India
748824,2023-12-25,207,coca cola,75,100,25,1,00116,India
748824,2023-12-25,201,paneer,210,340,130,1,00116,India
748824,2023-12-25,206,yakult,360,400,40,1,00116,India
200322,2023-12-25,205,classic yogurt,45,60,15,1,00285,India
316069,2023-12-25,203,mango yogurt,50,60,10,1,00239,India
844409,2023-12-25,210,mountain dew,75,100,25,1,00420,India
844409,2023-12-25,205,classic yogurt,45,60,15,1,00420,India
844409,2023-12-25,202,milk,12,27,15,1,00420,India
933892,2023-12-25,211,red bull,90,125,35,1,00260,India
933892,2023-12-25,213,bisleri,6,15,9,1,00260,India
124692,2023-12-25,205,classic yogurt,45,60,15,1,00473,India
124692,2023-12-25,210,mountain dew,75,100,25,1,00473,India
185002,2023-12-25,209,pepsi,75,100,25,1,00191,India
767616,2023-12-25,210,mountain dew,75,100,25,1,00084,India
767616,2023-12-25,212,amul cheese,250,315,65,1,00084,India
384578,2023-12-25,206,yakult,360,400,40,1,00314,India
549241,2023-12-25,213,bisleri,6,15,9,1,00141,India
549241,2023-12-25,211,red bull,90,125,35,1,00141,India
549241,2023-12-25,203,mango yogurt,50,60,10,1,00141,India
964303,2023-12-25,210,mountain dew,75,100,25,1,00230,India
788530,2023-12-25,213,bisleri,6,15,9,1,00223,India
155510,2023-12-25,204,strawberry yogurt,50,60,10,1,00491,India
155510,2023-12-25,207,coca cola,75,100,25,1,00491,India
155510,2023-12-25,213,bisleri,6,15,9,1,00491,India
660171,2023-12-25,207,coca cola,75,100,25,1,00364,India
660171,2023-12-25,213,bisleri,6,15,9,1,00364,India
660171,2023-12-25,209,pepsi,75,100,25,1,00364,India
410936,2023-12-25,209,pepsi,75,100,25,1,00062,India
410936,2023-12-25,208,sprite,75,100,25,1,00062,India
887029,2023-12-25,212,amul cheese,250,315,65,1,00430,India
887029,2023-12-25,208,sprite,75,100,25,1,00430,India
887029,2023-12-25,203,mango yogurt,50,60,10,1,00430,India
887029,2023-12-25,210,mountain dew,75,100,25,1,00430,India
887029,2023-12-25,202,milk,12,27,15,1,00430,India
111060,2023-12-25,205,classic yogurt,45,60,15,1,00036,India
111060,2023-12-25,210,mountain dew,75,100,25,1,00036,India
111060,2023-12-25,202,milk,12,27,15,1,00036,India
111060,2023-12-25,211,red bull,90,125,35,1,00036,India
157690,2023-12-25,210,mountain dew,75,100,25,1,00276,India
157690,2023-12-25,205,classic yogurt,45,60,15,1,00276,India
157690,2023-12-25,213,bisleri,6,15,9,1,00276,India
157690,2023-12-25,208,sprite,75,100,25,1,00276,India
142311,2023-12-25,213,bisleri,6,15,9,1,00491,India
142311,2023-12-25,212,amul cheese,250,315,65,1,00491,India
142311,2023-12-25,202,milk,12,27,15,1,00491,India
142311,2023-12-25,204,strawberry yogurt,50,60,10,1,00491,India
984050,2023-12-25,210,mountain dew,75,100,25,1,00411,India
984050,2023-12-25,207,coca cola,75,100,25,1,00411,India
984050,2023-12-25,208,sprite,75,100,25,1,00411,India
984050,2023-12-25,211,red bull,90,125,35,1,00411,India
826927,2023-12-25,204,strawberry yogurt,50,60,10,1,00323,India
826927,2023-12-25,203,mango yogurt,50,60,10,1,00323,India
826927,2023-12-25,209,pepsi,75,100,25,1,00323,India
826927,2023-12-25,211,red bull,90,125,35,1,00323,India
627660,2023-12-25,210,mountain dew,75,100,25,1,00006,India
312334,2023-12-25,212,amul cheese,250,315,65,1,00191,India
312334,2023-12-25,208,sprite,75,100,25,1,00191,India
930353,2023-12-25,210,mountain dew,75,100,25,1,00023,India
930353,2023-12-25,201,paneer,210,340,130,1,00023,India
151736,2023-12-25,207,coca cola,75,100,25,1,00167,India
151736,2023-12-25,208,sprite,75,100,25,1,00167,India
151736,2023-12-25,205,classic yogurt,45,60,15,1,00167,India
151736,2023-12-25,211,red bull,90,125,35,1,00167,India
829522,2023-12-25,204,strawberry yogurt,50,60,10,1,00132,India
829522,2023-12-25,201,paneer,210,340,130,1,00132,India
829522,2023-12-25,207,coca cola,75,100,25,1,00132,India
829522,2023-12-25,209,pepsi,75,100,25,1,00132,India
733464,2023-12-25,204,strawberry yogurt,50,60,10,1,00133,India
733464,2023-12-25,212,amul cheese,250,315,65,1,00133,India
733464,2023-12-25,213,bisleri,6,15,9,1,00133,India
733464,2023-12-25,203,mango yogurt,50,60,10,1,00133,India
117266,2023-12-25,213,bisleri,6,15,9,1,00082,India
117266,2023-12-25,205,classic yogurt,45,60,15,1,00082,India
106822,2023-12-25,208,sprite,75,100,25,1,00173,India
283660,2023-12-25,203,mango yogurt,50,60,10,1,00217,India
702198,2023-12-25,201,paneer,210,340,130,1,00361,India
968245,2023-12-25,207,coca cola,75,100,25,1,00471,India
444021,2023-12-25,208,sprite,75,100,25,1,00153,India
444021,2023-12-25,211,red bull,90,125,35,1,00153,India
444021,2023-12-25,205,classic yogurt,45,60,15,1,00153,India
444021,2023-12-25,207,coca cola,75,100,25,1,00153,India
684638,2023-12-25,206,yakult,360,400,40,1,00060,India
684638,2023-12-25,207,coca cola,75,100,25,1,00060,India
684638,2023-12-25,203,mango yogurt,50,60,10,1,00060,India
684638,2023-12-25,209,pepsi,75,100,25,1,00060,India
193418,2023-12-25,211,red bull,90,125,35,1,00212,India
193418,2023-12-25,210,mountain dew,75,100,25,1,00212,India
193418,2023-12-25,207,coca cola,75,100,25,1,00212,India
193418,2023-12-25,205,classic yogurt,45,60,15,1,00212,India
471662,2023-12-25,204,strawberry yogurt,50,60,10,1,00112,India
712702,2023-12-25,206,yakult,360,400,40,1,00158,India
712702,2023-12-25,201,paneer,210,340,130,1,00158,India
221576,2023-12-25,207,coca cola,75,100,25,1,00189,India
221576,2023-12-25,203,mango yogurt,50,60,10,1,00189,India
221576,2023-12-25,205,classic yogurt,45,60,15,1,00189,India
776689,2023-12-25,211,red bull,90,125,35,1,00088,India
776689,2023-12-25,206,yakult,360,400,40,1,00088,India
776689,2023-12-25,201,paneer,210,340,130,1,00088,India
756097,2023-12-25,206,yakult,360,400,40,1,00219,India
756097,2023-12-25,207,coca cola,75,100,25,1,00219,India
756097,2023-12-25,212,amul cheese,250,315,65,1,00219,India
984783,2023-12-25,209,pepsi,75,100,25,1,00078,India
984783,2023-12-25,202,milk,12,27,15,1,00078,India
984783,2023-12-25,213,bisleri,6,15,9,1,00078,India
662730,2023-12-25,208,sprite,75,100,25,1,00275,India
662730,2023-12-25,211,red bull,90,125,35,1,00275,India
662730,2023-12-25,207,coca cola,75,100,25,1,00275,India
905775,2023-12-25,208,sprite,75,100,25,1,00358,India
905775,2023-12-25,211,red bull,90,125,35,1,00358,India
901963,2023-12-25,213,bisleri,6,15,9,1,00248,India
278313,2023-12-25,209,pepsi,75,100,25,1,00233,India
191232,2023-12-25,201,paneer,210,340,130,1,00381,India
191232,2023-12-25,209,pepsi,75,100,25,1,00381,India
414824,2023-12-25,205,classic yogurt,45,60,15,1,00410,India
414824,2023-12-25,213,bisleri,6,15,9,1,00410,India
254044,2023-12-25,203,mango yogurt,50,60,10,1,00437,India
623429,2023-12-25,203,mango yogurt,50,60,10,1,00415,India
623429,2023-12-25,208,sprite,75,100,25,1,00415,India
623429,2023-12-25,205,classic yogurt,45,60,15,1,00415,India
758018,2023-12-25,208,sprite,75,100,25,1,00160,India
973227,2023-12-25,211,red bull,90,125,35,1,00098,India
973227,2023-12-25,201,paneer,210,340,130,1,00098,India
779311,2023-12-25,210,mountain dew,75,100,25,1,00350,India
779311,2023-12-25,211,red bull,90,125,35,1,00350,India
779311,2023-12-25,213,bisleri,6,15,9,1,00350,India
225800,2023-12-25,211,red bull,90,125,35,1,00400,India
225800,2023-12-25,208,sprite,75,100,25,1,00400,India
342307,2023-12-25,211,red bull,90,125,35,1,00061,India
342307,2023-12-25,204,strawberry yogurt,50,60,10,1,00061,India
675232,2023-12-25,212,amul cheese,250,315,65,1,00360,India
675232,2023-12-25,213,bisleri,6,15,9,1,00360,India
675232,2023-12-25,210,mountain dew,75,100,25,1,00360,India
675232,2023-12-25,207,coca cola,75,100,25,1,00360,India
265019,2023-12-25,209,pepsi,75,100,25,1,00327,India
265019,2023-12-25,207,coca cola,75,100,25,1,00327,India
860591,2023-12-25,213,bisleri,6,15,9,1,00092,India
860591,2023-12-25,206,yakult,360,400,40,1,00092,India
860591,2023-12-25,203,mango yogurt,50,60,10,1,00092,India
769333,2023-12-25,211,red bull,90,125,35,1,00094,India
769333,2023-12-25,210,mountain dew,75,100,25,1,00094,India
769333,2023-12-25,204,strawberry yogurt,50,60,10,1,00094,India
769333,2023-12-25,208,sprite,75,100,25,1,00094,India
992717,2023-12-25,211,red bull,90,125,35,1,00070,India
992717,2023-12-25,210,mountain dew,75,100,25,1,00070,India
363477,2023-12-25,209,pepsi,75,100,25,1,00042,India
363477,2023-12-25,204,strawberry yogurt,50,60,10,1,00042,India
363477,2023-12-25,202,milk,12,27,15,1,00042,India
726565,2023-12-25,202,milk,12,27,15,1,00316,India
381439,2023-12-25,210,mountain dew,75,100,25,1,00489,India
381439,2023-12-25,206,yakult,360,400,40,1,00489,India
381439,2023-12-25,212,amul cheese,250,315,65,1,00489,India
991638,2023-12-25,201,paneer,210,340,130,1,00199,India
991638,2023-12-25,207,coca cola,75,100,25,1,00199,India
373382,2023-12-25,213,bisleri,6,15,9,1,00074,India
373382,2023-12-25,203,mango yogurt,50,60,10,1,00074,India
492366,2023-12-25,213,bisleri,6,15,9,1,00382,India
492366,2023-12-25,212,amul cheese,250,315,65,1,00382,India
492366,2023-12-25,211,red bull,90,125,35,1,00382,India
492366,2023-12-25,201,paneer,210,340,130,1,00382,India
811736,2023-12-25,208,sprite,75,100,25,1,00108,India
811736,2023-12-25,205,classic yogurt,45,60,15,1,00108,India
175329,2023-12-25,213,bisleri,6,15,9,1,00261,India
175329,2023-12-25,201,paneer,210,340,130,1,00261,India
165711,2023-12-25,209,pepsi,75,100,25,1,00340,India
596902,2023-12-25,208,sprite,75,100,25,1,00204,India
229629,2023-12-25,205,classic yogurt,45,60,15,1,00365,India
654905,2023-12-25,211,red bull,90,125,35,1,00447,India
654905,2023-12-25,213,bisleri,6,15,9,1,00447,India
654905,2023-12-25,210,mountain dew,75,100,25,1,00447,India
788754,2023-12-25,213,bisleri,6,15,9,1,00410,India
788754,2023-12-25,202,milk,12,27,15,1,00410,India
671642,2023-12-25,202,milk,12,27,15,1,00262,India
101312,2023-12-25,208,sprite,75,100,25,1,00380,India
101312,2023-12-25,210,mountain dew,75,100,25,1,00380,India
101312,2023-12-25,201,paneer,210,340,130,1,00380,India
131514,2023-12-25,212,amul cheese,250,315,65,1,00222,India
131514,2023-12-25,207,coca cola,75,100,25,1,00222,India
131514,2023-12-25,206,yakult,360,400,40,1,00222,India
131514,2023-12-25,204,strawberry yogurt,50,60,10,1,00222,India
789057,2023-12-25,204,strawberry yogurt,50,60,10,1,00479,India
653489,2023-12-25,208,sprite,75,100,25,1,00452,India
653489,2023-12-25,213,bisleri,6,15,9,1,00452,India
653489,2023-12-25,204,strawberry yogurt,50,60,10,1,00452,India
938106,2023-12-25,202,milk,12,27,15,1,00160,India
938106,2023-12-25,206,yakult,360,400,40,1,00160,India
927219,2023-12-25,212,amul cheese,250,315,65,1,00082,India
927219,2023-12-25,202,milk,12,27,15,1,00082,India
927219,2023-12-25,205,classic yogurt,45,60,15,1,00082,India
397845,2023-12-25,205,classic yogurt,45,60,15,1,00231,India
397845,2023-12-25,211,red bull,90,125,35,1,00231,India
397845,2023-12-25,209,pepsi,75,100,25,1,00231,India
974199,2023-12-25,205,classic yogurt,45,60,15,1,00358,India
974199,2023-12-25,201,paneer,210,340,130,1,00358,India
974199,2023-12-25,208,sprite,75,100,25,1,00358,India
974199,2023-12-25,207,coca cola,75,100,25,1,00358,India
826001,2023-12-25,210,mountain dew,75,100,25,1,00320,India
538912,2023-12-25,206,yakult,360,400,40,1,00139,India
538912,2023-12-25,212,amul cheese,250,315,65,1,00139,India
113229,2023-12-25,201,paneer,210,340,130,1,00383,India
113229,2023-12-25,210,mountain dew,75,100,25,1,00383,India
113229,2023-12-25,209,pepsi,75,100,25,1,00383,India
168232,2023-12-26,210,mountain dew,75,100,25,1,00373,India
956174,2023-12-26,211,red bull,90,125,35,1,00451,India
934992,2023-12-26,205,classic yogurt,45,60,15,1,00423,India
934992,2023-12-26,203,mango yogurt,50,60,10,1,00423,India
934992,2023-12-26,206,yakult,360,400,40,1,00423,India
385547,2023-12-26,210,mountain dew,75,100,25,1,00391,India
385547,2023-12-26,206,yakult,360,400,40,1,00391,India
385547,2023-12-26,204,strawberry yogurt,50,60,10,1,00391,India
637953,2023-12-26,204,strawberry yogurt,50,60,10,1,00114,India
637953,2023-12-26,212,amul cheese,250,315,65,1,00114,India
637953,2023-12-26,211,red bull,90,125,35,1,00114,India
637953,2023-12-26,213,bisleri,6,15,9,1,00114,India
100945,2023-12-26,207,coca cola,75,100,25,1,00313,India
100945,2023-12-26,208,sprite,75,100,25,1,00313,India
100945,2023-12-26,212,amul cheese,250,315,65,1,00313,India
534956,2023-12-26,203,mango yogurt,50,60,10,1,00329,India
534956,2023-12-26,209,pepsi,75,100,25,1,00329,India
534956,2023-12-26,210,mountain dew,75,100,25,1,00329,India
778008,2023-12-26,206,yakult,360,400,40,1,00368,India
778008,2023-12-26,203,mango yogurt,50,60,10,1,00368,India
322344,2023-12-26,211,red bull,90,125,35,1,00251,India
322344,2023-12-26,212,amul cheese,250,315,65,1,00251,India
646059,2023-12-26,204,strawberry yogurt,50,60,10,1,00092,India
646059,2023-12-26,203,mango yogurt,50,60,10,1,00092,India
735672,2023-12-26,211,red bull,90,125,35,1,00058,India
735672,2023-12-26,201,paneer,210,340,130,1,00058,India
735672,2023-12-26,207,coca cola,75,100,25,1,00058,India
209880,2023-12-26,207,coca cola,75,100,25,1,00175,India
209880,2023-12-26,208,sprite,75,100,25,1,00175,India
209880,2023-12-26,203,mango yogurt,50,60,10,1,00175,India
209880,2023-12-26,201,paneer,210,340,130,1,00175,India
786631,2023-12-26,206,yakult,360,400,40,1,00057,India
786631,2023-12-26,205,classic yogurt,45,60,15,1,00057,India
786631,2023-12-26,213,bisleri,6,15,9,1,00057,India
397788,2023-12-26,204,strawberry yogurt,50,60,10,1,00297,India
397788,2023-12-26,201,paneer,210,340,130,1,00297,India
397788,2023-12-26,208,sprite,75,100,25,1,00297,India
397788,2023-12-26,203,mango yogurt,50,60,10,1,00297,India
397788,2023-12-26,210,mountain dew,75,100,25,1,00297,India
218973,2023-12-26,206,yakult,360,400,40,1,00163,India
218973,2023-12-26,205,classic yogurt,45,60,15,1,00163,India
218973,2023-12-26,213,bisleri,6,15,9,1,00163,India
517183,2023-12-26,201,paneer,210,340,130,1,00283,India
517183,2023-12-26,210,mountain dew,75,100,25,1,00283,India
517183,2023-12-26,211,red bull,90,125,35,1,00283,India
567032,2023-12-26,213,bisleri,6,15,9,1,00195,India
567032,2023-12-26,205,classic yogurt,45,60,15,1,00195,India
567032,2023-12-26,211,red bull,90,125,35,1,00195,India
567032,2023-12-26,208,sprite,75,100,25,1,00195,India
567032,2023-12-26,204,strawberry yogurt,50,60,10,1,00195,India
776505,2023-12-26,204,strawberry yogurt,50,60,10,1,00248,India
776505,2023-12-26,202,milk,12,27,15,1,00248,India
647485,2023-12-26,211,red bull,90,125,35,1,00340,India
758648,2023-12-26,210,mountain dew,75,100,25,1,00079,India
758648,2023-12-26,204,strawberry yogurt,50,60,10,1,00079,India
758648,2023-12-26,208,sprite,75,100,25,1,00079,India
616081,2023-12-26,211,red bull,90,125,35,1,00438,India
908562,2023-12-26,212,amul cheese,250,315,65,1,00352,India
908562,2023-12-26,204,strawberry yogurt,50,60,10,1,00352,India
908562,2023-12-26,213,bisleri,6,15,9,1,00352,India
908562,2023-12-26,208,sprite,75,100,25,1,00352,India
908562,2023-12-26,210,mountain dew,75,100,25,1,00352,India
323879,2023-12-26,202,milk,12,27,15,1,00142,India
323879,2023-12-26,212,amul cheese,250,315,65,1,00142,India
710412,2023-12-26,204,strawberry yogurt,50,60,10,1,00167,India
710412,2023-12-26,209,pepsi,75,100,25,1,00167,India
710412,2023-12-26,210,mountain dew,75,100,25,1,00167,India
710412,2023-12-26,201,paneer,210,340,130,1,00167,India
710412,2023-12-26,202,milk,12,27,15,1,00167,India
760535,2023-12-26,207,coca cola,75,100,25,1,00325,India
355039,2023-12-26,207,coca cola,75,100,25,1,00190,India
355039,2023-12-26,202,milk,12,27,15,1,00190,India
355039,2023-12-26,203,mango yogurt,50,60,10,1,00190,India
141693,2023-12-26,205,classic yogurt,45,60,15,1,00449,India
141693,2023-12-26,213,bisleri,6,15,9,1,00449,India
874354,2023-12-26,210,mountain dew,75,100,25,1,00184,India
874354,2023-12-26,202,milk,12,27,15,1,00184,India
966167,2023-12-26,201,paneer,210,340,130,1,00383,India
966167,2023-12-26,206,yakult,360,400,40,1,00383,India
371367,2023-12-26,202,milk,12,27,15,1,00370,India
371367,2023-12-26,212,amul cheese,250,315,65,1,00370,India
371367,2023-12-26,206,yakult,360,400,40,1,00370,India
371367,2023-12-26,204,strawberry yogurt,50,60,10,1,00370,India
954614,2023-12-26,213,bisleri,6,15,9,1,00423,India
954614,2023-12-26,206,yakult,360,400,40,1,00423,India
954614,2023-12-26,208,sprite,75,100,25,1,00423,India
766745,2023-12-26,212,amul cheese,250,315,65,1,00113,India
766745,2023-12-26,207,coca cola,75,100,25,1,00113,India
423638,2023-12-26,207,coca cola,75,100,25,1,00111,India
423638,2023-12-26,203,mango yogurt,50,60,10,1,00111,India
423638,2023-12-26,211,red bull,90,125,35,1,00111,India
423638,2023-12-26,213,bisleri,6,15,9,1,00111,India
652457,2023-12-26,210,mountain dew,75,100,25,1,00474,India
652457,2023-12-26,207,coca cola,75,100,25,1,00474,India
652457,2023-12-26,208,sprite,75,100,25,1,00474,India
629478,2023-12-26,201,paneer,210,340,130,1,00322,India
629478,2023-12-26,210,mountain dew,75,100,25,1,00322,India
629478,2023-12-26,205,classic yogurt,45,60,15,1,00322,India
629478,2023-12-26,208,sprite,75,100,25,1,00322,India
629478,2023-12-26,207,coca cola,75,100,25,1,00322,India
991531,2023-12-26,208,sprite,75,100,25,1,00459,India
991531,2023-12-26,211,red bull,90,125,35,1,00459,India
991531,2023-12-26,209,pepsi,75,100,25,1,00459,India
991531,2023-12-26,207,coca cola,75,100,25,1,00459,India
579482,2023-12-26,209,pepsi,75,100,25,1,00351,India
579482,2023-12-26,212,amul cheese,250,315,65,1,00351,India
946042,2023-12-26,204,strawberry yogurt,50,60,10,1,00359,India
313889,2023-12-26,213,bisleri,6,15,9,1,00297,India
993949,2023-12-26,203,mango yogurt,50,60,10,1,00065,India
993949,2023-12-26,210,mountain dew,75,100,25,1,00065,India
966150,2023-12-26,209,pepsi,75,100,25,1,00058,India
966150,2023-12-26,211,red bull,90,125,35,1,00058,India
966150,2023-12-26,204,strawberry yogurt,50,60,10,1,00058,India
341025,2023-12-26,203,mango yogurt,50,60,10,1,00015,India
341025,2023-12-26,206,yakult,360,400,40,1,00015,India
341025,2023-12-26,212,amul cheese,250,315,65,1,00015,India
341025,2023-12-26,211,red bull,90,125,35,1,00015,India
355605,2023-12-26,213,bisleri,6,15,9,1,00414,India
355605,2023-12-26,207,coca cola,75,100,25,1,00414,India
355605,2023-12-26,212,amul cheese,250,315,65,1,00414,India
355605,2023-12-26,209,pepsi,75,100,25,1,00414,India
590672,2023-12-26,212,amul cheese,250,315,65,1,00399,India
590672,2023-12-26,213,bisleri,6,15,9,1,00399,India
708719,2023-12-26,202,milk,12,27,15,1,00285,India
708719,2023-12-26,203,mango yogurt,50,60,10,1,00285,India
708719,2023-12-26,208,sprite,75,100,25,1,00285,India
388890,2023-12-26,208,sprite,75,100,25,1,00300,India
388890,2023-12-26,207,coca cola,75,100,25,1,00300,India
388890,2023-12-26,213,bisleri,6,15,9,1,00300,India
388890,2023-12-26,210,mountain dew,75,100,25,1,00300,India
911891,2023-12-26,206,yakult,360,400,40,1,00345,India
911891,2023-12-26,213,bisleri,6,15,9,1,00345,India
951050,2023-12-26,208,sprite,75,100,25,1,00382,India
951050,2023-12-26,209,pepsi,75,100,25,1,00382,India
951050,2023-12-26,213,bisleri,6,15,9,1,00382,India
951050,2023-12-26,206,yakult,360,400,40,1,00382,India
951050,2023-12-26,207,coca cola,75,100,25,1,00382,India
605981,2023-12-26,211,red bull,90,125,35,1,00463,India
605981,2023-12-26,212,amul cheese,250,315,65,1,00463,India
605981,2023-12-26,210,mountain dew,75,100,25,1,00463,India
231070,2023-12-26,210,mountain dew,75,100,25,1,00263,India
231070,2023-12-26,211,red bull,90,125,35,1,00263,India
457367,2023-12-26,204,strawberry yogurt,50,60,10,1,00033,India
457367,2023-12-26,207,coca cola,75,100,25,1,00033,India
457367,2023-12-26,206,yakult,360,400,40,1,00033,India
457367,2023-12-26,212,amul cheese,250,315,65,1,00033,India
457367,2023-12-26,210,mountain dew,75,100,25,1,00033,India
337783,2023-12-26,209,pepsi,75,100,25,1,00211,India
337783,2023-12-26,211,red bull,90,125,35,1,00211,India
866601,2023-12-26,202,milk,12,27,15,1,00120,India
866601,2023-12-26,203,mango yogurt,50,60,10,1,00120,India
866601,2023-12-26,206,yakult,360,400,40,1,00120,India
866601,2023-12-26,207,coca cola,75,100,25,1,00120,India
669211,2023-12-26,204,strawberry yogurt,50,60,10,1,00398,India
827964,2023-12-26,209,pepsi,75,100,25,1,00338,India
827964,2023-12-26,205,classic yogurt,45,60,15,1,00338,India
360274,2023-12-26,212,amul cheese,250,315,65,1,00105,India
360274,2023-12-26,203,mango yogurt,50,60,10,1,00105,India
558120,2023-12-26,202,milk,12,27,15,1,00435,India
558120,2023-12-26,205,classic yogurt,45,60,15,1,00435,India
887608,2023-12-26,207,coca cola,75,100,25,1,00037,India
887608,2023-12-26,203,mango yogurt,50,60,10,1,00037,India
887608,2023-12-26,201,paneer,210,340,130,1,00037,India
341764,2023-12-26,202,milk,12,27,15,1,00161,India
341764,2023-12-26,203,mango yogurt,50,60,10,1,00161,India
341764,2023-12-26,211,red bull,90,125,35,1,00161,India
341764,2023-12-26,213,bisleri,6,15,9,1,00161,India
948668,2023-12-26,207,coca cola,75,100,25,1,00385,India
948668,2023-12-26,203,mango yogurt,50,60,10,1,00385,India
948668,2023-12-26,213,bisleri,6,15,9,1,00385,India
414912,2023-12-26,201,paneer,210,340,130,1,00242,India
229614,2023-12-26,206,yakult,360,400,40,1,00051,India
211625,2023-12-26,204,strawberry yogurt,50,60,10,1,00184,India
211625,2023-12-26,203,mango yogurt,50,60,10,1,00184,India
211625,2023-12-26,208,sprite,75,100,25,1,00184,India
211625,2023-12-26,211,red bull,90,125,35,1,00184,India
401727,2023-12-26,206,yakult,360,400,40,1,00374,India
595642,2023-12-26,204,strawberry yogurt,50,60,10,1,00136,India
595642,2023-12-26,213,bisleri,6,15,9,1,00136,India
964214,2023-12-26,207,coca cola,75,100,25,1,00237,India
964214,2023-12-26,206,yakult,360,400,40,1,00237,India
964214,2023-12-26,211,red bull,90,125,35,1,00237,India
850277,2023-12-26,201,paneer,210,340,130,1,00378,India
850277,2023-12-26,210,mountain dew,75,100,25,1,00378,India
850277,2023-12-26,208,sprite,75,100,25,1,00378,India
850277,2023-12-26,203,mango yogurt,50,60,10,1,00378,India
352735,2023-12-26,204,strawberry yogurt,50,60,10,1,00331,India
352735,2023-12-26,206,yakult,360,400,40,1,00331,India
352735,2023-12-26,207,coca cola,75,100,25,1,00331,India
528390,2023-12-26,213,bisleri,6,15,9,1,00280,India
692799,2023-12-26,212,amul cheese,250,315,65,1,00063,India
692799,2023-12-26,206,yakult,360,400,40,1,00063,India
493689,2023-12-26,208,sprite,75,100,25,1,00332,India
345428,2023-12-26,210,mountain dew,75,100,25,1,00382,India
345428,2023-12-26,211,red bull,90,125,35,1,00382,India
345428,2023-12-26,204,strawberry yogurt,50,60,10,1,00382,India
345428,2023-12-26,212,amul cheese,250,315,65,1,00382,India
345428,2023-12-26,208,sprite,75,100,25,1,00382,India
412203,2023-12-26,213,bisleri,6,15,9,1,00045,India
412203,2023-12-26,207,coca cola,75,100,25,1,00045,India
412203,2023-12-26,201,paneer,210,340,130,1,00045,India
412203,2023-12-26,206,yakult,360,400,40,1,00045,India
791433,2023-12-26,208,sprite,75,100,25,1,00460,India
791433,2023-12-26,205,classic yogurt,45,60,15,1,00460,India
791433,2023-12-26,203,mango yogurt,50,60,10,1,00460,India
791433,2023-12-26,202,milk,12,27,15,1,00460,India
183370,2023-12-26,205,classic yogurt,45,60,15,1,00246,India
183370,2023-12-26,204,strawberry yogurt,50,60,10,1,00246,India
183370,2023-12-26,213,bisleri,6,15,9,1,00246,India
925094,2023-12-26,209,pepsi,75,100,25,1,00481,India
153033,2023-12-26,206,yakult,360,400,40,1,00050,India
550476,2023-12-26,211,red bull,90,125,35,1,00250,India
550476,2023-12-26,212,amul cheese,250,315,65,1,00250,India
550476,2023-12-26,203,mango yogurt,50,60,10,1,00250,India
835793,2023-12-26,212,amul cheese,250,315,65,1,00001,India
835793,2023-12-26,207,coca cola,75,100,25,1,00001,India
835793,2023-12-26,206,yakult,360,400,40,1,00001,India
387988,2023-12-26,205,classic yogurt,45,60,15,1,00214,India
387988,2023-12-26,209,pepsi,75,100,25,1,00214,India
387988,2023-12-26,201,paneer,210,340,130,1,00214,India
387988,2023-12-26,203,mango yogurt,50,60,10,1,00214,India
387988,2023-12-26,210,mountain dew,75,100,25,1,00214,India
527736,2023-12-26,201,paneer,210,340,130,1,00228,India
527736,2023-12-26,213,bisleri,6,15,9,1,00228,India
527736,2023-12-26,208,sprite,75,100,25,1,00228,India
527736,2023-12-26,204,strawberry yogurt,50,60,10,1,00228,India
510492,2023-12-26,210,mountain dew,75,100,25,1,00488,India
510492,2023-12-26,206,yakult,360,400,40,1,00488,India
510492,2023-12-26,201,paneer,210,340,130,1,00488,India
741773,2023-12-26,207,coca cola,75,100,25,1,00293,India
741773,2023-12-26,201,paneer,210,340,130,1,00293,India
945489,2023-12-26,210,mountain dew,75,100,25,1,00109,India
945489,2023-12-26,203,mango yogurt,50,60,10,1,00109,India
945489,2023-12-26,211,red bull,90,125,35,1,00109,India
489334,2023-12-26,212,amul cheese,250,315,65,1,00316,India
489334,2023-12-26,201,paneer,210,340,130,1,00316,India
489334,2023-12-26,213,bisleri,6,15,9,1,00316,India
489334,2023-12-26,209,pepsi,75,100,25,1,00316,India
577431,2023-12-26,208,sprite,75,100,25,1,00060,India
641837,2023-12-26,213,bisleri,6,15,9,1,00363,India
641837,2023-12-26,208,sprite,75,100,25,1,00363,India
641837,2023-12-26,206,yakult,360,400,40,1,00363,India
987402,2023-12-27,208,sprite,75,100,25,1,00070,India
581212,2023-12-27,213,bisleri,6,15,9,1,00436,India
581212,2023-12-27,211,red bull,90,125,35,1,00436,India
581212,2023-12-27,205,classic yogurt,45,60,15,1,00436,India
446525,2023-12-27,203,mango yogurt,50,60,10,1,00220,India
446525,2023-12-27,201,paneer,210,340,130,1,00220,India
237110,2023-12-27,210,mountain dew,75,100,25,1,00105,India
237110,2023-12-27,206,yakult,360,400,40,1,00105,India
163409,2023-12-27,203,mango yogurt,50,60,10,1,00130,India
448706,2023-12-27,204,strawberry yogurt,50,60,10,1,00488,India
989023,2023-12-27,207,coca cola,75,100,25,1,00092,India
989023,2023-12-27,212,amul cheese,250,315,65,1,00092,India
989023,2023-12-27,211,red bull,90,125,35,1,00092,India
989023,2023-12-27,201,paneer,210,340,130,1,00092,India
887559,2023-12-27,213,bisleri,6,15,9,1,00016,India
887559,2023-12-27,205,classic yogurt,45,60,15,1,00016,India
887559,2023-12-27,206,yakult,360,400,40,1,00016,India
178377,2023-12-27,203,mango yogurt,50,60,10,1,00337,India
382031,2023-12-27,212,amul cheese,250,315,65,1,00176,India
382031,2023-12-27,209,pepsi,75,100,25,1,00176,India
382031,2023-12-27,204,strawberry yogurt,50,60,10,1,00176,India
382031,2023-12-27,202,milk,12,27,15,1,00176,India
518190,2023-12-27,203,mango yogurt,50,60,10,1,00082,India
518190,2023-12-27,213,bisleri,6,15,9,1,00082,India
518190,2023-12-27,201,paneer,210,340,130,1,00082,India
518190,2023-12-27,204,strawberry yogurt,50,60,10,1,00082,India
534848,2023-12-27,207,coca cola,75,100,25,1,00308,India
534848,2023-12-27,201,paneer,210,340,130,1,00308,India
534848,2023-12-27,203,mango yogurt,50,60,10,1,00308,India
615507,2023-12-27,201,paneer,210,340,130,1,00115,India
615507,2023-12-27,205,classic yogurt,45,60,15,1,00115,India
980920,2023-12-27,208,sprite,75,100,25,1,00179,India
980920,2023-12-27,206,yakult,360,400,40,1,00179,India
980920,2023-12-27,210,mountain dew,75,100,25,1,00179,India
980920,2023-12-27,213,bisleri,6,15,9,1,00179,India
980920,2023-12-27,202,milk,12,27,15,1,00179,India
721708,2023-12-27,212,amul cheese,250,315,65,1,00208,India
721708,2023-12-27,211,red bull,90,125,35,1,00208,India
721708,2023-12-27,210,mountain dew,75,100,25,1,00208,India
721708,2023-12-27,203,mango yogurt,50,60,10,1,00208,India
876849,2023-12-27,204,strawberry yogurt,50,60,10,1,00248,India
113986,2023-12-27,213,bisleri,6,15,9,1,00406,India
113986,2023-12-27,208,sprite,75,100,25,1,00406,India
113986,2023-12-27,206,yakult,360,400,40,1,00406,India
113986,2023-12-27,209,pepsi,75,100,25,1,00406,India
862650,2023-12-27,212,amul cheese,250,315,65,1,00165,India
862650,2023-12-27,209,pepsi,75,100,25,1,00165,India
862650,2023-12-27,210,mountain dew,75,100,25,1,00165,India
862650,2023-12-27,208,sprite,75,100,25,1,00165,India
438324,2023-12-27,210,mountain dew,75,100,25,1,00458,India
438324,2023-12-27,204,strawberry yogurt,50,60,10,1,00458,India
438324,2023-12-27,201,paneer,210,340,130,1,00458,India
533418,2023-12-27,201,paneer,210,340,130,1,00334,India
533418,2023-12-27,203,mango yogurt,50,60,10,1,00334,India
533418,2023-12-27,206,yakult,360,400,40,1,00334,India
533418,2023-12-27,212,amul cheese,250,315,65,1,00334,India
533418,2023-12-27,205,classic yogurt,45,60,15,1,00334,India
498598,2023-12-27,206,yakult,360,400,40,1,00317,India
498598,2023-12-27,208,sprite,75,100,25,1,00317,India
628130,2023-12-27,207,coca cola,75,100,25,1,00437,India
628130,2023-12-27,213,bisleri,6,15,9,1,00437,India
628130,2023-12-27,206,yakult,360,400,40,1,00437,India
628130,2023-12-27,201,paneer,210,340,130,1,00437,India
398829,2023-12-27,207,coca cola,75,100,25,1,00080,India
672598,2023-12-27,211,red bull,90,125,35,1,00259,India
640713,2023-12-27,213,bisleri,6,15,9,1,00290,India
639066,2023-12-27,204,strawberry yogurt,50,60,10,1,00415,India
966134,2023-12-27,212,amul cheese,250,315,65,1,00284,India
249214,2023-12-27,203,mango yogurt,50,60,10,1,00035,India
731461,2023-12-27,201,paneer,210,340,130,1,00005,India
731461,2023-12-27,211,red bull,90,125,35,1,00005,India
731461,2023-12-27,206,yakult,360,400,40,1,00005,India
731461,2023-12-27,203,mango yogurt,50,60,10,1,00005,India
219287,2023-12-27,209,pepsi,75,100,25,1,00440,India
219287,2023-12-27,213,bisleri,6,15,9,1,00440,India
219287,2023-12-27,212,amul cheese,250,315,65,1,00440,India
336492,2023-12-27,211,red bull,90,125,35,1,00486,India
336492,2023-12-27,206,yakult,360,400,40,1,00486,India
420031,2023-12-27,205,classic yogurt,45,60,15,1,00201,India
420031,2023-12-27,210,mountain dew,75,100,25,1,00201,India
816516,2023-12-27,211,red bull,90,125,35,1,00068,India
373370,2023-12-27,209,pepsi,75,100,25,1,00242,India
373370,2023-12-27,204,strawberry yogurt,50,60,10,1,00242,India
373370,2023-12-27,202,milk,12,27,15,1,00242,India
373370,2023-12-27,201,paneer,210,340,130,1,00242,India
103912,2023-12-27,205,classic yogurt,45,60,15,1,00346,India
103912,2023-12-27,203,mango yogurt,50,60,10,1,00346,India
103912,2023-12-27,212,amul cheese,250,315,65,1,00346,India
822427,2023-12-27,209,pepsi,75,100,25,1,00296,India
153683,2023-12-27,212,amul cheese,250,315,65,1,00034,India
153683,2023-12-27,201,paneer,210,340,130,1,00034,India
667661,2023-12-27,208,sprite,75,100,25,1,00490,India
667661,2023-12-27,206,yakult,360,400,40,1,00490,India
966121,2023-12-27,208,sprite,75,100,25,1,00136,India
966121,2023-12-27,202,milk,12,27,15,1,00136,India
501802,2023-12-27,206,yakult,360,400,40,1,00076,India
501802,2023-12-27,210,mountain dew,75,100,25,1,00076,India
501802,2023-12-27,207,coca cola,75,100,25,1,00076,India
501802,2023-12-27,205,classic yogurt,45,60,15,1,00076,India
606419,2023-12-27,203,mango yogurt,50,60,10,1,00439,India
606419,2023-12-27,201,paneer,210,340,130,1,00439,India
723560,2023-12-27,201,paneer,210,340,130,1,00328,India
329977,2023-12-27,203,mango yogurt,50,60,10,1,00298,India
329977,2023-12-27,205,classic yogurt,45,60,15,1,00298,India
329977,2023-12-27,201,paneer,210,340,130,1,00298,India
173454,2023-12-27,202,milk,12,27,15,1,00190,India
173454,2023-12-27,209,pepsi,75,100,25,1,00190,India
837517,2023-12-27,201,paneer,210,340,130,1,00197,India
837517,2023-12-27,209,pepsi,75,100,25,1,00197,India
837517,2023-12-27,213,bisleri,6,15,9,1,00197,India
837517,2023-12-27,205,classic yogurt,45,60,15,1,00197,India
837517,2023-12-27,202,milk,12,27,15,1,00197,India
114410,2023-12-27,205,classic yogurt,45,60,15,1,00302,India
114410,2023-12-27,202,milk,12,27,15,1,00302,India
617743,2023-12-27,203,mango yogurt,50,60,10,1,00171,India
617743,2023-12-27,212,amul cheese,250,315,65,1,00171,India
617743,2023-12-27,213,bisleri,6,15,9,1,00171,India
617743,2023-12-27,205,classic yogurt,45,60,15,1,00171,India
295586,2023-12-27,207,coca cola,75,100,25,1,00236,India
295586,2023-12-27,212,amul cheese,250,315,65,1,00236,India
295586,2023-12-27,204,strawberry yogurt,50,60,10,1,00236,India
113378,2023-12-27,203,mango yogurt,50,60,10,1,00069,India
113378,2023-12-27,204,strawberry yogurt,50,60,10,1,00069,India
718906,2023-12-27,211,red bull,90,125,35,1,00383,India
718906,2023-12-27,212,amul cheese,250,315,65,1,00383,India
718906,2023-12-27,213,bisleri,6,15,9,1,00383,India
718906,2023-12-27,209,pepsi,75,100,25,1,00383,India
293836,2023-12-28,203,mango yogurt,50,60,10,1,00086,India
293836,2023-12-28,212,amul cheese,250,315,65,1,00086,India
293836,2023-12-28,207,coca cola,75,100,25,1,00086,India
293836,2023-12-28,202,milk,12,27,15,1,00086,India
293836,2023-12-28,211,red bull,90,125,35,1,00086,India
713650,2023-12-28,204,strawberry yogurt,50,60,10,1,00487,India
713650,2023-12-28,212,amul cheese,250,315,65,1,00487,India
713650,2023-12-28,208,sprite,75,100,25,1,00487,India
275988,2023-12-28,206,yakult,360,400,40,1,00002,India
678311,2023-12-28,211,red bull,90,125,35,1,00064,India
115673,2023-12-28,212,amul cheese,250,315,65,1,00367,India
115673,2023-12-28,213,bisleri,6,15,9,1,00367,India
115673,2023-12-28,205,classic yogurt,45,60,15,1,00367,India
115673,2023-12-28,208,sprite,75,100,25,1,00367,India
119820,2023-12-28,210,mountain dew,75,100,25,1,00239,India
119820,2023-12-28,212,amul cheese,250,315,65,1,00239,India
119820,2023-12-28,205,classic yogurt,45,60,15,1,00239,India
119820,2023-12-28,203,mango yogurt,50,60,10,1,00239,India
612150,2023-12-28,211,red bull,90,125,35,1,00181,India
612150,2023-12-28,207,coca cola,75,100,25,1,00181,India
435712,2023-12-28,204,strawberry yogurt,50,60,10,1,00090,India
424954,2023-12-28,202,milk,12,27,15,1,00403,India
876641,2023-12-28,203,mango yogurt,50,60,10,1,00042,India
143494,2023-12-28,207,coca cola,75,100,25,1,00353,India
143494,2023-12-28,201,paneer,210,340,130,1,00353,India
143494,2023-12-28,213,bisleri,6,15,9,1,00353,India
582891,2023-12-28,212,amul cheese,250,315,65,1,00421,India
582891,2023-12-28,205,classic yogurt,45,60,15,1,00421,India
582891,2023-12-28,213,bisleri,6,15,9,1,00421,India
237976,2023-12-28,206,yakult,360,400,40,1,00174,India
237976,2023-12-28,213,bisleri,6,15,9,1,00174,India
237976,2023-12-28,204,strawberry yogurt,50,60,10,1,00174,India
289213,2023-12-28,202,milk,12,27,15,1,00245,India
289213,2023-12-28,207,coca cola,75,100,25,1,00245,India
588855,2023-12-28,211,red bull,90,125,35,1,00268,India
588855,2023-12-28,204,strawberry yogurt,50,60,10,1,00268,India
588855,2023-12-28,203,mango yogurt,50,60,10,1,00268,India
588855,2023-12-28,210,mountain dew,75,100,25,1,00268,India
387084,2023-12-28,203,mango yogurt,50,60,10,1,00101,India
387084,2023-12-28,208,sprite,75,100,25,1,00101,India
387084,2023-12-28,211,red bull,90,125,35,1,00101,India
925339,2023-12-28,204,strawberry yogurt,50,60,10,1,00017,India
901872,2023-12-28,206,yakult,360,400,40,1,00116,India
901872,2023-12-28,201,paneer,210,340,130,1,00116,India
608988,2023-12-28,205,classic yogurt,45,60,15,1,00385,India
608988,2023-12-28,202,milk,12,27,15,1,00385,India
608988,2023-12-28,212,amul cheese,250,315,65,1,00385,India
507511,2023-12-28,202,milk,12,27,15,1,00347,India
507511,2023-12-28,204,strawberry yogurt,50,60,10,1,00347,India
989907,2023-12-28,206,yakult,360,400,40,1,00024,India
215062,2023-12-28,209,pepsi,75,100,25,1,00198,India
215062,2023-12-28,205,classic yogurt,45,60,15,1,00198,India
215062,2023-12-28,202,milk,12,27,15,1,00198,India
797700,2023-12-28,208,sprite,75,100,25,1,00405,India
797700,2023-12-28,211,red bull,90,125,35,1,00405,India
797700,2023-12-28,202,milk,12,27,15,1,00405,India
274002,2023-12-28,208,sprite,75,100,25,1,00273,India
274002,2023-12-28,204,strawberry yogurt,50,60,10,1,00273,India
740350,2023-12-28,211,red bull,90,125,35,1,00313,India
740350,2023-12-28,202,milk,12,27,15,1,00313,India
740350,2023-12-28,210,mountain dew,75,100,25,1,00313,India
740350,2023-12-28,213,bisleri,6,15,9,1,00313,India
182218,2023-12-28,202,milk,12,27,15,1,00301,India
473894,2023-12-28,213,bisleri,6,15,9,1,00228,India
473894,2023-12-28,201,paneer,210,340,130,1,00228,India
473894,2023-12-28,211,red bull,90,125,35,1,00228,India
111988,2023-12-28,209,pepsi,75,100,25,1,00084,India
111988,2023-12-28,210,mountain dew,75,100,25,1,00084,India
111988,2023-12-28,208,sprite,75,100,25,1,00084,India
709795,2023-12-28,202,milk,12,27,15,1,00239,India
750212,2023-12-28,205,classic yogurt,45,60,15,1,00456,India
835311,2023-12-28,203,mango yogurt,50,60,10,1,00052,India
835311,2023-12-28,212,amul cheese,250,315,65,1,00052,India
514233,2023-12-28,207,coca cola,75,100,25,1,00176,India
514233,2023-12-28,204,strawberry yogurt,50,60,10,1,00176,India
514233,2023-12-28,208,sprite,75,100,25,1,00176,India
514233,2023-12-28,203,mango yogurt,50,60,10,1,00176,India
514233,2023-12-28,206,yakult,360,400,40,1,00176,India
576944,2023-12-28,213,bisleri,6,15,9,1,00217,India
576944,2023-12-28,210,mountain dew,75,100,25,1,00217,India
576944,2023-12-28,206,yakult,360,400,40,1,00217,India
576944,2023-12-28,204,strawberry yogurt,50,60,10,1,00217,India
576944,2023-12-28,212,amul cheese,250,315,65,1,00217,India
964470,2023-12-28,212,amul cheese,250,315,65,1,00103,India
964470,2023-12-28,205,classic yogurt,45,60,15,1,00103,India
964470,2023-12-28,202,milk,12,27,15,1,00103,India
781375,2023-12-28,204,strawberry yogurt,50,60,10,1,00200,India
781375,2023-12-28,212,amul cheese,250,315,65,1,00200,India
781375,2023-12-28,206,yakult,360,400,40,1,00200,India
489502,2023-12-28,209,pepsi,75,100,25,1,00077,India
489502,2023-12-28,206,yakult,360,400,40,1,00077,India
236224,2023-12-28,211,red bull,90,125,35,1,00275,India
236224,2023-12-28,207,coca cola,75,100,25,1,00275,India
988848,2023-12-28,203,mango yogurt,50,60,10,1,00112,India
988848,2023-12-28,205,classic yogurt,45,60,15,1,00112,India
988848,2023-12-28,204,strawberry yogurt,50,60,10,1,00112,India
150469,2023-12-28,209,pepsi,75,100,25,1,00269,India
150469,2023-12-28,201,paneer,210,340,130,1,00269,India
494396,2023-12-28,201,paneer,210,340,130,1,00413,India
878526,2023-12-28,211,red bull,90,125,35,1,00100,India
878526,2023-12-28,204,strawberry yogurt,50,60,10,1,00100,India
333547,2023-12-28,209,pepsi,75,100,25,1,00117,India
994792,2023-12-28,201,paneer,210,340,130,1,00332,India
994792,2023-12-28,206,yakult,360,400,40,1,00332,India
980898,2023-12-28,205,classic yogurt,45,60,15,1,00414,India
435680,2023-12-28,206,yakult,360,400,40,1,00238,India
435680,2023-12-28,205,classic yogurt,45,60,15,1,00238,India
435680,2023-12-28,208,sprite,75,100,25,1,00238,India
944817,2023-12-28,210,mountain dew,75,100,25,1,00164,India
944817,2023-12-28,206,yakult,360,400,40,1,00164,India
605802,2023-12-28,211,red bull,90,125,35,1,00149,India
605802,2023-12-28,205,classic yogurt,45,60,15,1,00149,India
605802,2023-12-28,210,mountain dew,75,100,25,1,00149,India
605802,2023-12-28,213,bisleri,6,15,9,1,00149,India
868147,2023-12-28,205,classic yogurt,45,60,15,1,00455,India
868147,2023-12-28,207,coca cola,75,100,25,1,00455,India
507684,2023-12-28,207,coca cola,75,100,25,1,00256,India
507684,2023-12-28,206,yakult,360,400,40,1,00256,India
764454,2023-12-28,202,milk,12,27,15,1,00396,India
764454,2023-12-28,201,paneer,210,340,130,1,00396,India
764454,2023-12-28,208,sprite,75,100,25,1,00396,India
764454,2023-12-28,206,yakult,360,400,40,1,00396,India
809928,2023-12-28,211,red bull,90,125,35,1,00038,India
809928,2023-12-28,209,pepsi,75,100,25,1,00038,India
809928,2023-12-28,208,sprite,75,100,25,1,00038,India
809928,2023-12-28,205,classic yogurt,45,60,15,1,00038,India
980516,2023-12-28,206,yakult,360,400,40,1,00065,India
980516,2023-12-28,213,bisleri,6,15,9,1,00065,India
707575,2023-12-28,213,bisleri,6,15,9,1,00321,India
707575,2023-12-28,208,sprite,75,100,25,1,00321,India
707575,2023-12-28,202,milk,12,27,15,1,00321,India
984383,2023-12-28,211,red bull,90,125,35,1,00044,India
583432,2023-12-28,206,yakult,360,400,40,1,00321,India
583432,2023-12-28,202,milk,12,27,15,1,00321,India
583432,2023-12-28,212,amul cheese,250,315,65,1,00321,India
583432,2023-12-28,204,strawberry yogurt,50,60,10,1,00321,India
583432,2023-12-28,213,bisleri,6,15,9,1,00321,India
721055,2023-12-29,210,mountain dew,75,100,25,1,00245,India
721055,2023-12-29,213,bisleri,6,15,9,1,00245,India
721055,2023-12-29,204,strawberry yogurt,50,60,10,1,00245,India
112918,2023-12-29,210,mountain dew,75,100,25,1,00293,India
112918,2023-12-29,205,classic yogurt,45,60,15,1,00293,India
112918,2023-12-29,212,amul cheese,250,315,65,1,00293,India
652790,2023-12-29,206,yakult,360,400,40,1,00259,India
652790,2023-12-29,204,strawberry yogurt,50,60,10,1,00259,India
652790,2023-12-29,207,coca cola,75,100,25,1,00259,India
458191,2023-12-29,203,mango yogurt,50,60,10,1,00280,India
458191,2023-12-29,202,milk,12,27,15,1,00280,India
458191,2023-12-29,204,strawberry yogurt,50,60,10,1,00280,India
458191,2023-12-29,213,bisleri,6,15,9,1,00280,India
444028,2023-12-29,213,bisleri,6,15,9,1,00134,India
790108,2023-12-29,204,strawberry yogurt,50,60,10,1,00129,India
790108,2023-12-29,210,mountain dew,75,100,25,1,00129,India
302876,2023-12-29,203,mango yogurt,50,60,10,1,00481,India
302876,2023-12-29,205,classic yogurt,45,60,15,1,00481,India
302876,2023-12-29,207,coca cola,75,100,25,1,00481,India
305457,2023-12-29,212,amul cheese,250,315,65,1,00469,India
305457,2023-12-29,213,bisleri,6,15,9,1,00469,India
305457,2023-12-29,210,mountain dew,75,100,25,1,00469,India
669755,2023-12-29,207,coca cola,75,100,25,1,00290,India
669755,2023-12-29,206,yakult,360,400,40,1,00290,India
669755,2023-12-29,213,bisleri,6,15,9,1,00290,India
302978,2023-12-29,207,coca cola,75,100,25,1,00246,India
546726,2023-12-29,202,milk,12,27,15,1,00411,India
907971,2023-12-29,209,pepsi,75,100,25,1,00165,India
992451,2023-12-29,213,bisleri,6,15,9,1,00282,India
992451,2023-12-29,203,mango yogurt,50,60,10,1,00282,India
992451,2023-12-29,205,classic yogurt,45,60,15,1,00282,India
693971,2023-12-29,201,paneer,210,340,130,1,00469,India
693971,2023-12-29,207,coca cola,75,100,25,1,00469,India
304699,2023-12-29,202,milk,12,27,15,1,00210,India
304699,2023-12-29,211,red bull,90,125,35,1,00210,India
304699,2023-12-29,208,sprite,75,100,25,1,00210,India
304699,2023-12-29,213,bisleri,6,15,9,1,00210,India
304699,2023-12-29,206,yakult,360,400,40,1,00210,India
446648,2023-12-29,202,milk,12,27,15,1,00168,India
446648,2023-12-29,212,amul cheese,250,315,65,1,00168,India
446648,2023-12-29,211,red bull,90,125,35,1,00168,India
200717,2023-12-29,203,mango yogurt,50,60,10,1,00118,India
200717,2023-12-29,208,sprite,75,100,25,1,00118,India
200717,2023-12-29,201,paneer,210,340,130,1,00118,India
200717,2023-12-29,210,mountain dew,75,100,25,1,00118,India
935435,2023-12-29,202,milk,12,27,15,1,00179,India
935435,2023-12-29,206,yakult,360,400,40,1,00179,India
935435,2023-12-29,201,paneer,210,340,130,1,00179,India
935435,2023-12-29,205,classic yogurt,45,60,15,1,00179,India
315157,2023-12-29,210,mountain dew,75,100,25,1,00130,India
315157,2023-12-29,202,milk,12,27,15,1,00130,India
315157,2023-12-29,201,paneer,210,340,130,1,00130,India
448450,2023-12-29,203,mango yogurt,50,60,10,1,00355,India
448450,2023-12-29,206,yakult,360,400,40,1,00355,India
669095,2023-12-29,211,red bull,90,125,35,1,00202,India
151119,2023-12-29,210,mountain dew,75,100,25,1,00306,India
151119,2023-12-29,207,coca cola,75,100,25,1,00306,India
797939,2023-12-29,212,amul cheese,250,315,65,1,00056,India
531361,2023-12-29,202,milk,12,27,15,1,00343,India
531361,2023-12-29,213,bisleri,6,15,9,1,00343,India
531361,2023-12-29,209,pepsi,75,100,25,1,00343,India
531361,2023-12-29,206,yakult,360,400,40,1,00343,India
152558,2023-12-29,203,mango yogurt,50,60,10,1,00471,India
152558,2023-12-29,211,red bull,90,125,35,1,00471,India
152558,2023-12-29,213,bisleri,6,15,9,1,00471,India
100025,2023-12-29,203,mango yogurt,50,60,10,1,00158,India
390601,2023-12-29,205,classic yogurt,45,60,15,1,00195,India
390601,2023-12-29,211,red bull,90,125,35,1,00195,India
873724,2023-12-29,205,classic yogurt,45,60,15,1,00350,India
873724,2023-12-29,206,yakult,360,400,40,1,00350,India
873724,2023-12-29,201,paneer,210,340,130,1,00350,India
873724,2023-12-29,210,mountain dew,75,100,25,1,00350,India
873724,2023-12-29,211,red bull,90,125,35,1,00350,India
213140,2023-12-29,203,mango yogurt,50,60,10,1,00279,India
213140,2023-12-29,210,mountain dew,75,100,25,1,00279,India
243079,2023-12-29,213,bisleri,6,15,9,1,00441,India
243079,2023-12-29,203,mango yogurt,50,60,10,1,00441,India
475350,2023-12-29,213,bisleri,6,15,9,1,00307,India
864355,2023-12-29,212,amul cheese,250,315,65,1,00106,India
864355,2023-12-29,209,pepsi,75,100,25,1,00106,India
864355,2023-12-29,203,mango yogurt,50,60,10,1,00106,India
412947,2023-12-29,206,yakult,360,400,40,1,00443,India
412947,2023-12-29,212,amul cheese,250,315,65,1,00443,India
412947,2023-12-29,202,milk,12,27,15,1,00443,India
412947,2023-12-29,210,mountain dew,75,100,25,1,00443,India
412947,2023-12-29,209,pepsi,75,100,25,1,00443,India
504183,2023-12-29,208,sprite,75,100,25,1,00251,India
504183,2023-12-29,201,paneer,210,340,130,1,00251,India
504183,2023-12-29,205,classic yogurt,45,60,15,1,00251,India
504183,2023-12-29,207,coca cola,75,100,25,1,00251,India
504183,2023-12-29,212,amul cheese,250,315,65,1,00251,India
349433,2023-12-29,211,red bull,90,125,35,1,00346,India
349433,2023-12-29,210,mountain dew,75,100,25,1,00346,India
133439,2023-12-29,210,mountain dew,75,100,25,1,00245,India
944448,2023-12-29,205,classic yogurt,45,60,15,1,00331,India
803951,2023-12-29,205,classic yogurt,45,60,15,1,00461,India
524020,2023-12-29,208,sprite,75,100,25,1,00404,India
524020,2023-12-29,206,yakult,360,400,40,1,00404,India
297358,2023-12-29,213,bisleri,6,15,9,1,00359,India
297358,2023-12-29,208,sprite,75,100,25,1,00359,India
297358,2023-12-29,203,mango yogurt,50,60,10,1,00359,India
501271,2023-12-29,206,yakult,360,400,40,1,00085,India
987312,2023-12-29,202,milk,12,27,15,1,00266,India
378667,2023-12-29,212,amul cheese,250,315,65,1,00296,India
378667,2023-12-29,201,paneer,210,340,130,1,00296,India
378667,2023-12-29,210,mountain dew,75,100,25,1,00296,India
562656,2023-12-29,204,strawberry yogurt,50,60,10,1,00079,India
562656,2023-12-29,212,amul cheese,250,315,65,1,00079,India
562656,2023-12-29,210,mountain dew,75,100,25,1,00079,India
562656,2023-12-29,203,mango yogurt,50,60,10,1,00079,India
797401,2023-12-29,206,yakult,360,400,40,1,00404,India
385062,2023-12-29,204,strawberry yogurt,50,60,10,1,00197,India
385062,2023-12-29,201,paneer,210,340,130,1,00197,India
246118,2023-12-29,212,amul cheese,250,315,65,1,00037,India
246118,2023-12-29,208,sprite,75,100,25,1,00037,India
354377,2023-12-29,213,bisleri,6,15,9,1,00282,India
354377,2023-12-29,202,milk,12,27,15,1,00282,India
214810,2023-12-29,206,yakult,360,400,40,1,00420,India
129132,2023-12-29,206,yakult,360,400,40,1,00271,India
129132,2023-12-29,212,amul cheese,250,315,65,1,00271,India
561230,2023-12-29,202,milk,12,27,15,1,00331,India
498362,2023-12-29,205,classic yogurt,45,60,15,1,00252,India
498362,2023-12-29,203,mango yogurt,50,60,10,1,00252,India
498362,2023-12-29,209,pepsi,75,100,25,1,00252,India
498362,2023-12-29,201,paneer,210,340,130,1,00252,India
498362,2023-12-29,211,red bull,90,125,35,1,00252,India
820103,2023-12-29,210,mountain dew,75,100,25,1,00407,India
744609,2023-12-29,207,coca cola,75,100,25,1,00474,India
744609,2023-12-29,211,red bull,90,125,35,1,00474,India
744609,2023-12-29,201,paneer,210,340,130,1,00474,India
204834,2023-12-29,213,bisleri,6,15,9,1,00212,India
753428,2023-12-29,204,strawberry yogurt,50,60,10,1,00316,India
905276,2023-12-29,204,strawberry yogurt,50,60,10,1,00412,India
905276,2023-12-29,212,amul cheese,250,315,65,1,00412,India
905276,2023-12-29,208,sprite,75,100,25,1,00412,India
905276,2023-12-29,213,bisleri,6,15,9,1,00412,India
905276,2023-12-29,206,yakult,360,400,40,1,00412,India
592815,2023-12-29,209,pepsi,75,100,25,1,00202,India
345383,2023-12-29,201,paneer,210,340,130,1,00183,India
345383,2023-12-29,203,mango yogurt,50,60,10,1,00183,India
345383,2023-12-29,211,red bull,90,125,35,1,00183,India
345383,2023-12-29,212,amul cheese,250,315,65,1,00183,India
857360,2023-12-29,201,paneer,210,340,130,1,00475,India
857360,2023-12-29,208,sprite,75,100,25,1,00475,India
857360,2023-12-29,203,mango yogurt,50,60,10,1,00475,India
857360,2023-12-29,207,coca cola,75,100,25,1,00475,India
857360,2023-12-29,202,milk,12,27,15,1,00475,India
694025,2023-12-29,208,sprite,75,100,25,1,00217,India
694025,2023-12-29,205,classic yogurt,45,60,15,1,00217,India
694025,2023-12-29,213,bisleri,6,15,9,1,00217,India
643644,2023-12-29,207,coca cola,75,100,25,1,00478,India
643644,2023-12-29,210,mountain dew,75,100,25,1,00478,India
643644,2023-12-29,205,classic yogurt,45,60,15,1,00478,India
784194,2023-12-29,204,strawberry yogurt,50,60,10,1,00325,India
202564,2023-12-29,205,classic yogurt,45,60,15,1,00208,India
202564,2023-12-29,211,red bull,90,125,35,1,00208,India
202564,2023-12-29,204,strawberry yogurt,50,60,10,1,00208,India
202564,2023-12-29,207,coca cola,75,100,25,1,00208,India
107369,2023-12-30,205,classic yogurt,45,60,15,1,00378,India
107369,2023-12-30,202,milk,12,27,15,1,00378,India
107369,2023-12-30,201,paneer,210,340,130,1,00378,India
625554,2023-12-30,212,amul cheese,250,315,65,1,00270,India
625554,2023-12-30,207,coca cola,75,100,25,1,00270,India
625554,2023-12-30,208,sprite,75,100,25,1,00270,India
625554,2023-12-30,213,bisleri,6,15,9,1,00270,India
625554,2023-12-30,210,mountain dew,75,100,25,1,00270,India
900897,2023-12-30,204,strawberry yogurt,50,60,10,1,00158,India
900897,2023-12-30,211,red bull,90,125,35,1,00158,India
900897,2023-12-30,210,mountain dew,75,100,25,1,00158,India
549347,2023-12-30,206,yakult,360,400,40,1,00094,India
549347,2023-12-30,204,strawberry yogurt,50,60,10,1,00094,India
549347,2023-12-30,201,paneer,210,340,130,1,00094,India
549347,2023-12-30,203,mango yogurt,50,60,10,1,00094,India
549347,2023-12-30,212,amul cheese,250,315,65,1,00094,India
461463,2023-12-30,212,amul cheese,250,315,65,1,00108,India
541171,2023-12-30,203,mango yogurt,50,60,10,1,00440,India
541171,2023-12-30,207,coca cola,75,100,25,1,00440,India
541171,2023-12-30,211,red bull,90,125,35,1,00440,India
134887,2023-12-30,211,red bull,90,125,35,1,00112,India
134887,2023-12-30,206,yakult,360,400,40,1,00112,India
134887,2023-12-30,212,amul cheese,250,315,65,1,00112,India
274738,2023-12-30,204,strawberry yogurt,50,60,10,1,00339,India
371142,2023-12-30,206,yakult,360,400,40,1,00380,India
371142,2023-12-30,209,pepsi,75,100,25,1,00380,India
371142,2023-12-30,203,mango yogurt,50,60,10,1,00380,India
371142,2023-12-30,204,strawberry yogurt,50,60,10,1,00380,India
825809,2023-12-30,209,pepsi,75,100,25,1,00443,India
825809,2023-12-30,206,yakult,360,400,40,1,00443,India
825809,2023-12-30,203,mango yogurt,50,60,10,1,00443,India
292436,2023-12-30,209,pepsi,75,100,25,1,00472,India
292436,2023-12-30,207,coca cola,75,100,25,1,00472,India
292436,2023-12-30,213,bisleri,6,15,9,1,00472,India
292436,2023-12-30,208,sprite,75,100,25,1,00472,India
558330,2023-12-30,210,mountain dew,75,100,25,1,00474,India
558330,2023-12-30,206,yakult,360,400,40,1,00474,India
558330,2023-12-30,208,sprite,75,100,25,1,00474,India
558330,2023-12-30,209,pepsi,75,100,25,1,00474,India
558330,2023-12-30,211,red bull,90,125,35,1,00474,India
907413,2023-12-30,209,pepsi,75,100,25,1,00086,India
907413,2023-12-30,203,mango yogurt,50,60,10,1,00086,India
907413,2023-12-30,210,mountain dew,75,100,25,1,00086,India
836287,2023-12-30,203,mango yogurt,50,60,10,1,00296,India
836287,2023-12-30,210,mountain dew,75,100,25,1,00296,India
836287,2023-12-30,204,strawberry yogurt,50,60,10,1,00296,India
836287,2023-12-30,202,milk,12,27,15,1,00296,India
103147,2023-12-30,211,red bull,90,125,35,1,00255,India
103147,2023-12-30,208,sprite,75,100,25,1,00255,India
725610,2023-12-30,205,classic yogurt,45,60,15,1,00015,India
725610,2023-12-30,201,paneer,210,340,130,1,00015,India
725610,2023-12-30,203,mango yogurt,50,60,10,1,00015,India
849263,2023-12-30,202,milk,12,27,15,1,00177,India
849263,2023-12-30,208,sprite,75,100,25,1,00177,India
849263,2023-12-30,211,red bull,90,125,35,1,00177,India
849263,2023-12-30,213,bisleri,6,15,9,1,00177,India
849263,2023-12-30,212,amul cheese,250,315,65,1,00177,India
643064,2023-12-30,204,strawberry yogurt,50,60,10,1,00318,India
643064,2023-12-30,203,mango yogurt,50,60,10,1,00318,India
643064,2023-12-30,213,bisleri,6,15,9,1,00318,India
697006,2023-12-30,212,amul cheese,250,315,65,1,00012,India
697006,2023-12-30,208,sprite,75,100,25,1,00012,India
697006,2023-12-30,209,pepsi,75,100,25,1,00012,India
192294,2023-12-30,201,paneer,210,340,130,1,00419,India
192294,2023-12-30,206,yakult,360,400,40,1,00419,India
192294,2023-12-30,211,red bull,90,125,35,1,00419,India
596741,2023-12-30,205,classic yogurt,45,60,15,1,00424,India
596741,2023-12-30,212,amul cheese,250,315,65,1,00424,India
268550,2023-12-30,209,pepsi,75,100,25,1,00199,India
268550,2023-12-30,212,amul cheese,250,315,65,1,00199,India
268550,2023-12-30,203,mango yogurt,50,60,10,1,00199,India
127556,2023-12-30,209,pepsi,75,100,25,1,00186,India
127556,2023-12-30,212,amul cheese,250,315,65,1,00186,India
127556,2023-12-30,205,classic yogurt,45,60,15,1,00186,India
639021,2023-12-30,205,classic yogurt,45,60,15,1,00262,India
639021,2023-12-30,204,strawberry yogurt,50,60,10,1,00262,India
639021,2023-12-30,210,mountain dew,75,100,25,1,00262,India
639021,2023-12-30,213,bisleri,6,15,9,1,00262,India
978543,2023-12-30,210,mountain dew,75,100,25,1,00395,India
978543,2023-12-30,208,sprite,75,100,25,1,00395,India
978543,2023-12-30,206,yakult,360,400,40,1,00395,India
887636,2023-12-30,207,coca cola,75,100,25,1,00157,India
887636,2023-12-30,204,strawberry yogurt,50,60,10,1,00157,India
887636,2023-12-30,202,milk,12,27,15,1,00157,India
486820,2023-12-30,208,sprite,75,100,25,1,00392,India
462399,2023-12-30,203,mango yogurt,50,60,10,1,00449,India
462399,2023-12-30,205,classic yogurt,45,60,15,1,00449,India
615426,2023-12-30,212,amul cheese,250,315,65,1,00278,India
615426,2023-12-30,213,bisleri,6,15,9,1,00278,India
615426,2023-12-30,210,mountain dew,75,100,25,1,00278,India
615426,2023-12-30,201,paneer,210,340,130,1,00278,India
400390,2023-12-30,208,sprite,75,100,25,1,00120,India
400390,2023-12-30,203,mango yogurt,50,60,10,1,00120,India
400390,2023-12-30,205,classic yogurt,45,60,15,1,00120,India
706681,2023-12-30,208,sprite,75,100,25,1,00342,India
706681,2023-12-30,202,milk,12,27,15,1,00342,India
706681,2023-12-30,203,mango yogurt,50,60,10,1,00342,India
706681,2023-12-30,205,classic yogurt,45,60,15,1,00342,India
517260,2023-12-30,201,paneer,210,340,130,1,00190,India
517260,2023-12-30,213,bisleri,6,15,9,1,00190,India
517260,2023-12-30,209,pepsi,75,100,25,1,00190,India
308919,2023-12-30,208,sprite,75,100,25,1,00462,India
308919,2023-12-30,205,classic yogurt,45,60,15,1,00462,India
308919,2023-12-30,213,bisleri,6,15,9,1,00462,India
882975,2023-12-30,206,yakult,360,400,40,1,00118,India
882975,2023-12-30,212,amul cheese,250,315,65,1,00118,India
882975,2023-12-30,204,strawberry yogurt,50,60,10,1,00118,India
882975,2023-12-30,203,mango yogurt,50,60,10,1,00118,India
281147,2023-12-30,206,yakult,360,400,40,1,00392,India
281147,2023-12-30,201,paneer,210,340,130,1,00392,India
518881,2023-12-30,210,mountain dew,75,100,25,1,00184,India
518881,2023-12-30,201,paneer,210,340,130,1,00184,India
556374,2023-12-30,207,coca cola,75,100,25,1,00340,India
556374,2023-12-30,203,mango yogurt,50,60,10,1,00340,India
556374,2023-12-30,211,red bull,90,125,35,1,00340,India
556374,2023-12-30,201,paneer,210,340,130,1,00340,India
556374,2023-12-30,204,strawberry yogurt,50,60,10,1,00340,India
173774,2023-12-30,206,yakult,360,400,40,1,00449,India
173774,2023-12-30,204,strawberry yogurt,50,60,10,1,00449,India
173774,2023-12-30,210,mountain dew,75,100,25,1,00449,India
994344,2023-12-30,207,coca cola,75,100,25,1,00275,India
851203,2023-12-30,207,coca cola,75,100,25,1,00252,India
851203,2023-12-30,202,milk,12,27,15,1,00252,India
851203,2023-12-30,204,strawberry yogurt,50,60,10,1,00252,India
851203,2023-12-30,213,bisleri,6,15,9,1,00252,India
243628,2023-12-30,211,red bull,90,125,35,1,00367,India
243628,2023-12-30,207,coca cola,75,100,25,1,00367,India
694050,2023-12-30,205,classic yogurt,45,60,15,1,00092,India
694050,2023-12-30,201,paneer,210,340,130,1,00092,India
805202,2023-12-30,201,paneer,210,340,130,1,00058,India
805202,2023-12-30,202,milk,12,27,15,1,00058,India
805202,2023-12-30,206,yakult,360,400,40,1,00058,India
805202,2023-12-30,213,bisleri,6,15,9,1,00058,India
520744,2023-12-30,210,mountain dew,75,100,25,1,00318,India
520744,2023-12-30,208,sprite,75,100,25,1,00318,India
520744,2023-12-30,209,pepsi,75,100,25,1,00318,India
805301,2023-12-30,211,red bull,90,125,35,1,00431,India
955603,2023-12-30,202,milk,12,27,15,1,00304,India
955603,2023-12-30,204,strawberry yogurt,50,60,10,1,00304,India
955603,2023-12-30,213,bisleri,6,15,9,1,00304,India
652368,2023-12-30,205,classic yogurt,45,60,15,1,00460,India
461711,2023-12-30,205,classic yogurt,45,60,15,1,00487,India
461711,2023-12-30,211,red bull,90,125,35,1,00487,India
783031,2023-12-30,210,mountain dew,75,100,25,1,00199,India
783031,2023-12-30,207,coca cola,75,100,25,1,00199,India
783031,2023-12-30,202,milk,12,27,15,1,00199,India
524641,2023-12-30,201,paneer,210,340,130,1,00460,India
524641,2023-12-30,207,coca cola,75,100,25,1,00460,India
115570,2023-12-30,203,mango yogurt,50,60,10,1,00112,India
780392,2023-12-30,212,amul cheese,250,315,65,1,00492,India
780392,2023-12-30,206,yakult,360,400,40,1,00492,India
780392,2023-12-30,202,milk,12,27,15,1,00492,India
404965,2023-12-30,202,milk,12,27,15,1,00234,India
436670,2023-12-30,210,mountain dew,75,100,25,1,00391,India
436670,2023-12-30,206,yakult,360,400,40,1,00391,India
518508,2023-12-30,211,red bull,90,125,35,1,00317,India
518508,2023-12-30,201,paneer,210,340,130,1,00317,India
616424,2023-12-30,208,sprite,75,100,25,1,00050,India
872787,2023-12-30,208,sprite,75,100,25,1,00489,India
872787,2023-12-30,201,paneer,210,340,130,1,00489,India
397407,2023-12-30,208,sprite,75,100,25,1,00273,India
481417,2023-12-30,201,paneer,210,340,130,1,00143,India
481417,2023-12-30,204,strawberry yogurt,50,60,10,1,00143,India
481417,2023-12-30,205,classic yogurt,45,60,15,1,00143,India
481417,2023-12-30,208,sprite,75,100,25,1,00143,India
481417,2023-12-30,209,pepsi,75,100,25,1,00143,India
198151,2023-12-30,210,mountain dew,75,100,25,1,00325,India
198151,2023-12-30,205,classic yogurt,45,60,15,1,00325,India
198151,2023-12-30,207,coca cola,75,100,25,1,00325,India
198151,2023-12-30,209,pepsi,75,100,25,1,00325,India
359541,2023-12-30,203,mango yogurt,50,60,10,1,00401,India
359541,2023-12-30,209,pepsi,75,100,25,1,00401,India
359541,2023-12-30,210,mountain dew,75,100,25,1,00401,India
359541,2023-12-30,202,milk,12,27,15,1,00401,India
903120,2023-12-30,210,mountain dew,75,100,25,1,00485,India
903120,2023-12-30,208,sprite,75,100,25,1,00485,India
903120,2023-12-30,203,mango yogurt,50,60,10,1,00485,India
903120,2023-12-30,211,red bull,90,125,35,1,00485,India
871382,2023-12-30,206,yakult,360,400,40,1,00478,India
871382,2023-12-30,205,classic yogurt,45,60,15,1,00478,India
674283,2023-12-30,201,paneer,210,340,130,1,00013,India
704566,2023-12-30,210,mountain dew,75,100,25,1,00404,India
704566,2023-12-30,209,pepsi,75,100,25,1,00404,India
898882,2023-12-30,209,pepsi,75,100,25,1,00250,India
898882,2023-12-30,213,bisleri,6,15,9,1,00250,India
898882,2023-12-30,207,coca cola,75,100,25,1,00250,India
437832,2023-12-30,205,classic yogurt,45,60,15,1,00255,India
437832,2023-12-30,206,yakult,360,400,40,1,00255,India
502989,2023-12-30,213,bisleri,6,15,9,1,00274,India
502989,2023-12-30,212,amul cheese,250,315,65,1,00274,India
502989,2023-12-30,203,mango yogurt,50,60,10,1,00274,India
502989,2023-12-30,204,strawberry yogurt,50,60,10,1,00274,India
616296,2023-12-30,212,amul cheese,250,315,65,1,00005,India
264248,2023-12-30,207,coca cola,75,100,25,1,00456,India
264248,2023-12-30,208,sprite,75,100,25,1,00456,India
287871,2023-12-30,210,mountain dew,75,100,25,1,00470,India
287871,2023-12-30,208,sprite,75,100,25,1,00470,India
516285,2023-12-30,206,yakult,360,400,40,1,00396,India
516285,2023-12-30,209,pepsi,75,100,25,1,00396,India
743737,2023-12-30,212,amul cheese,250,315,65,1,00114,India
743737,2023-12-30,209,pepsi,75,100,25,1,00114,India
596761,2023-12-30,211,red bull,90,125,35,1,00231,India
596761,2023-12-30,205,classic yogurt,45,60,15,1,00231,India
591357,2023-12-30,213,bisleri,6,15,9,1,00450,India
591357,2023-12-30,202,milk,12,27,15,1,00450,India
591357,2023-12-30,201,paneer,210,340,130,1,00450,India
178233,2023-12-30,211,red bull,90,125,35,1,00301,India
178233,2023-12-30,204,strawberry yogurt,50,60,10,1,00301,India
586519,2023-12-30,201,paneer,210,340,130,1,00347,India
586519,2023-12-30,209,pepsi,75,100,25,1,00347,India
996265,2023-12-30,211,red bull,90,125,35,1,00149,India
313114,2023-12-30,213,bisleri,6,15,9,1,00118,India
313114,2023-12-30,207,coca cola,75,100,25,1,00118,India
313114,2023-12-30,205,classic yogurt,45,60,15,1,00118,India
313114,2023-12-30,201,paneer,210,340,130,1,00118,India
313114,2023-12-30,202,milk,12,27,15,1,00118,India
910703,2023-12-31,208,sprite,75,100,25,1,00496,India
910703,2023-12-31,202,milk,12,27,15,1,00496,India
910703,2023-12-31,203,mango yogurt,50,60,10,1,00496,India
305044,2023-12-31,208,sprite,75,100,25,1,00304,India
305044,2023-12-31,207,coca cola,75,100,25,1,00304,India
305044,2023-12-31,201,paneer,210,340,130,1,00304,India
281711,2023-12-31,207,coca cola,75,100,25,1,00337,India
281711,2023-12-31,213,bisleri,6,15,9,1,00337,India
281711,2023-12-31,204,strawberry yogurt,50,60,10,1,00337,India
311484,2023-12-31,204,strawberry yogurt,50,60,10,1,00392,India
311484,2023-12-31,209,pepsi,75,100,25,1,00392,India
311484,2023-12-31,202,milk,12,27,15,1,00392,India
583095,2023-12-31,212,amul cheese,250,315,65,1,00021,India
583095,2023-12-31,206,yakult,360,400,40,1,00021,India
583095,2023-12-31,209,pepsi,75,100,25,1,00021,India
583095,2023-12-31,204,strawberry yogurt,50,60,10,1,00021,India
340391,2023-12-31,211,red bull,90,125,35,1,00182,India
340391,2023-12-31,213,bisleri,6,15,9,1,00182,India
340391,2023-12-31,210,mountain dew,75,100,25,1,00182,India
340391,2023-12-31,201,paneer,210,340,130,1,00182,India
717702,2023-12-31,209,pepsi,75,100,25,1,00222,India
717702,2023-12-31,206,yakult,360,400,40,1,00222,India
605467,2023-12-31,205,classic yogurt,45,60,15,1,00104,India
605467,2023-12-31,211,red bull,90,125,35,1,00104,India
496893,2023-12-31,201,paneer,210,340,130,1,00150,India
496893,2023-12-31,204,strawberry yogurt,50,60,10,1,00150,India
496893,2023-12-31,213,bisleri,6,15,9,1,00150,India
110254,2023-12-31,206,yakult,360,400,40,1,00095,India
110254,2023-12-31,204,strawberry yogurt,50,60,10,1,00095,India
110254,2023-12-31,201,paneer,210,340,130,1,00095,India
110254,2023-12-31,202,milk,12,27,15,1,00095,India
110254,2023-12-31,211,red bull,90,125,35,1,00095,India
951550,2023-12-31,213,bisleri,6,15,9,1,00197,India
951550,2023-12-31,209,pepsi,75,100,25,1,00197,India
951550,2023-12-31,208,sprite,75,100,25,1,00197,India
437953,2023-12-31,207,coca cola,75,100,25,1,00075,India
437953,2023-12-31,209,pepsi,75,100,25,1,00075,India
437953,2023-12-31,201,paneer,210,340,130,1,00075,India
353927,2023-12-31,209,pepsi,75,100,25,1,00024,India
497521,2023-12-31,206,yakult,360,400,40,1,00136,India
497521,2023-12-31,205,classic yogurt,45,60,15,1,00136,India
967481,2023-12-31,213,bisleri,6,15,9,1,00079,India
967481,2023-12-31,203,mango yogurt,50,60,10,1,00079,India
967481,2023-12-31,205,classic yogurt,45,60,15,1,00079,India
967481,2023-12-31,202,milk,12,27,15,1,00079,India
219910,2023-12-31,209,pepsi,75,100,25,1,00368,India
219910,2023-12-31,203,mango yogurt,50,60,10,1,00368,India
219910,2023-12-31,213,bisleri,6,15,9,1,00368,India
219910,2023-12-31,210,mountain dew,75,100,25,1,00368,India
130809,2023-12-31,212,amul cheese,250,315,65,1,00037,India
130809,2023-12-31,205,classic yogurt,45,60,15,1,00037,India
130809,2023-12-31,207,coca cola,75,100,25,1,00037,India
130809,2023-12-31,208,sprite,75,100,25,1,00037,India
873334,2023-12-31,204,strawberry yogurt,50,60,10,1,00265,India
873334,2023-12-31,209,pepsi,75,100,25,1,00265,India
873334,2023-12-31,202,milk,12,27,15,1,00265,India
182923,2023-12-31,208,sprite,75,100,25,1,00194,India
182923,2023-12-31,209,pepsi,75,100,25,1,00194,India
182923,2023-12-31,205,classic yogurt,45,60,15,1,00194,India
182923,2023-12-31,201,paneer,210,340,130,1,00194,India
747406,2023-12-31,210,mountain dew,75,100,25,1,00415,India
310978,2023-12-31,203,mango yogurt,50,60,10,1,00473,India
310978,2023-12-31,207,coca cola,75,100,25,1,00473,India
310978,2023-12-31,208,sprite,75,100,25,1,00473,India
310978,2023-12-31,212,amul cheese,250,315,65,1,00473,India
796509,2023-12-31,211,red bull,90,125,35,1,00372,India
796509,2023-12-31,206,yakult,360,400,40,1,00372,India
796509,2023-12-31,207,coca cola,75,100,25,1,00372,India
834117,2023-12-31,213,bisleri,6,15,9,1,00246,India
834117,2023-12-31,210,mountain dew,75,100,25,1,00246,India
300555,2023-12-31,201,paneer,210,340,130,1,00435,India
777572,2023-12-31,201,paneer,210,340,130,1,00160,India
777572,2023-12-31,207,coca cola,75,100,25,1,00160,India
777572,2023-12-31,202,milk,12,27,15,1,00160,India
491472,2023-12-31,204,strawberry yogurt,50,60,10,1,00031,India
491472,2023-12-31,208,sprite,75,100,25,1,00031,India
491472,2023-12-31,211,red bull,90,125,35,1,00031,India
753792,2023-12-31,205,classic yogurt,45,60,15,1,00133,India
753792,2023-12-31,202,milk,12,27,15,1,00133,India
833168,2023-12-31,202,milk,12,27,15,1,00095,India
833168,2023-12-31,201,paneer,210,340,130,1,00095,India
833168,2023-12-31,206,yakult,360,400,40,1,00095,India
833168,2023-12-31,212,amul cheese,250,315,65,1,00095,India
543105,2023-12-31,207,coca cola,75,100,25,1,00146,India
543105,2023-12-31,202,milk,12,27,15,1,00146,India
543105,2023-12-31,212,amul cheese,250,315,65,1,00146,India
543105,2023-12-31,201,paneer,210,340,130,1,00146,India
641088,2023-12-31,203,mango yogurt,50,60,10,1,00467,India
641088,2023-12-31,201,paneer,210,340,130,1,00467,India
641088,2023-12-31,212,amul cheese,250,315,65,1,00467,India
641088,2023-12-31,209,pepsi,75,100,25,1,00467,India
641088,2023-12-31,208,sprite,75,100,25,1,00467,India
156658,2023-12-31,213,bisleri,6,15,9,1,00301,India
156658,2023-12-31,203,mango yogurt,50,60,10,1,00301,India
156658,2023-12-31,204,strawberry yogurt,50,60,10,1,00301,India
156658,2023-12-31,210,mountain dew,75,100,25,1,00301,India
672438,2023-12-31,203,mango yogurt,50,60,10,1,00433,India
672438,2023-12-31,201,paneer,210,340,130,1,00433,India
672438,2023-12-31,207,coca cola,75,100,25,1,00433,India
679419,2023-12-31,210,mountain dew,75,100,25,1,00006,India
679419,2023-12-31,203,mango yogurt,50,60,10,1,00006,India
679419,2023-12-31,212,amul cheese,250,315,65,1,00006,India
679419,2023-12-31,213,bisleri,6,15,9,1,00006,India
679419,2023-12-31,211,red bull,90,125,35,1,00006,India
648224,2023-12-31,209,pepsi,75,100,25,1,00399,India
648224,2023-12-31,205,classic yogurt,45,60,15,1,00399,India
949417,2023-12-31,202,milk,12,27,15,1,00137,India
949417,2023-12-31,209,pepsi,75,100,25,1,00137,India
949417,2023-12-31,207,coca cola,75,100,25,1,00137,India
949417,2023-12-31,213,bisleri,6,15,9,1,00137,India
453265,2023-12-31,205,classic yogurt,45,60,15,1,00174,India
590368,2023-12-31,205,classic yogurt,45,60,15,1,00309,India
590368,2023-12-31,203,mango yogurt,50,60,10,1,00309,India
511603,2023-12-31,205,classic yogurt,45,60,15,1,00241,India
511603,2023-12-31,209,pepsi,75,100,25,1,00241,India
408109,2023-12-31,203,mango yogurt,50,60,10,1,00139,India
542947,2023-12-31,202,milk,12,27,15,1,00171,India
542947,2023-12-31,208,sprite,75,100,25,1,00171,India
542947,2023-12-31,210,mountain dew,75,100,25,1,00171,India
974397,2023-12-31,205,classic yogurt,45,60,15,1,00291,India
862250,2023-12-31,204,strawberry yogurt,50,60,10,1,00349,India
862250,2023-12-31,207,coca cola,75,100,25,1,00349,India
862250,2023-12-31,209,pepsi,75,100,25,1,00349,India
862250,2023-12-31,205,classic yogurt,45,60,15,1,00349,India
160284,2023-12-31,205,classic yogurt,45,60,15,1,00446,India
160284,2023-12-31,202,milk,12,27,15,1,00446,India
160284,2023-12-31,208,sprite,75,100,25,1,00446,India
209717,2023-12-31,201,paneer,210,340,130,1,00437,India
209717,2023-12-31,213,bisleri,6,15,9,1,00437,India
209717,2023-12-31,203,mango yogurt,50,60,10,1,00437,India
336694,2023-12-31,209,pepsi,75,100,25,1,00283,India
336694,2023-12-31,211,red bull,90,125,35,1,00283,India
336694,2023-12-31,203,mango yogurt,50,60,10,1,00283,India
336694,2023-12-31,210,mountain dew,75,100,25,1,00283,India
614716,2023-12-31,211,red bull,90,125,35,1,00250,India
312663,2023-12-31,212,amul cheese,250,315,65,1,00321,India
106873,2023-12-31,207,coca cola,75,100,25,1,00277,India
106873,2023-12-31,209,pepsi,75,100,25,1,00277,India
106873,2023-12-31,203,mango yogurt,50,60,10,1,00277,India
786216,2023-12-31,204,strawberry yogurt,50,60,10,1,00178,India
310522,2023-12-31,208,sprite,75,100,25,1,00179,India
310522,2023-12-31,201,paneer,210,340,130,1,00179,India
310522,2023-12-31,206,yakult,360,400,40,1,00179,India
310522,2023-12-31,213,bisleri,6,15,9,1,00179,India
310522,2023-12-31,203,mango yogurt,50,60,10,1,00179,India
230724,2023-12-31,202,milk,12,27,15,1,00479,India
230724,2023-12-31,213,bisleri,6,15,9,1,00479,India
230724,2023-12-31,208,sprite,75,100,25,1,00479,India
230724,2023-12-31,212,amul cheese,250,315,65,1,00479,India
230724,2023-12-31,210,mountain dew,75,100,25,1,00479,India
285270,2023-12-31,212,amul cheese,250,315,65,1,00235,India
285270,2023-12-31,205,classic yogurt,45,60,15,1,00235,India
285270,2023-12-31,211,red bull,90,125,35,1,00235,India
316043,2023-12-31,201,paneer,210,340,130,1,00225,India
316043,2023-12-31,206,yakult,360,400,40,1,00225,India
316043,2023-12-31,210,mountain dew,75,100,25,1,00225,India
316043,2023-12-31,208,sprite,75,100,25,1,00225,India
316043,2023-12-31,213,bisleri,6,15,9,1,00225,India
966651,2023-12-31,212,amul cheese,250,315,65,1,00193,India
166246,2023-12-31,207,coca cola,75,100,25,1,00082,India
166246,2023-12-31,212,amul cheese,250,315,65,1,00082,India
962725,2023-12-31,204,strawberry yogurt,50,60,10,1,00099,India
962725,2023-12-31,202,milk,12,27,15,1,00099,India
962725,2023-12-31,210,mountain dew,75,100,25,1,00099,India
962725,2023-12-31,212,amul cheese,250,315,65,1,00099,India
962725,2023-12-31,206,yakult,360,400,40,1,00099,India
570295,2023-12-31,207,coca cola,75,100,25,1,00103,India
570295,2023-12-31,211,red bull,90,125,35,1,00103,India
570295,2023-12-31,210,mountain dew,75,100,25,1,00103,India
570295,2023-12-31,204,strawberry yogurt,50,60,10,1,00103,India
573320,2023-12-31,213,bisleri,6,15,9,1,00129,India
573320,2023-12-31,202,milk,12,27,15,1,00129,India
573320,2023-12-31,210,mountain dew,75,100,25,1,00129,India
573320,2023-12-31,201,paneer,210,340,130,1,00129,India
993163,2023-12-31,212,amul cheese,250,315,65,1,00004,India
993163,2023-12-31,209,pepsi,75,100,25,1,00004,India
993163,2023-12-31,201,paneer,210,340,130,1,00004,India
993163,2023-12-31,211,red bull,90,125,35,1,00004,India
993163,2023-12-31,206,yakult,360,400,40,1,00004,India
157177,2023-12-31,213,bisleri,6,15,9,1,00199,India
625445,2023-12-31,209,pepsi,75,100,25,1,00128,India
842466,2023-12-31,206,yakult,360,400,40,1,00029,India
842466,2023-12-31,205,classic yogurt,45,60,15,1,00029,India
842466,2023-12-31,212,amul cheese,250,315,65,1,00029,India
699739,2023-12-31,203,mango yogurt,50,60,10,1,00082,India
699739,2023-12-31,210,mountain dew,75,100,25,1,00082,India
699739,2023-12-31,211,red bull,90,125,35,1,00082,India
537874,2023-12-31,213,bisleri,6,15,9,1,00042,India
537874,2023-12-31,205,classic yogurt,45,60,15,1,00042,India
537874,2023-12-31,207,coca cola,75,100,25,1,00042,India
374105,2023-12-31,207,coca cola,75,100,25,1,00028,India
374105,2023-12-31,201,paneer,210,340,130,1,00028,India
374105,2023-12-31,206,yakult,360,400,40,1,00028,India
374105,2023-12-31,203,mango yogurt,50,60,10,1,00028,India
969551,2023-12-31,201,paneer,210,340,130,1,00110,India
969551,2023-12-31,212,amul cheese,250,315,65,1,00110,India
969551,2023-12-31,206,yakult,360,400,40,1,00110,India
969551,2023-12-31,209,pepsi,75,100,25,1,00110,India
735619,2023-12-31,203,mango yogurt,50,60,10,1,00212,India
275557,2023-12-31,206,yakult,360,400,40,1,00161,India
275557,2023-12-31,211,red bull,90,125,35,1,00161,India
697358,2023-12-31,210,mountain dew,75,100,25,1,00102,India
697358,2023-12-31,202,milk,12,27,15,1,00102,India
697358,2023-12-31,213,bisleri,6,15,9,1,00102,India
697358,2023-12-31,207,coca cola,75,100,25,1,00102,India
883215,2023-12-31,206,yakult,360,400,40,1,00339,India
883215,2023-12-31,211,red bull,90,125,35,1,00339,India
883215,2023-12-31,213,bisleri,6,15,9,1,00339,India
525497,2023-12-31,206,yakult,360,400,40,1,00048,India
525497,2023-12-31,207,coca cola,75,100,25,1,00048,India
848119,2023-12-31,207,coca cola,75,100,25,1,00090,India
379540,2023-12-31,205,classic yogurt,45,60,15,1,00056,India
379540,2023-12-31,209,pepsi,75,100,25,1,00056,India
462862,2023-12-31,206,yakult,360,400,40,1,00475,India
462862,2023-12-31,208,sprite,75,100,25,1,00475,India
462862,2023-12-31,201,paneer,210,340,130,1,00475,India
618779,2023-12-31,210,mountain dew,75,100,25,1,00104,India
625095,2023-12-31,203,mango yogurt,50,60,10,1,00417,India
625095,2023-12-31,201,paneer,210,340,130,1,00417,India
625095,2023-12-31,211,red bull,90,125,35,1,00417,India
964593,2023-12-31,207,coca cola,75,100,25,1,00109,India
964593,2023-12-31,209,pepsi,75,100,25,1,00109,India
855151,2023-12-31,211,red bull,90,125,35,1,00468,India
855151,2023-12-31,202,milk,12,27,15,1,00468,India
352892,2023-12-31,209,pepsi,75,100,25,1,00351,India
352892,2023-12-31,202,milk,12,27,15,1,00351,India
699748,2023-12-31,201,paneer,210,340,130,1,00322,India
360235,2023-12-31,211,red bull,90,125,35,1,00394,India
360235,2023-12-31,213,bisleri,6,15,9,1,00394,India
360235,2023-12-31,207,coca cola,75,100,25,1,00394,India
139714,2023-12-31,210,mountain dew,75,100,25,1,00394,India
139714,2023-12-31,212,amul cheese,250,315,65,1,00394,India
139714,2023-12-31,207,coca cola,75,100,25,1,00394,India
127257,2023-12-31,202,milk,12,27,15,1,00251,India
127257,2023-12-31,213,bisleri,6,15,9,1,00251,India
880471,2023-12-31,208,sprite,75,100,25,1,00028,India
880471,2023-12-31,212,amul cheese,250,315,65,1,00028,India
517205,2023-12-31,212,amul cheese,250,315,65,1,00011,India
517205,2023-12-31,203,mango yogurt,50,60,10,1,00011,India
517205,2023-12-31,208,sprite,75,100,25,1,00011,India
517205,2023-12-31,207,coca cola,75,100,25,1,00011,India
517205,2023-12-31,213,bisleri,6,15,9,1,00011,India
218609,2023-12-31,208,sprite,75,100,25,1,00260,India
218609,2023-12-31,203,mango yogurt,50,60,10,1,00260,India
218609,2023-12-31,204,strawberry yogurt,50,60,10,1,00260,India
218609,2023-12-31,207,coca cola,75,100,25,1,00260,India
218609,2023-12-31,213,bisleri,6,15,9,1,00260,India
881842,2024-01-01,209,pepsi,75,100,25,1,00207,India
359019,2024-01-01,205,classic yogurt,45,60,15,1,00343,India
359019,2024-01-01,204,strawberry yogurt,50,60,10,1,00343,India
359019,2024-01-01,207,coca cola,75,100,25,1,00343,India
359019,2024-01-01,203,mango yogurt,50,60,10,1,00343,India
399423,2024-01-01,211,red bull,90,125,35,1,00118,India
399423,2024-01-01,201,paneer,210,340,130,1,00118,India
399423,2024-01-01,203,mango yogurt,50,60,10,1,00118,India
519399,2024-01-01,209,pepsi,75,100,25,1,00344,India
519399,2024-01-01,202,milk,12,27,15,1,00344,India
519399,2024-01-01,201,paneer,210,340,130,1,00344,India
519399,2024-01-01,207,coca cola,75,100,25,1,00344,India
310417,2024-01-01,209,pepsi,75,100,25,1,00212,India
564266,2024-01-01,209,pepsi,75,100,25,1,00332,India
160209,2024-01-01,202,milk,12,27,15,1,00138,India
160209,2024-01-01,210,mountain dew,75,100,25,1,00138,India
743882,2024-01-01,204,strawberry yogurt,50,60,10,1,00137,India
743882,2024-01-01,202,milk,12,27,15,1,00137,India
743882,2024-01-01,213,bisleri,6,15,9,1,00137,India
743882,2024-01-01,209,pepsi,75,100,25,1,00137,India
978890,2024-01-01,210,mountain dew,75,100,25,1,00247,India
978890,2024-01-01,204,strawberry yogurt,50,60,10,1,00247,India
982592,2024-01-01,209,pepsi,75,100,25,1,00395,India
982592,2024-01-01,203,mango yogurt,50,60,10,1,00395,India
982592,2024-01-01,204,strawberry yogurt,50,60,10,1,00395,India
982592,2024-01-01,210,mountain dew,75,100,25,1,00395,India
672590,2024-01-01,213,bisleri,6,15,9,1,00047,India
672590,2024-01-01,212,amul cheese,250,315,65,1,00047,India
672590,2024-01-01,204,strawberry yogurt,50,60,10,1,00047,India
741203,2024-01-01,213,bisleri,6,15,9,1,00026,India
741203,2024-01-01,201,paneer,210,340,130,1,00026,India
818933,2024-01-01,202,milk,12,27,15,1,00052,India
818933,2024-01-01,206,yakult,360,400,40,1,00052,India
428554,2024-01-01,211,red bull,90,125,35,1,00481,India
428554,2024-01-01,210,mountain dew,75,100,25,1,00481,India
414445,2024-01-01,201,paneer,210,340,130,1,00235,India
414445,2024-01-01,204,strawberry yogurt,50,60,10,1,00235,India
414445,2024-01-01,202,milk,12,27,15,1,00235,India
848474,2024-01-01,204,strawberry yogurt,50,60,10,1,00227,India
848474,2024-01-01,201,paneer,210,340,130,1,00227,India
848474,2024-01-01,212,amul cheese,250,315,65,1,00227,India
848474,2024-01-01,210,mountain dew,75,100,25,1,00227,India
848474,2024-01-01,211,red bull,90,125,35,1,00227,India
857194,2024-01-01,208,sprite,75,100,25,1,00455,India
857194,2024-01-01,201,paneer,210,340,130,1,00455,India
145946,2024-01-01,212,amul cheese,250,315,65,1,00131,India
145946,2024-01-01,207,coca cola,75,100,25,1,00131,India
145946,2024-01-01,209,pepsi,75,100,25,1,00131,India
145946,2024-01-01,201,paneer,210,340,130,1,00131,India
997459,2024-01-01,210,mountain dew,75,100,25,1,00392,India
694127,2024-01-01,203,mango yogurt,50,60,10,1,00271,India
481573,2024-01-01,211,red bull,90,125,35,1,00454,India
719516,2024-01-01,211,red bull,90,125,35,1,00006,India
719516,2024-01-01,204,strawberry yogurt,50,60,10,1,00006,India
914770,2024-01-01,201,paneer,210,340,130,1,00022,India
914770,2024-01-01,205,classic yogurt,45,60,15,1,00022,India
914770,2024-01-01,213,bisleri,6,15,9,1,00022,India
411595,2024-01-01,202,milk,12,27,15,1,00405,India
411595,2024-01-01,212,amul cheese,250,315,65,1,00405,India
411595,2024-01-01,213,bisleri,6,15,9,1,00405,India
133178,2024-01-01,205,classic yogurt,45,60,15,1,00406,India
133178,2024-01-01,204,strawberry yogurt,50,60,10,1,00406,India
133178,2024-01-01,201,paneer,210,340,130,1,00406,India
896237,2024-01-01,202,milk,12,27,15,1,00081,India
896237,2024-01-01,205,classic yogurt,45,60,15,1,00081,India
896237,2024-01-01,210,mountain dew,75,100,25,1,00081,India
656787,2024-01-01,211,red bull,90,125,35,1,00318,India
656787,2024-01-01,207,coca cola,75,100,25,1,00318,India
656787,2024-01-01,213,bisleri,6,15,9,1,00318,India
656787,2024-01-01,202,milk,12,27,15,1,00318,India
601216,2024-01-01,206,yakult,360,400,40,1,00259,India
601216,2024-01-01,201,paneer,210,340,130,1,00259,India
601216,2024-01-01,213,bisleri,6,15,9,1,00259,India
923495,2024-01-01,205,classic yogurt,45,60,15,1,00032,India
923495,2024-01-01,210,mountain dew,75,100,25,1,00032,India
923495,2024-01-01,201,paneer,210,340,130,1,00032,India
923495,2024-01-01,211,red bull,90,125,35,1,00032,India
923495,2024-01-01,212,amul cheese,250,315,65,1,00032,India
334766,2024-01-01,210,mountain dew,75,100,25,1,00173,India
334766,2024-01-01,201,paneer,210,340,130,1,00173,India
334766,2024-01-01,208,sprite,75,100,25,1,00173,India
355026,2024-01-01,207,coca cola,75,100,25,1,00412,India
355026,2024-01-01,208,sprite,75,100,25,1,00412,India
801953,2024-01-01,210,mountain dew,75,100,25,1,00133,India
352122,2024-01-01,205,classic yogurt,45,60,15,1,00430,India
352122,2024-01-01,207,coca cola,75,100,25,1,00430,India
909297,2024-01-01,206,yakult,360,400,40,1,00033,India
909297,2024-01-01,212,amul cheese,250,315,65,1,00033,India
909297,2024-01-01,203,mango yogurt,50,60,10,1,00033,India
619610,2024-01-01,213,bisleri,6,15,9,1,00221,India
619610,2024-01-01,207,coca cola,75,100,25,1,00221,India
619610,2024-01-01,212,amul cheese,250,315,65,1,00221,India
619610,2024-01-01,202,milk,12,27,15,1,00221,India
619610,2024-01-01,201,paneer,210,340,130,1,00221,India
869972,2024-01-01,204,strawberry yogurt,50,60,10,1,00059,India
869972,2024-01-01,213,bisleri,6,15,9,1,00059,India
869972,2024-01-01,209,pepsi,75,100,25,1,00059,India
869972,2024-01-01,210,mountain dew,75,100,25,1,00059,India
322255,2024-01-01,209,pepsi,75,100,25,1,00027,India
322255,2024-01-01,210,mountain dew,75,100,25,1,00027,India
322255,2024-01-01,205,classic yogurt,45,60,15,1,00027,India
322255,2024-01-01,208,sprite,75,100,25,1,00027,India
416521,2024-01-01,212,amul cheese,250,315,65,1,00478,India
963287,2024-01-01,207,coca cola,75,100,25,1,00226,India
963287,2024-01-01,201,paneer,210,340,130,1,00226,India
963287,2024-01-01,208,sprite,75,100,25,1,00226,India
963287,2024-01-01,203,mango yogurt,50,60,10,1,00226,India
963287,2024-01-01,204,strawberry yogurt,50,60,10,1,00226,India
788555,2024-01-01,203,mango yogurt,50,60,10,1,00083,India
788555,2024-01-01,206,yakult,360,400,40,1,00083,India
839901,2024-01-01,212,amul cheese,250,315,65,1,00240,India
839901,2024-01-01,213,bisleri,6,15,9,1,00240,India
301887,2024-01-01,210,mountain dew,75,100,25,1,00280,India
301887,2024-01-01,213,bisleri,6,15,9,1,00280,India
301887,2024-01-01,203,mango yogurt,50,60,10,1,00280,India
301887,2024-01-01,201,paneer,210,340,130,1,00280,India
372805,2024-01-01,213,bisleri,6,15,9,1,00083,India
372805,2024-01-01,209,pepsi,75,100,25,1,00083,India
401638,2024-01-01,205,classic yogurt,45,60,15,1,00214,India
401638,2024-01-01,211,red bull,90,125,35,1,00214,India
401638,2024-01-01,204,strawberry yogurt,50,60,10,1,00214,India
710770,2024-01-01,208,sprite,75,100,25,1,00121,India
710770,2024-01-01,210,mountain dew,75,100,25,1,00121,India
710770,2024-01-01,206,yakult,360,400,40,1,00121,India
710770,2024-01-01,212,amul cheese,250,315,65,1,00121,India
229779,2024-01-01,201,paneer,210,340,130,1,00128,India
229779,2024-01-01,205,classic yogurt,45,60,15,1,00128,India
229779,2024-01-01,210,mountain dew,75,100,25,1,00128,India
229779,2024-01-01,204,strawberry yogurt,50,60,10,1,00128,India
903961,2024-01-01,208,sprite,75,100,25,1,00299,India
903961,2024-01-01,202,milk,12,27,15,1,00299,India
903961,2024-01-01,212,amul cheese,250,315,65,1,00299,India
903961,2024-01-01,206,yakult,360,400,40,1,00299,India
181457,2024-01-01,209,pepsi,75,100,25,1,00081,India
436533,2024-01-01,203,mango yogurt,50,60,10,1,00185,India
436533,2024-01-01,210,mountain dew,75,100,25,1,00185,India
436533,2024-01-01,205,classic yogurt,45,60,15,1,00185,India
875762,2024-01-01,211,red bull,90,125,35,1,00237,India
875762,2024-01-01,212,amul cheese,250,315,65,1,00237,India
875762,2024-01-01,213,bisleri,6,15,9,1,00237,India
875762,2024-01-01,209,pepsi,75,100,25,1,00237,India
875762,2024-01-01,206,yakult,360,400,40,1,00237,India
595841,2024-01-01,213,bisleri,6,15,9,1,00350,India
986210,2024-01-01,208,sprite,75,100,25,1,00176,India
986210,2024-01-01,206,yakult,360,400,40,1,00176,India
986210,2024-01-01,207,coca cola,75,100,25,1,00176,India
986210,2024-01-01,202,milk,12,27,15,1,00176,India
986210,2024-01-01,205,classic yogurt,45,60,15,1,00176,India
604321,2024-01-01,210,mountain dew,75,100,25,1,00064,India
815216,2024-01-01,201,paneer,210,340,130,1,00026,India
815216,2024-01-01,204,strawberry yogurt,50,60,10,1,00026,India
815216,2024-01-01,202,milk,12,27,15,1,00026,India
229892,2024-01-01,201,paneer,210,340,130,1,00028,India
229892,2024-01-01,210,mountain dew,75,100,25,1,00028,India
229892,2024-01-01,208,sprite,75,100,25,1,00028,India
229892,2024-01-01,206,yakult,360,400,40,1,00028,India
229892,2024-01-01,211,red bull,90,125,35,1,00028,India
823159,2024-01-01,203,mango yogurt,50,60,10,1,00145,India
823159,2024-01-01,213,bisleri,6,15,9,1,00145,India
280454,2024-01-01,207,coca cola,75,100,25,1,00145,India
280454,2024-01-01,202,milk,12,27,15,1,00145,India
280454,2024-01-01,211,red bull,90,125,35,1,00145,India
280454,2024-01-01,212,amul cheese,250,315,65,1,00145,India
148785,2024-01-01,206,yakult,360,400,40,1,00008,India
148785,2024-01-01,212,amul cheese,250,315,65,1,00008,India
392886,2024-01-01,212,amul cheese,250,315,65,1,00179,India
647216,2024-01-01,212,amul cheese,250,315,65,1,00308,India
647216,2024-01-01,201,paneer,210,340,130,1,00308,India
647216,2024-01-01,213,bisleri,6,15,9,1,00308,India
805364,2024-01-01,209,pepsi,75,100,25,1,00015,India
805364,2024-01-01,211,red bull,90,125,35,1,00015,India
805364,2024-01-01,213,bisleri,6,15,9,1,00015,India
401769,2024-01-01,205,classic yogurt,45,60,15,1,00428,India
401769,2024-01-01,207,coca cola,75,100,25,1,00428,India
401769,2024-01-01,204,strawberry yogurt,50,60,10,1,00428,India
401769,2024-01-01,210,mountain dew,75,100,25,1,00428,India
578188,2024-01-01,213,bisleri,6,15,9,1,00269,India
578188,2024-01-01,205,classic yogurt,45,60,15,1,00269,India
578188,2024-01-01,202,milk,12,27,15,1,00269,India
578188,2024-01-01,203,mango yogurt,50,60,10,1,00269,India
826088,2024-01-01,207,coca cola,75,100,25,1,00416,India
550676,2024-01-01,211,red bull,90,125,35,1,00290,India
550676,2024-01-01,209,pepsi,75,100,25,1,00290,India
550676,2024-01-01,202,milk,12,27,15,1,00290,India
403595,2024-01-02,202,milk,12,27,15,1,00255,India
403595,2024-01-02,207,coca cola,75,100,25,1,00255,India
403595,2024-01-02,203,mango yogurt,50,60,10,1,00255,India
403595,2024-01-02,201,paneer,210,340,130,1,00255,India
403595,2024-01-02,210,mountain dew,75,100,25,1,00255,India
584266,2024-01-02,211,red bull,90,125,35,1,00085,India
483297,2024-01-02,204,strawberry yogurt,50,60,10,1,00450,India
346200,2024-01-02,203,mango yogurt,50,60,10,1,00421,India
346200,2024-01-02,204,strawberry yogurt,50,60,10,1,00421,India
603606,2024-01-02,210,mountain dew,75,100,25,1,00345,India
603606,2024-01-02,212,amul cheese,250,315,65,1,00345,India
603606,2024-01-02,211,red bull,90,125,35,1,00345,India
168660,2024-01-02,203,mango yogurt,50,60,10,1,00493,India
164193,2024-01-02,209,pepsi,75,100,25,1,00258,India
164193,2024-01-02,201,paneer,210,340,130,1,00258,India
164193,2024-01-02,206,yakult,360,400,40,1,00258,India
293964,2024-01-02,210,mountain dew,75,100,25,1,00226,India
293964,2024-01-02,208,sprite,75,100,25,1,00226,India
293964,2024-01-02,203,mango yogurt,50,60,10,1,00226,India
293964,2024-01-02,204,strawberry yogurt,50,60,10,1,00226,India
707384,2024-01-02,208,sprite,75,100,25,1,00409,India
707384,2024-01-02,206,yakult,360,400,40,1,00409,India
707384,2024-01-02,207,coca cola,75,100,25,1,00409,India
941129,2024-01-02,210,mountain dew,75,100,25,1,00409,India
941129,2024-01-02,213,bisleri,6,15,9,1,00409,India
941129,2024-01-02,202,milk,12,27,15,1,00409,India
941129,2024-01-02,203,mango yogurt,50,60,10,1,00409,India
663919,2024-01-02,210,mountain dew,75,100,25,1,00117,India
663919,2024-01-02,209,pepsi,75,100,25,1,00117,India
663919,2024-01-02,212,amul cheese,250,315,65,1,00117,India
710174,2024-01-02,212,amul cheese,250,315,65,1,00054,India
710174,2024-01-02,209,pepsi,75,100,25,1,00054,India
710174,2024-01-02,201,paneer,210,340,130,1,00054,India
240090,2024-01-02,212,amul cheese,250,315,65,1,00003,India
240090,2024-01-02,211,red bull,90,125,35,1,00003,India
240090,2024-01-02,209,pepsi,75,100,25,1,00003,India
240090,2024-01-02,204,strawberry yogurt,50,60,10,1,00003,India
699240,2024-01-02,209,pepsi,75,100,25,1,00290,India
699240,2024-01-02,201,paneer,210,340,130,1,00290,India
245615,2024-01-02,206,yakult,360,400,40,1,00098,India
245615,2024-01-02,203,mango yogurt,50,60,10,1,00098,India
245615,2024-01-02,202,milk,12,27,15,1,00098,India
245615,2024-01-02,210,mountain dew,75,100,25,1,00098,India
829703,2024-01-02,209,pepsi,75,100,25,1,00349,India
829703,2024-01-02,213,bisleri,6,15,9,1,00349,India
862824,2024-01-02,212,amul cheese,250,315,65,1,00464,India
488343,2024-01-02,204,strawberry yogurt,50,60,10,1,00477,India
199820,2024-01-02,213,bisleri,6,15,9,1,00300,India
377713,2024-01-02,209,pepsi,75,100,25,1,00369,India
320593,2024-01-02,206,yakult,360,400,40,1,00240,India
320593,2024-01-02,207,coca cola,75,100,25,1,00240,India
320593,2024-01-02,213,bisleri,6,15,9,1,00240,India
648395,2024-01-02,208,sprite,75,100,25,1,00044,India
648395,2024-01-02,211,red bull,90,125,35,1,00044,India
648395,2024-01-02,207,coca cola,75,100,25,1,00044,India
165024,2024-01-02,207,coca cola,75,100,25,1,00254,India
165024,2024-01-02,202,milk,12,27,15,1,00254,India
165024,2024-01-02,206,yakult,360,400,40,1,00254,India
165024,2024-01-02,210,mountain dew,75,100,25,1,00254,India
400956,2024-01-02,204,strawberry yogurt,50,60,10,1,00404,India
400956,2024-01-02,203,mango yogurt,50,60,10,1,00404,India
214657,2024-01-02,202,milk,12,27,15,1,00033,India
214657,2024-01-02,205,classic yogurt,45,60,15,1,00033,India
214657,2024-01-02,207,coca cola,75,100,25,1,00033,India
429369,2024-01-02,213,bisleri,6,15,9,1,00425,India
429369,2024-01-02,210,mountain dew,75,100,25,1,00425,India
141059,2024-01-02,203,mango yogurt,50,60,10,1,00434,India
141059,2024-01-02,213,bisleri,6,15,9,1,00434,India
345246,2024-01-02,206,yakult,360,400,40,1,00057,India
345246,2024-01-02,205,classic yogurt,45,60,15,1,00057,India
902673,2024-01-02,212,amul cheese,250,315,65,1,00393,India
595976,2024-01-02,205,classic yogurt,45,60,15,1,00051,India
427303,2024-01-02,204,strawberry yogurt,50,60,10,1,00310,India
427303,2024-01-02,201,paneer,210,340,130,1,00310,India
427303,2024-01-02,207,coca cola,75,100,25,1,00310,India
178392,2024-01-02,213,bisleri,6,15,9,1,00348,India
434464,2024-01-02,201,paneer,210,340,130,1,00214,India
488475,2024-01-02,205,classic yogurt,45,60,15,1,00052,India
261533,2024-01-02,206,yakult,360,400,40,1,00302,India
901904,2024-01-02,211,red bull,90,125,35,1,00190,India
901904,2024-01-02,203,mango yogurt,50,60,10,1,00190,India
901904,2024-01-02,201,paneer,210,340,130,1,00190,India
901904,2024-01-02,213,bisleri,6,15,9,1,00190,India
901904,2024-01-02,210,mountain dew,75,100,25,1,00190,India
826414,2024-01-02,209,pepsi,75,100,25,1,00432,India
826414,2024-01-02,206,yakult,360,400,40,1,00432,India
826414,2024-01-02,211,red bull,90,125,35,1,00432,India
826414,2024-01-02,213,bisleri,6,15,9,1,00432,India
879514,2024-01-02,212,amul cheese,250,315,65,1,00267,India
879514,2024-01-02,211,red bull,90,125,35,1,00267,India
879514,2024-01-02,201,paneer,210,340,130,1,00267,India
277103,2024-01-02,213,bisleri,6,15,9,1,00241,India
277103,2024-01-02,212,amul cheese,250,315,65,1,00241,India
277103,2024-01-02,206,yakult,360,400,40,1,00241,India
277103,2024-01-02,210,mountain dew,75,100,25,1,00241,India
277103,2024-01-02,209,pepsi,75,100,25,1,00241,India
243538,2024-01-02,203,mango yogurt,50,60,10,1,00221,India
243538,2024-01-02,212,amul cheese,250,315,65,1,00221,India
835000,2024-01-02,213,bisleri,6,15,9,1,00336,India
835000,2024-01-02,206,yakult,360,400,40,1,00336,India
835000,2024-01-02,210,mountain dew,75,100,25,1,00336,India
835000,2024-01-02,205,classic yogurt,45,60,15,1,00336,India
835000,2024-01-02,211,red bull,90,125,35,1,00336,India
617470,2024-01-02,206,yakult,360,400,40,1,00457,India
417121,2024-01-02,209,pepsi,75,100,25,1,00315,India
417121,2024-01-02,205,classic yogurt,45,60,15,1,00315,India
417121,2024-01-02,210,mountain dew,75,100,25,1,00315,India
459409,2024-01-02,201,paneer,210,340,130,1,00309,India
459409,2024-01-02,207,coca cola,75,100,25,1,00309,India
459409,2024-01-02,205,classic yogurt,45,60,15,1,00309,India
459409,2024-01-02,203,mango yogurt,50,60,10,1,00309,India
945972,2024-01-02,207,coca cola,75,100,25,1,00021,India
945972,2024-01-02,210,mountain dew,75,100,25,1,00021,India
945972,2024-01-02,209,pepsi,75,100,25,1,00021,India
945972,2024-01-02,201,paneer,210,340,130,1,00021,India
206751,2024-01-02,206,yakult,360,400,40,1,00458,India
943497,2024-01-02,210,mountain dew,75,100,25,1,00170,India
933145,2024-01-02,203,mango yogurt,50,60,10,1,00294,India
867281,2024-01-02,208,sprite,75,100,25,1,00474,India
867281,2024-01-02,206,yakult,360,400,40,1,00474,India
867281,2024-01-02,207,coca cola,75,100,25,1,00474,India
867281,2024-01-02,211,red bull,90,125,35,1,00474,India
524634,2024-01-02,207,coca cola,75,100,25,1,00323,India
659616,2024-01-02,209,pepsi,75,100,25,1,00381,India
659616,2024-01-02,213,bisleri,6,15,9,1,00381,India
408905,2024-01-02,211,red bull,90,125,35,1,00433,India
408905,2024-01-02,210,mountain dew,75,100,25,1,00433,India
408905,2024-01-02,207,coca cola,75,100,25,1,00433,India
408905,2024-01-02,206,yakult,360,400,40,1,00433,India
408905,2024-01-02,209,pepsi,75,100,25,1,00433,India
213072,2024-01-02,202,milk,12,27,15,1,00249,India
213072,2024-01-02,210,mountain dew,75,100,25,1,00249,India
335254,2024-01-02,210,mountain dew,75,100,25,1,00485,India
597634,2024-01-02,211,red bull,90,125,35,1,00164,India
597634,2024-01-02,202,milk,12,27,15,1,00164,India
566867,2024-01-02,210,mountain dew,75,100,25,1,00206,India
408599,2024-01-02,208,sprite,75,100,25,1,00276,India
479175,2024-01-02,204,strawberry yogurt,50,60,10,1,00268,India
479175,2024-01-02,205,classic yogurt,45,60,15,1,00268,India
479175,2024-01-02,208,sprite,75,100,25,1,00268,India
309853,2024-01-02,212,amul cheese,250,315,65,1,00136,India
309853,2024-01-02,205,classic yogurt,45,60,15,1,00136,India
522843,2024-01-02,207,coca cola,75,100,25,1,00490,India
838805,2024-01-02,212,amul cheese,250,315,65,1,00013,India
838805,2024-01-02,210,mountain dew,75,100,25,1,00013,India
838805,2024-01-02,204,strawberry yogurt,50,60,10,1,00013,India
838805,2024-01-02,207,coca cola,75,100,25,1,00013,India
700666,2024-01-02,207,coca cola,75,100,25,1,00255,India
700666,2024-01-02,205,classic yogurt,45,60,15,1,00255,India
700666,2024-01-02,206,yakult,360,400,40,1,00255,India
266045,2024-01-02,212,amul cheese,250,315,65,1,00489,India
266045,2024-01-02,202,milk,12,27,15,1,00489,India
645483,2024-01-02,201,paneer,210,340,130,1,00117,India
645483,2024-01-02,208,sprite,75,100,25,1,00117,India
712042,2024-01-02,202,milk,12,27,15,1,00228,India
712042,2024-01-02,207,coca cola,75,100,25,1,00228,India
155537,2024-01-02,210,mountain dew,75,100,25,1,00397,India
155537,2024-01-02,208,sprite,75,100,25,1,00397,India
155537,2024-01-02,202,milk,12,27,15,1,00397,India
155537,2024-01-02,213,bisleri,6,15,9,1,00397,India
230083,2024-01-02,207,coca cola,75,100,25,1,00111,India
230083,2024-01-02,213,bisleri,6,15,9,1,00111,India
230083,2024-01-02,206,yakult,360,400,40,1,00111,India
230083,2024-01-02,210,mountain dew,75,100,25,1,00111,India
190249,2024-01-02,201,paneer,210,340,130,1,00259,India
190249,2024-01-02,205,classic yogurt,45,60,15,1,00259,India
190249,2024-01-02,203,mango yogurt,50,60,10,1,00259,India
190249,2024-01-02,212,amul cheese,250,315,65,1,00259,India
841711,2024-01-02,206,yakult,360,400,40,1,00376,India
841711,2024-01-02,207,coca cola,75,100,25,1,00376,India
841711,2024-01-02,201,paneer,210,340,130,1,00376,India
358994,2024-01-02,207,coca cola,75,100,25,1,00075,India
358994,2024-01-02,203,mango yogurt,50,60,10,1,00075,India
362380,2024-01-02,209,pepsi,75,100,25,1,00243,India
362380,2024-01-02,206,yakult,360,400,40,1,00243,India
362380,2024-01-02,213,bisleri,6,15,9,1,00243,India
362380,2024-01-02,204,strawberry yogurt,50,60,10,1,00243,India
719943,2024-01-02,203,mango yogurt,50,60,10,1,00206,India
719943,2024-01-02,202,milk,12,27,15,1,00206,India
719943,2024-01-02,209,pepsi,75,100,25,1,00206,India
719943,2024-01-02,205,classic yogurt,45,60,15,1,00206,India
671816,2024-01-02,204,strawberry yogurt,50,60,10,1,00461,India
671816,2024-01-02,207,coca cola,75,100,25,1,00461,India
671816,2024-01-02,203,mango yogurt,50,60,10,1,00461,India
671816,2024-01-02,212,amul cheese,250,315,65,1,00461,India
671816,2024-01-02,211,red bull,90,125,35,1,00461,India
902630,2024-01-02,202,milk,12,27,15,1,00424,India
902630,2024-01-02,213,bisleri,6,15,9,1,00424,India
902630,2024-01-02,206,yakult,360,400,40,1,00424,India
902630,2024-01-02,205,classic yogurt,45,60,15,1,00424,India
537790,2024-01-02,210,mountain dew,75,100,25,1,00197,India
537790,2024-01-02,207,coca cola,75,100,25,1,00197,India
537790,2024-01-02,209,pepsi,75,100,25,1,00197,India
537790,2024-01-02,201,paneer,210,340,130,1,00197,India
946292,2024-01-02,212,amul cheese,250,315,65,1,00388,India
946292,2024-01-02,204,strawberry yogurt,50,60,10,1,00388,India
946292,2024-01-02,202,milk,12,27,15,1,00388,India
946292,2024-01-02,209,pepsi,75,100,25,1,00388,India
946292,2024-01-02,205,classic yogurt,45,60,15,1,00388,India
359494,2024-01-02,208,sprite,75,100,25,1,00295,India
359494,2024-01-02,212,amul cheese,250,315,65,1,00295,India
359494,2024-01-02,213,bisleri,6,15,9,1,00295,India
398815,2024-01-02,211,red bull,90,125,35,1,00161,India
398815,2024-01-02,213,bisleri,6,15,9,1,00161,India
398815,2024-01-02,206,yakult,360,400,40,1,00161,India
398815,2024-01-02,202,milk,12,27,15,1,00161,India
432609,2024-01-02,204,strawberry yogurt,50,60,10,1,00427,India
432609,2024-01-02,210,mountain dew,75,100,25,1,00427,India
432609,2024-01-02,205,classic yogurt,45,60,15,1,00427,India
812874,2024-01-02,202,milk,12,27,15,1,00284,India
812874,2024-01-02,210,mountain dew,75,100,25,1,00284,India
812874,2024-01-02,207,coca cola,75,100,25,1,00284,India
812874,2024-01-02,212,amul cheese,250,315,65,1,00284,India
998002,2024-01-02,205,classic yogurt,45,60,15,1,00093,India
998002,2024-01-02,213,bisleri,6,15,9,1,00093,India
797739,2024-01-02,211,red bull,90,125,35,1,00375,India
797739,2024-01-02,203,mango yogurt,50,60,10,1,00375,India
797739,2024-01-02,202,milk,12,27,15,1,00375,India
797739,2024-01-02,213,bisleri,6,15,9,1,00375,India
171425,2024-01-03,211,red bull,90,125,35,1,00188,India
171425,2024-01-03,205,classic yogurt,45,60,15,1,00188,India
171425,2024-01-03,202,milk,12,27,15,1,00188,India
171425,2024-01-03,201,paneer,210,340,130,1,00188,India
219929,2024-01-03,206,yakult,360,400,40,1,00183,India
219929,2024-01-03,210,mountain dew,75,100,25,1,00183,India
219929,2024-01-03,201,paneer,210,340,130,1,00183,India
219929,2024-01-03,212,amul cheese,250,315,65,1,00183,India
396287,2024-01-03,208,sprite,75,100,25,1,00090,India
107725,2024-01-03,212,amul cheese,250,315,65,1,00433,India
107725,2024-01-03,202,milk,12,27,15,1,00433,India
156020,2024-01-03,213,bisleri,6,15,9,1,00436,India
156020,2024-01-03,206,yakult,360,400,40,1,00436,India
663854,2024-01-03,211,red bull,90,125,35,1,00360,India
663854,2024-01-03,201,paneer,210,340,130,1,00360,India
663854,2024-01-03,205,classic yogurt,45,60,15,1,00360,India
286021,2024-01-03,203,mango yogurt,50,60,10,1,00494,India
286021,2024-01-03,201,paneer,210,340,130,1,00494,India
286021,2024-01-03,204,strawberry yogurt,50,60,10,1,00494,India
286021,2024-01-03,207,coca cola,75,100,25,1,00494,India
422808,2024-01-03,201,paneer,210,340,130,1,00475,India
306644,2024-01-03,212,amul cheese,250,315,65,1,00387,India
306644,2024-01-03,202,milk,12,27,15,1,00387,India
306644,2024-01-03,206,yakult,360,400,40,1,00387,India
306644,2024-01-03,210,mountain dew,75,100,25,1,00387,India
903065,2024-01-03,207,coca cola,75,100,25,1,00008,India
903065,2024-01-03,204,strawberry yogurt,50,60,10,1,00008,India
903065,2024-01-03,201,paneer,210,340,130,1,00008,India
873197,2024-01-03,201,paneer,210,340,130,1,00239,India
415573,2024-01-03,204,strawberry yogurt,50,60,10,1,00423,India
415573,2024-01-03,209,pepsi,75,100,25,1,00423,India
415573,2024-01-03,210,mountain dew,75,100,25,1,00423,India
348853,2024-01-03,207,coca cola,75,100,25,1,00226,India
558101,2024-01-03,212,amul cheese,250,315,65,1,00380,India
558101,2024-01-03,208,sprite,75,100,25,1,00380,India
558101,2024-01-03,201,paneer,210,340,130,1,00380,India
558101,2024-01-03,204,strawberry yogurt,50,60,10,1,00380,India
584206,2024-01-03,213,bisleri,6,15,9,1,00405,India
584206,2024-01-03,210,mountain dew,75,100,25,1,00405,India
584206,2024-01-03,208,sprite,75,100,25,1,00405,India
585934,2024-01-03,205,classic yogurt,45,60,15,1,00082,India
609384,2024-01-03,202,milk,12,27,15,1,00299,India
609384,2024-01-03,211,red bull,90,125,35,1,00299,India
609384,2024-01-03,208,sprite,75,100,25,1,00299,India
725295,2024-01-03,211,red bull,90,125,35,1,00246,India
658822,2024-01-03,211,red bull,90,125,35,1,00355,India
658822,2024-01-03,213,bisleri,6,15,9,1,00355,India
658822,2024-01-03,207,coca cola,75,100,25,1,00355,India
658822,2024-01-03,204,strawberry yogurt,50,60,10,1,00355,India
217351,2024-01-03,212,amul cheese,250,315,65,1,00436,India
217351,2024-01-03,202,milk,12,27,15,1,00436,India
217351,2024-01-03,206,yakult,360,400,40,1,00436,India
390220,2024-01-03,207,coca cola,75,100,25,1,00099,India
390220,2024-01-03,211,red bull,90,125,35,1,00099,India
390220,2024-01-03,204,strawberry yogurt,50,60,10,1,00099,India
390220,2024-01-03,201,paneer,210,340,130,1,00099,India
390220,2024-01-03,213,bisleri,6,15,9,1,00099,India
789478,2024-01-03,209,pepsi,75,100,25,1,00153,India
789478,2024-01-03,207,coca cola,75,100,25,1,00153,India
789478,2024-01-03,205,classic yogurt,45,60,15,1,00153,India
789478,2024-01-03,206,yakult,360,400,40,1,00153,India
972502,2024-01-03,205,classic yogurt,45,60,15,1,00216,India
158485,2024-01-03,202,milk,12,27,15,1,00454,India
158485,2024-01-03,207,coca cola,75,100,25,1,00454,India
158485,2024-01-03,208,sprite,75,100,25,1,00454,India
158485,2024-01-03,210,mountain dew,75,100,25,1,00454,India
219420,2024-01-03,209,pepsi,75,100,25,1,00058,India
219420,2024-01-03,204,strawberry yogurt,50,60,10,1,00058,India
282800,2024-01-03,201,paneer,210,340,130,1,00076,India
282800,2024-01-03,207,coca cola,75,100,25,1,00076,India
691167,2024-01-03,212,amul cheese,250,315,65,1,00158,India
691167,2024-01-03,201,paneer,210,340,130,1,00158,India
691167,2024-01-03,205,classic yogurt,45,60,15,1,00158,India
691167,2024-01-03,210,mountain dew,75,100,25,1,00158,India
528955,2024-01-03,203,mango yogurt,50,60,10,1,00317,India
528955,2024-01-03,201,paneer,210,340,130,1,00317,India
397523,2024-01-03,205,classic yogurt,45,60,15,1,00285,India
397523,2024-01-03,210,mountain dew,75,100,25,1,00285,India
397523,2024-01-03,208,sprite,75,100,25,1,00285,India
397523,2024-01-03,201,paneer,210,340,130,1,00285,India
397523,2024-01-03,204,strawberry yogurt,50,60,10,1,00285,India
390888,2024-01-03,201,paneer,210,340,130,1,00088,India
390888,2024-01-03,203,mango yogurt,50,60,10,1,00088,India
390888,2024-01-03,205,classic yogurt,45,60,15,1,00088,India
396133,2024-01-03,211,red bull,90,125,35,1,00472,India
396133,2024-01-03,208,sprite,75,100,25,1,00472,India
884894,2024-01-03,212,amul cheese,250,315,65,1,00500,India
884894,2024-01-03,208,sprite,75,100,25,1,00500,India
884894,2024-01-03,206,yakult,360,400,40,1,00500,India
884894,2024-01-03,207,coca cola,75,100,25,1,00500,India
751708,2024-01-03,211,red bull,90,125,35,1,00232,India
751708,2024-01-03,203,mango yogurt,50,60,10,1,00232,India
751708,2024-01-03,204,strawberry yogurt,50,60,10,1,00232,India
178030,2024-01-03,213,bisleri,6,15,9,1,00115,India
497547,2024-01-03,210,mountain dew,75,100,25,1,00360,India
497547,2024-01-03,211,red bull,90,125,35,1,00360,India
202268,2024-01-03,204,strawberry yogurt,50,60,10,1,00260,India
202268,2024-01-03,208,sprite,75,100,25,1,00260,India
202268,2024-01-03,210,mountain dew,75,100,25,1,00260,India
202268,2024-01-03,205,classic yogurt,45,60,15,1,00260,India
826700,2024-01-03,202,milk,12,27,15,1,00014,India
826700,2024-01-03,213,bisleri,6,15,9,1,00014,India
826700,2024-01-03,201,paneer,210,340,130,1,00014,India
184757,2024-01-03,201,paneer,210,340,130,1,00025,India
184757,2024-01-03,208,sprite,75,100,25,1,00025,India
184757,2024-01-03,202,milk,12,27,15,1,00025,India
184757,2024-01-03,207,coca cola,75,100,25,1,00025,India
907804,2024-01-03,203,mango yogurt,50,60,10,1,00285,India
907804,2024-01-03,210,mountain dew,75,100,25,1,00285,India
393700,2024-01-03,212,amul cheese,250,315,65,1,00309,India
229140,2024-01-03,202,milk,12,27,15,1,00118,India
229140,2024-01-03,209,pepsi,75,100,25,1,00118,India
229140,2024-01-03,204,strawberry yogurt,50,60,10,1,00118,India
229140,2024-01-03,205,classic yogurt,45,60,15,1,00118,India
133269,2024-01-03,201,paneer,210,340,130,1,00062,India
900878,2024-01-03,208,sprite,75,100,25,1,00147,India
657412,2024-01-03,209,pepsi,75,100,25,1,00386,India
657412,2024-01-03,202,milk,12,27,15,1,00386,India
657412,2024-01-03,211,red bull,90,125,35,1,00386,India
993189,2024-01-03,202,milk,12,27,15,1,00105,India
265884,2024-01-03,209,pepsi,75,100,25,1,00056,India
940823,2024-01-03,206,yakult,360,400,40,1,00078,India
940823,2024-01-03,203,mango yogurt,50,60,10,1,00078,India
882937,2024-01-03,208,sprite,75,100,25,1,00339,India
676078,2024-01-03,210,mountain dew,75,100,25,1,00178,India
676078,2024-01-03,201,paneer,210,340,130,1,00178,India
676078,2024-01-03,203,mango yogurt,50,60,10,1,00178,India
633257,2024-01-03,202,milk,12,27,15,1,00428,India
633257,2024-01-03,212,amul cheese,250,315,65,1,00428,India
633257,2024-01-03,201,paneer,210,340,130,1,00428,India
732131,2024-01-03,213,bisleri,6,15,9,1,00396,India
732131,2024-01-03,202,milk,12,27,15,1,00396,India
732131,2024-01-03,212,amul cheese,250,315,65,1,00396,India
837433,2024-01-03,212,amul cheese,250,315,65,1,00377,India
271812,2024-01-03,208,sprite,75,100,25,1,00237,India
271812,2024-01-03,202,milk,12,27,15,1,00237,India
271812,2024-01-03,210,mountain dew,75,100,25,1,00237,India
271812,2024-01-03,207,coca cola,75,100,25,1,00237,India
381169,2024-01-03,202,milk,12,27,15,1,00067,India
381169,2024-01-03,209,pepsi,75,100,25,1,00067,India
381169,2024-01-03,210,mountain dew,75,100,25,1,00067,India
289289,2024-01-03,213,bisleri,6,15,9,1,00066,India
289289,2024-01-03,211,red bull,90,125,35,1,00066,India
289289,2024-01-03,203,mango yogurt,50,60,10,1,00066,India
289289,2024-01-03,212,amul cheese,250,315,65,1,00066,India
154713,2024-01-03,212,amul cheese,250,315,65,1,00350,India
154713,2024-01-03,202,milk,12,27,15,1,00350,India
363202,2024-01-03,203,mango yogurt,50,60,10,1,00217,India
412681,2024-01-03,205,classic yogurt,45,60,15,1,00371,India
412681,2024-01-03,208,sprite,75,100,25,1,00371,India
412681,2024-01-03,211,red bull,90,125,35,1,00371,India
412681,2024-01-03,213,bisleri,6,15,9,1,00371,India
543661,2024-01-03,206,yakult,360,400,40,1,00213,India
543661,2024-01-03,203,mango yogurt,50,60,10,1,00213,India
543661,2024-01-03,213,bisleri,6,15,9,1,00213,India
715401,2024-01-03,206,yakult,360,400,40,1,00374,India
715401,2024-01-03,204,strawberry yogurt,50,60,10,1,00374,India
715401,2024-01-03,201,paneer,210,340,130,1,00374,India
715401,2024-01-03,210,mountain dew,75,100,25,1,00374,India
715401,2024-01-03,212,amul cheese,250,315,65,1,00374,India
652498,2024-01-03,207,coca cola,75,100,25,1,00319,India
652498,2024-01-03,211,red bull,90,125,35,1,00319,India
128270,2024-01-03,211,red bull,90,125,35,1,00263,India
128270,2024-01-03,201,paneer,210,340,130,1,00263,India
128270,2024-01-03,202,milk,12,27,15,1,00263,India
128270,2024-01-03,206,yakult,360,400,40,1,00263,India
383928,2024-01-03,209,pepsi,75,100,25,1,00157,India
383928,2024-01-03,201,paneer,210,340,130,1,00157,India
383928,2024-01-03,213,bisleri,6,15,9,1,00157,India
882082,2024-01-03,212,amul cheese,250,315,65,1,00387,India
882082,2024-01-03,201,paneer,210,340,130,1,00387,India
882082,2024-01-03,204,strawberry yogurt,50,60,10,1,00387,India
882082,2024-01-03,203,mango yogurt,50,60,10,1,00387,India
120118,2024-01-03,211,red bull,90,125,35,1,00318,India
120118,2024-01-03,212,amul cheese,250,315,65,1,00318,India
931550,2024-01-03,210,mountain dew,75,100,25,1,00372,India
931550,2024-01-03,203,mango yogurt,50,60,10,1,00372,India
931550,2024-01-03,209,pepsi,75,100,25,1,00372,India
931550,2024-01-03,212,amul cheese,250,315,65,1,00372,India
601515,2024-01-03,213,bisleri,6,15,9,1,00295,India
601515,2024-01-03,209,pepsi,75,100,25,1,00295,India
601515,2024-01-03,210,mountain dew,75,100,25,1,00295,India
601515,2024-01-03,201,paneer,210,340,130,1,00295,India
418047,2024-01-03,205,classic yogurt,45,60,15,1,00081,India
418047,2024-01-03,211,red bull,90,125,35,1,00081,India
418047,2024-01-03,204,strawberry yogurt,50,60,10,1,00081,India
418047,2024-01-03,201,paneer,210,340,130,1,00081,India
418047,2024-01-03,203,mango yogurt,50,60,10,1,00081,India
412749,2024-01-03,205,classic yogurt,45,60,15,1,00284,India
412749,2024-01-03,213,bisleri,6,15,9,1,00284,India
412749,2024-01-03,209,pepsi,75,100,25,1,00284,India
613526,2024-01-03,202,milk,12,27,15,1,00020,India
613526,2024-01-03,201,paneer,210,340,130,1,00020,India
613526,2024-01-03,207,coca cola,75,100,25,1,00020,India
613526,2024-01-03,205,classic yogurt,45,60,15,1,00020,India
613526,2024-01-03,208,sprite,75,100,25,1,00020,India
498484,2024-01-03,210,mountain dew,75,100,25,1,00369,India
498484,2024-01-03,212,amul cheese,250,315,65,1,00369,India
530304,2024-01-03,207,coca cola,75,100,25,1,00158,India
469961,2024-01-03,202,milk,12,27,15,1,00086,India
311473,2024-01-03,208,sprite,75,100,25,1,00058,India
311473,2024-01-03,212,amul cheese,250,315,65,1,00058,India
311473,2024-01-03,202,milk,12,27,15,1,00058,India
311473,2024-01-03,206,yakult,360,400,40,1,00058,India
316241,2024-01-03,201,paneer,210,340,130,1,00426,India
316241,2024-01-03,210,mountain dew,75,100,25,1,00426,India
132192,2024-01-03,208,sprite,75,100,25,1,00037,India
132192,2024-01-03,209,pepsi,75,100,25,1,00037,India
132192,2024-01-03,205,classic yogurt,45,60,15,1,00037,India
499344,2024-01-03,209,pepsi,75,100,25,1,00378,India
440418,2024-01-03,213,bisleri,6,15,9,1,00024,India
440418,2024-01-03,206,yakult,360,400,40,1,00024,India
434296,2024-01-03,206,yakult,360,400,40,1,00116,India
434296,2024-01-03,205,classic yogurt,45,60,15,1,00116,India
434296,2024-01-03,202,milk,12,27,15,1,00116,India
434296,2024-01-03,203,mango yogurt,50,60,10,1,00116,India
326445,2024-01-03,205,classic yogurt,45,60,15,1,00137,India
179244,2024-01-03,211,red bull,90,125,35,1,00054,India
179244,2024-01-03,212,amul cheese,250,315,65,1,00054,India
179244,2024-01-03,206,yakult,360,400,40,1,00054,India
623734,2024-01-03,209,pepsi,75,100,25,1,00075,India
623734,2024-01-03,201,paneer,210,340,130,1,00075,India
474927,2024-01-03,201,paneer,210,340,130,1,00134,India
474927,2024-01-03,211,red bull,90,125,35,1,00134,India
474927,2024-01-03,207,coca cola,75,100,25,1,00134,India
474927,2024-01-03,209,pepsi,75,100,25,1,00134,India
489493,2024-01-03,206,yakult,360,400,40,1,00103,India
489493,2024-01-03,208,sprite,75,100,25,1,00103,India
489493,2024-01-03,205,classic yogurt,45,60,15,1,00103,India
733853,2024-01-03,206,yakult,360,400,40,1,00338,India
733853,2024-01-03,212,amul cheese,250,315,65,1,00338,India
834977,2024-01-03,208,sprite,75,100,25,1,00380,India
834977,2024-01-03,205,classic yogurt,45,60,15,1,00380,India
834977,2024-01-03,201,paneer,210,340,130,1,00380,India
834977,2024-01-03,210,mountain dew,75,100,25,1,00380,India
834977,2024-01-03,212,amul cheese,250,315,65,1,00380,India
455510,2024-01-03,209,pepsi,75,100,25,1,00234,India
495341,2024-01-03,206,yakult,360,400,40,1,00245,India
495341,2024-01-03,201,paneer,210,340,130,1,00245,India
495341,2024-01-03,204,strawberry yogurt,50,60,10,1,00245,India
495341,2024-01-03,212,amul cheese,250,315,65,1,00245,India
695726,2024-01-03,213,bisleri,6,15,9,1,00091,India
695726,2024-01-03,210,mountain dew,75,100,25,1,00091,India
695726,2024-01-03,202,milk,12,27,15,1,00091,India
998563,2024-01-03,209,pepsi,75,100,25,1,00086,India
998563,2024-01-03,205,classic yogurt,45,60,15,1,00086,India
998563,2024-01-03,213,bisleri,6,15,9,1,00086,India
401105,2024-01-03,203,mango yogurt,50,60,10,1,00399,India
401105,2024-01-03,201,paneer,210,340,130,1,00399,India
401105,2024-01-03,206,yakult,360,400,40,1,00399,India
123181,2024-01-03,207,coca cola,75,100,25,1,00230,India
123181,2024-01-03,213,bisleri,6,15,9,1,00230,India
123181,2024-01-03,212,amul cheese,250,315,65,1,00230,India
123181,2024-01-03,208,sprite,75,100,25,1,00230,India
123181,2024-01-03,204,strawberry yogurt,50,60,10,1,00230,India
958648,2024-01-04,210,mountain dew,75,100,25,1,00014,India
958648,2024-01-04,202,milk,12,27,15,1,00014,India
958648,2024-01-04,212,amul cheese,250,315,65,1,00014,India
958648,2024-01-04,203,mango yogurt,50,60,10,1,00014,India
983170,2024-01-04,213,bisleri,6,15,9,1,00315,India
983170,2024-01-04,209,pepsi,75,100,25,1,00315,India
983170,2024-01-04,211,red bull,90,125,35,1,00315,India
371562,2024-01-04,205,classic yogurt,45,60,15,1,00272,India
371562,2024-01-04,207,coca cola,75,100,25,1,00272,India
371562,2024-01-04,211,red bull,90,125,35,1,00272,India
371562,2024-01-04,202,milk,12,27,15,1,00272,India
202305,2024-01-04,201,paneer,210,340,130,1,00225,India
202305,2024-01-04,210,mountain dew,75,100,25,1,00225,India
841497,2024-01-04,204,strawberry yogurt,50,60,10,1,00497,India
841497,2024-01-04,202,milk,12,27,15,1,00497,India
733501,2024-01-04,202,milk,12,27,15,1,00468,India
733501,2024-01-04,210,mountain dew,75,100,25,1,00468,India
733501,2024-01-04,208,sprite,75,100,25,1,00468,India
733501,2024-01-04,213,bisleri,6,15,9,1,00468,India
551285,2024-01-04,207,coca cola,75,100,25,1,00345,India
154966,2024-01-04,204,strawberry yogurt,50,60,10,1,00107,India
154966,2024-01-04,205,classic yogurt,45,60,15,1,00107,India
919089,2024-01-04,208,sprite,75,100,25,1,00372,India
919089,2024-01-04,201,paneer,210,340,130,1,00372,India
223225,2024-01-04,201,paneer,210,340,130,1,00442,India
223225,2024-01-04,210,mountain dew,75,100,25,1,00442,India
532025,2024-01-04,212,amul cheese,250,315,65,1,00018,India
532025,2024-01-04,202,milk,12,27,15,1,00018,India
532025,2024-01-04,209,pepsi,75,100,25,1,00018,India
374495,2024-01-04,206,yakult,360,400,40,1,00352,India
374495,2024-01-04,211,red bull,90,125,35,1,00352,India
374495,2024-01-04,207,coca cola,75,100,25,1,00352,India
374495,2024-01-04,208,sprite,75,100,25,1,00352,India
393763,2024-01-04,213,bisleri,6,15,9,1,00027,India
393763,2024-01-04,201,paneer,210,340,130,1,00027,India
393763,2024-01-04,205,classic yogurt,45,60,15,1,00027,India
393763,2024-01-04,209,pepsi,75,100,25,1,00027,India
387299,2024-01-04,208,sprite,75,100,25,1,00147,India
387299,2024-01-04,201,paneer,210,340,130,1,00147,India
387299,2024-01-04,209,pepsi,75,100,25,1,00147,India
387299,2024-01-04,210,mountain dew,75,100,25,1,00147,India
191496,2024-01-04,209,pepsi,75,100,25,1,00254,India
191496,2024-01-04,201,paneer,210,340,130,1,00254,India
191496,2024-01-04,202,milk,12,27,15,1,00254,India
337540,2024-01-04,209,pepsi,75,100,25,1,00396,India
783430,2024-01-04,212,amul cheese,250,315,65,1,00084,India
978400,2024-01-04,205,classic yogurt,45,60,15,1,00214,India
978400,2024-01-04,201,paneer,210,340,130,1,00214,India
978400,2024-01-04,210,mountain dew,75,100,25,1,00214,India
978400,2024-01-04,212,amul cheese,250,315,65,1,00214,India
978400,2024-01-04,202,milk,12,27,15,1,00214,India
633783,2024-01-04,204,strawberry yogurt,50,60,10,1,00215,India
633783,2024-01-04,202,milk,12,27,15,1,00215,India
763466,2024-01-04,213,bisleri,6,15,9,1,00145,India
763466,2024-01-04,205,classic yogurt,45,60,15,1,00145,India
763466,2024-01-04,212,amul cheese,250,315,65,1,00145,India
693688,2024-01-04,204,strawberry yogurt,50,60,10,1,00428,India
693688,2024-01-04,208,sprite,75,100,25,1,00428,India
719741,2024-01-04,206,yakult,360,400,40,1,00115,India
719741,2024-01-04,208,sprite,75,100,25,1,00115,India
195408,2024-01-04,212,amul cheese,250,315,65,1,00481,India
195408,2024-01-04,209,pepsi,75,100,25,1,00481,India
195408,2024-01-04,207,coca cola,75,100,25,1,00481,India
195408,2024-01-04,205,classic yogurt,45,60,15,1,00481,India
195408,2024-01-04,202,milk,12,27,15,1,00481,India
254837,2024-01-04,203,mango yogurt,50,60,10,1,00260,India
277798,2024-01-04,211,red bull,90,125,35,1,00031,India
277798,2024-01-04,207,coca cola,75,100,25,1,00031,India
277798,2024-01-04,208,sprite,75,100,25,1,00031,India
495296,2024-01-04,206,yakult,360,400,40,1,00484,India
361912,2024-01-04,204,strawberry yogurt,50,60,10,1,00110,India
361912,2024-01-04,206,yakult,360,400,40,1,00110,India
361912,2024-01-04,212,amul cheese,250,315,65,1,00110,India
361912,2024-01-04,201,paneer,210,340,130,1,00110,India
947427,2024-01-04,204,strawberry yogurt,50,60,10,1,00421,India
947427,2024-01-04,210,mountain dew,75,100,25,1,00421,India
277469,2024-01-04,210,mountain dew,75,100,25,1,00215,India
593278,2024-01-04,211,red bull,90,125,35,1,00496,India
593278,2024-01-04,209,pepsi,75,100,25,1,00496,India
593278,2024-01-04,206,yakult,360,400,40,1,00496,India
593278,2024-01-04,213,bisleri,6,15,9,1,00496,India
242347,2024-01-04,208,sprite,75,100,25,1,00258,India
242347,2024-01-04,203,mango yogurt,50,60,10,1,00258,India
132516,2024-01-04,206,yakult,360,400,40,1,00425,India
132516,2024-01-04,210,mountain dew,75,100,25,1,00425,India
132516,2024-01-04,203,mango yogurt,50,60,10,1,00425,India
132516,2024-01-04,201,paneer,210,340,130,1,00425,India
169069,2024-01-04,208,sprite,75,100,25,1,00029,India
169069,2024-01-04,209,pepsi,75,100,25,1,00029,India
169069,2024-01-04,210,mountain dew,75,100,25,1,00029,India
169069,2024-01-04,211,red bull,90,125,35,1,00029,India
299754,2024-01-04,204,strawberry yogurt,50,60,10,1,00298,India
727800,2024-01-04,208,sprite,75,100,25,1,00348,India
280402,2024-01-04,211,red bull,90,125,35,1,00167,India
256619,2024-01-04,213,bisleri,6,15,9,1,00336,India
256619,2024-01-04,204,strawberry yogurt,50,60,10,1,00336,India
256619,2024-01-04,208,sprite,75,100,25,1,00336,India
374672,2024-01-04,210,mountain dew,75,100,25,1,00190,India
374672,2024-01-04,208,sprite,75,100,25,1,00190,India
233351,2024-01-04,201,paneer,210,340,130,1,00019,India
233351,2024-01-04,202,milk,12,27,15,1,00019,India
233351,2024-01-04,212,amul cheese,250,315,65,1,00019,India
233351,2024-01-04,205,classic yogurt,45,60,15,1,00019,India
567079,2024-01-04,206,yakult,360,400,40,1,00499,India
400415,2024-01-04,210,mountain dew,75,100,25,1,00438,India
555437,2024-01-04,201,paneer,210,340,130,1,00412,India
451624,2024-01-04,211,red bull,90,125,35,1,00270,India
208666,2024-01-04,212,amul cheese,250,315,65,1,00128,India
208666,2024-01-04,207,coca cola,75,100,25,1,00128,India
208666,2024-01-04,202,milk,12,27,15,1,00128,India
208666,2024-01-04,201,paneer,210,340,130,1,00128,India
244445,2024-01-04,207,coca cola,75,100,25,1,00470,India
824270,2024-01-04,202,milk,12,27,15,1,00154,India
824270,2024-01-04,203,mango yogurt,50,60,10,1,00154,India
824270,2024-01-04,204,strawberry yogurt,50,60,10,1,00154,India
903421,2024-01-04,213,bisleri,6,15,9,1,00102,India
903421,2024-01-04,201,paneer,210,340,130,1,00102,India
903421,2024-01-04,212,amul cheese,250,315,65,1,00102,India
903421,2024-01-04,206,yakult,360,400,40,1,00102,India
903421,2024-01-04,209,pepsi,75,100,25,1,00102,India
317630,2024-01-04,205,classic yogurt,45,60,15,1,00459,India
317630,2024-01-04,209,pepsi,75,100,25,1,00459,India
595389,2024-01-04,210,mountain dew,75,100,25,1,00211,India
455640,2024-01-04,204,strawberry yogurt,50,60,10,1,00095,India
455640,2024-01-04,206,yakult,360,400,40,1,00095,India
704228,2024-01-04,201,paneer,210,340,130,1,00236,India
704228,2024-01-04,208,sprite,75,100,25,1,00236,India
914040,2024-01-04,201,paneer,210,340,130,1,00491,India
914040,2024-01-04,205,classic yogurt,45,60,15,1,00491,India
914040,2024-01-04,213,bisleri,6,15,9,1,00491,India
822229,2024-01-04,207,coca cola,75,100,25,1,00103,India
551798,2024-01-04,208,sprite,75,100,25,1,00389,India
512673,2024-01-04,204,strawberry yogurt,50,60,10,1,00250,India
512673,2024-01-04,212,amul cheese,250,315,65,1,00250,India
512673,2024-01-04,209,pepsi,75,100,25,1,00250,India
512673,2024-01-04,206,yakult,360,400,40,1,00250,India
512673,2024-01-04,211,red bull,90,125,35,1,00250,India
857241,2024-01-04,205,classic yogurt,45,60,15,1,00100,India
165129,2024-01-04,205,classic yogurt,45,60,15,1,00189,India
165129,2024-01-04,211,red bull,90,125,35,1,00189,India
165129,2024-01-04,212,amul cheese,250,315,65,1,00189,India
165129,2024-01-04,213,bisleri,6,15,9,1,00189,India
774846,2024-01-04,212,amul cheese,250,315,65,1,00219,India
774846,2024-01-04,213,bisleri,6,15,9,1,00219,India
774846,2024-01-04,204,strawberry yogurt,50,60,10,1,00219,India
774846,2024-01-04,206,yakult,360,400,40,1,00219,India
774846,2024-01-04,203,mango yogurt,50,60,10,1,00219,India
315458,2024-01-04,212,amul cheese,250,315,65,1,00132,India
315458,2024-01-04,205,classic yogurt,45,60,15,1,00132,India
315458,2024-01-04,208,sprite,75,100,25,1,00132,India
315458,2024-01-04,211,red bull,90,125,35,1,00132,India
365082,2024-01-04,205,classic yogurt,45,60,15,1,00037,India
365082,2024-01-04,206,yakult,360,400,40,1,00037,India
365082,2024-01-04,208,sprite,75,100,25,1,00037,India
770936,2024-01-04,213,bisleri,6,15,9,1,00236,India
770936,2024-01-04,208,sprite,75,100,25,1,00236,India
770936,2024-01-04,207,coca cola,75,100,25,1,00236,India
367073,2024-01-04,207,coca cola,75,100,25,1,00487,India
289739,2024-01-04,207,coca cola,75,100,25,1,00153,India
289739,2024-01-04,209,pepsi,75,100,25,1,00153,India
289739,2024-01-04,212,amul cheese,250,315,65,1,00153,India
692383,2024-01-04,211,red bull,90,125,35,1,00150,India
692383,2024-01-04,209,pepsi,75,100,25,1,00150,India
692383,2024-01-04,202,milk,12,27,15,1,00150,India
692383,2024-01-04,203,mango yogurt,50,60,10,1,00150,India
129703,2024-01-04,211,red bull,90,125,35,1,00208,India
129703,2024-01-04,206,yakult,360,400,40,1,00208,India
129703,2024-01-04,208,sprite,75,100,25,1,00208,India
371031,2024-01-04,206,yakult,360,400,40,1,00476,India
371031,2024-01-04,202,milk,12,27,15,1,00476,India
371031,2024-01-04,203,mango yogurt,50,60,10,1,00476,India
751648,2024-01-04,206,yakult,360,400,40,1,00442,India
751648,2024-01-04,207,coca cola,75,100,25,1,00442,India
751648,2024-01-04,212,amul cheese,250,315,65,1,00442,India
199723,2024-01-04,209,pepsi,75,100,25,1,00302,India
199723,2024-01-04,213,bisleri,6,15,9,1,00302,India
452954,2024-01-04,203,mango yogurt,50,60,10,1,00295,India
630378,2024-01-04,205,classic yogurt,45,60,15,1,00024,India
102646,2024-01-04,204,strawberry yogurt,50,60,10,1,00164,India
102646,2024-01-04,203,mango yogurt,50,60,10,1,00164,India
416699,2024-01-04,213,bisleri,6,15,9,1,00307,India
416699,2024-01-04,205,classic yogurt,45,60,15,1,00307,India
416699,2024-01-04,211,red bull,90,125,35,1,00307,India
416699,2024-01-04,204,strawberry yogurt,50,60,10,1,00307,India
893052,2024-01-04,204,strawberry yogurt,50,60,10,1,00420,India
893052,2024-01-04,210,mountain dew,75,100,25,1,00420,India
893052,2024-01-04,205,classic yogurt,45,60,15,1,00420,India
488994,2024-01-04,204,strawberry yogurt,50,60,10,1,00248,India
488994,2024-01-04,208,sprite,75,100,25,1,00248,India
488994,2024-01-04,202,milk,12,27,15,1,00248,India
107227,2024-01-04,211,red bull,90,125,35,1,00212,India
112317,2024-01-04,205,classic yogurt,45,60,15,1,00102,India
112317,2024-01-04,209,pepsi,75,100,25,1,00102,India
112317,2024-01-04,202,milk,12,27,15,1,00102,India
839431,2024-01-04,205,classic yogurt,45,60,15,1,00135,India
839431,2024-01-04,212,amul cheese,250,315,65,1,00135,India
579710,2024-01-04,204,strawberry yogurt,50,60,10,1,00030,India
195063,2024-01-04,203,mango yogurt,50,60,10,1,00181,India
195063,2024-01-04,206,yakult,360,400,40,1,00181,India
295919,2024-01-04,206,yakult,360,400,40,1,00221,India
922748,2024-01-04,203,mango yogurt,50,60,10,1,00138,India
922748,2024-01-04,204,strawberry yogurt,50,60,10,1,00138,India
420820,2024-01-04,204,strawberry yogurt,50,60,10,1,00325,India
420820,2024-01-04,213,bisleri,6,15,9,1,00325,India
702827,2024-01-04,213,bisleri,6,15,9,1,00267,India
702827,2024-01-04,208,sprite,75,100,25,1,00267,India
702827,2024-01-04,212,amul cheese,250,315,65,1,00267,India
702827,2024-01-04,209,pepsi,75,100,25,1,00267,India
847404,2024-01-04,209,pepsi,75,100,25,1,00035,India
847404,2024-01-04,208,sprite,75,100,25,1,00035,India
847404,2024-01-04,205,classic yogurt,45,60,15,1,00035,India
814268,2024-01-04,205,classic yogurt,45,60,15,1,00431,India
814268,2024-01-04,206,yakult,360,400,40,1,00431,India
695351,2024-01-04,209,pepsi,75,100,25,1,00285,India
695351,2024-01-04,202,milk,12,27,15,1,00285,India
695351,2024-01-04,206,yakult,360,400,40,1,00285,India
695351,2024-01-04,210,mountain dew,75,100,25,1,00285,India
688135,2024-01-05,207,coca cola,75,100,25,1,00237,India
688135,2024-01-05,205,classic yogurt,45,60,15,1,00237,India
688135,2024-01-05,213,bisleri,6,15,9,1,00237,India
657234,2024-01-05,210,mountain dew,75,100,25,1,00375,India
657234,2024-01-05,206,yakult,360,400,40,1,00375,India
696771,2024-01-05,213,bisleri,6,15,9,1,00186,India
696771,2024-01-05,212,amul cheese,250,315,65,1,00186,India
696771,2024-01-05,204,strawberry yogurt,50,60,10,1,00186,India
855169,2024-01-05,210,mountain dew,75,100,25,1,00165,India
855169,2024-01-05,201,paneer,210,340,130,1,00165,India
379165,2024-01-05,213,bisleri,6,15,9,1,00459,India
379165,2024-01-05,209,pepsi,75,100,25,1,00459,India
379165,2024-01-05,204,strawberry yogurt,50,60,10,1,00459,India
379165,2024-01-05,203,mango yogurt,50,60,10,1,00459,India
379165,2024-01-05,208,sprite,75,100,25,1,00459,India
345815,2024-01-05,207,coca cola,75,100,25,1,00091,India
345815,2024-01-05,201,paneer,210,340,130,1,00091,India
345815,2024-01-05,209,pepsi,75,100,25,1,00091,India
345815,2024-01-05,206,yakult,360,400,40,1,00091,India
446178,2024-01-05,210,mountain dew,75,100,25,1,00085,India
446178,2024-01-05,212,amul cheese,250,315,65,1,00085,India
446178,2024-01-05,202,milk,12,27,15,1,00085,India
446178,2024-01-05,213,bisleri,6,15,9,1,00085,India
446178,2024-01-05,211,red bull,90,125,35,1,00085,India
919715,2024-01-05,201,paneer,210,340,130,1,00306,India
919715,2024-01-05,206,yakult,360,400,40,1,00306,India
172919,2024-01-05,202,milk,12,27,15,1,00406,India
172919,2024-01-05,209,pepsi,75,100,25,1,00406,India
114562,2024-01-05,208,sprite,75,100,25,1,00275,India
275561,2024-01-05,213,bisleri,6,15,9,1,00200,India
275561,2024-01-05,204,strawberry yogurt,50,60,10,1,00200,India
275561,2024-01-05,202,milk,12,27,15,1,00200,India
275561,2024-01-05,209,pepsi,75,100,25,1,00200,India
477595,2024-01-05,207,coca cola,75,100,25,1,00076,India
629523,2024-01-05,208,sprite,75,100,25,1,00443,India
634524,2024-01-05,201,paneer,210,340,130,1,00167,India
634524,2024-01-05,211,red bull,90,125,35,1,00167,India
634524,2024-01-05,212,amul cheese,250,315,65,1,00167,India
684521,2024-01-05,213,bisleri,6,15,9,1,00416,India
684521,2024-01-05,212,amul cheese,250,315,65,1,00416,India
684521,2024-01-05,203,mango yogurt,50,60,10,1,00416,India
552812,2024-01-05,204,strawberry yogurt,50,60,10,1,00129,India
552812,2024-01-05,210,mountain dew,75,100,25,1,00129,India
994213,2024-01-05,208,sprite,75,100,25,1,00397,India
994213,2024-01-05,211,red bull,90,125,35,1,00397,India
994213,2024-01-05,205,classic yogurt,45,60,15,1,00397,India
994213,2024-01-05,209,pepsi,75,100,25,1,00397,India
781506,2024-01-05,205,classic yogurt,45,60,15,1,00166,India
781506,2024-01-05,202,milk,12,27,15,1,00166,India
781506,2024-01-05,211,red bull,90,125,35,1,00166,India
781506,2024-01-05,204,strawberry yogurt,50,60,10,1,00166,India
460311,2024-01-05,205,classic yogurt,45,60,15,1,00500,India
963646,2024-01-05,213,bisleri,6,15,9,1,00385,India
193260,2024-01-05,210,mountain dew,75,100,25,1,00415,India
799599,2024-01-05,213,bisleri,6,15,9,1,00462,India
799599,2024-01-05,212,amul cheese,250,315,65,1,00462,India
799599,2024-01-05,209,pepsi,75,100,25,1,00462,India
799599,2024-01-05,210,mountain dew,75,100,25,1,00462,India
387420,2024-01-05,203,mango yogurt,50,60,10,1,00321,India
387420,2024-01-05,202,milk,12,27,15,1,00321,India
387420,2024-01-05,210,mountain dew,75,100,25,1,00321,India
387420,2024-01-05,209,pepsi,75,100,25,1,00321,India
577431,2024-01-05,208,sprite,75,100,25,1,00060,India
937157,2024-01-05,212,amul cheese,250,315,65,1,00246,India
937157,2024-01-05,201,paneer,210,340,130,1,00246,India
937157,2024-01-05,206,yakult,360,400,40,1,00246,India
937157,2024-01-05,213,bisleri,6,15,9,1,00246,India
223637,2024-01-05,210,mountain dew,75,100,25,1,00163,India
223637,2024-01-05,203,mango yogurt,50,60,10,1,00163,India
223637,2024-01-05,204,strawberry yogurt,50,60,10,1,00163,India
223637,2024-01-05,211,red bull,90,125,35,1,00163,India
710922,2024-01-05,201,paneer,210,340,130,1,00013,India
710922,2024-01-05,209,pepsi,75,100,25,1,00013,India
710922,2024-01-05,205,classic yogurt,45,60,15,1,00013,India
710922,2024-01-05,211,red bull,90,125,35,1,00013,India
140385,2024-01-05,208,sprite,75,100,25,1,00433,India
140385,2024-01-05,204,strawberry yogurt,50,60,10,1,00433,India
140385,2024-01-05,213,bisleri,6,15,9,1,00433,India
140385,2024-01-05,205,classic yogurt,45,60,15,1,00433,India
439061,2024-01-05,208,sprite,75,100,25,1,00395,India
439061,2024-01-05,207,coca cola,75,100,25,1,00395,India
439061,2024-01-05,201,paneer,210,340,130,1,00395,India
439061,2024-01-05,211,red bull,90,125,35,1,00395,India
439061,2024-01-05,205,classic yogurt,45,60,15,1,00395,India
719811,2024-01-05,202,milk,12,27,15,1,00480,India
623742,2024-01-05,202,milk,12,27,15,1,00028,India
623742,2024-01-05,210,mountain dew,75,100,25,1,00028,India
623742,2024-01-05,204,strawberry yogurt,50,60,10,1,00028,India
786794,2024-01-05,213,bisleri,6,15,9,1,00485,India
786794,2024-01-05,211,red bull,90,125,35,1,00485,India
786794,2024-01-05,204,strawberry yogurt,50,60,10,1,00485,India
786794,2024-01-05,205,classic yogurt,45,60,15,1,00485,India
870820,2024-01-05,208,sprite,75,100,25,1,00436,India
870820,2024-01-05,212,amul cheese,250,315,65,1,00436,India
870820,2024-01-05,210,mountain dew,75,100,25,1,00436,India
708675,2024-01-05,207,coca cola,75,100,25,1,00410,India
708675,2024-01-05,201,paneer,210,340,130,1,00410,India
708675,2024-01-05,211,red bull,90,125,35,1,00410,India
708675,2024-01-05,212,amul cheese,250,315,65,1,00410,India
614354,2024-01-05,212,amul cheese,250,315,65,1,00072,India
614354,2024-01-05,213,bisleri,6,15,9,1,00072,India
157416,2024-01-05,201,paneer,210,340,130,1,00077,India
157416,2024-01-05,206,yakult,360,400,40,1,00077,India
157416,2024-01-05,205,classic yogurt,45,60,15,1,00077,India
157416,2024-01-05,203,mango yogurt,50,60,10,1,00077,India
157416,2024-01-05,202,milk,12,27,15,1,00077,India
998767,2024-01-05,201,paneer,210,340,130,1,00360,India
953125,2024-01-05,202,milk,12,27,15,1,00491,India
245324,2024-01-05,208,sprite,75,100,25,1,00394,India
245324,2024-01-05,203,mango yogurt,50,60,10,1,00394,India
245324,2024-01-05,206,yakult,360,400,40,1,00394,India
245324,2024-01-05,201,paneer,210,340,130,1,00394,India
245324,2024-01-05,211,red bull,90,125,35,1,00394,India
810459,2024-01-05,213,bisleri,6,15,9,1,00471,India
683924,2024-01-05,211,red bull,90,125,35,1,00434,India
683924,2024-01-05,205,classic yogurt,45,60,15,1,00434,India
683924,2024-01-05,210,mountain dew,75,100,25,1,00434,India
683924,2024-01-05,203,mango yogurt,50,60,10,1,00434,India
683924,2024-01-05,208,sprite,75,100,25,1,00434,India
467210,2024-01-05,205,classic yogurt,45,60,15,1,00367,India
467210,2024-01-05,201,paneer,210,340,130,1,00367,India
467210,2024-01-05,202,milk,12,27,15,1,00367,India
756061,2024-01-05,207,coca cola,75,100,25,1,00403,India
756061,2024-01-05,211,red bull,90,125,35,1,00403,India
448203,2024-01-05,204,strawberry yogurt,50,60,10,1,00082,India
448203,2024-01-05,202,milk,12,27,15,1,00082,India
448203,2024-01-05,212,amul cheese,250,315,65,1,00082,India
448203,2024-01-05,209,pepsi,75,100,25,1,00082,India
448203,2024-01-05,201,paneer,210,340,130,1,00082,India
886871,2024-01-05,204,strawberry yogurt,50,60,10,1,00196,India
886871,2024-01-05,207,coca cola,75,100,25,1,00196,India
886871,2024-01-05,206,yakult,360,400,40,1,00196,India
886871,2024-01-05,212,amul cheese,250,315,65,1,00196,India
730452,2024-01-05,203,mango yogurt,50,60,10,1,00348,India
730452,2024-01-05,213,bisleri,6,15,9,1,00348,India
464823,2024-01-05,209,pepsi,75,100,25,1,00449,India
464823,2024-01-05,206,yakult,360,400,40,1,00449,India
855486,2024-01-05,204,strawberry yogurt,50,60,10,1,00113,India
335178,2024-01-05,206,yakult,360,400,40,1,00388,India
363742,2024-01-05,211,red bull,90,125,35,1,00025,India
363742,2024-01-05,213,bisleri,6,15,9,1,00025,India
363742,2024-01-05,203,mango yogurt,50,60,10,1,00025,India
759716,2024-01-05,204,strawberry yogurt,50,60,10,1,00239,India
759716,2024-01-05,212,amul cheese,250,315,65,1,00239,India
759716,2024-01-05,207,coca cola,75,100,25,1,00239,India
237527,2024-01-05,212,amul cheese,250,315,65,1,00027,India
237527,2024-01-05,202,milk,12,27,15,1,00027,India
237527,2024-01-05,213,bisleri,6,15,9,1,00027,India
237527,2024-01-05,211,red bull,90,125,35,1,00027,India
843232,2024-01-05,205,classic yogurt,45,60,15,1,00425,India
843232,2024-01-05,204,strawberry yogurt,50,60,10,1,00425,India
843232,2024-01-05,207,coca cola,75,100,25,1,00425,India
257239,2024-01-05,204,strawberry yogurt,50,60,10,1,00166,India
486027,2024-01-05,201,paneer,210,340,130,1,00485,India
486027,2024-01-05,208,sprite,75,100,25,1,00485,India
486027,2024-01-05,207,coca cola,75,100,25,1,00485,India
486027,2024-01-05,211,red bull,90,125,35,1,00485,India
299466,2024-01-05,212,amul cheese,250,315,65,1,00257,India
299466,2024-01-05,202,milk,12,27,15,1,00257,India
430842,2024-01-05,203,mango yogurt,50,60,10,1,00260,India
430842,2024-01-05,211,red bull,90,125,35,1,00260,India
138106,2024-01-05,204,strawberry yogurt,50,60,10,1,00303,India
328543,2024-01-05,210,mountain dew,75,100,25,1,00206,India
328543,2024-01-05,211,red bull,90,125,35,1,00206,India
328543,2024-01-05,209,pepsi,75,100,25,1,00206,India
256444,2024-01-05,212,amul cheese,250,315,65,1,00164,India
256444,2024-01-05,213,bisleri,6,15,9,1,00164,India
287082,2024-01-05,201,paneer,210,340,130,1,00150,India
287082,2024-01-05,205,classic yogurt,45,60,15,1,00150,India
515865,2024-01-05,206,yakult,360,400,40,1,00194,India
515865,2024-01-05,209,pepsi,75,100,25,1,00194,India
515865,2024-01-05,204,strawberry yogurt,50,60,10,1,00194,India
156572,2024-01-05,213,bisleri,6,15,9,1,00154,India
156572,2024-01-05,204,strawberry yogurt,50,60,10,1,00154,India
156572,2024-01-05,208,sprite,75,100,25,1,00154,India
156572,2024-01-05,210,mountain dew,75,100,25,1,00154,India
264272,2024-01-05,206,yakult,360,400,40,1,00392,India
264272,2024-01-05,213,bisleri,6,15,9,1,00392,India
264272,2024-01-05,203,mango yogurt,50,60,10,1,00392,India
264272,2024-01-05,201,paneer,210,340,130,1,00392,India
288606,2024-01-05,210,mountain dew,75,100,25,1,00247,India
288606,2024-01-05,211,red bull,90,125,35,1,00247,India
392525,2024-01-05,203,mango yogurt,50,60,10,1,00166,India
392525,2024-01-05,212,amul cheese,250,315,65,1,00166,India
318659,2024-01-05,213,bisleri,6,15,9,1,00043,India
318659,2024-01-05,208,sprite,75,100,25,1,00043,India
318659,2024-01-05,207,coca cola,75,100,25,1,00043,India
318659,2024-01-05,212,amul cheese,250,315,65,1,00043,India
474824,2024-01-05,205,classic yogurt,45,60,15,1,00279,India
852323,2024-01-05,213,bisleri,6,15,9,1,00014,India
852323,2024-01-05,209,pepsi,75,100,25,1,00014,India
852323,2024-01-05,201,paneer,210,340,130,1,00014,India
852323,2024-01-05,208,sprite,75,100,25,1,00014,India
813572,2024-01-05,203,mango yogurt,50,60,10,1,00394,India
932330,2024-01-05,207,coca cola,75,100,25,1,00197,India
932330,2024-01-05,203,mango yogurt,50,60,10,1,00197,India
932330,2024-01-05,209,pepsi,75,100,25,1,00197,India
406616,2024-01-05,202,milk,12,27,15,1,00368,India
862951,2024-01-05,204,strawberry yogurt,50,60,10,1,00283,India
593771,2024-01-05,209,pepsi,75,100,25,1,00071,India
593771,2024-01-05,202,milk,12,27,15,1,00071,India
593771,2024-01-05,201,paneer,210,340,130,1,00071,India
593771,2024-01-05,212,amul cheese,250,315,65,1,00071,India
137647,2024-01-05,203,mango yogurt,50,60,10,1,00329,India
137647,2024-01-05,207,coca cola,75,100,25,1,00329,India
137647,2024-01-05,209,pepsi,75,100,25,1,00329,India
137647,2024-01-05,210,mountain dew,75,100,25,1,00329,India
671880,2024-01-06,201,paneer,210,340,130,1,00059,India
889682,2024-01-06,206,yakult,360,400,40,1,00469,India
889682,2024-01-06,205,classic yogurt,45,60,15,1,00469,India
889682,2024-01-06,208,sprite,75,100,25,1,00469,India
972015,2024-01-06,201,paneer,210,340,130,1,00272,India
972015,2024-01-06,208,sprite,75,100,25,1,00272,India
972015,2024-01-06,202,milk,12,27,15,1,00272,India
972015,2024-01-06,205,classic yogurt,45,60,15,1,00272,India
770730,2024-01-06,201,paneer,210,340,130,1,00142,India
770730,2024-01-06,208,sprite,75,100,25,1,00142,India
968645,2024-01-06,205,classic yogurt,45,60,15,1,00005,India
316805,2024-01-06,205,classic yogurt,45,60,15,1,00040,India
316805,2024-01-06,204,strawberry yogurt,50,60,10,1,00040,India
316805,2024-01-06,213,bisleri,6,15,9,1,00040,India
484961,2024-01-06,212,amul cheese,250,315,65,1,00495,India
484961,2024-01-06,205,classic yogurt,45,60,15,1,00495,India
514789,2024-01-06,210,mountain dew,75,100,25,1,00065,India
514789,2024-01-06,206,yakult,360,400,40,1,00065,India
514789,2024-01-06,205,classic yogurt,45,60,15,1,00065,India
514789,2024-01-06,204,strawberry yogurt,50,60,10,1,00065,India
300974,2024-01-06,205,classic yogurt,45,60,15,1,00169,India
300974,2024-01-06,208,sprite,75,100,25,1,00169,India
300974,2024-01-06,203,mango yogurt,50,60,10,1,00169,India
471977,2024-01-06,209,pepsi,75,100,25,1,00375,India
471977,2024-01-06,213,bisleri,6,15,9,1,00375,India
471977,2024-01-06,205,classic yogurt,45,60,15,1,00375,India
471977,2024-01-06,207,coca cola,75,100,25,1,00375,India
471977,2024-01-06,206,yakult,360,400,40,1,00375,India
333878,2024-01-06,202,milk,12,27,15,1,00484,India
333878,2024-01-06,207,coca cola,75,100,25,1,00484,India
333878,2024-01-06,204,strawberry yogurt,50,60,10,1,00484,India
180382,2024-01-06,202,milk,12,27,15,1,00143,India
305760,2024-01-06,207,coca cola,75,100,25,1,00028,India
103638,2024-01-06,211,red bull,90,125,35,1,00232,India
665099,2024-01-06,209,pepsi,75,100,25,1,00449,India
665099,2024-01-06,212,amul cheese,250,315,65,1,00449,India
665099,2024-01-06,203,mango yogurt,50,60,10,1,00449,India
907769,2024-01-06,201,paneer,210,340,130,1,00484,India
907769,2024-01-06,204,strawberry yogurt,50,60,10,1,00484,India
907769,2024-01-06,205,classic yogurt,45,60,15,1,00484,India
168557,2024-01-06,209,pepsi,75,100,25,1,00079,India
151006,2024-01-06,207,coca cola,75,100,25,1,00452,India
151006,2024-01-06,209,pepsi,75,100,25,1,00452,India
151006,2024-01-06,211,red bull,90,125,35,1,00452,India
151006,2024-01-06,201,paneer,210,340,130,1,00452,India
105501,2024-01-06,201,paneer,210,340,130,1,00396,India
762576,2024-01-06,211,red bull,90,125,35,1,00371,India
762576,2024-01-06,205,classic yogurt,45,60,15,1,00371,India
360893,2024-01-06,202,milk,12,27,15,1,00349,India
360893,2024-01-06,204,strawberry yogurt,50,60,10,1,00349,India
360893,2024-01-06,212,amul cheese,250,315,65,1,00349,India
360893,2024-01-06,206,yakult,360,400,40,1,00349,India
360893,2024-01-06,208,sprite,75,100,25,1,00349,India
190998,2024-01-06,202,milk,12,27,15,1,00027,India
190998,2024-01-06,209,pepsi,75,100,25,1,00027,India
632175,2024-01-06,206,yakult,360,400,40,1,00058,India
632175,2024-01-06,213,bisleri,6,15,9,1,00058,India
632175,2024-01-06,202,milk,12,27,15,1,00058,India
515614,2024-01-06,207,coca cola,75,100,25,1,00417,India
515614,2024-01-06,209,pepsi,75,100,25,1,00417,India
916689,2024-01-06,203,mango yogurt,50,60,10,1,00444,India
916689,2024-01-06,208,sprite,75,100,25,1,00444,India
916689,2024-01-06,212,amul cheese,250,315,65,1,00444,India
916689,2024-01-06,209,pepsi,75,100,25,1,00444,India
870673,2024-01-06,205,classic yogurt,45,60,15,1,00391,India
870673,2024-01-06,201,paneer,210,340,130,1,00391,India
870673,2024-01-06,207,coca cola,75,100,25,1,00391,India
870673,2024-01-06,208,sprite,75,100,25,1,00391,India
680400,2024-01-06,213,bisleri,6,15,9,1,00417,India
568568,2024-01-06,202,milk,12,27,15,1,00246,India
568568,2024-01-06,213,bisleri,6,15,9,1,00246,India
568568,2024-01-06,210,mountain dew,75,100,25,1,00246,India
568568,2024-01-06,206,yakult,360,400,40,1,00246,India
616506,2024-01-06,211,red bull,90,125,35,1,00442,India
616506,2024-01-06,212,amul cheese,250,315,65,1,00442,India
616506,2024-01-06,201,paneer,210,340,130,1,00442,India
616506,2024-01-06,208,sprite,75,100,25,1,00442,India
616506,2024-01-06,207,coca cola,75,100,25,1,00442,India
893747,2024-01-06,207,coca cola,75,100,25,1,00103,India
893747,2024-01-06,213,bisleri,6,15,9,1,00103,India
423124,2024-01-06,201,paneer,210,340,130,1,00255,India
423124,2024-01-06,205,classic yogurt,45,60,15,1,00255,India
423124,2024-01-06,206,yakult,360,400,40,1,00255,India
188428,2024-01-06,211,red bull,90,125,35,1,00097,India
188428,2024-01-06,201,paneer,210,340,130,1,00097,India
425858,2024-01-06,208,sprite,75,100,25,1,00456,India
338941,2024-01-06,205,classic yogurt,45,60,15,1,00216,India
338941,2024-01-06,207,coca cola,75,100,25,1,00216,India
338941,2024-01-06,202,milk,12,27,15,1,00216,India
338941,2024-01-06,206,yakult,360,400,40,1,00216,India
827104,2024-01-06,208,sprite,75,100,25,1,00220,India
827104,2024-01-06,204,strawberry yogurt,50,60,10,1,00220,India
827104,2024-01-06,209,pepsi,75,100,25,1,00220,India
149461,2024-01-06,208,sprite,75,100,25,1,00446,India
961705,2024-01-06,211,red bull,90,125,35,1,00353,India
961705,2024-01-06,204,strawberry yogurt,50,60,10,1,00353,India
992066,2024-01-06,211,red bull,90,125,35,1,00264,India
992066,2024-01-06,209,pepsi,75,100,25,1,00264,India
890126,2024-01-06,205,classic yogurt,45,60,15,1,00435,India
890126,2024-01-06,202,milk,12,27,15,1,00435,India
890126,2024-01-06,206,yakult,360,400,40,1,00435,India
890126,2024-01-06,203,mango yogurt,50,60,10,1,00435,India
528691,2024-01-06,206,yakult,360,400,40,1,00269,India
601216,2024-01-06,208,sprite,75,100,25,1,00259,India
189542,2024-01-06,210,mountain dew,75,100,25,1,00186,India
189542,2024-01-06,203,mango yogurt,50,60,10,1,00186,India
339495,2024-01-06,213,bisleri,6,15,9,1,00316,India
339495,2024-01-06,207,coca cola,75,100,25,1,00316,India
339495,2024-01-06,203,mango yogurt,50,60,10,1,00316,India
339495,2024-01-06,204,strawberry yogurt,50,60,10,1,00316,India
789124,2024-01-06,213,bisleri,6,15,9,1,00048,India
902140,2024-01-06,206,yakult,360,400,40,1,00422,India
902140,2024-01-06,204,strawberry yogurt,50,60,10,1,00422,India
902140,2024-01-06,209,pepsi,75,100,25,1,00422,India
902140,2024-01-06,205,classic yogurt,45,60,15,1,00422,India
902140,2024-01-06,213,bisleri,6,15,9,1,00422,India
840923,2024-01-06,204,strawberry yogurt,50,60,10,1,00067,India
840923,2024-01-06,208,sprite,75,100,25,1,00067,India
726998,2024-01-06,201,paneer,210,340,130,1,00109,India
735484,2024-01-06,201,paneer,210,340,130,1,00115,India
735484,2024-01-06,208,sprite,75,100,25,1,00115,India
735484,2024-01-06,209,pepsi,75,100,25,1,00115,India
339777,2024-01-06,202,milk,12,27,15,1,00466,India
339777,2024-01-06,208,sprite,75,100,25,1,00466,India
339777,2024-01-06,211,red bull,90,125,35,1,00466,India
216301,2024-01-06,210,mountain dew,75,100,25,1,00395,India
605439,2024-01-06,203,mango yogurt,50,60,10,1,00103,India
605439,2024-01-06,208,sprite,75,100,25,1,00103,India
605439,2024-01-06,202,milk,12,27,15,1,00103,India
192071,2024-01-06,209,pepsi,75,100,25,1,00141,India
606475,2024-01-06,209,pepsi,75,100,25,1,00177,India
606475,2024-01-06,208,sprite,75,100,25,1,00177,India
225310,2024-01-06,202,milk,12,27,15,1,00008,India
559122,2024-01-06,202,milk,12,27,15,1,00039,India
559122,2024-01-06,206,yakult,360,400,40,1,00039,India
559122,2024-01-06,210,mountain dew,75,100,25,1,00039,India
559122,2024-01-06,204,strawberry yogurt,50,60,10,1,00039,India
746008,2024-01-06,206,yakult,360,400,40,1,00237,India
294112,2024-01-06,207,coca cola,75,100,25,1,00325,India
294112,2024-01-06,206,yakult,360,400,40,1,00325,India
728425,2024-01-06,203,mango yogurt,50,60,10,1,00360,India
728425,2024-01-06,202,milk,12,27,15,1,00360,India
728425,2024-01-06,204,strawberry yogurt,50,60,10,1,00360,India
728425,2024-01-06,210,mountain dew,75,100,25,1,00360,India
720022,2024-01-06,205,classic yogurt,45,60,15,1,00083,India
720022,2024-01-06,208,sprite,75,100,25,1,00083,India
720022,2024-01-06,211,red bull,90,125,35,1,00083,India
720022,2024-01-06,210,mountain dew,75,100,25,1,00083,India
333762,2024-01-06,209,pepsi,75,100,25,1,00121,India
333762,2024-01-06,201,paneer,210,340,130,1,00121,India
333762,2024-01-06,205,classic yogurt,45,60,15,1,00121,India
796187,2024-01-06,206,yakult,360,400,40,1,00416,India
796187,2024-01-06,203,mango yogurt,50,60,10,1,00416,India
796187,2024-01-06,204,strawberry yogurt,50,60,10,1,00416,India
393879,2024-01-06,203,mango yogurt,50,60,10,1,00033,India
393879,2024-01-06,213,bisleri,6,15,9,1,00033,India
393879,2024-01-06,201,paneer,210,340,130,1,00033,India
393879,2024-01-06,207,coca cola,75,100,25,1,00033,India
130627,2024-01-06,210,mountain dew,75,100,25,1,00224,India
130627,2024-01-06,213,bisleri,6,15,9,1,00224,India
130627,2024-01-06,203,mango yogurt,50,60,10,1,00224,India
608733,2024-01-06,210,mountain dew,75,100,25,1,00228,India
608733,2024-01-06,211,red bull,90,125,35,1,00228,India
677210,2024-01-06,210,mountain dew,75,100,25,1,00278,India
677210,2024-01-06,208,sprite,75,100,25,1,00278,India
391978,2024-01-06,209,pepsi,75,100,25,1,00260,India
391978,2024-01-06,205,classic yogurt,45,60,15,1,00260,India
391978,2024-01-06,203,mango yogurt,50,60,10,1,00260,India
391978,2024-01-06,206,yakult,360,400,40,1,00260,India
681550,2024-01-06,201,paneer,210,340,130,1,00064,India
681550,2024-01-06,211,red bull,90,125,35,1,00064,India
681550,2024-01-06,209,pepsi,75,100,25,1,00064,India
681550,2024-01-06,212,amul cheese,250,315,65,1,00064,India
241391,2024-01-06,209,pepsi,75,100,25,1,00460,India
241391,2024-01-06,207,coca cola,75,100,25,1,00460,India
241391,2024-01-06,213,bisleri,6,15,9,1,00460,India
141927,2024-01-06,204,strawberry yogurt,50,60,10,1,00133,India
141927,2024-01-06,206,yakult,360,400,40,1,00133,India
906188,2024-01-06,213,bisleri,6,15,9,1,00055,India
906188,2024-01-06,202,milk,12,27,15,1,00055,India
906188,2024-01-06,207,coca cola,75,100,25,1,00055,India
906188,2024-01-06,208,sprite,75,100,25,1,00055,India
608825,2024-01-06,202,milk,12,27,15,1,00466,India
574450,2024-01-06,213,bisleri,6,15,9,1,00034,India
574450,2024-01-06,211,red bull,90,125,35,1,00034,India
574450,2024-01-06,207,coca cola,75,100,25,1,00034,India
574450,2024-01-06,201,paneer,210,340,130,1,00034,India
769941,2024-01-06,213,bisleri,6,15,9,1,00408,India
880634,2024-01-06,209,pepsi,75,100,25,1,00230,India
880634,2024-01-06,213,bisleri,6,15,9,1,00230,India
880634,2024-01-06,201,paneer,210,340,130,1,00230,India
848343,2024-01-06,211,red bull,90,125,35,1,00044,India
848343,2024-01-06,212,amul cheese,250,315,65,1,00044,India
848343,2024-01-06,203,mango yogurt,50,60,10,1,00044,India
314982,2024-01-06,203,mango yogurt,50,60,10,1,00223,India
314982,2024-01-06,205,classic yogurt,45,60,15,1,00223,India
314982,2024-01-06,210,mountain dew,75,100,25,1,00223,India
314982,2024-01-06,208,sprite,75,100,25,1,00223,India
642040,2024-01-06,208,sprite,75,100,25,1,00402,India
642040,2024-01-06,202,milk,12,27,15,1,00402,India
309255,2024-01-06,203,mango yogurt,50,60,10,1,00122,India
309255,2024-01-06,209,pepsi,75,100,25,1,00122,India
543352,2024-01-06,204,strawberry yogurt,50,60,10,1,00013,India
543352,2024-01-06,202,milk,12,27,15,1,00013,India
543352,2024-01-06,212,amul cheese,250,315,65,1,00013,India
341042,2024-01-07,211,red bull,90,125,35,1,00027,India
341042,2024-01-07,209,pepsi,75,100,25,1,00027,India
341042,2024-01-07,206,yakult,360,400,40,1,00027,India
341042,2024-01-07,213,bisleri,6,15,9,1,00027,India
227875,2024-01-07,205,classic yogurt,45,60,15,1,00470,India
227875,2024-01-07,201,paneer,210,340,130,1,00470,India
227875,2024-01-07,208,sprite,75,100,25,1,00470,India
874662,2024-01-07,204,strawberry yogurt,50,60,10,1,00040,India
874662,2024-01-07,202,milk,12,27,15,1,00040,India
874662,2024-01-07,207,coca cola,75,100,25,1,00040,India
145836,2024-01-07,203,mango yogurt,50,60,10,1,00180,India
145836,2024-01-07,207,coca cola,75,100,25,1,00180,India
145836,2024-01-07,205,classic yogurt,45,60,15,1,00180,India
300478,2024-01-07,203,mango yogurt,50,60,10,1,00214,India
300478,2024-01-07,204,strawberry yogurt,50,60,10,1,00214,India
300478,2024-01-07,207,coca cola,75,100,25,1,00214,India
300478,2024-01-07,208,sprite,75,100,25,1,00214,India
300342,2024-01-07,205,classic yogurt,45,60,15,1,00427,India
300342,2024-01-07,206,yakult,360,400,40,1,00427,India
300342,2024-01-07,207,coca cola,75,100,25,1,00427,India
300342,2024-01-07,209,pepsi,75,100,25,1,00427,India
241762,2024-01-07,213,bisleri,6,15,9,1,00343,India
241762,2024-01-07,202,milk,12,27,15,1,00343,India
241762,2024-01-07,206,yakult,360,400,40,1,00343,India
871875,2024-01-07,206,yakult,360,400,40,1,00285,India
309573,2024-01-07,202,milk,12,27,15,1,00144,India
309573,2024-01-07,207,coca cola,75,100,25,1,00144,India
124328,2024-01-07,211,red bull,90,125,35,1,00476,India
124328,2024-01-07,212,amul cheese,250,315,65,1,00476,India
124328,2024-01-07,210,mountain dew,75,100,25,1,00476,India
124328,2024-01-07,203,mango yogurt,50,60,10,1,00476,India
119598,2024-01-07,204,strawberry yogurt,50,60,10,1,00474,India
119598,2024-01-07,211,red bull,90,125,35,1,00474,India
119598,2024-01-07,201,paneer,210,340,130,1,00474,India
379783,2024-01-07,206,yakult,360,400,40,1,00072,India
416310,2024-01-07,211,red bull,90,125,35,1,00106,India
164714,2024-01-07,212,amul cheese,250,315,65,1,00482,India
164714,2024-01-07,201,paneer,210,340,130,1,00482,India
164714,2024-01-07,204,strawberry yogurt,50,60,10,1,00482,India
137910,2024-01-07,208,sprite,75,100,25,1,00123,India
137910,2024-01-07,210,mountain dew,75,100,25,1,00123,India
137910,2024-01-07,205,classic yogurt,45,60,15,1,00123,India
821196,2024-01-07,211,red bull,90,125,35,1,00371,India
821196,2024-01-07,212,amul cheese,250,315,65,1,00371,India
821196,2024-01-07,201,paneer,210,340,130,1,00371,India
821196,2024-01-07,203,mango yogurt,50,60,10,1,00371,India
225321,2024-01-07,203,mango yogurt,50,60,10,1,00307,India
225321,2024-01-07,211,red bull,90,125,35,1,00307,India
281534,2024-01-07,205,classic yogurt,45,60,15,1,00437,India
281534,2024-01-07,207,coca cola,75,100,25,1,00437,India
281534,2024-01-07,213,bisleri,6,15,9,1,00437,India
281534,2024-01-07,209,pepsi,75,100,25,1,00437,India
943877,2024-01-07,207,coca cola,75,100,25,1,00391,India
943877,2024-01-07,212,amul cheese,250,315,65,1,00391,India
943877,2024-01-07,209,pepsi,75,100,25,1,00391,India
457369,2024-01-07,205,classic yogurt,45,60,15,1,00307,India
457369,2024-01-07,207,coca cola,75,100,25,1,00307,India
457369,2024-01-07,202,milk,12,27,15,1,00307,India
465530,2024-01-07,208,sprite,75,100,25,1,00439,India
465530,2024-01-07,201,paneer,210,340,130,1,00439,India
465530,2024-01-07,204,strawberry yogurt,50,60,10,1,00439,India
851160,2024-01-07,205,classic yogurt,45,60,15,1,00476,India
390303,2024-01-07,201,paneer,210,340,130,1,00446,India
373187,2024-01-07,207,coca cola,75,100,25,1,00290,India
373187,2024-01-07,209,pepsi,75,100,25,1,00290,India
373187,2024-01-07,206,yakult,360,400,40,1,00290,India
882978,2024-01-07,208,sprite,75,100,25,1,00223,India
882978,2024-01-07,202,milk,12,27,15,1,00223,India
882978,2024-01-07,212,amul cheese,250,315,65,1,00223,India
882978,2024-01-07,206,yakult,360,400,40,1,00223,India
496571,2024-01-07,207,coca cola,75,100,25,1,00332,India
496571,2024-01-07,209,pepsi,75,100,25,1,00332,India
496571,2024-01-07,206,yakult,360,400,40,1,00332,India
246420,2024-01-07,204,strawberry yogurt,50,60,10,1,00364,India
108735,2024-01-07,212,amul cheese,250,315,65,1,00101,India
108735,2024-01-07,211,red bull,90,125,35,1,00101,India
108735,2024-01-07,204,strawberry yogurt,50,60,10,1,00101,India
108735,2024-01-07,205,classic yogurt,45,60,15,1,00101,India
447358,2024-01-07,208,sprite,75,100,25,1,00021,India
447358,2024-01-07,203,mango yogurt,50,60,10,1,00021,India
447358,2024-01-07,201,paneer,210,340,130,1,00021,India
447358,2024-01-07,204,strawberry yogurt,50,60,10,1,00021,India
575483,2024-01-07,211,red bull,90,125,35,1,00178,India
575483,2024-01-07,202,milk,12,27,15,1,00178,India
575483,2024-01-07,206,yakult,360,400,40,1,00178,India
575483,2024-01-07,207,coca cola,75,100,25,1,00178,India
575483,2024-01-07,213,bisleri,6,15,9,1,00178,India
568221,2024-01-07,203,mango yogurt,50,60,10,1,00429,India
568221,2024-01-07,208,sprite,75,100,25,1,00429,India
568221,2024-01-07,209,pepsi,75,100,25,1,00429,India
568221,2024-01-07,204,strawberry yogurt,50,60,10,1,00429,India
568221,2024-01-07,211,red bull,90,125,35,1,00429,India
485801,2024-01-07,212,amul cheese,250,315,65,1,00388,India
485801,2024-01-07,202,milk,12,27,15,1,00388,India
213663,2024-01-07,213,bisleri,6,15,9,1,00086,India
213663,2024-01-07,205,classic yogurt,45,60,15,1,00086,India
245126,2024-01-07,212,amul cheese,250,315,65,1,00214,India
245126,2024-01-07,206,yakult,360,400,40,1,00214,India
245126,2024-01-07,202,milk,12,27,15,1,00214,India
164293,2024-01-07,208,sprite,75,100,25,1,00117,India
153195,2024-01-07,209,pepsi,75,100,25,1,00151,India
153195,2024-01-07,211,red bull,90,125,35,1,00151,India
365779,2024-01-07,209,pepsi,75,100,25,1,00194,India
567518,2024-01-07,209,pepsi,75,100,25,1,00016,India
567518,2024-01-07,210,mountain dew,75,100,25,1,00016,India
667990,2024-01-07,206,yakult,360,400,40,1,00470,India
667990,2024-01-07,209,pepsi,75,100,25,1,00470,India
667990,2024-01-07,203,mango yogurt,50,60,10,1,00470,India
693984,2024-01-07,213,bisleri,6,15,9,1,00355,India
693984,2024-01-07,211,red bull,90,125,35,1,00355,India
693984,2024-01-07,205,classic yogurt,45,60,15,1,00355,India
451859,2024-01-07,204,strawberry yogurt,50,60,10,1,00084,India
980832,2024-01-07,208,sprite,75,100,25,1,00269,India
561993,2024-01-07,205,classic yogurt,45,60,15,1,00059,India
561993,2024-01-07,212,amul cheese,250,315,65,1,00059,India
745726,2024-01-07,207,coca cola,75,100,25,1,00411,India
236750,2024-01-07,204,strawberry yogurt,50,60,10,1,00260,India
236750,2024-01-07,206,yakult,360,400,40,1,00260,India
532519,2024-01-07,203,mango yogurt,50,60,10,1,00042,India
532519,2024-01-07,212,amul cheese,250,315,65,1,00042,India
532519,2024-01-07,209,pepsi,75,100,25,1,00042,India
532519,2024-01-07,211,red bull,90,125,35,1,00042,India
276965,2024-01-07,209,pepsi,75,100,25,1,00053,India
276965,2024-01-07,201,paneer,210,340,130,1,00053,India
276965,2024-01-07,202,milk,12,27,15,1,00053,India
874867,2024-01-07,207,coca cola,75,100,25,1,00029,India
874867,2024-01-07,209,pepsi,75,100,25,1,00029,India
874867,2024-01-07,213,bisleri,6,15,9,1,00029,India
389103,2024-01-07,211,red bull,90,125,35,1,00058,India
389103,2024-01-07,204,strawberry yogurt,50,60,10,1,00058,India
389103,2024-01-07,203,mango yogurt,50,60,10,1,00058,India
389103,2024-01-07,206,yakult,360,400,40,1,00058,India
451766,2024-01-07,211,red bull,90,125,35,1,00136,India
451766,2024-01-07,203,mango yogurt,50,60,10,1,00136,India
451766,2024-01-07,209,pepsi,75,100,25,1,00136,India
766349,2024-01-07,202,milk,12,27,15,1,00292,India
766349,2024-01-07,201,paneer,210,340,130,1,00292,India
766349,2024-01-07,203,mango yogurt,50,60,10,1,00292,India
766349,2024-01-07,212,amul cheese,250,315,65,1,00292,India
716620,2024-01-07,212,amul cheese,250,315,65,1,00275,India
716620,2024-01-07,213,bisleri,6,15,9,1,00275,India
716620,2024-01-07,210,mountain dew,75,100,25,1,00275,India
716620,2024-01-07,207,coca cola,75,100,25,1,00275,India
136484,2024-01-07,211,red bull,90,125,35,1,00098,India
246186,2024-01-07,209,pepsi,75,100,25,1,00489,India
246186,2024-01-07,210,mountain dew,75,100,25,1,00489,India
815994,2024-01-07,210,mountain dew,75,100,25,1,00210,India
815994,2024-01-07,206,yakult,360,400,40,1,00210,India
603866,2024-01-07,204,strawberry yogurt,50,60,10,1,00352,India
603866,2024-01-07,202,milk,12,27,15,1,00352,India
603866,2024-01-07,209,pepsi,75,100,25,1,00352,India
701469,2024-01-07,210,mountain dew,75,100,25,1,00389,India
151082,2024-01-07,204,strawberry yogurt,50,60,10,1,00410,India
716595,2024-01-07,207,coca cola,75,100,25,1,00346,India
716595,2024-01-07,205,classic yogurt,45,60,15,1,00346,India
716595,2024-01-07,212,amul cheese,250,315,65,1,00346,India
716595,2024-01-07,202,milk,12,27,15,1,00346,India
716595,2024-01-07,201,paneer,210,340,130,1,00346,India
924955,2024-01-07,203,mango yogurt,50,60,10,1,00025,India
517792,2024-01-07,205,classic yogurt,45,60,15,1,00023,India
517792,2024-01-07,212,amul cheese,250,315,65,1,00023,India
517792,2024-01-07,206,yakult,360,400,40,1,00023,India
136385,2024-01-07,206,yakult,360,400,40,1,00228,India
136385,2024-01-07,208,sprite,75,100,25,1,473,India
136385,2024-01-07,205,classic yogurt,45,60,15,1,473,India
136385,2024-01-07,201,paneer,210,340,130,1,473,India
408104,2024-01-07,211,red bull,90,125,35,1,346,India
408104,2024-01-07,206,yakult,360,400,40,1,346,India
408104,2024-01-07,202,milk,12,27,15,1,346,India
408104,2024-01-07,207,coca cola,75,100,25,1,346,India
622111,2024-01-07,208,sprite,75,100,25,1,192,India
877307,2024-01-07,207,coca cola,75,100,25,1,213,India
877307,2024-01-07,208,sprite,75,100,25,1,213,India
211247,2024-01-07,201,paneer,210,340,130,1,116,India
211247,2024-01-07,210,mountain dew,75,100,25,1,116,India
211247,2024-01-07,203,mango yogurt,50,60,10,1,116,India
211247,2024-01-07,212,amul cheese,250,315,65,1,116,India
460733,2024-01-07,213,bisleri,6,15,9,1,455,India
460733,2024-01-07,202,milk,12,27,15,1,455,India
460733,2024-01-07,201,paneer,210,340,130,1,455,India
785864,2024-01-07,202,milk,12,27,15,1,90,India
785864,2024-01-07,208,sprite,75,100,25,1,90,India
586633,2024-01-07,206,yakult,360,400,40,1,66,India
273854,2024-01-07,205,classic yogurt,45,60,15,1,172,India
273854,2024-01-07,207,coca cola,75,100,25,1,172,India
273854,2024-01-07,206,yakult,360,400,40,1,172,India
273854,2024-01-07,213,bisleri,6,15,9,1,172,India
747157,2024-01-07,207,coca cola,75,100,25,1,411,India
747157,2024-01-07,204,strawberry yogurt,50,60,10,1,411,India
747157,2024-01-07,203,mango yogurt,50,60,10,1,411,India
990796,2024-01-07,204,strawberry yogurt,50,60,10,1,26,India
990796,2024-01-07,209,pepsi,75,100,25,1,26,India
990796,2024-01-07,205,classic yogurt,45,60,15,1,26,India
990796,2024-01-07,203,mango yogurt,50,60,10,1,26,India
955663,2024-01-07,211,red bull,90,125,35,1,373,India
563959,2024-01-07,204,strawberry yogurt,50,60,10,1,288,India
563959,2024-01-07,210,mountain dew,75,100,25,1,288,India
563959,2024-01-07,207,coca cola,75,100,25,1,288,India
564561,2024-01-07,202,milk,12,27,15,1,416,India
221662,2024-01-07,203,mango yogurt,50,60,10,1,463,India
221662,2024-01-07,208,sprite,75,100,25,1,463,India
221662,2024-01-07,212,amul cheese,250,315,65,1,463,India
528954,2024-01-07,201,paneer,210,340,130,1,310,India
528954,2024-01-07,202,milk,12,27,15,1,310,India
538112,2024-01-07,209,pepsi,75,100,25,1,117,India
682222,2024-01-07,201,paneer,210,340,130,1,97,India
682222,2024-01-07,213,bisleri,6,15,9,1,97,India
682222,2024-01-07,208,sprite,75,100,25,1,97,India
682222,2024-01-07,202,milk,12,27,15,1,97,India
800843,2024-01-07,213,bisleri,6,15,9,1,230,India
800843,2024-01-07,206,yakult,360,400,40,1,230,India
800843,2024-01-07,203,mango yogurt,50,60,10,1,230,India
329793,2024-01-07,211,red bull,90,125,35,1,195,India
329793,2024-01-07,210,mountain dew,75,100,25,1,195,India
771814,2024-01-07,209,pepsi,75,100,25,1,419,India
771814,2024-01-07,206,yakult,360,400,40,1,419,India
164204,2024-01-07,202,milk,12,27,15,1,219,India
382551,2024-01-07,204,strawberry yogurt,50,60,10,1,258,India
382551,2024-01-07,212,amul cheese,250,315,65,1,258,India
382551,2024-01-07,211,red bull,90,125,35,1,258,India
934575,2024-01-07,210,mountain dew,75,100,25,1,270,India
934575,2024-01-07,203,mango yogurt,50,60,10,1,270,India
934575,2024-01-07,208,sprite,75,100,25,1,270,India
934575,2024-01-07,201,paneer,210,340,130,1,270,India
651816,2024-01-07,211,red bull,90,125,35,1,296,India
651816,2024-01-07,212,amul cheese,250,315,65,1,296,India
651816,2024-01-07,202,milk,12,27,15,1,296,India
651816,2024-01-07,201,paneer,210,340,130,1,296,India
651816,2024-01-07,206,yakult,360,400,40,1,296,India
821815,2024-01-08,204,strawberry yogurt,50,60,10,1,397,India
821815,2024-01-08,207,coca cola,75,100,25,1,397,India
588326,2024-01-08,210,mountain dew,75,100,25,1,408,India
588326,2024-01-08,207,coca cola,75,100,25,1,408,India
588326,2024-01-08,205,classic yogurt,45,60,15,1,408,India
795963,2024-01-08,212,amul cheese,250,315,65,1,248,India
795963,2024-01-08,207,coca cola,75,100,25,1,248,India
795963,2024-01-08,206,yakult,360,400,40,1,248,India
867159,2024-01-08,206,yakult,360,400,40,1,125,India
867159,2024-01-08,202,milk,12,27,15,1,125,India
867159,2024-01-08,201,paneer,210,340,130,1,125,India
209272,2024-01-08,202,milk,12,27,15,1,25,India
209272,2024-01-08,212,amul cheese,250,315,65,1,25,India
209272,2024-01-08,207,coca cola,75,100,25,1,25,India
209272,2024-01-08,208,sprite,75,100,25,1,25,India
209272,2024-01-08,213,bisleri,6,15,9,1,25,India
494313,2024-01-08,206,yakult,360,400,40,1,495,India
494313,2024-01-08,212,amul cheese,250,315,65,1,495,India
494313,2024-01-08,211,red bull,90,125,35,1,495,India
885682,2024-01-08,212,amul cheese,250,315,65,1,386,India
885682,2024-01-08,204,strawberry yogurt,50,60,10,1,386,India
885682,2024-01-08,209,pepsi,75,100,25,1,386,India
885682,2024-01-08,210,mountain dew,75,100,25,1,386,India
885682,2024-01-08,205,classic yogurt,45,60,15,1,386,India
898708,2024-01-08,212,amul cheese,250,315,65,1,256,India
898708,2024-01-08,206,yakult,360,400,40,1,256,India
898708,2024-01-08,208,sprite,75,100,25,1,256,India
898708,2024-01-08,210,mountain dew,75,100,25,1,256,India
128817,2024-01-08,206,yakult,360,400,40,1,351,India
128817,2024-01-08,211,red bull,90,125,35,1,351,India
128817,2024-01-08,203,mango yogurt,50,60,10,1,351,India
734070,2024-01-08,207,coca cola,75,100,25,1,424,India
734070,2024-01-08,212,amul cheese,250,315,65,1,424,India
734070,2024-01-08,208,sprite,75,100,25,1,424,India
734070,2024-01-08,203,mango yogurt,50,60,10,1,424,India
734070,2024-01-08,210,mountain dew,75,100,25,1,424,India
892412,2024-01-08,209,pepsi,75,100,25,1,284,India
892412,2024-01-08,208,sprite,75,100,25,1,284,India
892412,2024-01-08,211,red bull,90,125,35,1,284,India
892412,2024-01-08,203,mango yogurt,50,60,10,1,284,India
284948,2024-01-08,201,paneer,210,340,130,1,127,India
284948,2024-01-08,202,milk,12,27,15,1,127,India
284948,2024-01-08,209,pepsi,75,100,25,1,127,India
284948,2024-01-08,212,amul cheese,250,315,65,1,127,India
591898,2024-01-08,204,strawberry yogurt,50,60,10,1,234,India
591898,2024-01-08,213,bisleri,6,15,9,1,234,India
473039,2024-01-08,212,amul cheese,250,315,65,1,164,India
616038,2024-01-08,210,mountain dew,75,100,25,1,482,India
914140,2024-01-08,206,yakult,360,400,40,1,70,India
914140,2024-01-08,213,bisleri,6,15,9,1,70,India
565236,2024-01-08,208,sprite,75,100,25,1,191,India
565236,2024-01-08,211,red bull,90,125,35,1,191,India
739553,2024-01-08,207,coca cola,75,100,25,1,147,India
739553,2024-01-08,204,strawberry yogurt,50,60,10,1,147,India
739553,2024-01-08,210,mountain dew,75,100,25,1,147,India
739553,2024-01-08,203,mango yogurt,50,60,10,1,147,India
871350,2024-01-08,210,mountain dew,75,100,25,1,403,India
871350,2024-01-08,204,strawberry yogurt,50,60,10,1,403,India
828102,2024-01-08,205,classic yogurt,45,60,15,1,321,India
828102,2024-01-08,209,pepsi,75,100,25,1,321,India
828102,2024-01-08,204,strawberry yogurt,50,60,10,1,321,India
828102,2024-01-08,212,amul cheese,250,315,65,1,321,India
128201,2024-01-08,207,coca cola,75,100,25,1,377,India
128201,2024-01-08,208,sprite,75,100,25,1,377,India
128201,2024-01-08,205,classic yogurt,45,60,15,1,377,India
106817,2024-01-08,210,mountain dew,75,100,25,1,380,India
106817,2024-01-08,205,classic yogurt,45,60,15,1,380,India
106817,2024-01-08,213,bisleri,6,15,9,1,380,India
494409,2024-01-08,206,yakult,360,400,40,1,327,India
494409,2024-01-08,201,paneer,210,340,130,1,327,India
437760,2024-01-08,210,mountain dew,75,100,25,1,332,India
437760,2024-01-08,204,strawberry yogurt,50,60,10,1,332,India
129240,2024-01-08,202,milk,12,27,15,1,228,India
129240,2024-01-08,212,amul cheese,250,315,65,1,228,India
129240,2024-01-08,206,yakult,360,400,40,1,228,India
896203,2024-01-08,211,red bull,90,125,35,1,229,India
959259,2024-01-08,208,sprite,75,100,25,1,163,India
959259,2024-01-08,205,classic yogurt,45,60,15,1,163,India
314398,2024-01-08,203,mango yogurt,50,60,10,1,364,India
314398,2024-01-08,213,bisleri,6,15,9,1,364,India
683519,2024-01-08,203,mango yogurt,50,60,10,1,284,India
683519,2024-01-08,202,milk,12,27,15,1,284,India
683519,2024-01-08,210,mountain dew,75,100,25,1,284,India
652531,2024-01-08,209,pepsi,75,100,25,1,81,India
213011,2024-01-08,202,milk,12,27,15,1,238,India
213011,2024-01-08,204,strawberry yogurt,50,60,10,1,238,India
213011,2024-01-08,207,coca cola,75,100,25,1,238,India
515715,2024-01-08,207,coca cola,75,100,25,1,257,India
939946,2024-01-08,207,coca cola,75,100,25,1,446,India
197086,2024-01-08,202,milk,12,27,15,1,231,India
197086,2024-01-08,203,mango yogurt,50,60,10,1,231,India
739892,2024-01-08,203,mango yogurt,50,60,10,1,84,India
739892,2024-01-08,208,sprite,75,100,25,1,84,India
739892,2024-01-08,206,yakult,360,400,40,1,84,India
739892,2024-01-08,209,pepsi,75,100,25,1,84,India
907371,2024-01-08,204,strawberry yogurt,50,60,10,1,496,India
907371,2024-01-08,205,classic yogurt,45,60,15,1,496,India
907371,2024-01-08,211,red bull,90,125,35,1,496,India
907371,2024-01-08,203,mango yogurt,50,60,10,1,496,India
907371,2024-01-08,201,paneer,210,340,130,1,496,India
115589,2024-01-08,204,strawberry yogurt,50,60,10,1,389,India
115589,2024-01-08,207,coca cola,75,100,25,1,389,India
398937,2024-01-08,208,sprite,75,100,25,1,362,India
398937,2024-01-08,201,paneer,210,340,130,1,362,India
398937,2024-01-08,206,yakult,360,400,40,1,362,India
398937,2024-01-08,204,strawberry yogurt,50,60,10,1,362,India
398937,2024-01-08,205,classic yogurt,45,60,15,1,362,India
135484,2024-01-08,210,mountain dew,75,100,25,1,433,India
935665,2024-01-08,207,coca cola,75,100,25,1,61,India
935665,2024-01-08,205,classic yogurt,45,60,15,1,61,India
935665,2024-01-08,202,milk,12,27,15,1,61,India
935665,2024-01-08,208,sprite,75,100,25,1,61,India
415649,2024-01-08,211,red bull,90,125,35,1,16,India
415649,2024-01-08,213,bisleri,6,15,9,1,16,India
415649,2024-01-08,206,yakult,360,400,40,1,16,India
311329,2024-01-08,212,amul cheese,250,315,65,1,290,India
311329,2024-01-08,204,strawberry yogurt,50,60,10,1,290,India
311329,2024-01-08,202,milk,12,27,15,1,290,India
311329,2024-01-08,207,coca cola,75,100,25,1,290,India
311329,2024-01-08,213,bisleri,6,15,9,1,290,India
116013,2024-01-08,207,coca cola,75,100,25,1,58,India
741370,2024-01-08,210,mountain dew,75,100,25,1,301,India
741370,2024-01-08,212,amul cheese,250,315,65,1,301,India
557027,2024-01-08,206,yakult,360,400,40,1,64,India
557027,2024-01-08,210,mountain dew,75,100,25,1,64,India
557027,2024-01-08,213,bisleri,6,15,9,1,64,India
408509,2024-01-08,210,mountain dew,75,100,25,1,285,India
408509,2024-01-08,202,milk,12,27,15,1,285,India
408509,2024-01-08,201,paneer,210,340,130,1,285,India
866495,2024-01-08,203,mango yogurt,50,60,10,1,297,India
866495,2024-01-08,206,yakult,360,400,40,1,297,India
866495,2024-01-08,202,milk,12,27,15,1,297,India
866495,2024-01-08,208,sprite,75,100,25,1,297,India
621096,2024-01-08,202,milk,12,27,15,1,426,India
621096,2024-01-08,205,classic yogurt,45,60,15,1,426,India
621096,2024-01-08,213,bisleri,6,15,9,1,426,India
621096,2024-01-08,210,mountain dew,75,100,25,1,426,India
621096,2024-01-08,212,amul cheese,250,315,65,1,426,India
520790,2024-01-08,205,classic yogurt,45,60,15,1,429,India
520790,2024-01-08,201,paneer,210,340,130,1,429,India
520790,2024-01-08,207,coca cola,75,100,25,1,429,India
520790,2024-01-08,209,pepsi,75,100,25,1,429,India
661469,2024-01-08,208,sprite,75,100,25,1,167,India
661469,2024-01-08,201,paneer,210,340,130,1,167,India
116556,2024-01-08,211,red bull,90,125,35,1,180,India
116556,2024-01-08,213,bisleri,6,15,9,1,180,India
540809,2024-01-08,201,paneer,210,340,130,1,132,India
729789,2024-01-08,213,bisleri,6,15,9,1,486,India
729789,2024-01-08,208,sprite,75,100,25,1,486,India
729789,2024-01-08,201,paneer,210,340,130,1,486,India
405087,2024-01-08,201,paneer,210,340,130,1,286,India
405087,2024-01-08,213,bisleri,6,15,9,1,286,India
651304,2024-01-08,213,bisleri,6,15,9,1,435,India
606480,2024-01-08,210,mountain dew,75,100,25,1,450,India
606480,2024-01-08,208,sprite,75,100,25,1,450,India
606480,2024-01-08,212,amul cheese,250,315,65,1,450,India
606480,2024-01-08,201,paneer,210,340,130,1,450,India
929295,2024-01-08,202,milk,12,27,15,1,272,India
929295,2024-01-08,204,strawberry yogurt,50,60,10,1,272,India
929295,2024-01-08,208,sprite,75,100,25,1,272,India
929295,2024-01-08,211,red bull,90,125,35,1,272,India
929295,2024-01-08,209,pepsi,75,100,25,1,272,India
497734,2024-01-08,205,classic yogurt,45,60,15,1,279,India
497734,2024-01-08,207,coca cola,75,100,25,1,279,India
497734,2024-01-08,210,mountain dew,75,100,25,1,279,India
497734,2024-01-08,211,red bull,90,125,35,1,279,India
497734,2024-01-08,213,bisleri,6,15,9,1,279,India
387986,2024-01-08,210,mountain dew,75,100,25,1,456,India
387986,2024-01-08,209,pepsi,75,100,25,1,456,India
387986,2024-01-08,211,red bull,90,125,35,1,456,India
409851,2024-01-08,209,pepsi,75,100,25,1,356,India
283108,2024-01-08,201,paneer,210,340,130,1,11,India
283108,2024-01-08,209,pepsi,75,100,25,1,11,India
283108,2024-01-08,213,bisleri,6,15,9,1,11,India
114581,2024-01-08,208,sprite,75,100,25,1,404,India
114581,2024-01-08,206,yakult,360,400,40,1,404,India
114581,2024-01-08,210,mountain dew,75,100,25,1,404,India
157315,2024-01-08,211,red bull,90,125,35,1,302,India
157315,2024-01-08,202,milk,12,27,15,1,302,India
157315,2024-01-08,205,classic yogurt,45,60,15,1,302,India
157315,2024-01-08,207,coca cola,75,100,25,1,302,India
157315,2024-01-08,213,bisleri,6,15,9,1,302,India
184207,2024-01-08,205,classic yogurt,45,60,15,1,466,India
184207,2024-01-08,204,strawberry yogurt,50,60,10,1,466,India
943421,2024-01-08,202,milk,12,27,15,1,119,India
711806,2024-01-08,203,mango yogurt,50,60,10,1,379,India
259975,2024-01-08,207,coca cola,75,100,25,1,389,India
259975,2024-01-08,210,mountain dew,75,100,25,1,389,India
259975,2024-01-08,209,pepsi,75,100,25,1,389,India
259975,2024-01-08,202,milk,12,27,15,1,389,India
259975,2024-01-08,201,paneer,210,340,130,1,389,India
926169,2024-01-08,212,amul cheese,250,315,65,1,410,India
926169,2024-01-08,204,strawberry yogurt,50,60,10,1,410,India
926169,2024-01-08,201,paneer,210,340,130,1,410,India
485054,2024-01-08,212,amul cheese,250,315,65,1,34,India
153616,2024-01-08,213,bisleri,6,15,9,1,467,India
153616,2024-01-08,206,yakult,360,400,40,1,467,India
668209,2024-01-08,212,amul cheese,250,315,65,1,41,India
950037,2024-01-08,210,mountain dew,75,100,25,1,376,India
950037,2024-01-08,206,yakult,360,400,40,1,376,India
284266,2024-01-08,206,yakult,360,400,40,1,173,India
279238,2024-01-08,202,milk,12,27,15,1,367,India
626262,2024-01-09,203,mango yogurt,50,60,10,1,284,India
548145,2024-01-09,202,milk,12,27,15,1,268,India
165202,2024-01-09,210,mountain dew,75,100,25,1,460,India
165202,2024-01-09,212,amul cheese,250,315,65,1,460,India
165202,2024-01-09,207,coca cola,75,100,25,1,460,India
557839,2024-01-09,205,classic yogurt,45,60,15,1,221,India
557839,2024-01-09,201,paneer,210,340,130,1,221,India
557839,2024-01-09,207,coca cola,75,100,25,1,221,India
425014,2024-01-09,206,yakult,360,400,40,1,450,India
425014,2024-01-09,208,sprite,75,100,25,1,450,India
425014,2024-01-09,209,pepsi,75,100,25,1,450,India
933250,2024-01-09,209,pepsi,75,100,25,1,490,India
933250,2024-01-09,210,mountain dew,75,100,25,1,490,India
933250,2024-01-09,211,red bull,90,125,35,1,490,India
933250,2024-01-09,204,strawberry yogurt,50,60,10,1,490,India
933250,2024-01-09,202,milk,12,27,15,1,490,India
972535,2024-01-09,212,amul cheese,250,315,65,1,115,India
972535,2024-01-09,205,classic yogurt,45,60,15,1,115,India
972535,2024-01-09,201,paneer,210,340,130,1,115,India
972535,2024-01-09,203,mango yogurt,50,60,10,1,115,India
208751,2024-01-09,206,yakult,360,400,40,1,357,India
208751,2024-01-09,207,coca cola,75,100,25,1,357,India
208751,2024-01-09,201,paneer,210,340,130,1,357,India
978615,2024-01-09,207,coca cola,75,100,25,1,346,India
978615,2024-01-09,213,bisleri,6,15,9,1,346,India
978615,2024-01-09,212,amul cheese,250,315,65,1,346,India
978615,2024-01-09,210,mountain dew,75,100,25,1,346,India
506932,2024-01-09,202,milk,12,27,15,1,193,India
506932,2024-01-09,207,coca cola,75,100,25,1,193,India
506932,2024-01-09,204,strawberry yogurt,50,60,10,1,193,India
843140,2024-01-09,211,red bull,90,125,35,1,327,India
843140,2024-01-09,213,bisleri,6,15,9,1,327,India
740065,2024-01-09,209,pepsi,75,100,25,1,215,India
740065,2024-01-09,204,strawberry yogurt,50,60,10,1,215,India
552825,2024-01-09,206,yakult,360,400,40,1,182,India
552825,2024-01-09,209,pepsi,75,100,25,1,182,India
552825,2024-01-09,208,sprite,75,100,25,1,182,India
552825,2024-01-09,205,classic yogurt,45,60,15,1,182,India
908683,2024-01-09,208,sprite,75,100,25,1,295,India
908683,2024-01-09,205,classic yogurt,45,60,15,1,295,India
908683,2024-01-09,204,strawberry yogurt,50,60,10,1,295,India
666427,2024-01-09,205,classic yogurt,45,60,15,1,120,India
666427,2024-01-09,213,bisleri,6,15,9,1,120,India
666427,2024-01-09,212,amul cheese,250,315,65,1,120,India
940567,2024-01-09,201,paneer,210,340,130,1,8,India
940567,2024-01-09,205,classic yogurt,45,60,15,1,8,India
940567,2024-01-09,212,amul cheese,250,315,65,1,8,India
940567,2024-01-09,209,pepsi,75,100,25,1,8,India
635466,2024-01-09,207,coca cola,75,100,25,1,51,India
635466,2024-01-09,212,amul cheese,250,315,65,1,51,India
635466,2024-01-09,211,red bull,90,125,35,1,51,India
618108,2024-01-09,208,sprite,75,100,25,1,126,India
618108,2024-01-09,209,pepsi,75,100,25,1,126,India
618108,2024-01-09,207,coca cola,75,100,25,1,126,India
618108,2024-01-09,212,amul cheese,250,315,65,1,126,India
615270,2024-01-09,204,strawberry yogurt,50,60,10,1,399,India
615270,2024-01-09,201,paneer,210,340,130,1,399,India
615270,2024-01-09,212,amul cheese,250,315,65,1,399,India
606385,2024-01-09,211,red bull,90,125,35,1,400,India
606385,2024-01-09,210,mountain dew,75,100,25,1,400,India
606385,2024-01-09,208,sprite,75,100,25,1,400,India
606385,2024-01-09,207,coca cola,75,100,25,1,400,India
855732,2024-01-09,204,strawberry yogurt,50,60,10,1,365,India
855732,2024-01-09,208,sprite,75,100,25,1,365,India
545583,2024-01-09,201,paneer,210,340,130,1,117,India
545583,2024-01-09,209,pepsi,75,100,25,1,117,India
815339,2024-01-09,210,mountain dew,75,100,25,1,424,India
815339,2024-01-09,204,strawberry yogurt,50,60,10,1,424,India
820231,2024-01-09,203,mango yogurt,50,60,10,1,498,India
820231,2024-01-09,201,paneer,210,340,130,1,498,India
820231,2024-01-09,208,sprite,75,100,25,1,498,India
820231,2024-01-09,209,pepsi,75,100,25,1,498,India
154476,2024-01-09,205,classic yogurt,45,60,15,1,274,India
154476,2024-01-09,204,strawberry yogurt,50,60,10,1,274,India
154476,2024-01-09,208,sprite,75,100,25,1,274,India
196215,2024-01-09,205,classic yogurt,45,60,15,1,9,India
464439,2024-01-09,208,sprite,75,100,25,1,251,India
464439,2024-01-09,202,milk,12,27,15,1,251,India
464439,2024-01-09,213,bisleri,6,15,9,1,251,India
464439,2024-01-09,205,classic yogurt,45,60,15,1,251,India
757251,2024-01-09,202,milk,12,27,15,1,300,India
757251,2024-01-09,205,classic yogurt,45,60,15,1,300,India
757251,2024-01-09,204,strawberry yogurt,50,60,10,1,300,India
757251,2024-01-09,206,yakult,360,400,40,1,300,India
757251,2024-01-09,211,red bull,90,125,35,1,300,India
691492,2024-01-09,209,pepsi,75,100,25,1,480,India
691492,2024-01-09,210,mountain dew,75,100,25,1,480,India
691492,2024-01-09,205,classic yogurt,45,60,15,1,480,India
824890,2024-01-09,203,mango yogurt,50,60,10,1,213,India
824890,2024-01-09,202,milk,12,27,15,1,213,India
993346,2024-01-09,213,bisleri,6,15,9,1,270,India
993346,2024-01-09,208,sprite,75,100,25,1,270,India
993346,2024-01-09,205,classic yogurt,45,60,15,1,270,India
993346,2024-01-09,211,red bull,90,125,35,1,270,India
193709,2024-01-09,209,pepsi,75,100,25,1,498,India
666107,2024-01-09,201,paneer,210,340,130,1,265,India
666107,2024-01-09,204,strawberry yogurt,50,60,10,1,265,India
666107,2024-01-09,209,pepsi,75,100,25,1,265,India
666107,2024-01-09,205,classic yogurt,45,60,15,1,265,India
102718,2024-01-09,205,classic yogurt,45,60,15,1,284,India
102718,2024-01-09,206,yakult,360,400,40,1,284,India
102718,2024-01-09,204,strawberry yogurt,50,60,10,1,284,India
178696,2024-01-09,201,paneer,210,340,130,1,382,India
178696,2024-01-09,213,bisleri,6,15,9,1,382,India
178696,2024-01-09,209,pepsi,75,100,25,1,382,India
178696,2024-01-09,204,strawberry yogurt,50,60,10,1,382,India
795996,2024-01-09,202,milk,12,27,15,1,389,India
795996,2024-01-09,205,classic yogurt,45,60,15,1,389,India
989672,2024-01-09,201,paneer,210,340,130,1,17,India
989672,2024-01-09,210,mountain dew,75,100,25,1,17,India
989672,2024-01-09,213,bisleri,6,15,9,1,17,India
494166,2024-01-09,203,mango yogurt,50,60,10,1,384,India
494166,2024-01-09,206,yakult,360,400,40,1,384,India
947290,2024-01-09,213,bisleri,6,15,9,1,48,India
947290,2024-01-09,202,milk,12,27,15,1,48,India
588949,2024-01-09,206,yakult,360,400,40,1,306,India
704390,2024-01-09,203,mango yogurt,50,60,10,1,117,India
704390,2024-01-09,204,strawberry yogurt,50,60,10,1,117,India
704390,2024-01-09,201,paneer,210,340,130,1,117,India
481886,2024-01-09,206,yakult,360,400,40,1,312,India
481886,2024-01-09,210,mountain dew,75,100,25,1,312,India
922696,2024-01-09,213,bisleri,6,15,9,1,60,India
922696,2024-01-09,202,milk,12,27,15,1,60,India
922696,2024-01-09,204,strawberry yogurt,50,60,10,1,60,India
922696,2024-01-09,211,red bull,90,125,35,1,60,India
768118,2024-01-09,213,bisleri,6,15,9,1,20,India
836227,2024-01-09,201,paneer,210,340,130,1,243,India
836227,2024-01-09,208,sprite,75,100,25,1,243,India
875196,2024-01-09,210,mountain dew,75,100,25,1,299,India
650189,2024-01-09,203,mango yogurt,50,60,10,1,186,India
650189,2024-01-09,204,strawberry yogurt,50,60,10,1,186,India
650189,2024-01-09,211,red bull,90,125,35,1,186,India
550434,2024-01-09,206,yakult,360,400,40,1,137,India
129168,2024-01-09,205,classic yogurt,45,60,15,1,310,India
129168,2024-01-09,202,milk,12,27,15,1,310,India
129168,2024-01-09,211,red bull,90,125,35,1,310,India
129168,2024-01-09,210,mountain dew,75,100,25,1,310,India
307985,2024-01-09,202,milk,12,27,15,1,92,India
307985,2024-01-09,208,sprite,75,100,25,1,92,India
159861,2024-01-09,207,coca cola,75,100,25,1,324,India
159861,2024-01-09,209,pepsi,75,100,25,1,324,India
159861,2024-01-09,203,mango yogurt,50,60,10,1,324,India
176747,2024-01-09,202,milk,12,27,15,1,47,India
176747,2024-01-09,212,amul cheese,250,315,65,1,47,India
176747,2024-01-09,208,sprite,75,100,25,1,47,India
176747,2024-01-09,207,coca cola,75,100,25,1,47,India
828433,2024-01-09,201,paneer,210,340,130,1,152,India
828433,2024-01-09,205,classic yogurt,45,60,15,1,152,India
715146,2024-01-09,204,strawberry yogurt,50,60,10,1,244,India
715146,2024-01-09,205,classic yogurt,45,60,15,1,244,India
715146,2024-01-09,206,yakult,360,400,40,1,244,India
384044,2024-01-09,211,red bull,90,125,35,1,261,India
384044,2024-01-09,205,classic yogurt,45,60,15,1,261,India
384044,2024-01-09,210,mountain dew,75,100,25,1,261,India
384044,2024-01-09,213,bisleri,6,15,9,1,261,India
384044,2024-01-09,202,milk,12,27,15,1,261,India
812440,2024-01-09,213,bisleri,6,15,9,1,187,India
812440,2024-01-09,202,milk,12,27,15,1,187,India
812440,2024-01-09,212,amul cheese,250,315,65,1,187,India
812440,2024-01-09,201,paneer,210,340,130,1,187,India
812440,2024-01-09,210,mountain dew,75,100,25,1,187,India
887877,2024-01-09,208,sprite,75,100,25,1,252,India
777470,2024-01-09,208,sprite,75,100,25,1,355,India
777470,2024-01-09,210,mountain dew,75,100,25,1,355,India
599249,2024-01-09,204,strawberry yogurt,50,60,10,1,262,India
599249,2024-01-09,211,red bull,90,125,35,1,262,India
553604,2024-01-09,201,paneer,210,340,130,1,182,India
553604,2024-01-09,202,milk,12,27,15,1,182,India
553604,2024-01-09,213,bisleri,6,15,9,1,182,India
316452,2024-01-09,209,pepsi,75,100,25,1,62,India
316452,2024-01-09,206,yakult,360,400,40,1,62,India
316452,2024-01-09,203,mango yogurt,50,60,10,1,62,India
316452,2024-01-09,201,paneer,210,340,130,1,62,India
316452,2024-01-09,213,bisleri,6,15,9,1,62,India
195440,2024-01-09,206,yakult,360,400,40,1,114,India
195440,2024-01-09,201,paneer,210,340,130,1,114,India
207320,2024-01-09,204,strawberry yogurt,50,60,10,1,127,India
207320,2024-01-09,201,paneer,210,340,130,1,127,India
207320,2024-01-09,207,coca cola,75,100,25,1,127,India
207320,2024-01-09,212,amul cheese,250,315,65,1,127,India
666015,2024-01-09,202,milk,12,27,15,1,381,India
666015,2024-01-09,209,pepsi,75,100,25,1,381,India
666015,2024-01-09,212,amul cheese,250,315,65,1,381,India
591690,2024-01-09,207,coca cola,75,100,25,1,325,India
591690,2024-01-09,201,paneer,210,340,130,1,325,India
925707,2024-01-09,204,strawberry yogurt,50,60,10,1,47,India
925707,2024-01-09,212,amul cheese,250,315,65,1,47,India
375264,2024-01-09,203,mango yogurt,50,60,10,1,130,India
375264,2024-01-09,211,red bull,90,125,35,1,130,India
962614,2024-01-09,201,paneer,210,340,130,1,194,India
962614,2024-01-09,207,coca cola,75,100,25,1,194,India
962614,2024-01-09,204,strawberry yogurt,50,60,10,1,194,India
962614,2024-01-09,203,mango yogurt,50,60,10,1,194,India
923459,2024-01-09,211,red bull,90,125,35,1,223,India
923459,2024-01-09,202,milk,12,27,15,1,223,India
923459,2024-01-09,203,mango yogurt,50,60,10,1,223,India
923459,2024-01-09,204,strawberry yogurt,50,60,10,1,223,India
334057,2024-01-09,203,mango yogurt,50,60,10,1,60,India
334057,2024-01-09,213,bisleri,6,15,9,1,60,India
334057,2024-01-09,205,classic yogurt,45,60,15,1,60,India
334057,2024-01-09,211,red bull,90,125,35,1,60,India
503449,2024-01-09,210,mountain dew,75,100,25,1,474,India
168196,2024-01-09,210,mountain dew,75,100,25,1,55,India
168196,2024-01-09,202,milk,12,27,15,1,55,India
517271,2024-01-09,211,red bull,90,125,35,1,417,India
517271,2024-01-09,209,pepsi,75,100,25,1,417,India
517271,2024-01-09,206,yakult,360,400,40,1,417,India
824944,2024-01-09,210,mountain dew,75,100,25,1,170,India
824944,2024-01-09,208,sprite,75,100,25,1,170,India
404882,2024-01-09,203,mango yogurt,50,60,10,1,469,India
404882,2024-01-09,211,red bull,90,125,35,1,469,India
706887,2024-01-09,211,red bull,90,125,35,1,190,India
329633,2024-01-09,208,sprite,75,100,25,1,88,India
329633,2024-01-09,202,milk,12,27,15,1,88,India
733732,2024-01-10,203,mango yogurt,50,60,10,1,453,India
733732,2024-01-10,210,mountain dew,75,100,25,1,453,India
733732,2024-01-10,209,pepsi,75,100,25,1,453,India
337554,2024-01-10,207,coca cola,75,100,25,1,314,India
337554,2024-01-10,213,bisleri,6,15,9,1,314,India
558566,2024-01-10,203,mango yogurt,50,60,10,1,93,India
407211,2024-01-10,213,bisleri,6,15,9,1,133,India
407211,2024-01-10,212,amul cheese,250,315,65,1,133,India
407211,2024-01-10,205,classic yogurt,45,60,15,1,133,India
407211,2024-01-10,202,milk,12,27,15,1,133,India
407211,2024-01-10,203,mango yogurt,50,60,10,1,133,India
439228,2024-01-10,201,paneer,210,340,130,1,252,India
439228,2024-01-10,208,sprite,75,100,25,1,252,India
439228,2024-01-10,205,classic yogurt,45,60,15,1,252,India
387338,2024-01-10,211,red bull,90,125,35,1,110,India
387338,2024-01-10,202,milk,12,27,15,1,110,India
387338,2024-01-10,209,pepsi,75,100,25,1,110,India
387338,2024-01-10,210,mountain dew,75,100,25,1,110,India
104387,2024-01-10,210,mountain dew,75,100,25,1,262,India
104387,2024-01-10,211,red bull,90,125,35,1,262,India
217052,2024-01-10,202,milk,12,27,15,1,292,India
217052,2024-01-10,213,bisleri,6,15,9,1,292,India
935674,2024-01-10,212,amul cheese,250,315,65,1,369,India
992180,2024-01-10,202,milk,12,27,15,1,480,India
992180,2024-01-10,207,coca cola,75,100,25,1,480,India
913114,2024-01-10,208,sprite,75,100,25,1,23,India
913114,2024-01-10,205,classic yogurt,45,60,15,1,23,India
913114,2024-01-10,210,mountain dew,75,100,25,1,23,India
913114,2024-01-10,207,coca cola,75,100,25,1,23,India
819816,2024-01-10,204,strawberry yogurt,50,60,10,1,69,India
819816,2024-01-10,203,mango yogurt,50,60,10,1,69,India
300677,2024-01-10,207,coca cola,75,100,25,1,195,India
300677,2024-01-10,213,bisleri,6,15,9,1,195,India
637581,2024-01-10,203,mango yogurt,50,60,10,1,431,India
637581,2024-01-10,206,yakult,360,400,40,1,431,India
654261,2024-01-10,206,yakult,360,400,40,1,181,India
654261,2024-01-10,204,strawberry yogurt,50,60,10,1,181,India
737178,2024-01-10,207,coca cola,75,100,25,1,456,India
737178,2024-01-10,212,amul cheese,250,315,65,1,456,India
373427,2024-01-10,213,bisleri,6,15,9,1,432,India
373427,2024-01-10,203,mango yogurt,50,60,10,1,432,India
373427,2024-01-10,208,sprite,75,100,25,1,432,India
373427,2024-01-10,201,paneer,210,340,130,1,432,India
169263,2024-01-10,211,red bull,90,125,35,1,103,India
169263,2024-01-10,201,paneer,210,340,130,1,103,India
169263,2024-01-10,213,bisleri,6,15,9,1,103,India
840569,2024-01-10,210,mountain dew,75,100,25,1,440,India
840569,2024-01-10,208,sprite,75,100,25,1,440,India
518994,2024-01-10,211,red bull,90,125,35,1,315,India
518994,2024-01-10,207,coca cola,75,100,25,1,315,India
518994,2024-01-10,209,pepsi,75,100,25,1,315,India
518994,2024-01-10,202,milk,12,27,15,1,315,India
518994,2024-01-10,205,classic yogurt,45,60,15,1,315,India
889820,2024-01-10,208,sprite,75,100,25,1,295,India
889820,2024-01-10,202,milk,12,27,15,1,295,India
889820,2024-01-10,201,paneer,210,340,130,1,295,India
889820,2024-01-10,213,bisleri,6,15,9,1,295,India
829510,2024-01-10,204,strawberry yogurt,50,60,10,1,338,India
829510,2024-01-10,209,pepsi,75,100,25,1,338,India
454555,2024-01-10,206,yakult,360,400,40,1,407,India
454555,2024-01-10,205,classic yogurt,45,60,15,1,407,India
454555,2024-01-10,213,bisleri,6,15,9,1,407,India
454555,2024-01-10,209,pepsi,75,100,25,1,407,India
454555,2024-01-10,204,strawberry yogurt,50,60,10,1,407,India
154588,2024-01-10,211,red bull,90,125,35,1,430,India
154588,2024-01-10,212,amul cheese,250,315,65,1,430,India
642271,2024-01-10,202,milk,12,27,15,1,259,India
642271,2024-01-10,212,amul cheese,250,315,65,1,259,India
642271,2024-01-10,213,bisleri,6,15,9,1,259,India
642271,2024-01-10,209,pepsi,75,100,25,1,259,India
341764,2024-01-10,204,strawberry yogurt,50,60,10,1,247,India
341764,2024-01-10,209,pepsi,75,100,25,1,247,India
341764,2024-01-10,211,red bull,90,125,35,1,247,India
341764,2024-01-10,201,paneer,210,340,130,1,247,India
341764,2024-01-10,206,yakult,360,400,40,1,247,India
990066,2024-01-10,212,amul cheese,250,315,65,1,441,India
533650,2024-01-10,208,sprite,75,100,25,1,344,India
187861,2024-01-10,213,bisleri,6,15,9,1,439,India
237675,2024-01-10,211,red bull,90,125,35,1,117,India
237675,2024-01-10,207,coca cola,75,100,25,1,117,India
237675,2024-01-10,210,mountain dew,75,100,25,1,117,India
980773,2024-01-10,204,strawberry yogurt,50,60,10,1,301,India
980773,2024-01-10,208,sprite,75,100,25,1,301,India
980773,2024-01-10,209,pepsi,75,100,25,1,301,India
997867,2024-01-10,211,red bull,90,125,35,1,215,India
855595,2024-01-10,212,amul cheese,250,315,65,1,15,India
173298,2024-01-10,204,strawberry yogurt,50,60,10,1,340,India
173298,2024-01-10,207,coca cola,75,100,25,1,340,India
173298,2024-01-10,201,paneer,210,340,130,1,340,India
173298,2024-01-10,211,red bull,90,125,35,1,340,India
785180,2024-01-10,213,bisleri,6,15,9,1,171,India
785180,2024-01-10,210,mountain dew,75,100,25,1,171,India
942553,2024-01-10,208,sprite,75,100,25,1,193,India
942553,2024-01-10,201,paneer,210,340,130,1,193,India
608649,2024-01-10,204,strawberry yogurt,50,60,10,1,313,India
608649,2024-01-10,206,yakult,360,400,40,1,313,India
608649,2024-01-10,213,bisleri,6,15,9,1,313,India
815434,2024-01-10,201,paneer,210,340,130,1,184,India
815434,2024-01-10,205,classic yogurt,45,60,15,1,184,India
517380,2024-01-10,213,bisleri,6,15,9,1,419,India
517380,2024-01-10,210,mountain dew,75,100,25,1,419,India
611080,2024-01-10,202,milk,12,27,15,1,127,India
611080,2024-01-10,207,coca cola,75,100,25,1,127,India
611080,2024-01-10,209,pepsi,75,100,25,1,127,India
611080,2024-01-10,204,strawberry yogurt,50,60,10,1,127,India
563247,2024-01-10,211,red bull,90,125,35,1,159,India
563247,2024-01-10,203,mango yogurt,50,60,10,1,159,India
563247,2024-01-10,212,amul cheese,250,315,65,1,159,India
563247,2024-01-10,209,pepsi,75,100,25,1,159,India
954957,2024-01-10,201,paneer,210,340,130,1,72,India
954957,2024-01-10,211,red bull,90,125,35,1,72,India
954957,2024-01-10,208,sprite,75,100,25,1,72,India
693561,2024-01-10,204,strawberry yogurt,50,60,10,1,222,India
693561,2024-01-10,206,yakult,360,400,40,1,222,India
693561,2024-01-10,207,coca cola,75,100,25,1,222,India
246776,2024-01-10,211,red bull,90,125,35,1,29,India
246776,2024-01-10,210,mountain dew,75,100,25,1,29,India
246776,2024-01-10,206,yakult,360,400,40,1,29,India
246776,2024-01-10,205,classic yogurt,45,60,15,1,29,India
758155,2024-01-10,206,yakult,360,400,40,1,188,India
821375,2024-01-10,205,classic yogurt,45,60,15,1,99,India
821375,2024-01-10,206,yakult,360,400,40,1,99,India
821375,2024-01-10,208,sprite,75,100,25,1,99,India
961918,2024-01-10,213,bisleri,6,15,9,1,173,India
961918,2024-01-10,201,paneer,210,340,130,1,173,India
961918,2024-01-10,202,milk,12,27,15,1,173,India
961918,2024-01-10,207,coca cola,75,100,25,1,173,India
582882,2024-01-10,211,red bull,90,125,35,1,496,India
582882,2024-01-10,204,strawberry yogurt,50,60,10,1,496,India
645560,2024-01-10,213,bisleri,6,15,9,1,425,India
645560,2024-01-10,203,mango yogurt,50,60,10,1,425,India
645560,2024-01-10,204,strawberry yogurt,50,60,10,1,425,India
645560,2024-01-10,212,amul cheese,250,315,65,1,425,India
645560,2024-01-10,201,paneer,210,340,130,1,425,India
969040,2024-01-10,210,mountain dew,75,100,25,1,247,India
969040,2024-01-10,201,paneer,210,340,130,1,247,India
969040,2024-01-10,205,classic yogurt,45,60,15,1,247,India
969040,2024-01-10,206,yakult,360,400,40,1,247,India
575698,2024-01-10,207,coca cola,75,100,25,1,450,India
575698,2024-01-10,206,yakult,360,400,40,1,450,India
259117,2024-01-10,203,mango yogurt,50,60,10,1,306,India
259117,2024-01-10,213,bisleri,6,15,9,1,306,India
259117,2024-01-10,209,pepsi,75,100,25,1,306,India
508233,2024-01-10,212,amul cheese,250,315,65,1,302,India
508233,2024-01-10,207,coca cola,75,100,25,1,302,India
508233,2024-01-10,209,pepsi,75,100,25,1,302,India
508233,2024-01-10,206,yakult,360,400,40,1,302,India
342615,2024-01-10,209,pepsi,75,100,25,1,456,India
342615,2024-01-10,211,red bull,90,125,35,1,456,India
342615,2024-01-10,212,amul cheese,250,315,65,1,456,India
342615,2024-01-10,206,yakult,360,400,40,1,456,India
918254,2024-01-10,211,red bull,90,125,35,1,221,India
918254,2024-01-10,201,paneer,210,340,130,1,221,India
918254,2024-01-10,210,mountain dew,75,100,25,1,221,India
918254,2024-01-10,206,yakult,360,400,40,1,221,India
840193,2024-01-10,209,pepsi,75,100,25,1,54,India
840193,2024-01-10,205,classic yogurt,45,60,15,1,54,India
840193,2024-01-10,213,bisleri,6,15,9,1,54,India
140265,2024-01-10,206,yakult,360,400,40,1,161,India
140265,2024-01-10,210,mountain dew,75,100,25,1,161,India
140265,2024-01-10,205,classic yogurt,45,60,15,1,161,India
140265,2024-01-10,201,paneer,210,340,130,1,161,India
140265,2024-01-10,211,red bull,90,125,35,1,161,India
857244,2024-01-10,201,paneer,210,340,130,1,70,India
857244,2024-01-10,213,bisleri,6,15,9,1,70,India
857244,2024-01-10,208,sprite,75,100,25,1,70,India
857244,2024-01-10,203,mango yogurt,50,60,10,1,70,India
928990,2024-01-10,206,yakult,360,400,40,1,137,India
928990,2024-01-10,207,coca cola,75,100,25,1,137,India
225489,2024-01-10,210,mountain dew,75,100,25,1,262,India
225489,2024-01-10,209,pepsi,75,100,25,1,262,India
233296,2024-01-10,211,red bull,90,125,35,1,63,India
233296,2024-01-10,201,paneer,210,340,130,1,63,India
450487,2024-01-10,203,mango yogurt,50,60,10,1,350,India
741412,2024-01-10,208,sprite,75,100,25,1,54,India
741412,2024-01-10,202,milk,12,27,15,1,54,India
703556,2024-01-10,203,mango yogurt,50,60,10,1,439,India
703556,2024-01-10,209,pepsi,75,100,25,1,439,India
703556,2024-01-10,206,yakult,360,400,40,1,439,India
815612,2024-01-10,204,strawberry yogurt,50,60,10,1,299,India
815612,2024-01-10,202,milk,12,27,15,1,299,India
815612,2024-01-10,207,coca cola,75,100,25,1,299,India
948989,2024-01-10,209,pepsi,75,100,25,1,160,India
948989,2024-01-10,208,sprite,75,100,25,1,160,India
948989,2024-01-10,205,classic yogurt,45,60,15,1,160,India
311930,2024-01-10,209,pepsi,75,100,25,1,468,India
774865,2024-01-10,205,classic yogurt,45,60,15,1,4,India
774865,2024-01-10,206,yakult,360,400,40,1,4,India
774865,2024-01-10,209,pepsi,75,100,25,1,4,India
386019,2024-01-10,210,mountain dew,75,100,25,1,355,India
386019,2024-01-10,213,bisleri,6,15,9,1,355,India
386019,2024-01-10,211,red bull,90,125,35,1,355,India
386019,2024-01-10,212,amul cheese,250,315,65,1,355,India
446399,2024-01-10,202,milk,12,27,15,1,190,India
446399,2024-01-10,201,paneer,210,340,130,1,190,India
446399,2024-01-10,203,mango yogurt,50,60,10,1,190,India
446399,2024-01-10,205,classic yogurt,45,60,15,1,190,India
446399,2024-01-10,206,yakult,360,400,40,1,190,India
111388,2024-01-10,210,mountain dew,75,100,25,1,431,India
111388,2024-01-10,207,coca cola,75,100,25,1,431,India
850945,2024-01-10,209,pepsi,75,100,25,1,333,India
850945,2024-01-10,205,classic yogurt,45,60,15,1,333,India
850945,2024-01-10,210,mountain dew,75,100,25,1,333,India
836889,2024-01-10,202,milk,12,27,15,1,269,India
836889,2024-01-10,203,mango yogurt,50,60,10,1,269,India
590238,2024-01-10,206,yakult,360,400,40,1,326,India
590238,2024-01-10,201,paneer,210,340,130,1,326,India
590238,2024-01-10,203,mango yogurt,50,60,10,1,326,India
943694,2024-01-10,210,mountain dew,75,100,25,1,41,India
943694,2024-01-10,205,classic yogurt,45,60,15,1,41,India
943694,2024-01-10,201,paneer,210,340,130,1,41,India
480934,2024-01-10,203,mango yogurt,50,60,10,1,239,India
480934,2024-01-10,205,classic yogurt,45,60,15,1,239,India
636606,2024-01-10,206,yakult,360,400,40,1,167,India
255174,2024-01-10,213,bisleri,6,15,9,1,185,India
771456,2024-01-10,206,yakult,360,400,40,1,82,India
771456,2024-01-10,213,bisleri,6,15,9,1,82,India
771456,2024-01-10,204,strawberry yogurt,50,60,10,1,82,India
196101,2024-01-10,213,bisleri,6,15,9,1,373,India
196101,2024-01-10,211,red bull,90,125,35,1,373,India
113860,2024-01-10,211,red bull,90,125,35,1,322,India
376253,2024-01-10,210,mountain dew,75,100,25,1,117,India
376253,2024-01-10,203,mango yogurt,50,60,10,1,117,India
620639,2024-01-10,212,amul cheese,250,315,65,1,325,India
546615,2024-01-10,204,strawberry yogurt,50,60,10,1,280,India
137899,2024-01-10,210,mountain dew,75,100,25,1,363,India
137899,2024-01-10,204,strawberry yogurt,50,60,10,1,363,India
137899,2024-01-10,206,yakult,360,400,40,1,363,India
137899,2024-01-10,202,milk,12,27,15,1,363,India
943434,2024-01-10,207,coca cola,75,100,25,1,494,India
943434,2024-01-10,204,strawberry yogurt,50,60,10,1,494,India
943434,2024-01-10,211,red bull,90,125,35,1,494,India
467131,2024-01-10,206,yakult,360,400,40,1,342,India
467131,2024-01-10,205,classic yogurt,45,60,15,1,342,India
467131,2024-01-10,204,strawberry yogurt,50,60,10,1,342,India
435427,2024-01-10,211,red bull,90,125,35,1,106,India
435427,2024-01-10,210,mountain dew,75,100,25,1,106,India
435427,2024-01-10,201,paneer,210,340,130,1,106,India
771728,2024-01-10,204,strawberry yogurt,50,60,10,1,305,India
771728,2024-01-10,205,classic yogurt,45,60,15,1,305,India
348443,2024-01-10,211,red bull,90,125,35,1,30,India
949498,2024-01-10,203,mango yogurt,50,60,10,1,492,India
949498,2024-01-10,206,yakult,360,400,40,1,492,India
949498,2024-01-10,205,classic yogurt,45,60,15,1,492,India
564362,2024-01-10,209,pepsi,75,100,25,1,352,India
564362,2024-01-10,210,mountain dew,75,100,25,1,352,India
564362,2024-01-10,212,amul cheese,250,315,65,1,352,India
564362,2024-01-10,213,bisleri,6,15,9,1,352,India
866573,2024-01-10,205,classic yogurt,45,60,15,1,173,India
866573,2024-01-10,211,red bull,90,125,35,1,173,India
866573,2024-01-10,209,pepsi,75,100,25,1,173,India
572484,2024-01-10,213,bisleri,6,15,9,1,96,India
572484,2024-01-10,201,paneer,210,340,130,1,96,India
572484,2024-01-10,211,red bull,90,125,35,1,96,India
572484,2024-01-10,207,coca cola,75,100,25,1,96,India
997931,2024-01-10,201,paneer,210,340,130,1,55,India
997931,2024-01-10,206,yakult,360,400,40,1,55,India
997931,2024-01-10,211,red bull,90,125,35,1,55,India
997931,2024-01-10,204,strawberry yogurt,50,60,10,1,55,India
607332,2024-01-10,203,mango yogurt,50,60,10,1,432,India
975075,2024-01-11,213,bisleri,6,15,9,1,208,India
975075,2024-01-11,208,sprite,75,100,25,1,208,India
838083,2024-01-11,213,bisleri,6,15,9,1,444,India
838083,2024-01-11,202,milk,12,27,15,1,444,India
281600,2024-01-11,203,mango yogurt,50,60,10,1,35,India
281600,2024-01-11,211,red bull,90,125,35,1,35,India
281600,2024-01-11,212,amul cheese,250,315,65,1,35,India
829928,2024-01-11,205,classic yogurt,45,60,15,1,50,India
829928,2024-01-11,204,strawberry yogurt,50,60,10,1,50,India
829928,2024-01-11,209,pepsi,75,100,25,1,50,India
490163,2024-01-11,213,bisleri,6,15,9,1,35,India
490163,2024-01-11,208,sprite,75,100,25,1,35,India
490163,2024-01-11,206,yakult,360,400,40,1,35,India
490163,2024-01-11,202,milk,12,27,15,1,35,India
962222,2024-01-11,212,amul cheese,250,315,65,1,353,India
962222,2024-01-11,205,classic yogurt,45,60,15,1,353,India
962222,2024-01-11,201,paneer,210,340,130,1,353,India
272264,2024-01-11,204,strawberry yogurt,50,60,10,1,157,India
272264,2024-01-11,212,amul cheese,250,315,65,1,157,India
272264,2024-01-11,211,red bull,90,125,35,1,157,India
213272,2024-01-11,211,red bull,90,125,35,1,315,India
213272,2024-01-11,202,milk,12,27,15,1,315,India
260584,2024-01-11,212,amul cheese,250,315,65,1,67,India
260584,2024-01-11,208,sprite,75,100,25,1,67,India
260584,2024-01-11,201,paneer,210,340,130,1,67,India
260584,2024-01-11,207,coca cola,75,100,25,1,67,India
662833,2024-01-11,208,sprite,75,100,25,1,225,India
662833,2024-01-11,207,coca cola,75,100,25,1,225,India
405567,2024-01-11,213,bisleri,6,15,9,1,366,India
405567,2024-01-11,201,paneer,210,340,130,1,366,India
405567,2024-01-11,211,red bull,90,125,35,1,366,India
405567,2024-01-11,212,amul cheese,250,315,65,1,366,India
405567,2024-01-11,205,classic yogurt,45,60,15,1,366,India
718395,2024-01-11,201,paneer,210,340,130,1,1,India
718395,2024-01-11,210,mountain dew,75,100,25,1,1,India
323987,2024-01-11,201,paneer,210,340,130,1,67,India
323987,2024-01-11,209,pepsi,75,100,25,1,67,India
323987,2024-01-11,202,milk,12,27,15,1,67,India
323987,2024-01-11,204,strawberry yogurt,50,60,10,1,67,India
761579,2024-01-11,212,amul cheese,250,315,65,1,210,India
761579,2024-01-11,211,red bull,90,125,35,1,210,India
300569,2024-01-11,204,strawberry yogurt,50,60,10,1,60,India
562928,2024-01-11,210,mountain dew,75,100,25,1,400,India
479402,2024-01-11,201,paneer,210,340,130,1,323,India
778051,2024-01-11,206,yakult,360,400,40,1,53,India
778051,2024-01-11,202,milk,12,27,15,1,53,India
778051,2024-01-11,207,coca cola,75,100,25,1,53,India
944923,2024-01-11,208,sprite,75,100,25,1,108,India
944923,2024-01-11,204,strawberry yogurt,50,60,10,1,108,India
944923,2024-01-11,207,coca cola,75,100,25,1,108,India
932917,2024-01-11,210,mountain dew,75,100,25,1,194,India
932917,2024-01-11,202,milk,12,27,15,1,194,India
932917,2024-01-11,203,mango yogurt,50,60,10,1,194,India
932917,2024-01-11,208,sprite,75,100,25,1,194,India
579312,2024-01-11,209,pepsi,75,100,25,1,309,India
579312,2024-01-11,203,mango yogurt,50,60,10,1,309,India
157061,2024-01-11,211,red bull,90,125,35,1,104,India
157061,2024-01-11,207,coca cola,75,100,25,1,104,India
157061,2024-01-11,213,bisleri,6,15,9,1,104,India
605820,2024-01-11,207,coca cola,75,100,25,1,132,India
605820,2024-01-11,209,pepsi,75,100,25,1,132,India
605820,2024-01-11,202,milk,12,27,15,1,132,India
605820,2024-01-11,205,classic yogurt,45,60,15,1,132,India
592434,2024-01-11,201,paneer,210,340,130,1,13,India
592434,2024-01-11,208,sprite,75,100,25,1,13,India
592434,2024-01-11,211,red bull,90,125,35,1,13,India
592434,2024-01-11,210,mountain dew,75,100,25,1,13,India
235566,2024-01-11,212,amul cheese,250,315,65,1,42,India
235566,2024-01-11,206,yakult,360,400,40,1,42,India
577506,2024-01-11,206,yakult,360,400,40,1,151,India
577506,2024-01-11,201,paneer,210,340,130,1,151,India
577506,2024-01-11,211,red bull,90,125,35,1,151,India
577506,2024-01-11,210,mountain dew,75,100,25,1,151,India
472591,2024-01-11,208,sprite,75,100,25,1,224,India
472591,2024-01-11,202,milk,12,27,15,1,224,India
472591,2024-01-11,205,classic yogurt,45,60,15,1,224,India
524417,2024-01-11,209,pepsi,75,100,25,1,84,India
524417,2024-01-11,211,red bull,90,125,35,1,84,India
524417,2024-01-11,210,mountain dew,75,100,25,1,84,India
401379,2024-01-11,207,coca cola,75,100,25,1,499,India
401379,2024-01-11,202,milk,12,27,15,1,499,India
834286,2024-01-11,207,coca cola,75,100,25,1,149,India
541562,2024-01-11,209,pepsi,75,100,25,1,466,India
541562,2024-01-11,210,mountain dew,75,100,25,1,466,India
541562,2024-01-11,213,bisleri,6,15,9,1,466,India
541562,2024-01-11,204,strawberry yogurt,50,60,10,1,466,India
433876,2024-01-11,206,yakult,360,400,40,1,298,India
854058,2024-01-11,202,milk,12,27,15,1,352,India
856192,2024-01-11,207,coca cola,75,100,25,1,398,India
856192,2024-01-11,202,milk,12,27,15,1,398,India
856192,2024-01-11,208,sprite,75,100,25,1,398,India
856192,2024-01-11,203,mango yogurt,50,60,10,1,398,India
856192,2024-01-11,213,bisleri,6,15,9,1,398,India
742924,2024-01-11,211,red bull,90,125,35,1,307,India
742924,2024-01-11,209,pepsi,75,100,25,1,307,India
869832,2024-01-11,209,pepsi,75,100,25,1,220,India
869832,2024-01-11,211,red bull,90,125,35,1,220,India
869832,2024-01-11,208,sprite,75,100,25,1,220,India
748052,2024-01-11,206,yakult,360,400,40,1,205,India
748052,2024-01-11,211,red bull,90,125,35,1,205,India
748052,2024-01-11,201,paneer,210,340,130,1,205,India
518730,2024-01-11,211,red bull,90,125,35,1,395,India
605282,2024-01-11,211,red bull,90,125,35,1,178,India
605282,2024-01-11,205,classic yogurt,45,60,15,1,178,India
605282,2024-01-11,212,amul cheese,250,315,65,1,178,India
605282,2024-01-11,207,coca cola,75,100,25,1,178,India
466933,2024-01-11,204,strawberry yogurt,50,60,10,1,257,India
466933,2024-01-11,203,mango yogurt,50,60,10,1,257,India
466933,2024-01-11,213,bisleri,6,15,9,1,257,India
466933,2024-01-11,206,yakult,360,400,40,1,257,India
480251,2024-01-11,212,amul cheese,250,315,65,1,4,India
480251,2024-01-11,204,strawberry yogurt,50,60,10,1,4,India
110682,2024-01-11,201,paneer,210,340,130,1,209,India
110682,2024-01-11,210,mountain dew,75,100,25,1,209,India
763962,2024-01-11,212,amul cheese,250,315,65,1,39,India
763962,2024-01-11,205,classic yogurt,45,60,15,1,39,India
763962,2024-01-11,207,coca cola,75,100,25,1,39,India
763962,2024-01-11,213,bisleri,6,15,9,1,39,India
751761,2024-01-11,201,paneer,210,340,130,1,425,India
520220,2024-01-11,207,coca cola,75,100,25,1,260,India
520220,2024-01-11,202,milk,12,27,15,1,260,India
359774,2024-01-11,203,mango yogurt,50,60,10,1,171,India
851420,2024-01-11,204,strawberry yogurt,50,60,10,1,240,India
851420,2024-01-11,210,mountain dew,75,100,25,1,240,India
337843,2024-01-11,209,pepsi,75,100,25,1,62,India
313736,2024-01-11,201,paneer,210,340,130,1,325,India
313736,2024-01-11,207,coca cola,75,100,25,1,325,India
313736,2024-01-11,206,yakult,360,400,40,1,325,India
313736,2024-01-11,212,amul cheese,250,315,65,1,325,India
313736,2024-01-11,204,strawberry yogurt,50,60,10,1,325,India
946229,2024-01-11,201,paneer,210,340,130,1,384,India
776327,2024-01-11,201,paneer,210,340,130,1,450,India
776327,2024-01-11,210,mountain dew,75,100,25,1,450,India
315295,2024-01-11,210,mountain dew,75,100,25,1,363,India
793831,2024-01-11,202,milk,12,27,15,1,378,India
793831,2024-01-11,207,coca cola,75,100,25,1,378,India
793831,2024-01-11,213,bisleri,6,15,9,1,378,India
156025,2024-01-11,204,strawberry yogurt,50,60,10,1,205,India
156025,2024-01-11,203,mango yogurt,50,60,10,1,205,India
156025,2024-01-11,202,milk,12,27,15,1,205,India
718405,2024-01-11,211,red bull,90,125,35,1,49,India
191240,2024-01-11,209,pepsi,75,100,25,1,44,India
191240,2024-01-11,212,amul cheese,250,315,65,1,44,India
191240,2024-01-11,203,mango yogurt,50,60,10,1,44,India
191240,2024-01-11,206,yakult,360,400,40,1,44,India
229273,2024-01-11,209,pepsi,75,100,25,1,188,India
229273,2024-01-11,206,yakult,360,400,40,1,188,India
229273,2024-01-11,210,mountain dew,75,100,25,1,188,India
229273,2024-01-11,204,strawberry yogurt,50,60,10,1,188,India
837987,2024-01-11,212,amul cheese,250,315,65,1,153,India
507994,2024-01-11,203,mango yogurt,50,60,10,1,408,India
507994,2024-01-11,212,amul cheese,250,315,65,1,408,India
507994,2024-01-11,202,milk,12,27,15,1,408,India
507994,2024-01-11,206,yakult,360,400,40,1,408,India
127406,2024-01-11,206,yakult,360,400,40,1,381,India
808258,2024-01-11,203,mango yogurt,50,60,10,1,449,India
808258,2024-01-11,213,bisleri,6,15,9,1,449,India
808258,2024-01-11,208,sprite,75,100,25,1,449,India
808258,2024-01-11,207,coca cola,75,100,25,1,449,India
701499,2024-01-11,210,mountain dew,75,100,25,1,331,India
701499,2024-01-11,203,mango yogurt,50,60,10,1,331,India
568275,2024-01-11,208,sprite,75,100,25,1,336,India
568275,2024-01-11,204,strawberry yogurt,50,60,10,1,336,India
568275,2024-01-11,205,classic yogurt,45,60,15,1,336,India
568275,2024-01-11,201,paneer,210,340,130,1,336,India
505029,2024-01-11,201,paneer,210,340,130,1,281,India
505029,2024-01-11,209,pepsi,75,100,25,1,281,India
505029,2024-01-11,204,strawberry yogurt,50,60,10,1,281,India
505029,2024-01-11,203,mango yogurt,50,60,10,1,281,India
505029,2024-01-11,207,coca cola,75,100,25,1,281,India
284649,2024-01-11,202,milk,12,27,15,1,371,India
284649,2024-01-11,203,mango yogurt,50,60,10,1,371,India
284649,2024-01-11,208,sprite,75,100,25,1,371,India
284649,2024-01-11,213,bisleri,6,15,9,1,371,India
284649,2024-01-11,211,red bull,90,125,35,1,371,India
425737,2024-01-11,206,yakult,360,400,40,1,274,India
425737,2024-01-11,212,amul cheese,250,315,65,1,274,India
425737,2024-01-11,209,pepsi,75,100,25,1,274,India
528578,2024-01-11,205,classic yogurt,45,60,15,1,355,India
528578,2024-01-11,208,sprite,75,100,25,1,355,India
528578,2024-01-11,206,yakult,360,400,40,1,355,India
528578,2024-01-11,204,strawberry yogurt,50,60,10,1,355,India
528578,2024-01-11,211,red bull,90,125,35,1,355,India
577834,2024-01-11,205,classic yogurt,45,60,15,1,48,India
577834,2024-01-11,210,mountain dew,75,100,25,1,48,India
577834,2024-01-11,212,amul cheese,250,315,65,1,48,India
449732,2024-01-11,206,yakult,360,400,40,1,260,India
962431,2024-01-11,213,bisleri,6,15,9,1,166,India
962431,2024-01-11,204,strawberry yogurt,50,60,10,1,166,India
418558,2024-01-11,211,red bull,90,125,35,1,95,India
418558,2024-01-11,205,classic yogurt,45,60,15,1,95,India
418558,2024-01-11,207,coca cola,75,100,25,1,95,India
418558,2024-01-11,202,milk,12,27,15,1,95,India
736994,2024-01-11,207,coca cola,75,100,25,1,64,India
736994,2024-01-11,203,mango yogurt,50,60,10,1,64,India
736994,2024-01-11,210,mountain dew,75,100,25,1,64,India
840021,2024-01-11,202,milk,12,27,15,1,128,India
840021,2024-01-11,204,strawberry yogurt,50,60,10,1,128,India
840021,2024-01-11,203,mango yogurt,50,60,10,1,128,India
840021,2024-01-11,211,red bull,90,125,35,1,128,India
636451,2024-01-11,204,strawberry yogurt,50,60,10,1,387,India
636451,2024-01-11,205,classic yogurt,45,60,15,1,387,India
636451,2024-01-11,202,milk,12,27,15,1,387,India
909651,2024-01-11,209,pepsi,75,100,25,1,287,India
909651,2024-01-11,205,classic yogurt,45,60,15,1,287,India
206353,2024-01-11,213,bisleri,6,15,9,1,167,India
206353,2024-01-11,205,classic yogurt,45,60,15,1,167,India
206353,2024-01-11,210,mountain dew,75,100,25,1,167,India
206353,2024-01-11,207,coca cola,75,100,25,1,167,India
499293,2024-01-11,209,pepsi,75,100,25,1,400,India
499293,2024-01-11,213,bisleri,6,15,9,1,400,India
499293,2024-01-11,211,red bull,90,125,35,1,400,India
412843,2024-01-11,207,coca cola,75,100,25,1,71,India
412843,2024-01-11,204,strawberry yogurt,50,60,10,1,71,India
261428,2024-01-11,201,paneer,210,340,130,1,256,India
261428,2024-01-11,203,mango yogurt,50,60,10,1,256,India
261428,2024-01-11,213,bisleri,6,15,9,1,256,India
261428,2024-01-11,212,amul cheese,250,315,65,1,256,India
261428,2024-01-11,205,classic yogurt,45,60,15,1,256,India
821447,2024-01-11,206,yakult,360,400,40,1,338,India
821447,2024-01-11,211,red bull,90,125,35,1,338,India
571052,2024-01-11,206,yakult,360,400,40,1,293,India
571052,2024-01-11,211,red bull,90,125,35,1,293,India
412796,2024-01-11,210,mountain dew,75,100,25,1,392,India
120778,2024-01-11,203,mango yogurt,50,60,10,1,193,India
120778,2024-01-11,213,bisleri,6,15,9,1,193,India
120778,2024-01-11,205,classic yogurt,45,60,15,1,193,India
491559,2024-01-11,212,amul cheese,250,315,65,1,82,India
491559,2024-01-11,204,strawberry yogurt,50,60,10,1,82,India
600337,2024-01-12,210,mountain dew,75,100,25,1,350,India
523846,2024-01-12,204,strawberry yogurt,50,60,10,1,213,India
981651,2024-01-12,213,bisleri,6,15,9,1,168,India
981651,2024-01-12,202,milk,12,27,15,1,168,India
981651,2024-01-12,206,yakult,360,400,40,1,168,India
938600,2024-01-12,205,classic yogurt,45,60,15,1,92,India
938600,2024-01-12,212,amul cheese,250,315,65,1,92,India
938600,2024-01-12,204,strawberry yogurt,50,60,10,1,92,India
661949,2024-01-12,209,pepsi,75,100,25,1,375,India
661949,2024-01-12,207,coca cola,75,100,25,1,375,India
979572,2024-01-12,209,pepsi,75,100,25,1,303,India
653953,2024-01-12,202,milk,12,27,15,1,142,India
436787,2024-01-12,210,mountain dew,75,100,25,1,224,India
436787,2024-01-12,207,coca cola,75,100,25,1,224,India
436787,2024-01-12,205,classic yogurt,45,60,15,1,224,India
803112,2024-01-12,205,classic yogurt,45,60,15,1,47,India
803112,2024-01-12,206,yakult,360,400,40,1,47,India
803112,2024-01-12,208,sprite,75,100,25,1,47,India
803112,2024-01-12,210,mountain dew,75,100,25,1,47,India
654800,2024-01-12,208,sprite,75,100,25,1,374,India
654800,2024-01-12,210,mountain dew,75,100,25,1,374,India
654800,2024-01-12,213,bisleri,6,15,9,1,374,India
664247,2024-01-12,201,paneer,210,340,130,1,366,India
664247,2024-01-12,208,sprite,75,100,25,1,366,India
664247,2024-01-12,213,bisleri,6,15,9,1,366,India
853967,2024-01-12,208,sprite,75,100,25,1,414,India
853967,2024-01-12,201,paneer,210,340,130,1,414,India
853967,2024-01-12,202,milk,12,27,15,1,414,India
972108,2024-01-12,211,red bull,90,125,35,1,190,India
972108,2024-01-12,203,mango yogurt,50,60,10,1,190,India
972108,2024-01-12,210,mountain dew,75,100,25,1,190,India
972108,2024-01-12,208,sprite,75,100,25,1,190,India
527582,2024-01-12,208,sprite,75,100,25,1,98,India
527582,2024-01-12,211,red bull,90,125,35,1,98,India
527582,2024-01-12,204,strawberry yogurt,50,60,10,1,98,India
527582,2024-01-12,205,classic yogurt,45,60,15,1,98,India
801039,2024-01-12,203,mango yogurt,50,60,10,1,276,India
801039,2024-01-12,204,strawberry yogurt,50,60,10,1,276,India
801039,2024-01-12,205,classic yogurt,45,60,15,1,276,India
137540,2024-01-12,203,mango yogurt,50,60,10,1,95,India
137540,2024-01-12,206,yakult,360,400,40,1,95,India
137540,2024-01-12,208,sprite,75,100,25,1,95,India
137540,2024-01-12,202,milk,12,27,15,1,95,India
691413,2024-01-12,203,mango yogurt,50,60,10,1,395,India
691413,2024-01-12,212,amul cheese,250,315,65,1,395,India
508740,2024-01-12,210,mountain dew,75,100,25,1,413,India
519782,2024-01-12,202,milk,12,27,15,1,310,India
519782,2024-01-12,210,mountain dew,75,100,25,1,310,India
685315,2024-01-12,201,paneer,210,340,130,1,211,India
685315,2024-01-12,213,bisleri,6,15,9,1,211,India
685315,2024-01-12,209,pepsi,75,100,25,1,211,India
685315,2024-01-12,207,coca cola,75,100,25,1,211,India
195480,2024-01-12,210,mountain dew,75,100,25,1,14,India
245307,2024-01-12,206,yakult,360,400,40,1,105,India
245307,2024-01-12,203,mango yogurt,50,60,10,1,105,India
961947,2024-01-12,205,classic yogurt,45,60,15,1,351,India
961947,2024-01-12,204,strawberry yogurt,50,60,10,1,351,India
961947,2024-01-12,202,milk,12,27,15,1,351,India
828063,2024-01-12,207,coca cola,75,100,25,1,260,India
828063,2024-01-12,203,mango yogurt,50,60,10,1,260,India
862421,2024-01-12,209,pepsi,75,100,25,1,98,India
862421,2024-01-12,206,yakult,360,400,40,1,98,India
862421,2024-01-12,203,mango yogurt,50,60,10,1,98,India
691337,2024-01-12,206,yakult,360,400,40,1,35,India
354286,2024-01-12,202,milk,12,27,15,1,332,India
354286,2024-01-12,208,sprite,75,100,25,1,332,India
354286,2024-01-12,204,strawberry yogurt,50,60,10,1,332,India
354286,2024-01-12,209,pepsi,75,100,25,1,332,India
581849,2024-01-12,208,sprite,75,100,25,1,439,India
581849,2024-01-12,206,yakult,360,400,40,1,439,India
581849,2024-01-12,201,paneer,210,340,130,1,439,India
581849,2024-01-12,211,red bull,90,125,35,1,439,India
259960,2024-01-12,202,milk,12,27,15,1,499,India
259960,2024-01-12,211,red bull,90,125,35,1,499,India
164895,2024-01-12,207,coca cola,75,100,25,1,165,India
164895,2024-01-12,206,yakult,360,400,40,1,165,India
536023,2024-01-12,203,mango yogurt,50,60,10,1,219,India
536023,2024-01-12,212,amul cheese,250,315,65,1,219,India
536023,2024-01-12,206,yakult,360,400,40,1,219,India
536023,2024-01-12,208,sprite,75,100,25,1,219,India
384656,2024-01-12,207,coca cola,75,100,25,1,100,India
543475,2024-01-12,201,paneer,210,340,130,1,42,India
543475,2024-01-12,213,bisleri,6,15,9,1,42,India
543475,2024-01-12,207,coca cola,75,100,25,1,42,India
543475,2024-01-12,211,red bull,90,125,35,1,42,India
150048,2024-01-12,210,mountain dew,75,100,25,1,223,India
431154,2024-01-12,208,sprite,75,100,25,1,227,India
431154,2024-01-12,206,yakult,360,400,40,1,227,India
431154,2024-01-12,203,mango yogurt,50,60,10,1,227,India
715812,2024-01-12,207,coca cola,75,100,25,1,167,India
715812,2024-01-12,212,amul cheese,250,315,65,1,167,India
715812,2024-01-12,210,mountain dew,75,100,25,1,167,India
245002,2024-01-12,208,sprite,75,100,25,1,267,India
245002,2024-01-12,207,coca cola,75,100,25,1,267,India
245002,2024-01-12,212,amul cheese,250,315,65,1,267,India
173119,2024-01-12,209,pepsi,75,100,25,1,347,India
846104,2024-01-12,203,mango yogurt,50,60,10,1,345,India
846104,2024-01-12,205,classic yogurt,45,60,15,1,345,India
846104,2024-01-12,206,yakult,360,400,40,1,345,India
983309,2024-01-12,209,pepsi,75,100,25,1,165,India
983309,2024-01-12,203,mango yogurt,50,60,10,1,165,India
538127,2024-01-12,204,strawberry yogurt,50,60,10,1,357,India
538127,2024-01-12,208,sprite,75,100,25,1,357,India
727443,2024-01-12,204,strawberry yogurt,50,60,10,1,162,India
559985,2024-01-12,213,bisleri,6,15,9,1,481,India
559985,2024-01-12,204,strawberry yogurt,50,60,10,1,481,India
559985,2024-01-12,206,yakult,360,400,40,1,481,India
559985,2024-01-12,202,milk,12,27,15,1,481,India
699345,2024-01-12,213,bisleri,6,15,9,1,375,India
699345,2024-01-12,206,yakult,360,400,40,1,375,India
699345,2024-01-12,208,sprite,75,100,25,1,375,India
699345,2024-01-12,209,pepsi,75,100,25,1,375,India
979256,2024-01-12,209,pepsi,75,100,25,1,450,India
979256,2024-01-12,212,amul cheese,250,315,65,1,450,India
979256,2024-01-12,204,strawberry yogurt,50,60,10,1,450,India
979256,2024-01-12,208,sprite,75,100,25,1,450,India
224802,2024-01-12,202,milk,12,27,15,1,447,India
224802,2024-01-12,207,coca cola,75,100,25,1,447,India
763834,2024-01-12,210,mountain dew,75,100,25,1,85,India
600813,2024-01-12,201,paneer,210,340,130,1,132,India
600813,2024-01-12,208,sprite,75,100,25,1,132,India
600813,2024-01-12,212,amul cheese,250,315,65,1,132,India
600813,2024-01-12,213,bisleri,6,15,9,1,132,India
482574,2024-01-12,213,bisleri,6,15,9,1,308,India
482574,2024-01-12,211,red bull,90,125,35,1,308,India
482574,2024-01-12,202,milk,12,27,15,1,308,India
482574,2024-01-12,207,coca cola,75,100,25,1,308,India
724925,2024-01-12,208,sprite,75,100,25,1,316,India
724925,2024-01-12,210,mountain dew,75,100,25,1,316,India
724925,2024-01-12,212,amul cheese,250,315,65,1,316,India
724925,2024-01-12,204,strawberry yogurt,50,60,10,1,316,India
854267,2024-01-12,210,mountain dew,75,100,25,1,367,India
854267,2024-01-12,208,sprite,75,100,25,1,367,India
601887,2024-01-12,206,yakult,360,400,40,1,207,India
601887,2024-01-12,209,pepsi,75,100,25,1,207,India
263149,2024-01-12,207,coca cola,75,100,25,1,135,India
263149,2024-01-12,211,red bull,90,125,35,1,135,India
263149,2024-01-12,205,classic yogurt,45,60,15,1,135,India
263149,2024-01-12,210,mountain dew,75,100,25,1,135,India
888220,2024-01-12,207,coca cola,75,100,25,1,166,India
888220,2024-01-12,206,yakult,360,400,40,1,166,India
888220,2024-01-12,204,strawberry yogurt,50,60,10,1,166,India
198351,2024-01-12,201,paneer,210,340,130,1,124,India
198351,2024-01-12,211,red bull,90,125,35,1,124,India
198351,2024-01-12,205,classic yogurt,45,60,15,1,124,India
198351,2024-01-12,210,mountain dew,75,100,25,1,124,India
885179,2024-01-12,204,strawberry yogurt,50,60,10,1,179,India
885179,2024-01-12,208,sprite,75,100,25,1,179,India
885179,2024-01-12,213,bisleri,6,15,9,1,179,India
885179,2024-01-12,210,mountain dew,75,100,25,1,179,India
888864,2024-01-12,203,mango yogurt,50,60,10,1,279,India
811268,2024-01-12,207,coca cola,75,100,25,1,232,India
811268,2024-01-12,204,strawberry yogurt,50,60,10,1,232,India
811268,2024-01-12,210,mountain dew,75,100,25,1,232,India
744377,2024-01-12,203,mango yogurt,50,60,10,1,306,India
495447,2024-01-12,201,paneer,210,340,130,1,381,India
495447,2024-01-12,208,sprite,75,100,25,1,381,India
495447,2024-01-12,209,pepsi,75,100,25,1,381,India
495447,2024-01-12,210,mountain dew,75,100,25,1,381,India
849017,2024-01-12,206,yakult,360,400,40,1,284,India
769411,2024-01-12,207,coca cola,75,100,25,1,66,India
769411,2024-01-12,212,amul cheese,250,315,65,1,66,India
166841,2024-01-12,204,strawberry yogurt,50,60,10,1,47,India
166841,2024-01-12,207,coca cola,75,100,25,1,47,India
166841,2024-01-12,211,red bull,90,125,35,1,47,India
167222,2024-01-12,210,mountain dew,75,100,25,1,51,India
167222,2024-01-12,207,coca cola,75,100,25,1,51,India
702078,2024-01-12,209,pepsi,75,100,25,1,212,India
702078,2024-01-12,201,paneer,210,340,130,1,212,India
702078,2024-01-12,211,red bull,90,125,35,1,212,India
826143,2024-01-12,213,bisleri,6,15,9,1,256,India
826143,2024-01-12,211,red bull,90,125,35,1,256,India
826143,2024-01-12,210,mountain dew,75,100,25,1,256,India
826143,2024-01-12,207,coca cola,75,100,25,1,256,India
380090,2024-01-12,201,paneer,210,340,130,1,442,India
380090,2024-01-12,208,sprite,75,100,25,1,442,India
755131,2024-01-12,205,classic yogurt,45,60,15,1,75,India
755131,2024-01-12,202,milk,12,27,15,1,75,India
565726,2024-01-12,201,paneer,210,340,130,1,185,India
370074,2024-01-12,209,pepsi,75,100,25,1,371,India
370074,2024-01-12,203,mango yogurt,50,60,10,1,371,India
636849,2024-01-12,206,yakult,360,400,40,1,435,India
665893,2024-01-12,204,strawberry yogurt,50,60,10,1,105,India
665893,2024-01-12,207,coca cola,75,100,25,1,105,India
711625,2024-01-12,207,coca cola,75,100,25,1,220,India
711625,2024-01-12,208,sprite,75,100,25,1,220,India
711625,2024-01-12,203,mango yogurt,50,60,10,1,220,India
810942,2024-01-12,205,classic yogurt,45,60,15,1,20,India
810942,2024-01-12,207,coca cola,75,100,25,1,20,India
810942,2024-01-12,203,mango yogurt,50,60,10,1,20,India
856010,2024-01-12,206,yakult,360,400,40,1,315,India
750095,2024-01-12,205,classic yogurt,45,60,15,1,17,India
750095,2024-01-12,201,paneer,210,340,130,1,17,India
750095,2024-01-12,209,pepsi,75,100,25,1,17,India
750095,2024-01-12,207,coca cola,75,100,25,1,17,India
226153,2024-01-12,208,sprite,75,100,25,1,371,India
226153,2024-01-12,202,milk,12,27,15,1,371,India
226153,2024-01-12,205,classic yogurt,45,60,15,1,371,India
173956,2024-01-12,210,mountain dew,75,100,25,1,350,India
227450,2024-01-12,201,paneer,210,340,130,1,185,India
227450,2024-01-12,210,mountain dew,75,100,25,1,185,India
227450,2024-01-12,206,yakult,360,400,40,1,185,India
227450,2024-01-12,211,red bull,90,125,35,1,185,India
914217,2024-01-12,202,milk,12,27,15,1,86,India
907597,2024-01-12,204,strawberry yogurt,50,60,10,1,316,India
907597,2024-01-12,209,pepsi,75,100,25,1,316,India
271471,2024-01-12,205,classic yogurt,45,60,15,1,202,India
160226,2024-01-12,212,amul cheese,250,315,65,1,248,India
160226,2024-01-12,206,yakult,360,400,40,1,248,India
160226,2024-01-12,208,sprite,75,100,25,1,248,India
160226,2024-01-12,207,coca cola,75,100,25,1,248,India
462027,2024-01-12,206,yakult,360,400,40,1,400,India
462027,2024-01-12,205,classic yogurt,45,60,15,1,400,India
417516,2024-01-12,204,strawberry yogurt,50,60,10,1,227,India
417516,2024-01-12,209,pepsi,75,100,25,1,227,India
417516,2024-01-12,211,red bull,90,125,35,1,227,India
696155,2024-01-12,205,classic yogurt,45,60,15,1,103,India
696155,2024-01-12,203,mango yogurt,50,60,10,1,103,India
274252,2024-01-12,202,milk,12,27,15,1,487,India
274252,2024-01-12,206,yakult,360,400,40,1,487,India
274252,2024-01-12,203,mango yogurt,50,60,10,1,487,India
274252,2024-01-12,211,red bull,90,125,35,1,487,India
414187,2024-01-12,203,mango yogurt,50,60,10,1,200,India
414187,2024-01-12,208,sprite,75,100,25,1,200,India
414187,2024-01-12,213,bisleri,6,15,9,1,200,India
778084,2024-01-12,208,sprite,75,100,25,1,220,India
778084,2024-01-12,209,pepsi,75,100,25,1,220,India
778084,2024-01-12,213,bisleri,6,15,9,1,220,India
203852,2024-01-12,205,classic yogurt,45,60,15,1,144,India
910788,2024-01-12,209,pepsi,75,100,25,1,497,India
910788,2024-01-12,213,bisleri,6,15,9,1,497,India
910788,2024-01-12,212,amul cheese,250,315,65,1,497,India
910788,2024-01-12,208,sprite,75,100,25,1,497,India
910788,2024-01-12,202,milk,12,27,15,1,497,India
852743,2024-01-12,207,coca cola,75,100,25,1,188,India
852743,2024-01-12,206,yakult,360,400,40,1,188,India
852743,2024-01-12,213,bisleri,6,15,9,1,188,India
346499,2024-01-12,213,bisleri,6,15,9,1,427,India
346499,2024-01-12,201,paneer,210,340,130,1,427,India
346499,2024-01-12,206,yakult,360,400,40,1,427,India
749662,2024-01-12,207,coca cola,75,100,25,1,346,India
749662,2024-01-12,213,bisleri,6,15,9,1,346,India
749662,2024-01-12,206,yakult,360,400,40,1,346,India
749662,2024-01-12,209,pepsi,75,100,25,1,346,India
541742,2024-01-12,210,mountain dew,75,100,25,1,270,India
541742,2024-01-12,208,sprite,75,100,25,1,270,India
541742,2024-01-12,211,red bull,90,125,35,1,270,India
541742,2024-01-12,209,pepsi,75,100,25,1,270,India
541742,2024-01-12,205,classic yogurt,45,60,15,1,270,India
520269,2024-01-12,202,milk,12,27,15,1,262,India
520269,2024-01-12,206,yakult,360,400,40,1,262,India
366947,2024-01-13,212,amul cheese,250,315,65,1,58,India
366947,2024-01-13,204,strawberry yogurt,50,60,10,1,58,India
366947,2024-01-13,208,sprite,75,100,25,1,58,India
366947,2024-01-13,201,paneer,210,340,130,1,58,India
331123,2024-01-13,210,mountain dew,75,100,25,1,424,India
331123,2024-01-13,206,yakult,360,400,40,1,424,India
331123,2024-01-13,202,milk,12,27,15,1,424,India
730003,2024-01-13,202,milk,12,27,15,1,138,India
730003,2024-01-13,204,strawberry yogurt,50,60,10,1,138,India
760874,2024-01-13,213,bisleri,6,15,9,1,255,India
411796,2024-01-13,211,red bull,90,125,35,1,188,India
411796,2024-01-13,206,yakult,360,400,40,1,188,India
411796,2024-01-13,213,bisleri,6,15,9,1,188,India
411796,2024-01-13,210,mountain dew,75,100,25,1,188,India
411796,2024-01-13,204,strawberry yogurt,50,60,10,1,188,India
444767,2024-01-13,205,classic yogurt,45,60,15,1,339,India
444767,2024-01-13,210,mountain dew,75,100,25,1,339,India
444767,2024-01-13,206,yakult,360,400,40,1,339,India
444767,2024-01-13,202,milk,12,27,15,1,339,India
444767,2024-01-13,208,sprite,75,100,25,1,339,India
503514,2024-01-13,212,amul cheese,250,315,65,1,213,India
503514,2024-01-13,208,sprite,75,100,25,1,213,India
503514,2024-01-13,211,red bull,90,125,35,1,213,India
503514,2024-01-13,207,coca cola,75,100,25,1,213,India
634503,2024-01-13,206,yakult,360,400,40,1,190,India
634503,2024-01-13,211,red bull,90,125,35,1,190,India
634503,2024-01-13,212,amul cheese,250,315,65,1,190,India
634503,2024-01-13,208,sprite,75,100,25,1,190,India
243096,2024-01-13,206,yakult,360,400,40,1,496,India
243096,2024-01-13,207,coca cola,75,100,25,1,496,India
912540,2024-01-13,211,red bull,90,125,35,1,222,India
912540,2024-01-13,209,pepsi,75,100,25,1,222,India
912540,2024-01-13,212,amul cheese,250,315,65,1,222,India
663762,2024-01-13,204,strawberry yogurt,50,60,10,1,168,India
663762,2024-01-13,205,classic yogurt,45,60,15,1,168,India
663762,2024-01-13,209,pepsi,75,100,25,1,168,India
663762,2024-01-13,203,mango yogurt,50,60,10,1,168,India
316791,2024-01-13,212,amul cheese,250,315,65,1,333,India
316791,2024-01-13,203,mango yogurt,50,60,10,1,333,India
435642,2024-01-13,210,mountain dew,75,100,25,1,387,India
435642,2024-01-13,204,strawberry yogurt,50,60,10,1,387,India
435642,2024-01-13,201,paneer,210,340,130,1,387,India
111997,2024-01-13,201,paneer,210,340,130,1,145,India
111997,2024-01-13,206,yakult,360,400,40,1,145,India
111997,2024-01-13,210,mountain dew,75,100,25,1,145,India
111997,2024-01-13,202,milk,12,27,15,1,145,India
290340,2024-01-13,211,red bull,90,125,35,1,448,India
290340,2024-01-13,206,yakult,360,400,40,1,448,India
290340,2024-01-13,212,amul cheese,250,315,65,1,448,India
306656,2024-01-13,205,classic yogurt,45,60,15,1,80,India
306656,2024-01-13,209,pepsi,75,100,25,1,80,India
306656,2024-01-13,212,amul cheese,250,315,65,1,80,India
306656,2024-01-13,201,paneer,210,340,130,1,80,India
979071,2024-01-13,206,yakult,360,400,40,1,203,India
968235,2024-01-13,208,sprite,75,100,25,1,62,India
968235,2024-01-13,204,strawberry yogurt,50,60,10,1,62,India
746816,2024-01-13,205,classic yogurt,45,60,15,1,401,India
746816,2024-01-13,211,red bull,90,125,35,1,401,India
746816,2024-01-13,204,strawberry yogurt,50,60,10,1,401,India
746816,2024-01-13,207,coca cola,75,100,25,1,401,India
746816,2024-01-13,213,bisleri,6,15,9,1,401,India
123619,2024-01-13,211,red bull,90,125,35,1,68,India
123619,2024-01-13,205,classic yogurt,45,60,15,1,68,India
537130,2024-01-13,204,strawberry yogurt,50,60,10,1,444,India
537130,2024-01-13,207,coca cola,75,100,25,1,444,India
537130,2024-01-13,210,mountain dew,75,100,25,1,444,India
903281,2024-01-13,204,strawberry yogurt,50,60,10,1,305,India
903281,2024-01-13,203,mango yogurt,50,60,10,1,305,India
903281,2024-01-13,201,paneer,210,340,130,1,305,India
903281,2024-01-13,207,coca cola,75,100,25,1,305,India
973531,2024-01-13,212,amul cheese,250,315,65,1,155,India
973531,2024-01-13,202,milk,12,27,15,1,155,India
973531,2024-01-13,204,strawberry yogurt,50,60,10,1,155,India
302313,2024-01-13,207,coca cola,75,100,25,1,387,India
302313,2024-01-13,204,strawberry yogurt,50,60,10,1,387,India
302313,2024-01-13,208,sprite,75,100,25,1,387,India
588368,2024-01-13,208,sprite,75,100,25,1,456,India
588368,2024-01-13,213,bisleri,6,15,9,1,456,India
389463,2024-01-13,202,milk,12,27,15,1,259,India
389463,2024-01-13,209,pepsi,75,100,25,1,259,India
982246,2024-01-13,213,bisleri,6,15,9,1,397,India
982246,2024-01-13,212,amul cheese,250,315,65,1,397,India
982246,2024-01-13,211,red bull,90,125,35,1,397,India
982246,2024-01-13,203,mango yogurt,50,60,10,1,397,India
699953,2024-01-13,208,sprite,75,100,25,1,94,India
699953,2024-01-13,207,coca cola,75,100,25,1,94,India
699953,2024-01-13,210,mountain dew,75,100,25,1,94,India
699953,2024-01-13,203,mango yogurt,50,60,10,1,94,India
699953,2024-01-13,209,pepsi,75,100,25,1,94,India
188059,2024-01-13,207,coca cola,75,100,25,1,413,India
188059,2024-01-13,204,strawberry yogurt,50,60,10,1,413,India
188059,2024-01-13,208,sprite,75,100,25,1,413,India
188059,2024-01-13,211,red bull,90,125,35,1,413,India
188059,2024-01-13,209,pepsi,75,100,25,1,413,India
743825,2024-01-13,212,amul cheese,250,315,65,1,331,India
813188,2024-01-13,207,coca cola,75,100,25,1,444,India
813188,2024-01-13,208,sprite,75,100,25,1,444,India
813188,2024-01-13,206,yakult,360,400,40,1,444,India
998096,2024-01-13,213,bisleri,6,15,9,1,404,India
256843,2024-01-13,209,pepsi,75,100,25,1,389,India
256843,2024-01-13,207,coca cola,75,100,25,1,389,India
256843,2024-01-13,202,milk,12,27,15,1,389,India
573274,2024-01-13,201,paneer,210,340,130,1,415,India
944010,2024-01-13,203,mango yogurt,50,60,10,1,13,India
944010,2024-01-13,208,sprite,75,100,25,1,13,India
278650,2024-01-13,202,milk,12,27,15,1,470,India
278650,2024-01-13,209,pepsi,75,100,25,1,470,India
278650,2024-01-13,204,strawberry yogurt,50,60,10,1,470,India
285593,2024-01-13,204,strawberry yogurt,50,60,10,1,261,India
285593,2024-01-13,206,yakult,360,400,40,1,261,India
915186,2024-01-13,213,bisleri,6,15,9,1,460,India
915186,2024-01-13,203,mango yogurt,50,60,10,1,460,India
915186,2024-01-13,204,strawberry yogurt,50,60,10,1,460,India
915186,2024-01-13,208,sprite,75,100,25,1,460,India
915186,2024-01-13,207,coca cola,75,100,25,1,460,India
619652,2024-01-13,213,bisleri,6,15,9,1,458,India
619652,2024-01-13,203,mango yogurt,50,60,10,1,458,India
476418,2024-01-13,206,yakult,360,400,40,1,101,India
779201,2024-01-13,202,milk,12,27,15,1,462,India
752540,2024-01-13,212,amul cheese,250,315,65,1,21,India
752540,2024-01-13,211,red bull,90,125,35,1,21,India
323604,2024-01-13,208,sprite,75,100,25,1,312,India
323604,2024-01-13,213,bisleri,6,15,9,1,312,India
530887,2024-01-13,205,classic yogurt,45,60,15,1,317,India
530887,2024-01-13,204,strawberry yogurt,50,60,10,1,317,India
530887,2024-01-13,213,bisleri,6,15,9,1,317,India
289312,2024-01-13,202,milk,12,27,15,1,466,India
289312,2024-01-13,206,yakult,360,400,40,1,466,India
990513,2024-01-13,203,mango yogurt,50,60,10,1,71,India
990513,2024-01-13,204,strawberry yogurt,50,60,10,1,71,India
990513,2024-01-13,212,amul cheese,250,315,65,1,71,India
990513,2024-01-13,211,red bull,90,125,35,1,71,India
990513,2024-01-13,213,bisleri,6,15,9,1,71,India
966197,2024-01-13,206,yakult,360,400,40,1,477,India
149807,2024-01-13,205,classic yogurt,45,60,15,1,122,India
149807,2024-01-13,207,coca cola,75,100,25,1,122,India
149807,2024-01-13,209,pepsi,75,100,25,1,122,India
149807,2024-01-13,201,paneer,210,340,130,1,122,India
128279,2024-01-13,211,red bull,90,125,35,1,336,India
128279,2024-01-13,204,strawberry yogurt,50,60,10,1,336,India
740340,2024-01-13,204,strawberry yogurt,50,60,10,1,199,India
360889,2024-01-13,209,pepsi,75,100,25,1,368,India
360889,2024-01-13,202,milk,12,27,15,1,368,India
360889,2024-01-13,206,yakult,360,400,40,1,368,India
360889,2024-01-13,208,sprite,75,100,25,1,368,India
360889,2024-01-13,204,strawberry yogurt,50,60,10,1,368,India
614283,2024-01-13,209,pepsi,75,100,25,1,268,India
614283,2024-01-13,205,classic yogurt,45,60,15,1,268,India
614283,2024-01-13,206,yakult,360,400,40,1,268,India
614283,2024-01-13,211,red bull,90,125,35,1,268,India
638330,2024-01-13,209,pepsi,75,100,25,1,61,India
638330,2024-01-13,208,sprite,75,100,25,1,61,India
638330,2024-01-13,213,bisleri,6,15,9,1,61,India
638330,2024-01-13,204,strawberry yogurt,50,60,10,1,61,India
824621,2024-01-13,205,classic yogurt,45,60,15,1,91,India
824621,2024-01-13,206,yakult,360,400,40,1,91,India
824621,2024-01-13,210,mountain dew,75,100,25,1,91,India
824621,2024-01-13,204,strawberry yogurt,50,60,10,1,91,India
579187,2024-01-13,208,sprite,75,100,25,1,399,India
579187,2024-01-13,212,amul cheese,250,315,65,1,399,India
579187,2024-01-13,203,mango yogurt,50,60,10,1,399,India
579187,2024-01-13,206,yakult,360,400,40,1,399,India
517453,2024-01-13,209,pepsi,75,100,25,1,278,India
517453,2024-01-13,208,sprite,75,100,25,1,278,India
517453,2024-01-13,202,milk,12,27,15,1,278,India
517453,2024-01-13,205,classic yogurt,45,60,15,1,278,India
596613,2024-01-13,211,red bull,90,125,35,1,353,India
596613,2024-01-13,203,mango yogurt,50,60,10,1,353,India
612240,2024-01-13,209,pepsi,75,100,25,1,136,India
612240,2024-01-13,205,classic yogurt,45,60,15,1,136,India
612240,2024-01-13,206,yakult,360,400,40,1,136,India
612240,2024-01-13,203,mango yogurt,50,60,10,1,136,India
918531,2024-01-13,201,paneer,210,340,130,1,367,India
156231,2024-01-13,213,bisleri,6,15,9,1,263,India
156231,2024-01-13,212,amul cheese,250,315,65,1,263,India
648976,2024-01-13,208,sprite,75,100,25,1,90,India
648976,2024-01-13,210,mountain dew,75,100,25,1,90,India
648976,2024-01-13,206,yakult,360,400,40,1,90,India
814046,2024-01-13,206,yakult,360,400,40,1,145,India
814046,2024-01-13,204,strawberry yogurt,50,60,10,1,145,India
814046,2024-01-13,203,mango yogurt,50,60,10,1,145,India
814046,2024-01-13,205,classic yogurt,45,60,15,1,145,India
814046,2024-01-13,211,red bull,90,125,35,1,145,India
345752,2024-01-13,204,strawberry yogurt,50,60,10,1,35,India
345752,2024-01-13,202,milk,12,27,15,1,35,India
661462,2024-01-13,212,amul cheese,250,315,65,1,500,India
472121,2024-01-13,213,bisleri,6,15,9,1,276,India
472121,2024-01-13,212,amul cheese,250,315,65,1,276,India
587219,2024-01-13,213,bisleri,6,15,9,1,333,India
587219,2024-01-13,210,mountain dew,75,100,25,1,333,India
587219,2024-01-13,208,sprite,75,100,25,1,333,India
587219,2024-01-13,206,yakult,360,400,40,1,333,India
500809,2024-01-13,204,strawberry yogurt,50,60,10,1,499,India
500809,2024-01-13,208,sprite,75,100,25,1,499,India
500809,2024-01-13,209,pepsi,75,100,25,1,499,India
721935,2024-01-13,203,mango yogurt,50,60,10,1,134,India
721935,2024-01-13,209,pepsi,75,100,25,1,134,India
572123,2024-01-13,204,strawberry yogurt,50,60,10,1,476,India
572123,2024-01-13,210,mountain dew,75,100,25,1,476,India
753011,2024-01-13,209,pepsi,75,100,25,1,433,India
753011,2024-01-13,210,mountain dew,75,100,25,1,433,India
753011,2024-01-13,204,strawberry yogurt,50,60,10,1,433,India
407396,2024-01-13,211,red bull,90,125,35,1,362,India
407396,2024-01-13,210,mountain dew,75,100,25,1,362,India
407396,2024-01-13,206,yakult,360,400,40,1,362,India
407396,2024-01-13,207,coca cola,75,100,25,1,362,India
869746,2024-01-13,206,yakult,360,400,40,1,466,India
869746,2024-01-13,210,mountain dew,75,100,25,1,466,India
869746,2024-01-13,209,pepsi,75,100,25,1,466,India
869746,2024-01-13,213,bisleri,6,15,9,1,466,India
869746,2024-01-13,205,classic yogurt,45,60,15,1,466,India
215294,2024-01-13,204,strawberry yogurt,50,60,10,1,169,India
215294,2024-01-13,208,sprite,75,100,25,1,169,India
215294,2024-01-13,202,milk,12,27,15,1,169,India
324755,2024-01-13,212,amul cheese,250,315,65,1,330,India
324755,2024-01-13,203,mango yogurt,50,60,10,1,330,India
324755,2024-01-13,204,strawberry yogurt,50,60,10,1,330,India
324755,2024-01-13,207,coca cola,75,100,25,1,330,India
324755,2024-01-13,208,sprite,75,100,25,1,330,India
326068,2024-01-14,204,strawberry yogurt,50,60,10,1,466,India
326068,2024-01-14,203,mango yogurt,50,60,10,1,466,India
781767,2024-01-14,204,strawberry yogurt,50,60,10,1,156,India
781767,2024-01-14,213,bisleri,6,15,9,1,156,India
781767,2024-01-14,207,coca cola,75,100,25,1,156,India
311553,2024-01-14,209,pepsi,75,100,25,1,187,India
311553,2024-01-14,211,red bull,90,125,35,1,187,India
748679,2024-01-14,201,paneer,210,340,130,1,104,India
748679,2024-01-14,209,pepsi,75,100,25,1,104,India
472942,2024-01-14,207,coca cola,75,100,25,1,137,India
472942,2024-01-14,205,classic yogurt,45,60,15,1,137,India
472942,2024-01-14,204,strawberry yogurt,50,60,10,1,137,India
472942,2024-01-14,213,bisleri,6,15,9,1,137,India
380261,2024-01-14,211,red bull,90,125,35,1,447,India
380261,2024-01-14,202,milk,12,27,15,1,447,India
380261,2024-01-14,201,paneer,210,340,130,1,447,India
380261,2024-01-14,209,pepsi,75,100,25,1,447,India
380261,2024-01-14,210,mountain dew,75,100,25,1,447,India
957960,2024-01-14,207,coca cola,75,100,25,1,303,India
520624,2024-01-14,212,amul cheese,250,315,65,1,496,India
520624,2024-01-14,203,mango yogurt,50,60,10,1,496,India
520624,2024-01-14,209,pepsi,75,100,25,1,496,India
347687,2024-01-14,204,strawberry yogurt,50,60,10,1,499,India
347687,2024-01-14,211,red bull,90,125,35,1,499,India
538050,2024-01-14,208,sprite,75,100,25,1,60,India
538050,2024-01-14,207,coca cola,75,100,25,1,60,India
237636,2024-01-14,206,yakult,360,400,40,1,42,India
237636,2024-01-14,204,strawberry yogurt,50,60,10,1,42,India
351427,2024-01-14,203,mango yogurt,50,60,10,1,318,India
351427,2024-01-14,202,milk,12,27,15,1,318,India
351427,2024-01-14,208,sprite,75,100,25,1,318,India
351427,2024-01-14,207,coca cola,75,100,25,1,318,India
351427,2024-01-14,209,pepsi,75,100,25,1,318,India
734628,2024-01-14,203,mango yogurt,50,60,10,1,490,India
734628,2024-01-14,209,pepsi,75,100,25,1,490,India
734628,2024-01-14,201,paneer,210,340,130,1,490,India
734628,2024-01-14,210,mountain dew,75,100,25,1,490,India
981940,2024-01-14,202,milk,12,27,15,1,362,India
981940,2024-01-14,208,sprite,75,100,25,1,362,India
981940,2024-01-14,201,paneer,210,340,130,1,362,India
879230,2024-01-14,203,mango yogurt,50,60,10,1,484,India
437566,2024-01-14,210,mountain dew,75,100,25,1,205,India
437566,2024-01-14,201,paneer,210,340,130,1,205,India
980307,2024-01-14,209,pepsi,75,100,25,1,429,India
980307,2024-01-14,201,paneer,210,340,130,1,429,India
580310,2024-01-14,201,paneer,210,340,130,1,493,India
580310,2024-01-14,210,mountain dew,75,100,25,1,493,India
580310,2024-01-14,204,strawberry yogurt,50,60,10,1,493,India
947993,2024-01-14,204,strawberry yogurt,50,60,10,1,486,India
947993,2024-01-14,205,classic yogurt,45,60,15,1,486,India
947993,2024-01-14,210,mountain dew,75,100,25,1,486,India
962725,2024-01-14,206,yakult,360,400,40,1,284,India
962725,2024-01-14,201,paneer,210,340,130,1,284,India
962725,2024-01-14,208,sprite,75,100,25,1,284,India
962725,2024-01-14,207,coca cola,75,100,25,1,284,India
124552,2024-01-14,211,red bull,90,125,35,1,198,India
124552,2024-01-14,208,sprite,75,100,25,1,198,India
213075,2024-01-14,211,red bull,90,125,35,1,309,India
865647,2024-01-14,212,amul cheese,250,315,65,1,135,India
865647,2024-01-14,210,mountain dew,75,100,25,1,135,India
865647,2024-01-14,202,milk,12,27,15,1,135,India
986807,2024-01-14,207,coca cola,75,100,25,1,110,India
986807,2024-01-14,208,sprite,75,100,25,1,110,India
986807,2024-01-14,203,mango yogurt,50,60,10,1,110,India
342521,2024-01-14,202,milk,12,27,15,1,463,India
342521,2024-01-14,204,strawberry yogurt,50,60,10,1,463,India
342521,2024-01-14,203,mango yogurt,50,60,10,1,463,India
398502,2024-01-14,206,yakult,360,400,40,1,113,India
398502,2024-01-14,213,bisleri,6,15,9,1,113,India
974740,2024-01-14,208,sprite,75,100,25,1,257,India
974740,2024-01-14,209,pepsi,75,100,25,1,257,India
974740,2024-01-14,205,classic yogurt,45,60,15,1,257,India
752819,2024-01-14,203,mango yogurt,50,60,10,1,52,India
752819,2024-01-14,208,sprite,75,100,25,1,52,India
752819,2024-01-14,210,mountain dew,75,100,25,1,52,India
752819,2024-01-14,211,red bull,90,125,35,1,52,India
144918,2024-01-14,206,yakult,360,400,40,1,311,India
144918,2024-01-14,203,mango yogurt,50,60,10,1,311,India
144918,2024-01-14,213,bisleri,6,15,9,1,311,India
708640,2024-01-14,201,paneer,210,340,130,1,136,India
708640,2024-01-14,209,pepsi,75,100,25,1,136,India
708640,2024-01-14,212,amul cheese,250,315,65,1,136,India
879027,2024-01-14,206,yakult,360,400,40,1,311,India
391123,2024-01-14,208,sprite,75,100,25,1,18,India
391123,2024-01-14,204,strawberry yogurt,50,60,10,1,18,India
391123,2024-01-14,206,yakult,360,400,40,1,18,India
114742,2024-01-14,201,paneer,210,340,130,1,472,India
114742,2024-01-14,210,mountain dew,75,100,25,1,472,India
114742,2024-01-14,213,bisleri,6,15,9,1,472,India
444003,2024-01-14,204,strawberry yogurt,50,60,10,1,174,India
444003,2024-01-14,202,milk,12,27,15,1,174,India
444003,2024-01-14,206,yakult,360,400,40,1,174,India
103934,2024-01-14,204,strawberry yogurt,50,60,10,1,442,India
929508,2024-01-14,204,strawberry yogurt,50,60,10,1,485,India
269503,2024-01-14,211,red bull,90,125,35,1,94,India
591336,2024-01-14,205,classic yogurt,45,60,15,1,453,India
846455,2024-01-14,209,pepsi,75,100,25,1,157,India
846455,2024-01-14,208,sprite,75,100,25,1,157,India
228487,2024-01-14,201,paneer,210,340,130,1,290,India
228487,2024-01-14,210,mountain dew,75,100,25,1,290,India
228487,2024-01-14,208,sprite,75,100,25,1,290,India
228487,2024-01-14,205,classic yogurt,45,60,15,1,290,India
703633,2024-01-14,210,mountain dew,75,100,25,1,407,India
703633,2024-01-14,204,strawberry yogurt,50,60,10,1,407,India
672266,2024-01-14,201,paneer,210,340,130,1,311,India
672266,2024-01-14,203,mango yogurt,50,60,10,1,311,India
672266,2024-01-14,209,pepsi,75,100,25,1,311,India
672266,2024-01-14,213,bisleri,6,15,9,1,311,India
672266,2024-01-14,202,milk,12,27,15,1,311,India
306346,2024-01-14,207,coca cola,75,100,25,1,244,India
306346,2024-01-14,201,paneer,210,340,130,1,244,India
306346,2024-01-14,211,red bull,90,125,35,1,244,India
306346,2024-01-14,205,classic yogurt,45,60,15,1,244,India
582834,2024-01-14,203,mango yogurt,50,60,10,1,80,India
582834,2024-01-14,205,classic yogurt,45,60,15,1,80,India
537288,2024-01-14,210,mountain dew,75,100,25,1,278,India
788093,2024-01-14,213,bisleri,6,15,9,1,499,India
788093,2024-01-14,204,strawberry yogurt,50,60,10,1,499,India
788093,2024-01-14,209,pepsi,75,100,25,1,499,India
527730,2024-01-14,206,yakult,360,400,40,1,361,India
527730,2024-01-14,205,classic yogurt,45,60,15,1,361,India
938962,2024-01-14,208,sprite,75,100,25,1,419,India
938962,2024-01-14,211,red bull,90,125,35,1,419,India
938962,2024-01-14,201,paneer,210,340,130,1,419,India
938962,2024-01-14,207,coca cola,75,100,25,1,419,India
871498,2024-01-14,211,red bull,90,125,35,1,100,India
871498,2024-01-14,205,classic yogurt,45,60,15,1,100,India
871498,2024-01-14,202,milk,12,27,15,1,100,India
871498,2024-01-14,213,bisleri,6,15,9,1,100,India
743445,2024-01-14,209,pepsi,75,100,25,1,237,India
741760,2024-01-14,212,amul cheese,250,315,65,1,82,India
741760,2024-01-14,209,pepsi,75,100,25,1,82,India
741760,2024-01-14,205,classic yogurt,45,60,15,1,82,India
929906,2024-01-14,211,red bull,90,125,35,1,69,India
929906,2024-01-14,206,yakult,360,400,40,1,69,India
286625,2024-01-14,213,bisleri,6,15,9,1,196,India
286625,2024-01-14,203,mango yogurt,50,60,10,1,196,India
286625,2024-01-14,209,pepsi,75,100,25,1,196,India
286625,2024-01-14,204,strawberry yogurt,50,60,10,1,196,India
125177,2024-01-14,207,coca cola,75,100,25,1,318,India
163488,2024-01-14,208,sprite,75,100,25,1,119,India
163488,2024-01-14,202,milk,12,27,15,1,119,India
163488,2024-01-14,212,amul cheese,250,315,65,1,119,India
163488,2024-01-14,210,mountain dew,75,100,25,1,119,India
280946,2024-01-14,212,amul cheese,250,315,65,1,278,India
280946,2024-01-14,206,yakult,360,400,40,1,278,India
625250,2024-01-14,203,mango yogurt,50,60,10,1,141,India
782329,2024-01-14,202,milk,12,27,15,1,347,India
782329,2024-01-14,205,classic yogurt,45,60,15,1,347,India
299925,2024-01-14,201,paneer,210,340,130,1,247,India
787969,2024-01-14,206,yakult,360,400,40,1,57,India
889644,2024-01-14,207,coca cola,75,100,25,1,125,India
889644,2024-01-14,212,amul cheese,250,315,65,1,125,India
889644,2024-01-14,209,pepsi,75,100,25,1,125,India
849473,2024-01-14,201,paneer,210,340,130,1,318,India
157081,2024-01-14,213,bisleri,6,15,9,1,218,India
157081,2024-01-14,209,pepsi,75,100,25,1,218,India
157081,2024-01-14,208,sprite,75,100,25,1,218,India
157081,2024-01-14,212,amul cheese,250,315,65,1,218,India
157081,2024-01-14,203,mango yogurt,50,60,10,1,218,India
831330,2024-01-14,204,strawberry yogurt,50,60,10,1,178,India
831330,2024-01-14,209,pepsi,75,100,25,1,178,India
831330,2024-01-14,213,bisleri,6,15,9,1,178,India
831330,2024-01-14,202,milk,12,27,15,1,178,India
831330,2024-01-14,205,classic yogurt,45,60,15,1,178,India
179758,2024-01-14,210,mountain dew,75,100,25,1,1,India
179758,2024-01-14,204,strawberry yogurt,50,60,10,1,1,India
785048,2024-01-14,208,sprite,75,100,25,1,487,India
785048,2024-01-14,211,red bull,90,125,35,1,487,India
785048,2024-01-14,203,mango yogurt,50,60,10,1,487,India
785048,2024-01-14,201,paneer,210,340,130,1,487,India
727270,2024-01-14,208,sprite,75,100,25,1,345,India
727270,2024-01-14,212,amul cheese,250,315,65,1,345,India
727270,2024-01-14,209,pepsi,75,100,25,1,345,India
727270,2024-01-14,210,mountain dew,75,100,25,1,345,India
727270,2024-01-14,205,classic yogurt,45,60,15,1,345,India
550936,2024-01-14,212,amul cheese,250,315,65,1,234,India
550936,2024-01-14,211,red bull,90,125,35,1,234,India
550936,2024-01-14,213,bisleri,6,15,9,1,234,India
550936,2024-01-14,208,sprite,75,100,25,1,234,India
550936,2024-01-14,203,mango yogurt,50,60,10,1,234,India
565251,2024-01-14,206,yakult,360,400,40,1,278,India
565251,2024-01-14,212,amul cheese,250,315,65,1,278,India
565251,2024-01-14,201,paneer,210,340,130,1,278,India
565251,2024-01-14,211,red bull,90,125,35,1,278,India
816623,2024-01-14,208,sprite,75,100,25,1,255,India
816623,2024-01-14,204,strawberry yogurt,50,60,10,1,255,India
955792,2024-01-14,209,pepsi,75,100,25,1,229,India
122912,2024-01-15,202,milk,12,27,15,1,321,India
895367,2024-01-15,210,mountain dew,75,100,25,1,114,India
895367,2024-01-15,201,paneer,210,340,130,1,114,India
912376,2024-01-15,211,red bull,90,125,35,1,2,India
912376,2024-01-15,206,yakult,360,400,40,1,2,India
912376,2024-01-15,205,classic yogurt,45,60,15,1,2,India
549712,2024-01-15,209,pepsi,75,100,25,1,414,India
549712,2024-01-15,203,mango yogurt,50,60,10,1,414,India
549712,2024-01-15,212,amul cheese,250,315,65,1,414,India
549712,2024-01-15,201,paneer,210,340,130,1,414,India
663072,2024-01-15,209,pepsi,75,100,25,1,486,India
663072,2024-01-15,208,sprite,75,100,25,1,486,India
394844,2024-01-15,204,strawberry yogurt,50,60,10,1,400,India
394844,2024-01-15,207,coca cola,75,100,25,1,400,India
394844,2024-01-15,209,pepsi,75,100,25,1,400,India
860066,2024-01-15,207,coca cola,75,100,25,1,484,India
860066,2024-01-15,205,classic yogurt,45,60,15,1,484,India
757338,2024-01-15,203,mango yogurt,50,60,10,1,178,India
757338,2024-01-15,208,sprite,75,100,25,1,178,India
757338,2024-01-15,212,amul cheese,250,315,65,1,178,India
830135,2024-01-15,201,paneer,210,340,130,1,201,India
830135,2024-01-15,202,milk,12,27,15,1,201,India
830135,2024-01-15,203,mango yogurt,50,60,10,1,201,India
830135,2024-01-15,210,mountain dew,75,100,25,1,201,India
744030,2024-01-15,213,bisleri,6,15,9,1,217,India
744030,2024-01-15,211,red bull,90,125,35,1,217,India
744030,2024-01-15,207,coca cola,75,100,25,1,217,India
344308,2024-01-15,213,bisleri,6,15,9,1,53,India
344308,2024-01-15,205,classic yogurt,45,60,15,1,53,India
344308,2024-01-15,204,strawberry yogurt,50,60,10,1,53,India
344308,2024-01-15,202,milk,12,27,15,1,53,India
712527,2024-01-15,201,paneer,210,340,130,1,196,India
223163,2024-01-15,202,milk,12,27,15,1,14,India
223163,2024-01-15,204,strawberry yogurt,50,60,10,1,14,India
223163,2024-01-15,208,sprite,75,100,25,1,14,India
201185,2024-01-15,208,sprite,75,100,25,1,254,India
201185,2024-01-15,201,paneer,210,340,130,1,254,India
201185,2024-01-15,203,mango yogurt,50,60,10,1,254,India
201185,2024-01-15,202,milk,12,27,15,1,254,India
149184,2024-01-15,213,bisleri,6,15,9,1,220,India
149184,2024-01-15,201,paneer,210,340,130,1,220,India
149184,2024-01-15,210,mountain dew,75,100,25,1,220,India
310646,2024-01-15,206,yakult,360,400,40,1,272,India
857556,2024-01-15,202,milk,12,27,15,1,259,India
857556,2024-01-15,209,pepsi,75,100,25,1,259,India
857556,2024-01-15,208,sprite,75,100,25,1,259,India
857556,2024-01-15,205,classic yogurt,45,60,15,1,259,India
857556,2024-01-15,201,paneer,210,340,130,1,259,India
700496,2024-01-15,210,mountain dew,75,100,25,1,158,India
700496,2024-01-15,207,coca cola,75,100,25,1,158,India
772878,2024-01-15,201,paneer,210,340,130,1,17,India
772878,2024-01-15,202,milk,12,27,15,1,17,India
772878,2024-01-15,208,sprite,75,100,25,1,17,India
734204,2024-01-15,206,yakult,360,400,40,1,369,India
734204,2024-01-15,213,bisleri,6,15,9,1,369,India
734204,2024-01-15,208,sprite,75,100,25,1,369,India
734204,2024-01-15,202,milk,12,27,15,1,369,India
425656,2024-01-15,205,classic yogurt,45,60,15,1,405,India
425656,2024-01-15,206,yakult,360,400,40,1,405,India
425656,2024-01-15,211,red bull,90,125,35,1,405,India
425656,2024-01-15,207,coca cola,75,100,25,1,405,India
761485,2024-01-15,210,mountain dew,75,100,25,1,367,India
761485,2024-01-15,207,coca cola,75,100,25,1,367,India
763483,2024-01-15,213,bisleri,6,15,9,1,304,India
763483,2024-01-15,202,milk,12,27,15,1,304,India
763483,2024-01-15,211,red bull,90,125,35,1,304,India
763483,2024-01-15,212,amul cheese,250,315,65,1,304,India
391971,2024-01-15,202,milk,12,27,15,1,478,India
391971,2024-01-15,210,mountain dew,75,100,25,1,478,India
937570,2024-01-15,203,mango yogurt,50,60,10,1,371,India
937570,2024-01-15,213,bisleri,6,15,9,1,371,India
460543,2024-01-15,204,strawberry yogurt,50,60,10,1,330,India
937045,2024-01-15,203,mango yogurt,50,60,10,1,448,India
937045,2024-01-15,211,red bull,90,125,35,1,448,India
937045,2024-01-15,209,pepsi,75,100,25,1,448,India
937045,2024-01-15,207,coca cola,75,100,25,1,448,India
187247,2024-01-15,204,strawberry yogurt,50,60,10,1,457,India
187247,2024-01-15,211,red bull,90,125,35,1,457,India
187247,2024-01-15,203,mango yogurt,50,60,10,1,457,India
579604,2024-01-15,202,milk,12,27,15,1,270,India
579604,2024-01-15,205,classic yogurt,45,60,15,1,270,India
579604,2024-01-15,201,paneer,210,340,130,1,270,India
579604,2024-01-15,209,pepsi,75,100,25,1,270,India
676380,2024-01-15,205,classic yogurt,45,60,15,1,140,India
802367,2024-01-15,212,amul cheese,250,315,65,1,475,India
802367,2024-01-15,204,strawberry yogurt,50,60,10,1,475,India
802367,2024-01-15,207,coca cola,75,100,25,1,475,India
740047,2024-01-15,210,mountain dew,75,100,25,1,195,India
740047,2024-01-15,208,sprite,75,100,25,1,195,India
740047,2024-01-15,202,milk,12,27,15,1,195,India
791217,2024-01-15,201,paneer,210,340,130,1,172,India
791217,2024-01-15,202,milk,12,27,15,1,172,India
791217,2024-01-15,209,pepsi,75,100,25,1,172,India
146991,2024-01-15,202,milk,12,27,15,1,252,India
146991,2024-01-15,212,amul cheese,250,315,65,1,252,India
425822,2024-01-15,213,bisleri,6,15,9,1,6,India
425822,2024-01-15,208,sprite,75,100,25,1,6,India
244094,2024-01-15,209,pepsi,75,100,25,1,480,India
244094,2024-01-15,211,red bull,90,125,35,1,480,India
244094,2024-01-15,213,bisleri,6,15,9,1,480,India
112213,2024-01-15,202,milk,12,27,15,1,196,India
112213,2024-01-15,207,coca cola,75,100,25,1,196,India
112213,2024-01-15,204,strawberry yogurt,50,60,10,1,196,India
112213,2024-01-15,205,classic yogurt,45,60,15,1,196,India
943678,2024-01-15,212,amul cheese,250,315,65,1,224,India
943678,2024-01-15,207,coca cola,75,100,25,1,224,India
943678,2024-01-15,202,milk,12,27,15,1,224,India
943678,2024-01-15,206,yakult,360,400,40,1,224,India
755867,2024-01-15,201,paneer,210,340,130,1,334,India
755867,2024-01-15,206,yakult,360,400,40,1,334,India
755867,2024-01-15,202,milk,12,27,15,1,334,India
970330,2024-01-15,204,strawberry yogurt,50,60,10,1,170,India
970330,2024-01-15,211,red bull,90,125,35,1,170,India
970330,2024-01-15,201,paneer,210,340,130,1,170,India
970330,2024-01-15,213,bisleri,6,15,9,1,170,India
516482,2024-01-15,202,milk,12,27,15,1,64,India
516482,2024-01-15,206,yakult,360,400,40,1,64,India
137983,2024-01-15,201,paneer,210,340,130,1,55,India
137983,2024-01-15,204,strawberry yogurt,50,60,10,1,55,India
375116,2024-01-15,203,mango yogurt,50,60,10,1,32,India
375116,2024-01-15,211,red bull,90,125,35,1,32,India
375116,2024-01-15,210,mountain dew,75,100,25,1,32,India
220518,2024-01-15,205,classic yogurt,45,60,15,1,108,India
220518,2024-01-15,206,yakult,360,400,40,1,108,India
220518,2024-01-15,209,pepsi,75,100,25,1,108,India
220518,2024-01-15,204,strawberry yogurt,50,60,10,1,108,India
800956,2024-01-15,209,pepsi,75,100,25,1,346,India
800956,2024-01-15,201,paneer,210,340,130,1,346,India
800956,2024-01-15,204,strawberry yogurt,50,60,10,1,346,India
800956,2024-01-15,206,yakult,360,400,40,1,346,India
673917,2024-01-15,212,amul cheese,250,315,65,1,61,India
673917,2024-01-15,211,red bull,90,125,35,1,61,India
139680,2024-01-15,205,classic yogurt,45,60,15,1,263,India
139680,2024-01-15,202,milk,12,27,15,1,263,India
139680,2024-01-15,204,strawberry yogurt,50,60,10,1,263,India
139680,2024-01-15,207,coca cola,75,100,25,1,263,India
645833,2024-01-15,210,mountain dew,75,100,25,1,281,India
360345,2024-01-15,206,yakult,360,400,40,1,5,India
360345,2024-01-15,208,sprite,75,100,25,1,5,India
360345,2024-01-15,210,mountain dew,75,100,25,1,5,India
774653,2024-01-15,211,red bull,90,125,35,1,37,India
774653,2024-01-15,204,strawberry yogurt,50,60,10,1,37,India
774653,2024-01-15,207,coca cola,75,100,25,1,37,India
774653,2024-01-15,209,pepsi,75,100,25,1,37,India
870398,2024-01-15,210,mountain dew,75,100,25,1,59,India
870398,2024-01-15,207,coca cola,75,100,25,1,59,India
617138,2024-01-15,203,mango yogurt,50,60,10,1,203,India
617138,2024-01-15,213,bisleri,6,15,9,1,203,India
617138,2024-01-15,206,yakult,360,400,40,1,203,India
617138,2024-01-15,212,amul cheese,250,315,65,1,203,India
770755,2024-01-15,203,mango yogurt,50,60,10,1,173,India
770755,2024-01-15,210,mountain dew,75,100,25,1,173,India
770755,2024-01-15,212,amul cheese,250,315,65,1,173,India
287616,2024-01-15,204,strawberry yogurt,50,60,10,1,253,India
287616,2024-01-15,213,bisleri,6,15,9,1,253,India
287616,2024-01-15,211,red bull,90,125,35,1,253,India
530368,2024-01-15,205,classic yogurt,45,60,15,1,401,India
530368,2024-01-15,211,red bull,90,125,35,1,401,India
530368,2024-01-15,208,sprite,75,100,25,1,401,India
530368,2024-01-15,201,paneer,210,340,130,1,401,India
615305,2024-01-15,209,pepsi,75,100,25,1,23,India
615305,2024-01-15,206,yakult,360,400,40,1,23,India
422952,2024-01-15,204,strawberry yogurt,50,60,10,1,471,India
422952,2024-01-15,205,classic yogurt,45,60,15,1,471,India
422952,2024-01-15,213,bisleri,6,15,9,1,471,India
422952,2024-01-15,211,red bull,90,125,35,1,471,India
883883,2024-01-15,210,mountain dew,75,100,25,1,482,India
883883,2024-01-15,213,bisleri,6,15,9,1,482,India
107956,2024-01-15,212,amul cheese,250,315,65,1,168,India
107956,2024-01-15,202,milk,12,27,15,1,168,India
107956,2024-01-15,204,strawberry yogurt,50,60,10,1,168,India
107956,2024-01-15,205,classic yogurt,45,60,15,1,168,India
344399,2024-01-15,201,paneer,210,340,130,1,112,India
350233,2024-01-15,208,sprite,75,100,25,1,153,India
301040,2024-01-15,211,red bull,90,125,35,1,203,India
301040,2024-01-15,202,milk,12,27,15,1,203,India
301040,2024-01-15,205,classic yogurt,45,60,15,1,203,India
381877,2024-01-15,210,mountain dew,75,100,25,1,294,India
381877,2024-01-15,212,amul cheese,250,315,65,1,294,India
381877,2024-01-15,208,sprite,75,100,25,1,294,India
494284,2024-01-15,202,milk,12,27,15,1,60,India
494284,2024-01-15,209,pepsi,75,100,25,1,60,India
494284,2024-01-15,206,yakult,360,400,40,1,60,India
127632,2024-01-15,204,strawberry yogurt,50,60,10,1,475,India
127632,2024-01-15,212,amul cheese,250,315,65,1,475,India
127632,2024-01-15,209,pepsi,75,100,25,1,475,India
782307,2024-01-15,202,milk,12,27,15,1,168,India
782307,2024-01-15,210,mountain dew,75,100,25,1,168,India
782307,2024-01-15,207,coca cola,75,100,25,1,168,India
281526,2024-01-15,203,mango yogurt,50,60,10,1,405,India
281526,2024-01-15,207,coca cola,75,100,25,1,405,India
281526,2024-01-15,208,sprite,75,100,25,1,405,India
281526,2024-01-15,209,pepsi,75,100,25,1,405,India
281526,2024-01-15,206,yakult,360,400,40,1,405,India
614492,2024-01-15,209,pepsi,75,100,25,1,149,India
373410,2024-01-15,208,sprite,75,100,25,1,51,India
373410,2024-01-15,204,strawberry yogurt,50,60,10,1,51,India
373410,2024-01-15,211,red bull,90,125,35,1,51,India
323337,2024-01-15,205,classic yogurt,45,60,15,1,425,India
323337,2024-01-15,202,milk,12,27,15,1,425,India
967822,2024-01-15,206,yakult,360,400,40,1,465,India
967822,2024-01-15,207,coca cola,75,100,25,1,465,India
801121,2024-01-16,210,mountain dew,75,100,25,1,167,India
801121,2024-01-16,204,strawberry yogurt,50,60,10,1,167,India
801121,2024-01-16,208,sprite,75,100,25,1,167,India
902342,2024-01-16,212,amul cheese,250,315,65,1,41,India
902342,2024-01-16,202,milk,12,27,15,1,41,India
902342,2024-01-16,203,mango yogurt,50,60,10,1,41,India
688574,2024-01-16,201,paneer,210,340,130,1,172,India
688574,2024-01-16,206,yakult,360,400,40,1,172,India
688574,2024-01-16,207,coca cola,75,100,25,1,172,India
688574,2024-01-16,208,sprite,75,100,25,1,172,India
810473,2024-01-16,209,pepsi,75,100,25,1,371,India
810473,2024-01-16,210,mountain dew,75,100,25,1,371,India
810473,2024-01-16,202,milk,12,27,15,1,371,India
810473,2024-01-16,208,sprite,75,100,25,1,371,India
978521,2024-01-16,202,milk,12,27,15,1,86,India
978521,2024-01-16,205,classic yogurt,45,60,15,1,86,India
601506,2024-01-16,203,mango yogurt,50,60,10,1,60,India
601506,2024-01-16,211,red bull,90,125,35,1,60,India
601506,2024-01-16,210,mountain dew,75,100,25,1,60,India
601506,2024-01-16,213,bisleri,6,15,9,1,60,India
601506,2024-01-16,209,pepsi,75,100,25,1,60,India
663750,2024-01-16,211,red bull,90,125,35,1,337,India
663750,2024-01-16,212,amul cheese,250,315,65,1,337,India
663750,2024-01-16,204,strawberry yogurt,50,60,10,1,337,India
525348,2024-01-16,210,mountain dew,75,100,25,1,173,India
525348,2024-01-16,207,coca cola,75,100,25,1,173,India
525348,2024-01-16,204,strawberry yogurt,50,60,10,1,173,India
817965,2024-01-16,205,classic yogurt,45,60,15,1,210,India
788872,2024-01-16,207,coca cola,75,100,25,1,288,India
788872,2024-01-16,201,paneer,210,340,130,1,288,India
788872,2024-01-16,213,bisleri,6,15,9,1,288,India
788872,2024-01-16,209,pepsi,75,100,25,1,288,India
682562,2024-01-16,207,coca cola,75,100,25,1,22,India
682562,2024-01-16,208,sprite,75,100,25,1,22,India
682562,2024-01-16,212,amul cheese,250,315,65,1,22,India
388240,2024-01-16,207,coca cola,75,100,25,1,9,India
388240,2024-01-16,203,mango yogurt,50,60,10,1,9,India
388240,2024-01-16,205,classic yogurt,45,60,15,1,9,India
388240,2024-01-16,202,milk,12,27,15,1,9,India
118021,2024-01-16,209,pepsi,75,100,25,1,54,India
118021,2024-01-16,201,paneer,210,340,130,1,54,India
118021,2024-01-16,205,classic yogurt,45,60,15,1,54,India
118021,2024-01-16,204,strawberry yogurt,50,60,10,1,54,India
710102,2024-01-16,204,strawberry yogurt,50,60,10,1,468,India
710102,2024-01-16,209,pepsi,75,100,25,1,468,India
710102,2024-01-16,210,mountain dew,75,100,25,1,468,India
710102,2024-01-16,211,red bull,90,125,35,1,468,India
845043,2024-01-16,208,sprite,75,100,25,1,97,India
845043,2024-01-16,202,milk,12,27,15,1,97,India
845043,2024-01-16,209,pepsi,75,100,25,1,97,India
845043,2024-01-16,206,yakult,360,400,40,1,97,India
681595,2024-01-16,206,yakult,360,400,40,1,60,India
681595,2024-01-16,203,mango yogurt,50,60,10,1,60,India
946387,2024-01-16,213,bisleri,6,15,9,1,312,India
946387,2024-01-16,205,classic yogurt,45,60,15,1,312,India
946387,2024-01-16,202,milk,12,27,15,1,312,India
946387,2024-01-16,211,red bull,90,125,35,1,312,India
639009,2024-01-16,203,mango yogurt,50,60,10,1,168,India
639009,2024-01-16,204,strawberry yogurt,50,60,10,1,168,India
639009,2024-01-16,213,bisleri,6,15,9,1,168,India
639009,2024-01-16,206,yakult,360,400,40,1,168,India
100995,2024-01-16,205,classic yogurt,45,60,15,1,292,India
100995,2024-01-16,207,coca cola,75,100,25,1,292,India
100995,2024-01-16,212,amul cheese,250,315,65,1,292,India
100995,2024-01-16,203,mango yogurt,50,60,10,1,292,India
100995,2024-01-16,204,strawberry yogurt,50,60,10,1,292,India
351660,2024-01-16,201,paneer,210,340,130,1,416,India
351660,2024-01-16,203,mango yogurt,50,60,10,1,416,India
351660,2024-01-16,209,pepsi,75,100,25,1,416,India
351660,2024-01-16,211,red bull,90,125,35,1,416,India
351660,2024-01-16,212,amul cheese,250,315,65,1,416,India
846622,2024-01-16,206,yakult,360,400,40,1,406,India
846622,2024-01-16,210,mountain dew,75,100,25,1,406,India
846622,2024-01-16,207,coca cola,75,100,25,1,406,India
846622,2024-01-16,202,milk,12,27,15,1,406,India
982194,2024-01-16,201,paneer,210,340,130,1,130,India
982194,2024-01-16,205,classic yogurt,45,60,15,1,130,India
982194,2024-01-16,203,mango yogurt,50,60,10,1,130,India
757242,2024-01-16,203,mango yogurt,50,60,10,1,321,India
757242,2024-01-16,209,pepsi,75,100,25,1,321,India
825717,2024-01-16,210,mountain dew,75,100,25,1,272,India
825717,2024-01-16,202,milk,12,27,15,1,272,India
825717,2024-01-16,208,sprite,75,100,25,1,272,India
452883,2024-01-16,207,coca cola,75,100,25,1,28,India
452883,2024-01-16,209,pepsi,75,100,25,1,28,India
452883,2024-01-16,208,sprite,75,100,25,1,28,India
361323,2024-01-16,205,classic yogurt,45,60,15,1,494,India
361323,2024-01-16,211,red bull,90,125,35,1,494,India
361323,2024-01-16,204,strawberry yogurt,50,60,10,1,494,India
361323,2024-01-16,202,milk,12,27,15,1,494,India
361323,2024-01-16,213,bisleri,6,15,9,1,494,India
393081,2024-01-16,211,red bull,90,125,35,1,172,India
393081,2024-01-16,210,mountain dew,75,100,25,1,172,India
393081,2024-01-16,207,coca cola,75,100,25,1,172,India
393081,2024-01-16,201,paneer,210,340,130,1,172,India
547908,2024-01-16,211,red bull,90,125,35,1,99,India
547908,2024-01-16,205,classic yogurt,45,60,15,1,99,India
547908,2024-01-16,212,amul cheese,250,315,65,1,99,India
790695,2024-01-16,201,paneer,210,340,130,1,34,India
790695,2024-01-16,207,coca cola,75,100,25,1,34,India
790695,2024-01-16,204,strawberry yogurt,50,60,10,1,34,India
642065,2024-01-16,212,amul cheese,250,315,65,1,286,India
642065,2024-01-16,204,strawberry yogurt,50,60,10,1,286,India
642065,2024-01-16,207,coca cola,75,100,25,1,286,India
675483,2024-01-16,213,bisleri,6,15,9,1,167,India
675483,2024-01-16,201,paneer,210,340,130,1,167,India
675483,2024-01-16,208,sprite,75,100,25,1,167,India
839649,2024-01-16,211,red bull,90,125,35,1,178,India
839649,2024-01-16,207,coca cola,75,100,25,1,178,India
750536,2024-01-16,202,milk,12,27,15,1,463,India
750536,2024-01-16,201,paneer,210,340,130,1,463,India
576973,2024-01-16,210,mountain dew,75,100,25,1,211,India
940442,2024-01-16,205,classic yogurt,45,60,15,1,439,India
940442,2024-01-16,212,amul cheese,250,315,65,1,439,India
940442,2024-01-16,203,mango yogurt,50,60,10,1,439,India
729236,2024-01-16,209,pepsi,75,100,25,1,26,India
729236,2024-01-16,204,strawberry yogurt,50,60,10,1,26,India
729236,2024-01-16,206,yakult,360,400,40,1,26,India
499807,2024-01-16,202,milk,12,27,15,1,254,India
499807,2024-01-16,206,yakult,360,400,40,1,254,India
393084,2024-01-16,207,coca cola,75,100,25,1,231,India
393084,2024-01-16,208,sprite,75,100,25,1,231,India
393084,2024-01-16,210,mountain dew,75,100,25,1,231,India
436873,2024-01-16,203,mango yogurt,50,60,10,1,300,India
531379,2024-01-16,211,red bull,90,125,35,1,323,India
602954,2024-01-16,204,strawberry yogurt,50,60,10,1,273,India
602954,2024-01-16,207,coca cola,75,100,25,1,273,India
602954,2024-01-16,209,pepsi,75,100,25,1,273,India
843956,2024-01-16,205,classic yogurt,45,60,15,1,379,India
843956,2024-01-16,203,mango yogurt,50,60,10,1,379,India
843956,2024-01-16,204,strawberry yogurt,50,60,10,1,379,India
843956,2024-01-16,202,milk,12,27,15,1,379,India
584075,2024-01-16,206,yakult,360,400,40,1,344,India
584075,2024-01-16,209,pepsi,75,100,25,1,344,India
584075,2024-01-16,201,paneer,210,340,130,1,344,India
443319,2024-01-16,210,mountain dew,75,100,25,1,204,India
443319,2024-01-16,206,yakult,360,400,40,1,204,India
222302,2024-01-16,201,paneer,210,340,130,1,479,India
222302,2024-01-16,202,milk,12,27,15,1,479,India
222302,2024-01-16,204,strawberry yogurt,50,60,10,1,479,India
222302,2024-01-16,205,classic yogurt,45,60,15,1,479,India
710152,2024-01-16,212,amul cheese,250,315,65,1,294,India
232450,2024-01-16,210,mountain dew,75,100,25,1,409,India
705552,2024-01-16,206,yakult,360,400,40,1,62,India
826368,2024-01-16,207,coca cola,75,100,25,1,298,India
826368,2024-01-16,208,sprite,75,100,25,1,298,India
826368,2024-01-16,201,paneer,210,340,130,1,298,India
826368,2024-01-16,203,mango yogurt,50,60,10,1,298,India
826368,2024-01-16,212,amul cheese,250,315,65,1,298,India
597621,2024-01-16,213,bisleri,6,15,9,1,152,India
597621,2024-01-16,210,mountain dew,75,100,25,1,152,India
597621,2024-01-16,206,yakult,360,400,40,1,152,India
949574,2024-01-16,210,mountain dew,75,100,25,1,347,India
281997,2024-01-16,212,amul cheese,250,315,65,1,454,India
281997,2024-01-16,206,yakult,360,400,40,1,454,India
281997,2024-01-16,203,mango yogurt,50,60,10,1,454,India
281997,2024-01-16,201,paneer,210,340,130,1,454,India
281997,2024-01-16,208,sprite,75,100,25,1,454,India
293336,2024-01-16,212,amul cheese,250,315,65,1,51,India
293336,2024-01-16,201,paneer,210,340,130,1,51,India
293336,2024-01-16,213,bisleri,6,15,9,1,51,India
293336,2024-01-16,204,strawberry yogurt,50,60,10,1,51,India
293336,2024-01-16,208,sprite,75,100,25,1,51,India
545484,2024-01-16,212,amul cheese,250,315,65,1,117,India
545484,2024-01-16,203,mango yogurt,50,60,10,1,117,India
545484,2024-01-16,213,bisleri,6,15,9,1,117,India
312215,2024-01-16,209,pepsi,75,100,25,1,381,India
312215,2024-01-16,213,bisleri,6,15,9,1,381,India
312215,2024-01-16,207,coca cola,75,100,25,1,381,India
455014,2024-01-16,202,milk,12,27,15,1,417,India
455014,2024-01-16,205,classic yogurt,45,60,15,1,417,India
455014,2024-01-16,201,paneer,210,340,130,1,417,India
455014,2024-01-16,213,bisleri,6,15,9,1,417,India
290337,2024-01-16,210,mountain dew,75,100,25,1,377,India
290337,2024-01-16,212,amul cheese,250,315,65,1,377,India
100905,2024-01-16,208,sprite,75,100,25,1,430,India
100905,2024-01-16,205,classic yogurt,45,60,15,1,430,India
642290,2024-01-16,203,mango yogurt,50,60,10,1,451,India
642290,2024-01-16,206,yakult,360,400,40,1,451,India
642290,2024-01-16,210,mountain dew,75,100,25,1,451,India
321153,2024-01-16,208,sprite,75,100,25,1,110,India
602346,2024-01-16,210,mountain dew,75,100,25,1,204,India
602346,2024-01-16,205,classic yogurt,45,60,15,1,204,India
617286,2024-01-16,205,classic yogurt,45,60,15,1,157,India
617286,2024-01-16,206,yakult,360,400,40,1,157,India
617286,2024-01-16,203,mango yogurt,50,60,10,1,157,India
201218,2024-01-16,204,strawberry yogurt,50,60,10,1,406,India
201218,2024-01-16,203,mango yogurt,50,60,10,1,406,India
966269,2024-01-16,210,mountain dew,75,100,25,1,380,India
966269,2024-01-16,208,sprite,75,100,25,1,380,India
966269,2024-01-16,207,coca cola,75,100,25,1,380,India
966269,2024-01-16,212,amul cheese,250,315,65,1,380,India
409202,2024-01-16,201,paneer,210,340,130,1,400,India
409202,2024-01-16,212,amul cheese,250,315,65,1,400,India
409202,2024-01-16,204,strawberry yogurt,50,60,10,1,400,India
409202,2024-01-16,210,mountain dew,75,100,25,1,400,India
902185,2024-01-16,202,milk,12,27,15,1,197,India
902185,2024-01-16,211,red bull,90,125,35,1,197,India
902185,2024-01-16,204,strawberry yogurt,50,60,10,1,197,India
902185,2024-01-16,201,paneer,210,340,130,1,197,India
229133,2024-01-16,203,mango yogurt,50,60,10,1,285,India
229133,2024-01-16,202,milk,12,27,15,1,285,India
229133,2024-01-16,208,sprite,75,100,25,1,285,India
229133,2024-01-16,209,pepsi,75,100,25,1,285,India
334068,2024-01-16,201,paneer,210,340,130,1,74,India
930695,2024-01-16,212,amul cheese,250,315,65,1,423,India
930695,2024-01-16,211,red bull,90,125,35,1,423,India
930695,2024-01-16,201,paneer,210,340,130,1,423,India
594886,2024-01-16,213,bisleri,6,15,9,1,436,India
594886,2024-01-16,203,mango yogurt,50,60,10,1,436,India
185310,2024-01-16,206,yakult,360,400,40,1,46,India
185310,2024-01-16,205,classic yogurt,45,60,15,1,46,India
801597,2024-01-16,203,mango yogurt,50,60,10,1,4,India
801597,2024-01-16,206,yakult,360,400,40,1,4,India
801597,2024-01-16,209,pepsi,75,100,25,1,4,India
801597,2024-01-16,210,mountain dew,75,100,25,1,4,India
611341,2024-01-16,201,paneer,210,340,130,1,435,India
867983,2024-01-16,201,paneer,210,340,130,1,471,India
867983,2024-01-16,206,yakult,360,400,40,1,471,India
867983,2024-01-16,203,mango yogurt,50,60,10,1,471,India
867983,2024-01-16,207,coca cola,75,100,25,1,471,India
424099,2024-01-16,202,milk,12,27,15,1,275,India
424099,2024-01-16,204,strawberry yogurt,50,60,10,1,275,India
424099,2024-01-16,211,red bull,90,125,35,1,275,India
898515,2024-01-16,202,milk,12,27,15,1,128,India
805388,2024-01-16,212,amul cheese,250,315,65,1,407,India
805388,2024-01-16,205,classic yogurt,45,60,15,1,407,India
805388,2024-01-16,201,paneer,210,340,130,1,407,India
805388,2024-01-16,208,sprite,75,100,25,1,407,India
805388,2024-01-16,203,mango yogurt,50,60,10,1,407,India
787860,2024-01-16,208,sprite,75,100,25,1,367,India
787860,2024-01-16,209,pepsi,75,100,25,1,367,India
787860,2024-01-16,211,red bull,90,125,35,1,367,India
787860,2024-01-16,202,milk,12,27,15,1,367,India
366731,2024-01-16,210,mountain dew,75,100,25,1,162,India
366731,2024-01-16,201,paneer,210,340,130,1,162,India
366731,2024-01-16,204,strawberry yogurt,50,60,10,1,162,India
308889,2024-01-16,212,amul cheese,250,315,65,1,8,India
308889,2024-01-16,203,mango yogurt,50,60,10,1,8,India
632654,2024-01-16,203,mango yogurt,50,60,10,1,272,India
541873,2024-01-16,203,mango yogurt,50,60,10,1,398,India
541873,2024-01-16,204,strawberry yogurt,50,60,10,1,398,India
541873,2024-01-16,207,coca cola,75,100,25,1,398,India
446387,2024-01-16,202,milk,12,27,15,1,205,India
446387,2024-01-16,207,coca cola,75,100,25,1,205,India
879165,2024-01-16,204,strawberry yogurt,50,60,10,1,445,India
879165,2024-01-16,212,amul cheese,250,315,65,1,445,India
879165,2024-01-16,203,mango yogurt,50,60,10,1,445,India
879165,2024-01-16,210,mountain dew,75,100,25,1,445,India
879165,2024-01-16,205,classic yogurt,45,60,15,1,445,India
725067,2024-01-16,212,amul cheese,250,315,65,1,461,India
725067,2024-01-16,206,yakult,360,400,40,1,461,India
996200,2024-01-16,207,coca cola,75,100,25,1,443,India
996200,2024-01-16,203,mango yogurt,50,60,10,1,443,India
996200,2024-01-16,202,milk,12,27,15,1,443,India
514110,2024-01-16,203,mango yogurt,50,60,10,1,374,India
514110,2024-01-16,213,bisleri,6,15,9,1,374,India
514110,2024-01-16,207,coca cola,75,100,25,1,374,India
514110,2024-01-16,211,red bull,90,125,35,1,374,India
501694,2024-01-16,212,amul cheese,250,315,65,1,387,India
501694,2024-01-16,210,mountain dew,75,100,25,1,387,India
501694,2024-01-16,203,mango yogurt,50,60,10,1,387,India
501694,2024-01-16,208,sprite,75,100,25,1,387,India
644903,2024-01-16,210,mountain dew,75,100,25,1,5,India
644903,2024-01-16,208,sprite,75,100,25,1,5,India
644903,2024-01-16,209,pepsi,75,100,25,1,5,India
673754,2024-01-16,210,mountain dew,75,100,25,1,392,India
673754,2024-01-16,206,yakult,360,400,40,1,392,India
673754,2024-01-16,209,pepsi,75,100,25,1,392,India
217361,2024-01-16,207,coca cola,75,100,25,1,160,India
217361,2024-01-16,204,strawberry yogurt,50,60,10,1,160,India
788941,2024-01-16,206,yakult,360,400,40,1,126,India
788941,2024-01-16,209,pepsi,75,100,25,1,126,India
788941,2024-01-16,205,classic yogurt,45,60,15,1,126,India
269757,2024-01-16,206,yakult,360,400,40,1,296,India
269757,2024-01-16,205,classic yogurt,45,60,15,1,296,India
532752,2024-01-16,207,coca cola,75,100,25,1,49,India
581887,2024-01-16,202,milk,12,27,15,1,379,India
581887,2024-01-16,208,sprite,75,100,25,1,379,India
581887,2024-01-16,205,classic yogurt,45,60,15,1,379,India
768336,2024-01-16,203,mango yogurt,50,60,10,1,491,India
305623,2024-01-16,212,amul cheese,250,315,65,1,359,India
305623,2024-01-16,204,strawberry yogurt,50,60,10,1,359,India
305623,2024-01-16,201,paneer,210,340,130,1,359,India
653754,2024-01-17,209,pepsi,75,100,25,1,418,India
653754,2024-01-17,211,red bull,90,125,35,1,418,India
653754,2024-01-17,210,mountain dew,75,100,25,1,418,India
653754,2024-01-17,202,milk,12,27,15,1,418,India
840068,2024-01-17,207,coca cola,75,100,25,1,173,India
840068,2024-01-17,202,milk,12,27,15,1,173,India
529611,2024-01-17,201,paneer,210,340,130,1,28,India
529611,2024-01-17,205,classic yogurt,45,60,15,1,28,India
552399,2024-01-17,211,red bull,90,125,35,1,304,India
552399,2024-01-17,206,yakult,360,400,40,1,304,India
495070,2024-01-17,205,classic yogurt,45,60,15,1,309,India
495070,2024-01-17,202,milk,12,27,15,1,309,India
495070,2024-01-17,206,yakult,360,400,40,1,309,India
495070,2024-01-17,210,mountain dew,75,100,25,1,309,India
382654,2024-01-17,204,strawberry yogurt,50,60,10,1,158,India
382654,2024-01-17,213,bisleri,6,15,9,1,158,India
382654,2024-01-17,208,sprite,75,100,25,1,158,India
382654,2024-01-17,211,red bull,90,125,35,1,158,India
382654,2024-01-17,212,amul cheese,250,315,65,1,158,India
531907,2024-01-17,204,strawberry yogurt,50,60,10,1,9,India
623355,2024-01-17,212,amul cheese,250,315,65,1,158,India
623355,2024-01-17,207,coca cola,75,100,25,1,158,India
623355,2024-01-17,213,bisleri,6,15,9,1,158,India
512998,2024-01-17,209,pepsi,75,100,25,1,143,India
512998,2024-01-17,207,coca cola,75,100,25,1,143,India
812066,2024-01-17,210,mountain dew,75,100,25,1,194,India
812066,2024-01-17,208,sprite,75,100,25,1,194,India
459835,2024-01-17,207,coca cola,75,100,25,1,349,India
785494,2024-01-17,205,classic yogurt,45,60,15,1,308,India
785494,2024-01-17,209,pepsi,75,100,25,1,308,India
785494,2024-01-17,213,bisleri,6,15,9,1,308,India
785494,2024-01-17,211,red bull,90,125,35,1,308,India
278288,2024-01-17,201,paneer,210,340,130,1,50,India
278288,2024-01-17,206,yakult,360,400,40,1,50,India
790863,2024-01-17,204,strawberry yogurt,50,60,10,1,12,India
790863,2024-01-17,202,milk,12,27,15,1,12,India
790863,2024-01-17,210,mountain dew,75,100,25,1,12,India
790863,2024-01-17,208,sprite,75,100,25,1,12,India
790863,2024-01-17,213,bisleri,6,15,9,1,12,India
171957,2024-01-17,212,amul cheese,250,315,65,1,159,India
171957,2024-01-17,204,strawberry yogurt,50,60,10,1,159,India
171957,2024-01-17,207,coca cola,75,100,25,1,159,India
708085,2024-01-17,212,amul cheese,250,315,65,1,390,India
708085,2024-01-17,208,sprite,75,100,25,1,390,India
708085,2024-01-17,210,mountain dew,75,100,25,1,390,India
708085,2024-01-17,209,pepsi,75,100,25,1,390,India
466990,2024-01-17,205,classic yogurt,45,60,15,1,98,India
466990,2024-01-17,203,mango yogurt,50,60,10,1,98,India
466990,2024-01-17,201,paneer,210,340,130,1,98,India
466990,2024-01-17,213,bisleri,6,15,9,1,98,India
732459,2024-01-17,208,sprite,75,100,25,1,118,India
732459,2024-01-17,202,milk,12,27,15,1,118,India
732459,2024-01-17,212,amul cheese,250,315,65,1,118,India
732459,2024-01-17,209,pepsi,75,100,25,1,118,India
109085,2024-01-17,213,bisleri,6,15,9,1,302,India
109085,2024-01-17,212,amul cheese,250,315,65,1,302,India
109085,2024-01-17,205,classic yogurt,45,60,15,1,302,India
319240,2024-01-17,213,bisleri,6,15,9,1,398,India
319240,2024-01-17,207,coca cola,75,100,25,1,398,India
224609,2024-01-17,201,paneer,210,340,130,1,3,India
224609,2024-01-17,210,mountain dew,75,100,25,1,3,India
224609,2024-01-17,204,strawberry yogurt,50,60,10,1,3,India
722833,2024-01-17,203,mango yogurt,50,60,10,1,167,India
722833,2024-01-17,202,milk,12,27,15,1,167,India
722833,2024-01-17,205,classic yogurt,45,60,15,1,167,India
722833,2024-01-17,209,pepsi,75,100,25,1,167,India
722833,2024-01-17,201,paneer,210,340,130,1,167,India
993993,2024-01-17,208,sprite,75,100,25,1,181,India
993993,2024-01-17,211,red bull,90,125,35,1,181,India
993993,2024-01-17,207,coca cola,75,100,25,1,181,India
961124,2024-01-17,211,red bull,90,125,35,1,423,India
961124,2024-01-17,206,yakult,360,400,40,1,423,India
961124,2024-01-17,208,sprite,75,100,25,1,423,India
961124,2024-01-17,201,paneer,210,340,130,1,423,India
928985,2024-01-17,207,coca cola,75,100,25,1,110,India
928985,2024-01-17,201,paneer,210,340,130,1,110,India
928985,2024-01-17,206,yakult,360,400,40,1,110,India
928985,2024-01-17,208,sprite,75,100,25,1,110,India
928985,2024-01-17,211,red bull,90,125,35,1,110,India
999226,2024-01-17,207,coca cola,75,100,25,1,369,India
999226,2024-01-17,209,pepsi,75,100,25,1,369,India
999226,2024-01-17,210,mountain dew,75,100,25,1,369,India
999226,2024-01-17,204,strawberry yogurt,50,60,10,1,369,India
999226,2024-01-17,211,red bull,90,125,35,1,369,India
224846,2024-01-17,203,mango yogurt,50,60,10,1,234,India
224846,2024-01-17,201,paneer,210,340,130,1,234,India
224846,2024-01-17,213,bisleri,6,15,9,1,234,India
224846,2024-01-17,206,yakult,360,400,40,1,234,India
200591,2024-01-17,204,strawberry yogurt,50,60,10,1,452,India
759797,2024-01-17,213,bisleri,6,15,9,1,199,India
143854,2024-01-17,203,mango yogurt,50,60,10,1,455,India
143854,2024-01-17,204,strawberry yogurt,50,60,10,1,455,India
143854,2024-01-17,208,sprite,75,100,25,1,455,India
143854,2024-01-17,211,red bull,90,125,35,1,455,India
998593,2024-01-17,209,pepsi,75,100,25,1,76,India
998593,2024-01-17,208,sprite,75,100,25,1,76,India
998593,2024-01-17,206,yakult,360,400,40,1,76,India
998593,2024-01-17,204,strawberry yogurt,50,60,10,1,76,India
396493,2024-01-17,210,mountain dew,75,100,25,1,173,India
396493,2024-01-17,206,yakult,360,400,40,1,173,India
396493,2024-01-17,207,coca cola,75,100,25,1,173,India
396493,2024-01-17,201,paneer,210,340,130,1,173,India
396493,2024-01-17,205,classic yogurt,45,60,15,1,173,India
104872,2024-01-17,203,mango yogurt,50,60,10,1,203,India
104872,2024-01-17,208,sprite,75,100,25,1,203,India
104872,2024-01-17,205,classic yogurt,45,60,15,1,203,India
104872,2024-01-17,206,yakult,360,400,40,1,203,India
366335,2024-01-17,212,amul cheese,250,315,65,1,83,India
366335,2024-01-17,203,mango yogurt,50,60,10,1,83,India
366335,2024-01-17,201,paneer,210,340,130,1,83,India
658317,2024-01-17,203,mango yogurt,50,60,10,1,79,India
658317,2024-01-17,201,paneer,210,340,130,1,79,India
225971,2024-01-17,202,milk,12,27,15,1,276,India
225971,2024-01-17,204,strawberry yogurt,50,60,10,1,276,India
225971,2024-01-17,203,mango yogurt,50,60,10,1,276,India
225971,2024-01-17,209,pepsi,75,100,25,1,276,India
205711,2024-01-17,201,paneer,210,340,130,1,480,India
205711,2024-01-17,210,mountain dew,75,100,25,1,480,India
205711,2024-01-17,213,bisleri,6,15,9,1,480,India
205711,2024-01-17,209,pepsi,75,100,25,1,480,India
205711,2024-01-17,202,milk,12,27,15,1,480,India
164948,2024-01-17,201,paneer,210,340,130,1,319,India
164948,2024-01-17,208,sprite,75,100,25,1,319,India
325815,2024-01-17,206,yakult,360,400,40,1,472,India
325815,2024-01-17,204,strawberry yogurt,50,60,10,1,472,India
811510,2024-01-17,209,pepsi,75,100,25,1,411,India
811510,2024-01-17,208,sprite,75,100,25,1,411,India
592358,2024-01-17,211,red bull,90,125,35,1,96,India
589310,2024-01-17,208,sprite,75,100,25,1,299,India
891000,2024-01-17,210,mountain dew,75,100,25,1,187,India
917896,2024-01-17,201,paneer,210,340,130,1,67,India
917896,2024-01-17,204,strawberry yogurt,50,60,10,1,67,India
124447,2024-01-17,206,yakult,360,400,40,1,320,India
124447,2024-01-17,207,coca cola,75,100,25,1,320,India
124447,2024-01-17,211,red bull,90,125,35,1,320,India
514680,2024-01-17,211,red bull,90,125,35,1,224,India
514680,2024-01-17,202,milk,12,27,15,1,224,India
514680,2024-01-17,205,classic yogurt,45,60,15,1,224,India
514680,2024-01-17,208,sprite,75,100,25,1,224,India
219075,2024-01-17,211,red bull,90,125,35,1,75,India
219075,2024-01-17,209,pepsi,75,100,25,1,75,India
762867,2024-01-17,204,strawberry yogurt,50,60,10,1,266,India
762867,2024-01-17,203,mango yogurt,50,60,10,1,266,India
693843,2024-01-17,207,coca cola,75,100,25,1,85,India
693843,2024-01-17,203,mango yogurt,50,60,10,1,85,India
693843,2024-01-17,209,pepsi,75,100,25,1,85,India
693843,2024-01-17,205,classic yogurt,45,60,15,1,85,India
437355,2024-01-17,202,milk,12,27,15,1,94,India
437355,2024-01-17,208,sprite,75,100,25,1,94,India
437355,2024-01-17,211,red bull,90,125,35,1,94,India
952960,2024-01-17,212,amul cheese,250,315,65,1,232,India
952960,2024-01-17,205,classic yogurt,45,60,15,1,232,India
952960,2024-01-17,207,coca cola,75,100,25,1,232,India
952960,2024-01-17,202,milk,12,27,15,1,232,India
635507,2024-01-17,205,classic yogurt,45,60,15,1,326,India
635507,2024-01-17,203,mango yogurt,50,60,10,1,326,India
678476,2024-01-17,208,sprite,75,100,25,1,173,India
678476,2024-01-17,211,red bull,90,125,35,1,173,India
678476,2024-01-17,201,paneer,210,340,130,1,173,India
816133,2024-01-17,205,classic yogurt,45,60,15,1,231,India
816133,2024-01-17,211,red bull,90,125,35,1,231,India
816133,2024-01-17,210,mountain dew,75,100,25,1,231,India
488740,2024-01-17,206,yakult,360,400,40,1,69,India
488740,2024-01-17,210,mountain dew,75,100,25,1,69,India
488740,2024-01-17,207,coca cola,75,100,25,1,69,India
488740,2024-01-17,213,bisleri,6,15,9,1,69,India
928597,2024-01-17,211,red bull,90,125,35,1,107,India
928597,2024-01-17,210,mountain dew,75,100,25,1,107,India
928597,2024-01-17,201,paneer,210,340,130,1,107,India
197983,2024-01-17,210,mountain dew,75,100,25,1,114,India
197983,2024-01-17,209,pepsi,75,100,25,1,114,India
197983,2024-01-17,201,paneer,210,340,130,1,114,India
197983,2024-01-17,206,yakult,360,400,40,1,114,India
576935,2024-01-17,212,amul cheese,250,315,65,1,237,India
118308,2024-01-17,206,yakult,360,400,40,1,104,India
118308,2024-01-17,210,mountain dew,75,100,25,1,104,India
118308,2024-01-17,208,sprite,75,100,25,1,104,India
118308,2024-01-17,202,milk,12,27,15,1,104,India
118308,2024-01-17,212,amul cheese,250,315,65,1,104,India
711989,2024-01-17,207,coca cola,75,100,25,1,404,India
711989,2024-01-17,208,sprite,75,100,25,1,404,India
711989,2024-01-17,201,paneer,210,340,130,1,404,India
397220,2024-01-17,210,mountain dew,75,100,25,1,447,India
397220,2024-01-17,212,amul cheese,250,315,65,1,447,India
397220,2024-01-17,211,red bull,90,125,35,1,447,India
945538,2024-01-17,213,bisleri,6,15,9,1,81,India
945538,2024-01-17,207,coca cola,75,100,25,1,81,India
945538,2024-01-17,204,strawberry yogurt,50,60,10,1,81,India
945538,2024-01-17,202,milk,12,27,15,1,81,India
231620,2024-01-17,208,sprite,75,100,25,1,351,India
231620,2024-01-17,213,bisleri,6,15,9,1,351,India
231620,2024-01-17,204,strawberry yogurt,50,60,10,1,351,India
231620,2024-01-17,205,classic yogurt,45,60,15,1,351,India
645008,2024-01-17,213,bisleri,6,15,9,1,221,India
645008,2024-01-17,207,coca cola,75,100,25,1,221,India
645008,2024-01-17,210,mountain dew,75,100,25,1,221,India
645008,2024-01-17,212,amul cheese,250,315,65,1,221,India
117267,2024-01-17,207,coca cola,75,100,25,1,475,India
117267,2024-01-17,208,sprite,75,100,25,1,475,India
190565,2024-01-17,213,bisleri,6,15,9,1,430,India
190565,2024-01-17,211,red bull,90,125,35,1,430,India
789927,2024-01-17,206,yakult,360,400,40,1,65,India
789927,2024-01-17,205,classic yogurt,45,60,15,1,65,India
789927,2024-01-17,201,paneer,210,340,130,1,65,India
967195,2024-01-17,213,bisleri,6,15,9,1,392,India
967195,2024-01-17,205,classic yogurt,45,60,15,1,392,India
967195,2024-01-17,204,strawberry yogurt,50,60,10,1,392,India
751472,2024-01-17,201,paneer,210,340,130,1,281,India
751472,2024-01-17,203,mango yogurt,50,60,10,1,281,India
532091,2024-01-17,203,mango yogurt,50,60,10,1,141,India
532091,2024-01-17,206,yakult,360,400,40,1,141,India
392773,2024-01-17,209,pepsi,75,100,25,1,442,India
392773,2024-01-17,206,yakult,360,400,40,1,442,India
356065,2024-01-17,205,classic yogurt,45,60,15,1,344,India
356065,2024-01-17,202,milk,12,27,15,1,344,India
356065,2024-01-17,203,mango yogurt,50,60,10,1,344,India
356065,2024-01-17,208,sprite,75,100,25,1,344,India
814412,2024-01-17,212,amul cheese,250,315,65,1,194,India
273673,2024-01-17,208,sprite,75,100,25,1,321,India
273673,2024-01-17,205,classic yogurt,45,60,15,1,321,India
485844,2024-01-17,209,pepsi,75,100,25,1,139,India
485844,2024-01-17,206,yakult,360,400,40,1,139,India
485844,2024-01-17,213,bisleri,6,15,9,1,139,India
924991,2024-01-17,212,amul cheese,250,315,65,1,53,India
924991,2024-01-17,205,classic yogurt,45,60,15,1,53,India
924991,2024-01-17,201,paneer,210,340,130,1,53,India
924991,2024-01-17,209,pepsi,75,100,25,1,53,India
309513,2024-01-17,206,yakult,360,400,40,1,289,India
826344,2024-01-17,206,yakult,360,400,40,1,68,India
826344,2024-01-17,212,amul cheese,250,315,65,1,68,India
560540,2024-01-17,211,red bull,90,125,35,1,337,India
560540,2024-01-17,212,amul cheese,250,315,65,1,337,India
489274,2024-01-17,212,amul cheese,250,315,65,1,107,India
489274,2024-01-17,209,pepsi,75,100,25,1,107,India
120296,2024-01-17,202,milk,12,27,15,1,104,India
120296,2024-01-17,206,yakult,360,400,40,1,104,India
120296,2024-01-17,201,paneer,210,340,130,1,104,India
120296,2024-01-17,207,coca cola,75,100,25,1,104,India
133555,2024-01-17,212,amul cheese,250,315,65,1,446,India
695251,2024-01-17,206,yakult,360,400,40,1,296,India
695251,2024-01-17,208,sprite,75,100,25,1,296,India
951188,2024-01-17,205,classic yogurt,45,60,15,1,101,India
951188,2024-01-17,201,paneer,210,340,130,1,101,India
951188,2024-01-17,210,mountain dew,75,100,25,1,101,India
951188,2024-01-17,208,sprite,75,100,25,1,101,India
509177,2024-01-17,211,red bull,90,125,35,1,151,India
509177,2024-01-17,208,sprite,75,100,25,1,151,India
509177,2024-01-17,202,milk,12,27,15,1,151,India
649010,2024-01-17,204,strawberry yogurt,50,60,10,1,104,India
649010,2024-01-17,207,coca cola,75,100,25,1,104,India
504440,2024-01-17,210,mountain dew,75,100,25,1,375,India
504440,2024-01-17,201,paneer,210,340,130,1,375,India
504440,2024-01-17,203,mango yogurt,50,60,10,1,375,India
504440,2024-01-17,212,amul cheese,250,315,65,1,375,India
486521,2024-01-17,210,mountain dew,75,100,25,1,186,India
486521,2024-01-17,211,red bull,90,125,35,1,186,India
920190,2024-01-17,203,mango yogurt,50,60,10,1,337,India
920190,2024-01-17,210,mountain dew,75,100,25,1,337,India
968560,2024-01-17,213,bisleri,6,15,9,1,42,India
826863,2024-01-17,206,yakult,360,400,40,1,183,India
826863,2024-01-17,213,bisleri,6,15,9,1,183,India
826863,2024-01-17,201,paneer,210,340,130,1,183,India
981953,2024-01-17,209,pepsi,75,100,25,1,371,India
981953,2024-01-17,212,amul cheese,250,315,65,1,371,India
171981,2024-01-17,212,amul cheese,250,315,65,1,500,India
171981,2024-01-17,211,red bull,90,125,35,1,500,India
171981,2024-01-17,204,strawberry yogurt,50,60,10,1,500,India
759656,2024-01-17,208,sprite,75,100,25,1,129,India
759656,2024-01-17,211,red bull,90,125,35,1,129,India
701376,2024-01-17,204,strawberry yogurt,50,60,10,1,112,India
701376,2024-01-17,212,amul cheese,250,315,65,1,112,India
701376,2024-01-17,202,milk,12,27,15,1,112,India
701376,2024-01-17,207,coca cola,75,100,25,1,112,India
701376,2024-01-17,205,classic yogurt,45,60,15,1,112,India
439411,2024-01-17,206,yakult,360,400,40,1,245,India
439411,2024-01-17,204,strawberry yogurt,50,60,10,1,245,India
439411,2024-01-17,202,milk,12,27,15,1,245,India
983987,2024-01-18,204,strawberry yogurt,50,60,10,1,129,India
633943,2024-01-18,206,yakult,360,400,40,1,408,India
633943,2024-01-18,205,classic yogurt,45,60,15,1,408,India
691940,2024-01-18,202,milk,12,27,15,1,171,India
492572,2024-01-18,202,milk,12,27,15,1,378,India
492572,2024-01-18,201,paneer,210,340,130,1,378,India
492572,2024-01-18,212,amul cheese,250,315,65,1,378,India
492572,2024-01-18,208,sprite,75,100,25,1,378,India
626257,2024-01-18,203,mango yogurt,50,60,10,1,178,India
626257,2024-01-18,204,strawberry yogurt,50,60,10,1,178,India
626257,2024-01-18,207,coca cola,75,100,25,1,178,India
761021,2024-01-18,208,sprite,75,100,25,1,199,India
810513,2024-01-18,207,coca cola,75,100,25,1,12,India
810513,2024-01-18,205,classic yogurt,45,60,15,1,12,India
810513,2024-01-18,206,yakult,360,400,40,1,12,India
810513,2024-01-18,211,red bull,90,125,35,1,12,India
689565,2024-01-18,202,milk,12,27,15,1,270,India
689565,2024-01-18,207,coca cola,75,100,25,1,270,India
244774,2024-01-18,210,mountain dew,75,100,25,1,294,India
244774,2024-01-18,211,red bull,90,125,35,1,294,India
244774,2024-01-18,202,milk,12,27,15,1,294,India
127350,2024-01-18,212,amul cheese,250,315,65,1,246,India
127350,2024-01-18,208,sprite,75,100,25,1,246,India
165317,2024-01-18,206,yakult,360,400,40,1,19,India
165317,2024-01-18,207,coca cola,75,100,25,1,19,India
165317,2024-01-18,213,bisleri,6,15,9,1,19,India
884597,2024-01-18,210,mountain dew,75,100,25,1,275,India
884597,2024-01-18,207,coca cola,75,100,25,1,275,India
884597,2024-01-18,201,paneer,210,340,130,1,275,India
884597,2024-01-18,202,milk,12,27,15,1,275,India
721790,2024-01-18,206,yakult,360,400,40,1,288,India
721790,2024-01-18,213,bisleri,6,15,9,1,288,India
721790,2024-01-18,201,paneer,210,340,130,1,288,India
721790,2024-01-18,205,classic yogurt,45,60,15,1,288,India
721790,2024-01-18,208,sprite,75,100,25,1,288,India
935400,2024-01-18,202,milk,12,27,15,1,179,India
935400,2024-01-18,212,amul cheese,250,315,65,1,179,India
935400,2024-01-18,203,mango yogurt,50,60,10,1,179,India
292646,2024-01-18,209,pepsi,75,100,25,1,170,India
292646,2024-01-18,206,yakult,360,400,40,1,170,India
292646,2024-01-18,210,mountain dew,75,100,25,1,170,India
321390,2024-01-18,207,coca cola,75,100,25,1,227,India
280533,2024-01-18,202,milk,12,27,15,1,40,India
280533,2024-01-18,207,coca cola,75,100,25,1,40,India
280533,2024-01-18,201,paneer,210,340,130,1,40,India
924610,2024-01-18,202,milk,12,27,15,1,364,India
924610,2024-01-18,211,red bull,90,125,35,1,364,India
924610,2024-01-18,212,amul cheese,250,315,65,1,364,India
834304,2024-01-18,202,milk,12,27,15,1,409,India
158396,2024-01-18,202,milk,12,27,15,1,438,India
158396,2024-01-18,204,strawberry yogurt,50,60,10,1,438,India
158396,2024-01-18,209,pepsi,75,100,25,1,438,India
975052,2024-01-18,212,amul cheese,250,315,65,1,296,India
975052,2024-01-18,213,bisleri,6,15,9,1,296,India
975052,2024-01-18,201,paneer,210,340,130,1,296,India
693979,2024-01-18,208,sprite,75,100,25,1,205,India
377310,2024-01-18,207,coca cola,75,100,25,1,105,India
656387,2024-01-18,208,sprite,75,100,25,1,395,India
607035,2024-01-18,204,strawberry yogurt,50,60,10,1,438,India
607035,2024-01-18,212,amul cheese,250,315,65,1,438,India
607035,2024-01-18,209,pepsi,75,100,25,1,438,India
607035,2024-01-18,207,coca cola,75,100,25,1,438,India
973090,2024-01-18,203,mango yogurt,50,60,10,1,168,India
973090,2024-01-18,211,red bull,90,125,35,1,168,India
454171,2024-01-18,210,mountain dew,75,100,25,1,65,India
454171,2024-01-18,213,bisleri,6,15,9,1,65,India
185617,2024-01-18,207,coca cola,75,100,25,1,426,India
185617,2024-01-18,209,pepsi,75,100,25,1,426,India
185617,2024-01-18,208,sprite,75,100,25,1,426,India
286645,2024-01-18,206,yakult,360,400,40,1,108,India
286645,2024-01-18,210,mountain dew,75,100,25,1,108,India
286645,2024-01-18,213,bisleri,6,15,9,1,108,India
286645,2024-01-18,202,milk,12,27,15,1,108,India
286645,2024-01-18,211,red bull,90,125,35,1,108,India
331368,2024-01-18,206,yakult,360,400,40,1,206,India
331368,2024-01-18,212,amul cheese,250,315,65,1,206,India
331368,2024-01-18,203,mango yogurt,50,60,10,1,206,India
874839,2024-01-18,203,mango yogurt,50,60,10,1,268,India
874839,2024-01-18,210,mountain dew,75,100,25,1,268,India
874839,2024-01-18,202,milk,12,27,15,1,268,India
874839,2024-01-18,201,paneer,210,340,130,1,268,India
359080,2024-01-18,212,amul cheese,250,315,65,1,210,India
359080,2024-01-18,213,bisleri,6,15,9,1,210,India
359080,2024-01-18,206,yakult,360,400,40,1,210,India
359080,2024-01-18,210,mountain dew,75,100,25,1,210,India
507689,2024-01-18,206,yakult,360,400,40,1,262,India
814762,2024-01-18,205,classic yogurt,45,60,15,1,183,India
814762,2024-01-18,207,coca cola,75,100,25,1,183,India
814762,2024-01-18,201,paneer,210,340,130,1,183,India
673780,2024-01-18,205,classic yogurt,45,60,15,1,197,India
673780,2024-01-18,210,mountain dew,75,100,25,1,197,India
666385,2024-01-18,203,mango yogurt,50,60,10,1,434,India
666385,2024-01-18,205,classic yogurt,45,60,15,1,434,India
666385,2024-01-18,211,red bull,90,125,35,1,434,India
311257,2024-01-18,203,mango yogurt,50,60,10,1,406,India
311257,2024-01-18,211,red bull,90,125,35,1,406,India
311257,2024-01-18,210,mountain dew,75,100,25,1,406,India
311257,2024-01-18,205,classic yogurt,45,60,15,1,406,India
917713,2024-01-18,202,milk,12,27,15,1,494,India
917713,2024-01-18,208,sprite,75,100,25,1,494,India
917713,2024-01-18,203,mango yogurt,50,60,10,1,494,India
917713,2024-01-18,212,amul cheese,250,315,65,1,494,India
917713,2024-01-18,210,mountain dew,75,100,25,1,494,India
662182,2024-01-18,212,amul cheese,250,315,65,1,449,India
510725,2024-01-18,211,red bull,90,125,35,1,155,India
510725,2024-01-18,207,coca cola,75,100,25,1,155,India
510725,2024-01-18,206,yakult,360,400,40,1,155,India
510725,2024-01-18,210,mountain dew,75,100,25,1,155,India
559998,2024-01-18,209,pepsi,75,100,25,1,69,India
559998,2024-01-18,203,mango yogurt,50,60,10,1,69,India
124063,2024-01-18,212,amul cheese,250,315,65,1,15,India
124063,2024-01-18,213,bisleri,6,15,9,1,15,India
124063,2024-01-18,207,coca cola,75,100,25,1,15,India
124063,2024-01-18,201,paneer,210,340,130,1,15,India
420082,2024-01-18,211,red bull,90,125,35,1,389,India
480030,2024-01-18,206,yakult,360,400,40,1,2,India
480030,2024-01-18,205,classic yogurt,45,60,15,1,2,India
480030,2024-01-18,203,mango yogurt,50,60,10,1,2,India
480030,2024-01-18,201,paneer,210,340,130,1,2,India
480030,2024-01-18,210,mountain dew,75,100,25,1,2,India
230530,2024-01-18,212,amul cheese,250,315,65,1,64,India
230530,2024-01-18,203,mango yogurt,50,60,10,1,64,India
230530,2024-01-18,202,milk,12,27,15,1,64,India
690043,2024-01-18,206,yakult,360,400,40,1,224,India
767615,2024-01-18,209,pepsi,75,100,25,1,132,India
767615,2024-01-18,202,milk,12,27,15,1,132,India
767615,2024-01-18,213,bisleri,6,15,9,1,132,India
767615,2024-01-18,206,yakult,360,400,40,1,132,India
190813,2024-01-18,205,classic yogurt,45,60,15,1,67,India
190813,2024-01-18,212,amul cheese,250,315,65,1,67,India
505580,2024-01-18,203,mango yogurt,50,60,10,1,481,India
505580,2024-01-18,201,paneer,210,340,130,1,481,India
505580,2024-01-18,210,mountain dew,75,100,25,1,481,India
992805,2024-01-18,202,milk,12,27,15,1,275,India
992805,2024-01-18,201,paneer,210,340,130,1,275,India
992805,2024-01-18,205,classic yogurt,45,60,15,1,275,India
402343,2024-01-18,204,strawberry yogurt,50,60,10,1,461,India
402343,2024-01-18,202,milk,12,27,15,1,461,India
355427,2024-01-18,206,yakult,360,400,40,1,108,India
679974,2024-01-18,211,red bull,90,125,35,1,270,India
679974,2024-01-18,205,classic yogurt,45,60,15,1,270,India
679974,2024-01-18,203,mango yogurt,50,60,10,1,270,India
679974,2024-01-18,207,coca cola,75,100,25,1,270,India
679974,2024-01-18,208,sprite,75,100,25,1,270,India
445854,2024-01-18,201,paneer,210,340,130,1,60,India
445854,2024-01-18,212,amul cheese,250,315,65,1,60,India
445854,2024-01-18,205,classic yogurt,45,60,15,1,60,India
445854,2024-01-18,213,bisleri,6,15,9,1,60,India
532358,2024-01-18,210,mountain dew,75,100,25,1,88,India
532358,2024-01-18,212,amul cheese,250,315,65,1,88,India
637587,2024-01-18,203,mango yogurt,50,60,10,1,472,India
637587,2024-01-18,207,coca cola,75,100,25,1,472,India
637587,2024-01-18,201,paneer,210,340,130,1,472,India
637587,2024-01-18,204,strawberry yogurt,50,60,10,1,472,India
637587,2024-01-18,210,mountain dew,75,100,25,1,472,India
102932,2024-01-18,207,coca cola,75,100,25,1,407,India
102932,2024-01-18,209,pepsi,75,100,25,1,407,India
102932,2024-01-18,204,strawberry yogurt,50,60,10,1,407,India
102932,2024-01-18,202,milk,12,27,15,1,407,India
102932,2024-01-18,210,mountain dew,75,100,25,1,407,India
890086,2024-01-18,211,red bull,90,125,35,1,64,India
342051,2024-01-18,204,strawberry yogurt,50,60,10,1,380,India
342051,2024-01-18,210,mountain dew,75,100,25,1,380,India
342051,2024-01-18,203,mango yogurt,50,60,10,1,380,India
342051,2024-01-18,212,amul cheese,250,315,65,1,380,India
630770,2024-01-18,213,bisleri,6,15,9,1,145,India
630770,2024-01-18,204,strawberry yogurt,50,60,10,1,145,India
282173,2024-01-18,213,bisleri,6,15,9,1,416,India
282173,2024-01-18,210,mountain dew,75,100,25,1,416,India
282173,2024-01-18,206,yakult,360,400,40,1,416,India
657953,2024-01-18,210,mountain dew,75,100,25,1,19,India
109278,2024-01-18,213,bisleri,6,15,9,1,465,India
109278,2024-01-18,209,pepsi,75,100,25,1,465,India
109278,2024-01-18,208,sprite,75,100,25,1,465,India
109278,2024-01-18,201,paneer,210,340,130,1,465,India
782778,2024-01-18,209,pepsi,75,100,25,1,58,India
782778,2024-01-18,203,mango yogurt,50,60,10,1,58,India
782778,2024-01-18,207,coca cola,75,100,25,1,58,India
267097,2024-01-18,201,paneer,210,340,130,1,184,India
267097,2024-01-18,213,bisleri,6,15,9,1,184,India
227426,2024-01-18,207,coca cola,75,100,25,1,347,India
227426,2024-01-18,205,classic yogurt,45,60,15,1,347,India
853142,2024-01-18,212,amul cheese,250,315,65,1,448,India
853142,2024-01-18,204,strawberry yogurt,50,60,10,1,448,India
853142,2024-01-18,207,coca cola,75,100,25,1,448,India
853142,2024-01-18,206,yakult,360,400,40,1,448,India
853142,2024-01-18,211,red bull,90,125,35,1,448,India
330585,2024-01-18,212,amul cheese,250,315,65,1,20,India
986732,2024-01-18,207,coca cola,75,100,25,1,225,India
657076,2024-01-18,201,paneer,210,340,130,1,154,India
657076,2024-01-18,212,amul cheese,250,315,65,1,154,India
285562,2024-01-18,205,classic yogurt,45,60,15,1,73,India
285562,2024-01-18,202,milk,12,27,15,1,73,India
285562,2024-01-18,211,red bull,90,125,35,1,73,India
350618,2024-01-18,212,amul cheese,250,315,65,1,418,India
150748,2024-01-18,207,coca cola,75,100,25,1,13,India
150748,2024-01-18,201,paneer,210,340,130,1,13,India
150748,2024-01-18,202,milk,12,27,15,1,13,India
150748,2024-01-18,209,pepsi,75,100,25,1,13,India
235599,2024-01-18,206,yakult,360,400,40,1,122,India
235599,2024-01-18,211,red bull,90,125,35,1,122,India
235599,2024-01-18,207,coca cola,75,100,25,1,122,India
235599,2024-01-18,204,strawberry yogurt,50,60,10,1,122,India
235599,2024-01-18,213,bisleri,6,15,9,1,122,India
158130,2024-01-18,205,classic yogurt,45,60,15,1,29,India
158130,2024-01-18,201,paneer,210,340,130,1,29,India
158130,2024-01-18,211,red bull,90,125,35,1,29,India
606206,2024-01-18,207,coca cola,75,100,25,1,474,India
606206,2024-01-18,212,amul cheese,250,315,65,1,474,India
614302,2024-01-18,210,mountain dew,75,100,25,1,36,India
614302,2024-01-18,208,sprite,75,100,25,1,36,India
614302,2024-01-18,202,milk,12,27,15,1,36,India
614302,2024-01-18,206,yakult,360,400,40,1,36,India
525845,2024-01-19,203,mango yogurt,50,60,10,1,494,India
525845,2024-01-19,213,bisleri,6,15,9,1,494,India
235081,2024-01-19,206,yakult,360,400,40,1,458,India
235081,2024-01-19,208,sprite,75,100,25,1,458,India
235081,2024-01-19,202,milk,12,27,15,1,458,India
648619,2024-01-19,213,bisleri,6,15,9,1,188,India
648619,2024-01-19,211,red bull,90,125,35,1,188,India
961294,2024-01-19,204,strawberry yogurt,50,60,10,1,80,India
961294,2024-01-19,205,classic yogurt,45,60,15,1,80,India
961294,2024-01-19,203,mango yogurt,50,60,10,1,80,India
961294,2024-01-19,211,red bull,90,125,35,1,80,India
961294,2024-01-19,201,paneer,210,340,130,1,80,India
345660,2024-01-19,213,bisleri,6,15,9,1,228,India
345660,2024-01-19,201,paneer,210,340,130,1,228,India
154630,2024-01-19,213,bisleri,6,15,9,1,471,India
154630,2024-01-19,201,paneer,210,340,130,1,471,India
891278,2024-01-19,207,coca cola,75,100,25,1,478,India
891278,2024-01-19,209,pepsi,75,100,25,1,478,India
416025,2024-01-19,212,amul cheese,250,315,65,1,414,India
811925,2024-01-19,205,classic yogurt,45,60,15,1,482,India
811925,2024-01-19,202,milk,12,27,15,1,482,India
811925,2024-01-19,213,bisleri,6,15,9,1,482,India
865784,2024-01-19,204,strawberry yogurt,50,60,10,1,247,India
865784,2024-01-19,207,coca cola,75,100,25,1,247,India
865784,2024-01-19,209,pepsi,75,100,25,1,247,India
865784,2024-01-19,205,classic yogurt,45,60,15,1,247,India
465154,2024-01-19,213,bisleri,6,15,9,1,187,India
465154,2024-01-19,211,red bull,90,125,35,1,187,India
465154,2024-01-19,207,coca cola,75,100,25,1,187,India
889701,2024-01-19,209,pepsi,75,100,25,1,415,India
889701,2024-01-19,206,yakult,360,400,40,1,415,India
505032,2024-01-19,205,classic yogurt,45,60,15,1,495,India
676418,2024-01-19,207,coca cola,75,100,25,1,220,India
676418,2024-01-19,209,pepsi,75,100,25,1,220,India
491278,2024-01-19,203,mango yogurt,50,60,10,1,282,India
491278,2024-01-19,211,red bull,90,125,35,1,282,India
365859,2024-01-19,204,strawberry yogurt,50,60,10,1,239,India
365859,2024-01-19,210,mountain dew,75,100,25,1,239,India
365859,2024-01-19,207,coca cola,75,100,25,1,239,India
365859,2024-01-19,206,yakult,360,400,40,1,239,India
658259,2024-01-19,206,yakult,360,400,40,1,90,India
123580,2024-01-19,207,coca cola,75,100,25,1,431,India
123580,2024-01-19,208,sprite,75,100,25,1,431,India
123580,2024-01-19,211,red bull,90,125,35,1,431,India
134959,2024-01-19,205,classic yogurt,45,60,15,1,325,India
134959,2024-01-19,203,mango yogurt,50,60,10,1,325,India
134959,2024-01-19,208,sprite,75,100,25,1,325,India
246037,2024-01-19,209,pepsi,75,100,25,1,169,India
246037,2024-01-19,201,paneer,210,340,130,1,169,India
533011,2024-01-19,211,red bull,90,125,35,1,60,India
303292,2024-01-19,213,bisleri,6,15,9,1,131,India
987567,2024-01-19,213,bisleri,6,15,9,1,59,India
987567,2024-01-19,205,classic yogurt,45,60,15,1,59,India
987567,2024-01-19,203,mango yogurt,50,60,10,1,59,India
987567,2024-01-19,208,sprite,75,100,25,1,59,India
684503,2024-01-19,208,sprite,75,100,25,1,452,India
684503,2024-01-19,201,paneer,210,340,130,1,452,India
684503,2024-01-19,207,coca cola,75,100,25,1,452,India
684503,2024-01-19,205,classic yogurt,45,60,15,1,452,India
684503,2024-01-19,202,milk,12,27,15,1,452,India
838839,2024-01-19,203,mango yogurt,50,60,10,1,97,India
598161,2024-01-19,206,yakult,360,400,40,1,118,India
546441,2024-01-19,208,sprite,75,100,25,1,338,India
737650,2024-01-19,211,red bull,90,125,35,1,46,India
544898,2024-01-19,210,mountain dew,75,100,25,1,184,India
544898,2024-01-19,211,red bull,90,125,35,1,184,India
724423,2024-01-19,206,yakult,360,400,40,1,346,India
724423,2024-01-19,205,classic yogurt,45,60,15,1,346,India
724423,2024-01-19,211,red bull,90,125,35,1,346,India
724423,2024-01-19,212,amul cheese,250,315,65,1,346,India
536504,2024-01-19,202,milk,12,27,15,1,206,India
536504,2024-01-19,211,red bull,90,125,35,1,206,India
536504,2024-01-19,213,bisleri,6,15,9,1,206,India
388072,2024-01-19,201,paneer,210,340,130,1,149,India
388072,2024-01-19,206,yakult,360,400,40,1,149,India
388072,2024-01-19,212,amul cheese,250,315,65,1,149,India
388072,2024-01-19,208,sprite,75,100,25,1,149,India
143275,2024-01-19,211,red bull,90,125,35,1,459,India
143275,2024-01-19,212,amul cheese,250,315,65,1,459,India
621878,2024-01-19,203,mango yogurt,50,60,10,1,267,India
621878,2024-01-19,206,yakult,360,400,40,1,267,India
941871,2024-01-19,211,red bull,90,125,35,1,2,India
852270,2024-01-19,213,bisleri,6,15,9,1,332,India
532146,2024-01-19,202,milk,12,27,15,1,167,India
532146,2024-01-19,208,sprite,75,100,25,1,167,India
532146,2024-01-19,207,coca cola,75,100,25,1,167,India
532146,2024-01-19,201,paneer,210,340,130,1,167,India
532146,2024-01-19,210,mountain dew,75,100,25,1,167,India
865328,2024-01-19,207,coca cola,75,100,25,1,60,India
865328,2024-01-19,213,bisleri,6,15,9,1,60,India
865328,2024-01-19,208,sprite,75,100,25,1,60,India
167023,2024-01-19,211,red bull,90,125,35,1,295,India
167023,2024-01-19,212,amul cheese,250,315,65,1,295,India
167023,2024-01-19,204,strawberry yogurt,50,60,10,1,295,India
167023,2024-01-19,201,paneer,210,340,130,1,295,India
758083,2024-01-19,202,milk,12,27,15,1,337,India
758083,2024-01-19,211,red bull,90,125,35,1,337,India
758083,2024-01-19,204,strawberry yogurt,50,60,10,1,337,India
758083,2024-01-19,209,pepsi,75,100,25,1,337,India
440491,2024-01-19,203,mango yogurt,50,60,10,1,343,India
440491,2024-01-19,202,milk,12,27,15,1,343,India
440491,2024-01-19,210,mountain dew,75,100,25,1,343,India
440491,2024-01-19,211,red bull,90,125,35,1,343,India
488299,2024-01-19,205,classic yogurt,45,60,15,1,390,India
488299,2024-01-19,206,yakult,360,400,40,1,390,India
488299,2024-01-19,210,mountain dew,75,100,25,1,390,India
152876,2024-01-19,207,coca cola,75,100,25,1,218,India
152876,2024-01-19,203,mango yogurt,50,60,10,1,218,India
152876,2024-01-19,212,amul cheese,250,315,65,1,218,India
152876,2024-01-19,210,mountain dew,75,100,25,1,218,India
175014,2024-01-19,205,classic yogurt,45,60,15,1,355,India
175014,2024-01-19,206,yakult,360,400,40,1,355,India
175014,2024-01-19,207,coca cola,75,100,25,1,355,India
175014,2024-01-19,211,red bull,90,125,35,1,355,India
840955,2024-01-19,205,classic yogurt,45,60,15,1,210,India
840955,2024-01-19,212,amul cheese,250,315,65,1,210,India
840955,2024-01-19,209,pepsi,75,100,25,1,210,India
840955,2024-01-19,211,red bull,90,125,35,1,210,India
454371,2024-01-19,206,yakult,360,400,40,1,357,India
454371,2024-01-19,210,mountain dew,75,100,25,1,357,India
454371,2024-01-19,202,milk,12,27,15,1,357,India
454371,2024-01-19,204,strawberry yogurt,50,60,10,1,357,India
839657,2024-01-19,212,amul cheese,250,315,65,1,36,India
839657,2024-01-19,201,paneer,210,340,130,1,36,India
839657,2024-01-19,211,red bull,90,125,35,1,36,India
697184,2024-01-19,207,coca cola,75,100,25,1,407,India
697184,2024-01-19,208,sprite,75,100,25,1,407,India
697184,2024-01-19,213,bisleri,6,15,9,1,407,India
697184,2024-01-19,212,amul cheese,250,315,65,1,407,India
974833,2024-01-19,208,sprite,75,100,25,1,285,India
974833,2024-01-19,210,mountain dew,75,100,25,1,285,India
553297,2024-01-19,213,bisleri,6,15,9,1,96,India
553297,2024-01-19,205,classic yogurt,45,60,15,1,96,India
385845,2024-01-19,210,mountain dew,75,100,25,1,390,India
250167,2024-01-19,206,yakult,360,400,40,1,243,India
250167,2024-01-19,203,mango yogurt,50,60,10,1,243,India
209156,2024-01-19,208,sprite,75,100,25,1,269,India
209156,2024-01-19,212,amul cheese,250,315,65,1,269,India
209156,2024-01-19,201,paneer,210,340,130,1,269,India
209156,2024-01-19,213,bisleri,6,15,9,1,269,India
986631,2024-01-19,210,mountain dew,75,100,25,1,257,India
986631,2024-01-19,203,mango yogurt,50,60,10,1,257,India
986631,2024-01-19,208,sprite,75,100,25,1,257,India
986631,2024-01-19,207,coca cola,75,100,25,1,257,India
110093,2024-01-19,211,red bull,90,125,35,1,401,India
110093,2024-01-19,204,strawberry yogurt,50,60,10,1,401,India
110093,2024-01-19,212,amul cheese,250,315,65,1,401,India
544087,2024-01-19,210,mountain dew,75,100,25,1,225,India
544087,2024-01-19,212,amul cheese,250,315,65,1,225,India
544087,2024-01-19,206,yakult,360,400,40,1,225,India
800232,2024-01-19,208,sprite,75,100,25,1,499,India
800232,2024-01-19,206,yakult,360,400,40,1,499,India
772316,2024-01-19,206,yakult,360,400,40,1,392,India
149149,2024-01-19,203,mango yogurt,50,60,10,1,235,India
142994,2024-01-19,207,coca cola,75,100,25,1,455,India
142994,2024-01-19,206,yakult,360,400,40,1,455,India
142994,2024-01-19,209,pepsi,75,100,25,1,455,India
806108,2024-01-20,201,paneer,210,340,130,1,292,India
806108,2024-01-20,210,mountain dew,75,100,25,1,292,India
806108,2024-01-20,209,pepsi,75,100,25,1,292,India
197772,2024-01-20,201,paneer,210,340,130,1,120,India
519005,2024-01-20,210,mountain dew,75,100,25,1,208,India
519005,2024-01-20,208,sprite,75,100,25,1,208,India
519005,2024-01-20,203,mango yogurt,50,60,10,1,208,India
804671,2024-01-20,203,mango yogurt,50,60,10,1,47,India
804671,2024-01-20,210,mountain dew,75,100,25,1,47,India
804671,2024-01-20,202,milk,12,27,15,1,47,India
804671,2024-01-20,207,coca cola,75,100,25,1,47,India
448858,2024-01-20,209,pepsi,75,100,25,1,278,India
448858,2024-01-20,210,mountain dew,75,100,25,1,278,India
448858,2024-01-20,207,coca cola,75,100,25,1,278,India
448858,2024-01-20,211,red bull,90,125,35,1,278,India
998087,2024-01-20,211,red bull,90,125,35,1,272,India
647279,2024-01-20,210,mountain dew,75,100,25,1,206,India
647279,2024-01-20,203,mango yogurt,50,60,10,1,206,India
647279,2024-01-20,211,red bull,90,125,35,1,206,India
943509,2024-01-20,212,amul cheese,250,315,65,1,396,India
943509,2024-01-20,209,pepsi,75,100,25,1,396,India
943509,2024-01-20,203,mango yogurt,50,60,10,1,396,India
943509,2024-01-20,205,classic yogurt,45,60,15,1,396,India
943509,2024-01-20,206,yakult,360,400,40,1,396,India
651319,2024-01-20,206,yakult,360,400,40,1,88,India
299153,2024-01-20,203,mango yogurt,50,60,10,1,240,India
299153,2024-01-20,211,red bull,90,125,35,1,240,India
299153,2024-01-20,213,bisleri,6,15,9,1,240,India
299153,2024-01-20,207,coca cola,75,100,25,1,240,India
836550,2024-01-20,205,classic yogurt,45,60,15,1,354,India
165835,2024-01-20,210,mountain dew,75,100,25,1,53,India
902953,2024-01-20,201,paneer,210,340,130,1,453,India
902953,2024-01-20,202,milk,12,27,15,1,453,India
902953,2024-01-20,205,classic yogurt,45,60,15,1,453,India
702650,2024-01-20,205,classic yogurt,45,60,15,1,175,India
702650,2024-01-20,210,mountain dew,75,100,25,1,175,India
927352,2024-01-20,201,paneer,210,340,130,1,302,India
927352,2024-01-20,203,mango yogurt,50,60,10,1,302,India
927352,2024-01-20,204,strawberry yogurt,50,60,10,1,302,India
927352,2024-01-20,209,pepsi,75,100,25,1,302,India
291690,2024-01-20,208,sprite,75,100,25,1,313,India
291690,2024-01-20,209,pepsi,75,100,25,1,313,India
291690,2024-01-20,202,milk,12,27,15,1,313,India
291690,2024-01-20,211,red bull,90,125,35,1,313,India
982543,2024-01-20,208,sprite,75,100,25,1,272,India
982543,2024-01-20,202,milk,12,27,15,1,272,India
124725,2024-01-20,202,milk,12,27,15,1,55,India
124725,2024-01-20,207,coca cola,75,100,25,1,55,India
124725,2024-01-20,205,classic yogurt,45,60,15,1,55,India
438571,2024-01-20,211,red bull,90,125,35,1,141,India
438571,2024-01-20,206,yakult,360,400,40,1,141,India
438571,2024-01-20,205,classic yogurt,45,60,15,1,141,India
438571,2024-01-20,212,amul cheese,250,315,65,1,141,India
974291,2024-01-20,206,yakult,360,400,40,1,301,India
398119,2024-01-20,208,sprite,75,100,25,1,235,India
986439,2024-01-20,205,classic yogurt,45,60,15,1,477,India
986439,2024-01-20,212,amul cheese,250,315,65,1,477,India
914713,2024-01-20,202,milk,12,27,15,1,252,India
914713,2024-01-20,211,red bull,90,125,35,1,252,India
914713,2024-01-20,209,pepsi,75,100,25,1,252,India
914713,2024-01-20,208,sprite,75,100,25,1,252,India
914713,2024-01-20,205,classic yogurt,45,60,15,1,252,India
870382,2024-01-20,208,sprite,75,100,25,1,30,India
870382,2024-01-20,213,bisleri,6,15,9,1,30,India
870382,2024-01-20,206,yakult,360,400,40,1,30,India
645681,2024-01-20,202,milk,12,27,15,1,258,India
645681,2024-01-20,201,paneer,210,340,130,1,258,India
906858,2024-01-20,213,bisleri,6,15,9,1,195,India
906858,2024-01-20,210,mountain dew,75,100,25,1,195,India
906858,2024-01-20,211,red bull,90,125,35,1,195,India
906858,2024-01-20,207,coca cola,75,100,25,1,195,India
906858,2024-01-20,206,yakult,360,400,40,1,195,India
286061,2024-01-20,203,mango yogurt,50,60,10,1,495,India
286061,2024-01-20,213,bisleri,6,15,9,1,495,India
286061,2024-01-20,210,mountain dew,75,100,25,1,495,India
175798,2024-01-20,213,bisleri,6,15,9,1,304,India
175798,2024-01-20,208,sprite,75,100,25,1,304,India
175798,2024-01-20,203,mango yogurt,50,60,10,1,304,India
150508,2024-01-20,209,pepsi,75,100,25,1,451,India
150508,2024-01-20,207,coca cola,75,100,25,1,451,India
150508,2024-01-20,213,bisleri,6,15,9,1,451,India
150508,2024-01-20,204,strawberry yogurt,50,60,10,1,451,India
424221,2024-01-20,204,strawberry yogurt,50,60,10,1,221,India
424221,2024-01-20,209,pepsi,75,100,25,1,221,India
458147,2024-01-20,203,mango yogurt,50,60,10,1,376,India
458147,2024-01-20,204,strawberry yogurt,50,60,10,1,376,India
458147,2024-01-20,206,yakult,360,400,40,1,376,India
458147,2024-01-20,207,coca cola,75,100,25,1,376,India
458147,2024-01-20,208,sprite,75,100,25,1,376,India
742090,2024-01-20,207,coca cola,75,100,25,1,61,India
742090,2024-01-20,209,pepsi,75,100,25,1,61,India
742090,2024-01-20,213,bisleri,6,15,9,1,61,India
315056,2024-01-20,207,coca cola,75,100,25,1,135,India
390252,2024-01-20,213,bisleri,6,15,9,1,160,India
390252,2024-01-20,204,strawberry yogurt,50,60,10,1,160,India
257621,2024-01-20,206,yakult,360,400,40,1,240,India
257621,2024-01-20,211,red bull,90,125,35,1,240,India
257621,2024-01-20,202,milk,12,27,15,1,240,India
763725,2024-01-20,211,red bull,90,125,35,1,239,India
377840,2024-01-20,210,mountain dew,75,100,25,1,46,India
377840,2024-01-20,209,pepsi,75,100,25,1,46,India
377840,2024-01-20,208,sprite,75,100,25,1,46,India
377840,2024-01-20,207,coca cola,75,100,25,1,46,India
799523,2024-01-20,208,sprite,75,100,25,1,287,India
717930,2024-01-20,204,strawberry yogurt,50,60,10,1,152,India
717930,2024-01-20,212,amul cheese,250,315,65,1,152,India
717930,2024-01-20,202,milk,12,27,15,1,152,India
717930,2024-01-20,208,sprite,75,100,25,1,152,India
700521,2024-01-20,204,strawberry yogurt,50,60,10,1,130,India
700521,2024-01-20,213,bisleri,6,15,9,1,130,India
644202,2024-01-20,213,bisleri,6,15,9,1,41,India
644202,2024-01-20,202,milk,12,27,15,1,41,India
644202,2024-01-20,201,paneer,210,340,130,1,41,India
875072,2024-01-20,205,classic yogurt,45,60,15,1,247,India
875072,2024-01-20,206,yakult,360,400,40,1,247,India
875072,2024-01-20,213,bisleri,6,15,9,1,247,India
875072,2024-01-20,204,strawberry yogurt,50,60,10,1,247,India
875072,2024-01-20,207,coca cola,75,100,25,1,247,India
314071,2024-01-20,213,bisleri,6,15,9,1,425,India
314071,2024-01-20,210,mountain dew,75,100,25,1,425,India
314071,2024-01-20,204,strawberry yogurt,50,60,10,1,425,India
314071,2024-01-20,208,sprite,75,100,25,1,425,India
901373,2024-01-20,206,yakult,360,400,40,1,499,India
295797,2024-01-20,203,mango yogurt,50,60,10,1,203,India
295797,2024-01-20,206,yakult,360,400,40,1,203,India
295797,2024-01-20,202,milk,12,27,15,1,203,India
295797,2024-01-20,210,mountain dew,75,100,25,1,203,India
726422,2024-01-20,207,coca cola,75,100,25,1,48,India
726422,2024-01-20,210,mountain dew,75,100,25,1,48,India
726422,2024-01-20,211,red bull,90,125,35,1,48,India
655556,2024-01-20,212,amul cheese,250,315,65,1,476,India
655556,2024-01-20,206,yakult,360,400,40,1,476,India
655556,2024-01-20,207,coca cola,75,100,25,1,476,India
796450,2024-01-20,202,milk,12,27,15,1,15,India
796450,2024-01-20,213,bisleri,6,15,9,1,15,India
423183,2024-01-20,201,paneer,210,340,130,1,369,India
423183,2024-01-20,212,amul cheese,250,315,65,1,369,India
423183,2024-01-20,213,bisleri,6,15,9,1,369,India
423183,2024-01-20,205,classic yogurt,45,60,15,1,369,India
423183,2024-01-20,203,mango yogurt,50,60,10,1,369,India
902780,2024-01-20,208,sprite,75,100,25,1,360,India
634658,2024-01-20,212,amul cheese,250,315,65,1,299,India
634658,2024-01-20,207,coca cola,75,100,25,1,299,India
634658,2024-01-20,210,mountain dew,75,100,25,1,299,India
634658,2024-01-20,203,mango yogurt,50,60,10,1,299,India
433461,2024-01-20,211,red bull,90,125,35,1,467,India
433461,2024-01-20,208,sprite,75,100,25,1,467,India
629555,2024-01-20,205,classic yogurt,45,60,15,1,187,India
382518,2024-01-20,202,milk,12,27,15,1,431,India
431690,2024-01-20,202,milk,12,27,15,1,434,India
177158,2024-01-20,210,mountain dew,75,100,25,1,454,India
177158,2024-01-20,202,milk,12,27,15,1,454,India
177158,2024-01-20,204,strawberry yogurt,50,60,10,1,454,India
994810,2024-01-20,211,red bull,90,125,35,1,213,India
994810,2024-01-20,206,yakult,360,400,40,1,213,India
994810,2024-01-20,201,paneer,210,340,130,1,213,India
994810,2024-01-20,210,mountain dew,75,100,25,1,213,India
544509,2024-01-20,212,amul cheese,250,315,65,1,389,India
390227,2024-01-20,210,mountain dew,75,100,25,1,432,India
396991,2024-01-20,205,classic yogurt,45,60,15,1,155,India
426393,2024-01-20,212,amul cheese,250,315,65,1,100,India
449780,2024-01-20,213,bisleri,6,15,9,1,420,India
449780,2024-01-20,202,milk,12,27,15,1,420,India
449780,2024-01-20,211,red bull,90,125,35,1,420,India
617895,2024-01-20,204,strawberry yogurt,50,60,10,1,330,India
617895,2024-01-20,206,yakult,360,400,40,1,330,India
617895,2024-01-20,205,classic yogurt,45,60,15,1,330,India
617895,2024-01-20,202,milk,12,27,15,1,330,India
871737,2024-01-20,206,yakult,360,400,40,1,228,India
871737,2024-01-20,203,mango yogurt,50,60,10,1,228,India
871737,2024-01-20,201,paneer,210,340,130,1,228,India
849917,2024-01-20,203,mango yogurt,50,60,10,1,285,India
849917,2024-01-20,213,bisleri,6,15,9,1,285,India
103626,2024-01-20,211,red bull,90,125,35,1,175,India
103626,2024-01-20,203,mango yogurt,50,60,10,1,175,India
779427,2024-01-20,210,mountain dew,75,100,25,1,382,India
779427,2024-01-20,206,yakult,360,400,40,1,382,India
779427,2024-01-20,211,red bull,90,125,35,1,382,India
871004,2024-01-20,213,bisleri,6,15,9,1,332,India
910201,2024-01-20,202,milk,12,27,15,1,479,India
910201,2024-01-20,208,sprite,75,100,25,1,479,India
910201,2024-01-20,204,strawberry yogurt,50,60,10,1,479,India
618197,2024-01-20,202,milk,12,27,15,1,356,India
618197,2024-01-20,204,strawberry yogurt,50,60,10,1,356,India
618197,2024-01-20,201,paneer,210,340,130,1,356,India
618197,2024-01-20,213,bisleri,6,15,9,1,356,India
278330,2024-01-20,206,yakult,360,400,40,1,122,India
752392,2024-01-20,203,mango yogurt,50,60,10,1,23,India
752392,2024-01-20,204,strawberry yogurt,50,60,10,1,23,India
752392,2024-01-20,201,paneer,210,340,130,1,23,India
969409,2024-01-21,213,bisleri,6,15,9,1,114,India
146060,2024-01-21,201,paneer,210,340,130,1,386,India
146060,2024-01-21,209,pepsi,75,100,25,1,386,India
146060,2024-01-21,203,mango yogurt,50,60,10,1,386,India
146060,2024-01-21,202,milk,12,27,15,1,386,India
143640,2024-01-21,204,strawberry yogurt,50,60,10,1,87,India
143640,2024-01-21,207,coca cola,75,100,25,1,87,India
143640,2024-01-21,206,yakult,360,400,40,1,87,India
143640,2024-01-21,203,mango yogurt,50,60,10,1,87,India
143640,2024-01-21,202,milk,12,27,15,1,87,India
862557,2024-01-21,210,mountain dew,75,100,25,1,397,India
862557,2024-01-21,213,bisleri,6,15,9,1,397,India
862557,2024-01-21,205,classic yogurt,45,60,15,1,397,India
191803,2024-01-21,203,mango yogurt,50,60,10,1,180,India
191803,2024-01-21,201,paneer,210,340,130,1,180,India
727093,2024-01-21,209,pepsi,75,100,25,1,368,India
727093,2024-01-21,203,mango yogurt,50,60,10,1,368,India
727093,2024-01-21,213,bisleri,6,15,9,1,368,India
592960,2024-01-21,212,amul cheese,250,315,65,1,45,India
592960,2024-01-21,206,yakult,360,400,40,1,45,India
919253,2024-01-21,213,bisleri,6,15,9,1,300,India
919253,2024-01-21,212,amul cheese,250,315,65,1,300,India
919253,2024-01-21,206,yakult,360,400,40,1,300,India
919253,2024-01-21,204,strawberry yogurt,50,60,10,1,300,India
919253,2024-01-21,203,mango yogurt,50,60,10,1,300,India
112171,2024-01-21,207,coca cola,75,100,25,1,22,India
112171,2024-01-21,212,amul cheese,250,315,65,1,22,India
112171,2024-01-21,211,red bull,90,125,35,1,22,India
734060,2024-01-21,205,classic yogurt,45,60,15,1,429,India
734060,2024-01-21,206,yakult,360,400,40,1,429,India
734060,2024-01-21,203,mango yogurt,50,60,10,1,429,India
415682,2024-01-21,208,sprite,75,100,25,1,242,India
415682,2024-01-21,203,mango yogurt,50,60,10,1,242,India
789039,2024-01-21,211,red bull,90,125,35,1,338,India
789039,2024-01-21,202,milk,12,27,15,1,338,India
789039,2024-01-21,212,amul cheese,250,315,65,1,338,India
768853,2024-01-21,204,strawberry yogurt,50,60,10,1,142,India
768853,2024-01-21,203,mango yogurt,50,60,10,1,142,India
768853,2024-01-21,205,classic yogurt,45,60,15,1,142,India
768853,2024-01-21,213,bisleri,6,15,9,1,142,India
645372,2024-01-21,210,mountain dew,75,100,25,1,95,India
645372,2024-01-21,209,pepsi,75,100,25,1,95,India
645372,2024-01-21,206,yakult,360,400,40,1,95,India
180925,2024-01-21,208,sprite,75,100,25,1,491,India
180925,2024-01-21,202,milk,12,27,15,1,491,India
180925,2024-01-21,201,paneer,210,340,130,1,491,India
180925,2024-01-21,213,bisleri,6,15,9,1,491,India
248017,2024-01-21,209,pepsi,75,100,25,1,482,India
248017,2024-01-21,205,classic yogurt,45,60,15,1,482,India
248017,2024-01-21,202,milk,12,27,15,1,482,India
248017,2024-01-21,204,strawberry yogurt,50,60,10,1,482,India
248017,2024-01-21,208,sprite,75,100,25,1,482,India
158696,2024-01-21,212,amul cheese,250,315,65,1,438,India
158696,2024-01-21,204,strawberry yogurt,50,60,10,1,438,India
158696,2024-01-21,213,bisleri,6,15,9,1,438,India
158696,2024-01-21,201,paneer,210,340,130,1,438,India
170433,2024-01-21,202,milk,12,27,15,1,236,India
170433,2024-01-21,208,sprite,75,100,25,1,236,India
170433,2024-01-21,206,yakult,360,400,40,1,236,India
599216,2024-01-21,204,strawberry yogurt,50,60,10,1,353,India
599216,2024-01-21,208,sprite,75,100,25,1,353,India
599216,2024-01-21,205,classic yogurt,45,60,15,1,353,India
376560,2024-01-21,203,mango yogurt,50,60,10,1,392,India
376560,2024-01-21,202,milk,12,27,15,1,392,India
376560,2024-01-21,201,paneer,210,340,130,1,392,India
838425,2024-01-21,205,classic yogurt,45,60,15,1,141,India
838425,2024-01-21,206,yakult,360,400,40,1,141,India
836765,2024-01-21,211,red bull,90,125,35,1,449,India
836765,2024-01-21,213,bisleri,6,15,9,1,449,India
836765,2024-01-21,207,coca cola,75,100,25,1,449,India
836765,2024-01-21,210,mountain dew,75,100,25,1,449,India
864702,2024-01-21,210,mountain dew,75,100,25,1,50,India
864702,2024-01-21,211,red bull,90,125,35,1,50,India
444856,2024-01-21,206,yakult,360,400,40,1,256,India
444856,2024-01-21,201,paneer,210,340,130,1,256,India
444856,2024-01-21,202,milk,12,27,15,1,256,India
444856,2024-01-21,204,strawberry yogurt,50,60,10,1,256,India
694965,2024-01-21,213,bisleri,6,15,9,1,491,India
694965,2024-01-21,211,red bull,90,125,35,1,491,India
694965,2024-01-21,212,amul cheese,250,315,65,1,491,India
694965,2024-01-21,209,pepsi,75,100,25,1,491,India
214340,2024-01-21,207,coca cola,75,100,25,1,436,India
214340,2024-01-21,204,strawberry yogurt,50,60,10,1,436,India
214340,2024-01-21,202,milk,12,27,15,1,436,India
214340,2024-01-21,212,amul cheese,250,315,65,1,436,India
990542,2024-01-21,208,sprite,75,100,25,1,315,India
990542,2024-01-21,211,red bull,90,125,35,1,315,India
928343,2024-01-21,211,red bull,90,125,35,1,182,India
928343,2024-01-21,210,mountain dew,75,100,25,1,182,India
928343,2024-01-21,201,paneer,210,340,130,1,182,India
351710,2024-01-21,203,mango yogurt,50,60,10,1,205,India
351710,2024-01-21,206,yakult,360,400,40,1,205,India
351710,2024-01-21,202,milk,12,27,15,1,205,India
351710,2024-01-21,201,paneer,210,340,130,1,205,India
789225,2024-01-21,207,coca cola,75,100,25,1,108,India
276897,2024-01-21,212,amul cheese,250,315,65,1,63,India
276897,2024-01-21,204,strawberry yogurt,50,60,10,1,63,India
276897,2024-01-21,209,pepsi,75,100,25,1,63,India
276897,2024-01-21,213,bisleri,6,15,9,1,63,India
571079,2024-01-21,201,paneer,210,340,130,1,350,India
571079,2024-01-21,203,mango yogurt,50,60,10,1,350,India
571079,2024-01-21,213,bisleri,6,15,9,1,350,India
848210,2024-01-21,203,mango yogurt,50,60,10,1,218,India
848210,2024-01-21,212,amul cheese,250,315,65,1,218,India
848210,2024-01-21,209,pepsi,75,100,25,1,218,India
812469,2024-01-21,208,sprite,75,100,25,1,350,India
812469,2024-01-21,203,mango yogurt,50,60,10,1,350,India
812469,2024-01-21,213,bisleri,6,15,9,1,350,India
812469,2024-01-21,209,pepsi,75,100,25,1,350,India
373144,2024-01-21,209,pepsi,75,100,25,1,272,India
867240,2024-01-21,201,paneer,210,340,130,1,29,India
122946,2024-01-21,211,red bull,90,125,35,1,125,India
335424,2024-01-21,202,milk,12,27,15,1,23,India
701804,2024-01-21,208,sprite,75,100,25,1,308,India
701804,2024-01-21,211,red bull,90,125,35,1,308,India
701804,2024-01-21,204,strawberry yogurt,50,60,10,1,308,India
328337,2024-01-21,207,coca cola,75,100,25,1,216,India
328337,2024-01-21,205,classic yogurt,45,60,15,1,216,India
328337,2024-01-21,201,paneer,210,340,130,1,216,India
770435,2024-01-21,205,classic yogurt,45,60,15,1,263,India
770435,2024-01-21,202,milk,12,27,15,1,263,India
770435,2024-01-21,208,sprite,75,100,25,1,263,India
820631,2024-01-21,204,strawberry yogurt,50,60,10,1,341,India
820631,2024-01-21,202,milk,12,27,15,1,341,India
820631,2024-01-21,201,paneer,210,340,130,1,341,India
820631,2024-01-21,211,red bull,90,125,35,1,341,India
781820,2024-01-21,213,bisleri,6,15,9,1,238,India
781820,2024-01-21,212,amul cheese,250,315,65,1,238,India
781820,2024-01-21,205,classic yogurt,45,60,15,1,238,India
331730,2024-01-21,205,classic yogurt,45,60,15,1,296,India
242273,2024-01-21,209,pepsi,75,100,25,1,447,India
242273,2024-01-21,204,strawberry yogurt,50,60,10,1,447,India
562761,2024-01-21,202,milk,12,27,15,1,272,India
562761,2024-01-21,206,yakult,360,400,40,1,272,India
562761,2024-01-21,212,amul cheese,250,315,65,1,272,India
562761,2024-01-21,210,mountain dew,75,100,25,1,272,India
253118,2024-01-21,209,pepsi,75,100,25,1,314,India
253118,2024-01-21,210,mountain dew,75,100,25,1,314,India
253118,2024-01-21,203,mango yogurt,50,60,10,1,314,India
253118,2024-01-21,205,classic yogurt,45,60,15,1,314,India
253118,2024-01-21,213,bisleri,6,15,9,1,314,India
321278,2024-01-21,207,coca cola,75,100,25,1,342,India
321278,2024-01-21,210,mountain dew,75,100,25,1,342,India
784684,2024-01-21,203,mango yogurt,50,60,10,1,366,India
784684,2024-01-21,205,classic yogurt,45,60,15,1,366,India
162403,2024-01-21,202,milk,12,27,15,1,442,India
162403,2024-01-21,209,pepsi,75,100,25,1,442,India
162403,2024-01-21,210,mountain dew,75,100,25,1,442,India
162403,2024-01-21,203,mango yogurt,50,60,10,1,442,India
162403,2024-01-21,207,coca cola,75,100,25,1,442,India
764622,2024-01-21,202,milk,12,27,15,1,146,India
764622,2024-01-21,205,classic yogurt,45,60,15,1,146,India
384780,2024-01-21,203,mango yogurt,50,60,10,1,194,India
384780,2024-01-21,213,bisleri,6,15,9,1,194,India
384780,2024-01-21,204,strawberry yogurt,50,60,10,1,194,India
697047,2024-01-21,201,paneer,210,340,130,1,198,India
697047,2024-01-21,205,classic yogurt,45,60,15,1,198,India
697047,2024-01-21,208,sprite,75,100,25,1,198,India
697047,2024-01-21,212,amul cheese,250,315,65,1,198,India
697047,2024-01-21,206,yakult,360,400,40,1,198,India
282019,2024-01-21,212,amul cheese,250,315,65,1,268,India
282019,2024-01-21,202,milk,12,27,15,1,268,India
282019,2024-01-21,201,paneer,210,340,130,1,268,India
282019,2024-01-21,210,mountain dew,75,100,25,1,268,India
740653,2024-01-21,202,milk,12,27,15,1,52,India
740653,2024-01-21,207,coca cola,75,100,25,1,52,India
413008,2024-01-21,203,mango yogurt,50,60,10,1,344,India
413008,2024-01-21,208,sprite,75,100,25,1,344,India
413008,2024-01-21,210,mountain dew,75,100,25,1,344,India
413008,2024-01-21,213,bisleri,6,15,9,1,344,India
883775,2024-01-21,210,mountain dew,75,100,25,1,162,India
883775,2024-01-21,209,pepsi,75,100,25,1,162,India
998802,2024-01-21,209,pepsi,75,100,25,1,163,India
998802,2024-01-21,211,red bull,90,125,35,1,163,India
998802,2024-01-21,213,bisleri,6,15,9,1,163,India
706867,2024-01-21,208,sprite,75,100,25,1,451,India
706867,2024-01-21,205,classic yogurt,45,60,15,1,451,India
706867,2024-01-21,212,amul cheese,250,315,65,1,451,India
706867,2024-01-21,209,pepsi,75,100,25,1,451,India
763002,2024-01-21,208,sprite,75,100,25,1,415,India
763002,2024-01-21,203,mango yogurt,50,60,10,1,415,India
685106,2024-01-22,213,bisleri,6,15,9,1,315,India
685106,2024-01-22,202,milk,12,27,15,1,315,India
815652,2024-01-22,201,paneer,210,340,130,1,75,India
632927,2024-01-22,204,strawberry yogurt,50,60,10,1,117,India
632927,2024-01-22,212,amul cheese,250,315,65,1,117,India
632927,2024-01-22,203,mango yogurt,50,60,10,1,117,India
632927,2024-01-22,205,classic yogurt,45,60,15,1,117,India
788087,2024-01-22,211,red bull,90,125,35,1,46,India
788087,2024-01-22,210,mountain dew,75,100,25,1,46,India
788087,2024-01-22,201,paneer,210,340,130,1,46,India
358726,2024-01-22,209,pepsi,75,100,25,1,466,India
358726,2024-01-22,205,classic yogurt,45,60,15,1,466,India
358726,2024-01-22,202,milk,12,27,15,1,466,India
487085,2024-01-22,202,milk,12,27,15,1,38,India
487085,2024-01-22,211,red bull,90,125,35,1,38,India
790252,2024-01-22,212,amul cheese,250,315,65,1,328,India
790252,2024-01-22,206,yakult,360,400,40,1,328,India
939879,2024-01-22,210,mountain dew,75,100,25,1,453,India
939879,2024-01-22,203,mango yogurt,50,60,10,1,453,India
706599,2024-01-22,201,paneer,210,340,130,1,494,India
706599,2024-01-22,213,bisleri,6,15,9,1,494,India
846955,2024-01-22,203,mango yogurt,50,60,10,1,376,India
770374,2024-01-22,211,red bull,90,125,35,1,107,India
770374,2024-01-22,205,classic yogurt,45,60,15,1,107,India
770374,2024-01-22,210,mountain dew,75,100,25,1,107,India
140937,2024-01-22,210,mountain dew,75,100,25,1,392,India
140937,2024-01-22,208,sprite,75,100,25,1,392,India
772951,2024-01-22,202,milk,12,27,15,1,374,India
772951,2024-01-22,205,classic yogurt,45,60,15,1,374,India
772951,2024-01-22,209,pepsi,75,100,25,1,374,India
534029,2024-01-22,204,strawberry yogurt,50,60,10,1,342,India
534029,2024-01-22,208,sprite,75,100,25,1,342,India
616227,2024-01-22,211,red bull,90,125,35,1,84,India
147824,2024-01-22,202,milk,12,27,15,1,57,India
311545,2024-01-22,205,classic yogurt,45,60,15,1,214,India
311545,2024-01-22,203,mango yogurt,50,60,10,1,214,India
311545,2024-01-22,206,yakult,360,400,40,1,214,India
311545,2024-01-22,201,paneer,210,340,130,1,214,India
621578,2024-01-22,212,amul cheese,250,315,65,1,298,India
621578,2024-01-22,206,yakult,360,400,40,1,298,India
621578,2024-01-22,209,pepsi,75,100,25,1,298,India
621578,2024-01-22,205,classic yogurt,45,60,15,1,298,India
621578,2024-01-22,203,mango yogurt,50,60,10,1,298,India
734562,2024-01-22,203,mango yogurt,50,60,10,1,28,India
734562,2024-01-22,205,classic yogurt,45,60,15,1,28,India
746554,2024-01-22,209,pepsi,75,100,25,1,181,India
746554,2024-01-22,201,paneer,210,340,130,1,181,India
746554,2024-01-22,211,red bull,90,125,35,1,181,India
622831,2024-01-22,203,mango yogurt,50,60,10,1,75,India
622831,2024-01-22,211,red bull,90,125,35,1,75,India
622831,2024-01-22,209,pepsi,75,100,25,1,75,India
622831,2024-01-22,210,mountain dew,75,100,25,1,75,India
552696,2024-01-22,206,yakult,360,400,40,1,487,India
552696,2024-01-22,212,amul cheese,250,315,65,1,487,India
552696,2024-01-22,201,paneer,210,340,130,1,487,India
592365,2024-01-22,206,yakult,360,400,40,1,360,India
592365,2024-01-22,201,paneer,210,340,130,1,360,India
592365,2024-01-22,203,mango yogurt,50,60,10,1,360,India
741037,2024-01-22,213,bisleri,6,15,9,1,116,India
340528,2024-01-22,203,mango yogurt,50,60,10,1,239,India
340528,2024-01-22,209,pepsi,75,100,25,1,239,India
340528,2024-01-22,211,red bull,90,125,35,1,239,India
340528,2024-01-22,210,mountain dew,75,100,25,1,239,India
340528,2024-01-22,213,bisleri,6,15,9,1,239,India
895717,2024-01-22,209,pepsi,75,100,25,1,208,India
895717,2024-01-22,203,mango yogurt,50,60,10,1,208,India
713688,2024-01-22,211,red bull,90,125,35,1,312,India
713688,2024-01-22,206,yakult,360,400,40,1,312,India
713688,2024-01-22,205,classic yogurt,45,60,15,1,312,India
713688,2024-01-22,207,coca cola,75,100,25,1,312,India
713688,2024-01-22,208,sprite,75,100,25,1,312,India
389234,2024-01-22,204,strawberry yogurt,50,60,10,1,119,India
389234,2024-01-22,201,paneer,210,340,130,1,119,India
389234,2024-01-22,208,sprite,75,100,25,1,119,India
372609,2024-01-22,207,coca cola,75,100,25,1,341,India
372609,2024-01-22,203,mango yogurt,50,60,10,1,341,India
752275,2024-01-22,207,coca cola,75,100,25,1,465,India
263945,2024-01-22,212,amul cheese,250,315,65,1,138,India
263945,2024-01-22,206,yakult,360,400,40,1,138,India
263945,2024-01-22,204,strawberry yogurt,50,60,10,1,138,India
106107,2024-01-22,209,pepsi,75,100,25,1,252,India
937149,2024-01-22,208,sprite,75,100,25,1,80,India
937149,2024-01-22,204,strawberry yogurt,50,60,10,1,80,India
669944,2024-01-22,205,classic yogurt,45,60,15,1,56,India
557429,2024-01-22,208,sprite,75,100,25,1,29,India
557429,2024-01-22,211,red bull,90,125,35,1,29,India
557429,2024-01-22,207,coca cola,75,100,25,1,29,India
869329,2024-01-22,210,mountain dew,75,100,25,1,470,India
869329,2024-01-22,201,paneer,210,340,130,1,470,India
571349,2024-01-22,211,red bull,90,125,35,1,173,India
662013,2024-01-22,205,classic yogurt,45,60,15,1,387,India
662013,2024-01-22,212,amul cheese,250,315,65,1,387,India
662013,2024-01-22,210,mountain dew,75,100,25,1,387,India
148445,2024-01-22,205,classic yogurt,45,60,15,1,489,India
148445,2024-01-22,202,milk,12,27,15,1,489,India
148445,2024-01-22,211,red bull,90,125,35,1,489,India
148445,2024-01-22,213,bisleri,6,15,9,1,489,India
148445,2024-01-22,212,amul cheese,250,315,65,1,489,India
673408,2024-01-22,209,pepsi,75,100,25,1,242,India
673408,2024-01-22,204,strawberry yogurt,50,60,10,1,242,India
673408,2024-01-22,207,coca cola,75,100,25,1,242,India
673408,2024-01-22,202,milk,12,27,15,1,242,India
172167,2024-01-22,208,sprite,75,100,25,1,380,India
579323,2024-01-22,211,red bull,90,125,35,1,271,India
579323,2024-01-22,208,sprite,75,100,25,1,271,India
810549,2024-01-22,211,red bull,90,125,35,1,193,India
810549,2024-01-22,210,mountain dew,75,100,25,1,193,India
810549,2024-01-22,202,milk,12,27,15,1,193,India
810549,2024-01-22,206,yakult,360,400,40,1,193,India
655972,2024-01-22,212,amul cheese,250,315,65,1,188,India
655972,2024-01-22,201,paneer,210,340,130,1,188,India
655972,2024-01-22,204,strawberry yogurt,50,60,10,1,188,India
655972,2024-01-22,202,milk,12,27,15,1,188,India
104414,2024-01-22,204,strawberry yogurt,50,60,10,1,369,India
104414,2024-01-22,207,coca cola,75,100,25,1,369,India
104414,2024-01-22,211,red bull,90,125,35,1,369,India
104414,2024-01-22,202,milk,12,27,15,1,369,India
104414,2024-01-22,205,classic yogurt,45,60,15,1,369,India
452517,2024-01-22,201,paneer,210,340,130,1,373,India
452517,2024-01-22,205,classic yogurt,45,60,15,1,373,India
452517,2024-01-22,211,red bull,90,125,35,1,373,India
123884,2024-01-22,206,yakult,360,400,40,1,455,India
123884,2024-01-22,204,strawberry yogurt,50,60,10,1,455,India
123884,2024-01-22,201,paneer,210,340,130,1,455,India
123884,2024-01-22,203,mango yogurt,50,60,10,1,455,India
813649,2024-01-22,209,pepsi,75,100,25,1,145,India
436818,2024-01-22,208,sprite,75,100,25,1,133,India
436818,2024-01-22,209,pepsi,75,100,25,1,133,India
436818,2024-01-22,206,yakult,360,400,40,1,133,India
436818,2024-01-22,203,mango yogurt,50,60,10,1,133,India
100574,2024-01-22,210,mountain dew,75,100,25,1,320,India
808138,2024-01-22,207,coca cola,75,100,25,1,488,India
808138,2024-01-22,201,paneer,210,340,130,1,488,India
808138,2024-01-22,204,strawberry yogurt,50,60,10,1,488,India
808138,2024-01-22,211,red bull,90,125,35,1,488,India
217165,2024-01-22,206,yakult,360,400,40,1,460,India
217165,2024-01-22,210,mountain dew,75,100,25,1,460,India
892233,2024-01-22,207,coca cola,75,100,25,1,88,India
892233,2024-01-22,209,pepsi,75,100,25,1,88,India
428958,2024-01-22,206,yakult,360,400,40,1,295,India
428958,2024-01-22,211,red bull,90,125,35,1,295,India
948748,2024-01-22,208,sprite,75,100,25,1,456,India
948748,2024-01-22,201,paneer,210,340,130,1,456,India
946739,2024-01-22,209,pepsi,75,100,25,1,48,India
269882,2024-01-22,210,mountain dew,75,100,25,1,116,India
456862,2024-01-22,204,strawberry yogurt,50,60,10,1,39,India
456862,2024-01-22,206,yakult,360,400,40,1,39,India
456862,2024-01-22,213,bisleri,6,15,9,1,39,India
456862,2024-01-22,207,coca cola,75,100,25,1,39,India
456862,2024-01-22,212,amul cheese,250,315,65,1,39,India
427031,2024-01-22,213,bisleri,6,15,9,1,413,India
427031,2024-01-22,211,red bull,90,125,35,1,413,India
139062,2024-01-22,205,classic yogurt,45,60,15,1,409,India
139062,2024-01-22,203,mango yogurt,50,60,10,1,409,India
139062,2024-01-22,201,paneer,210,340,130,1,409,India
755241,2024-01-22,205,classic yogurt,45,60,15,1,251,India
755241,2024-01-22,201,paneer,210,340,130,1,251,India
755241,2024-01-22,210,mountain dew,75,100,25,1,251,India
476243,2024-01-22,201,paneer,210,340,130,1,269,India
476243,2024-01-22,204,strawberry yogurt,50,60,10,1,269,India
476243,2024-01-22,207,coca cola,75,100,25,1,269,India
476243,2024-01-22,206,yakult,360,400,40,1,269,India
634972,2024-01-23,206,yakult,360,400,40,1,357,India
845920,2024-01-23,209,pepsi,75,100,25,1,49,India
845920,2024-01-23,211,red bull,90,125,35,1,49,India
845920,2024-01-23,204,strawberry yogurt,50,60,10,1,49,India
991281,2024-01-23,201,paneer,210,340,130,1,265,India
991281,2024-01-23,207,coca cola,75,100,25,1,265,India
991281,2024-01-23,210,mountain dew,75,100,25,1,265,India
991281,2024-01-23,206,yakult,360,400,40,1,265,India
559904,2024-01-23,205,classic yogurt,45,60,15,1,51,India
559904,2024-01-23,209,pepsi,75,100,25,1,51,India
559904,2024-01-23,202,milk,12,27,15,1,51,India
559904,2024-01-23,204,strawberry yogurt,50,60,10,1,51,India
649559,2024-01-23,207,coca cola,75,100,25,1,174,India
649559,2024-01-23,203,mango yogurt,50,60,10,1,174,India
649559,2024-01-23,204,strawberry yogurt,50,60,10,1,174,India
649559,2024-01-23,206,yakult,360,400,40,1,174,India
791877,2024-01-23,205,classic yogurt,45,60,15,1,126,India
791877,2024-01-23,213,bisleri,6,15,9,1,126,India
791877,2024-01-23,204,strawberry yogurt,50,60,10,1,126,India
791877,2024-01-23,206,yakult,360,400,40,1,126,India
791877,2024-01-23,211,red bull,90,125,35,1,126,India
912446,2024-01-23,209,pepsi,75,100,25,1,402,India
912446,2024-01-23,211,red bull,90,125,35,1,402,India
912446,2024-01-23,213,bisleri,6,15,9,1,402,India
912446,2024-01-23,210,mountain dew,75,100,25,1,402,India
303455,2024-01-23,210,mountain dew,75,100,25,1,356,India
303455,2024-01-23,207,coca cola,75,100,25,1,356,India
303455,2024-01-23,206,yakult,360,400,40,1,356,India
836229,2024-01-23,213,bisleri,6,15,9,1,279,India
836229,2024-01-23,212,amul cheese,250,315,65,1,279,India
836229,2024-01-23,208,sprite,75,100,25,1,279,India
836229,2024-01-23,204,strawberry yogurt,50,60,10,1,279,India
836229,2024-01-23,207,coca cola,75,100,25,1,279,India
158257,2024-01-23,209,pepsi,75,100,25,1,232,India
106337,2024-01-23,205,classic yogurt,45,60,15,1,429,India
106337,2024-01-23,202,milk,12,27,15,1,429,India
106337,2024-01-23,203,mango yogurt,50,60,10,1,429,India
839461,2024-01-23,201,paneer,210,340,130,1,491,India
839461,2024-01-23,208,sprite,75,100,25,1,491,India
839461,2024-01-23,212,amul cheese,250,315,65,1,491,India
650055,2024-01-23,201,paneer,210,340,130,1,319,India
650055,2024-01-23,202,milk,12,27,15,1,319,India
650055,2024-01-23,204,strawberry yogurt,50,60,10,1,319,India
650055,2024-01-23,208,sprite,75,100,25,1,319,India
650055,2024-01-23,213,bisleri,6,15,9,1,319,India
624119,2024-01-23,211,red bull,90,125,35,1,125,India
624119,2024-01-23,205,classic yogurt,45,60,15,1,125,India
624119,2024-01-23,202,milk,12,27,15,1,125,India
466709,2024-01-23,213,bisleri,6,15,9,1,470,India
709174,2024-01-23,211,red bull,90,125,35,1,120,India
709174,2024-01-23,208,sprite,75,100,25,1,120,India
709174,2024-01-23,207,coca cola,75,100,25,1,120,India
902370,2024-01-23,209,pepsi,75,100,25,1,426,India
902370,2024-01-23,206,yakult,360,400,40,1,426,India
902370,2024-01-23,207,coca cola,75,100,25,1,426,India
830731,2024-01-23,208,sprite,75,100,25,1,72,India
235441,2024-01-23,208,sprite,75,100,25,1,459,India
235441,2024-01-23,209,pepsi,75,100,25,1,459,India
235441,2024-01-23,212,amul cheese,250,315,65,1,459,India
947237,2024-01-23,209,pepsi,75,100,25,1,483,India
159983,2024-01-23,205,classic yogurt,45,60,15,1,46,India
159983,2024-01-23,213,bisleri,6,15,9,1,46,India
368503,2024-01-23,205,classic yogurt,45,60,15,1,171,India
368503,2024-01-23,206,yakult,360,400,40,1,171,India
619945,2024-01-23,206,yakult,360,400,40,1,264,India
935969,2024-01-23,211,red bull,90,125,35,1,55,India
650412,2024-01-23,202,milk,12,27,15,1,217,India
650412,2024-01-23,210,mountain dew,75,100,25,1,217,India
650412,2024-01-23,204,strawberry yogurt,50,60,10,1,217,India
650412,2024-01-23,208,sprite,75,100,25,1,217,India
741548,2024-01-23,209,pepsi,75,100,25,1,467,India
741548,2024-01-23,203,mango yogurt,50,60,10,1,467,India
741548,2024-01-23,211,red bull,90,125,35,1,467,India
741548,2024-01-23,206,yakult,360,400,40,1,467,India
610875,2024-01-23,208,sprite,75,100,25,1,421,India
610875,2024-01-23,206,yakult,360,400,40,1,421,India
610875,2024-01-23,203,mango yogurt,50,60,10,1,421,India
772977,2024-01-23,203,mango yogurt,50,60,10,1,482,India
772977,2024-01-23,205,classic yogurt,45,60,15,1,482,India
772977,2024-01-23,211,red bull,90,125,35,1,482,India
772977,2024-01-23,212,amul cheese,250,315,65,1,482,India
624794,2024-01-23,201,paneer,210,340,130,1,81,India
624794,2024-01-23,212,amul cheese,250,315,65,1,81,India
624794,2024-01-23,207,coca cola,75,100,25,1,81,India
777334,2024-01-23,204,strawberry yogurt,50,60,10,1,486,India
991726,2024-01-23,203,mango yogurt,50,60,10,1,492,India
991726,2024-01-23,210,mountain dew,75,100,25,1,492,India
991726,2024-01-23,209,pepsi,75,100,25,1,492,India
991726,2024-01-23,206,yakult,360,400,40,1,492,India
348961,2024-01-23,211,red bull,90,125,35,1,11,India
757516,2024-01-23,201,paneer,210,340,130,1,16,India
757516,2024-01-23,212,amul cheese,250,315,65,1,16,India
757516,2024-01-23,213,bisleri,6,15,9,1,16,India
757516,2024-01-23,206,yakult,360,400,40,1,16,India
757516,2024-01-23,203,mango yogurt,50,60,10,1,16,India
377313,2024-01-23,208,sprite,75,100,25,1,424,India
377313,2024-01-23,211,red bull,90,125,35,1,424,India
377313,2024-01-23,212,amul cheese,250,315,65,1,424,India
377313,2024-01-23,205,classic yogurt,45,60,15,1,424,India
995121,2024-01-23,201,paneer,210,340,130,1,254,India
995121,2024-01-23,210,mountain dew,75,100,25,1,254,India
995121,2024-01-23,202,milk,12,27,15,1,254,India
995121,2024-01-23,203,mango yogurt,50,60,10,1,254,India
196483,2024-01-23,213,bisleri,6,15,9,1,375,India
196483,2024-01-23,201,paneer,210,340,130,1,375,India
196483,2024-01-23,205,classic yogurt,45,60,15,1,375,India
196483,2024-01-23,208,sprite,75,100,25,1,375,India
571889,2024-01-23,204,strawberry yogurt,50,60,10,1,39,India
571889,2024-01-23,209,pepsi,75,100,25,1,39,India
151720,2024-01-23,202,milk,12,27,15,1,451,India
151720,2024-01-23,208,sprite,75,100,25,1,451,India
391021,2024-01-23,208,sprite,75,100,25,1,96,India
391021,2024-01-23,202,milk,12,27,15,1,96,India
391021,2024-01-23,203,mango yogurt,50,60,10,1,96,India
202509,2024-01-23,201,paneer,210,340,130,1,92,India
202509,2024-01-23,207,coca cola,75,100,25,1,92,India
202509,2024-01-23,211,red bull,90,125,35,1,92,India
904550,2024-01-23,209,pepsi,75,100,25,1,125,India
904550,2024-01-23,211,red bull,90,125,35,1,125,India
904550,2024-01-23,212,amul cheese,250,315,65,1,125,India
904550,2024-01-23,213,bisleri,6,15,9,1,125,India
904550,2024-01-23,207,coca cola,75,100,25,1,125,India
462103,2024-01-23,202,milk,12,27,15,1,370,India
462103,2024-01-23,201,paneer,210,340,130,1,370,India
918891,2024-01-23,206,yakult,360,400,40,1,98,India
918891,2024-01-23,213,bisleri,6,15,9,1,98,India
741790,2024-01-23,212,amul cheese,250,315,65,1,174,India
921870,2024-01-23,208,sprite,75,100,25,1,50,India
921870,2024-01-23,209,pepsi,75,100,25,1,50,India
921870,2024-01-23,202,milk,12,27,15,1,50,India
520880,2024-01-23,206,yakult,360,400,40,1,483,India
520880,2024-01-23,213,bisleri,6,15,9,1,483,India
520880,2024-01-23,202,milk,12,27,15,1,483,India
601548,2024-01-23,203,mango yogurt,50,60,10,1,470,India
596429,2024-01-23,201,paneer,210,340,130,1,97,India
596429,2024-01-23,213,bisleri,6,15,9,1,97,India
596429,2024-01-23,203,mango yogurt,50,60,10,1,97,India
596429,2024-01-23,207,coca cola,75,100,25,1,97,India
596429,2024-01-23,211,red bull,90,125,35,1,97,India
311121,2024-01-23,202,milk,12,27,15,1,276,India
577056,2024-01-23,212,amul cheese,250,315,65,1,401,India
577056,2024-01-23,203,mango yogurt,50,60,10,1,401,India
577056,2024-01-23,202,milk,12,27,15,1,401,India
577056,2024-01-23,210,mountain dew,75,100,25,1,401,India
316382,2024-01-23,202,milk,12,27,15,1,431,India
316382,2024-01-23,205,classic yogurt,45,60,15,1,431,India
316382,2024-01-23,208,sprite,75,100,25,1,431,India
853208,2024-01-24,213,bisleri,6,15,9,1,38,India
853208,2024-01-24,208,sprite,75,100,25,1,38,India
853208,2024-01-24,203,mango yogurt,50,60,10,1,38,India
853208,2024-01-24,207,coca cola,75,100,25,1,38,India
503080,2024-01-24,208,sprite,75,100,25,1,24,India
503080,2024-01-24,212,amul cheese,250,315,65,1,24,India
503080,2024-01-24,201,paneer,210,340,130,1,24,India
503080,2024-01-24,205,classic yogurt,45,60,15,1,24,India
807557,2024-01-24,201,paneer,210,340,130,1,365,India
349204,2024-01-24,211,red bull,90,125,35,1,135,India
349204,2024-01-24,201,paneer,210,340,130,1,135,India
349204,2024-01-24,208,sprite,75,100,25,1,135,India
924459,2024-01-24,202,milk,12,27,15,1,223,India
924459,2024-01-24,207,coca cola,75,100,25,1,223,India
479471,2024-01-24,207,coca cola,75,100,25,1,435,India
479471,2024-01-24,209,pepsi,75,100,25,1,435,India
479471,2024-01-24,203,mango yogurt,50,60,10,1,435,India
538072,2024-01-24,212,amul cheese,250,315,65,1,111,India
538072,2024-01-24,213,bisleri,6,15,9,1,111,India
538072,2024-01-24,206,yakult,360,400,40,1,111,India
531625,2024-01-24,209,pepsi,75,100,25,1,158,India
531625,2024-01-24,203,mango yogurt,50,60,10,1,158,India
531625,2024-01-24,210,mountain dew,75,100,25,1,158,India
531625,2024-01-24,211,red bull,90,125,35,1,158,India
602561,2024-01-24,203,mango yogurt,50,60,10,1,325,India
602561,2024-01-24,212,amul cheese,250,315,65,1,325,India
602561,2024-01-24,205,classic yogurt,45,60,15,1,325,India
602561,2024-01-24,207,coca cola,75,100,25,1,325,India
171566,2024-01-24,205,classic yogurt,45,60,15,1,96,India
171566,2024-01-24,210,mountain dew,75,100,25,1,96,India
100519,2024-01-24,209,pepsi,75,100,25,1,356,India
100519,2024-01-24,213,bisleri,6,15,9,1,356,India
100519,2024-01-24,204,strawberry yogurt,50,60,10,1,356,India
348876,2024-01-24,204,strawberry yogurt,50,60,10,1,125,India
711321,2024-01-24,207,coca cola,75,100,25,1,387,India
711321,2024-01-24,213,bisleri,6,15,9,1,387,India
711321,2024-01-24,204,strawberry yogurt,50,60,10,1,387,India
976532,2024-01-24,212,amul cheese,250,315,65,1,481,India
976532,2024-01-24,208,sprite,75,100,25,1,481,India
976532,2024-01-24,205,classic yogurt,45,60,15,1,481,India
976532,2024-01-24,209,pepsi,75,100,25,1,481,India
140045,2024-01-24,213,bisleri,6,15,9,1,207,India
324031,2024-01-24,204,strawberry yogurt,50,60,10,1,79,India
324031,2024-01-24,209,pepsi,75,100,25,1,79,India
324031,2024-01-24,213,bisleri,6,15,9,1,79,India
324031,2024-01-24,211,red bull,90,125,35,1,79,India
961344,2024-01-24,206,yakult,360,400,40,1,360,India
961344,2024-01-24,210,mountain dew,75,100,25,1,360,India
961344,2024-01-24,205,classic yogurt,45,60,15,1,360,India
962646,2024-01-24,209,pepsi,75,100,25,1,57,India
962646,2024-01-24,211,red bull,90,125,35,1,57,India
843176,2024-01-24,203,mango yogurt,50,60,10,1,289,India
843176,2024-01-24,210,mountain dew,75,100,25,1,289,India
762586,2024-01-24,206,yakult,360,400,40,1,281,India
762586,2024-01-24,203,mango yogurt,50,60,10,1,281,India
409962,2024-01-24,201,paneer,210,340,130,1,52,India
409962,2024-01-24,211,red bull,90,125,35,1,52,India
409962,2024-01-24,210,mountain dew,75,100,25,1,52,India
409962,2024-01-24,202,milk,12,27,15,1,52,India
549741,2024-01-24,204,strawberry yogurt,50,60,10,1,203,India
549741,2024-01-24,201,paneer,210,340,130,1,203,India
482166,2024-01-24,212,amul cheese,250,315,65,1,455,India
482166,2024-01-24,201,paneer,210,340,130,1,455,India
482166,2024-01-24,209,pepsi,75,100,25,1,455,India
482166,2024-01-24,213,bisleri,6,15,9,1,455,India
116276,2024-01-24,205,classic yogurt,45,60,15,1,13,India
116276,2024-01-24,207,coca cola,75,100,25,1,13,India
116276,2024-01-24,212,amul cheese,250,315,65,1,13,India
214182,2024-01-24,211,red bull,90,125,35,1,15,India
214182,2024-01-24,212,amul cheese,250,315,65,1,15,India
214182,2024-01-24,204,strawberry yogurt,50,60,10,1,15,India
365666,2024-01-24,212,amul cheese,250,315,65,1,348,India
365666,2024-01-24,203,mango yogurt,50,60,10,1,348,India
900778,2024-01-24,209,pepsi,75,100,25,1,284,India
900778,2024-01-24,201,paneer,210,340,130,1,284,India
540626,2024-01-24,204,strawberry yogurt,50,60,10,1,275,India
198826,2024-01-24,206,yakult,360,400,40,1,157,India
198826,2024-01-24,209,pepsi,75,100,25,1,157,India
906738,2024-01-24,204,strawberry yogurt,50,60,10,1,226,India
108445,2024-01-24,213,bisleri,6,15,9,1,254,India
108445,2024-01-24,202,milk,12,27,15,1,254,India
108445,2024-01-24,204,strawberry yogurt,50,60,10,1,254,India
108445,2024-01-24,210,mountain dew,75,100,25,1,254,India
303074,2024-01-24,204,strawberry yogurt,50,60,10,1,289,India
127410,2024-01-24,209,pepsi,75,100,25,1,48,India
127410,2024-01-24,205,classic yogurt,45,60,15,1,48,India
127410,2024-01-24,207,coca cola,75,100,25,1,48,India
127410,2024-01-24,201,paneer,210,340,130,1,48,India
208144,2024-01-24,210,mountain dew,75,100,25,1,369,India
866349,2024-01-24,212,amul cheese,250,315,65,1,180,India
866349,2024-01-24,207,coca cola,75,100,25,1,180,India
866349,2024-01-24,203,mango yogurt,50,60,10,1,180,India
866349,2024-01-24,205,classic yogurt,45,60,15,1,180,India
292019,2024-01-24,201,paneer,210,340,130,1,189,India
292019,2024-01-24,206,yakult,360,400,40,1,189,India
292019,2024-01-24,202,milk,12,27,15,1,189,India
371124,2024-01-24,201,paneer,210,340,130,1,64,India
371124,2024-01-24,213,bisleri,6,15,9,1,64,India
876219,2024-01-24,207,coca cola,75,100,25,1,445,India
876219,2024-01-24,212,amul cheese,250,315,65,1,445,India
644179,2024-01-24,209,pepsi,75,100,25,1,101,India
644179,2024-01-24,213,bisleri,6,15,9,1,101,India
644179,2024-01-24,207,coca cola,75,100,25,1,101,India
644179,2024-01-24,210,mountain dew,75,100,25,1,101,India
644179,2024-01-24,201,paneer,210,340,130,1,101,India
588678,2024-01-24,206,yakult,360,400,40,1,397,India
588678,2024-01-24,211,red bull,90,125,35,1,397,India
709519,2024-01-24,212,amul cheese,250,315,65,1,295,India
670033,2024-01-24,204,strawberry yogurt,50,60,10,1,113,India
769318,2024-01-24,208,sprite,75,100,25,1,275,India
918200,2024-01-24,207,coca cola,75,100,25,1,457,India
918200,2024-01-24,201,paneer,210,340,130,1,457,India
918200,2024-01-24,212,amul cheese,250,315,65,1,457,India
949159,2024-01-24,210,mountain dew,75,100,25,1,249,India
949159,2024-01-24,211,red bull,90,125,35,1,249,India
417621,2024-01-24,208,sprite,75,100,25,1,78,India
417621,2024-01-24,213,bisleri,6,15,9,1,78,India
869482,2024-01-24,201,paneer,210,340,130,1,193,India
869482,2024-01-24,206,yakult,360,400,40,1,193,India
540828,2024-01-24,203,mango yogurt,50,60,10,1,73,India
540828,2024-01-24,209,pepsi,75,100,25,1,73,India
540828,2024-01-24,213,bisleri,6,15,9,1,73,India
680809,2024-01-24,209,pepsi,75,100,25,1,469,India
680809,2024-01-24,207,coca cola,75,100,25,1,469,India
680809,2024-01-24,201,paneer,210,340,130,1,469,India
238912,2024-01-24,203,mango yogurt,50,60,10,1,140,India
238912,2024-01-24,202,milk,12,27,15,1,140,India
767809,2024-01-24,205,classic yogurt,45,60,15,1,282,India
767809,2024-01-24,212,amul cheese,250,315,65,1,282,India
767809,2024-01-24,202,milk,12,27,15,1,282,India
767809,2024-01-24,204,strawberry yogurt,50,60,10,1,282,India
767809,2024-01-24,201,paneer,210,340,130,1,282,India
653360,2024-01-24,205,classic yogurt,45,60,15,1,99,India
653360,2024-01-24,201,paneer,210,340,130,1,99,India
884264,2024-01-24,211,red bull,90,125,35,1,373,India
884264,2024-01-24,206,yakult,360,400,40,1,373,India
980493,2024-01-24,204,strawberry yogurt,50,60,10,1,173,India
980493,2024-01-24,205,classic yogurt,45,60,15,1,173,India
146259,2024-01-24,205,classic yogurt,45,60,15,1,479,India
146259,2024-01-24,208,sprite,75,100,25,1,479,India
146259,2024-01-24,201,paneer,210,340,130,1,479,India
146259,2024-01-24,210,mountain dew,75,100,25,1,479,India
809328,2024-01-25,208,sprite,75,100,25,1,347,India
809328,2024-01-25,206,yakult,360,400,40,1,347,India
809328,2024-01-25,211,red bull,90,125,35,1,347,India
452957,2024-01-25,212,amul cheese,250,315,65,1,96,India
909373,2024-01-25,210,mountain dew,75,100,25,1,52,India
909373,2024-01-25,208,sprite,75,100,25,1,52,India
909373,2024-01-25,207,coca cola,75,100,25,1,52,India
909373,2024-01-25,209,pepsi,75,100,25,1,52,India
447488,2024-01-25,202,milk,12,27,15,1,496,India
662134,2024-01-25,203,mango yogurt,50,60,10,1,64,India
658353,2024-01-25,213,bisleri,6,15,9,1,383,India
658353,2024-01-25,201,paneer,210,340,130,1,383,India
658353,2024-01-25,210,mountain dew,75,100,25,1,383,India
658353,2024-01-25,203,mango yogurt,50,60,10,1,383,India
658353,2024-01-25,202,milk,12,27,15,1,383,India
708341,2024-01-25,206,yakult,360,400,40,1,277,India
708341,2024-01-25,203,mango yogurt,50,60,10,1,277,India
708341,2024-01-25,211,red bull,90,125,35,1,277,India
708341,2024-01-25,213,bisleri,6,15,9,1,277,India
414489,2024-01-25,212,amul cheese,250,315,65,1,168,India
414489,2024-01-25,211,red bull,90,125,35,1,168,India
414489,2024-01-25,207,coca cola,75,100,25,1,168,India
546449,2024-01-25,204,strawberry yogurt,50,60,10,1,80,India
546449,2024-01-25,209,pepsi,75,100,25,1,80,India
546449,2024-01-25,208,sprite,75,100,25,1,80,India
468371,2024-01-25,201,paneer,210,340,130,1,128,India
468371,2024-01-25,209,pepsi,75,100,25,1,128,India
211523,2024-01-25,206,yakult,360,400,40,1,386,India
211523,2024-01-25,211,red bull,90,125,35,1,386,India
211523,2024-01-25,208,sprite,75,100,25,1,386,India
428221,2024-01-25,209,pepsi,75,100,25,1,312,India
428221,2024-01-25,202,milk,12,27,15,1,312,India
428221,2024-01-25,206,yakult,360,400,40,1,312,India
233329,2024-01-25,209,pepsi,75,100,25,1,498,India
233329,2024-01-25,211,red bull,90,125,35,1,498,India
233329,2024-01-25,206,yakult,360,400,40,1,498,India
267017,2024-01-25,212,amul cheese,250,315,65,1,116,India
267017,2024-01-25,203,mango yogurt,50,60,10,1,116,India
267017,2024-01-25,210,mountain dew,75,100,25,1,116,India
267017,2024-01-25,205,classic yogurt,45,60,15,1,116,India
217847,2024-01-25,208,sprite,75,100,25,1,297,India
217847,2024-01-25,201,paneer,210,340,130,1,297,India
217847,2024-01-25,213,bisleri,6,15,9,1,297,India
292982,2024-01-25,203,mango yogurt,50,60,10,1,56,India
292982,2024-01-25,213,bisleri,6,15,9,1,56,India
292982,2024-01-25,212,amul cheese,250,315,65,1,56,India
292982,2024-01-25,207,coca cola,75,100,25,1,56,India
292982,2024-01-25,208,sprite,75,100,25,1,56,India
423178,2024-01-25,212,amul cheese,250,315,65,1,166,India
111473,2024-01-25,210,mountain dew,75,100,25,1,124,India
111473,2024-01-25,209,pepsi,75,100,25,1,124,India
111473,2024-01-25,202,milk,12,27,15,1,124,India
881875,2024-01-25,208,sprite,75,100,25,1,152,India
177043,2024-01-25,206,yakult,360,400,40,1,435,India
177043,2024-01-25,203,mango yogurt,50,60,10,1,435,India
177043,2024-01-25,205,classic yogurt,45,60,15,1,435,India
951181,2024-01-25,207,coca cola,75,100,25,1,491,India
951181,2024-01-25,204,strawberry yogurt,50,60,10,1,491,India
876247,2024-01-25,202,milk,12,27,15,1,261,India
876247,2024-01-25,211,red bull,90,125,35,1,261,India
109080,2024-01-25,213,bisleri,6,15,9,1,85,India
109080,2024-01-25,207,coca cola,75,100,25,1,85,India
109080,2024-01-25,201,paneer,210,340,130,1,85,India
530742,2024-01-25,211,red bull,90,125,35,1,440,India
814121,2024-01-25,207,coca cola,75,100,25,1,258,India
814121,2024-01-25,211,red bull,90,125,35,1,258,India
814121,2024-01-25,201,paneer,210,340,130,1,258,India
814121,2024-01-25,202,milk,12,27,15,1,258,India
693882,2024-01-25,210,mountain dew,75,100,25,1,90,India
693882,2024-01-25,206,yakult,360,400,40,1,90,India
693882,2024-01-25,213,bisleri,6,15,9,1,90,India
985323,2024-01-25,212,amul cheese,250,315,65,1,208,India
474748,2024-01-25,212,amul cheese,250,315,65,1,447,India
321985,2024-01-25,201,paneer,210,340,130,1,498,India
321985,2024-01-25,207,coca cola,75,100,25,1,498,India
321985,2024-01-25,203,mango yogurt,50,60,10,1,498,India
228295,2024-01-25,203,mango yogurt,50,60,10,1,317,India
228295,2024-01-25,205,classic yogurt,45,60,15,1,317,India
228295,2024-01-25,207,coca cola,75,100,25,1,317,India
900230,2024-01-25,207,coca cola,75,100,25,1,436,India
900230,2024-01-25,205,classic yogurt,45,60,15,1,436,India
900230,2024-01-25,204,strawberry yogurt,50,60,10,1,436,India
900230,2024-01-25,213,bisleri,6,15,9,1,436,India
558662,2024-01-25,208,sprite,75,100,25,1,369,India
558662,2024-01-25,202,milk,12,27,15,1,369,India
558662,2024-01-25,211,red bull,90,125,35,1,369,India
782908,2024-01-25,204,strawberry yogurt,50,60,10,1,333,India
782908,2024-01-25,212,amul cheese,250,315,65,1,333,India
782908,2024-01-25,208,sprite,75,100,25,1,333,India
508156,2024-01-25,209,pepsi,75,100,25,1,69,India
199644,2024-01-25,210,mountain dew,75,100,25,1,46,India
199644,2024-01-25,202,milk,12,27,15,1,46,India
199644,2024-01-25,205,classic yogurt,45,60,15,1,46,India
199644,2024-01-25,213,bisleri,6,15,9,1,46,India
199644,2024-01-25,203,mango yogurt,50,60,10,1,46,India
184587,2024-01-25,207,coca cola,75,100,25,1,129,India
184587,2024-01-25,208,sprite,75,100,25,1,129,India
184587,2024-01-25,213,bisleri,6,15,9,1,129,India
448115,2024-01-25,206,yakult,360,400,40,1,9,India
448115,2024-01-25,212,amul cheese,250,315,65,1,9,India
448115,2024-01-25,203,mango yogurt,50,60,10,1,9,India
386024,2024-01-25,206,yakult,360,400,40,1,447,India
386024,2024-01-25,210,mountain dew,75,100,25,1,447,India
386024,2024-01-25,208,sprite,75,100,25,1,447,India
402528,2024-01-25,206,yakult,360,400,40,1,39,India
900146,2024-01-25,202,milk,12,27,15,1,458,India
900146,2024-01-25,211,red bull,90,125,35,1,458,India
900146,2024-01-25,206,yakult,360,400,40,1,458,India
900146,2024-01-25,204,strawberry yogurt,50,60,10,1,458,India
551706,2024-01-25,212,amul cheese,250,315,65,1,50,India
551706,2024-01-25,208,sprite,75,100,25,1,50,India
551706,2024-01-25,204,strawberry yogurt,50,60,10,1,50,India
298539,2024-01-25,213,bisleri,6,15,9,1,370,India
298539,2024-01-25,202,milk,12,27,15,1,370,India
298539,2024-01-25,212,amul cheese,250,315,65,1,370,India
299507,2024-01-25,204,strawberry yogurt,50,60,10,1,453,India
299507,2024-01-25,213,bisleri,6,15,9,1,453,India
462569,2024-01-25,209,pepsi,75,100,25,1,63,India
462569,2024-01-25,203,mango yogurt,50,60,10,1,63,India
277097,2024-01-25,201,paneer,210,340,130,1,282,India
277097,2024-01-25,204,strawberry yogurt,50,60,10,1,282,India
323759,2024-01-25,211,red bull,90,125,35,1,208,India
631501,2024-01-25,211,red bull,90,125,35,1,291,India
631501,2024-01-25,202,milk,12,27,15,1,291,India
631501,2024-01-25,212,amul cheese,250,315,65,1,291,India
631501,2024-01-25,201,paneer,210,340,130,1,291,India
698772,2024-01-25,203,mango yogurt,50,60,10,1,472,India
270661,2024-01-25,213,bisleri,6,15,9,1,64,India
270661,2024-01-25,211,red bull,90,125,35,1,64,India
270661,2024-01-25,201,paneer,210,340,130,1,64,India
295720,2024-01-25,202,milk,12,27,15,1,178,India
726025,2024-01-25,211,red bull,90,125,35,1,415,India
277812,2024-01-25,201,paneer,210,340,130,1,110,India
277812,2024-01-25,208,sprite,75,100,25,1,110,India
861255,2024-01-25,211,red bull,90,125,35,1,387,India
500833,2024-01-25,206,yakult,360,400,40,1,120,India
500833,2024-01-25,211,red bull,90,125,35,1,120,India
500833,2024-01-25,202,milk,12,27,15,1,120,India
500833,2024-01-25,209,pepsi,75,100,25,1,120,India
500833,2024-01-25,213,bisleri,6,15,9,1,120,India
195874,2024-01-26,204,strawberry yogurt,50,60,10,1,467,India
195874,2024-01-26,208,sprite,75,100,25,1,467,India
382109,2024-01-26,206,yakult,360,400,40,1,105,India
382109,2024-01-26,205,classic yogurt,45,60,15,1,105,India
382109,2024-01-26,211,red bull,90,125,35,1,105,India
382109,2024-01-26,201,paneer,210,340,130,1,105,India
270167,2024-01-26,204,strawberry yogurt,50,60,10,1,151,India
270167,2024-01-26,205,classic yogurt,45,60,15,1,151,India
337971,2024-01-26,210,mountain dew,75,100,25,1,212,India
337971,2024-01-26,205,classic yogurt,45,60,15,1,212,India
447084,2024-01-26,211,red bull,90,125,35,1,362,India
612915,2024-01-26,207,coca cola,75,100,25,1,433,India
721917,2024-01-26,212,amul cheese,250,315,65,1,443,India
721917,2024-01-26,205,classic yogurt,45,60,15,1,443,India
721917,2024-01-26,202,milk,12,27,15,1,443,India
721917,2024-01-26,210,mountain dew,75,100,25,1,443,India
721917,2024-01-26,206,yakult,360,400,40,1,443,India
618620,2024-01-26,209,pepsi,75,100,25,1,319,India
618620,2024-01-26,201,paneer,210,340,130,1,319,India
618620,2024-01-26,211,red bull,90,125,35,1,319,India
618620,2024-01-26,204,strawberry yogurt,50,60,10,1,319,India
176195,2024-01-26,209,pepsi,75,100,25,1,138,India
176195,2024-01-26,201,paneer,210,340,130,1,138,India
176195,2024-01-26,207,coca cola,75,100,25,1,138,India
486868,2024-01-26,207,coca cola,75,100,25,1,286,India
486868,2024-01-26,212,amul cheese,250,315,65,1,286,India
963797,2024-01-26,205,classic yogurt,45,60,15,1,218,India
963797,2024-01-26,202,milk,12,27,15,1,218,India
324853,2024-01-26,207,coca cola,75,100,25,1,93,India
324853,2024-01-26,206,yakult,360,400,40,1,93,India
324853,2024-01-26,201,paneer,210,340,130,1,93,India
324853,2024-01-26,208,sprite,75,100,25,1,93,India
507767,2024-01-26,209,pepsi,75,100,25,1,477,India
507767,2024-01-26,203,mango yogurt,50,60,10,1,477,India
507767,2024-01-26,206,yakult,360,400,40,1,477,India
507767,2024-01-26,205,classic yogurt,45,60,15,1,477,India
948000,2024-01-26,204,strawberry yogurt,50,60,10,1,424,India
948000,2024-01-26,210,mountain dew,75,100,25,1,424,India
948000,2024-01-26,212,amul cheese,250,315,65,1,424,India
890984,2024-01-26,201,paneer,210,340,130,1,254,India
557005,2024-01-26,203,mango yogurt,50,60,10,1,359,India
557005,2024-01-26,210,mountain dew,75,100,25,1,359,India
716087,2024-01-26,204,strawberry yogurt,50,60,10,1,401,India
716087,2024-01-26,207,coca cola,75,100,25,1,401,India
716087,2024-01-26,208,sprite,75,100,25,1,401,India
305738,2024-01-26,211,red bull,90,125,35,1,68,India
846180,2024-01-26,206,yakult,360,400,40,1,397,India
846180,2024-01-26,201,paneer,210,340,130,1,397,India
846180,2024-01-26,210,mountain dew,75,100,25,1,397,India
724045,2024-01-26,213,bisleri,6,15,9,1,454,India
724045,2024-01-26,204,strawberry yogurt,50,60,10,1,454,India
724045,2024-01-26,203,mango yogurt,50,60,10,1,454,India
162057,2024-01-26,213,bisleri,6,15,9,1,493,India
162057,2024-01-26,205,classic yogurt,45,60,15,1,493,India
162057,2024-01-26,211,red bull,90,125,35,1,493,India
162057,2024-01-26,201,paneer,210,340,130,1,493,India
921231,2024-01-26,201,paneer,210,340,130,1,282,India
138313,2024-01-26,202,milk,12,27,15,1,14,India
138313,2024-01-26,207,coca cola,75,100,25,1,14,India
138313,2024-01-26,201,paneer,210,340,130,1,14,India
454484,2024-01-26,203,mango yogurt,50,60,10,1,30,India
454484,2024-01-26,204,strawberry yogurt,50,60,10,1,30,India
454484,2024-01-26,208,sprite,75,100,25,1,30,India
283877,2024-01-26,207,coca cola,75,100,25,1,477,India
283877,2024-01-26,213,bisleri,6,15,9,1,477,India
283877,2024-01-26,210,mountain dew,75,100,25,1,477,India
283877,2024-01-26,201,paneer,210,340,130,1,477,India
865928,2024-01-26,211,red bull,90,125,35,1,288,India
865928,2024-01-26,209,pepsi,75,100,25,1,288,India
865928,2024-01-26,201,paneer,210,340,130,1,288,India
856686,2024-01-26,202,milk,12,27,15,1,52,India
856686,2024-01-26,211,red bull,90,125,35,1,52,India
856686,2024-01-26,207,coca cola,75,100,25,1,52,India
856686,2024-01-26,203,mango yogurt,50,60,10,1,52,India
555328,2024-01-26,205,classic yogurt,45,60,15,1,443,India
604338,2024-01-26,204,strawberry yogurt,50,60,10,1,468,India
604338,2024-01-26,206,yakult,360,400,40,1,468,India
980971,2024-01-26,213,bisleri,6,15,9,1,102,India
436239,2024-01-26,202,milk,12,27,15,1,346,India
436239,2024-01-26,201,paneer,210,340,130,1,346,India
436239,2024-01-26,212,amul cheese,250,315,65,1,346,India
561878,2024-01-26,206,yakult,360,400,40,1,141,India
561878,2024-01-26,205,classic yogurt,45,60,15,1,141,India
561878,2024-01-26,201,paneer,210,340,130,1,141,India
561878,2024-01-26,211,red bull,90,125,35,1,141,India
530237,2024-01-26,210,mountain dew,75,100,25,1,173,India
530237,2024-01-26,208,sprite,75,100,25,1,173,India
530237,2024-01-26,202,milk,12,27,15,1,173,India
530237,2024-01-26,201,paneer,210,340,130,1,173,India
719089,2024-01-26,207,coca cola,75,100,25,1,255,India
719089,2024-01-26,201,paneer,210,340,130,1,255,India
106873,2024-01-26,202,milk,12,27,15,1,35,India
106873,2024-01-26,213,bisleri,6,15,9,1,35,India
106873,2024-01-26,210,mountain dew,75,100,25,1,35,India
106873,2024-01-26,206,yakult,360,400,40,1,35,India
268529,2024-01-26,204,strawberry yogurt,50,60,10,1,375,India
111446,2024-01-26,202,milk,12,27,15,1,451,India
111446,2024-01-26,211,red bull,90,125,35,1,451,India
405636,2024-01-26,206,yakult,360,400,40,1,173,India
279874,2024-01-26,205,classic yogurt,45,60,15,1,36,India
279874,2024-01-26,211,red bull,90,125,35,1,36,India
279874,2024-01-26,207,coca cola,75,100,25,1,36,India
279874,2024-01-26,208,sprite,75,100,25,1,36,India
267485,2024-01-26,201,paneer,210,340,130,1,137,India
793959,2024-01-26,203,mango yogurt,50,60,10,1,438,India
793959,2024-01-26,210,mountain dew,75,100,25,1,438,India
793959,2024-01-26,202,milk,12,27,15,1,438,India
839762,2024-01-26,201,paneer,210,340,130,1,376,India
839762,2024-01-26,207,coca cola,75,100,25,1,376,India
545675,2024-01-26,207,coca cola,75,100,25,1,482,India
545675,2024-01-26,211,red bull,90,125,35,1,482,India
545675,2024-01-26,201,paneer,210,340,130,1,482,India
545675,2024-01-26,212,amul cheese,250,315,65,1,482,India
411047,2024-01-26,211,red bull,90,125,35,1,76,India
411047,2024-01-26,201,paneer,210,340,130,1,76,India
411047,2024-01-26,205,classic yogurt,45,60,15,1,76,India
764076,2024-01-26,210,mountain dew,75,100,25,1,236,India
764076,2024-01-26,201,paneer,210,340,130,1,236,India
764076,2024-01-26,206,yakult,360,400,40,1,236,India
764076,2024-01-26,212,amul cheese,250,315,65,1,236,India
594374,2024-01-26,202,milk,12,27,15,1,45,India
594374,2024-01-26,205,classic yogurt,45,60,15,1,45,India
594374,2024-01-26,208,sprite,75,100,25,1,45,India
594374,2024-01-26,206,yakult,360,400,40,1,45,India
236257,2024-01-26,211,red bull,90,125,35,1,284,India
236257,2024-01-26,203,mango yogurt,50,60,10,1,284,India
236257,2024-01-26,202,milk,12,27,15,1,284,India
236257,2024-01-26,205,classic yogurt,45,60,15,1,284,India
463789,2024-01-26,210,mountain dew,75,100,25,1,80,India
881731,2024-01-26,212,amul cheese,250,315,65,1,443,India
881731,2024-01-26,202,milk,12,27,15,1,443,India
881731,2024-01-26,203,mango yogurt,50,60,10,1,443,India
586748,2024-01-26,208,sprite,75,100,25,1,268,India
586748,2024-01-26,213,bisleri,6,15,9,1,268,India
586748,2024-01-26,201,paneer,210,340,130,1,268,India
586748,2024-01-26,202,milk,12,27,15,1,268,India
932141,2024-01-26,209,pepsi,75,100,25,1,104,India
932141,2024-01-26,205,classic yogurt,45,60,15,1,104,India
188305,2024-01-26,210,mountain dew,75,100,25,1,261,India
188305,2024-01-26,207,coca cola,75,100,25,1,261,India
188305,2024-01-26,204,strawberry yogurt,50,60,10,1,261,India
389747,2024-01-26,201,paneer,210,340,130,1,493,India
389747,2024-01-26,212,amul cheese,250,315,65,1,493,India
389747,2024-01-26,206,yakult,360,400,40,1,493,India
281421,2024-01-26,208,sprite,75,100,25,1,409,India
281421,2024-01-26,205,classic yogurt,45,60,15,1,409,India
281421,2024-01-26,204,strawberry yogurt,50,60,10,1,409,India
281421,2024-01-26,212,amul cheese,250,315,65,1,409,India
281421,2024-01-26,210,mountain dew,75,100,25,1,409,India
333295,2024-01-26,204,strawberry yogurt,50,60,10,1,457,India
333295,2024-01-26,202,milk,12,27,15,1,457,India
333295,2024-01-26,210,mountain dew,75,100,25,1,457,India
333295,2024-01-26,203,mango yogurt,50,60,10,1,457,India
884810,2024-01-26,205,classic yogurt,45,60,15,1,122,India
884810,2024-01-26,213,bisleri,6,15,9,1,122,India
884810,2024-01-26,204,strawberry yogurt,50,60,10,1,122,India
884810,2024-01-26,206,yakult,360,400,40,1,122,India
672480,2024-01-26,206,yakult,360,400,40,1,13,India
401129,2024-01-26,211,red bull,90,125,35,1,60,India
401129,2024-01-26,213,bisleri,6,15,9,1,60,India
401129,2024-01-26,206,yakult,360,400,40,1,60,India
583977,2024-01-26,203,mango yogurt,50,60,10,1,57,India
583977,2024-01-26,201,paneer,210,340,130,1,57,India
583977,2024-01-26,207,coca cola,75,100,25,1,57,India
583977,2024-01-26,209,pepsi,75,100,25,1,57,India
708266,2024-01-26,202,milk,12,27,15,1,310,India
708266,2024-01-26,206,yakult,360,400,40,1,310,India
708266,2024-01-26,209,pepsi,75,100,25,1,310,India
708266,2024-01-26,205,classic yogurt,45,60,15,1,310,India
708266,2024-01-26,208,sprite,75,100,25,1,310,India
414801,2024-01-26,213,bisleri,6,15,9,1,262,India
414801,2024-01-26,203,mango yogurt,50,60,10,1,262,India
414801,2024-01-26,206,yakult,360,400,40,1,262,India
414801,2024-01-26,211,red bull,90,125,35,1,262,India
844411,2024-01-26,209,pepsi,75,100,25,1,478,India
844411,2024-01-26,205,classic yogurt,45,60,15,1,478,India
756808,2024-01-26,211,red bull,90,125,35,1,180,India
756808,2024-01-26,213,bisleri,6,15,9,1,180,India
756808,2024-01-26,209,pepsi,75,100,25,1,180,India
768274,2024-01-26,203,mango yogurt,50,60,10,1,196,India
768274,2024-01-26,210,mountain dew,75,100,25,1,196,India
863413,2024-01-26,211,red bull,90,125,35,1,99,India
863413,2024-01-26,208,sprite,75,100,25,1,99,India
863413,2024-01-26,206,yakult,360,400,40,1,99,India
713014,2024-01-27,206,yakult,360,400,40,1,250,India
216243,2024-01-27,208,sprite,75,100,25,1,227,India
439104,2024-01-27,211,red bull,90,125,35,1,472,India
197940,2024-01-27,209,pepsi,75,100,25,1,461,India
718573,2024-01-27,201,paneer,210,340,130,1,300,India
523176,2024-01-27,210,mountain dew,75,100,25,1,461,India
523176,2024-01-27,203,mango yogurt,50,60,10,1,461,India
523176,2024-01-27,211,red bull,90,125,35,1,461,India
523176,2024-01-27,202,milk,12,27,15,1,461,India
523176,2024-01-27,208,sprite,75,100,25,1,461,India
231031,2024-01-27,208,sprite,75,100,25,1,285,India
231031,2024-01-27,203,mango yogurt,50,60,10,1,285,India
231031,2024-01-27,210,mountain dew,75,100,25,1,285,India
231031,2024-01-27,211,red bull,90,125,35,1,285,India
482882,2024-01-27,211,red bull,90,125,35,1,182,India
482882,2024-01-27,207,coca cola,75,100,25,1,182,India
553619,2024-01-27,204,strawberry yogurt,50,60,10,1,459,India
553619,2024-01-27,212,amul cheese,250,315,65,1,459,India
553619,2024-01-27,207,coca cola,75,100,25,1,459,India
553619,2024-01-27,203,mango yogurt,50,60,10,1,459,India
776058,2024-01-27,208,sprite,75,100,25,1,169,India
776058,2024-01-27,210,mountain dew,75,100,25,1,169,India
166654,2024-01-27,205,classic yogurt,45,60,15,1,392,India
166654,2024-01-27,203,mango yogurt,50,60,10,1,392,India
166654,2024-01-27,209,pepsi,75,100,25,1,392,India
166654,2024-01-27,201,paneer,210,340,130,1,392,India
166654,2024-01-27,208,sprite,75,100,25,1,392,India
818940,2024-01-27,206,yakult,360,400,40,1,118,India
818940,2024-01-27,208,sprite,75,100,25,1,118,India
818940,2024-01-27,209,pepsi,75,100,25,1,118,India
818940,2024-01-27,201,paneer,210,340,130,1,118,India
660932,2024-01-27,207,coca cola,75,100,25,1,414,India
660932,2024-01-27,205,classic yogurt,45,60,15,1,414,India
660932,2024-01-27,209,pepsi,75,100,25,1,414,India
957590,2024-01-27,201,paneer,210,340,130,1,73,India
957590,2024-01-27,203,mango yogurt,50,60,10,1,73,India
173812,2024-01-27,202,milk,12,27,15,1,218,India
173812,2024-01-27,203,mango yogurt,50,60,10,1,218,India
173812,2024-01-27,201,paneer,210,340,130,1,218,India
173812,2024-01-27,208,sprite,75,100,25,1,218,India
692154,2024-01-27,209,pepsi,75,100,25,1,473,India
347042,2024-01-27,207,coca cola,75,100,25,1,51,India
685545,2024-01-27,207,coca cola,75,100,25,1,194,India
685545,2024-01-27,209,pepsi,75,100,25,1,194,India
811590,2024-01-27,203,mango yogurt,50,60,10,1,240,India
811590,2024-01-27,204,strawberry yogurt,50,60,10,1,240,India
902581,2024-01-27,205,classic yogurt,45,60,15,1,365,India
529045,2024-01-27,205,classic yogurt,45,60,15,1,374,India
529045,2024-01-27,211,red bull,90,125,35,1,374,India
529045,2024-01-27,208,sprite,75,100,25,1,374,India
530367,2024-01-27,203,mango yogurt,50,60,10,1,479,India
530367,2024-01-27,211,red bull,90,125,35,1,479,India
530367,2024-01-27,209,pepsi,75,100,25,1,479,India
104646,2024-01-27,204,strawberry yogurt,50,60,10,1,118,India
104646,2024-01-27,205,classic yogurt,45,60,15,1,118,India
665977,2024-01-27,204,strawberry yogurt,50,60,10,1,467,India
665977,2024-01-27,206,yakult,360,400,40,1,467,India
983139,2024-01-27,208,sprite,75,100,25,1,375,India
409169,2024-01-27,206,yakult,360,400,40,1,13,India
409169,2024-01-27,204,strawberry yogurt,50,60,10,1,13,India
409169,2024-01-27,202,milk,12,27,15,1,13,India
409169,2024-01-27,213,bisleri,6,15,9,1,13,India
201210,2024-01-27,212,amul cheese,250,315,65,1,92,India
201210,2024-01-27,208,sprite,75,100,25,1,92,India
201210,2024-01-27,205,classic yogurt,45,60,15,1,92,India
306976,2024-01-27,212,amul cheese,250,315,65,1,257,India
834428,2024-01-27,203,mango yogurt,50,60,10,1,112,India
834428,2024-01-27,202,milk,12,27,15,1,112,India
481323,2024-01-27,210,mountain dew,75,100,25,1,302,India
481323,2024-01-27,208,sprite,75,100,25,1,302,India
481323,2024-01-27,201,paneer,210,340,130,1,302,India
376731,2024-01-27,213,bisleri,6,15,9,1,31,India
376731,2024-01-27,203,mango yogurt,50,60,10,1,31,India
314670,2024-01-27,204,strawberry yogurt,50,60,10,1,35,India
314670,2024-01-27,201,paneer,210,340,130,1,35,India
314670,2024-01-27,211,red bull,90,125,35,1,35,India
490683,2024-01-27,206,yakult,360,400,40,1,64,India
490683,2024-01-27,209,pepsi,75,100,25,1,64,India
490683,2024-01-27,211,red bull,90,125,35,1,64,India
182200,2024-01-27,206,yakult,360,400,40,1,25,India
182200,2024-01-27,208,sprite,75,100,25,1,25,India
182200,2024-01-27,203,mango yogurt,50,60,10,1,25,India
182200,2024-01-27,210,mountain dew,75,100,25,1,25,India
502030,2024-01-27,206,yakult,360,400,40,1,351,India
106103,2024-01-27,210,mountain dew,75,100,25,1,354,India
106103,2024-01-27,212,amul cheese,250,315,65,1,354,India
535527,2024-01-27,201,paneer,210,340,130,1,219,India
535527,2024-01-27,203,mango yogurt,50,60,10,1,219,India
767063,2024-01-27,211,red bull,90,125,35,1,353,India
997595,2024-01-27,206,yakult,360,400,40,1,128,India
997595,2024-01-27,211,red bull,90,125,35,1,128,India
552763,2024-01-27,203,mango yogurt,50,60,10,1,490,India
552763,2024-01-27,212,amul cheese,250,315,65,1,490,India
599595,2024-01-27,202,milk,12,27,15,1,171,India
678557,2024-01-27,207,coca cola,75,100,25,1,286,India
678557,2024-01-27,208,sprite,75,100,25,1,286,India
678557,2024-01-27,203,mango yogurt,50,60,10,1,286,India
623592,2024-01-27,213,bisleri,6,15,9,1,191,India
623592,2024-01-27,206,yakult,360,400,40,1,191,India
623592,2024-01-27,201,paneer,210,340,130,1,191,India
623592,2024-01-27,209,pepsi,75,100,25,1,191,India
411601,2024-01-27,211,red bull,90,125,35,1,345,India
260133,2024-01-27,212,amul cheese,250,315,65,1,67,India
260133,2024-01-27,204,strawberry yogurt,50,60,10,1,67,India
260133,2024-01-27,213,bisleri,6,15,9,1,67,India
260133,2024-01-27,211,red bull,90,125,35,1,67,India
559129,2024-01-27,213,bisleri,6,15,9,1,272,India
559129,2024-01-27,211,red bull,90,125,35,1,272,India
559129,2024-01-27,205,classic yogurt,45,60,15,1,272,India
135685,2024-01-27,211,red bull,90,125,35,1,474,India
135685,2024-01-27,210,mountain dew,75,100,25,1,474,India
140025,2024-01-27,205,classic yogurt,45,60,15,1,216,India
140025,2024-01-27,210,mountain dew,75,100,25,1,216,India
140025,2024-01-27,207,coca cola,75,100,25,1,216,India
645499,2024-01-27,202,milk,12,27,15,1,7,India
645499,2024-01-27,205,classic yogurt,45,60,15,1,7,India
645499,2024-01-27,211,red bull,90,125,35,1,7,India
645499,2024-01-27,206,yakult,360,400,40,1,7,India
645499,2024-01-27,208,sprite,75,100,25,1,7,India
538728,2024-01-27,207,coca cola,75,100,25,1,129,India
667031,2024-01-27,213,bisleri,6,15,9,1,408,India
442508,2024-01-27,208,sprite,75,100,25,1,325,India
442508,2024-01-27,207,coca cola,75,100,25,1,325,India
442508,2024-01-27,204,strawberry yogurt,50,60,10,1,325,India
767423,2024-01-27,205,classic yogurt,45,60,15,1,153,India
767423,2024-01-27,201,paneer,210,340,130,1,153,India
767423,2024-01-27,207,coca cola,75,100,25,1,153,India
767423,2024-01-27,206,yakult,360,400,40,1,153,India
767423,2024-01-27,210,mountain dew,75,100,25,1,153,India
496872,2024-01-27,206,yakult,360,400,40,1,347,India
226655,2024-01-27,203,mango yogurt,50,60,10,1,188,India
226655,2024-01-27,202,milk,12,27,15,1,188,India
226655,2024-01-27,208,sprite,75,100,25,1,188,India
620457,2024-01-27,210,mountain dew,75,100,25,1,228,India
620457,2024-01-27,205,classic yogurt,45,60,15,1,228,India
162198,2024-01-27,210,mountain dew,75,100,25,1,77,India
162198,2024-01-27,201,paneer,210,340,130,1,77,India
162198,2024-01-27,205,classic yogurt,45,60,15,1,77,India
162198,2024-01-27,211,red bull,90,125,35,1,77,India
752046,2024-01-27,213,bisleri,6,15,9,1,385,India
752046,2024-01-27,208,sprite,75,100,25,1,385,India
752046,2024-01-27,205,classic yogurt,45,60,15,1,385,India
185659,2024-01-27,203,mango yogurt,50,60,10,1,326,India
185659,2024-01-27,205,classic yogurt,45,60,15,1,326,India
185659,2024-01-27,206,yakult,360,400,40,1,326,India
185659,2024-01-27,211,red bull,90,125,35,1,326,India
995687,2024-01-27,201,paneer,210,340,130,1,1,India
995687,2024-01-27,211,red bull,90,125,35,1,1,India
995687,2024-01-27,204,strawberry yogurt,50,60,10,1,1,India
995687,2024-01-27,213,bisleri,6,15,9,1,1,India
334174,2024-01-27,206,yakult,360,400,40,1,332,India
334174,2024-01-27,201,paneer,210,340,130,1,332,India
787240,2024-01-27,212,amul cheese,250,315,65,1,77,India
787240,2024-01-27,207,coca cola,75,100,25,1,77,India
787240,2024-01-27,206,yakult,360,400,40,1,77,India
787240,2024-01-27,213,bisleri,6,15,9,1,77,India
764261,2024-01-27,201,paneer,210,340,130,1,250,India
764261,2024-01-27,205,classic yogurt,45,60,15,1,250,India
950500,2024-01-27,202,milk,12,27,15,1,334,India
380100,2024-01-27,211,red bull,90,125,35,1,433,India
380100,2024-01-27,207,coca cola,75,100,25,1,433,India
380100,2024-01-27,205,classic yogurt,45,60,15,1,433,India
380100,2024-01-27,206,yakult,360,400,40,1,433,India
854564,2024-01-27,208,sprite,75,100,25,1,375,India
854564,2024-01-27,212,amul cheese,250,315,65,1,375,India
854564,2024-01-27,213,bisleri,6,15,9,1,375,India
583805,2024-01-27,203,mango yogurt,50,60,10,1,400,India
583805,2024-01-27,207,coca cola,75,100,25,1,400,India
583805,2024-01-27,201,paneer,210,340,130,1,400,India
583805,2024-01-27,208,sprite,75,100,25,1,400,India
583805,2024-01-27,209,pepsi,75,100,25,1,400,India
251932,2024-01-27,205,classic yogurt,45,60,15,1,77,India
251932,2024-01-27,202,milk,12,27,15,1,77,India
251932,2024-01-27,212,amul cheese,250,315,65,1,77,India
251932,2024-01-27,213,bisleri,6,15,9,1,77,India
251932,2024-01-27,209,pepsi,75,100,25,1,77,India
667430,2024-01-27,204,strawberry yogurt,50,60,10,1,198,India
714599,2024-01-27,204,strawberry yogurt,50,60,10,1,123,India
714599,2024-01-27,212,amul cheese,250,315,65,1,123,India
714599,2024-01-27,202,milk,12,27,15,1,123,India
392316,2024-01-27,202,milk,12,27,15,1,3,India
392316,2024-01-27,210,mountain dew,75,100,25,1,3,India
997848,2024-01-27,209,pepsi,75,100,25,1,434,India
997848,2024-01-27,207,coca cola,75,100,25,1,434,India
401499,2024-01-27,207,coca cola,75,100,25,1,425,India
401499,2024-01-27,203,mango yogurt,50,60,10,1,425,India
333277,2024-01-27,212,amul cheese,250,315,65,1,253,India
608383,2024-01-27,208,sprite,75,100,25,1,32,India
608383,2024-01-27,210,mountain dew,75,100,25,1,32,India
608383,2024-01-27,213,bisleri,6,15,9,1,32,India
191447,2024-01-27,202,milk,12,27,15,1,39,India
191447,2024-01-27,209,pepsi,75,100,25,1,39,India
191447,2024-01-27,205,classic yogurt,45,60,15,1,39,India
191447,2024-01-27,208,sprite,75,100,25,1,39,India
609319,2024-01-27,203,mango yogurt,50,60,10,1,76,India
623139,2024-01-27,201,paneer,210,340,130,1,490,India
623139,2024-01-27,213,bisleri,6,15,9,1,490,India
623139,2024-01-27,208,sprite,75,100,25,1,490,India
891661,2024-01-27,208,sprite,75,100,25,1,13,India
891661,2024-01-27,207,coca cola,75,100,25,1,13,India
891661,2024-01-27,203,mango yogurt,50,60,10,1,13,India
276153,2024-01-27,203,mango yogurt,50,60,10,1,388,India
276153,2024-01-27,210,mountain dew,75,100,25,1,388,India
276153,2024-01-27,206,yakult,360,400,40,1,388,India
530122,2024-01-27,211,red bull,90,125,35,1,348,India
694887,2024-01-27,213,bisleri,6,15,9,1,37,India
694887,2024-01-27,202,milk,12,27,15,1,37,India
694887,2024-01-27,204,strawberry yogurt,50,60,10,1,37,India
694887,2024-01-27,209,pepsi,75,100,25,1,37,India
694887,2024-01-27,206,yakult,360,400,40,1,37,India
684694,2024-01-27,209,pepsi,75,100,25,1,217,India
684694,2024-01-27,204,strawberry yogurt,50,60,10,1,217,India
201612,2024-01-27,205,classic yogurt,45,60,15,1,481,India
201612,2024-01-27,201,paneer,210,340,130,1,481,India
201612,2024-01-27,203,mango yogurt,50,60,10,1,481,India
201612,2024-01-27,202,milk,12,27,15,1,481,India
201612,2024-01-27,204,strawberry yogurt,50,60,10,1,481,India
349003,2024-01-27,211,red bull,90,125,35,1,414,India
349003,2024-01-27,207,coca cola,75,100,25,1,414,India
349003,2024-01-27,206,yakult,360,400,40,1,414,India
472596,2024-01-28,204,strawberry yogurt,50,60,10,1,360,India
584929,2024-01-28,202,milk,12,27,15,1,268,India
584929,2024-01-28,204,strawberry yogurt,50,60,10,1,268,India
584929,2024-01-28,201,paneer,210,340,130,1,268,India
315516,2024-01-28,203,mango yogurt,50,60,10,1,49,India
315516,2024-01-28,208,sprite,75,100,25,1,49,India
315516,2024-01-28,207,coca cola,75,100,25,1,49,India
315516,2024-01-28,210,mountain dew,75,100,25,1,49,India
934368,2024-01-28,208,sprite,75,100,25,1,486,India
934368,2024-01-28,201,paneer,210,340,130,1,486,India
934368,2024-01-28,206,yakult,360,400,40,1,486,India
478519,2024-01-28,207,coca cola,75,100,25,1,449,India
478519,2024-01-28,206,yakult,360,400,40,1,449,India
478519,2024-01-28,208,sprite,75,100,25,1,449,India
478519,2024-01-28,202,milk,12,27,15,1,449,India
613824,2024-01-28,210,mountain dew,75,100,25,1,411,India
613824,2024-01-28,206,yakult,360,400,40,1,411,India
613824,2024-01-28,204,strawberry yogurt,50,60,10,1,411,India
222312,2024-01-28,212,amul cheese,250,315,65,1,490,India
663127,2024-01-28,213,bisleri,6,15,9,1,109,India
663127,2024-01-28,205,classic yogurt,45,60,15,1,109,India
663127,2024-01-28,203,mango yogurt,50,60,10,1,109,India
663127,2024-01-28,201,paneer,210,340,130,1,109,India
313875,2024-01-28,212,amul cheese,250,315,65,1,296,India
313875,2024-01-28,203,mango yogurt,50,60,10,1,296,India
313875,2024-01-28,201,paneer,210,340,130,1,296,India
949654,2024-01-28,211,red bull,90,125,35,1,496,India
949654,2024-01-28,205,classic yogurt,45,60,15,1,496,India
898569,2024-01-28,204,strawberry yogurt,50,60,10,1,244,India
898569,2024-01-28,213,bisleri,6,15,9,1,244,India
898569,2024-01-28,208,sprite,75,100,25,1,244,India
378325,2024-01-28,201,paneer,210,340,130,1,455,India
378325,2024-01-28,211,red bull,90,125,35,1,455,India
220675,2024-01-28,211,red bull,90,125,35,1,407,India
220675,2024-01-28,203,mango yogurt,50,60,10,1,407,India
220675,2024-01-28,202,milk,12,27,15,1,407,India
606365,2024-01-28,203,mango yogurt,50,60,10,1,29,India
606365,2024-01-28,208,sprite,75,100,25,1,29,India
606365,2024-01-28,204,strawberry yogurt,50,60,10,1,29,India
606365,2024-01-28,201,paneer,210,340,130,1,29,India
606365,2024-01-28,206,yakult,360,400,40,1,29,India
603200,2024-01-28,207,coca cola,75,100,25,1,230,India
603200,2024-01-28,202,milk,12,27,15,1,230,India
195123,2024-01-28,209,pepsi,75,100,25,1,77,India
350628,2024-01-28,210,mountain dew,75,100,25,1,63,India
350628,2024-01-28,212,amul cheese,250,315,65,1,63,India
521239,2024-01-28,207,coca cola,75,100,25,1,402,India
521239,2024-01-28,203,mango yogurt,50,60,10,1,402,India
559034,2024-01-28,207,coca cola,75,100,25,1,5,India
559034,2024-01-28,209,pepsi,75,100,25,1,5,India
271404,2024-01-28,212,amul cheese,250,315,65,1,45,India
271404,2024-01-28,208,sprite,75,100,25,1,45,India
271404,2024-01-28,211,red bull,90,125,35,1,45,India
271404,2024-01-28,209,pepsi,75,100,25,1,45,India
499104,2024-01-28,207,coca cola,75,100,25,1,389,India
457740,2024-01-28,206,yakult,360,400,40,1,12,India
457740,2024-01-28,201,paneer,210,340,130,1,12,India
457740,2024-01-28,209,pepsi,75,100,25,1,12,India
457740,2024-01-28,213,bisleri,6,15,9,1,12,India
250119,2024-01-28,201,paneer,210,340,130,1,201,India
250119,2024-01-28,203,mango yogurt,50,60,10,1,201,India
250119,2024-01-28,209,pepsi,75,100,25,1,201,India
817977,2024-01-28,203,mango yogurt,50,60,10,1,499,India
817977,2024-01-28,208,sprite,75,100,25,1,499,India
727341,2024-01-28,204,strawberry yogurt,50,60,10,1,66,India
727341,2024-01-28,206,yakult,360,400,40,1,66,India
874732,2024-01-28,206,yakult,360,400,40,1,23,India
874732,2024-01-28,208,sprite,75,100,25,1,23,India
874732,2024-01-28,204,strawberry yogurt,50,60,10,1,23,India
874732,2024-01-28,211,red bull,90,125,35,1,23,India
345512,2024-01-28,212,amul cheese,250,315,65,1,186,India
345512,2024-01-28,213,bisleri,6,15,9,1,186,India
345512,2024-01-28,205,classic yogurt,45,60,15,1,186,India
345512,2024-01-28,209,pepsi,75,100,25,1,186,India
633272,2024-01-28,201,paneer,210,340,130,1,16,India
168594,2024-01-28,213,bisleri,6,15,9,1,368,India
304058,2024-01-28,207,coca cola,75,100,25,1,464,India
142370,2024-01-28,203,mango yogurt,50,60,10,1,450,India
142370,2024-01-28,210,mountain dew,75,100,25,1,450,India
142370,2024-01-28,207,coca cola,75,100,25,1,450,India
142370,2024-01-28,211,red bull,90,125,35,1,450,India
759631,2024-01-28,201,paneer,210,340,130,1,59,India
759631,2024-01-28,207,coca cola,75,100,25,1,59,India
759631,2024-01-28,209,pepsi,75,100,25,1,59,India
759631,2024-01-28,204,strawberry yogurt,50,60,10,1,59,India
657124,2024-01-28,210,mountain dew,75,100,25,1,161,India
657124,2024-01-28,201,paneer,210,340,130,1,161,India
145815,2024-01-28,210,mountain dew,75,100,25,1,477,India
145815,2024-01-28,212,amul cheese,250,315,65,1,477,India
598448,2024-01-28,205,classic yogurt,45,60,15,1,487,India
598448,2024-01-28,211,red bull,90,125,35,1,487,India
598448,2024-01-28,204,strawberry yogurt,50,60,10,1,487,India
598448,2024-01-28,207,coca cola,75,100,25,1,487,India
916052,2024-01-28,208,sprite,75,100,25,1,216,India
916052,2024-01-28,207,coca cola,75,100,25,1,216,India
916052,2024-01-28,204,strawberry yogurt,50,60,10,1,216,India
916052,2024-01-28,201,paneer,210,340,130,1,216,India
825280,2024-01-28,207,coca cola,75,100,25,1,24,India
825280,2024-01-28,204,strawberry yogurt,50,60,10,1,24,India
825280,2024-01-28,205,classic yogurt,45,60,15,1,24,India
173341,2024-01-28,204,strawberry yogurt,50,60,10,1,158,India
173341,2024-01-28,212,amul cheese,250,315,65,1,158,India
173341,2024-01-28,213,bisleri,6,15,9,1,158,India
173341,2024-01-28,209,pepsi,75,100,25,1,158,India
453480,2024-01-28,207,coca cola,75,100,25,1,138,India
453480,2024-01-28,203,mango yogurt,50,60,10,1,138,India
744491,2024-01-28,213,bisleri,6,15,9,1,203,India
744491,2024-01-28,203,mango yogurt,50,60,10,1,203,India
976620,2024-01-28,207,coca cola,75,100,25,1,312,India
976620,2024-01-28,202,milk,12,27,15,1,312,India
505392,2024-01-28,210,mountain dew,75,100,25,1,396,India
505392,2024-01-28,207,coca cola,75,100,25,1,396,India
335258,2024-01-28,209,pepsi,75,100,25,1,327,India
335258,2024-01-28,201,paneer,210,340,130,1,327,India
335258,2024-01-28,205,classic yogurt,45,60,15,1,327,India
335258,2024-01-28,213,bisleri,6,15,9,1,327,India
335258,2024-01-28,212,amul cheese,250,315,65,1,327,India
814946,2024-01-28,209,pepsi,75,100,25,1,359,India
814946,2024-01-28,205,classic yogurt,45,60,15,1,359,India
814946,2024-01-28,212,amul cheese,250,315,65,1,359,India
938822,2024-01-28,204,strawberry yogurt,50,60,10,1,493,India
871884,2024-01-28,202,milk,12,27,15,1,302,India
871884,2024-01-28,207,coca cola,75,100,25,1,302,India
145515,2024-01-28,207,coca cola,75,100,25,1,349,India
145515,2024-01-28,206,yakult,360,400,40,1,349,India
408608,2024-01-28,206,yakult,360,400,40,1,420,India
408608,2024-01-28,204,strawberry yogurt,50,60,10,1,420,India
233708,2024-01-28,205,classic yogurt,45,60,15,1,432,India
233708,2024-01-28,203,mango yogurt,50,60,10,1,432,India
233708,2024-01-28,207,coca cola,75,100,25,1,432,India
233708,2024-01-28,202,milk,12,27,15,1,432,India
495642,2024-01-28,211,red bull,90,125,35,1,451,India
495642,2024-01-28,205,classic yogurt,45,60,15,1,451,India
495642,2024-01-28,202,milk,12,27,15,1,451,India
495642,2024-01-28,203,mango yogurt,50,60,10,1,451,India
535972,2024-01-28,203,mango yogurt,50,60,10,1,385,India
810263,2024-01-28,206,yakult,360,400,40,1,233,India
810263,2024-01-28,204,strawberry yogurt,50,60,10,1,233,India
291943,2024-01-28,213,bisleri,6,15,9,1,400,India
291943,2024-01-28,208,sprite,75,100,25,1,400,India
291943,2024-01-28,211,red bull,90,125,35,1,400,India
291943,2024-01-28,203,mango yogurt,50,60,10,1,400,India
291943,2024-01-28,205,classic yogurt,45,60,15,1,400,India
719643,2024-01-28,201,paneer,210,340,130,1,159,India
225803,2024-01-28,204,strawberry yogurt,50,60,10,1,306,India
225803,2024-01-28,211,red bull,90,125,35,1,306,India
589753,2024-01-28,209,pepsi,75,100,25,1,201,India
589753,2024-01-28,210,mountain dew,75,100,25,1,201,India
508783,2024-01-28,208,sprite,75,100,25,1,330,India
508783,2024-01-28,212,amul cheese,250,315,65,1,330,India
241906,2024-01-28,204,strawberry yogurt,50,60,10,1,116,India
241906,2024-01-28,207,coca cola,75,100,25,1,116,India
241906,2024-01-28,212,amul cheese,250,315,65,1,116,India
241906,2024-01-28,206,yakult,360,400,40,1,116,India
500665,2024-01-28,209,pepsi,75,100,25,1,339,India
500665,2024-01-28,202,milk,12,27,15,1,339,India
500665,2024-01-28,203,mango yogurt,50,60,10,1,339,India
621041,2024-01-28,202,milk,12,27,15,1,57,India
621041,2024-01-28,207,coca cola,75,100,25,1,57,India
621041,2024-01-28,204,strawberry yogurt,50,60,10,1,57,India
621041,2024-01-28,210,mountain dew,75,100,25,1,57,India
735832,2024-01-28,213,bisleri,6,15,9,1,409,India
735832,2024-01-28,207,coca cola,75,100,25,1,409,India
735832,2024-01-28,211,red bull,90,125,35,1,409,India
735832,2024-01-28,203,mango yogurt,50,60,10,1,409,India
735832,2024-01-28,206,yakult,360,400,40,1,409,India
754214,2024-01-28,209,pepsi,75,100,25,1,109,India
723165,2024-01-28,208,sprite,75,100,25,1,248,India
723165,2024-01-28,205,classic yogurt,45,60,15,1,248,India
723165,2024-01-28,203,mango yogurt,50,60,10,1,248,India
264225,2024-01-28,201,paneer,210,340,130,1,231,India
264225,2024-01-28,204,strawberry yogurt,50,60,10,1,231,India
102949,2024-01-28,208,sprite,75,100,25,1,320,India
486319,2024-01-28,208,sprite,75,100,25,1,216,India
486319,2024-01-28,207,coca cola,75,100,25,1,216,India
996986,2024-01-28,212,amul cheese,250,315,65,1,243,India
996986,2024-01-28,206,yakult,360,400,40,1,243,India
996986,2024-01-28,202,milk,12,27,15,1,243,India
996986,2024-01-28,203,mango yogurt,50,60,10,1,243,India
996986,2024-01-28,204,strawberry yogurt,50,60,10,1,243,India
213723,2024-01-28,201,paneer,210,340,130,1,246,India
213723,2024-01-28,210,mountain dew,75,100,25,1,246,India
213723,2024-01-28,202,milk,12,27,15,1,246,India
213723,2024-01-28,207,coca cola,75,100,25,1,246,India
213723,2024-01-28,208,sprite,75,100,25,1,246,India
611614,2024-01-28,211,red bull,90,125,35,1,337,India
247368,2024-01-28,201,paneer,210,340,130,1,447,India
423022,2024-01-28,208,sprite,75,100,25,1,3,India
423022,2024-01-28,203,mango yogurt,50,60,10,1,3,India
528981,2024-01-28,211,red bull,90,125,35,1,20,India
528981,2024-01-28,210,mountain dew,75,100,25,1,20,India
528981,2024-01-28,213,bisleri,6,15,9,1,20,India
528981,2024-01-28,205,classic yogurt,45,60,15,1,20,India
549077,2024-01-28,211,red bull,90,125,35,1,341,India
403639,2024-01-28,202,milk,12,27,15,1,312,India
132195,2024-01-28,212,amul cheese,250,315,65,1,397,India
132195,2024-01-28,207,coca cola,75,100,25,1,397,India
663179,2024-01-28,209,pepsi,75,100,25,1,307,India
663179,2024-01-28,201,paneer,210,340,130,1,307,India
663179,2024-01-28,206,yakult,360,400,40,1,307,India
883738,2024-01-28,212,amul cheese,250,315,65,1,67,India
883738,2024-01-28,201,paneer,210,340,130,1,67,India
883738,2024-01-28,208,sprite,75,100,25,1,67,India
883738,2024-01-28,206,yakult,360,400,40,1,67,India
865758,2024-01-28,209,pepsi,75,100,25,1,92,India
865758,2024-01-28,205,classic yogurt,45,60,15,1,92,India
308634,2024-01-28,203,mango yogurt,50,60,10,1,448,India
864686,2024-01-28,203,mango yogurt,50,60,10,1,136,India
864686,2024-01-28,211,red bull,90,125,35,1,136,India
864686,2024-01-28,212,amul cheese,250,315,65,1,136,India
957120,2024-01-28,209,pepsi,75,100,25,1,347,India
957120,2024-01-28,202,milk,12,27,15,1,347,India
957120,2024-01-28,201,paneer,210,340,130,1,347,India
932094,2024-01-28,213,bisleri,6,15,9,1,287,India
932094,2024-01-28,202,milk,12,27,15,1,287,India
932094,2024-01-28,205,classic yogurt,45,60,15,1,287,India
932094,2024-01-28,207,coca cola,75,100,25,1,287,India
339979,2024-01-28,209,pepsi,75,100,25,1,379,India
339979,2024-01-28,208,sprite,75,100,25,1,379,India
339979,2024-01-28,210,mountain dew,75,100,25,1,379,India
339979,2024-01-28,201,paneer,210,340,130,1,379,India
339979,2024-01-28,206,yakult,360,400,40,1,379,India
883496,2024-01-28,211,red bull,90,125,35,1,56,India
883496,2024-01-28,209,pepsi,75,100,25,1,56,India
451477,2024-01-28,206,yakult,360,400,40,1,356,India
451477,2024-01-28,209,pepsi,75,100,25,1,356,India
451477,2024-01-28,205,classic yogurt,45,60,15,1,356,India
451477,2024-01-28,203,mango yogurt,50,60,10,1,356,India
702094,2024-01-28,201,paneer,210,340,130,1,8,India
702094,2024-01-28,203,mango yogurt,50,60,10,1,8,India
702094,2024-01-28,208,sprite,75,100,25,1,8,India
702094,2024-01-28,206,yakult,360,400,40,1,8,India
850912,2024-01-28,205,classic yogurt,45,60,15,1,414,India
850912,2024-01-28,204,strawberry yogurt,50,60,10,1,414,India
850912,2024-01-28,210,mountain dew,75,100,25,1,414,India
850912,2024-01-28,209,pepsi,75,100,25,1,414,India
997989,2024-01-28,205,classic yogurt,45,60,15,1,148,India
997989,2024-01-28,206,yakult,360,400,40,1,148,India
427773,2024-01-28,212,amul cheese,250,315,65,1,251,India
427773,2024-01-28,202,milk,12,27,15,1,251,India
427773,2024-01-28,203,mango yogurt,50,60,10,1,251,India
354583,2024-01-28,210,mountain dew,75,100,25,1,119,India
605926,2024-01-28,206,yakult,360,400,40,1,11,India
605926,2024-01-28,204,strawberry yogurt,50,60,10,1,11,India
605926,2024-01-28,205,classic yogurt,45,60,15,1,11,India
935715,2024-01-28,203,mango yogurt,50,60,10,1,93,India
464848,2024-01-28,213,bisleri,6,15,9,1,124,India
464848,2024-01-28,209,pepsi,75,100,25,1,124,India
520817,2024-01-28,212,amul cheese,250,315,65,1,344,India
520817,2024-01-28,207,coca cola,75,100,25,1,344,India
775764,2024-01-28,203,mango yogurt,50,60,10,1,378,India
775764,2024-01-28,206,yakult,360,400,40,1,378,India
775764,2024-01-28,212,amul cheese,250,315,65,1,378,India
775764,2024-01-28,211,red bull,90,125,35,1,378,India
203449,2024-01-28,205,classic yogurt,45,60,15,1,255,India
203449,2024-01-28,212,amul cheese,250,315,65,1,255,India
203449,2024-01-28,210,mountain dew,75,100,25,1,255,India
203449,2024-01-28,208,sprite,75,100,25,1,255,India
962208,2024-01-28,206,yakult,360,400,40,1,451,India
962208,2024-01-28,203,mango yogurt,50,60,10,1,451,India
412063,2024-01-28,212,amul cheese,250,315,65,1,476,India
412063,2024-01-28,206,yakult,360,400,40,1,476,India
412063,2024-01-28,203,mango yogurt,50,60,10,1,476,India
609883,2024-01-28,208,sprite,75,100,25,1,484,India
226943,2024-01-29,212,amul cheese,250,315,65,1,423,India
226943,2024-01-29,203,mango yogurt,50,60,10,1,423,India
226943,2024-01-29,213,bisleri,6,15,9,1,423,India
709019,2024-01-29,207,coca cola,75,100,25,1,18,India
709019,2024-01-29,204,strawberry yogurt,50,60,10,1,18,India
425152,2024-01-29,208,sprite,75,100,25,1,123,India
970608,2024-01-29,211,red bull,90,125,35,1,304,India
970608,2024-01-29,201,paneer,210,340,130,1,304,India
970608,2024-01-29,206,yakult,360,400,40,1,304,India
515176,2024-01-29,213,bisleri,6,15,9,1,254,India
515176,2024-01-29,202,milk,12,27,15,1,254,India
515176,2024-01-29,205,classic yogurt,45,60,15,1,254,India
515176,2024-01-29,206,yakult,360,400,40,1,254,India
446817,2024-01-29,203,mango yogurt,50,60,10,1,185,India
446817,2024-01-29,212,amul cheese,250,315,65,1,185,India
446817,2024-01-29,211,red bull,90,125,35,1,185,India
264110,2024-01-29,203,mango yogurt,50,60,10,1,170,India
582005,2024-01-29,202,milk,12,27,15,1,69,India
582005,2024-01-29,206,yakult,360,400,40,1,69,India
582005,2024-01-29,204,strawberry yogurt,50,60,10,1,69,India
582005,2024-01-29,210,mountain dew,75,100,25,1,69,India
429779,2024-01-29,211,red bull,90,125,35,1,233,India
543521,2024-01-29,206,yakult,360,400,40,1,68,India
543521,2024-01-29,204,strawberry yogurt,50,60,10,1,68,India
649520,2024-01-29,213,bisleri,6,15,9,1,382,India
649520,2024-01-29,204,strawberry yogurt,50,60,10,1,382,India
649520,2024-01-29,208,sprite,75,100,25,1,382,India
962976,2024-01-29,206,yakult,360,400,40,1,245,India
962976,2024-01-29,212,amul cheese,250,315,65,1,245,India
962976,2024-01-29,207,coca cola,75,100,25,1,245,India
330521,2024-01-29,209,pepsi,75,100,25,1,434,India
330521,2024-01-29,205,classic yogurt,45,60,15,1,434,India
330521,2024-01-29,207,coca cola,75,100,25,1,434,India
330521,2024-01-29,201,paneer,210,340,130,1,434,India
882449,2024-01-29,210,mountain dew,75,100,25,1,228,India
882449,2024-01-29,206,yakult,360,400,40,1,228,India
882449,2024-01-29,203,mango yogurt,50,60,10,1,228,India
882449,2024-01-29,207,coca cola,75,100,25,1,228,India
882449,2024-01-29,202,milk,12,27,15,1,228,India
189083,2024-01-29,204,strawberry yogurt,50,60,10,1,247,India
797095,2024-01-29,205,classic yogurt,45,60,15,1,265,India
797095,2024-01-29,203,mango yogurt,50,60,10,1,265,India
797095,2024-01-29,202,milk,12,27,15,1,265,India
846757,2024-01-29,213,bisleri,6,15,9,1,452,India
846757,2024-01-29,212,amul cheese,250,315,65,1,452,India
846757,2024-01-29,210,mountain dew,75,100,25,1,452,India
248122,2024-01-29,204,strawberry yogurt,50,60,10,1,13,India
248122,2024-01-29,213,bisleri,6,15,9,1,13,India
791388,2024-01-29,209,pepsi,75,100,25,1,247,India
791388,2024-01-29,201,paneer,210,340,130,1,247,India
791388,2024-01-29,205,classic yogurt,45,60,15,1,247,India
791388,2024-01-29,202,milk,12,27,15,1,247,India
428695,2024-01-29,207,coca cola,75,100,25,1,191,India
428695,2024-01-29,201,paneer,210,340,130,1,191,India
428695,2024-01-29,210,mountain dew,75,100,25,1,191,India
428695,2024-01-29,203,mango yogurt,50,60,10,1,191,India
735419,2024-01-29,208,sprite,75,100,25,1,355,India
735419,2024-01-29,207,coca cola,75,100,25,1,355,India
735419,2024-01-29,203,mango yogurt,50,60,10,1,355,India
951166,2024-01-29,213,bisleri,6,15,9,1,248,India
951166,2024-01-29,209,pepsi,75,100,25,1,248,India
951166,2024-01-29,208,sprite,75,100,25,1,248,India
675728,2024-01-29,205,classic yogurt,45,60,15,1,21,India
675728,2024-01-29,212,amul cheese,250,315,65,1,21,India
675728,2024-01-29,209,pepsi,75,100,25,1,21,India
675728,2024-01-29,204,strawberry yogurt,50,60,10,1,21,India
675728,2024-01-29,207,coca cola,75,100,25,1,21,India
296971,2024-01-29,211,red bull,90,125,35,1,255,India
296971,2024-01-29,204,strawberry yogurt,50,60,10,1,255,India
317276,2024-01-29,201,paneer,210,340,130,1,101,India
317276,2024-01-29,208,sprite,75,100,25,1,101,India
317276,2024-01-29,213,bisleri,6,15,9,1,101,India
317276,2024-01-29,212,amul cheese,250,315,65,1,101,India
933654,2024-01-29,209,pepsi,75,100,25,1,145,India
933654,2024-01-29,213,bisleri,6,15,9,1,145,India
427773,2024-01-29,202,milk,12,27,15,1,251,India
427773,2024-01-29,201,paneer,210,340,130,1,251,India
427773,2024-01-29,207,coca cola,75,100,25,1,251,India
362528,2024-01-29,211,red bull,90,125,35,1,126,India
362528,2024-01-29,209,pepsi,75,100,25,1,126,India
362528,2024-01-29,210,mountain dew,75,100,25,1,126,India
572932,2024-01-29,209,pepsi,75,100,25,1,464,India
306741,2024-01-29,212,amul cheese,250,315,65,1,69,India
306741,2024-01-29,210,mountain dew,75,100,25,1,69,India
306741,2024-01-29,206,yakult,360,400,40,1,69,India
306741,2024-01-29,205,classic yogurt,45,60,15,1,69,India
306741,2024-01-29,211,red bull,90,125,35,1,69,India
509495,2024-01-29,206,yakult,360,400,40,1,493,India
509495,2024-01-29,204,strawberry yogurt,50,60,10,1,493,India
509495,2024-01-29,209,pepsi,75,100,25,1,493,India
509495,2024-01-29,202,milk,12,27,15,1,493,India
509495,2024-01-29,203,mango yogurt,50,60,10,1,493,India
684957,2024-01-29,202,milk,12,27,15,1,71,India
684957,2024-01-29,212,amul cheese,250,315,65,1,71,India
448246,2024-01-29,210,mountain dew,75,100,25,1,101,India
448246,2024-01-29,201,paneer,210,340,130,1,101,India
448246,2024-01-29,202,milk,12,27,15,1,101,India
448246,2024-01-29,207,coca cola,75,100,25,1,101,India
774281,2024-01-29,212,amul cheese,250,315,65,1,56,India
774281,2024-01-29,203,mango yogurt,50,60,10,1,56,India
774281,2024-01-29,209,pepsi,75,100,25,1,56,India
975974,2024-01-29,213,bisleri,6,15,9,1,158,India
975974,2024-01-29,202,milk,12,27,15,1,158,India
975974,2024-01-29,206,yakult,360,400,40,1,158,India
975974,2024-01-29,204,strawberry yogurt,50,60,10,1,158,India
975974,2024-01-29,201,paneer,210,340,130,1,158,India
283715,2024-01-29,210,mountain dew,75,100,25,1,169,India
790587,2024-01-29,213,bisleri,6,15,9,1,110,India
790587,2024-01-29,210,mountain dew,75,100,25,1,110,India
790587,2024-01-29,203,mango yogurt,50,60,10,1,110,India
915859,2024-01-29,210,mountain dew,75,100,25,1,410,India
235195,2024-01-29,203,mango yogurt,50,60,10,1,275,India
422363,2024-01-29,211,red bull,90,125,35,1,53,India
422363,2024-01-29,201,paneer,210,340,130,1,53,India
422363,2024-01-29,204,strawberry yogurt,50,60,10,1,53,India
295944,2024-01-29,208,sprite,75,100,25,1,56,India
295944,2024-01-29,204,strawberry yogurt,50,60,10,1,56,India
794938,2024-01-29,207,coca cola,75,100,25,1,365,India
794938,2024-01-29,204,strawberry yogurt,50,60,10,1,365,India
794938,2024-01-29,203,mango yogurt,50,60,10,1,365,India
794938,2024-01-29,212,amul cheese,250,315,65,1,365,India
868647,2024-01-29,209,pepsi,75,100,25,1,113,India
868647,2024-01-29,210,mountain dew,75,100,25,1,113,India
841483,2024-01-29,202,milk,12,27,15,1,316,India
841483,2024-01-29,205,classic yogurt,45,60,15,1,316,India
841483,2024-01-29,211,red bull,90,125,35,1,316,India
841483,2024-01-29,209,pepsi,75,100,25,1,316,India
741597,2024-01-29,212,amul cheese,250,315,65,1,304,India
741597,2024-01-29,208,sprite,75,100,25,1,304,India
741597,2024-01-29,202,milk,12,27,15,1,304,India
741597,2024-01-29,203,mango yogurt,50,60,10,1,304,India
630936,2024-01-29,213,bisleri,6,15,9,1,315,India
630936,2024-01-29,209,pepsi,75,100,25,1,315,India
382798,2024-01-29,209,pepsi,75,100,25,1,53,India
701400,2024-01-29,202,milk,12,27,15,1,199,India
701400,2024-01-29,204,strawberry yogurt,50,60,10,1,199,India
701400,2024-01-29,203,mango yogurt,50,60,10,1,199,India
701400,2024-01-29,206,yakult,360,400,40,1,199,India
564170,2024-01-29,207,coca cola,75,100,25,1,421,India
665509,2024-01-29,213,bisleri,6,15,9,1,313,India
479999,2024-01-29,208,sprite,75,100,25,1,211,India
479999,2024-01-29,207,coca cola,75,100,25,1,211,India
479999,2024-01-29,211,red bull,90,125,35,1,211,India
813618,2024-01-29,206,yakult,360,400,40,1,446,India
813618,2024-01-29,202,milk,12,27,15,1,446,India
172117,2024-01-29,202,milk,12,27,15,1,58,India
172117,2024-01-29,210,mountain dew,75,100,25,1,58,India
172117,2024-01-29,204,strawberry yogurt,50,60,10,1,58,India
172117,2024-01-29,212,amul cheese,250,315,65,1,58,India
726807,2024-01-29,211,red bull,90,125,35,1,142,India
726807,2024-01-29,212,amul cheese,250,315,65,1,142,India
237543,2024-01-29,211,red bull,90,125,35,1,324,India
237543,2024-01-29,206,yakult,360,400,40,1,324,India
237543,2024-01-29,205,classic yogurt,45,60,15,1,324,India
237543,2024-01-29,202,milk,12,27,15,1,324,India
849641,2024-01-29,210,mountain dew,75,100,25,1,135,India
849641,2024-01-29,207,coca cola,75,100,25,1,135,India
247242,2024-01-29,202,milk,12,27,15,1,472,India
247242,2024-01-29,209,pepsi,75,100,25,1,472,India
247242,2024-01-29,213,bisleri,6,15,9,1,472,India
247242,2024-01-29,205,classic yogurt,45,60,15,1,472,India
153280,2024-01-29,207,coca cola,75,100,25,1,296,India
153280,2024-01-29,202,milk,12,27,15,1,296,India
153280,2024-01-29,209,pepsi,75,100,25,1,296,India
153280,2024-01-29,210,mountain dew,75,100,25,1,296,India
648084,2024-01-29,205,classic yogurt,45,60,15,1,109,India
648084,2024-01-29,201,paneer,210,340,130,1,109,India
648084,2024-01-29,212,amul cheese,250,315,65,1,109,India
648084,2024-01-29,206,yakult,360,400,40,1,109,India
417883,2024-01-29,204,strawberry yogurt,50,60,10,1,476,India
417883,2024-01-29,203,mango yogurt,50,60,10,1,476,India
417883,2024-01-29,208,sprite,75,100,25,1,476,India
417883,2024-01-29,211,red bull,90,125,35,1,476,India
417883,2024-01-29,213,bisleri,6,15,9,1,476,India
121123,2024-01-29,206,yakult,360,400,40,1,122,India
121123,2024-01-29,201,paneer,210,340,130,1,122,India
121123,2024-01-29,202,milk,12,27,15,1,122,India
121123,2024-01-29,209,pepsi,75,100,25,1,122,India
398075,2024-01-29,204,strawberry yogurt,50,60,10,1,255,India
398075,2024-01-29,213,bisleri,6,15,9,1,255,India
398075,2024-01-29,211,red bull,90,125,35,1,255,India
987991,2024-01-29,205,classic yogurt,45,60,15,1,313,India
987991,2024-01-29,207,coca cola,75,100,25,1,313,India
987991,2024-01-29,213,bisleri,6,15,9,1,313,India
987991,2024-01-29,212,amul cheese,250,315,65,1,313,India
431366,2024-01-29,206,yakult,360,400,40,1,270,India
431366,2024-01-29,212,amul cheese,250,315,65,1,270,India
547151,2024-01-29,203,mango yogurt,50,60,10,1,99,India
547151,2024-01-29,206,yakult,360,400,40,1,99,India
547151,2024-01-29,213,bisleri,6,15,9,1,99,India
489595,2024-01-29,203,mango yogurt,50,60,10,1,244,India
489595,2024-01-29,212,amul cheese,250,315,65,1,244,India
489595,2024-01-29,202,milk,12,27,15,1,244,India
489595,2024-01-29,206,yakult,360,400,40,1,244,India
594865,2024-01-29,201,paneer,210,340,130,1,173,India
594865,2024-01-29,211,red bull,90,125,35,1,173,India
497646,2024-01-29,210,mountain dew,75,100,25,1,500,India
497646,2024-01-29,209,pepsi,75,100,25,1,500,India
497646,2024-01-29,203,mango yogurt,50,60,10,1,500,India
497646,2024-01-29,202,milk,12,27,15,1,500,India
908123,2024-01-29,206,yakult,360,400,40,1,154,India
908123,2024-01-29,213,bisleri,6,15,9,1,154,India
863664,2024-01-29,212,amul cheese,250,315,65,1,33,India
863664,2024-01-29,201,paneer,210,340,130,1,33,India
863664,2024-01-29,204,strawberry yogurt,50,60,10,1,33,India
232669,2024-01-29,213,bisleri,6,15,9,1,286,India
264837,2024-01-29,208,sprite,75,100,25,1,324,India
264837,2024-01-29,204,strawberry yogurt,50,60,10,1,324,India
264837,2024-01-29,202,milk,12,27,15,1,324,India
295803,2024-01-29,205,classic yogurt,45,60,15,1,442,India
687043,2024-01-29,203,mango yogurt,50,60,10,1,302,India
687043,2024-01-29,212,amul cheese,250,315,65,1,302,India
687043,2024-01-29,202,milk,12,27,15,1,302,India
529745,2024-01-29,202,milk,12,27,15,1,416,India
529745,2024-01-29,208,sprite,75,100,25,1,416,India
529745,2024-01-29,211,red bull,90,125,35,1,416,India
529745,2024-01-29,209,pepsi,75,100,25,1,416,India
245269,2024-01-29,207,coca cola,75,100,25,1,105,India
769553,2024-01-29,213,bisleri,6,15,9,1,170,India
769553,2024-01-29,206,yakult,360,400,40,1,170,India
769553,2024-01-29,205,classic yogurt,45,60,15,1,170,India
769553,2024-01-29,203,mango yogurt,50,60,10,1,170,India
594954,2024-01-29,203,mango yogurt,50,60,10,1,201,India
145513,2024-01-29,203,mango yogurt,50,60,10,1,68,India
145513,2024-01-29,209,pepsi,75,100,25,1,68,India
145513,2024-01-29,204,strawberry yogurt,50,60,10,1,68,India
145513,2024-01-29,202,milk,12,27,15,1,68,India
287985,2024-01-29,210,mountain dew,75,100,25,1,252,India
287985,2024-01-29,201,paneer,210,340,130,1,252,India
287985,2024-01-29,208,sprite,75,100,25,1,252,India
287985,2024-01-29,212,amul cheese,250,315,65,1,252,India
212177,2024-01-29,207,coca cola,75,100,25,1,452,India
212177,2024-01-29,203,mango yogurt,50,60,10,1,452,India
151591,2024-01-29,203,mango yogurt,50,60,10,1,452,India
151591,2024-01-29,201,paneer,210,340,130,1,452,India
183825,2024-01-29,213,bisleri,6,15,9,1,268,India
285546,2024-01-29,207,coca cola,75,100,25,1,161,India
880641,2024-01-29,206,yakult,360,400,40,1,342,India
880641,2024-01-29,213,bisleri,6,15,9,1,342,India
880641,2024-01-29,208,sprite,75,100,25,1,342,India
505489,2024-01-29,213,bisleri,6,15,9,1,233,India
505489,2024-01-29,212,amul cheese,250,315,65,1,233,India
505489,2024-01-29,206,yakult,360,400,40,1,233,India
505489,2024-01-29,204,strawberry yogurt,50,60,10,1,233,India
237619,2024-01-29,201,paneer,210,340,130,1,266,India
237619,2024-01-29,204,strawberry yogurt,50,60,10,1,266,India
237619,2024-01-29,207,coca cola,75,100,25,1,266,India
237619,2024-01-29,211,red bull,90,125,35,1,266,India
514929,2024-01-30,209,pepsi,75,100,25,1,303,India
514929,2024-01-30,211,red bull,90,125,35,1,303,India
994702,2024-01-30,210,mountain dew,75,100,25,1,194,India
994702,2024-01-30,202,milk,12,27,15,1,194,India
994702,2024-01-30,213,bisleri,6,15,9,1,194,India
994702,2024-01-30,203,mango yogurt,50,60,10,1,194,India
675572,2024-01-30,201,paneer,210,340,130,1,175,India
675572,2024-01-30,209,pepsi,75,100,25,1,175,India
691905,2024-01-30,206,yakult,360,400,40,1,384,India
280066,2024-01-30,211,red bull,90,125,35,1,148,India
280066,2024-01-30,212,amul cheese,250,315,65,1,148,India
280066,2024-01-30,205,classic yogurt,45,60,15,1,148,India
811013,2024-01-30,212,amul cheese,250,315,65,1,93,India
811013,2024-01-30,213,bisleri,6,15,9,1,93,India
811013,2024-01-30,208,sprite,75,100,25,1,93,India
607970,2024-01-30,201,paneer,210,340,130,1,438,India
607970,2024-01-30,211,red bull,90,125,35,1,438,India
607970,2024-01-30,212,amul cheese,250,315,65,1,438,India
607970,2024-01-30,202,milk,12,27,15,1,438,India
607970,2024-01-30,203,mango yogurt,50,60,10,1,438,India
164066,2024-01-30,210,mountain dew,75,100,25,1,219,India
552944,2024-01-30,201,paneer,210,340,130,1,255,India
552944,2024-01-30,209,pepsi,75,100,25,1,255,India
552944,2024-01-30,206,yakult,360,400,40,1,255,India
552944,2024-01-30,212,amul cheese,250,315,65,1,255,India
493904,2024-01-30,213,bisleri,6,15,9,1,207,India
493904,2024-01-30,205,classic yogurt,45,60,15,1,207,India
493904,2024-01-30,203,mango yogurt,50,60,10,1,207,India
493904,2024-01-30,208,sprite,75,100,25,1,207,India
128746,2024-01-30,212,amul cheese,250,315,65,1,363,India
128746,2024-01-30,203,mango yogurt,50,60,10,1,363,India
128746,2024-01-30,209,pepsi,75,100,25,1,363,India
128746,2024-01-30,205,classic yogurt,45,60,15,1,363,India
128746,2024-01-30,211,red bull,90,125,35,1,363,India
611963,2024-01-30,208,sprite,75,100,25,1,263,India
611963,2024-01-30,207,coca cola,75,100,25,1,263,India
500781,2024-01-30,207,coca cola,75,100,25,1,180,India
500781,2024-01-30,208,sprite,75,100,25,1,180,India
939002,2024-01-30,212,amul cheese,250,315,65,1,107,India
939002,2024-01-30,206,yakult,360,400,40,1,107,India
787047,2024-01-30,213,bisleri,6,15,9,1,46,India
787047,2024-01-30,207,coca cola,75,100,25,1,46,India
787047,2024-01-30,202,milk,12,27,15,1,46,India
787047,2024-01-30,212,amul cheese,250,315,65,1,46,India
787047,2024-01-30,201,paneer,210,340,130,1,46,India
491392,2024-01-30,210,mountain dew,75,100,25,1,166,India
491392,2024-01-30,209,pepsi,75,100,25,1,166,India
491392,2024-01-30,207,coca cola,75,100,25,1,166,India
491392,2024-01-30,208,sprite,75,100,25,1,166,India
491392,2024-01-30,202,milk,12,27,15,1,166,India
184391,2024-01-30,206,yakult,360,400,40,1,480,India
459139,2024-01-30,210,mountain dew,75,100,25,1,279,India
459139,2024-01-30,209,pepsi,75,100,25,1,279,India
157469,2024-01-30,209,pepsi,75,100,25,1,27,India
529441,2024-01-30,201,paneer,210,340,130,1,28,India
529441,2024-01-30,212,amul cheese,250,315,65,1,28,India
265361,2024-01-30,209,pepsi,75,100,25,1,332,India
562229,2024-01-30,210,mountain dew,75,100,25,1,12,India
562229,2024-01-30,205,classic yogurt,45,60,15,1,12,India
562229,2024-01-30,206,yakult,360,400,40,1,12,India
562229,2024-01-30,212,amul cheese,250,315,65,1,12,India
649000,2024-01-30,201,paneer,210,340,130,1,90,India
649000,2024-01-30,209,pepsi,75,100,25,1,90,India
649000,2024-01-30,206,yakult,360,400,40,1,90,India
584542,2024-01-30,208,sprite,75,100,25,1,257,India
992801,2024-01-30,207,coca cola,75,100,25,1,376,India
234358,2024-01-30,206,yakult,360,400,40,1,394,India
234358,2024-01-30,210,mountain dew,75,100,25,1,394,India
234358,2024-01-30,201,paneer,210,340,130,1,394,India
234358,2024-01-30,209,pepsi,75,100,25,1,394,India
898737,2024-01-30,202,milk,12,27,15,1,277,India
898737,2024-01-30,203,mango yogurt,50,60,10,1,277,India
898737,2024-01-30,207,coca cola,75,100,25,1,277,India
857420,2024-01-30,205,classic yogurt,45,60,15,1,422,India
473045,2024-01-30,206,yakult,360,400,40,1,193,India
473045,2024-01-30,205,classic yogurt,45,60,15,1,193,India
473045,2024-01-30,207,coca cola,75,100,25,1,193,India
864280,2024-01-30,205,classic yogurt,45,60,15,1,496,India
864280,2024-01-30,208,sprite,75,100,25,1,496,India
317560,2024-01-30,208,sprite,75,100,25,1,248,India
346805,2024-01-30,210,mountain dew,75,100,25,1,444,India
724432,2024-01-30,203,mango yogurt,50,60,10,1,435,India
240762,2024-01-30,202,milk,12,27,15,1,212,India
240762,2024-01-30,210,mountain dew,75,100,25,1,212,India
240762,2024-01-30,204,strawberry yogurt,50,60,10,1,212,India
120170,2024-01-30,205,classic yogurt,45,60,15,1,371,India
120170,2024-01-30,207,coca cola,75,100,25,1,371,India
120170,2024-01-30,202,milk,12,27,15,1,371,India
120170,2024-01-30,206,yakult,360,400,40,1,371,India
531152,2024-01-30,208,sprite,75,100,25,1,351,India
165207,2024-01-30,207,coca cola,75,100,25,1,210,India
165207,2024-01-30,202,milk,12,27,15,1,210,India
165207,2024-01-30,201,paneer,210,340,130,1,210,India
165207,2024-01-30,204,strawberry yogurt,50,60,10,1,210,India
936366,2024-01-30,206,yakult,360,400,40,1,2,India
936366,2024-01-30,202,milk,12,27,15,1,2,India
540638,2024-01-30,210,mountain dew,75,100,25,1,71,India
540638,2024-01-30,202,milk,12,27,15,1,71,India
540638,2024-01-30,209,pepsi,75,100,25,1,71,India
540638,2024-01-30,205,classic yogurt,45,60,15,1,71,India
540638,2024-01-30,204,strawberry yogurt,50,60,10,1,71,India
493723,2024-01-30,205,classic yogurt,45,60,15,1,87,India
493723,2024-01-30,210,mountain dew,75,100,25,1,87,India
493723,2024-01-30,206,yakult,360,400,40,1,87,India
493723,2024-01-30,209,pepsi,75,100,25,1,87,India
435391,2024-01-30,206,yakult,360,400,40,1,251,India
435391,2024-01-30,209,pepsi,75,100,25,1,251,India
435391,2024-01-30,203,mango yogurt,50,60,10,1,251,India
410249,2024-01-30,206,yakult,360,400,40,1,489,India
410249,2024-01-30,213,bisleri,6,15,9,1,489,India
410249,2024-01-30,203,mango yogurt,50,60,10,1,489,India
410249,2024-01-30,210,mountain dew,75,100,25,1,489,India
694899,2024-01-30,201,paneer,210,340,130,1,433,India
694899,2024-01-30,207,coca cola,75,100,25,1,433,India
694899,2024-01-30,204,strawberry yogurt,50,60,10,1,433,India
694899,2024-01-30,209,pepsi,75,100,25,1,433,India
444249,2024-01-30,202,milk,12,27,15,1,416,India
444249,2024-01-30,208,sprite,75,100,25,1,416,India
164021,2024-01-30,207,coca cola,75,100,25,1,275,India
164021,2024-01-30,204,strawberry yogurt,50,60,10,1,275,India
164021,2024-01-30,201,paneer,210,340,130,1,275,India
164021,2024-01-30,202,milk,12,27,15,1,275,India
569412,2024-01-30,211,red bull,90,125,35,1,52,India
569412,2024-01-30,210,mountain dew,75,100,25,1,52,India
569412,2024-01-30,209,pepsi,75,100,25,1,52,India
932909,2024-01-30,213,bisleri,6,15,9,1,156,India
932909,2024-01-30,202,milk,12,27,15,1,156,India
932909,2024-01-30,207,coca cola,75,100,25,1,156,India
932909,2024-01-30,205,classic yogurt,45,60,15,1,156,India
648307,2024-01-30,206,yakult,360,400,40,1,18,India
648307,2024-01-30,205,classic yogurt,45,60,15,1,18,India
648307,2024-01-30,201,paneer,210,340,130,1,18,India
648307,2024-01-30,212,amul cheese,250,315,65,1,18,India
711642,2024-01-30,203,mango yogurt,50,60,10,1,199,India
711642,2024-01-30,208,sprite,75,100,25,1,199,India
711642,2024-01-30,205,classic yogurt,45,60,15,1,199,India
661043,2024-01-30,207,coca cola,75,100,25,1,377,India
661043,2024-01-30,201,paneer,210,340,130,1,377,India
881676,2024-01-30,201,paneer,210,340,130,1,198,India
881676,2024-01-30,213,bisleri,6,15,9,1,198,India
881676,2024-01-30,203,mango yogurt,50,60,10,1,198,India
410450,2024-01-30,209,pepsi,75,100,25,1,196,India
786498,2024-01-30,201,paneer,210,340,130,1,436,India
786498,2024-01-30,208,sprite,75,100,25,1,436,India
786498,2024-01-30,213,bisleri,6,15,9,1,436,India
774695,2024-01-30,213,bisleri,6,15,9,1,147,India
774695,2024-01-30,209,pepsi,75,100,25,1,147,India
774695,2024-01-30,212,amul cheese,250,315,65,1,147,India
774695,2024-01-30,207,coca cola,75,100,25,1,147,India
774695,2024-01-30,202,milk,12,27,15,1,147,India
923130,2024-01-30,213,bisleri,6,15,9,1,146,India
949575,2024-01-30,207,coca cola,75,100,25,1,253,India
949575,2024-01-30,211,red bull,90,125,35,1,253,India
949575,2024-01-30,205,classic yogurt,45,60,15,1,253,India
187399,2024-01-30,211,red bull,90,125,35,1,53,India
187399,2024-01-30,204,strawberry yogurt,50,60,10,1,53,India
784585,2024-01-30,202,milk,12,27,15,1,262,India
694848,2024-01-30,205,classic yogurt,45,60,15,1,140,India
694848,2024-01-30,210,mountain dew,75,100,25,1,140,India
694848,2024-01-30,213,bisleri,6,15,9,1,140,India
965445,2024-01-30,202,milk,12,27,15,1,369,India
965445,2024-01-30,205,classic yogurt,45,60,15,1,369,India
965445,2024-01-30,212,amul cheese,250,315,65,1,369,India
965445,2024-01-30,204,strawberry yogurt,50,60,10,1,369,India
722356,2024-01-30,204,strawberry yogurt,50,60,10,1,497,India
722356,2024-01-30,210,mountain dew,75,100,25,1,497,India
722356,2024-01-30,206,yakult,360,400,40,1,497,India
722356,2024-01-30,207,coca cola,75,100,25,1,497,India
218929,2024-01-30,203,mango yogurt,50,60,10,1,460,India
821351,2024-01-30,205,classic yogurt,45,60,15,1,128,India
821351,2024-01-30,208,sprite,75,100,25,1,128,India
846734,2024-01-30,202,milk,12,27,15,1,110,India
846734,2024-01-30,208,sprite,75,100,25,1,110,India
846734,2024-01-30,212,amul cheese,250,315,65,1,110,India
574561,2024-01-30,205,classic yogurt,45,60,15,1,252,India
574561,2024-01-30,207,coca cola,75,100,25,1,252,India
574561,2024-01-30,201,paneer,210,340,130,1,252,India
648313,2024-01-30,202,milk,12,27,15,1,98,India
648313,2024-01-30,213,bisleri,6,15,9,1,98,India
648313,2024-01-30,203,mango yogurt,50,60,10,1,98,India
648313,2024-01-30,212,amul cheese,250,315,65,1,98,India
955236,2024-01-30,208,sprite,75,100,25,1,269,India
955236,2024-01-30,201,paneer,210,340,130,1,269,India
955236,2024-01-30,210,mountain dew,75,100,25,1,269,India
955236,2024-01-30,212,amul cheese,250,315,65,1,269,India
793925,2024-01-30,207,coca cola,75,100,25,1,337,India
793925,2024-01-30,213,bisleri,6,15,9,1,337,India
793925,2024-01-30,211,red bull,90,125,35,1,337,India
793925,2024-01-30,208,sprite,75,100,25,1,337,India
398811,2024-01-30,203,mango yogurt,50,60,10,1,240,India
398811,2024-01-30,213,bisleri,6,15,9,1,240,India
782801,2024-01-30,201,paneer,210,340,130,1,125,India
782801,2024-01-30,210,mountain dew,75,100,25,1,125,India
800464,2024-01-30,207,coca cola,75,100,25,1,242,India
800464,2024-01-30,206,yakult,360,400,40,1,242,India
375756,2024-01-30,207,coca cola,75,100,25,1,456,India
375756,2024-01-30,203,mango yogurt,50,60,10,1,456,India
375756,2024-01-30,208,sprite,75,100,25,1,456,India
827613,2024-01-30,209,pepsi,75,100,25,1,57,India
320640,2024-01-30,206,yakult,360,400,40,1,153,India
213318,2024-01-30,201,paneer,210,340,130,1,134,India
213318,2024-01-30,213,bisleri,6,15,9,1,134,India
213318,2024-01-30,202,milk,12,27,15,1,134,India
213318,2024-01-30,204,strawberry yogurt,50,60,10,1,134,India
299768,2024-01-31,206,yakult,360,400,40,1,105,India
299768,2024-01-31,210,mountain dew,75,100,25,1,105,India
299768,2024-01-31,208,sprite,75,100,25,1,105,India
299768,2024-01-31,204,strawberry yogurt,50,60,10,1,105,India
863868,2024-01-31,212,amul cheese,250,315,65,1,275,India
863868,2024-01-31,209,pepsi,75,100,25,1,275,India
863868,2024-01-31,201,paneer,210,340,130,1,275,India
863868,2024-01-31,206,yakult,360,400,40,1,275,India
863868,2024-01-31,202,milk,12,27,15,1,275,India
896109,2024-01-31,204,strawberry yogurt,50,60,10,1,135,India
896109,2024-01-31,212,amul cheese,250,315,65,1,135,India
896109,2024-01-31,213,bisleri,6,15,9,1,135,India
755497,2024-01-31,202,milk,12,27,15,1,230,India
755497,2024-01-31,207,coca cola,75,100,25,1,230,India
755497,2024-01-31,201,paneer,210,340,130,1,230,India
719000,2024-01-31,210,mountain dew,75,100,25,1,213,India
574844,2024-01-31,204,strawberry yogurt,50,60,10,1,1,India
574844,2024-01-31,205,classic yogurt,45,60,15,1,1,India
574844,2024-01-31,201,paneer,210,340,130,1,1,India
541709,2024-01-31,205,classic yogurt,45,60,15,1,307,India
541709,2024-01-31,210,mountain dew,75,100,25,1,307,India
541709,2024-01-31,208,sprite,75,100,25,1,307,India
989919,2024-01-31,210,mountain dew,75,100,25,1,130,India
989919,2024-01-31,212,amul cheese,250,315,65,1,130,India
586903,2024-01-31,211,red bull,90,125,35,1,477,India
586903,2024-01-31,205,classic yogurt,45,60,15,1,477,India
581985,2024-01-31,206,yakult,360,400,40,1,407,India
581985,2024-01-31,209,pepsi,75,100,25,1,407,India
581985,2024-01-31,205,classic yogurt,45,60,15,1,407,India
581985,2024-01-31,201,paneer,210,340,130,1,407,India
581985,2024-01-31,212,amul cheese,250,315,65,1,407,India
163154,2024-01-31,209,pepsi,75,100,25,1,94,India
163154,2024-01-31,202,milk,12,27,15,1,94,India
119084,2024-01-31,211,red bull,90,125,35,1,115,India
119084,2024-01-31,208,sprite,75,100,25,1,115,India
119084,2024-01-31,202,milk,12,27,15,1,115,India
299217,2024-01-31,202,milk,12,27,15,1,148,India
299217,2024-01-31,207,coca cola,75,100,25,1,148,India
633434,2024-01-31,205,classic yogurt,45,60,15,1,351,India
633434,2024-01-31,209,pepsi,75,100,25,1,351,India
633434,2024-01-31,213,bisleri,6,15,9,1,351,India
633434,2024-01-31,210,mountain dew,75,100,25,1,351,India
841020,2024-01-31,211,red bull,90,125,35,1,17,India
841020,2024-01-31,213,bisleri,6,15,9,1,17,India
841020,2024-01-31,204,strawberry yogurt,50,60,10,1,17,India
583773,2024-01-31,201,paneer,210,340,130,1,126,India
583773,2024-01-31,211,red bull,90,125,35,1,126,India
583773,2024-01-31,208,sprite,75,100,25,1,126,India
475124,2024-01-31,207,coca cola,75,100,25,1,369,India
622613,2024-01-31,208,sprite,75,100,25,1,400,India
855688,2024-01-31,213,bisleri,6,15,9,1,446,India
855688,2024-01-31,208,sprite,75,100,25,1,446,India
855688,2024-01-31,201,paneer,210,340,130,1,446,India
168611,2024-01-31,207,coca cola,75,100,25,1,145,India
784573,2024-01-31,205,classic yogurt,45,60,15,1,359,India
784573,2024-01-31,212,amul cheese,250,315,65,1,359,India
784573,2024-01-31,204,strawberry yogurt,50,60,10,1,359,India
808466,2024-01-31,208,sprite,75,100,25,1,346,India
808466,2024-01-31,205,classic yogurt,45,60,15,1,346,India
808466,2024-01-31,203,mango yogurt,50,60,10,1,346,India
808466,2024-01-31,209,pepsi,75,100,25,1,346,India
603047,2024-01-31,206,yakult,360,400,40,1,348,India
603047,2024-01-31,201,paneer,210,340,130,1,348,India
383435,2024-01-31,210,mountain dew,75,100,25,1,204,India
383435,2024-01-31,204,strawberry yogurt,50,60,10,1,204,India
457675,2024-01-31,206,yakult,360,400,40,1,91,India
457675,2024-01-31,203,mango yogurt,50,60,10,1,91,India
207250,2024-01-31,202,milk,12,27,15,1,402,India
698108,2024-01-31,209,pepsi,75,100,25,1,383,India
377199,2024-01-31,203,mango yogurt,50,60,10,1,187,India
377199,2024-01-31,207,coca cola,75,100,25,1,187,India
377199,2024-01-31,206,yakult,360,400,40,1,187,India
377199,2024-01-31,213,bisleri,6,15,9,1,187,India
717149,2024-01-31,209,pepsi,75,100,25,1,396,India
717149,2024-01-31,202,milk,12,27,15,1,396,India
717149,2024-01-31,211,red bull,90,125,35,1,396,India
584392,2024-01-31,205,classic yogurt,45,60,15,1,270,India
584392,2024-01-31,202,milk,12,27,15,1,270,India
584392,2024-01-31,211,red bull,90,125,35,1,270,India
631863,2024-01-31,204,strawberry yogurt,50,60,10,1,89,India
631863,2024-01-31,213,bisleri,6,15,9,1,89,India
631863,2024-01-31,210,mountain dew,75,100,25,1,89,India
631863,2024-01-31,211,red bull,90,125,35,1,89,India
772659,2024-01-31,206,yakult,360,400,40,1,327,India
772659,2024-01-31,210,mountain dew,75,100,25,1,327,India
772659,2024-01-31,202,milk,12,27,15,1,327,India
772659,2024-01-31,207,coca cola,75,100,25,1,327,India
772659,2024-01-31,211,red bull,90,125,35,1,327,India
891065,2024-01-31,202,milk,12,27,15,1,500,India
891065,2024-01-31,211,red bull,90,125,35,1,500,India
283100,2024-01-31,204,strawberry yogurt,50,60,10,1,207,India
283100,2024-01-31,208,sprite,75,100,25,1,207,India
280711,2024-01-31,205,classic yogurt,45,60,15,1,242,India
280711,2024-01-31,212,amul cheese,250,315,65,1,242,India
280711,2024-01-31,206,yakult,360,400,40,1,242,India
645491,2024-01-31,206,yakult,360,400,40,1,240,India
645491,2024-01-31,212,amul cheese,250,315,65,1,240,India
758596,2024-01-31,211,red bull,90,125,35,1,369,India
922929,2024-01-31,204,strawberry yogurt,50,60,10,1,233,India
922929,2024-01-31,211,red bull,90,125,35,1,233,India
922929,2024-01-31,206,yakult,360,400,40,1,233,India
962882,2024-01-31,213,bisleri,6,15,9,1,50,India
930113,2024-01-31,208,sprite,75,100,25,1,263,India
930113,2024-01-31,210,mountain dew,75,100,25,1,263,India
783057,2024-01-31,206,yakult,360,400,40,1,156,India
593644,2024-01-31,211,red bull,90,125,35,1,94,India
593644,2024-01-31,209,pepsi,75,100,25,1,94,India
593644,2024-01-31,208,sprite,75,100,25,1,94,India
103972,2024-01-31,203,mango yogurt,50,60,10,1,298,India
103972,2024-01-31,212,amul cheese,250,315,65,1,298,India
103972,2024-01-31,206,yakult,360,400,40,1,298,India
103972,2024-01-31,208,sprite,75,100,25,1,298,India
994034,2024-01-31,212,amul cheese,250,315,65,1,338,India
994034,2024-01-31,213,bisleri,6,15,9,1,338,India
994034,2024-01-31,210,mountain dew,75,100,25,1,338,India
994034,2024-01-31,204,strawberry yogurt,50,60,10,1,338,India
613309,2024-01-31,211,red bull,90,125,35,1,224,India
613309,2024-01-31,207,coca cola,75,100,25,1,224,India
441737,2024-01-31,204,strawberry yogurt,50,60,10,1,341,India
441737,2024-01-31,206,yakult,360,400,40,1,341,India
330557,2024-01-31,206,yakult,360,400,40,1,25,India
330557,2024-01-31,207,coca cola,75,100,25,1,25,India
330557,2024-01-31,202,milk,12,27,15,1,25,India
840697,2024-01-31,211,red bull,90,125,35,1,260,India
840697,2024-01-31,208,sprite,75,100,25,1,260,India
840697,2024-01-31,206,yakult,360,400,40,1,260,India
582966,2024-01-31,204,strawberry yogurt,50,60,10,1,473,India
582966,2024-01-31,201,paneer,210,340,130,1,473,India
582966,2024-01-31,210,mountain dew,75,100,25,1,473,India
582966,2024-01-31,205,classic yogurt,45,60,15,1,473,India
890194,2024-01-31,205,classic yogurt,45,60,15,1,82,India
890194,2024-01-31,202,milk,12,27,15,1,82,India
890194,2024-01-31,211,red bull,90,125,35,1,82,India
890194,2024-01-31,210,mountain dew,75,100,25,1,82,India
343528,2024-02-01,201,paneer,210,340,130,1,259,India
343528,2024-02-01,203,mango yogurt,50,60,10,1,259,India
343528,2024-02-01,211,red bull,90,125,35,1,259,India
945497,2024-02-01,203,mango yogurt,50,60,10,1,147,India
945497,2024-02-01,207,coca cola,75,100,25,1,147,India
751709,2024-02-01,210,mountain dew,75,100,25,1,124,India
321453,2024-02-01,208,sprite,75,100,25,1,329,India
321453,2024-02-01,202,milk,12,27,15,1,329,India
964597,2024-02-01,211,red bull,90,125,35,1,180,India
964597,2024-02-01,203,mango yogurt,50,60,10,1,180,India
739043,2024-02-01,205,classic yogurt,45,60,15,1,5,India
739043,2024-02-01,201,paneer,210,340,130,1,5,India
739043,2024-02-01,207,coca cola,75,100,25,1,5,India
558429,2024-02-01,201,paneer,210,340,130,1,135,India
558429,2024-02-01,212,amul cheese,250,315,65,1,135,India
558429,2024-02-01,213,bisleri,6,15,9,1,135,India
167133,2024-02-01,210,mountain dew,75,100,25,1,480,India
167133,2024-02-01,212,amul cheese,250,315,65,1,480,India
167133,2024-02-01,211,red bull,90,125,35,1,480,India
167133,2024-02-01,213,bisleri,6,15,9,1,480,India
167133,2024-02-01,207,coca cola,75,100,25,1,480,India
851042,2024-02-01,204,strawberry yogurt,50,60,10,1,350,India
371183,2024-02-01,213,bisleri,6,15,9,1,274,India
371183,2024-02-01,209,pepsi,75,100,25,1,274,India
340393,2024-02-01,212,amul cheese,250,315,65,1,472,India
340393,2024-02-01,207,coca cola,75,100,25,1,472,India
461641,2024-02-01,207,coca cola,75,100,25,1,434,India
611872,2024-02-01,208,sprite,75,100,25,1,10,India
611872,2024-02-01,210,mountain dew,75,100,25,1,10,India
611872,2024-02-01,209,pepsi,75,100,25,1,10,India
403883,2024-02-01,207,coca cola,75,100,25,1,444,India
334498,2024-02-01,206,yakult,360,400,40,1,92,India
334498,2024-02-01,213,bisleri,6,15,9,1,92,India
809272,2024-02-01,213,bisleri,6,15,9,1,360,India
809272,2024-02-01,202,milk,12,27,15,1,360,India
836755,2024-02-01,205,classic yogurt,45,60,15,1,493,India
836755,2024-02-01,210,mountain dew,75,100,25,1,493,India
836755,2024-02-01,201,paneer,210,340,130,1,493,India
836755,2024-02-01,202,milk,12,27,15,1,493,India
743236,2024-02-01,213,bisleri,6,15,9,1,425,India
743236,2024-02-01,208,sprite,75,100,25,1,425,India
743236,2024-02-01,212,amul cheese,250,315,65,1,425,India
743236,2024-02-01,209,pepsi,75,100,25,1,425,India
354324,2024-02-01,213,bisleri,6,15,9,1,185,India
354324,2024-02-01,209,pepsi,75,100,25,1,185,India
354324,2024-02-01,201,paneer,210,340,130,1,185,India
354324,2024-02-01,208,sprite,75,100,25,1,185,India
354324,2024-02-01,207,coca cola,75,100,25,1,185,India
401640,2024-02-01,213,bisleri,6,15,9,1,16,India
401640,2024-02-01,202,milk,12,27,15,1,16,India
789253,2024-02-01,206,yakult,360,400,40,1,202,India
789253,2024-02-01,201,paneer,210,340,130,1,202,India
789253,2024-02-01,213,bisleri,6,15,9,1,202,India
789253,2024-02-01,207,coca cola,75,100,25,1,202,India
917120,2024-02-01,202,milk,12,27,15,1,429,India
446165,2024-02-01,202,milk,12,27,15,1,17,India
446165,2024-02-01,209,pepsi,75,100,25,1,17,India
446165,2024-02-01,213,bisleri,6,15,9,1,17,India
446165,2024-02-01,204,strawberry yogurt,50,60,10,1,17,India
446165,2024-02-01,212,amul cheese,250,315,65,1,17,India
440771,2024-02-01,209,pepsi,75,100,25,1,387,India
440771,2024-02-01,201,paneer,210,340,130,1,387,India
440771,2024-02-01,205,classic yogurt,45,60,15,1,387,India
440771,2024-02-01,202,milk,12,27,15,1,387,India
449182,2024-02-01,208,sprite,75,100,25,1,296,India
449182,2024-02-01,213,bisleri,6,15,9,1,296,India
449182,2024-02-01,210,mountain dew,75,100,25,1,296,India
782764,2024-02-01,207,coca cola,75,100,25,1,469,India
782764,2024-02-01,212,amul cheese,250,315,65,1,469,India
782764,2024-02-01,204,strawberry yogurt,50,60,10,1,469,India
782764,2024-02-01,202,milk,12,27,15,1,469,India
782764,2024-02-01,211,red bull,90,125,35,1,469,India
503468,2024-02-01,201,paneer,210,340,130,1,478,India
444649,2024-02-01,212,amul cheese,250,315,65,1,13,India
444649,2024-02-01,205,classic yogurt,45,60,15,1,13,India
444649,2024-02-01,211,red bull,90,125,35,1,13,India
444649,2024-02-01,204,strawberry yogurt,50,60,10,1,13,India
203390,2024-02-01,202,milk,12,27,15,1,412,India
203390,2024-02-01,203,mango yogurt,50,60,10,1,412,India
736349,2024-02-01,202,milk,12,27,15,1,450,India
736349,2024-02-01,209,pepsi,75,100,25,1,450,India
736349,2024-02-01,213,bisleri,6,15,9,1,450,India
736349,2024-02-01,203,mango yogurt,50,60,10,1,450,India
736349,2024-02-01,211,red bull,90,125,35,1,450,India
816723,2024-02-01,201,paneer,210,340,130,1,267,India
816723,2024-02-01,212,amul cheese,250,315,65,1,267,India
816723,2024-02-01,203,mango yogurt,50,60,10,1,267,India
236748,2024-02-01,204,strawberry yogurt,50,60,10,1,47,India
236748,2024-02-01,212,amul cheese,250,315,65,1,47,India
132155,2024-02-01,210,mountain dew,75,100,25,1,467,India
132155,2024-02-01,207,coca cola,75,100,25,1,467,India
132155,2024-02-01,213,bisleri,6,15,9,1,467,India
928193,2024-02-01,205,classic yogurt,45,60,15,1,232,India
928193,2024-02-01,203,mango yogurt,50,60,10,1,232,India
928193,2024-02-01,208,sprite,75,100,25,1,232,India
674404,2024-02-01,205,classic yogurt,45,60,15,1,276,India
351091,2024-02-01,209,pepsi,75,100,25,1,141,India
351091,2024-02-01,208,sprite,75,100,25,1,141,India
351091,2024-02-01,201,paneer,210,340,130,1,141,India
351091,2024-02-01,205,classic yogurt,45,60,15,1,141,India
351091,2024-02-01,212,amul cheese,250,315,65,1,141,India
167036,2024-02-01,204,strawberry yogurt,50,60,10,1,428,India
167036,2024-02-01,210,mountain dew,75,100,25,1,428,India
167036,2024-02-01,206,yakult,360,400,40,1,428,India
328444,2024-02-01,207,coca cola,75,100,25,1,203,India
328444,2024-02-01,206,yakult,360,400,40,1,203,India
328444,2024-02-01,208,sprite,75,100,25,1,203,India
328444,2024-02-01,210,mountain dew,75,100,25,1,203,India
369914,2024-02-01,210,mountain dew,75,100,25,1,304,India
369914,2024-02-01,208,sprite,75,100,25,1,304,India
369914,2024-02-01,204,strawberry yogurt,50,60,10,1,304,India
369914,2024-02-01,213,bisleri,6,15,9,1,304,India
374432,2024-02-01,203,mango yogurt,50,60,10,1,245,India
374432,2024-02-01,210,mountain dew,75,100,25,1,245,India
409531,2024-02-01,210,mountain dew,75,100,25,1,153,India
409531,2024-02-01,204,strawberry yogurt,50,60,10,1,153,India
409531,2024-02-01,202,milk,12,27,15,1,153,India
848413,2024-02-01,202,milk,12,27,15,1,154,India
977861,2024-02-01,207,coca cola,75,100,25,1,19,India
977861,2024-02-01,213,bisleri,6,15,9,1,19,India
575184,2024-02-01,212,amul cheese,250,315,65,1,331,India
575184,2024-02-01,204,strawberry yogurt,50,60,10,1,331,India
982524,2024-02-01,206,yakult,360,400,40,1,367,India
982524,2024-02-01,205,classic yogurt,45,60,15,1,367,India
982524,2024-02-01,213,bisleri,6,15,9,1,367,India
963188,2024-02-01,206,yakult,360,400,40,1,332,India
963188,2024-02-01,202,milk,12,27,15,1,332,India
963188,2024-02-01,210,mountain dew,75,100,25,1,332,India
963188,2024-02-01,207,coca cola,75,100,25,1,332,India
963188,2024-02-01,208,sprite,75,100,25,1,332,India
852374,2024-02-01,203,mango yogurt,50,60,10,1,477,India
852374,2024-02-01,211,red bull,90,125,35,1,477,India
852374,2024-02-01,213,bisleri,6,15,9,1,477,India
895100,2024-02-01,213,bisleri,6,15,9,1,272,India
895100,2024-02-01,204,strawberry yogurt,50,60,10,1,272,India
611671,2024-02-01,205,classic yogurt,45,60,15,1,303,India
611671,2024-02-01,201,paneer,210,340,130,1,303,India
611671,2024-02-01,208,sprite,75,100,25,1,303,India
611671,2024-02-01,211,red bull,90,125,35,1,303,India
891864,2024-02-01,207,coca cola,75,100,25,1,361,India
638508,2024-02-01,205,classic yogurt,45,60,15,1,483,India
638508,2024-02-01,212,amul cheese,250,315,65,1,483,India
638508,2024-02-01,203,mango yogurt,50,60,10,1,483,India
638508,2024-02-01,202,milk,12,27,15,1,483,India
638508,2024-02-01,209,pepsi,75,100,25,1,483,India
740323,2024-02-01,201,paneer,210,340,130,1,181,India
370258,2024-02-01,213,bisleri,6,15,9,1,16,India
370258,2024-02-01,202,milk,12,27,15,1,16,India
370258,2024-02-01,212,amul cheese,250,315,65,1,16,India
699328,2024-02-01,208,sprite,75,100,25,1,415,India
699328,2024-02-01,212,amul cheese,250,315,65,1,415,India
699328,2024-02-01,211,red bull,90,125,35,1,415,India
699328,2024-02-01,201,paneer,210,340,130,1,415,India
960046,2024-02-01,206,yakult,360,400,40,1,268,India
960046,2024-02-01,205,classic yogurt,45,60,15,1,268,India
357726,2024-02-01,206,yakult,360,400,40,1,91,India
863711,2024-02-01,203,mango yogurt,50,60,10,1,363,India
863711,2024-02-01,201,paneer,210,340,130,1,363,India
347231,2024-02-01,213,bisleri,6,15,9,1,114,India
347231,2024-02-01,212,amul cheese,250,315,65,1,114,India
347231,2024-02-01,211,red bull,90,125,35,1,114,India
347231,2024-02-01,210,mountain dew,75,100,25,1,114,India
553350,2024-02-01,213,bisleri,6,15,9,1,288,India
553350,2024-02-01,207,coca cola,75,100,25,1,288,India
553350,2024-02-01,208,sprite,75,100,25,1,288,India
553350,2024-02-01,210,mountain dew,75,100,25,1,288,India
553350,2024-02-01,206,yakult,360,400,40,1,288,India
751224,2024-02-01,211,red bull,90,125,35,1,333,India
751224,2024-02-01,210,mountain dew,75,100,25,1,333,India
751224,2024-02-01,207,coca cola,75,100,25,1,333,India
461786,2024-02-01,206,yakult,360,400,40,1,402,India
388311,2024-02-01,205,classic yogurt,45,60,15,1,46,India
388311,2024-02-01,213,bisleri,6,15,9,1,46,India
149246,2024-02-01,208,sprite,75,100,25,1,219,India
195265,2024-02-01,209,pepsi,75,100,25,1,15,India
195265,2024-02-01,208,sprite,75,100,25,1,15,India
195265,2024-02-01,213,bisleri,6,15,9,1,15,India
195265,2024-02-01,202,milk,12,27,15,1,15,India
181408,2024-02-01,209,pepsi,75,100,25,1,165,India
181408,2024-02-01,210,mountain dew,75,100,25,1,165,India
181408,2024-02-01,203,mango yogurt,50,60,10,1,165,India
829715,2024-02-01,203,mango yogurt,50,60,10,1,89,India
829715,2024-02-01,210,mountain dew,75,100,25,1,89,India
558100,2024-02-01,213,bisleri,6,15,9,1,477,India
558100,2024-02-01,210,mountain dew,75,100,25,1,477,India
558100,2024-02-01,203,mango yogurt,50,60,10,1,477,India
558100,2024-02-01,211,red bull,90,125,35,1,477,India
265382,2024-02-01,211,red bull,90,125,35,1,380,India
265382,2024-02-01,204,strawberry yogurt,50,60,10,1,380,India
265382,2024-02-01,212,amul cheese,250,315,65,1,380,India
633323,2024-02-01,213,bisleri,6,15,9,1,35,India
633323,2024-02-01,210,mountain dew,75,100,25,1,35,India
633323,2024-02-01,204,strawberry yogurt,50,60,10,1,35,India
925109,2024-02-01,205,classic yogurt,45,60,15,1,74,India
314792,2024-02-02,209,pepsi,75,100,25,1,465,India
314792,2024-02-02,207,coca cola,75,100,25,1,465,India
314792,2024-02-02,211,red bull,90,125,35,1,465,India
314792,2024-02-02,202,milk,12,27,15,1,465,India
364642,2024-02-02,207,coca cola,75,100,25,1,168,India
778521,2024-02-02,209,pepsi,75,100,25,1,492,India
778521,2024-02-02,213,bisleri,6,15,9,1,492,India
138452,2024-02-02,211,red bull,90,125,35,1,99,India
138452,2024-02-02,207,coca cola,75,100,25,1,99,India
666020,2024-02-02,213,bisleri,6,15,9,1,147,India
666020,2024-02-02,209,pepsi,75,100,25,1,147,India
666020,2024-02-02,212,amul cheese,250,315,65,1,147,India
666020,2024-02-02,211,red bull,90,125,35,1,147,India
411259,2024-02-02,205,classic yogurt,45,60,15,1,2,India
461415,2024-02-02,208,sprite,75,100,25,1,94,India
461415,2024-02-02,202,milk,12,27,15,1,94,India
461415,2024-02-02,207,coca cola,75,100,25,1,94,India
461415,2024-02-02,206,yakult,360,400,40,1,94,India
461415,2024-02-02,201,paneer,210,340,130,1,94,India
246527,2024-02-02,208,sprite,75,100,25,1,434,India
246527,2024-02-02,206,yakult,360,400,40,1,434,India
246527,2024-02-02,210,mountain dew,75,100,25,1,434,India
246527,2024-02-02,202,milk,12,27,15,1,434,India
235005,2024-02-02,213,bisleri,6,15,9,1,5,India
235005,2024-02-02,204,strawberry yogurt,50,60,10,1,5,India
235005,2024-02-02,209,pepsi,75,100,25,1,5,India
263403,2024-02-02,205,classic yogurt,45,60,15,1,65,India
857379,2024-02-02,211,red bull,90,125,35,1,204,India
857379,2024-02-02,204,strawberry yogurt,50,60,10,1,204,India
857379,2024-02-02,201,paneer,210,340,130,1,204,India
857379,2024-02-02,209,pepsi,75,100,25,1,204,India
857379,2024-02-02,210,mountain dew,75,100,25,1,204,India
390363,2024-02-02,203,mango yogurt,50,60,10,1,352,India
390363,2024-02-02,202,milk,12,27,15,1,352,India
390363,2024-02-02,205,classic yogurt,45,60,15,1,352,India
390363,2024-02-02,209,pepsi,75,100,25,1,352,India
296356,2024-02-02,208,sprite,75,100,25,1,127,India
296356,2024-02-02,213,bisleri,6,15,9,1,127,India
665414,2024-02-02,204,strawberry yogurt,50,60,10,1,71,India
665414,2024-02-02,201,paneer,210,340,130,1,71,India
665414,2024-02-02,212,amul cheese,250,315,65,1,71,India
665414,2024-02-02,203,mango yogurt,50,60,10,1,71,India
928236,2024-02-02,210,mountain dew,75,100,25,1,206,India
928236,2024-02-02,204,strawberry yogurt,50,60,10,1,206,India
603343,2024-02-02,210,mountain dew,75,100,25,1,247,India
603343,2024-02-02,212,amul cheese,250,315,65,1,247,India
603343,2024-02-02,209,pepsi,75,100,25,1,247,India
603343,2024-02-02,202,milk,12,27,15,1,247,India
715695,2024-02-02,213,bisleri,6,15,9,1,153,India
617585,2024-02-02,207,coca cola,75,100,25,1,445,India
617585,2024-02-02,202,milk,12,27,15,1,445,India
617585,2024-02-02,211,red bull,90,125,35,1,445,India
617585,2024-02-02,212,amul cheese,250,315,65,1,445,India
617585,2024-02-02,210,mountain dew,75,100,25,1,445,India
229425,2024-02-02,211,red bull,90,125,35,1,10,India
256043,2024-02-02,205,classic yogurt,45,60,15,1,155,India
256043,2024-02-02,209,pepsi,75,100,25,1,155,India
256043,2024-02-02,204,strawberry yogurt,50,60,10,1,155,India
256043,2024-02-02,211,red bull,90,125,35,1,155,India
558078,2024-02-02,202,milk,12,27,15,1,392,India
558078,2024-02-02,204,strawberry yogurt,50,60,10,1,392,India
558078,2024-02-02,201,paneer,210,340,130,1,392,India
558078,2024-02-02,211,red bull,90,125,35,1,392,India
160071,2024-02-02,202,milk,12,27,15,1,35,India
160071,2024-02-02,205,classic yogurt,45,60,15,1,35,India
534605,2024-02-02,201,paneer,210,340,130,1,202,India
301485,2024-02-02,213,bisleri,6,15,9,1,244,India
301485,2024-02-02,210,mountain dew,75,100,25,1,244,India
301485,2024-02-02,204,strawberry yogurt,50,60,10,1,244,India
301485,2024-02-02,211,red bull,90,125,35,1,244,India
128249,2024-02-02,208,sprite,75,100,25,1,166,India
403692,2024-02-02,206,yakult,360,400,40,1,422,India
403692,2024-02-02,212,amul cheese,250,315,65,1,422,India
403692,2024-02-02,207,coca cola,75,100,25,1,422,India
403692,2024-02-02,202,milk,12,27,15,1,422,India
403692,2024-02-02,210,mountain dew,75,100,25,1,422,India
834347,2024-02-02,205,classic yogurt,45,60,15,1,325,India
283781,2024-02-02,202,milk,12,27,15,1,46,India
283781,2024-02-02,203,mango yogurt,50,60,10,1,46,India
283781,2024-02-02,207,coca cola,75,100,25,1,46,India
153540,2024-02-02,212,amul cheese,250,315,65,1,199,India
153540,2024-02-02,211,red bull,90,125,35,1,199,India
153540,2024-02-02,206,yakult,360,400,40,1,199,India
153540,2024-02-02,202,milk,12,27,15,1,199,India
721397,2024-02-02,201,paneer,210,340,130,1,22,India
721397,2024-02-02,209,pepsi,75,100,25,1,22,India
721397,2024-02-02,202,milk,12,27,15,1,22,India
721397,2024-02-02,210,mountain dew,75,100,25,1,22,India
927047,2024-02-02,211,red bull,90,125,35,1,61,India
927047,2024-02-02,202,milk,12,27,15,1,61,India
960376,2024-02-02,211,red bull,90,125,35,1,301,India
210784,2024-02-02,210,mountain dew,75,100,25,1,196,India
210784,2024-02-02,211,red bull,90,125,35,1,196,India
500440,2024-02-02,202,milk,12,27,15,1,127,India
500440,2024-02-02,207,coca cola,75,100,25,1,127,India
500440,2024-02-02,209,pepsi,75,100,25,1,127,India
500440,2024-02-02,211,red bull,90,125,35,1,127,India
174618,2024-02-02,213,bisleri,6,15,9,1,416,India
174618,2024-02-02,204,strawberry yogurt,50,60,10,1,416,India
174618,2024-02-02,207,coca cola,75,100,25,1,416,India
174618,2024-02-02,211,red bull,90,125,35,1,416,India
136417,2024-02-02,212,amul cheese,250,315,65,1,343,India
136417,2024-02-02,210,mountain dew,75,100,25,1,343,India
136417,2024-02-02,204,strawberry yogurt,50,60,10,1,343,India
136417,2024-02-02,211,red bull,90,125,35,1,343,India
136417,2024-02-02,208,sprite,75,100,25,1,343,India
673144,2024-02-02,208,sprite,75,100,25,1,341,India
673144,2024-02-02,211,red bull,90,125,35,1,341,India
673144,2024-02-02,212,amul cheese,250,315,65,1,341,India
673144,2024-02-02,213,bisleri,6,15,9,1,341,India
433363,2024-02-02,205,classic yogurt,45,60,15,1,247,India
433363,2024-02-02,212,amul cheese,250,315,65,1,247,India
433363,2024-02-02,204,strawberry yogurt,50,60,10,1,247,India
401041,2024-02-02,213,bisleri,6,15,9,1,489,India
401041,2024-02-02,206,yakult,360,400,40,1,489,India
401041,2024-02-02,205,classic yogurt,45,60,15,1,489,India
428620,2024-02-02,211,red bull,90,125,35,1,194,India
428620,2024-02-02,206,yakult,360,400,40,1,194,India
428620,2024-02-02,213,bisleri,6,15,9,1,194,India
449703,2024-02-02,208,sprite,75,100,25,1,402,India
449703,2024-02-02,213,bisleri,6,15,9,1,402,India
449703,2024-02-02,204,strawberry yogurt,50,60,10,1,402,India
609561,2024-02-02,213,bisleri,6,15,9,1,375,India
609561,2024-02-02,206,yakult,360,400,40,1,375,India
745721,2024-02-02,203,mango yogurt,50,60,10,1,400,India
745721,2024-02-02,201,paneer,210,340,130,1,400,India
745721,2024-02-02,212,amul cheese,250,315,65,1,400,India
745721,2024-02-02,213,bisleri,6,15,9,1,400,India
416617,2024-02-02,202,milk,12,27,15,1,2,India
416617,2024-02-02,206,yakult,360,400,40,1,2,India
416617,2024-02-02,205,classic yogurt,45,60,15,1,2,India
416617,2024-02-02,211,red bull,90,125,35,1,2,India
195204,2024-02-02,208,sprite,75,100,25,1,186,India
195204,2024-02-02,205,classic yogurt,45,60,15,1,186,India
195204,2024-02-02,213,bisleri,6,15,9,1,186,India
195204,2024-02-02,203,mango yogurt,50,60,10,1,186,India
404580,2024-02-02,212,amul cheese,250,315,65,1,494,India
404580,2024-02-02,207,coca cola,75,100,25,1,494,India
404580,2024-02-02,205,classic yogurt,45,60,15,1,494,India
404580,2024-02-02,210,mountain dew,75,100,25,1,494,India
404580,2024-02-02,204,strawberry yogurt,50,60,10,1,494,India
606384,2024-02-02,209,pepsi,75,100,25,1,463,India
373943,2024-02-02,203,mango yogurt,50,60,10,1,317,India
373943,2024-02-02,210,mountain dew,75,100,25,1,317,India
373943,2024-02-02,206,yakult,360,400,40,1,317,India
950440,2024-02-02,204,strawberry yogurt,50,60,10,1,364,India
927327,2024-02-02,210,mountain dew,75,100,25,1,304,India
607927,2024-02-02,208,sprite,75,100,25,1,110,India
607927,2024-02-02,213,bisleri,6,15,9,1,110,India
607927,2024-02-02,207,coca cola,75,100,25,1,110,India
607927,2024-02-02,205,classic yogurt,45,60,15,1,110,India
466177,2024-02-02,212,amul cheese,250,315,65,1,287,India
466177,2024-02-02,205,classic yogurt,45,60,15,1,287,India
466177,2024-02-02,204,strawberry yogurt,50,60,10,1,287,India
466177,2024-02-02,210,mountain dew,75,100,25,1,287,India
466177,2024-02-02,208,sprite,75,100,25,1,287,India
266338,2024-02-02,210,mountain dew,75,100,25,1,228,India
266338,2024-02-02,206,yakult,360,400,40,1,228,India
266338,2024-02-02,204,strawberry yogurt,50,60,10,1,228,India
266338,2024-02-02,203,mango yogurt,50,60,10,1,228,India
266338,2024-02-02,202,milk,12,27,15,1,228,India
183816,2024-02-02,212,amul cheese,250,315,65,1,208,India
963588,2024-02-02,201,paneer,210,340,130,1,494,India
274557,2024-02-02,205,classic yogurt,45,60,15,1,294,India
274557,2024-02-02,211,red bull,90,125,35,1,294,India
751863,2024-02-02,212,amul cheese,250,315,65,1,465,India
751863,2024-02-02,211,red bull,90,125,35,1,465,India
751863,2024-02-02,202,milk,12,27,15,1,465,India
751863,2024-02-02,209,pepsi,75,100,25,1,465,India
751863,2024-02-02,210,mountain dew,75,100,25,1,465,India
467670,2024-02-02,211,red bull,90,125,35,1,208,India
467670,2024-02-02,210,mountain dew,75,100,25,1,208,India
467670,2024-02-02,207,coca cola,75,100,25,1,208,India
467670,2024-02-02,205,classic yogurt,45,60,15,1,208,India
467670,2024-02-02,201,paneer,210,340,130,1,208,India
288464,2024-02-02,213,bisleri,6,15,9,1,142,India
288464,2024-02-02,212,amul cheese,250,315,65,1,142,India
288464,2024-02-02,204,strawberry yogurt,50,60,10,1,142,India
232014,2024-02-02,211,red bull,90,125,35,1,331,India
232014,2024-02-02,201,paneer,210,340,130,1,331,India
369391,2024-02-02,213,bisleri,6,15,9,1,343,India
369391,2024-02-02,210,mountain dew,75,100,25,1,343,India
369391,2024-02-02,207,coca cola,75,100,25,1,343,India
518907,2024-02-02,204,strawberry yogurt,50,60,10,1,56,India
518907,2024-02-02,203,mango yogurt,50,60,10,1,56,India
518907,2024-02-02,205,classic yogurt,45,60,15,1,56,India
951828,2024-02-02,207,coca cola,75,100,25,1,455,India
951828,2024-02-02,203,mango yogurt,50,60,10,1,455,India
792637,2024-02-02,203,mango yogurt,50,60,10,1,392,India
792637,2024-02-02,213,bisleri,6,15,9,1,392,India
792637,2024-02-02,207,coca cola,75,100,25,1,392,India
792637,2024-02-02,201,paneer,210,340,130,1,392,India
599845,2024-02-02,207,coca cola,75,100,25,1,10,India
599845,2024-02-02,202,milk,12,27,15,1,10,India
599845,2024-02-02,201,paneer,210,340,130,1,10,India
599845,2024-02-02,213,bisleri,6,15,9,1,10,India
279789,2024-02-02,201,paneer,210,340,130,1,21,India
279789,2024-02-02,213,bisleri,6,15,9,1,21,India
279789,2024-02-02,211,red bull,90,125,35,1,21,India
279504,2024-02-02,206,yakult,360,400,40,1,295,India
279504,2024-02-02,205,classic yogurt,45,60,15,1,295,India
279504,2024-02-02,204,strawberry yogurt,50,60,10,1,295,India
874833,2024-02-02,205,classic yogurt,45,60,15,1,371,India
810678,2024-02-02,203,mango yogurt,50,60,10,1,95,India
810678,2024-02-02,204,strawberry yogurt,50,60,10,1,95,India
810678,2024-02-02,206,yakult,360,400,40,1,95,India
810678,2024-02-02,207,coca cola,75,100,25,1,95,India
431522,2024-02-02,213,bisleri,6,15,9,1,500,India
526108,2024-02-02,202,milk,12,27,15,1,87,India
526108,2024-02-02,211,red bull,90,125,35,1,87,India
526108,2024-02-02,201,paneer,210,340,130,1,87,India
403988,2024-02-02,203,mango yogurt,50,60,10,1,157,India
751755,2024-02-02,206,yakult,360,400,40,1,498,India
751755,2024-02-02,209,pepsi,75,100,25,1,498,India
751755,2024-02-02,211,red bull,90,125,35,1,498,India
388033,2024-02-02,212,amul cheese,250,315,65,1,156,India
388033,2024-02-02,203,mango yogurt,50,60,10,1,156,India
846804,2024-02-02,201,paneer,210,340,130,1,231,India
846804,2024-02-02,202,milk,12,27,15,1,231,India
846804,2024-02-02,204,strawberry yogurt,50,60,10,1,231,India
280049,2024-02-02,202,milk,12,27,15,1,385,India
315236,2024-02-02,206,yakult,360,400,40,1,141,India
315236,2024-02-02,213,bisleri,6,15,9,1,141,India
315236,2024-02-02,201,paneer,210,340,130,1,141,India
315236,2024-02-02,203,mango yogurt,50,60,10,1,141,India
781752,2024-02-02,207,coca cola,75,100,25,1,100,India
684971,2024-02-02,208,sprite,75,100,25,1,206,India
684971,2024-02-02,203,mango yogurt,50,60,10,1,206,India
901625,2024-02-02,201,paneer,210,340,130,1,477,India
977604,2024-02-02,213,bisleri,6,15,9,1,409,India
411582,2024-02-02,208,sprite,75,100,25,1,349,India
411582,2024-02-02,205,classic yogurt,45,60,15,1,349,India
411582,2024-02-02,206,yakult,360,400,40,1,349,India
118291,2024-02-02,210,mountain dew,75,100,25,1,22,India
118291,2024-02-02,204,strawberry yogurt,50,60,10,1,22,India
913956,2024-02-02,213,bisleri,6,15,9,1,32,India
913956,2024-02-02,209,pepsi,75,100,25,1,32,India
165691,2024-02-02,212,amul cheese,250,315,65,1,43,India
165691,2024-02-02,208,sprite,75,100,25,1,43,India
165691,2024-02-02,201,paneer,210,340,130,1,43,India
909612,2024-02-03,213,bisleri,6,15,9,1,387,India
909612,2024-02-03,208,sprite,75,100,25,1,387,India
909612,2024-02-03,211,red bull,90,125,35,1,387,India
909612,2024-02-03,207,coca cola,75,100,25,1,387,India
909612,2024-02-03,202,milk,12,27,15,1,387,India
842943,2024-02-03,201,paneer,210,340,130,1,366,India
883528,2024-02-03,201,paneer,210,340,130,1,435,India
883528,2024-02-03,209,pepsi,75,100,25,1,435,India
883528,2024-02-03,212,amul cheese,250,315,65,1,435,India
883528,2024-02-03,213,bisleri,6,15,9,1,435,India
883528,2024-02-03,211,red bull,90,125,35,1,435,India
501231,2024-02-03,212,amul cheese,250,315,65,1,211,India
501231,2024-02-03,211,red bull,90,125,35,1,211,India
489761,2024-02-03,206,yakult,360,400,40,1,244,India
465281,2024-02-03,202,milk,12,27,15,1,286,India
465281,2024-02-03,201,paneer,210,340,130,1,286,India
719324,2024-02-03,207,coca cola,75,100,25,1,468,India
719324,2024-02-03,204,strawberry yogurt,50,60,10,1,468,India
719324,2024-02-03,206,yakult,360,400,40,1,468,India
719324,2024-02-03,210,mountain dew,75,100,25,1,468,India
719324,2024-02-03,201,paneer,210,340,130,1,468,India
352726,2024-02-03,202,milk,12,27,15,1,487,India
922666,2024-02-03,207,coca cola,75,100,25,1,255,India
458832,2024-02-03,210,mountain dew,75,100,25,1,463,India
458832,2024-02-03,202,milk,12,27,15,1,463,India
458832,2024-02-03,205,classic yogurt,45,60,15,1,463,India
197919,2024-02-03,203,mango yogurt,50,60,10,1,186,India
820799,2024-02-03,208,sprite,75,100,25,1,11,India
820799,2024-02-03,209,pepsi,75,100,25,1,11,India
820799,2024-02-03,205,classic yogurt,45,60,15,1,11,India
480400,2024-02-03,203,mango yogurt,50,60,10,1,369,India
480400,2024-02-03,204,strawberry yogurt,50,60,10,1,369,India
480400,2024-02-03,212,amul cheese,250,315,65,1,369,India
891554,2024-02-03,210,mountain dew,75,100,25,1,276,India
891554,2024-02-03,209,pepsi,75,100,25,1,276,India
891554,2024-02-03,211,red bull,90,125,35,1,276,India
891554,2024-02-03,206,yakult,360,400,40,1,276,India
702601,2024-02-03,207,coca cola,75,100,25,1,334,India
702601,2024-02-03,211,red bull,90,125,35,1,334,India
702601,2024-02-03,212,amul cheese,250,315,65,1,334,India
702601,2024-02-03,206,yakult,360,400,40,1,334,India
926191,2024-02-03,206,yakult,360,400,40,1,379,India
857220,2024-02-03,209,pepsi,75,100,25,1,211,India
449124,2024-02-03,203,mango yogurt,50,60,10,1,139,India
449124,2024-02-03,210,mountain dew,75,100,25,1,139,India
449124,2024-02-03,201,paneer,210,340,130,1,139,India
449124,2024-02-03,206,yakult,360,400,40,1,139,India
449124,2024-02-03,207,coca cola,75,100,25,1,139,India
944864,2024-02-03,210,mountain dew,75,100,25,1,53,India
944864,2024-02-03,206,yakult,360,400,40,1,53,India
944864,2024-02-03,212,amul cheese,250,315,65,1,53,India
667230,2024-02-03,204,strawberry yogurt,50,60,10,1,331,India
667230,2024-02-03,206,yakult,360,400,40,1,331,India
667230,2024-02-03,205,classic yogurt,45,60,15,1,331,India
667230,2024-02-03,213,bisleri,6,15,9,1,331,India
667230,2024-02-03,208,sprite,75,100,25,1,331,India
521406,2024-02-03,208,sprite,75,100,25,1,297,India
521406,2024-02-03,212,amul cheese,250,315,65,1,297,India
521406,2024-02-03,201,paneer,210,340,130,1,297,India
521406,2024-02-03,204,strawberry yogurt,50,60,10,1,297,India
390608,2024-02-03,210,mountain dew,75,100,25,1,95,India
390608,2024-02-03,202,milk,12,27,15,1,95,India
390608,2024-02-03,207,coca cola,75,100,25,1,95,India
390608,2024-02-03,209,pepsi,75,100,25,1,95,India
267254,2024-02-03,204,strawberry yogurt,50,60,10,1,487,India
803319,2024-02-03,201,paneer,210,340,130,1,267,India
979852,2024-02-03,202,milk,12,27,15,1,177,India
979852,2024-02-03,210,mountain dew,75,100,25,1,177,India
115239,2024-02-03,203,mango yogurt,50,60,10,1,225,India
115239,2024-02-03,210,mountain dew,75,100,25,1,225,India
115239,2024-02-03,212,amul cheese,250,315,65,1,225,India
432321,2024-02-03,204,strawberry yogurt,50,60,10,1,60,India
432321,2024-02-03,209,pepsi,75,100,25,1,60,India
432321,2024-02-03,202,milk,12,27,15,1,60,India
510803,2024-02-03,205,classic yogurt,45,60,15,1,248,India
510803,2024-02-03,207,coca cola,75,100,25,1,248,India
510803,2024-02-03,213,bisleri,6,15,9,1,248,India
159913,2024-02-03,205,classic yogurt,45,60,15,1,303,India
498230,2024-02-03,206,yakult,360,400,40,1,15,India
498230,2024-02-03,210,mountain dew,75,100,25,1,15,India
498230,2024-02-03,205,classic yogurt,45,60,15,1,15,India
498230,2024-02-03,213,bisleri,6,15,9,1,15,India
670022,2024-02-03,203,mango yogurt,50,60,10,1,175,India
670022,2024-02-03,207,coca cola,75,100,25,1,175,India
670022,2024-02-03,202,milk,12,27,15,1,175,India
670022,2024-02-03,205,classic yogurt,45,60,15,1,175,India
818465,2024-02-03,206,yakult,360,400,40,1,292,India
818465,2024-02-03,203,mango yogurt,50,60,10,1,292,India
818465,2024-02-03,211,red bull,90,125,35,1,292,India
317907,2024-02-03,207,coca cola,75,100,25,1,347,India
317907,2024-02-03,201,paneer,210,340,130,1,347,India
927236,2024-02-03,213,bisleri,6,15,9,1,387,India
927236,2024-02-03,210,mountain dew,75,100,25,1,387,India
260398,2024-02-03,213,bisleri,6,15,9,1,494,India
260398,2024-02-03,206,yakult,360,400,40,1,494,India
499650,2024-02-03,209,pepsi,75,100,25,1,467,India
499650,2024-02-03,203,mango yogurt,50,60,10,1,467,India
499650,2024-02-03,212,amul cheese,250,315,65,1,467,India
881919,2024-02-03,205,classic yogurt,45,60,15,1,396,India
881919,2024-02-03,206,yakult,360,400,40,1,396,India
421083,2024-02-03,210,mountain dew,75,100,25,1,75,India
421083,2024-02-03,212,amul cheese,250,315,65,1,75,India
421083,2024-02-03,211,red bull,90,125,35,1,75,India
666239,2024-02-03,202,milk,12,27,15,1,327,India
666239,2024-02-03,205,classic yogurt,45,60,15,1,327,India
666239,2024-02-03,207,coca cola,75,100,25,1,327,India
854788,2024-02-03,204,strawberry yogurt,50,60,10,1,227,India
854788,2024-02-03,209,pepsi,75,100,25,1,227,India
854788,2024-02-03,201,paneer,210,340,130,1,227,India
270191,2024-02-03,210,mountain dew,75,100,25,1,55,India
270191,2024-02-03,205,classic yogurt,45,60,15,1,55,India
835130,2024-02-03,201,paneer,210,340,130,1,225,India
835130,2024-02-03,208,sprite,75,100,25,1,225,India
835130,2024-02-03,205,classic yogurt,45,60,15,1,225,India
901738,2024-02-03,208,sprite,75,100,25,1,115,India
901738,2024-02-03,203,mango yogurt,50,60,10,1,115,India
901738,2024-02-03,210,mountain dew,75,100,25,1,115,India
586437,2024-02-03,208,sprite,75,100,25,1,407,India
586437,2024-02-03,204,strawberry yogurt,50,60,10,1,407,India
551964,2024-02-03,204,strawberry yogurt,50,60,10,1,258,India
998779,2024-02-03,210,mountain dew,75,100,25,1,37,India
998779,2024-02-03,204,strawberry yogurt,50,60,10,1,37,India
998779,2024-02-03,207,coca cola,75,100,25,1,37,India
998779,2024-02-03,203,mango yogurt,50,60,10,1,37,India
998779,2024-02-03,213,bisleri,6,15,9,1,37,India
730882,2024-02-03,212,amul cheese,250,315,65,1,428,India
803072,2024-02-03,208,sprite,75,100,25,1,54,India
803072,2024-02-03,213,bisleri,6,15,9,1,54,India
803072,2024-02-03,212,amul cheese,250,315,65,1,54,India
234470,2024-02-03,207,coca cola,75,100,25,1,196,India
234470,2024-02-03,205,classic yogurt,45,60,15,1,196,India
234470,2024-02-03,209,pepsi,75,100,25,1,196,India
371818,2024-02-03,207,coca cola,75,100,25,1,60,India
371818,2024-02-03,208,sprite,75,100,25,1,60,India
371818,2024-02-03,201,paneer,210,340,130,1,60,India
371818,2024-02-03,211,red bull,90,125,35,1,60,India
371818,2024-02-03,209,pepsi,75,100,25,1,60,India
418995,2024-02-03,202,milk,12,27,15,1,281,India
307330,2024-02-03,204,strawberry yogurt,50,60,10,1,415,India
756441,2024-02-03,204,strawberry yogurt,50,60,10,1,55,India
625620,2024-02-03,211,red bull,90,125,35,1,134,India
625620,2024-02-03,208,sprite,75,100,25,1,134,India
625620,2024-02-03,201,paneer,210,340,130,1,134,India
625620,2024-02-03,204,strawberry yogurt,50,60,10,1,134,India
708954,2024-02-03,212,amul cheese,250,315,65,1,332,India
389050,2024-02-03,209,pepsi,75,100,25,1,282,India
291771,2024-02-03,204,strawberry yogurt,50,60,10,1,456,India
291771,2024-02-03,209,pepsi,75,100,25,1,456,India
291771,2024-02-03,205,classic yogurt,45,60,15,1,456,India
592526,2024-02-04,207,coca cola,75,100,25,1,477,India
592526,2024-02-04,206,yakult,360,400,40,1,477,India
592526,2024-02-04,209,pepsi,75,100,25,1,477,India
592526,2024-02-04,208,sprite,75,100,25,1,477,India
438950,2024-02-04,210,mountain dew,75,100,25,1,340,India
438950,2024-02-04,201,paneer,210,340,130,1,340,India
438950,2024-02-04,206,yakult,360,400,40,1,340,India
249921,2024-02-04,203,mango yogurt,50,60,10,1,488,India
249921,2024-02-04,204,strawberry yogurt,50,60,10,1,488,India
432363,2024-02-04,202,milk,12,27,15,1,295,India
432363,2024-02-04,210,mountain dew,75,100,25,1,295,India
432363,2024-02-04,209,pepsi,75,100,25,1,295,India
237130,2024-02-04,208,sprite,75,100,25,1,299,India
373361,2024-02-04,208,sprite,75,100,25,1,421,India
373361,2024-02-04,211,red bull,90,125,35,1,421,India
373361,2024-02-04,203,mango yogurt,50,60,10,1,421,India
557232,2024-02-04,213,bisleri,6,15,9,1,95,India
557232,2024-02-04,201,paneer,210,340,130,1,95,India
557232,2024-02-04,206,yakult,360,400,40,1,95,India
557232,2024-02-04,204,strawberry yogurt,50,60,10,1,95,India
415390,2024-02-04,211,red bull,90,125,35,1,269,India
350247,2024-02-04,212,amul cheese,250,315,65,1,207,India
350247,2024-02-04,205,classic yogurt,45,60,15,1,207,India
350247,2024-02-04,208,sprite,75,100,25,1,207,India
350443,2024-02-04,202,milk,12,27,15,1,252,India
357230,2024-02-04,204,strawberry yogurt,50,60,10,1,290,India
357230,2024-02-04,209,pepsi,75,100,25,1,290,India
357230,2024-02-04,201,paneer,210,340,130,1,290,India
985676,2024-02-04,207,coca cola,75,100,25,1,28,India
985676,2024-02-04,202,milk,12,27,15,1,28,India
985676,2024-02-04,213,bisleri,6,15,9,1,28,India
985676,2024-02-04,203,mango yogurt,50,60,10,1,28,India
954641,2024-02-04,211,red bull,90,125,35,1,35,India
954641,2024-02-04,213,bisleri,6,15,9,1,35,India
954641,2024-02-04,209,pepsi,75,100,25,1,35,India
954641,2024-02-04,210,mountain dew,75,100,25,1,35,India
498764,2024-02-04,202,milk,12,27,15,1,393,India
498764,2024-02-04,213,bisleri,6,15,9,1,393,India
498764,2024-02-04,201,paneer,210,340,130,1,393,India
711615,2024-02-04,209,pepsi,75,100,25,1,332,India
711615,2024-02-04,210,mountain dew,75,100,25,1,332,India
711615,2024-02-04,202,milk,12,27,15,1,332,India
711615,2024-02-04,204,strawberry yogurt,50,60,10,1,332,India
179295,2024-02-04,204,strawberry yogurt,50,60,10,1,288,India
179295,2024-02-04,212,amul cheese,250,315,65,1,288,India
385900,2024-02-04,212,amul cheese,250,315,65,1,487,India
385900,2024-02-04,210,mountain dew,75,100,25,1,487,India
241002,2024-02-04,212,amul cheese,250,315,65,1,493,India
241002,2024-02-04,209,pepsi,75,100,25,1,493,India
372743,2024-02-04,207,coca cola,75,100,25,1,40,India
372743,2024-02-04,208,sprite,75,100,25,1,40,India
372743,2024-02-04,210,mountain dew,75,100,25,1,40,India
598791,2024-02-04,210,mountain dew,75,100,25,1,365,India
598791,2024-02-04,205,classic yogurt,45,60,15,1,365,India
598791,2024-02-04,206,yakult,360,400,40,1,365,India
598791,2024-02-04,209,pepsi,75,100,25,1,365,India
788731,2024-02-04,211,red bull,90,125,35,1,8,India
142573,2024-02-04,206,yakult,360,400,40,1,182,India
142573,2024-02-04,205,classic yogurt,45,60,15,1,182,India
142573,2024-02-04,204,strawberry yogurt,50,60,10,1,182,India
142573,2024-02-04,213,bisleri,6,15,9,1,182,India
680244,2024-02-04,202,milk,12,27,15,1,448,India
909687,2024-02-04,203,mango yogurt,50,60,10,1,120,India
909687,2024-02-04,209,pepsi,75,100,25,1,120,India
909687,2024-02-04,202,milk,12,27,15,1,120,India
909687,2024-02-04,213,bisleri,6,15,9,1,120,India
398933,2024-02-04,209,pepsi,75,100,25,1,413,India
398933,2024-02-04,206,yakult,360,400,40,1,413,India
398933,2024-02-04,203,mango yogurt,50,60,10,1,413,India
398933,2024-02-04,211,red bull,90,125,35,1,413,India
897758,2024-02-04,210,mountain dew,75,100,25,1,48,India
897758,2024-02-04,207,coca cola,75,100,25,1,48,India
897758,2024-02-04,209,pepsi,75,100,25,1,48,India
936897,2024-02-04,203,mango yogurt,50,60,10,1,485,India
456443,2024-02-04,209,pepsi,75,100,25,1,404,India
850218,2024-02-04,206,yakult,360,400,40,1,349,India
850218,2024-02-04,210,mountain dew,75,100,25,1,349,India
850218,2024-02-04,201,paneer,210,340,130,1,349,India
850218,2024-02-04,207,coca cola,75,100,25,1,349,India
995107,2024-02-04,212,amul cheese,250,315,65,1,64,India
995107,2024-02-04,213,bisleri,6,15,9,1,64,India
995107,2024-02-04,207,coca cola,75,100,25,1,64,India
995107,2024-02-04,206,yakult,360,400,40,1,64,India
995107,2024-02-04,203,mango yogurt,50,60,10,1,64,India
526752,2024-02-04,205,classic yogurt,45,60,15,1,289,India
526752,2024-02-04,202,milk,12,27,15,1,289,India
395339,2024-02-04,206,yakult,360,400,40,1,48,India
395339,2024-02-04,209,pepsi,75,100,25,1,48,India
614573,2024-02-04,205,classic yogurt,45,60,15,1,10,India
614573,2024-02-04,207,coca cola,75,100,25,1,10,India
614573,2024-02-04,210,mountain dew,75,100,25,1,10,India
992609,2024-02-04,213,bisleri,6,15,9,1,127,India
956071,2024-02-04,207,coca cola,75,100,25,1,218,India
956071,2024-02-04,209,pepsi,75,100,25,1,218,India
345961,2024-02-04,210,mountain dew,75,100,25,1,36,India
345961,2024-02-04,213,bisleri,6,15,9,1,36,India
345961,2024-02-04,205,classic yogurt,45,60,15,1,36,India
420597,2024-02-04,211,red bull,90,125,35,1,11,India
420597,2024-02-04,210,mountain dew,75,100,25,1,11,India
937930,2024-02-04,207,coca cola,75,100,25,1,500,India
937930,2024-02-04,204,strawberry yogurt,50,60,10,1,500,India
937930,2024-02-04,202,milk,12,27,15,1,500,India
344288,2024-02-04,203,mango yogurt,50,60,10,1,104,India
139907,2024-02-04,204,strawberry yogurt,50,60,10,1,188,India
139907,2024-02-04,207,coca cola,75,100,25,1,188,India
490824,2024-02-04,210,mountain dew,75,100,25,1,489,India
490824,2024-02-04,212,amul cheese,250,315,65,1,489,India
490824,2024-02-04,202,milk,12,27,15,1,489,India
883940,2024-02-04,211,red bull,90,125,35,1,305,India
883940,2024-02-04,213,bisleri,6,15,9,1,305,India
883940,2024-02-04,205,classic yogurt,45,60,15,1,305,India
410221,2024-02-04,203,mango yogurt,50,60,10,1,8,India
410221,2024-02-04,213,bisleri,6,15,9,1,8,India
410221,2024-02-04,210,mountain dew,75,100,25,1,8,India
410221,2024-02-04,211,red bull,90,125,35,1,8,India
410221,2024-02-04,205,classic yogurt,45,60,15,1,8,India
306461,2024-02-04,210,mountain dew,75,100,25,1,206,India
306461,2024-02-04,202,milk,12,27,15,1,206,India
306461,2024-02-04,213,bisleri,6,15,9,1,206,India
306461,2024-02-04,205,classic yogurt,45,60,15,1,206,India
306461,2024-02-04,208,sprite,75,100,25,1,206,India
125114,2024-02-04,210,mountain dew,75,100,25,1,123,India
125114,2024-02-04,202,milk,12,27,15,1,123,India
125114,2024-02-04,205,classic yogurt,45,60,15,1,123,India
527817,2024-02-04,205,classic yogurt,45,60,15,1,119,India
527817,2024-02-04,204,strawberry yogurt,50,60,10,1,119,India
201791,2024-02-04,202,milk,12,27,15,1,365,India
201791,2024-02-04,203,mango yogurt,50,60,10,1,365,India
201791,2024-02-04,205,classic yogurt,45,60,15,1,365,India
324422,2024-02-04,201,paneer,210,340,130,1,393,India
250090,2024-02-04,213,bisleri,6,15,9,1,179,India
250090,2024-02-04,204,strawberry yogurt,50,60,10,1,179,India
555182,2024-02-04,204,strawberry yogurt,50,60,10,1,376,India
555182,2024-02-04,206,yakult,360,400,40,1,376,India
555182,2024-02-04,203,mango yogurt,50,60,10,1,376,India
905335,2024-02-04,202,milk,12,27,15,1,431,India
905335,2024-02-04,211,red bull,90,125,35,1,431,India
905335,2024-02-04,210,mountain dew,75,100,25,1,431,India
905335,2024-02-04,213,bisleri,6,15,9,1,431,India
905335,2024-02-04,205,classic yogurt,45,60,15,1,431,India
130038,2024-02-04,207,coca cola,75,100,25,1,94,India
130038,2024-02-04,208,sprite,75,100,25,1,94,India
876044,2024-02-04,211,red bull,90,125,35,1,62,India
348152,2024-02-04,208,sprite,75,100,25,1,366,India
348152,2024-02-04,205,classic yogurt,45,60,15,1,366,India
348152,2024-02-04,211,red bull,90,125,35,1,366,India
117096,2024-02-04,210,mountain dew,75,100,25,1,172,India
117096,2024-02-04,207,coca cola,75,100,25,1,172,India
117096,2024-02-04,202,milk,12,27,15,1,172,India
117096,2024-02-04,208,sprite,75,100,25,1,172,India
117096,2024-02-04,206,yakult,360,400,40,1,172,India
526024,2024-02-05,208,sprite,75,100,25,1,241,India
526024,2024-02-05,211,red bull,90,125,35,1,241,India
526024,2024-02-05,210,mountain dew,75,100,25,1,241,India
333483,2024-02-05,205,classic yogurt,45,60,15,1,236,India
333483,2024-02-05,209,pepsi,75,100,25,1,236,India
333483,2024-02-05,206,yakult,360,400,40,1,236,India
333483,2024-02-05,204,strawberry yogurt,50,60,10,1,236,India
400669,2024-02-05,206,yakult,360,400,40,1,197,India
400669,2024-02-05,205,classic yogurt,45,60,15,1,197,India
400669,2024-02-05,203,mango yogurt,50,60,10,1,197,India
400669,2024-02-05,212,amul cheese,250,315,65,1,197,India
400669,2024-02-05,210,mountain dew,75,100,25,1,197,India
368274,2024-02-05,209,pepsi,75,100,25,1,39,India
368274,2024-02-05,208,sprite,75,100,25,1,39,India
368274,2024-02-05,201,paneer,210,340,130,1,39,India
894325,2024-02-05,210,mountain dew,75,100,25,1,209,India
894325,2024-02-05,203,mango yogurt,50,60,10,1,209,India
894325,2024-02-05,201,paneer,210,340,130,1,209,India
894325,2024-02-05,209,pepsi,75,100,25,1,209,India
742351,2024-02-05,206,yakult,360,400,40,1,276,India
742351,2024-02-05,208,sprite,75,100,25,1,276,India
742351,2024-02-05,203,mango yogurt,50,60,10,1,276,India
287193,2024-02-05,212,amul cheese,250,315,65,1,286,India
287193,2024-02-05,209,pepsi,75,100,25,1,286,India
287193,2024-02-05,205,classic yogurt,45,60,15,1,286,India
287193,2024-02-05,211,red bull,90,125,35,1,286,India
287193,2024-02-05,210,mountain dew,75,100,25,1,286,India
898950,2024-02-05,211,red bull,90,125,35,1,421,India
898950,2024-02-05,207,coca cola,75,100,25,1,421,India
898950,2024-02-05,201,paneer,210,340,130,1,421,India
903264,2024-02-05,213,bisleri,6,15,9,1,432,India
903264,2024-02-05,209,pepsi,75,100,25,1,432,India
903264,2024-02-05,208,sprite,75,100,25,1,432,India
788021,2024-02-05,207,coca cola,75,100,25,1,117,India
788021,2024-02-05,211,red bull,90,125,35,1,117,India
788021,2024-02-05,209,pepsi,75,100,25,1,117,India
733964,2024-02-05,213,bisleri,6,15,9,1,7,India
873457,2024-02-05,206,yakult,360,400,40,1,190,India
151751,2024-02-05,210,mountain dew,75,100,25,1,135,India
151751,2024-02-05,211,red bull,90,125,35,1,135,India
151751,2024-02-05,202,milk,12,27,15,1,135,India
151751,2024-02-05,209,pepsi,75,100,25,1,135,India
459248,2024-02-05,213,bisleri,6,15,9,1,36,India
459248,2024-02-05,208,sprite,75,100,25,1,36,India
459248,2024-02-05,210,mountain dew,75,100,25,1,36,India
459248,2024-02-05,209,pepsi,75,100,25,1,36,India
187606,2024-02-05,202,milk,12,27,15,1,422,India
187606,2024-02-05,204,strawberry yogurt,50,60,10,1,422,India
165154,2024-02-05,207,coca cola,75,100,25,1,245,India
165154,2024-02-05,202,milk,12,27,15,1,245,India
453369,2024-02-05,210,mountain dew,75,100,25,1,185,India
453369,2024-02-05,206,yakult,360,400,40,1,185,India
453369,2024-02-05,213,bisleri,6,15,9,1,185,India
133491,2024-02-05,206,yakult,360,400,40,1,31,India
133491,2024-02-05,211,red bull,90,125,35,1,31,India
133491,2024-02-05,207,coca cola,75,100,25,1,31,India
867196,2024-02-05,208,sprite,75,100,25,1,498,India
313511,2024-02-05,206,yakult,360,400,40,1,372,India
626784,2024-02-05,210,mountain dew,75,100,25,1,352,India
637087,2024-02-05,202,milk,12,27,15,1,381,India
572558,2024-02-05,213,bisleri,6,15,9,1,126,India
572558,2024-02-05,202,milk,12,27,15,1,126,India
572558,2024-02-05,207,coca cola,75,100,25,1,126,India
572558,2024-02-05,212,amul cheese,250,315,65,1,126,India
251802,2024-02-05,209,pepsi,75,100,25,1,110,India
315686,2024-02-05,211,red bull,90,125,35,1,200,India
315686,2024-02-05,207,coca cola,75,100,25,1,200,India
315686,2024-02-05,205,classic yogurt,45,60,15,1,200,India
115127,2024-02-05,210,mountain dew,75,100,25,1,412,India
115127,2024-02-05,212,amul cheese,250,315,65,1,412,India
115127,2024-02-05,205,classic yogurt,45,60,15,1,412,India
115127,2024-02-05,208,sprite,75,100,25,1,412,India
129047,2024-02-05,202,milk,12,27,15,1,386,India
129047,2024-02-05,211,red bull,90,125,35,1,386,India
918811,2024-02-05,212,amul cheese,250,315,65,1,50,India
336035,2024-02-05,205,classic yogurt,45,60,15,1,267,India
336035,2024-02-05,208,sprite,75,100,25,1,267,India
336035,2024-02-05,207,coca cola,75,100,25,1,267,India
336035,2024-02-05,213,bisleri,6,15,9,1,267,India
336035,2024-02-05,201,paneer,210,340,130,1,267,India
964485,2024-02-05,213,bisleri,6,15,9,1,381,India
563485,2024-02-05,208,sprite,75,100,25,1,456,India
501907,2024-02-05,207,coca cola,75,100,25,1,453,India
501907,2024-02-05,201,paneer,210,340,130,1,453,India
701105,2024-02-05,201,paneer,210,340,130,1,247,India
701105,2024-02-05,213,bisleri,6,15,9,1,247,India
701105,2024-02-05,209,pepsi,75,100,25,1,247,India
499872,2024-02-05,210,mountain dew,75,100,25,1,313,India
499872,2024-02-05,209,pepsi,75,100,25,1,313,India
432713,2024-02-05,210,mountain dew,75,100,25,1,339,India
432713,2024-02-05,204,strawberry yogurt,50,60,10,1,339,India
670453,2024-02-05,201,paneer,210,340,130,1,78,India
670453,2024-02-05,211,red bull,90,125,35,1,78,India
670453,2024-02-05,207,coca cola,75,100,25,1,78,India
816207,2024-02-05,204,strawberry yogurt,50,60,10,1,200,India
816207,2024-02-05,208,sprite,75,100,25,1,200,India
527017,2024-02-05,202,milk,12,27,15,1,281,India
527017,2024-02-05,205,classic yogurt,45,60,15,1,281,India
527017,2024-02-05,204,strawberry yogurt,50,60,10,1,281,India
253788,2024-02-05,207,coca cola,75,100,25,1,319,India
253788,2024-02-05,208,sprite,75,100,25,1,319,India
253788,2024-02-05,201,paneer,210,340,130,1,319,India
253788,2024-02-05,202,milk,12,27,15,1,319,India
145785,2024-02-05,202,milk,12,27,15,1,295,India
145785,2024-02-05,203,mango yogurt,50,60,10,1,295,India
618262,2024-02-05,205,classic yogurt,45,60,15,1,219,India
618262,2024-02-05,213,bisleri,6,15,9,1,219,India
618262,2024-02-05,211,red bull,90,125,35,1,219,India
618262,2024-02-05,204,strawberry yogurt,50,60,10,1,219,India
985191,2024-02-05,201,paneer,210,340,130,1,317,India
985191,2024-02-05,204,strawberry yogurt,50,60,10,1,317,India
985191,2024-02-05,211,red bull,90,125,35,1,317,India
985191,2024-02-05,206,yakult,360,400,40,1,317,India
115384,2024-02-05,207,coca cola,75,100,25,1,399,India
115384,2024-02-05,201,paneer,210,340,130,1,399,India
692622,2024-02-05,205,classic yogurt,45,60,15,1,172,India
692622,2024-02-05,206,yakult,360,400,40,1,172,India
455722,2024-02-05,206,yakult,360,400,40,1,243,India
625643,2024-02-05,208,sprite,75,100,25,1,413,India
625643,2024-02-05,207,coca cola,75,100,25,1,413,India
625643,2024-02-05,212,amul cheese,250,315,65,1,413,India
625643,2024-02-05,205,classic yogurt,45,60,15,1,413,India
948009,2024-02-05,206,yakult,360,400,40,1,352,India
146589,2024-02-05,207,coca cola,75,100,25,1,114,India
146589,2024-02-05,208,sprite,75,100,25,1,114,India
146589,2024-02-05,213,bisleri,6,15,9,1,114,India
146589,2024-02-05,206,yakult,360,400,40,1,114,India
146589,2024-02-05,211,red bull,90,125,35,1,114,India
111691,2024-02-05,207,coca cola,75,100,25,1,56,India
732575,2024-02-05,201,paneer,210,340,130,1,354,India
732575,2024-02-05,208,sprite,75,100,25,1,354,India
732575,2024-02-05,210,mountain dew,75,100,25,1,354,India
732575,2024-02-05,205,classic yogurt,45,60,15,1,354,India
732575,2024-02-05,212,amul cheese,250,315,65,1,354,India
334399,2024-02-05,210,mountain dew,75,100,25,1,33,India
195876,2024-02-05,213,bisleri,6,15,9,1,343,India
195876,2024-02-05,201,paneer,210,340,130,1,343,India
495158,2024-02-05,203,mango yogurt,50,60,10,1,12,India
495158,2024-02-05,213,bisleri,6,15,9,1,12,India
383113,2024-02-05,213,bisleri,6,15,9,1,215,India
760255,2024-02-05,211,red bull,90,125,35,1,120,India
760255,2024-02-05,202,milk,12,27,15,1,120,India
629275,2024-02-05,204,strawberry yogurt,50,60,10,1,370,India
629275,2024-02-05,202,milk,12,27,15,1,370,India
629275,2024-02-05,213,bisleri,6,15,9,1,370,India
757040,2024-02-05,202,milk,12,27,15,1,86,India
757040,2024-02-05,208,sprite,75,100,25,1,86,India
419716,2024-02-05,206,yakult,360,400,40,1,294,India
419716,2024-02-05,209,pepsi,75,100,25,1,294,India
419716,2024-02-05,203,mango yogurt,50,60,10,1,294,India
419716,2024-02-05,213,bisleri,6,15,9,1,294,India
480232,2024-02-05,205,classic yogurt,45,60,15,1,205,India
480232,2024-02-05,212,amul cheese,250,315,65,1,205,India
723673,2024-02-05,206,yakult,360,400,40,1,414,India
723673,2024-02-05,213,bisleri,6,15,9,1,414,India
400027,2024-02-05,204,strawberry yogurt,50,60,10,1,182,India
400027,2024-02-05,207,coca cola,75,100,25,1,182,India
400027,2024-02-05,205,classic yogurt,45,60,15,1,182,India
400027,2024-02-05,208,sprite,75,100,25,1,182,India
951783,2024-02-05,211,red bull,90,125,35,1,207,India
182927,2024-02-05,202,milk,12,27,15,1,90,India
182927,2024-02-05,203,mango yogurt,50,60,10,1,90,India
182927,2024-02-05,210,mountain dew,75,100,25,1,90,India
182927,2024-02-05,205,classic yogurt,45,60,15,1,90,India
885836,2024-02-05,203,mango yogurt,50,60,10,1,361,India
821502,2024-02-05,201,paneer,210,340,130,1,432,India
853246,2024-02-05,210,mountain dew,75,100,25,1,115,India
853246,2024-02-05,206,yakult,360,400,40,1,115,India
853246,2024-02-05,204,strawberry yogurt,50,60,10,1,115,India
853246,2024-02-05,205,classic yogurt,45,60,15,1,115,India
933653,2024-02-05,205,classic yogurt,45,60,15,1,112,India
933653,2024-02-05,204,strawberry yogurt,50,60,10,1,112,India
933653,2024-02-05,207,coca cola,75,100,25,1,112,India
933653,2024-02-05,210,mountain dew,75,100,25,1,112,India
933653,2024-02-05,206,yakult,360,400,40,1,112,India
275454,2024-02-05,207,coca cola,75,100,25,1,397,India
275454,2024-02-05,209,pepsi,75,100,25,1,397,India
275454,2024-02-05,206,yakult,360,400,40,1,397,India
917517,2024-02-05,201,paneer,210,340,130,1,58,India
768189,2024-02-05,202,milk,12,27,15,1,28,India
768189,2024-02-05,207,coca cola,75,100,25,1,28,India
768189,2024-02-05,210,mountain dew,75,100,25,1,28,India
550235,2024-02-05,204,strawberry yogurt,50,60,10,1,287,India
550235,2024-02-05,203,mango yogurt,50,60,10,1,287,India
517833,2024-02-05,209,pepsi,75,100,25,1,162,India
517833,2024-02-05,203,mango yogurt,50,60,10,1,162,India
517833,2024-02-05,208,sprite,75,100,25,1,162,India
509662,2024-02-05,205,classic yogurt,45,60,15,1,283,India
882420,2024-02-05,204,strawberry yogurt,50,60,10,1,335,India
882420,2024-02-05,205,classic yogurt,45,60,15,1,335,India
695089,2024-02-05,211,red bull,90,125,35,1,469,India
695089,2024-02-05,206,yakult,360,400,40,1,469,India
376961,2024-02-05,207,coca cola,75,100,25,1,479,India
376961,2024-02-05,201,paneer,210,340,130,1,479,India
376961,2024-02-05,206,yakult,360,400,40,1,479,India
953652,2024-02-05,207,coca cola,75,100,25,1,94,India
273047,2024-02-05,207,coca cola,75,100,25,1,409,India
273047,2024-02-05,211,red bull,90,125,35,1,409,India
273047,2024-02-05,210,mountain dew,75,100,25,1,409,India
273047,2024-02-05,213,bisleri,6,15,9,1,409,India
821786,2024-02-05,201,paneer,210,340,130,1,177,India
821786,2024-02-05,204,strawberry yogurt,50,60,10,1,177,India
821786,2024-02-05,206,yakult,360,400,40,1,177,India
478191,2024-02-05,205,classic yogurt,45,60,15,1,225,India
478191,2024-02-05,210,mountain dew,75,100,25,1,225,India
478191,2024-02-05,208,sprite,75,100,25,1,225,India
478191,2024-02-05,212,amul cheese,250,315,65,1,225,India
286918,2024-02-05,211,red bull,90,125,35,1,39,India
286918,2024-02-05,204,strawberry yogurt,50,60,10,1,39,India
286918,2024-02-05,203,mango yogurt,50,60,10,1,39,India
201617,2024-02-05,211,red bull,90,125,35,1,60,India
201617,2024-02-05,204,strawberry yogurt,50,60,10,1,60,India
197997,2024-02-05,204,strawberry yogurt,50,60,10,1,83,India
197997,2024-02-05,213,bisleri,6,15,9,1,83,India
197997,2024-02-05,202,milk,12,27,15,1,83,India
210939,2024-02-05,204,strawberry yogurt,50,60,10,1,413,India
760391,2024-02-05,209,pepsi,75,100,25,1,488,India
760391,2024-02-05,202,milk,12,27,15,1,488,India
760391,2024-02-05,203,mango yogurt,50,60,10,1,488,India
210626,2024-02-05,204,strawberry yogurt,50,60,10,1,301,India
398252,2024-02-05,208,sprite,75,100,25,1,431,India
873774,2024-02-05,201,paneer,210,340,130,1,500,India
873774,2024-02-05,211,red bull,90,125,35,1,500,India
873774,2024-02-05,208,sprite,75,100,25,1,500,India
459773,2024-02-05,203,mango yogurt,50,60,10,1,350,India
177590,2024-02-05,211,red bull,90,125,35,1,474,India
177590,2024-02-05,201,paneer,210,340,130,1,474,India
177590,2024-02-05,202,milk,12,27,15,1,474,India
277470,2024-02-05,205,classic yogurt,45,60,15,1,27,India
277470,2024-02-05,210,mountain dew,75,100,25,1,27,India
277470,2024-02-05,206,yakult,360,400,40,1,27,India
260000,2024-02-05,208,sprite,75,100,25,1,398,India
260000,2024-02-05,204,strawberry yogurt,50,60,10,1,398,India
260000,2024-02-05,202,milk,12,27,15,1,398,India
260000,2024-02-05,201,paneer,210,340,130,1,398,India
356152,2024-02-06,201,paneer,210,340,130,1,226,India
936322,2024-02-06,206,yakult,360,400,40,1,413,India
276739,2024-02-06,205,classic yogurt,45,60,15,1,158,India
276739,2024-02-06,208,sprite,75,100,25,1,158,India
669541,2024-02-06,205,classic yogurt,45,60,15,1,221,India
669541,2024-02-06,208,sprite,75,100,25,1,221,India
669541,2024-02-06,207,coca cola,75,100,25,1,221,India
128318,2024-02-06,206,yakult,360,400,40,1,479,India
128318,2024-02-06,212,amul cheese,250,315,65,1,479,India
128318,2024-02-06,207,coca cola,75,100,25,1,479,India
128318,2024-02-06,210,mountain dew,75,100,25,1,479,India
455340,2024-02-06,211,red bull,90,125,35,1,263,India
455340,2024-02-06,205,classic yogurt,45,60,15,1,263,India
431607,2024-02-06,208,sprite,75,100,25,1,288,India
958585,2024-02-06,209,pepsi,75,100,25,1,42,India
958585,2024-02-06,211,red bull,90,125,35,1,42,India
318412,2024-02-06,207,coca cola,75,100,25,1,278,India
318412,2024-02-06,201,paneer,210,340,130,1,278,India
318412,2024-02-06,210,mountain dew,75,100,25,1,278,India
318412,2024-02-06,209,pepsi,75,100,25,1,278,India
318412,2024-02-06,208,sprite,75,100,25,1,278,India
448968,2024-02-06,202,milk,12,27,15,1,438,India
448968,2024-02-06,204,strawberry yogurt,50,60,10,1,438,India
448968,2024-02-06,208,sprite,75,100,25,1,438,India
614808,2024-02-06,208,sprite,75,100,25,1,204,India
446494,2024-02-06,201,paneer,210,340,130,1,54,India
446494,2024-02-06,204,strawberry yogurt,50,60,10,1,54,India
446494,2024-02-06,210,mountain dew,75,100,25,1,54,India
678144,2024-02-06,204,strawberry yogurt,50,60,10,1,52,India
425141,2024-02-06,212,amul cheese,250,315,65,1,1,India
756740,2024-02-06,211,red bull,90,125,35,1,363,India
756740,2024-02-06,210,mountain dew,75,100,25,1,363,India
285373,2024-02-06,211,red bull,90,125,35,1,419,India
285373,2024-02-06,212,amul cheese,250,315,65,1,419,India
222808,2024-02-06,211,red bull,90,125,35,1,71,India
222808,2024-02-06,203,mango yogurt,50,60,10,1,71,India
222808,2024-02-06,209,pepsi,75,100,25,1,71,India
222808,2024-02-06,201,paneer,210,340,130,1,71,India
222808,2024-02-06,205,classic yogurt,45,60,15,1,71,India
942686,2024-02-06,212,amul cheese,250,315,65,1,333,India
173367,2024-02-06,209,pepsi,75,100,25,1,487,India
173367,2024-02-06,203,mango yogurt,50,60,10,1,487,India
173367,2024-02-06,201,paneer,210,340,130,1,487,India
173367,2024-02-06,206,yakult,360,400,40,1,487,India
843041,2024-02-06,205,classic yogurt,45,60,15,1,444,India
843041,2024-02-06,208,sprite,75,100,25,1,444,India
551828,2024-02-06,203,mango yogurt,50,60,10,1,498,India
551828,2024-02-06,204,strawberry yogurt,50,60,10,1,498,India
987464,2024-02-06,207,coca cola,75,100,25,1,307,India
987464,2024-02-06,206,yakult,360,400,40,1,307,India
987464,2024-02-06,211,red bull,90,125,35,1,307,India
175042,2024-02-06,211,red bull,90,125,35,1,317,India
175042,2024-02-06,206,yakult,360,400,40,1,317,India
175042,2024-02-06,202,milk,12,27,15,1,317,India
920997,2024-02-06,204,strawberry yogurt,50,60,10,1,352,India
920997,2024-02-06,206,yakult,360,400,40,1,352,India
799625,2024-02-06,204,strawberry yogurt,50,60,10,1,329,India
799625,2024-02-06,203,mango yogurt,50,60,10,1,329,India
799625,2024-02-06,208,sprite,75,100,25,1,329,India
799625,2024-02-06,211,red bull,90,125,35,1,329,India
799625,2024-02-06,205,classic yogurt,45,60,15,1,329,India
779727,2024-02-06,208,sprite,75,100,25,1,10,India
590734,2024-02-06,209,pepsi,75,100,25,1,328,India
590734,2024-02-06,210,mountain dew,75,100,25,1,328,India
980556,2024-02-06,205,classic yogurt,45,60,15,1,396,India
980556,2024-02-06,212,amul cheese,250,315,65,1,396,India
980556,2024-02-06,209,pepsi,75,100,25,1,396,India
980556,2024-02-06,202,milk,12,27,15,1,396,India
980556,2024-02-06,206,yakult,360,400,40,1,396,India
366600,2024-02-06,212,amul cheese,250,315,65,1,243,India
366600,2024-02-06,205,classic yogurt,45,60,15,1,243,India
366600,2024-02-06,211,red bull,90,125,35,1,243,India
234357,2024-02-06,211,red bull,90,125,35,1,121,India
895234,2024-02-06,206,yakult,360,400,40,1,320,India
895234,2024-02-06,210,mountain dew,75,100,25,1,320,India
895234,2024-02-06,207,coca cola,75,100,25,1,320,India
657637,2024-02-06,202,milk,12,27,15,1,426,India
657637,2024-02-06,205,classic yogurt,45,60,15,1,426,India
657637,2024-02-06,210,mountain dew,75,100,25,1,426,India
237167,2024-02-06,203,mango yogurt,50,60,10,1,87,India
272076,2024-02-06,207,coca cola,75,100,25,1,414,India
272076,2024-02-06,204,strawberry yogurt,50,60,10,1,414,India
851802,2024-02-06,209,pepsi,75,100,25,1,222,India
851802,2024-02-06,206,yakult,360,400,40,1,222,India
851802,2024-02-06,208,sprite,75,100,25,1,222,India
207641,2024-02-06,212,amul cheese,250,315,65,1,370,India
207641,2024-02-06,211,red bull,90,125,35,1,370,India
785423,2024-02-06,210,mountain dew,75,100,25,1,37,India
785423,2024-02-06,205,classic yogurt,45,60,15,1,37,India
785423,2024-02-06,209,pepsi,75,100,25,1,37,India
785423,2024-02-06,202,milk,12,27,15,1,37,India
785423,2024-02-06,212,amul cheese,250,315,65,1,37,India
406211,2024-02-06,205,classic yogurt,45,60,15,1,161,India
645085,2024-02-06,209,pepsi,75,100,25,1,157,India
718511,2024-02-06,209,pepsi,75,100,25,1,227,India
718511,2024-02-06,205,classic yogurt,45,60,15,1,227,India
757582,2024-02-06,208,sprite,75,100,25,1,78,India
746939,2024-02-06,202,milk,12,27,15,1,432,India
746939,2024-02-06,204,strawberry yogurt,50,60,10,1,432,India
746939,2024-02-06,210,mountain dew,75,100,25,1,432,India
836160,2024-02-06,204,strawberry yogurt,50,60,10,1,11,India
836160,2024-02-06,205,classic yogurt,45,60,15,1,11,India
965179,2024-02-06,203,mango yogurt,50,60,10,1,337,India
965179,2024-02-06,207,coca cola,75,100,25,1,337,India
965179,2024-02-06,208,sprite,75,100,25,1,337,India
965179,2024-02-06,209,pepsi,75,100,25,1,337,India
133470,2024-02-06,206,yakult,360,400,40,1,36,India
283673,2024-02-06,201,paneer,210,340,130,1,31,India
283673,2024-02-06,210,mountain dew,75,100,25,1,31,India
283673,2024-02-06,213,bisleri,6,15,9,1,31,India
283673,2024-02-06,203,mango yogurt,50,60,10,1,31,India
283673,2024-02-06,211,red bull,90,125,35,1,31,India
839601,2024-02-06,212,amul cheese,250,315,65,1,250,India
839601,2024-02-06,213,bisleri,6,15,9,1,250,India
839601,2024-02-06,208,sprite,75,100,25,1,250,India
485993,2024-02-06,213,bisleri,6,15,9,1,23,India
485993,2024-02-06,209,pepsi,75,100,25,1,23,India
428723,2024-02-06,207,coca cola,75,100,25,1,331,India
428723,2024-02-06,211,red bull,90,125,35,1,331,India
428723,2024-02-06,206,yakult,360,400,40,1,331,India
271118,2024-02-06,201,paneer,210,340,130,1,111,India
271118,2024-02-06,213,bisleri,6,15,9,1,111,India
783213,2024-02-06,202,milk,12,27,15,1,493,India
540141,2024-02-06,202,milk,12,27,15,1,292,India
540141,2024-02-06,204,strawberry yogurt,50,60,10,1,292,India
436988,2024-02-06,204,strawberry yogurt,50,60,10,1,137,India
796788,2024-02-06,213,bisleri,6,15,9,1,251,India
796788,2024-02-06,210,mountain dew,75,100,25,1,251,India
796788,2024-02-06,206,yakult,360,400,40,1,251,India
796788,2024-02-06,202,milk,12,27,15,1,251,India
994295,2024-02-06,203,mango yogurt,50,60,10,1,117,India
994295,2024-02-06,211,red bull,90,125,35,1,117,India
994295,2024-02-06,202,milk,12,27,15,1,117,India
994295,2024-02-06,207,coca cola,75,100,25,1,117,India
771709,2024-02-07,211,red bull,90,125,35,1,396,India
771709,2024-02-07,207,coca cola,75,100,25,1,396,India
771709,2024-02-07,212,amul cheese,250,315,65,1,396,India
771709,2024-02-07,202,milk,12,27,15,1,396,India
118488,2024-02-07,209,pepsi,75,100,25,1,426,India
118488,2024-02-07,213,bisleri,6,15,9,1,426,India
118488,2024-02-07,205,classic yogurt,45,60,15,1,426,India
544709,2024-02-07,202,milk,12,27,15,1,493,India
544709,2024-02-07,211,red bull,90,125,35,1,493,India
544709,2024-02-07,205,classic yogurt,45,60,15,1,493,India
544709,2024-02-07,204,strawberry yogurt,50,60,10,1,493,India
544709,2024-02-07,201,paneer,210,340,130,1,493,India
865397,2024-02-07,208,sprite,75,100,25,1,475,India
768487,2024-02-07,201,paneer,210,340,130,1,308,India
768487,2024-02-07,206,yakult,360,400,40,1,308,India
768487,2024-02-07,213,bisleri,6,15,9,1,308,India
768487,2024-02-07,208,sprite,75,100,25,1,308,India
321132,2024-02-07,206,yakult,360,400,40,1,208,India
321132,2024-02-07,212,amul cheese,250,315,65,1,208,India
163711,2024-02-07,208,sprite,75,100,25,1,37,India
163711,2024-02-07,204,strawberry yogurt,50,60,10,1,37,India
269351,2024-02-07,211,red bull,90,125,35,1,151,India
279327,2024-02-07,207,coca cola,75,100,25,1,317,India
279327,2024-02-07,211,red bull,90,125,35,1,317,India
279327,2024-02-07,205,classic yogurt,45,60,15,1,317,India
222023,2024-02-07,213,bisleri,6,15,9,1,317,India
222023,2024-02-07,210,mountain dew,75,100,25,1,317,India
546936,2024-02-07,212,amul cheese,250,315,65,1,262,India
546936,2024-02-07,207,coca cola,75,100,25,1,262,India
142176,2024-02-07,202,milk,12,27,15,1,201,India
142176,2024-02-07,206,yakult,360,400,40,1,201,India
295484,2024-02-07,206,yakult,360,400,40,1,139,India
393582,2024-02-07,209,pepsi,75,100,25,1,445,India
469378,2024-02-07,213,bisleri,6,15,9,1,249,India
469378,2024-02-07,206,yakult,360,400,40,1,249,India
469378,2024-02-07,201,paneer,210,340,130,1,249,India
836132,2024-02-07,211,red bull,90,125,35,1,285,India
551581,2024-02-07,212,amul cheese,250,315,65,1,33,India
551581,2024-02-07,202,milk,12,27,15,1,33,India
551581,2024-02-07,213,bisleri,6,15,9,1,33,India
551581,2024-02-07,211,red bull,90,125,35,1,33,India
551581,2024-02-07,206,yakult,360,400,40,1,33,India
164518,2024-02-07,209,pepsi,75,100,25,1,402,India
164518,2024-02-07,206,yakult,360,400,40,1,402,India
164518,2024-02-07,213,bisleri,6,15,9,1,402,India
831288,2024-02-07,202,milk,12,27,15,1,254,India
831288,2024-02-07,205,classic yogurt,45,60,15,1,254,India
987840,2024-02-07,206,yakult,360,400,40,1,389,India
987840,2024-02-07,201,paneer,210,340,130,1,389,India
987840,2024-02-07,203,mango yogurt,50,60,10,1,389,India
406776,2024-02-07,208,sprite,75,100,25,1,164,India
406776,2024-02-07,207,coca cola,75,100,25,1,164,India
406776,2024-02-07,204,strawberry yogurt,50,60,10,1,164,India
399504,2024-02-07,211,red bull,90,125,35,1,159,India
399504,2024-02-07,202,milk,12,27,15,1,159,India
399504,2024-02-07,212,amul cheese,250,315,65,1,159,India
639158,2024-02-07,205,classic yogurt,45,60,15,1,254,India
639158,2024-02-07,202,milk,12,27,15,1,254,India
639158,2024-02-07,207,coca cola,75,100,25,1,254,India
639158,2024-02-07,210,mountain dew,75,100,25,1,254,India
815358,2024-02-07,207,coca cola,75,100,25,1,202,India
394368,2024-02-07,212,amul cheese,250,315,65,1,352,India
394368,2024-02-07,201,paneer,210,340,130,1,352,India
356010,2024-02-07,208,sprite,75,100,25,1,4,India
356010,2024-02-07,204,strawberry yogurt,50,60,10,1,4,India
356010,2024-02-07,203,mango yogurt,50,60,10,1,4,India
356010,2024-02-07,212,amul cheese,250,315,65,1,4,India
929252,2024-02-07,202,milk,12,27,15,1,44,India
329227,2024-02-07,209,pepsi,75,100,25,1,103,India
329227,2024-02-07,206,yakult,360,400,40,1,103,India
378743,2024-02-07,203,mango yogurt,50,60,10,1,28,India
798668,2024-02-07,205,classic yogurt,45,60,15,1,286,India
342257,2024-02-07,202,milk,12,27,15,1,20,India
342257,2024-02-07,211,red bull,90,125,35,1,20,India
342257,2024-02-07,209,pepsi,75,100,25,1,20,India
342257,2024-02-07,201,paneer,210,340,130,1,20,India
456244,2024-02-07,212,amul cheese,250,315,65,1,244,India
451532,2024-02-07,212,amul cheese,250,315,65,1,48,India
451532,2024-02-07,211,red bull,90,125,35,1,48,India
113189,2024-02-07,212,amul cheese,250,315,65,1,15,India
113189,2024-02-07,209,pepsi,75,100,25,1,15,India
113189,2024-02-07,211,red bull,90,125,35,1,15,India
113189,2024-02-07,202,milk,12,27,15,1,15,India
113189,2024-02-07,203,mango yogurt,50,60,10,1,15,India
562882,2024-02-07,209,pepsi,75,100,25,1,282,India
562882,2024-02-07,204,strawberry yogurt,50,60,10,1,282,India
562882,2024-02-07,201,paneer,210,340,130,1,282,India
267410,2024-02-07,212,amul cheese,250,315,65,1,110,India
267410,2024-02-07,206,yakult,360,400,40,1,110,India
267410,2024-02-07,208,sprite,75,100,25,1,110,India
267410,2024-02-07,211,red bull,90,125,35,1,110,India
267410,2024-02-07,204,strawberry yogurt,50,60,10,1,110,India
777755,2024-02-07,209,pepsi,75,100,25,1,295,India
777755,2024-02-07,206,yakult,360,400,40,1,295,India
777755,2024-02-07,213,bisleri,6,15,9,1,295,India
777755,2024-02-07,210,mountain dew,75,100,25,1,295,India
972879,2024-02-07,210,mountain dew,75,100,25,1,116,India
692709,2024-02-07,203,mango yogurt,50,60,10,1,212,India
692709,2024-02-07,209,pepsi,75,100,25,1,212,India
846116,2024-02-07,204,strawberry yogurt,50,60,10,1,13,India
846116,2024-02-07,203,mango yogurt,50,60,10,1,13,India
142470,2024-02-07,207,coca cola,75,100,25,1,49,India
142470,2024-02-07,202,milk,12,27,15,1,49,India
142470,2024-02-07,211,red bull,90,125,35,1,49,India
146960,2024-02-07,202,milk,12,27,15,1,119,India
146960,2024-02-07,208,sprite,75,100,25,1,119,India
146960,2024-02-07,203,mango yogurt,50,60,10,1,119,India
157321,2024-02-07,205,classic yogurt,45,60,15,1,73,India
320677,2024-02-07,201,paneer,210,340,130,1,497,India
320677,2024-02-07,213,bisleri,6,15,9,1,497,India
956399,2024-02-07,203,mango yogurt,50,60,10,1,483,India
956399,2024-02-07,207,coca cola,75,100,25,1,483,India
956399,2024-02-07,212,amul cheese,250,315,65,1,483,India
303278,2024-02-07,211,red bull,90,125,35,1,316,India
303278,2024-02-07,209,pepsi,75,100,25,1,316,India
303278,2024-02-07,210,mountain dew,75,100,25,1,316,India
787562,2024-02-07,201,paneer,210,340,130,1,213,India
787562,2024-02-07,212,amul cheese,250,315,65,1,213,India
787562,2024-02-07,209,pepsi,75,100,25,1,213,India
787562,2024-02-07,206,yakult,360,400,40,1,213,India
282069,2024-02-07,201,paneer,210,340,130,1,333,India
282069,2024-02-07,212,amul cheese,250,315,65,1,333,India
282069,2024-02-07,204,strawberry yogurt,50,60,10,1,333,India
921983,2024-02-07,207,coca cola,75,100,25,1,9,India
921983,2024-02-07,210,mountain dew,75,100,25,1,9,India
321263,2024-02-07,213,bisleri,6,15,9,1,173,India
321263,2024-02-07,201,paneer,210,340,130,1,173,India
321263,2024-02-07,207,coca cola,75,100,25,1,173,India
541600,2024-02-07,204,strawberry yogurt,50,60,10,1,304,India
541600,2024-02-07,209,pepsi,75,100,25,1,304,India
541600,2024-02-07,208,sprite,75,100,25,1,304,India
301866,2024-02-07,213,bisleri,6,15,9,1,271,India
301866,2024-02-07,204,strawberry yogurt,50,60,10,1,271,India
301866,2024-02-07,208,sprite,75,100,25,1,271,India
301866,2024-02-07,210,mountain dew,75,100,25,1,271,India
301866,2024-02-07,203,mango yogurt,50,60,10,1,271,India
199560,2024-02-07,213,bisleri,6,15,9,1,333,India
199560,2024-02-07,208,sprite,75,100,25,1,333,India
199560,2024-02-07,201,paneer,210,340,130,1,333,India
199560,2024-02-07,207,coca cola,75,100,25,1,333,India
199560,2024-02-07,210,mountain dew,75,100,25,1,333,India
936532,2024-02-07,205,classic yogurt,45,60,15,1,440,India
936532,2024-02-07,207,coca cola,75,100,25,1,440,India
936532,2024-02-07,202,milk,12,27,15,1,440,India
936532,2024-02-07,203,mango yogurt,50,60,10,1,440,India
975144,2024-02-07,206,yakult,360,400,40,1,117,India
975144,2024-02-07,210,mountain dew,75,100,25,1,117,India
975144,2024-02-07,212,amul cheese,250,315,65,1,117,India
942133,2024-02-07,201,paneer,210,340,130,1,247,India
942133,2024-02-07,213,bisleri,6,15,9,1,247,India
672789,2024-02-07,209,pepsi,75,100,25,1,486,India
672789,2024-02-07,204,strawberry yogurt,50,60,10,1,486,India
672789,2024-02-07,205,classic yogurt,45,60,15,1,486,India
970340,2024-02-07,204,strawberry yogurt,50,60,10,1,16,India
221882,2024-02-07,210,mountain dew,75,100,25,1,352,India
221882,2024-02-07,211,red bull,90,125,35,1,352,India
221882,2024-02-07,204,strawberry yogurt,50,60,10,1,352,India
221882,2024-02-07,206,yakult,360,400,40,1,352,India
221882,2024-02-07,208,sprite,75,100,25,1,352,India
623021,2024-02-07,204,strawberry yogurt,50,60,10,1,92,India
623021,2024-02-07,201,paneer,210,340,130,1,92,India
623021,2024-02-07,210,mountain dew,75,100,25,1,92,India
744047,2024-02-07,208,sprite,75,100,25,1,276,India
929348,2024-02-07,201,paneer,210,340,130,1,483,India
286665,2024-02-07,206,yakult,360,400,40,1,71,India
286665,2024-02-07,211,red bull,90,125,35,1,71,India
286665,2024-02-07,212,amul cheese,250,315,65,1,71,India
478221,2024-02-07,203,mango yogurt,50,60,10,1,355,India
478221,2024-02-07,207,coca cola,75,100,25,1,355,India
478221,2024-02-07,209,pepsi,75,100,25,1,355,India
478221,2024-02-07,210,mountain dew,75,100,25,1,355,India
478221,2024-02-07,206,yakult,360,400,40,1,355,India
891589,2024-02-07,203,mango yogurt,50,60,10,1,241,India
891589,2024-02-07,208,sprite,75,100,25,1,241,India
891589,2024-02-07,212,amul cheese,250,315,65,1,241,India
284311,2024-02-07,202,milk,12,27,15,1,469,India
284311,2024-02-07,203,mango yogurt,50,60,10,1,469,India
340870,2024-02-07,207,coca cola,75,100,25,1,357,India
340870,2024-02-07,208,sprite,75,100,25,1,357,India
340870,2024-02-07,205,classic yogurt,45,60,15,1,357,India
860877,2024-02-07,206,yakult,360,400,40,1,143,India
132505,2024-02-07,203,mango yogurt,50,60,10,1,500,India
132505,2024-02-07,209,pepsi,75,100,25,1,500,India
711717,2024-02-07,210,mountain dew,75,100,25,1,77,India
640315,2024-02-07,201,paneer,210,340,130,1,19,India
833383,2024-02-07,204,strawberry yogurt,50,60,10,1,323,India
833383,2024-02-07,202,milk,12,27,15,1,323,India
833383,2024-02-07,207,coca cola,75,100,25,1,323,India
833383,2024-02-07,203,mango yogurt,50,60,10,1,323,India
838572,2024-02-07,210,mountain dew,75,100,25,1,273,India
838572,2024-02-07,203,mango yogurt,50,60,10,1,273,India
445944,2024-02-07,209,pepsi,75,100,25,1,87,India
445944,2024-02-07,206,yakult,360,400,40,1,87,India
901627,2024-02-07,205,classic yogurt,45,60,15,1,308,India
901627,2024-02-07,207,coca cola,75,100,25,1,308,India
901627,2024-02-07,213,bisleri,6,15,9,1,308,India
317675,2024-02-07,210,mountain dew,75,100,25,1,206,India
317675,2024-02-07,208,sprite,75,100,25,1,206,India
317675,2024-02-07,204,strawberry yogurt,50,60,10,1,206,India
317675,2024-02-07,211,red bull,90,125,35,1,206,India
871472,2024-02-07,204,strawberry yogurt,50,60,10,1,436,India
871472,2024-02-07,207,coca cola,75,100,25,1,436,India
932499,2024-02-07,211,red bull,90,125,35,1,139,India
932499,2024-02-07,209,pepsi,75,100,25,1,139,India
932499,2024-02-07,201,paneer,210,340,130,1,139,India
349411,2024-02-07,207,coca cola,75,100,25,1,227,India
452765,2024-02-07,201,paneer,210,340,130,1,437,India
182030,2024-02-07,211,red bull,90,125,35,1,425,India
497687,2024-02-07,209,pepsi,75,100,25,1,339,India
497687,2024-02-07,203,mango yogurt,50,60,10,1,339,India
497687,2024-02-07,211,red bull,90,125,35,1,339,India
301762,2024-02-07,205,classic yogurt,45,60,15,1,41,India
301762,2024-02-07,201,paneer,210,340,130,1,41,India
301762,2024-02-07,202,milk,12,27,15,1,41,India
301762,2024-02-07,210,mountain dew,75,100,25,1,41,India
115259,2024-02-07,207,coca cola,75,100,25,1,282,India
115259,2024-02-07,212,amul cheese,250,315,65,1,282,India
115259,2024-02-07,211,red bull,90,125,35,1,282,India
815237,2024-02-07,205,classic yogurt,45,60,15,1,226,India
815237,2024-02-07,208,sprite,75,100,25,1,226,India
375110,2024-02-07,211,red bull,90,125,35,1,263,India
375110,2024-02-07,207,coca cola,75,100,25,1,263,India
375110,2024-02-07,213,bisleri,6,15,9,1,263,India
508511,2024-02-08,201,paneer,210,340,130,1,281,India
508511,2024-02-08,212,amul cheese,250,315,65,1,281,India
508511,2024-02-08,202,milk,12,27,15,1,281,India
864127,2024-02-08,212,amul cheese,250,315,65,1,5,India
864127,2024-02-08,213,bisleri,6,15,9,1,5,India
864127,2024-02-08,210,mountain dew,75,100,25,1,5,India
864127,2024-02-08,204,strawberry yogurt,50,60,10,1,5,India
356083,2024-02-08,203,mango yogurt,50,60,10,1,1,India
449379,2024-02-08,209,pepsi,75,100,25,1,209,India
101328,2024-02-08,212,amul cheese,250,315,65,1,375,India
101328,2024-02-08,204,strawberry yogurt,50,60,10,1,375,India
101328,2024-02-08,207,coca cola,75,100,25,1,375,India
101328,2024-02-08,205,classic yogurt,45,60,15,1,375,India
588443,2024-02-08,211,red bull,90,125,35,1,150,India
588443,2024-02-08,207,coca cola,75,100,25,1,150,India
588443,2024-02-08,213,bisleri,6,15,9,1,150,India
427815,2024-02-08,209,pepsi,75,100,25,1,381,India
427815,2024-02-08,205,classic yogurt,45,60,15,1,381,India
427815,2024-02-08,208,sprite,75,100,25,1,381,India
427815,2024-02-08,201,paneer,210,340,130,1,381,India
427815,2024-02-08,204,strawberry yogurt,50,60,10,1,381,India
381467,2024-02-08,204,strawberry yogurt,50,60,10,1,414,India
381467,2024-02-08,207,coca cola,75,100,25,1,414,India
381467,2024-02-08,203,mango yogurt,50,60,10,1,414,India
381467,2024-02-08,205,classic yogurt,45,60,15,1,414,India
171504,2024-02-08,202,milk,12,27,15,1,19,India
171504,2024-02-08,210,mountain dew,75,100,25,1,19,India
326577,2024-02-08,205,classic yogurt,45,60,15,1,163,India
103633,2024-02-08,205,classic yogurt,45,60,15,1,399,India
103633,2024-02-08,206,yakult,360,400,40,1,399,India
720842,2024-02-08,206,yakult,360,400,40,1,268,India
375689,2024-02-08,202,milk,12,27,15,1,71,India
375689,2024-02-08,213,bisleri,6,15,9,1,71,India
375689,2024-02-08,201,paneer,210,340,130,1,71,India
375689,2024-02-08,207,coca cola,75,100,25,1,71,India
105310,2024-02-08,203,mango yogurt,50,60,10,1,448,India
105310,2024-02-08,206,yakult,360,400,40,1,448,India
105310,2024-02-08,202,milk,12,27,15,1,448,India
105310,2024-02-08,207,coca cola,75,100,25,1,448,India
105310,2024-02-08,208,sprite,75,100,25,1,448,India
682203,2024-02-08,205,classic yogurt,45,60,15,1,299,India
682203,2024-02-08,203,mango yogurt,50,60,10,1,299,India
682203,2024-02-08,207,coca cola,75,100,25,1,299,India
682203,2024-02-08,206,yakult,360,400,40,1,299,India
682203,2024-02-08,210,mountain dew,75,100,25,1,299,India
253177,2024-02-08,210,mountain dew,75,100,25,1,477,India
253177,2024-02-08,201,paneer,210,340,130,1,477,India
322802,2024-02-08,210,mountain dew,75,100,25,1,25,India
322802,2024-02-08,208,sprite,75,100,25,1,25,India
322802,2024-02-08,207,coca cola,75,100,25,1,25,India
322802,2024-02-08,209,pepsi,75,100,25,1,25,India
249662,2024-02-08,201,paneer,210,340,130,1,455,India
510512,2024-02-08,203,mango yogurt,50,60,10,1,106,India
510512,2024-02-08,202,milk,12,27,15,1,106,India
148752,2024-02-08,206,yakult,360,400,40,1,43,India
489234,2024-02-08,203,mango yogurt,50,60,10,1,481,India
489234,2024-02-08,201,paneer,210,340,130,1,481,India
489234,2024-02-08,205,classic yogurt,45,60,15,1,481,India
489234,2024-02-08,208,sprite,75,100,25,1,481,India
454935,2024-02-08,210,mountain dew,75,100,25,1,78,India
454935,2024-02-08,206,yakult,360,400,40,1,78,India
454935,2024-02-08,211,red bull,90,125,35,1,78,India
591046,2024-02-08,203,mango yogurt,50,60,10,1,153,India
591046,2024-02-08,212,amul cheese,250,315,65,1,153,India
177373,2024-02-08,203,mango yogurt,50,60,10,1,127,India
177373,2024-02-08,210,mountain dew,75,100,25,1,127,India
177373,2024-02-08,208,sprite,75,100,25,1,127,India
177373,2024-02-08,201,paneer,210,340,130,1,127,India
177373,2024-02-08,206,yakult,360,400,40,1,127,India
591670,2024-02-08,212,amul cheese,250,315,65,1,70,India
591670,2024-02-08,202,milk,12,27,15,1,70,India
591670,2024-02-08,210,mountain dew,75,100,25,1,70,India
591670,2024-02-08,208,sprite,75,100,25,1,70,India
591670,2024-02-08,201,paneer,210,340,130,1,70,India
689654,2024-02-08,209,pepsi,75,100,25,1,395,India
689654,2024-02-08,208,sprite,75,100,25,1,395,India
689654,2024-02-08,210,mountain dew,75,100,25,1,395,India
689654,2024-02-08,202,milk,12,27,15,1,395,India
689654,2024-02-08,211,red bull,90,125,35,1,395,India
958064,2024-02-08,203,mango yogurt,50,60,10,1,276,India
773961,2024-02-08,201,paneer,210,340,130,1,13,India
773961,2024-02-08,211,red bull,90,125,35,1,13,India
234663,2024-02-08,210,mountain dew,75,100,25,1,240,India
234663,2024-02-08,203,mango yogurt,50,60,10,1,240,India
806961,2024-02-08,206,yakult,360,400,40,1,50,India
806961,2024-02-08,210,mountain dew,75,100,25,1,50,India
806961,2024-02-08,201,paneer,210,340,130,1,50,India
304331,2024-02-08,209,pepsi,75,100,25,1,267,India
304331,2024-02-08,213,bisleri,6,15,9,1,267,India
304331,2024-02-08,205,classic yogurt,45,60,15,1,267,India
411578,2024-02-08,208,sprite,75,100,25,1,424,India
411578,2024-02-08,207,coca cola,75,100,25,1,424,India
411578,2024-02-08,206,yakult,360,400,40,1,424,India
411578,2024-02-08,204,strawberry yogurt,50,60,10,1,424,India
301203,2024-02-08,210,mountain dew,75,100,25,1,288,India
301203,2024-02-08,211,red bull,90,125,35,1,288,India
301203,2024-02-08,201,paneer,210,340,130,1,288,India
301203,2024-02-08,202,milk,12,27,15,1,288,India
545782,2024-02-08,211,red bull,90,125,35,1,305,India
545782,2024-02-08,202,milk,12,27,15,1,305,India
545782,2024-02-08,203,mango yogurt,50,60,10,1,305,India
545782,2024-02-08,213,bisleri,6,15,9,1,305,India
545782,2024-02-08,212,amul cheese,250,315,65,1,305,India
392712,2024-02-08,212,amul cheese,250,315,65,1,180,India
392712,2024-02-08,205,classic yogurt,45,60,15,1,180,India
842921,2024-02-08,204,strawberry yogurt,50,60,10,1,25,India
842921,2024-02-08,213,bisleri,6,15,9,1,25,India
662606,2024-02-08,204,strawberry yogurt,50,60,10,1,92,India
662606,2024-02-08,203,mango yogurt,50,60,10,1,92,India
535672,2024-02-08,208,sprite,75,100,25,1,205,India
535672,2024-02-08,202,milk,12,27,15,1,205,India
535672,2024-02-08,204,strawberry yogurt,50,60,10,1,205,India
535672,2024-02-08,205,classic yogurt,45,60,15,1,205,India
727343,2024-02-08,201,paneer,210,340,130,1,304,India
727343,2024-02-08,207,coca cola,75,100,25,1,304,India
187714,2024-02-08,201,paneer,210,340,130,1,225,India
187714,2024-02-08,210,mountain dew,75,100,25,1,225,India
885217,2024-02-08,208,sprite,75,100,25,1,82,India
885217,2024-02-08,207,coca cola,75,100,25,1,82,India
885217,2024-02-08,206,yakult,360,400,40,1,82,India
885217,2024-02-08,213,bisleri,6,15,9,1,82,India
288424,2024-02-08,209,pepsi,75,100,25,1,445,India
288424,2024-02-08,213,bisleri,6,15,9,1,445,India
288424,2024-02-08,203,mango yogurt,50,60,10,1,445,India
288424,2024-02-08,207,coca cola,75,100,25,1,445,India
542608,2024-02-08,208,sprite,75,100,25,1,389,India
542608,2024-02-08,203,mango yogurt,50,60,10,1,389,India
542608,2024-02-08,206,yakult,360,400,40,1,389,India
542608,2024-02-08,207,coca cola,75,100,25,1,389,India
165930,2024-02-08,204,strawberry yogurt,50,60,10,1,427,India
165930,2024-02-08,205,classic yogurt,45,60,15,1,427,India
165930,2024-02-08,212,amul cheese,250,315,65,1,427,India
465517,2024-02-08,205,classic yogurt,45,60,15,1,145,India
465517,2024-02-08,202,milk,12,27,15,1,145,India
866860,2024-02-08,206,yakult,360,400,40,1,377,India
230024,2024-02-08,211,red bull,90,125,35,1,246,India
902396,2024-02-08,201,paneer,210,340,130,1,30,India
649571,2024-02-08,202,milk,12,27,15,1,345,India
605793,2024-02-08,206,yakult,360,400,40,1,275,India
605793,2024-02-08,210,mountain dew,75,100,25,1,275,India
605793,2024-02-08,209,pepsi,75,100,25,1,275,India
605793,2024-02-08,211,red bull,90,125,35,1,275,India
445980,2024-02-08,201,paneer,210,340,130,1,172,India
800411,2024-02-08,201,paneer,210,340,130,1,355,India
800411,2024-02-08,208,sprite,75,100,25,1,355,India
800411,2024-02-08,205,classic yogurt,45,60,15,1,355,India
800411,2024-02-08,211,red bull,90,125,35,1,355,India
621385,2024-02-08,202,milk,12,27,15,1,469,India
581360,2024-02-08,207,coca cola,75,100,25,1,111,India
581360,2024-02-08,211,red bull,90,125,35,1,111,India
554321,2024-02-08,213,bisleri,6,15,9,1,270,India
554321,2024-02-08,208,sprite,75,100,25,1,270,India
554321,2024-02-08,207,coca cola,75,100,25,1,270,India
554321,2024-02-08,203,mango yogurt,50,60,10,1,270,India
742991,2024-02-08,203,mango yogurt,50,60,10,1,108,India
742991,2024-02-08,208,sprite,75,100,25,1,108,India
462011,2024-02-08,205,classic yogurt,45,60,15,1,447,India
415771,2024-02-08,201,paneer,210,340,130,1,490,India
415771,2024-02-08,207,coca cola,75,100,25,1,490,India
415771,2024-02-08,211,red bull,90,125,35,1,490,India
415771,2024-02-08,210,mountain dew,75,100,25,1,490,India
415771,2024-02-08,212,amul cheese,250,315,65,1,490,India
340146,2024-02-08,213,bisleri,6,15,9,1,20,India
340146,2024-02-08,212,amul cheese,250,315,65,1,20,India
340146,2024-02-08,206,yakult,360,400,40,1,20,India
340146,2024-02-08,202,milk,12,27,15,1,20,India
392967,2024-02-08,201,paneer,210,340,130,1,39,India
392967,2024-02-08,210,mountain dew,75,100,25,1,39,India
392967,2024-02-08,205,classic yogurt,45,60,15,1,39,India
415743,2024-02-08,202,milk,12,27,15,1,406,India
415743,2024-02-08,210,mountain dew,75,100,25,1,406,India
415743,2024-02-08,211,red bull,90,125,35,1,406,India
415743,2024-02-08,212,amul cheese,250,315,65,1,406,India
415743,2024-02-08,205,classic yogurt,45,60,15,1,406,India
737612,2024-02-09,209,pepsi,75,100,25,1,463,India
455767,2024-02-09,206,yakult,360,400,40,1,331,India
246744,2024-02-09,206,yakult,360,400,40,1,425,India
818426,2024-02-09,208,sprite,75,100,25,1,493,India
818426,2024-02-09,207,coca cola,75,100,25,1,493,India
818426,2024-02-09,211,red bull,90,125,35,1,493,India
818426,2024-02-09,203,mango yogurt,50,60,10,1,493,India
818426,2024-02-09,206,yakult,360,400,40,1,493,India
703242,2024-02-09,213,bisleri,6,15,9,1,494,India
703242,2024-02-09,209,pepsi,75,100,25,1,494,India
703242,2024-02-09,202,milk,12,27,15,1,494,India
703242,2024-02-09,212,amul cheese,250,315,65,1,494,India
383185,2024-02-09,206,yakult,360,400,40,1,420,India
383185,2024-02-09,201,paneer,210,340,130,1,420,India
992038,2024-02-09,202,milk,12,27,15,1,242,India
992038,2024-02-09,212,amul cheese,250,315,65,1,242,India
992038,2024-02-09,211,red bull,90,125,35,1,242,India
992038,2024-02-09,207,coca cola,75,100,25,1,242,India
656400,2024-02-09,212,amul cheese,250,315,65,1,472,India
656400,2024-02-09,207,coca cola,75,100,25,1,472,India
399898,2024-02-09,202,milk,12,27,15,1,395,India
589897,2024-02-09,213,bisleri,6,15,9,1,82,India
589897,2024-02-09,203,mango yogurt,50,60,10,1,82,India
589897,2024-02-09,209,pepsi,75,100,25,1,82,India
589897,2024-02-09,211,red bull,90,125,35,1,82,India
218740,2024-02-09,201,paneer,210,340,130,1,44,India
208836,2024-02-09,205,classic yogurt,45,60,15,1,496,India
208836,2024-02-09,203,mango yogurt,50,60,10,1,496,India
603474,2024-02-09,205,classic yogurt,45,60,15,1,446,India
603474,2024-02-09,201,paneer,210,340,130,1,446,India
603474,2024-02-09,211,red bull,90,125,35,1,446,India
802780,2024-02-09,210,mountain dew,75,100,25,1,352,India
802780,2024-02-09,212,amul cheese,250,315,65,1,352,India
783053,2024-02-09,202,milk,12,27,15,1,424,India
783053,2024-02-09,204,strawberry yogurt,50,60,10,1,424,India
460966,2024-02-09,208,sprite,75,100,25,1,202,India
460966,2024-02-09,203,mango yogurt,50,60,10,1,202,India
121037,2024-02-09,211,red bull,90,125,35,1,453,India
121037,2024-02-09,201,paneer,210,340,130,1,453,India
870788,2024-02-09,207,coca cola,75,100,25,1,90,India
117972,2024-02-09,206,yakult,360,400,40,1,458,India
117972,2024-02-09,208,sprite,75,100,25,1,458,India
117972,2024-02-09,204,strawberry yogurt,50,60,10,1,458,India
765319,2024-02-09,211,red bull,90,125,35,1,54,India
765319,2024-02-09,212,amul cheese,250,315,65,1,54,India
765319,2024-02-09,207,coca cola,75,100,25,1,54,India
768686,2024-02-09,201,paneer,210,340,130,1,185,India
768686,2024-02-09,207,coca cola,75,100,25,1,185,India
768686,2024-02-09,206,yakult,360,400,40,1,185,India
768686,2024-02-09,208,sprite,75,100,25,1,185,India
412107,2024-02-09,205,classic yogurt,45,60,15,1,423,India
102591,2024-02-09,207,coca cola,75,100,25,1,60,India
897736,2024-02-09,208,sprite,75,100,25,1,277,India
897736,2024-02-09,204,strawberry yogurt,50,60,10,1,277,India
897736,2024-02-09,206,yakult,360,400,40,1,277,India
897736,2024-02-09,202,milk,12,27,15,1,277,India
581368,2024-02-09,207,coca cola,75,100,25,1,328,India
581368,2024-02-09,208,sprite,75,100,25,1,328,India
581368,2024-02-09,206,yakult,360,400,40,1,328,India
721665,2024-02-09,202,milk,12,27,15,1,128,India
721665,2024-02-09,208,sprite,75,100,25,1,128,India
721665,2024-02-09,205,classic yogurt,45,60,15,1,128,India
721665,2024-02-09,210,mountain dew,75,100,25,1,128,India
702148,2024-02-09,202,milk,12,27,15,1,200,India
702148,2024-02-09,209,pepsi,75,100,25,1,200,India
702148,2024-02-09,205,classic yogurt,45,60,15,1,200,India
702148,2024-02-09,210,mountain dew,75,100,25,1,200,India
682181,2024-02-09,208,sprite,75,100,25,1,456,India
739388,2024-02-09,207,coca cola,75,100,25,1,342,India
739388,2024-02-09,212,amul cheese,250,315,65,1,342,India
739388,2024-02-09,201,paneer,210,340,130,1,342,India
532882,2024-02-09,211,red bull,90,125,35,1,396,India
532882,2024-02-09,213,bisleri,6,15,9,1,396,India
532882,2024-02-09,205,classic yogurt,45,60,15,1,396,India
363948,2024-02-09,211,red bull,90,125,35,1,164,India
363948,2024-02-09,201,paneer,210,340,130,1,164,India
356649,2024-02-09,211,red bull,90,125,35,1,249,India
356649,2024-02-09,203,mango yogurt,50,60,10,1,249,India
356649,2024-02-09,212,amul cheese,250,315,65,1,249,India
625468,2024-02-09,202,milk,12,27,15,1,34,India
625468,2024-02-09,206,yakult,360,400,40,1,34,India
625468,2024-02-09,211,red bull,90,125,35,1,34,India
625468,2024-02-09,208,sprite,75,100,25,1,34,India
479428,2024-02-09,206,yakult,360,400,40,1,153,India
479428,2024-02-09,204,strawberry yogurt,50,60,10,1,153,India
479428,2024-02-09,208,sprite,75,100,25,1,153,India
479428,2024-02-09,205,classic yogurt,45,60,15,1,153,India
388061,2024-02-09,213,bisleri,6,15,9,1,17,India
388061,2024-02-09,204,strawberry yogurt,50,60,10,1,17,India
160686,2024-02-09,209,pepsi,75,100,25,1,159,India
160686,2024-02-09,201,paneer,210,340,130,1,159,India
160686,2024-02-09,206,yakult,360,400,40,1,159,India
160686,2024-02-09,204,strawberry yogurt,50,60,10,1,159,India
412237,2024-02-09,203,mango yogurt,50,60,10,1,99,India
786646,2024-02-09,210,mountain dew,75,100,25,1,104,India
339287,2024-02-09,206,yakult,360,400,40,1,118,India
339287,2024-02-09,211,red bull,90,125,35,1,118,India
339287,2024-02-09,210,mountain dew,75,100,25,1,118,India
339287,2024-02-09,209,pepsi,75,100,25,1,118,India
339287,2024-02-09,204,strawberry yogurt,50,60,10,1,118,India
298756,2024-02-09,209,pepsi,75,100,25,1,332,India
298756,2024-02-09,206,yakult,360,400,40,1,332,India
298756,2024-02-09,203,mango yogurt,50,60,10,1,332,India
201861,2024-02-09,208,sprite,75,100,25,1,193,India
201861,2024-02-09,211,red bull,90,125,35,1,193,India
201861,2024-02-09,203,mango yogurt,50,60,10,1,193,India
201861,2024-02-09,213,bisleri,6,15,9,1,193,India
216358,2024-02-09,205,classic yogurt,45,60,15,1,312,India
216358,2024-02-09,206,yakult,360,400,40,1,312,India
216358,2024-02-09,201,paneer,210,340,130,1,312,India
939856,2024-02-09,213,bisleri,6,15,9,1,83,India
640259,2024-02-09,201,paneer,210,340,130,1,254,India
640259,2024-02-09,213,bisleri,6,15,9,1,254,India
640259,2024-02-09,206,yakult,360,400,40,1,254,India
640259,2024-02-09,202,milk,12,27,15,1,254,India
553853,2024-02-09,211,red bull,90,125,35,1,47,India
553853,2024-02-09,208,sprite,75,100,25,1,47,India
553853,2024-02-09,201,paneer,210,340,130,1,47,India
553853,2024-02-09,204,strawberry yogurt,50,60,10,1,47,India
553853,2024-02-09,209,pepsi,75,100,25,1,47,India
635242,2024-02-09,203,mango yogurt,50,60,10,1,461,India
635242,2024-02-09,202,milk,12,27,15,1,461,India
635242,2024-02-09,207,coca cola,75,100,25,1,461,India
635242,2024-02-09,205,classic yogurt,45,60,15,1,461,India
635242,2024-02-09,206,yakult,360,400,40,1,461,India
941909,2024-02-09,202,milk,12,27,15,1,263,India
941909,2024-02-09,211,red bull,90,125,35,1,263,India
941909,2024-02-09,212,amul cheese,250,315,65,1,263,India
464929,2024-02-09,208,sprite,75,100,25,1,16,India
464929,2024-02-09,207,coca cola,75,100,25,1,16,India
464929,2024-02-09,204,strawberry yogurt,50,60,10,1,16,India
792211,2024-02-09,205,classic yogurt,45,60,15,1,135,India
792211,2024-02-09,209,pepsi,75,100,25,1,135,India
352106,2024-02-09,204,strawberry yogurt,50,60,10,1,34,India
376274,2024-02-09,205,classic yogurt,45,60,15,1,355,India
376274,2024-02-09,204,strawberry yogurt,50,60,10,1,355,India
376274,2024-02-09,209,pepsi,75,100,25,1,355,India
169951,2024-02-09,206,yakult,360,400,40,1,113,India
676877,2024-02-09,212,amul cheese,250,315,65,1,374,India
676877,2024-02-09,205,classic yogurt,45,60,15,1,374,India
676877,2024-02-09,210,mountain dew,75,100,25,1,374,India
676877,2024-02-09,204,strawberry yogurt,50,60,10,1,374,India
423224,2024-02-09,212,amul cheese,250,315,65,1,242,India
423224,2024-02-09,204,strawberry yogurt,50,60,10,1,242,India
423224,2024-02-09,213,bisleri,6,15,9,1,242,India
332601,2024-02-09,212,amul cheese,250,315,65,1,63,India
535739,2024-02-09,213,bisleri,6,15,9,1,479,India
535739,2024-02-09,208,sprite,75,100,25,1,479,India
535739,2024-02-09,212,amul cheese,250,315,65,1,479,India
823779,2024-02-09,201,paneer,210,340,130,1,229,India
974270,2024-02-09,206,yakult,360,400,40,1,366,India
974270,2024-02-09,203,mango yogurt,50,60,10,1,366,India
974270,2024-02-09,213,bisleri,6,15,9,1,366,India
974270,2024-02-09,210,mountain dew,75,100,25,1,366,India
994805,2024-02-09,208,sprite,75,100,25,1,280,India
994805,2024-02-09,213,bisleri,6,15,9,1,280,India
994805,2024-02-09,206,yakult,360,400,40,1,280,India
994805,2024-02-09,201,paneer,210,340,130,1,280,India
676864,2024-02-09,206,yakult,360,400,40,1,410,India
676864,2024-02-09,211,red bull,90,125,35,1,410,India
676864,2024-02-09,208,sprite,75,100,25,1,410,India
105982,2024-02-09,211,red bull,90,125,35,1,398,India
105982,2024-02-09,204,strawberry yogurt,50,60,10,1,398,India
105982,2024-02-09,203,mango yogurt,50,60,10,1,398,India
105982,2024-02-09,212,amul cheese,250,315,65,1,398,India
941491,2024-02-09,205,classic yogurt,45,60,15,1,233,India
941491,2024-02-09,202,milk,12,27,15,1,233,India
941491,2024-02-09,203,mango yogurt,50,60,10,1,233,India
759557,2024-02-09,204,strawberry yogurt,50,60,10,1,394,India
335051,2024-02-09,210,mountain dew,75,100,25,1,169,India
993157,2024-02-09,213,bisleri,6,15,9,1,308,India
922643,2024-02-09,201,paneer,210,340,130,1,240,India
922643,2024-02-09,205,classic yogurt,45,60,15,1,240,India
922643,2024-02-09,202,milk,12,27,15,1,240,India
774765,2024-02-09,208,sprite,75,100,25,1,70,India
774765,2024-02-09,209,pepsi,75,100,25,1,70,India
774765,2024-02-09,207,coca cola,75,100,25,1,70,India
223138,2024-02-09,201,paneer,210,340,130,1,393,India
223138,2024-02-09,213,bisleri,6,15,9,1,393,India
223138,2024-02-09,208,sprite,75,100,25,1,393,India
223138,2024-02-09,203,mango yogurt,50,60,10,1,393,India
211587,2024-02-09,202,milk,12,27,15,1,322,India
211587,2024-02-09,203,mango yogurt,50,60,10,1,322,India
963946,2024-02-09,205,classic yogurt,45,60,15,1,378,India
864766,2024-02-09,213,bisleri,6,15,9,1,281,India
864766,2024-02-09,205,classic yogurt,45,60,15,1,281,India
504903,2024-02-09,205,classic yogurt,45,60,15,1,396,India
504903,2024-02-09,210,mountain dew,75,100,25,1,396,India
937893,2024-02-09,201,paneer,210,340,130,1,296,India
937893,2024-02-09,209,pepsi,75,100,25,1,296,India
267715,2024-02-09,210,mountain dew,75,100,25,1,160,India
267715,2024-02-09,202,milk,12,27,15,1,160,India
758901,2024-02-09,202,milk,12,27,15,1,311,India
681859,2024-02-09,210,mountain dew,75,100,25,1,185,India
839028,2024-02-09,207,coca cola,75,100,25,1,117,India
839028,2024-02-09,211,red bull,90,125,35,1,117,India
839028,2024-02-09,201,paneer,210,340,130,1,117,India
839028,2024-02-09,212,amul cheese,250,315,65,1,117,India
835145,2024-02-09,204,strawberry yogurt,50,60,10,1,131,India
835145,2024-02-09,211,red bull,90,125,35,1,131,India
835145,2024-02-09,201,paneer,210,340,130,1,131,India
835145,2024-02-09,212,amul cheese,250,315,65,1,131,India
444484,2024-02-09,208,sprite,75,100,25,1,130,India
444484,2024-02-09,209,pepsi,75,100,25,1,130,India
611687,2024-02-09,201,paneer,210,340,130,1,101,India
791782,2024-02-09,213,bisleri,6,15,9,1,254,India
791782,2024-02-09,209,pepsi,75,100,25,1,254,India
791782,2024-02-09,212,amul cheese,250,315,65,1,254,India
791782,2024-02-09,210,mountain dew,75,100,25,1,254,India
966061,2024-02-09,212,amul cheese,250,315,65,1,276,India
966061,2024-02-09,208,sprite,75,100,25,1,276,India
966061,2024-02-09,202,milk,12,27,15,1,276,India
966061,2024-02-09,207,coca cola,75,100,25,1,276,India
966061,2024-02-09,210,mountain dew,75,100,25,1,276,India
346042,2024-02-09,211,red bull,90,125,35,1,454,India
346042,2024-02-09,202,milk,12,27,15,1,454,India
346042,2024-02-09,209,pepsi,75,100,25,1,454,India
327663,2024-02-09,205,classic yogurt,45,60,15,1,430,India
327663,2024-02-09,213,bisleri,6,15,9,1,430,India
469533,2024-02-09,203,mango yogurt,50,60,10,1,103,India
469533,2024-02-09,201,paneer,210,340,130,1,103,India
469533,2024-02-09,202,milk,12,27,15,1,103,India
469533,2024-02-09,213,bisleri,6,15,9,1,103,India
353980,2024-02-09,204,strawberry yogurt,50,60,10,1,360,India
382364,2024-02-09,207,coca cola,75,100,25,1,434,India
382364,2024-02-09,205,classic yogurt,45,60,15,1,434,India
382364,2024-02-09,209,pepsi,75,100,25,1,434,India
382364,2024-02-09,203,mango yogurt,50,60,10,1,434,India
382364,2024-02-09,211,red bull,90,125,35,1,434,India
665168,2024-02-09,205,classic yogurt,45,60,15,1,8,India
665168,2024-02-09,203,mango yogurt,50,60,10,1,8,India
823088,2024-02-09,209,pepsi,75,100,25,1,294,India
823088,2024-02-09,202,milk,12,27,15,1,294,India
823088,2024-02-09,211,red bull,90,125,35,1,294,India
823088,2024-02-09,203,mango yogurt,50,60,10,1,294,India
206177,2024-02-09,210,mountain dew,75,100,25,1,286,India
206177,2024-02-09,212,amul cheese,250,315,65,1,286,India
206177,2024-02-09,206,yakult,360,400,40,1,286,India
206177,2024-02-09,202,milk,12,27,15,1,286,India
206177,2024-02-09,203,mango yogurt,50,60,10,1,286,India
231676,2024-02-09,210,mountain dew,75,100,25,1,184,India
231676,2024-02-09,203,mango yogurt,50,60,10,1,184,India
919167,2024-02-09,212,amul cheese,250,315,65,1,107,India
919167,2024-02-09,203,mango yogurt,50,60,10,1,107,India
919167,2024-02-09,210,mountain dew,75,100,25,1,107,India
788480,2024-02-09,206,yakult,360,400,40,1,296,India
788480,2024-02-09,211,red bull,90,125,35,1,296,India
788480,2024-02-09,203,mango yogurt,50,60,10,1,296,India
587489,2024-02-09,206,yakult,360,400,40,1,310,India
587489,2024-02-09,211,red bull,90,125,35,1,310,India
587489,2024-02-09,209,pepsi,75,100,25,1,310,India
587489,2024-02-09,204,strawberry yogurt,50,60,10,1,310,India
587489,2024-02-09,201,paneer,210,340,130,1,310,India
512245,2024-02-09,210,mountain dew,75,100,25,1,56,India
512245,2024-02-09,201,paneer,210,340,130,1,56,India
512245,2024-02-09,209,pepsi,75,100,25,1,56,India
512245,2024-02-09,208,sprite,75,100,25,1,56,India
512245,2024-02-09,212,amul cheese,250,315,65,1,56,India
389844,2024-02-09,203,mango yogurt,50,60,10,1,470,India
713973,2024-02-09,204,strawberry yogurt,50,60,10,1,289,India
713973,2024-02-09,201,paneer,210,340,130,1,289,India
915361,2024-02-10,210,mountain dew,75,100,25,1,177,India
949335,2024-02-10,208,sprite,75,100,25,1,173,India
949335,2024-02-10,207,coca cola,75,100,25,1,173,India
929760,2024-02-10,201,paneer,210,340,130,1,400,India
929760,2024-02-10,210,mountain dew,75,100,25,1,400,India
962817,2024-02-10,202,milk,12,27,15,1,36,India
962817,2024-02-10,212,amul cheese,250,315,65,1,36,India
962817,2024-02-10,209,pepsi,75,100,25,1,36,India
644056,2024-02-10,210,mountain dew,75,100,25,1,356,India
122763,2024-02-10,203,mango yogurt,50,60,10,1,146,India
122763,2024-02-10,211,red bull,90,125,35,1,146,India
865063,2024-02-10,213,bisleri,6,15,9,1,156,India
865063,2024-02-10,212,amul cheese,250,315,65,1,156,India
865063,2024-02-10,203,mango yogurt,50,60,10,1,156,India
865063,2024-02-10,204,strawberry yogurt,50,60,10,1,156,India
865063,2024-02-10,210,mountain dew,75,100,25,1,156,India
986663,2024-02-10,204,strawberry yogurt,50,60,10,1,122,India
986663,2024-02-10,212,amul cheese,250,315,65,1,122,India
987388,2024-02-10,204,strawberry yogurt,50,60,10,1,177,India
385968,2024-02-10,213,bisleri,6,15,9,1,325,India
385968,2024-02-10,208,sprite,75,100,25,1,325,India
385968,2024-02-10,201,paneer,210,340,130,1,325,India
385968,2024-02-10,202,milk,12,27,15,1,325,India
318709,2024-02-10,204,strawberry yogurt,50,60,10,1,154,India
318709,2024-02-10,208,sprite,75,100,25,1,154,India
318709,2024-02-10,210,mountain dew,75,100,25,1,154,India
318709,2024-02-10,211,red bull,90,125,35,1,154,India
302398,2024-02-10,210,mountain dew,75,100,25,1,489,India
901470,2024-02-10,213,bisleri,6,15,9,1,175,India
313180,2024-02-10,213,bisleri,6,15,9,1,231,India
313180,2024-02-10,211,red bull,90,125,35,1,231,India
868060,2024-02-10,207,coca cola,75,100,25,1,287,India
868060,2024-02-10,204,strawberry yogurt,50,60,10,1,287,India
868060,2024-02-10,211,red bull,90,125,35,1,287,India
924358,2024-02-10,210,mountain dew,75,100,25,1,462,India
924358,2024-02-10,213,bisleri,6,15,9,1,462,India
924358,2024-02-10,202,milk,12,27,15,1,462,India
924358,2024-02-10,201,paneer,210,340,130,1,462,India
924358,2024-02-10,203,mango yogurt,50,60,10,1,462,India
893488,2024-02-10,203,mango yogurt,50,60,10,1,248,India
893488,2024-02-10,213,bisleri,6,15,9,1,248,India
893488,2024-02-10,204,strawberry yogurt,50,60,10,1,248,India
408827,2024-02-10,203,mango yogurt,50,60,10,1,96,India
408827,2024-02-10,201,paneer,210,340,130,1,96,India
852800,2024-02-10,208,sprite,75,100,25,1,278,India
799750,2024-02-10,207,coca cola,75,100,25,1,89,India
799750,2024-02-10,210,mountain dew,75,100,25,1,89,India
497298,2024-02-10,210,mountain dew,75,100,25,1,56,India
300260,2024-02-10,201,paneer,210,340,130,1,200,India
300260,2024-02-10,213,bisleri,6,15,9,1,200,India
300260,2024-02-10,204,strawberry yogurt,50,60,10,1,200,India
536875,2024-02-10,205,classic yogurt,45,60,15,1,370,India
536875,2024-02-10,202,milk,12,27,15,1,370,India
994603,2024-02-10,202,milk,12,27,15,1,2,India
994603,2024-02-10,204,strawberry yogurt,50,60,10,1,2,India
994603,2024-02-10,210,mountain dew,75,100,25,1,2,India
179176,2024-02-10,211,red bull,90,125,35,1,119,India
179176,2024-02-10,203,mango yogurt,50,60,10,1,119,India
179176,2024-02-10,208,sprite,75,100,25,1,119,India
179176,2024-02-10,212,amul cheese,250,315,65,1,119,India
179176,2024-02-10,213,bisleri,6,15,9,1,119,India
845171,2024-02-10,211,red bull,90,125,35,1,472,India
845171,2024-02-10,204,strawberry yogurt,50,60,10,1,472,India
845171,2024-02-10,208,sprite,75,100,25,1,472,India
845171,2024-02-10,205,classic yogurt,45,60,15,1,472,India
502214,2024-02-10,203,mango yogurt,50,60,10,1,48,India
816026,2024-02-10,201,paneer,210,340,130,1,477,India
422988,2024-02-10,210,mountain dew,75,100,25,1,487,India
633671,2024-02-10,203,mango yogurt,50,60,10,1,495,India
633671,2024-02-10,204,strawberry yogurt,50,60,10,1,495,India
633671,2024-02-10,201,paneer,210,340,130,1,495,India
633671,2024-02-10,207,coca cola,75,100,25,1,495,India
971984,2024-02-10,210,mountain dew,75,100,25,1,466,India
971984,2024-02-10,209,pepsi,75,100,25,1,466,India
289079,2024-02-10,207,coca cola,75,100,25,1,320,India
289079,2024-02-10,208,sprite,75,100,25,1,320,India
289079,2024-02-10,213,bisleri,6,15,9,1,320,India
289079,2024-02-10,201,paneer,210,340,130,1,320,India
836000,2024-02-10,213,bisleri,6,15,9,1,121,India
836000,2024-02-10,209,pepsi,75,100,25,1,121,India
836000,2024-02-10,202,milk,12,27,15,1,121,India
836000,2024-02-10,205,classic yogurt,45,60,15,1,121,India
836000,2024-02-10,212,amul cheese,250,315,65,1,121,India
213615,2024-02-10,203,mango yogurt,50,60,10,1,334,India
213615,2024-02-10,208,sprite,75,100,25,1,334,India
213615,2024-02-10,204,strawberry yogurt,50,60,10,1,334,India
213615,2024-02-10,211,red bull,90,125,35,1,334,India
282554,2024-02-10,213,bisleri,6,15,9,1,12,India
282554,2024-02-10,204,strawberry yogurt,50,60,10,1,12,India
282554,2024-02-10,212,amul cheese,250,315,65,1,12,India
693102,2024-02-10,203,mango yogurt,50,60,10,1,196,India
693102,2024-02-10,204,strawberry yogurt,50,60,10,1,196,India
693102,2024-02-10,205,classic yogurt,45,60,15,1,196,India
467921,2024-02-10,205,classic yogurt,45,60,15,1,81,India
495397,2024-02-10,206,yakult,360,400,40,1,416,India
495397,2024-02-10,213,bisleri,6,15,9,1,416,India
495397,2024-02-10,205,classic yogurt,45,60,15,1,416,India
348042,2024-02-10,206,yakult,360,400,40,1,410,India
640207,2024-02-10,206,yakult,360,400,40,1,344,India
640207,2024-02-10,211,red bull,90,125,35,1,344,India
894143,2024-02-10,207,coca cola,75,100,25,1,435,India
323999,2024-02-10,206,yakult,360,400,40,1,429,India
406030,2024-02-10,202,milk,12,27,15,1,369,India
406030,2024-02-10,211,red bull,90,125,35,1,369,India
406030,2024-02-10,206,yakult,360,400,40,1,369,India
671866,2024-02-10,213,bisleri,6,15,9,1,321,India
671866,2024-02-10,206,yakult,360,400,40,1,321,India
733836,2024-02-10,203,mango yogurt,50,60,10,1,232,India
733836,2024-02-10,209,pepsi,75,100,25,1,232,India
733836,2024-02-10,201,paneer,210,340,130,1,232,India
370579,2024-02-10,213,bisleri,6,15,9,1,15,India
370579,2024-02-10,202,milk,12,27,15,1,15,India
370579,2024-02-10,206,yakult,360,400,40,1,15,India
370579,2024-02-10,207,coca cola,75,100,25,1,15,India
370579,2024-02-10,212,amul cheese,250,315,65,1,15,India
850085,2024-02-10,202,milk,12,27,15,1,90,India
850085,2024-02-10,204,strawberry yogurt,50,60,10,1,90,India
850085,2024-02-10,210,mountain dew,75,100,25,1,90,India
850085,2024-02-10,201,paneer,210,340,130,1,90,India
200043,2024-02-10,209,pepsi,75,100,25,1,145,India
200043,2024-02-10,211,red bull,90,125,35,1,145,India
767399,2024-02-10,206,yakult,360,400,40,1,393,India
767399,2024-02-10,209,pepsi,75,100,25,1,393,India
146293,2024-02-10,211,red bull,90,125,35,1,307,India
146293,2024-02-10,201,paneer,210,340,130,1,307,India
146293,2024-02-10,213,bisleri,6,15,9,1,307,India
146293,2024-02-10,208,sprite,75,100,25,1,307,India
789653,2024-02-10,206,yakult,360,400,40,1,377,India
789653,2024-02-10,204,strawberry yogurt,50,60,10,1,377,India
789653,2024-02-10,208,sprite,75,100,25,1,377,India
789653,2024-02-10,211,red bull,90,125,35,1,377,India
269873,2024-02-10,208,sprite,75,100,25,1,46,India
269873,2024-02-10,205,classic yogurt,45,60,15,1,46,India
269873,2024-02-10,210,mountain dew,75,100,25,1,46,India
269873,2024-02-10,203,mango yogurt,50,60,10,1,46,India
269873,2024-02-10,201,paneer,210,340,130,1,46,India
752026,2024-02-10,211,red bull,90,125,35,1,221,India
752026,2024-02-10,208,sprite,75,100,25,1,221,India
752026,2024-02-10,201,paneer,210,340,130,1,221,India
752026,2024-02-10,207,coca cola,75,100,25,1,221,India
752026,2024-02-10,213,bisleri,6,15,9,1,221,India
620788,2024-02-10,206,yakult,360,400,40,1,99,India
620788,2024-02-10,209,pepsi,75,100,25,1,99,India
969593,2024-02-10,207,coca cola,75,100,25,1,267,India
969593,2024-02-10,204,strawberry yogurt,50,60,10,1,267,India
969593,2024-02-10,210,mountain dew,75,100,25,1,267,India
969593,2024-02-10,208,sprite,75,100,25,1,267,India
633737,2024-02-10,211,red bull,90,125,35,1,428,India
633737,2024-02-10,207,coca cola,75,100,25,1,428,India
633737,2024-02-10,209,pepsi,75,100,25,1,428,India
633737,2024-02-10,213,bisleri,6,15,9,1,428,India
633737,2024-02-10,205,classic yogurt,45,60,15,1,428,India
311154,2024-02-10,210,mountain dew,75,100,25,1,354,India
661700,2024-02-10,206,yakult,360,400,40,1,387,India
661700,2024-02-10,207,coca cola,75,100,25,1,387,India
661700,2024-02-10,211,red bull,90,125,35,1,387,India
661700,2024-02-10,204,strawberry yogurt,50,60,10,1,387,India
812258,2024-02-10,205,classic yogurt,45,60,15,1,73,India
505138,2024-02-10,203,mango yogurt,50,60,10,1,93,India
505138,2024-02-10,211,red bull,90,125,35,1,93,India
505138,2024-02-10,206,yakult,360,400,40,1,93,India
505138,2024-02-10,209,pepsi,75,100,25,1,93,India
453980,2024-02-10,204,strawberry yogurt,50,60,10,1,46,India
453980,2024-02-10,201,paneer,210,340,130,1,46,India
683101,2024-02-10,210,mountain dew,75,100,25,1,367,India
713717,2024-02-10,202,milk,12,27,15,1,14,India
713717,2024-02-10,204,strawberry yogurt,50,60,10,1,14,India
353695,2024-02-10,207,coca cola,75,100,25,1,313,India
353695,2024-02-10,201,paneer,210,340,130,1,313,India
655914,2024-02-10,209,pepsi,75,100,25,1,421,India
655914,2024-02-10,205,classic yogurt,45,60,15,1,421,India
382389,2024-02-10,203,mango yogurt,50,60,10,1,496,India
152285,2024-02-10,212,amul cheese,250,315,65,1,262,India
152285,2024-02-10,213,bisleri,6,15,9,1,262,India
923945,2024-02-10,202,milk,12,27,15,1,109,India
923945,2024-02-10,205,classic yogurt,45,60,15,1,109,India
516373,2024-02-10,208,sprite,75,100,25,1,41,India
516373,2024-02-10,213,bisleri,6,15,9,1,41,India
516373,2024-02-10,205,classic yogurt,45,60,15,1,41,India
516373,2024-02-10,202,milk,12,27,15,1,41,India
516373,2024-02-10,203,mango yogurt,50,60,10,1,41,India
760904,2024-02-10,210,mountain dew,75,100,25,1,127,India
760904,2024-02-10,206,yakult,360,400,40,1,127,India
760904,2024-02-10,205,classic yogurt,45,60,15,1,127,India
760904,2024-02-10,209,pepsi,75,100,25,1,127,India
232312,2024-02-10,210,mountain dew,75,100,25,1,211,India
232312,2024-02-10,202,milk,12,27,15,1,211,India
232312,2024-02-10,207,coca cola,75,100,25,1,211,India
647620,2024-02-10,203,mango yogurt,50,60,10,1,167,India
647620,2024-02-10,204,strawberry yogurt,50,60,10,1,167,India
647620,2024-02-10,205,classic yogurt,45,60,15,1,167,India
788974,2024-02-10,212,amul cheese,250,315,65,1,280,India
946651,2024-02-10,201,paneer,210,340,130,1,87,India
946651,2024-02-10,203,mango yogurt,50,60,10,1,87,India
946651,2024-02-10,211,red bull,90,125,35,1,87,India
537788,2024-02-10,213,bisleri,6,15,9,1,234,India
537788,2024-02-10,206,yakult,360,400,40,1,234,India
537788,2024-02-10,211,red bull,90,125,35,1,234,India
537788,2024-02-10,209,pepsi,75,100,25,1,234,India
373604,2024-02-10,206,yakult,360,400,40,1,119,India
333691,2024-02-10,208,sprite,75,100,25,1,20,India
468289,2024-02-10,209,pepsi,75,100,25,1,86,India
468289,2024-02-10,211,red bull,90,125,35,1,86,India
468289,2024-02-10,212,amul cheese,250,315,65,1,86,India
139003,2024-02-10,201,paneer,210,340,130,1,251,India
139003,2024-02-10,207,coca cola,75,100,25,1,251,India
139003,2024-02-10,204,strawberry yogurt,50,60,10,1,251,India
139003,2024-02-10,208,sprite,75,100,25,1,251,India
150579,2024-02-10,209,pepsi,75,100,25,1,318,India
150579,2024-02-10,202,milk,12,27,15,1,318,India
150579,2024-02-10,208,sprite,75,100,25,1,318,India
767061,2024-02-10,205,classic yogurt,45,60,15,1,276,India
767061,2024-02-10,211,red bull,90,125,35,1,276,India
767061,2024-02-10,201,paneer,210,340,130,1,276,India
767061,2024-02-10,207,coca cola,75,100,25,1,276,India
767061,2024-02-10,203,mango yogurt,50,60,10,1,276,India
851408,2024-02-10,210,mountain dew,75,100,25,1,266,India
851408,2024-02-10,209,pepsi,75,100,25,1,266,India
562193,2024-02-10,206,yakult,360,400,40,1,137,India
207737,2024-02-10,209,pepsi,75,100,25,1,365,India
207737,2024-02-10,211,red bull,90,125,35,1,365,India
870710,2024-02-10,213,bisleri,6,15,9,1,234,India
870710,2024-02-10,202,milk,12,27,15,1,234,India
870710,2024-02-10,204,strawberry yogurt,50,60,10,1,234,India
870710,2024-02-10,207,coca cola,75,100,25,1,234,India
870710,2024-02-10,205,classic yogurt,45,60,15,1,234,India
588450,2024-02-10,204,strawberry yogurt,50,60,10,1,314,India
588450,2024-02-10,203,mango yogurt,50,60,10,1,314,India
588450,2024-02-10,208,sprite,75,100,25,1,314,India
734222,2024-02-10,204,strawberry yogurt,50,60,10,1,193,India
734222,2024-02-10,210,mountain dew,75,100,25,1,193,India
734222,2024-02-10,209,pepsi,75,100,25,1,193,India
416355,2024-02-10,207,coca cola,75,100,25,1,398,India
416355,2024-02-10,205,classic yogurt,45,60,15,1,398,India
480404,2024-02-10,211,red bull,90,125,35,1,97,India
480404,2024-02-10,204,strawberry yogurt,50,60,10,1,97,India
927785,2024-02-11,206,yakult,360,400,40,1,175,India
927785,2024-02-11,209,pepsi,75,100,25,1,175,India
927785,2024-02-11,203,mango yogurt,50,60,10,1,175,India
927785,2024-02-11,202,milk,12,27,15,1,175,India
576779,2024-02-11,201,paneer,210,340,130,1,420,India
576779,2024-02-11,205,classic yogurt,45,60,15,1,420,India
576779,2024-02-11,202,milk,12,27,15,1,420,India
576779,2024-02-11,212,amul cheese,250,315,65,1,420,India
513672,2024-02-11,201,paneer,210,340,130,1,384,India
513672,2024-02-11,203,mango yogurt,50,60,10,1,384,India
513672,2024-02-11,208,sprite,75,100,25,1,384,India
513672,2024-02-11,210,mountain dew,75,100,25,1,384,India
450838,2024-02-11,209,pepsi,75,100,25,1,283,India
450838,2024-02-11,207,coca cola,75,100,25,1,283,India
450838,2024-02-11,201,paneer,210,340,130,1,283,India
296618,2024-02-11,202,milk,12,27,15,1,134,India
296618,2024-02-11,201,paneer,210,340,130,1,134,India
296618,2024-02-11,212,amul cheese,250,315,65,1,134,India
296618,2024-02-11,205,classic yogurt,45,60,15,1,134,India
125712,2024-02-11,208,sprite,75,100,25,1,77,India
125712,2024-02-11,201,paneer,210,340,130,1,77,India
125712,2024-02-11,207,coca cola,75,100,25,1,77,India
125712,2024-02-11,212,amul cheese,250,315,65,1,77,India
125712,2024-02-11,209,pepsi,75,100,25,1,77,India
856717,2024-02-11,202,milk,12,27,15,1,207,India
856717,2024-02-11,203,mango yogurt,50,60,10,1,207,India
856717,2024-02-11,213,bisleri,6,15,9,1,207,India
856717,2024-02-11,211,red bull,90,125,35,1,207,India
973799,2024-02-11,207,coca cola,75,100,25,1,317,India
973799,2024-02-11,204,strawberry yogurt,50,60,10,1,317,India
973799,2024-02-11,202,milk,12,27,15,1,317,India
722206,2024-02-11,204,strawberry yogurt,50,60,10,1,440,India
722206,2024-02-11,212,amul cheese,250,315,65,1,440,India
336577,2024-02-11,202,milk,12,27,15,1,240,India
336577,2024-02-11,208,sprite,75,100,25,1,240,India
860088,2024-02-11,210,mountain dew,75,100,25,1,318,India
860088,2024-02-11,208,sprite,75,100,25,1,318,India
860088,2024-02-11,213,bisleri,6,15,9,1,318,India
860088,2024-02-11,204,strawberry yogurt,50,60,10,1,318,India
505752,2024-02-11,203,mango yogurt,50,60,10,1,59,India
505752,2024-02-11,210,mountain dew,75,100,25,1,59,India
505752,2024-02-11,204,strawberry yogurt,50,60,10,1,59,India
505752,2024-02-11,211,red bull,90,125,35,1,59,India
236933,2024-02-11,212,amul cheese,250,315,65,1,377,India
236933,2024-02-11,206,yakult,360,400,40,1,377,India
779230,2024-02-11,210,mountain dew,75,100,25,1,266,India
779230,2024-02-11,201,paneer,210,340,130,1,266,India
779230,2024-02-11,213,bisleri,6,15,9,1,266,India
996084,2024-02-11,207,coca cola,75,100,25,1,458,India
113016,2024-02-11,208,sprite,75,100,25,1,289,India
113016,2024-02-11,209,pepsi,75,100,25,1,289,India
121946,2024-02-11,204,strawberry yogurt,50,60,10,1,494,India
121946,2024-02-11,213,bisleri,6,15,9,1,494,India
986939,2024-02-11,213,bisleri,6,15,9,1,305,India
629181,2024-02-11,201,paneer,210,340,130,1,409,India
629181,2024-02-11,207,coca cola,75,100,25,1,409,India
629181,2024-02-11,204,strawberry yogurt,50,60,10,1,409,India
629181,2024-02-11,206,yakult,360,400,40,1,409,India
629181,2024-02-11,208,sprite,75,100,25,1,409,India
551728,2024-02-11,210,mountain dew,75,100,25,1,405,India
551728,2024-02-11,202,milk,12,27,15,1,405,India
551728,2024-02-11,207,coca cola,75,100,25,1,405,India
959890,2024-02-11,212,amul cheese,250,315,65,1,124,India
959890,2024-02-11,211,red bull,90,125,35,1,124,India
959890,2024-02-11,209,pepsi,75,100,25,1,124,India
448241,2024-02-11,213,bisleri,6,15,9,1,30,India
448241,2024-02-11,207,coca cola,75,100,25,1,30,India
448241,2024-02-11,212,amul cheese,250,315,65,1,30,India
448241,2024-02-11,203,mango yogurt,50,60,10,1,30,India
234739,2024-02-11,211,red bull,90,125,35,1,447,India
234739,2024-02-11,209,pepsi,75,100,25,1,447,India
952508,2024-02-11,210,mountain dew,75,100,25,1,272,India
952508,2024-02-11,203,mango yogurt,50,60,10,1,272,India
952508,2024-02-11,207,coca cola,75,100,25,1,272,India
952508,2024-02-11,205,classic yogurt,45,60,15,1,272,India
952508,2024-02-11,209,pepsi,75,100,25,1,272,India
194531,2024-02-11,212,amul cheese,250,315,65,1,295,India
472951,2024-02-11,208,sprite,75,100,25,1,466,India
472951,2024-02-11,213,bisleri,6,15,9,1,466,India
472951,2024-02-11,211,red bull,90,125,35,1,466,India
811774,2024-02-11,208,sprite,75,100,25,1,17,India
811774,2024-02-11,202,milk,12,27,15,1,17,India
332675,2024-02-11,201,paneer,210,340,130,1,237,India
332675,2024-02-11,210,mountain dew,75,100,25,1,237,India
332675,2024-02-11,202,milk,12,27,15,1,237,India
385748,2024-02-11,209,pepsi,75,100,25,1,389,India
385748,2024-02-11,205,classic yogurt,45,60,15,1,389,India
796341,2024-02-11,210,mountain dew,75,100,25,1,495,India
796341,2024-02-11,203,mango yogurt,50,60,10,1,495,India
796341,2024-02-11,205,classic yogurt,45,60,15,1,495,India
997810,2024-02-11,204,strawberry yogurt,50,60,10,1,349,India
997810,2024-02-11,202,milk,12,27,15,1,349,India
150310,2024-02-11,206,yakult,360,400,40,1,152,India
150310,2024-02-11,205,classic yogurt,45,60,15,1,152,India
150310,2024-02-11,207,coca cola,75,100,25,1,152,India
216652,2024-02-11,202,milk,12,27,15,1,179,India
167657,2024-02-11,206,yakult,360,400,40,1,366,India
167657,2024-02-11,203,mango yogurt,50,60,10,1,366,India
167657,2024-02-11,212,amul cheese,250,315,65,1,366,India
167657,2024-02-11,208,sprite,75,100,25,1,366,India
167657,2024-02-11,211,red bull,90,125,35,1,366,India
820478,2024-02-11,202,milk,12,27,15,1,27,India
820478,2024-02-11,212,amul cheese,250,315,65,1,27,India
820478,2024-02-11,204,strawberry yogurt,50,60,10,1,27,India
820478,2024-02-11,203,mango yogurt,50,60,10,1,27,India
636728,2024-02-11,212,amul cheese,250,315,65,1,352,India
913558,2024-02-11,206,yakult,360,400,40,1,28,India
913558,2024-02-11,207,coca cola,75,100,25,1,28,India
913558,2024-02-11,211,red bull,90,125,35,1,28,India
623604,2024-02-11,207,coca cola,75,100,25,1,101,India
623604,2024-02-11,204,strawberry yogurt,50,60,10,1,101,India
623604,2024-02-11,211,red bull,90,125,35,1,101,India
275938,2024-02-11,203,mango yogurt,50,60,10,1,27,India
275938,2024-02-11,209,pepsi,75,100,25,1,27,India
275938,2024-02-11,212,amul cheese,250,315,65,1,27,India
275938,2024-02-11,204,strawberry yogurt,50,60,10,1,27,India
275938,2024-02-11,213,bisleri,6,15,9,1,27,India
372478,2024-02-11,212,amul cheese,250,315,65,1,7,India
372478,2024-02-11,204,strawberry yogurt,50,60,10,1,7,India
372478,2024-02-11,211,red bull,90,125,35,1,7,India
372478,2024-02-11,203,mango yogurt,50,60,10,1,7,India
140063,2024-02-11,205,classic yogurt,45,60,15,1,203,India
321206,2024-02-11,202,milk,12,27,15,1,301,India
321206,2024-02-11,208,sprite,75,100,25,1,301,India
120194,2024-02-11,209,pepsi,75,100,25,1,228,India
120194,2024-02-11,208,sprite,75,100,25,1,228,India
120194,2024-02-11,203,mango yogurt,50,60,10,1,228,India
781874,2024-02-11,207,coca cola,75,100,25,1,13,India
781874,2024-02-11,211,red bull,90,125,35,1,13,India
781874,2024-02-11,209,pepsi,75,100,25,1,13,India
246389,2024-02-11,202,milk,12,27,15,1,46,India
246389,2024-02-11,205,classic yogurt,45,60,15,1,46,India
246389,2024-02-11,209,pepsi,75,100,25,1,46,India
246389,2024-02-11,208,sprite,75,100,25,1,46,India
246389,2024-02-11,212,amul cheese,250,315,65,1,46,India
583132,2024-02-11,206,yakult,360,400,40,1,311,India
583132,2024-02-11,202,milk,12,27,15,1,311,India
583132,2024-02-11,203,mango yogurt,50,60,10,1,311,India
583132,2024-02-11,208,sprite,75,100,25,1,311,India
264777,2024-02-11,212,amul cheese,250,315,65,1,41,India
929174,2024-02-11,207,coca cola,75,100,25,1,486,India
929174,2024-02-11,205,classic yogurt,45,60,15,1,486,India
929174,2024-02-11,210,mountain dew,75,100,25,1,486,India
819997,2024-02-11,208,sprite,75,100,25,1,134,India
819997,2024-02-11,202,milk,12,27,15,1,134,India
845255,2024-02-11,211,red bull,90,125,35,1,413,India
107006,2024-02-11,205,classic yogurt,45,60,15,1,115,India
107006,2024-02-11,202,milk,12,27,15,1,115,India
107006,2024-02-11,204,strawberry yogurt,50,60,10,1,115,India
882375,2024-02-11,212,amul cheese,250,315,65,1,286,India
882375,2024-02-11,203,mango yogurt,50,60,10,1,286,India
757567,2024-02-11,202,milk,12,27,15,1,358,India
757567,2024-02-11,203,mango yogurt,50,60,10,1,358,India
757567,2024-02-11,207,coca cola,75,100,25,1,358,India
757567,2024-02-11,204,strawberry yogurt,50,60,10,1,358,India
427973,2024-02-11,203,mango yogurt,50,60,10,1,354,India
427973,2024-02-11,213,bisleri,6,15,9,1,354,India
427973,2024-02-11,204,strawberry yogurt,50,60,10,1,354,India
427973,2024-02-11,212,amul cheese,250,315,65,1,354,India
625395,2024-02-11,204,strawberry yogurt,50,60,10,1,367,India
238772,2024-02-11,209,pepsi,75,100,25,1,452,India
851288,2024-02-11,201,paneer,210,340,130,1,226,India
851288,2024-02-11,202,milk,12,27,15,1,226,India
858507,2024-02-11,213,bisleri,6,15,9,1,205,India
858507,2024-02-11,211,red bull,90,125,35,1,205,India
858507,2024-02-11,209,pepsi,75,100,25,1,205,India
893141,2024-02-11,201,paneer,210,340,130,1,479,India
893141,2024-02-11,204,strawberry yogurt,50,60,10,1,479,India
893141,2024-02-11,213,bisleri,6,15,9,1,479,India
893141,2024-02-11,205,classic yogurt,45,60,15,1,479,India
406245,2024-02-11,211,red bull,90,125,35,1,335,India
406245,2024-02-11,203,mango yogurt,50,60,10,1,335,India
406245,2024-02-11,209,pepsi,75,100,25,1,335,India
256137,2024-02-11,208,sprite,75,100,25,1,112,India
256137,2024-02-11,205,classic yogurt,45,60,15,1,112,India
256137,2024-02-11,212,amul cheese,250,315,65,1,112,India
824143,2024-02-11,201,paneer,210,340,130,1,470,India
824143,2024-02-11,211,red bull,90,125,35,1,470,India
597763,2024-02-11,201,paneer,210,340,130,1,186,India
597763,2024-02-11,209,pepsi,75,100,25,1,186,India
597763,2024-02-11,210,mountain dew,75,100,25,1,186,India
597763,2024-02-11,207,coca cola,75,100,25,1,186,India
597763,2024-02-11,204,strawberry yogurt,50,60,10,1,186,India
836726,2024-02-11,207,coca cola,75,100,25,1,483,India
836726,2024-02-11,201,paneer,210,340,130,1,483,India
280405,2024-02-11,207,coca cola,75,100,25,1,225,India
280405,2024-02-11,211,red bull,90,125,35,1,225,India
280405,2024-02-11,204,strawberry yogurt,50,60,10,1,225,India
413920,2024-02-11,201,paneer,210,340,130,1,322,India
413920,2024-02-11,204,strawberry yogurt,50,60,10,1,322,India
738071,2024-02-11,203,mango yogurt,50,60,10,1,333,India
738071,2024-02-11,211,red bull,90,125,35,1,333,India
738071,2024-02-11,207,coca cola,75,100,25,1,333,India
738071,2024-02-11,213,bisleri,6,15,9,1,333,India
431429,2024-02-11,205,classic yogurt,45,60,15,1,55,India
431429,2024-02-11,213,bisleri,6,15,9,1,55,India
431429,2024-02-11,202,milk,12,27,15,1,55,India
552173,2024-02-11,203,mango yogurt,50,60,10,1,138,India
552173,2024-02-11,205,classic yogurt,45,60,15,1,138,India
552173,2024-02-11,209,pepsi,75,100,25,1,138,India
552173,2024-02-11,204,strawberry yogurt,50,60,10,1,138,India
622375,2024-02-11,208,sprite,75,100,25,1,108,India
622375,2024-02-11,207,coca cola,75,100,25,1,108,India
622375,2024-02-11,202,milk,12,27,15,1,108,India
729546,2024-02-11,209,pepsi,75,100,25,1,212,India
729546,2024-02-11,205,classic yogurt,45,60,15,1,212,India
729546,2024-02-11,206,yakult,360,400,40,1,212,India
729546,2024-02-11,202,milk,12,27,15,1,212,India
729546,2024-02-11,204,strawberry yogurt,50,60,10,1,212,India
381804,2024-02-11,213,bisleri,6,15,9,1,466,India
813575,2024-02-11,211,red bull,90,125,35,1,420,India
813575,2024-02-11,213,bisleri,6,15,9,1,420,India
813575,2024-02-11,207,coca cola,75,100,25,1,420,India
813575,2024-02-11,201,paneer,210,340,130,1,420,India
214921,2024-02-11,210,mountain dew,75,100,25,1,333,India
214921,2024-02-11,209,pepsi,75,100,25,1,333,India
214921,2024-02-11,205,classic yogurt,45,60,15,1,333,India
106862,2024-02-11,208,sprite,75,100,25,1,75,India
333152,2024-02-11,204,strawberry yogurt,50,60,10,1,414,India
116798,2024-02-11,206,yakult,360,400,40,1,320,India
116798,2024-02-11,212,amul cheese,250,315,65,1,320,India
116798,2024-02-11,210,mountain dew,75,100,25,1,320,India
544645,2024-02-11,206,yakult,360,400,40,1,26,India
544645,2024-02-11,211,red bull,90,125,35,1,26,India
929237,2024-02-11,212,amul cheese,250,315,65,1,186,India
929237,2024-02-11,202,milk,12,27,15,1,186,India
929237,2024-02-11,208,sprite,75,100,25,1,186,India
680303,2024-02-11,206,yakult,360,400,40,1,64,India
680303,2024-02-11,212,amul cheese,250,315,65,1,64,India
680303,2024-02-11,213,bisleri,6,15,9,1,64,India
680303,2024-02-11,204,strawberry yogurt,50,60,10,1,64,India
594410,2024-02-11,203,mango yogurt,50,60,10,1,127,India
594410,2024-02-11,201,paneer,210,340,130,1,127,India
594410,2024-02-11,210,mountain dew,75,100,25,1,127,India
594410,2024-02-11,212,amul cheese,250,315,65,1,127,India
594410,2024-02-11,202,milk,12,27,15,1,127,India
559798,2024-02-11,205,classic yogurt,45,60,15,1,113,India
559798,2024-02-11,213,bisleri,6,15,9,1,113,India
559798,2024-02-11,208,sprite,75,100,25,1,113,India
559798,2024-02-11,203,mango yogurt,50,60,10,1,113,India
559798,2024-02-11,211,red bull,90,125,35,1,113,India
535952,2024-02-11,205,classic yogurt,45,60,15,1,190,India
535952,2024-02-11,204,strawberry yogurt,50,60,10,1,190,India
513081,2024-02-11,211,red bull,90,125,35,1,493,India
513081,2024-02-11,210,mountain dew,75,100,25,1,493,India
513081,2024-02-11,205,classic yogurt,45,60,15,1,493,India
986736,2024-02-11,201,paneer,210,340,130,1,439,India
986736,2024-02-11,209,pepsi,75,100,25,1,439,India
155871,2024-02-11,205,classic yogurt,45,60,15,1,73,India
155871,2024-02-11,203,mango yogurt,50,60,10,1,73,India
155871,2024-02-11,206,yakult,360,400,40,1,73,India
155871,2024-02-11,208,sprite,75,100,25,1,73,India
178130,2024-02-11,206,yakult,360,400,40,1,44,India
506049,2024-02-11,211,red bull,90,125,35,1,201,India
353239,2024-02-11,207,coca cola,75,100,25,1,66,India
353239,2024-02-11,209,pepsi,75,100,25,1,66,India
353239,2024-02-11,210,mountain dew,75,100,25,1,66,India
577905,2024-02-11,204,strawberry yogurt,50,60,10,1,254,India
126837,2024-02-12,205,classic yogurt,45,60,15,1,298,India
126837,2024-02-12,204,strawberry yogurt,50,60,10,1,298,India
921332,2024-02-12,206,yakult,360,400,40,1,499,India
921332,2024-02-12,211,red bull,90,125,35,1,499,India
709768,2024-02-12,209,pepsi,75,100,25,1,401,India
709768,2024-02-12,207,coca cola,75,100,25,1,401,India
709768,2024-02-12,201,paneer,210,340,130,1,401,India
709768,2024-02-12,213,bisleri,6,15,9,1,401,India
754832,2024-02-12,213,bisleri,6,15,9,1,149,India
218266,2024-02-12,208,sprite,75,100,25,1,250,India
218266,2024-02-12,207,coca cola,75,100,25,1,250,India
152068,2024-02-12,208,sprite,75,100,25,1,487,India
152068,2024-02-12,202,milk,12,27,15,1,487,India
152068,2024-02-12,210,mountain dew,75,100,25,1,487,India
152068,2024-02-12,212,amul cheese,250,315,65,1,487,India
791313,2024-02-12,208,sprite,75,100,25,1,82,India
595708,2024-02-12,204,strawberry yogurt,50,60,10,1,295,India
868859,2024-02-12,211,red bull,90,125,35,1,21,India
868859,2024-02-12,208,sprite,75,100,25,1,21,India
868859,2024-02-12,209,pepsi,75,100,25,1,21,India
868859,2024-02-12,212,amul cheese,250,315,65,1,21,India
868859,2024-02-12,207,coca cola,75,100,25,1,21,India
646831,2024-02-12,207,coca cola,75,100,25,1,110,India
646831,2024-02-12,206,yakult,360,400,40,1,110,India
646831,2024-02-12,213,bisleri,6,15,9,1,110,India
117077,2024-02-12,207,coca cola,75,100,25,1,102,India
117077,2024-02-12,201,paneer,210,340,130,1,102,India
131714,2024-02-12,202,milk,12,27,15,1,165,India
131714,2024-02-12,205,classic yogurt,45,60,15,1,165,India
131714,2024-02-12,208,sprite,75,100,25,1,165,India
131714,2024-02-12,203,mango yogurt,50,60,10,1,165,India
734764,2024-02-12,202,milk,12,27,15,1,215,India
734764,2024-02-12,209,pepsi,75,100,25,1,215,India
734764,2024-02-12,206,yakult,360,400,40,1,215,India
936508,2024-02-12,211,red bull,90,125,35,1,132,India
936508,2024-02-12,209,pepsi,75,100,25,1,132,India
936508,2024-02-12,210,mountain dew,75,100,25,1,132,India
277073,2024-02-12,205,classic yogurt,45,60,15,1,454,India
277073,2024-02-12,207,coca cola,75,100,25,1,454,India
277073,2024-02-12,209,pepsi,75,100,25,1,454,India
490533,2024-02-12,207,coca cola,75,100,25,1,40,India
490533,2024-02-12,213,bisleri,6,15,9,1,40,India
490533,2024-02-12,202,milk,12,27,15,1,40,India
490533,2024-02-12,205,classic yogurt,45,60,15,1,40,India
422249,2024-02-12,205,classic yogurt,45,60,15,1,348,India
393586,2024-02-12,211,red bull,90,125,35,1,247,India
393586,2024-02-12,203,mango yogurt,50,60,10,1,247,India
393586,2024-02-12,201,paneer,210,340,130,1,247,India
393586,2024-02-12,205,classic yogurt,45,60,15,1,247,India
131404,2024-02-12,206,yakult,360,400,40,1,478,India
131404,2024-02-12,211,red bull,90,125,35,1,478,India
131404,2024-02-12,207,coca cola,75,100,25,1,478,India
131404,2024-02-12,205,classic yogurt,45,60,15,1,478,India
106253,2024-02-12,205,classic yogurt,45,60,15,1,396,India
106253,2024-02-12,211,red bull,90,125,35,1,396,India
106253,2024-02-12,206,yakult,360,400,40,1,396,India
106253,2024-02-12,201,paneer,210,340,130,1,396,India
106253,2024-02-12,213,bisleri,6,15,9,1,396,India
675588,2024-02-12,209,pepsi,75,100,25,1,298,India
675588,2024-02-12,204,strawberry yogurt,50,60,10,1,298,India
675588,2024-02-12,202,milk,12,27,15,1,298,India
675588,2024-02-12,206,yakult,360,400,40,1,298,India
939053,2024-02-12,208,sprite,75,100,25,1,134,India
939053,2024-02-12,204,strawberry yogurt,50,60,10,1,134,India
939053,2024-02-12,213,bisleri,6,15,9,1,134,India
925183,2024-02-12,206,yakult,360,400,40,1,378,India
925183,2024-02-12,201,paneer,210,340,130,1,378,India
925183,2024-02-12,211,red bull,90,125,35,1,378,India
835155,2024-02-12,207,coca cola,75,100,25,1,418,India
835155,2024-02-12,202,milk,12,27,15,1,418,India
198454,2024-02-12,212,amul cheese,250,315,65,1,340,India
198454,2024-02-12,205,classic yogurt,45,60,15,1,340,India
198454,2024-02-12,209,pepsi,75,100,25,1,340,India
598539,2024-02-12,204,strawberry yogurt,50,60,10,1,322,India
598539,2024-02-12,202,milk,12,27,15,1,322,India
598539,2024-02-12,213,bisleri,6,15,9,1,322,India
419396,2024-02-12,209,pepsi,75,100,25,1,78,India
419396,2024-02-12,213,bisleri,6,15,9,1,78,India
419396,2024-02-12,211,red bull,90,125,35,1,78,India
419396,2024-02-12,212,amul cheese,250,315,65,1,78,India
419396,2024-02-12,206,yakult,360,400,40,1,78,India
922642,2024-02-12,204,strawberry yogurt,50,60,10,1,203,India
922642,2024-02-12,203,mango yogurt,50,60,10,1,203,India
922642,2024-02-12,206,yakult,360,400,40,1,203,India
643989,2024-02-12,207,coca cola,75,100,25,1,404,India
643989,2024-02-12,203,mango yogurt,50,60,10,1,404,India
643989,2024-02-12,201,paneer,210,340,130,1,404,India
421918,2024-02-12,209,pepsi,75,100,25,1,446,India
421918,2024-02-12,207,coca cola,75,100,25,1,446,India
375554,2024-02-12,201,paneer,210,340,130,1,195,India
765405,2024-02-12,207,coca cola,75,100,25,1,131,India
338574,2024-02-12,211,red bull,90,125,35,1,333,India
197237,2024-02-12,202,milk,12,27,15,1,443,India
197237,2024-02-12,204,strawberry yogurt,50,60,10,1,443,India
197237,2024-02-12,206,yakult,360,400,40,1,443,India
197237,2024-02-12,208,sprite,75,100,25,1,443,India
197237,2024-02-12,210,mountain dew,75,100,25,1,443,India
128908,2024-02-12,203,mango yogurt,50,60,10,1,73,India
128908,2024-02-12,205,classic yogurt,45,60,15,1,73,India
128908,2024-02-12,208,sprite,75,100,25,1,73,India
851929,2024-02-12,203,mango yogurt,50,60,10,1,451,India
851929,2024-02-12,213,bisleri,6,15,9,1,451,India
851929,2024-02-12,212,amul cheese,250,315,65,1,451,India
851929,2024-02-12,205,classic yogurt,45,60,15,1,451,India
988236,2024-02-12,204,strawberry yogurt,50,60,10,1,66,India
889969,2024-02-12,202,milk,12,27,15,1,351,India
889969,2024-02-12,211,red bull,90,125,35,1,351,India
889969,2024-02-12,213,bisleri,6,15,9,1,351,India
889969,2024-02-12,206,yakult,360,400,40,1,351,India
468944,2024-02-12,207,coca cola,75,100,25,1,264,India
468944,2024-02-12,208,sprite,75,100,25,1,264,India
468944,2024-02-12,213,bisleri,6,15,9,1,264,India
591144,2024-02-12,205,classic yogurt,45,60,15,1,109,India
591144,2024-02-12,213,bisleri,6,15,9,1,109,India
723206,2024-02-12,203,mango yogurt,50,60,10,1,385,India
723206,2024-02-12,208,sprite,75,100,25,1,385,India
825518,2024-02-12,209,pepsi,75,100,25,1,309,India
825518,2024-02-12,211,red bull,90,125,35,1,309,India
825518,2024-02-12,213,bisleri,6,15,9,1,309,India
834916,2024-02-12,204,strawberry yogurt,50,60,10,1,395,India
834916,2024-02-12,201,paneer,210,340,130,1,395,India
834916,2024-02-12,207,coca cola,75,100,25,1,395,India
474933,2024-02-12,208,sprite,75,100,25,1,255,India
474933,2024-02-12,206,yakult,360,400,40,1,255,India
474933,2024-02-12,202,milk,12,27,15,1,255,India
871427,2024-02-12,211,red bull,90,125,35,1,92,India
530284,2024-02-12,202,milk,12,27,15,1,464,India
530284,2024-02-12,207,coca cola,75,100,25,1,464,India
530284,2024-02-12,201,paneer,210,340,130,1,464,India
530284,2024-02-12,211,red bull,90,125,35,1,464,India
530284,2024-02-12,210,mountain dew,75,100,25,1,464,India
932014,2024-02-12,212,amul cheese,250,315,65,1,27,India
932014,2024-02-12,209,pepsi,75,100,25,1,27,India
932014,2024-02-12,206,yakult,360,400,40,1,27,India
454251,2024-02-12,207,coca cola,75,100,25,1,452,India
454251,2024-02-12,205,classic yogurt,45,60,15,1,452,India
454251,2024-02-12,210,mountain dew,75,100,25,1,452,India
872458,2024-02-12,206,yakult,360,400,40,1,399,India
872458,2024-02-12,211,red bull,90,125,35,1,399,India
872458,2024-02-12,201,paneer,210,340,130,1,399,India
741176,2024-02-12,213,bisleri,6,15,9,1,308,India
741176,2024-02-12,203,mango yogurt,50,60,10,1,308,India
741176,2024-02-12,211,red bull,90,125,35,1,308,India
741176,2024-02-12,202,milk,12,27,15,1,308,India
741176,2024-02-12,205,classic yogurt,45,60,15,1,308,India
625758,2024-02-12,213,bisleri,6,15,9,1,50,India
625758,2024-02-12,204,strawberry yogurt,50,60,10,1,50,India
625758,2024-02-12,207,coca cola,75,100,25,1,50,India
261796,2024-02-12,211,red bull,90,125,35,1,270,India
261796,2024-02-12,206,yakult,360,400,40,1,270,India
261796,2024-02-12,213,bisleri,6,15,9,1,270,India
261796,2024-02-12,202,milk,12,27,15,1,270,India
830919,2024-02-12,202,milk,12,27,15,1,194,India
765077,2024-02-12,205,classic yogurt,45,60,15,1,42,India
765077,2024-02-12,204,strawberry yogurt,50,60,10,1,42,India
765077,2024-02-12,206,yakult,360,400,40,1,42,India
814772,2024-02-12,204,strawberry yogurt,50,60,10,1,7,India
814772,2024-02-12,212,amul cheese,250,315,65,1,7,India
814772,2024-02-12,206,yakult,360,400,40,1,7,India
183834,2024-02-12,202,milk,12,27,15,1,209,India
183834,2024-02-12,209,pepsi,75,100,25,1,209,India
183834,2024-02-12,211,red bull,90,125,35,1,209,India
183834,2024-02-12,203,mango yogurt,50,60,10,1,209,India
687437,2024-02-12,204,strawberry yogurt,50,60,10,1,475,India
687437,2024-02-12,210,mountain dew,75,100,25,1,475,India
687437,2024-02-12,211,red bull,90,125,35,1,475,India
687437,2024-02-12,205,classic yogurt,45,60,15,1,475,India
687437,2024-02-12,209,pepsi,75,100,25,1,475,India
340916,2024-02-12,205,classic yogurt,45,60,15,1,367,India
340916,2024-02-12,203,mango yogurt,50,60,10,1,367,India
108364,2024-02-12,208,sprite,75,100,25,1,13,India
108364,2024-02-12,202,milk,12,27,15,1,13,India
108364,2024-02-12,206,yakult,360,400,40,1,13,India
108364,2024-02-12,213,bisleri,6,15,9,1,13,India
938194,2024-02-12,205,classic yogurt,45,60,15,1,454,India
938194,2024-02-12,209,pepsi,75,100,25,1,454,India
660372,2024-02-12,205,classic yogurt,45,60,15,1,285,India
660372,2024-02-12,208,sprite,75,100,25,1,285,India
660372,2024-02-12,202,milk,12,27,15,1,285,India
660372,2024-02-12,207,coca cola,75,100,25,1,285,India
660372,2024-02-12,209,pepsi,75,100,25,1,285,India
267533,2024-02-12,210,mountain dew,75,100,25,1,197,India
354446,2024-02-12,210,mountain dew,75,100,25,1,370,India
354446,2024-02-12,208,sprite,75,100,25,1,370,India
518953,2024-02-12,201,paneer,210,340,130,1,28,India
518953,2024-02-12,211,red bull,90,125,35,1,28,India
518953,2024-02-12,209,pepsi,75,100,25,1,28,India
518953,2024-02-12,213,bisleri,6,15,9,1,28,India
407516,2024-02-12,213,bisleri,6,15,9,1,453,India
407516,2024-02-12,204,strawberry yogurt,50,60,10,1,453,India
500191,2024-02-12,208,sprite,75,100,25,1,172,India
500191,2024-02-12,205,classic yogurt,45,60,15,1,172,India
500191,2024-02-12,212,amul cheese,250,315,65,1,172,India
500191,2024-02-12,207,coca cola,75,100,25,1,172,India
374830,2024-02-12,209,pepsi,75,100,25,1,369,India
374830,2024-02-12,205,classic yogurt,45,60,15,1,369,India
944371,2024-02-12,205,classic yogurt,45,60,15,1,48,India
944371,2024-02-12,204,strawberry yogurt,50,60,10,1,48,India
164539,2024-02-12,208,sprite,75,100,25,1,306,India
164539,2024-02-12,203,mango yogurt,50,60,10,1,306,India
164539,2024-02-12,202,milk,12,27,15,1,306,India
422482,2024-02-12,211,red bull,90,125,35,1,431,India
737181,2024-02-12,213,bisleri,6,15,9,1,350,India
737181,2024-02-12,205,classic yogurt,45,60,15,1,350,India
333366,2024-02-13,207,coca cola,75,100,25,1,255,India
333366,2024-02-13,202,milk,12,27,15,1,255,India
333366,2024-02-13,205,classic yogurt,45,60,15,1,255,India
333366,2024-02-13,206,yakult,360,400,40,1,255,India
295137,2024-02-13,211,red bull,90,125,35,1,268,India
295137,2024-02-13,202,milk,12,27,15,1,268,India
295137,2024-02-13,205,classic yogurt,45,60,15,1,268,India
909497,2024-02-13,203,mango yogurt,50,60,10,1,307,India
909497,2024-02-13,206,yakult,360,400,40,1,307,India
909497,2024-02-13,201,paneer,210,340,130,1,307,India
815217,2024-02-13,209,pepsi,75,100,25,1,83,India
815217,2024-02-13,201,paneer,210,340,130,1,83,India
512744,2024-02-13,205,classic yogurt,45,60,15,1,11,India
512744,2024-02-13,201,paneer,210,340,130,1,11,India
512744,2024-02-13,206,yakult,360,400,40,1,11,India
512744,2024-02-13,212,amul cheese,250,315,65,1,11,India
512744,2024-02-13,208,sprite,75,100,25,1,11,India
371968,2024-02-13,206,yakult,360,400,40,1,262,India
371968,2024-02-13,208,sprite,75,100,25,1,262,India
371968,2024-02-13,213,bisleri,6,15,9,1,262,India
371968,2024-02-13,203,mango yogurt,50,60,10,1,262,India
371968,2024-02-13,204,strawberry yogurt,50,60,10,1,262,India
252999,2024-02-13,212,amul cheese,250,315,65,1,347,India
252999,2024-02-13,210,mountain dew,75,100,25,1,347,India
252999,2024-02-13,205,classic yogurt,45,60,15,1,347,India
151938,2024-02-13,211,red bull,90,125,35,1,136,India
984224,2024-02-13,205,classic yogurt,45,60,15,1,120,India
330269,2024-02-13,206,yakult,360,400,40,1,221,India
330269,2024-02-13,209,pepsi,75,100,25,1,221,India
330269,2024-02-13,205,classic yogurt,45,60,15,1,221,India
732689,2024-02-13,207,coca cola,75,100,25,1,46,India
375456,2024-02-13,207,coca cola,75,100,25,1,169,India
375456,2024-02-13,212,amul cheese,250,315,65,1,169,India
375456,2024-02-13,210,mountain dew,75,100,25,1,169,India
402703,2024-02-13,213,bisleri,6,15,9,1,176,India
402703,2024-02-13,210,mountain dew,75,100,25,1,176,India
402703,2024-02-13,207,coca cola,75,100,25,1,176,India
248576,2024-02-13,212,amul cheese,250,315,65,1,75,India
248576,2024-02-13,201,paneer,210,340,130,1,75,India
682375,2024-02-13,201,paneer,210,340,130,1,96,India
682375,2024-02-13,208,sprite,75,100,25,1,96,India
682375,2024-02-13,203,mango yogurt,50,60,10,1,96,India
387652,2024-02-13,213,bisleri,6,15,9,1,412,India
387652,2024-02-13,207,coca cola,75,100,25,1,412,India
494914,2024-02-13,206,yakult,360,400,40,1,376,India
494914,2024-02-13,208,sprite,75,100,25,1,376,India
494914,2024-02-13,205,classic yogurt,45,60,15,1,376,India
363692,2024-02-13,211,red bull,90,125,35,1,439,India
631866,2024-02-13,202,milk,12,27,15,1,27,India
372225,2024-02-13,209,pepsi,75,100,25,1,66,India
154051,2024-02-13,205,classic yogurt,45,60,15,1,373,India
154051,2024-02-13,203,mango yogurt,50,60,10,1,373,India
154051,2024-02-13,213,bisleri,6,15,9,1,373,India
154051,2024-02-13,202,milk,12,27,15,1,373,India
150172,2024-02-13,204,strawberry yogurt,50,60,10,1,85,India
562136,2024-02-13,202,milk,12,27,15,1,492,India
562136,2024-02-13,204,strawberry yogurt,50,60,10,1,492,India
562136,2024-02-13,209,pepsi,75,100,25,1,492,India
496094,2024-02-13,202,milk,12,27,15,1,496,India
871720,2024-02-13,204,strawberry yogurt,50,60,10,1,369,India
871720,2024-02-13,213,bisleri,6,15,9,1,369,India
185875,2024-02-13,202,milk,12,27,15,1,160,India
185875,2024-02-13,211,red bull,90,125,35,1,160,India
185875,2024-02-13,210,mountain dew,75,100,25,1,160,India
422171,2024-02-13,204,strawberry yogurt,50,60,10,1,203,India
422171,2024-02-13,210,mountain dew,75,100,25,1,203,India
941027,2024-02-13,204,strawberry yogurt,50,60,10,1,218,India
941027,2024-02-13,210,mountain dew,75,100,25,1,218,India
941027,2024-02-13,213,bisleri,6,15,9,1,218,India
924340,2024-02-13,208,sprite,75,100,25,1,15,India
924340,2024-02-13,212,amul cheese,250,315,65,1,15,India
924340,2024-02-13,204,strawberry yogurt,50,60,10,1,15,India
924340,2024-02-13,210,mountain dew,75,100,25,1,15,India
924340,2024-02-13,211,red bull,90,125,35,1,15,India
763584,2024-02-13,213,bisleri,6,15,9,1,386,India
110263,2024-02-13,205,classic yogurt,45,60,15,1,47,India
110263,2024-02-13,202,milk,12,27,15,1,47,India
110263,2024-02-13,211,red bull,90,125,35,1,47,India
110263,2024-02-13,206,yakult,360,400,40,1,47,India
272667,2024-02-13,203,mango yogurt,50,60,10,1,354,India
584250,2024-02-13,205,classic yogurt,45,60,15,1,393,India
584250,2024-02-13,206,yakult,360,400,40,1,393,India
584250,2024-02-13,212,amul cheese,250,315,65,1,393,India
584250,2024-02-13,201,paneer,210,340,130,1,393,India
584250,2024-02-13,202,milk,12,27,15,1,393,India
471560,2024-02-13,204,strawberry yogurt,50,60,10,1,465,India
471560,2024-02-13,211,red bull,90,125,35,1,465,India
471560,2024-02-13,208,sprite,75,100,25,1,465,India
606532,2024-02-13,209,pepsi,75,100,25,1,146,India
606532,2024-02-13,206,yakult,360,400,40,1,146,India
606532,2024-02-13,207,coca cola,75,100,25,1,146,India
606532,2024-02-13,205,classic yogurt,45,60,15,1,146,India
606532,2024-02-13,204,strawberry yogurt,50,60,10,1,146,India
564759,2024-02-13,203,mango yogurt,50,60,10,1,422,India
564759,2024-02-13,211,red bull,90,125,35,1,422,India
947674,2024-02-13,208,sprite,75,100,25,1,283,India
947674,2024-02-13,210,mountain dew,75,100,25,1,283,India
947674,2024-02-13,202,milk,12,27,15,1,283,India
868095,2024-02-13,202,milk,12,27,15,1,329,India
868095,2024-02-13,206,yakult,360,400,40,1,329,India
868095,2024-02-13,211,red bull,90,125,35,1,329,India
986335,2024-02-13,210,mountain dew,75,100,25,1,192,India
986335,2024-02-13,209,pepsi,75,100,25,1,192,India
164701,2024-02-13,211,red bull,90,125,35,1,283,India
107568,2024-02-13,205,classic yogurt,45,60,15,1,43,India
107568,2024-02-13,207,coca cola,75,100,25,1,43,India
318070,2024-02-13,209,pepsi,75,100,25,1,411,India
318070,2024-02-13,208,sprite,75,100,25,1,411,India
318070,2024-02-13,213,bisleri,6,15,9,1,411,India
491707,2024-02-13,212,amul cheese,250,315,65,1,97,India
491707,2024-02-13,204,strawberry yogurt,50,60,10,1,97,India
491707,2024-02-13,208,sprite,75,100,25,1,97,India
149203,2024-02-13,209,pepsi,75,100,25,1,81,India
149203,2024-02-13,205,classic yogurt,45,60,15,1,81,India
149203,2024-02-13,213,bisleri,6,15,9,1,81,India
149203,2024-02-13,212,amul cheese,250,315,65,1,81,India
149203,2024-02-13,204,strawberry yogurt,50,60,10,1,81,India
117994,2024-02-13,205,classic yogurt,45,60,15,1,92,India
693153,2024-02-13,202,milk,12,27,15,1,218,India
693153,2024-02-13,206,yakult,360,400,40,1,218,India
693153,2024-02-13,207,coca cola,75,100,25,1,218,India
693153,2024-02-13,203,mango yogurt,50,60,10,1,218,India
693153,2024-02-13,205,classic yogurt,45,60,15,1,218,India
798521,2024-02-13,207,coca cola,75,100,25,1,7,India
654689,2024-02-13,212,amul cheese,250,315,65,1,465,India
654689,2024-02-13,201,paneer,210,340,130,1,465,India
693226,2024-02-13,201,paneer,210,340,130,1,434,India
693226,2024-02-13,208,sprite,75,100,25,1,434,India
693226,2024-02-13,211,red bull,90,125,35,1,434,India
693226,2024-02-13,209,pepsi,75,100,25,1,434,India
379923,2024-02-13,204,strawberry yogurt,50,60,10,1,217,India
379923,2024-02-13,201,paneer,210,340,130,1,217,India
379923,2024-02-13,207,coca cola,75,100,25,1,217,India
379923,2024-02-13,208,sprite,75,100,25,1,217,India
956228,2024-02-13,209,pepsi,75,100,25,1,101,India
956228,2024-02-13,212,amul cheese,250,315,65,1,101,India
600130,2024-02-13,207,coca cola,75,100,25,1,464,India
600130,2024-02-13,209,pepsi,75,100,25,1,464,India
600130,2024-02-13,202,milk,12,27,15,1,464,India
600130,2024-02-13,205,classic yogurt,45,60,15,1,464,India
996779,2024-02-13,203,mango yogurt,50,60,10,1,408,India
403687,2024-02-13,202,milk,12,27,15,1,247,India
403687,2024-02-13,209,pepsi,75,100,25,1,247,India
486731,2024-02-13,206,yakult,360,400,40,1,24,India
486731,2024-02-13,207,coca cola,75,100,25,1,24,India
486731,2024-02-13,202,milk,12,27,15,1,24,India
565664,2024-02-13,204,strawberry yogurt,50,60,10,1,230,India
708140,2024-02-13,210,mountain dew,75,100,25,1,293,India
708140,2024-02-13,211,red bull,90,125,35,1,293,India
708140,2024-02-13,202,milk,12,27,15,1,293,India
926546,2024-02-13,207,coca cola,75,100,25,1,312,India
926546,2024-02-13,206,yakult,360,400,40,1,312,India
926546,2024-02-13,203,mango yogurt,50,60,10,1,312,India
926546,2024-02-13,201,paneer,210,340,130,1,312,India
926546,2024-02-13,208,sprite,75,100,25,1,312,India
444325,2024-02-13,212,amul cheese,250,315,65,1,118,India
444325,2024-02-13,207,coca cola,75,100,25,1,118,India
444325,2024-02-13,204,strawberry yogurt,50,60,10,1,118,India
444325,2024-02-13,202,milk,12,27,15,1,118,India
777901,2024-02-13,201,paneer,210,340,130,1,55,India
777901,2024-02-13,212,amul cheese,250,315,65,1,55,India
843860,2024-02-13,207,coca cola,75,100,25,1,59,India
843860,2024-02-13,203,mango yogurt,50,60,10,1,59,India
561539,2024-02-13,203,mango yogurt,50,60,10,1,361,India
536172,2024-02-13,206,yakult,360,400,40,1,185,India
536172,2024-02-13,205,classic yogurt,45,60,15,1,185,India
853074,2024-02-13,205,classic yogurt,45,60,15,1,45,India
996731,2024-02-13,213,bisleri,6,15,9,1,468,India
996731,2024-02-13,208,sprite,75,100,25,1,468,India
996731,2024-02-13,210,mountain dew,75,100,25,1,468,India
996731,2024-02-13,203,mango yogurt,50,60,10,1,468,India
129192,2024-02-13,210,mountain dew,75,100,25,1,159,India
560416,2024-02-13,213,bisleri,6,15,9,1,33,India
560416,2024-02-13,211,red bull,90,125,35,1,33,India
560416,2024-02-13,202,milk,12,27,15,1,33,India
560416,2024-02-13,209,pepsi,75,100,25,1,33,India
490151,2024-02-13,205,classic yogurt,45,60,15,1,443,India
490151,2024-02-13,203,mango yogurt,50,60,10,1,443,India
490151,2024-02-13,201,paneer,210,340,130,1,443,India
683604,2024-02-13,206,yakult,360,400,40,1,282,India
683604,2024-02-13,213,bisleri,6,15,9,1,282,India
683604,2024-02-13,205,classic yogurt,45,60,15,1,282,India
683604,2024-02-13,201,paneer,210,340,130,1,282,India
803365,2024-02-13,203,mango yogurt,50,60,10,1,21,India
572075,2024-02-13,211,red bull,90,125,35,1,65,India
572075,2024-02-13,205,classic yogurt,45,60,15,1,65,India
572075,2024-02-13,203,mango yogurt,50,60,10,1,65,India
572075,2024-02-13,202,milk,12,27,15,1,65,India
237652,2024-02-13,202,milk,12,27,15,1,192,India
613230,2024-02-13,202,milk,12,27,15,1,298,India
613230,2024-02-13,201,paneer,210,340,130,1,298,India
613230,2024-02-13,207,coca cola,75,100,25,1,298,India
613230,2024-02-13,211,red bull,90,125,35,1,298,India
613230,2024-02-13,209,pepsi,75,100,25,1,298,India
304035,2024-02-13,211,red bull,90,125,35,1,17,India
304035,2024-02-13,213,bisleri,6,15,9,1,17,India
304035,2024-02-13,204,strawberry yogurt,50,60,10,1,17,India
654073,2024-02-13,201,paneer,210,340,130,1,391,India
654073,2024-02-13,211,red bull,90,125,35,1,391,India
654073,2024-02-13,202,milk,12,27,15,1,391,India
135451,2024-02-14,210,mountain dew,75,100,25,1,340,India
135451,2024-02-14,206,yakult,360,400,40,1,340,India
633332,2024-02-14,211,red bull,90,125,35,1,237,India
896302,2024-02-14,213,bisleri,6,15,9,1,123,India
896302,2024-02-14,210,mountain dew,75,100,25,1,123,India
896302,2024-02-14,211,red bull,90,125,35,1,123,India
757999,2024-02-14,205,classic yogurt,45,60,15,1,212,India
757999,2024-02-14,203,mango yogurt,50,60,10,1,212,India
757999,2024-02-14,210,mountain dew,75,100,25,1,212,India
454765,2024-02-14,208,sprite,75,100,25,1,207,India
454765,2024-02-14,211,red bull,90,125,35,1,207,India
454765,2024-02-14,210,mountain dew,75,100,25,1,207,India
657637,2024-02-14,212,amul cheese,250,315,65,1,426,India
657637,2024-02-14,204,strawberry yogurt,50,60,10,1,426,India
657637,2024-02-14,210,mountain dew,75,100,25,1,426,India
657637,2024-02-14,202,milk,12,27,15,1,426,India
657637,2024-02-14,206,yakult,360,400,40,1,426,India
813418,2024-02-14,206,yakult,360,400,40,1,424,India
813418,2024-02-14,208,sprite,75,100,25,1,424,India
890995,2024-02-14,213,bisleri,6,15,9,1,419,India
890995,2024-02-14,208,sprite,75,100,25,1,419,India
890995,2024-02-14,211,red bull,90,125,35,1,419,India
890995,2024-02-14,210,mountain dew,75,100,25,1,419,India
890995,2024-02-14,205,classic yogurt,45,60,15,1,419,India
249921,2024-02-14,209,pepsi,75,100,25,1,488,India
249921,2024-02-14,202,milk,12,27,15,1,488,India
249921,2024-02-14,203,mango yogurt,50,60,10,1,488,India
249921,2024-02-14,204,strawberry yogurt,50,60,10,1,488,India
567269,2024-02-14,210,mountain dew,75,100,25,1,378,India
567269,2024-02-14,206,yakult,360,400,40,1,378,India
567269,2024-02-14,202,milk,12,27,15,1,378,India
567269,2024-02-14,213,bisleri,6,15,9,1,378,India
567269,2024-02-14,211,red bull,90,125,35,1,378,India
251531,2024-02-14,210,mountain dew,75,100,25,1,156,India
251531,2024-02-14,206,yakult,360,400,40,1,156,India
251531,2024-02-14,209,pepsi,75,100,25,1,156,India
513986,2024-02-14,208,sprite,75,100,25,1,324,India
513986,2024-02-14,213,bisleri,6,15,9,1,324,India
513986,2024-02-14,205,classic yogurt,45,60,15,1,324,India
634823,2024-02-14,209,pepsi,75,100,25,1,255,India
702900,2024-02-14,212,amul cheese,250,315,65,1,382,India
702900,2024-02-14,211,red bull,90,125,35,1,382,India
702900,2024-02-14,202,milk,12,27,15,1,382,India
702900,2024-02-14,205,classic yogurt,45,60,15,1,382,India
909090,2024-02-14,213,bisleri,6,15,9,1,285,India
909090,2024-02-14,207,coca cola,75,100,25,1,285,India
689234,2024-02-14,211,red bull,90,125,35,1,102,India
689234,2024-02-14,206,yakult,360,400,40,1,102,India
689234,2024-02-14,209,pepsi,75,100,25,1,102,India
689234,2024-02-14,212,amul cheese,250,315,65,1,102,India
689234,2024-02-14,207,coca cola,75,100,25,1,102,India
962367,2024-02-14,206,yakult,360,400,40,1,414,India
962367,2024-02-14,213,bisleri,6,15,9,1,414,India
962367,2024-02-14,210,mountain dew,75,100,25,1,414,India
962367,2024-02-14,208,sprite,75,100,25,1,414,India
816820,2024-02-14,203,mango yogurt,50,60,10,1,191,India
385615,2024-02-14,206,yakult,360,400,40,1,186,India
385615,2024-02-14,209,pepsi,75,100,25,1,186,India
385615,2024-02-14,210,mountain dew,75,100,25,1,186,India
834730,2024-02-14,201,paneer,210,340,130,1,330,India
809397,2024-02-14,203,mango yogurt,50,60,10,1,369,India
809397,2024-02-14,212,amul cheese,250,315,65,1,369,India
878444,2024-02-14,204,strawberry yogurt,50,60,10,1,82,India
878444,2024-02-14,203,mango yogurt,50,60,10,1,82,India
553302,2024-02-14,202,milk,12,27,15,1,491,India
553302,2024-02-14,201,paneer,210,340,130,1,491,India
329865,2024-02-14,207,coca cola,75,100,25,1,235,India
329865,2024-02-14,210,mountain dew,75,100,25,1,235,India
670933,2024-02-14,209,pepsi,75,100,25,1,112,India
670933,2024-02-14,210,mountain dew,75,100,25,1,112,India
670933,2024-02-14,205,classic yogurt,45,60,15,1,112,India
670933,2024-02-14,203,mango yogurt,50,60,10,1,112,India
670933,2024-02-14,208,sprite,75,100,25,1,112,India
247489,2024-02-14,203,mango yogurt,50,60,10,1,356,India
247489,2024-02-14,201,paneer,210,340,130,1,356,India
247489,2024-02-14,212,amul cheese,250,315,65,1,356,India
247489,2024-02-14,207,coca cola,75,100,25,1,356,India
112279,2024-02-14,209,pepsi,75,100,25,1,451,India
350381,2024-02-14,206,yakult,360,400,40,1,435,India
976686,2024-02-14,213,bisleri,6,15,9,1,27,India
976686,2024-02-14,204,strawberry yogurt,50,60,10,1,27,India
976686,2024-02-14,208,sprite,75,100,25,1,27,India
976686,2024-02-14,209,pepsi,75,100,25,1,27,India
582773,2024-02-14,208,sprite,75,100,25,1,473,India
582773,2024-02-14,204,strawberry yogurt,50,60,10,1,473,India
510848,2024-02-14,207,coca cola,75,100,25,1,122,India
510848,2024-02-14,213,bisleri,6,15,9,1,122,India
667352,2024-02-14,210,mountain dew,75,100,25,1,295,India
667352,2024-02-14,213,bisleri,6,15,9,1,295,India
667352,2024-02-14,203,mango yogurt,50,60,10,1,295,India
257492,2024-02-14,210,mountain dew,75,100,25,1,93,India
257492,2024-02-14,208,sprite,75,100,25,1,93,India
257492,2024-02-14,201,paneer,210,340,130,1,93,India
257492,2024-02-14,209,pepsi,75,100,25,1,93,India
974325,2024-02-14,207,coca cola,75,100,25,1,17,India
974325,2024-02-14,210,mountain dew,75,100,25,1,17,India
974325,2024-02-14,211,red bull,90,125,35,1,17,India
974325,2024-02-14,208,sprite,75,100,25,1,17,India
356754,2024-02-14,210,mountain dew,75,100,25,1,222,India
356754,2024-02-14,211,red bull,90,125,35,1,222,India
356754,2024-02-14,206,yakult,360,400,40,1,222,India
356754,2024-02-14,209,pepsi,75,100,25,1,222,India
857934,2024-02-14,208,sprite,75,100,25,1,216,India
857934,2024-02-14,207,coca cola,75,100,25,1,216,India
857934,2024-02-14,210,mountain dew,75,100,25,1,216,India
636296,2024-02-14,208,sprite,75,100,25,1,73,India
522607,2024-02-14,201,paneer,210,340,130,1,410,India
522607,2024-02-14,203,mango yogurt,50,60,10,1,410,India
522607,2024-02-14,207,coca cola,75,100,25,1,410,India
993010,2024-02-14,203,mango yogurt,50,60,10,1,492,India
987491,2024-02-14,210,mountain dew,75,100,25,1,198,India
945705,2024-02-14,212,amul cheese,250,315,65,1,487,India
945705,2024-02-14,210,mountain dew,75,100,25,1,487,India
972853,2024-02-14,209,pepsi,75,100,25,1,316,India
167975,2024-02-14,206,yakult,360,400,40,1,489,India
167975,2024-02-14,212,amul cheese,250,315,65,1,489,India
167975,2024-02-14,210,mountain dew,75,100,25,1,489,India
167975,2024-02-14,202,milk,12,27,15,1,489,India
969838,2024-02-14,207,coca cola,75,100,25,1,292,India
969838,2024-02-14,201,paneer,210,340,130,1,292,India
969838,2024-02-14,213,bisleri,6,15,9,1,292,India
969838,2024-02-14,203,mango yogurt,50,60,10,1,292,India
837785,2024-02-14,206,yakult,360,400,40,1,443,India
837785,2024-02-14,204,strawberry yogurt,50,60,10,1,443,India
837785,2024-02-14,211,red bull,90,125,35,1,443,India
837785,2024-02-14,205,classic yogurt,45,60,15,1,443,India
195991,2024-02-14,211,red bull,90,125,35,1,394,India
195991,2024-02-14,207,coca cola,75,100,25,1,394,India
425003,2024-02-14,207,coca cola,75,100,25,1,301,India
425003,2024-02-14,205,classic yogurt,45,60,15,1,301,India
425003,2024-02-14,203,mango yogurt,50,60,10,1,301,India
976502,2024-02-14,201,paneer,210,340,130,1,262,India
976502,2024-02-14,210,mountain dew,75,100,25,1,262,India
976502,2024-02-14,213,bisleri,6,15,9,1,262,India
976502,2024-02-14,207,coca cola,75,100,25,1,262,India
976502,2024-02-14,204,strawberry yogurt,50,60,10,1,262,India
741502,2024-02-14,203,mango yogurt,50,60,10,1,173,India
741502,2024-02-14,210,mountain dew,75,100,25,1,173,India
645721,2024-02-14,203,mango yogurt,50,60,10,1,426,India
645721,2024-02-14,209,pepsi,75,100,25,1,426,India
144783,2024-02-14,203,mango yogurt,50,60,10,1,307,India
144783,2024-02-14,208,sprite,75,100,25,1,307,India
144783,2024-02-14,205,classic yogurt,45,60,15,1,307,India
412379,2024-02-14,203,mango yogurt,50,60,10,1,298,India
412379,2024-02-14,211,red bull,90,125,35,1,298,India
412379,2024-02-14,208,sprite,75,100,25,1,298,India
412379,2024-02-14,202,milk,12,27,15,1,298,India
448584,2024-02-14,204,strawberry yogurt,50,60,10,1,86,India
448584,2024-02-14,212,amul cheese,250,315,65,1,86,India
894836,2024-02-14,209,pepsi,75,100,25,1,309,India
894836,2024-02-14,211,red bull,90,125,35,1,309,India
894836,2024-02-14,206,yakult,360,400,40,1,309,India
894836,2024-02-14,207,coca cola,75,100,25,1,309,India
263028,2024-02-15,201,paneer,210,340,130,1,269,India
263028,2024-02-15,210,mountain dew,75,100,25,1,269,India
426955,2024-02-15,213,bisleri,6,15,9,1,343,India
611316,2024-02-15,201,paneer,210,340,130,1,106,India
611316,2024-02-15,206,yakult,360,400,40,1,106,India
918288,2024-02-15,202,milk,12,27,15,1,81,India
918288,2024-02-15,213,bisleri,6,15,9,1,81,India
125757,2024-02-15,209,pepsi,75,100,25,1,379,India
125757,2024-02-15,208,sprite,75,100,25,1,379,India
264608,2024-02-15,207,coca cola,75,100,25,1,157,India
264608,2024-02-15,202,milk,12,27,15,1,157,India
264608,2024-02-15,208,sprite,75,100,25,1,157,India
264608,2024-02-15,203,mango yogurt,50,60,10,1,157,India
232004,2024-02-15,202,milk,12,27,15,1,87,India
232004,2024-02-15,201,paneer,210,340,130,1,87,India
232004,2024-02-15,209,pepsi,75,100,25,1,87,India
662515,2024-02-15,203,mango yogurt,50,60,10,1,482,India
336167,2024-02-15,206,yakult,360,400,40,1,328,India
336167,2024-02-15,209,pepsi,75,100,25,1,328,India
336167,2024-02-15,211,red bull,90,125,35,1,328,India
734651,2024-02-15,211,red bull,90,125,35,1,381,India
734651,2024-02-15,212,amul cheese,250,315,65,1,381,India
734651,2024-02-15,209,pepsi,75,100,25,1,381,India
734651,2024-02-15,203,mango yogurt,50,60,10,1,381,India
291137,2024-02-15,205,classic yogurt,45,60,15,1,362,India
225340,2024-02-15,202,milk,12,27,15,1,494,India
225340,2024-02-15,211,red bull,90,125,35,1,494,India
225340,2024-02-15,201,paneer,210,340,130,1,494,India
649954,2024-02-15,210,mountain dew,75,100,25,1,38,India
649954,2024-02-15,207,coca cola,75,100,25,1,38,India
649954,2024-02-15,202,milk,12,27,15,1,38,India
670213,2024-02-15,204,strawberry yogurt,50,60,10,1,168,India
670213,2024-02-15,208,sprite,75,100,25,1,168,India
670213,2024-02-15,201,paneer,210,340,130,1,168,India
670213,2024-02-15,212,amul cheese,250,315,65,1,168,India
670213,2024-02-15,210,mountain dew,75,100,25,1,168,India
979755,2024-02-15,205,classic yogurt,45,60,15,1,298,India
979755,2024-02-15,212,amul cheese,250,315,65,1,298,India
979755,2024-02-15,204,strawberry yogurt,50,60,10,1,298,India
979755,2024-02-15,209,pepsi,75,100,25,1,298,India
103401,2024-02-15,203,mango yogurt,50,60,10,1,32,India
103401,2024-02-15,213,bisleri,6,15,9,1,32,India
103401,2024-02-15,206,yakult,360,400,40,1,32,India
257218,2024-02-15,202,milk,12,27,15,1,366,India
191559,2024-02-15,206,yakult,360,400,40,1,368,India
191559,2024-02-15,210,mountain dew,75,100,25,1,368,India
191559,2024-02-15,209,pepsi,75,100,25,1,368,India
191559,2024-02-15,204,strawberry yogurt,50,60,10,1,368,India
191559,2024-02-15,207,coca cola,75,100,25,1,368,India
979160,2024-02-15,212,amul cheese,250,315,65,1,410,India
318165,2024-02-15,208,sprite,75,100,25,1,253,India
618965,2024-02-15,209,pepsi,75,100,25,1,476,India
843914,2024-02-15,210,mountain dew,75,100,25,1,212,India
843914,2024-02-15,201,paneer,210,340,130,1,212,India
699736,2024-02-15,204,strawberry yogurt,50,60,10,1,157,India
699736,2024-02-15,208,sprite,75,100,25,1,157,India
964715,2024-02-15,209,pepsi,75,100,25,1,88,India
964715,2024-02-15,212,amul cheese,250,315,65,1,88,India
964715,2024-02-15,204,strawberry yogurt,50,60,10,1,88,India
964715,2024-02-15,205,classic yogurt,45,60,15,1,88,India
166109,2024-02-15,211,red bull,90,125,35,1,366,India
166109,2024-02-15,205,classic yogurt,45,60,15,1,366,India
166109,2024-02-15,209,pepsi,75,100,25,1,366,India
166109,2024-02-15,202,milk,12,27,15,1,366,India
166109,2024-02-15,207,coca cola,75,100,25,1,366,India
782648,2024-02-15,204,strawberry yogurt,50,60,10,1,371,India
782648,2024-02-15,203,mango yogurt,50,60,10,1,371,India
782648,2024-02-15,209,pepsi,75,100,25,1,371,India
782648,2024-02-15,211,red bull,90,125,35,1,371,India
917060,2024-02-15,209,pepsi,75,100,25,1,463,India
917060,2024-02-15,210,mountain dew,75,100,25,1,463,India
869091,2024-02-15,210,mountain dew,75,100,25,1,55,India
869091,2024-02-15,205,classic yogurt,45,60,15,1,55,India
869091,2024-02-15,201,paneer,210,340,130,1,55,India
869091,2024-02-15,213,bisleri,6,15,9,1,55,India
694200,2024-02-15,212,amul cheese,250,315,65,1,67,India
694200,2024-02-15,207,coca cola,75,100,25,1,67,India
694200,2024-02-15,210,mountain dew,75,100,25,1,67,India
694200,2024-02-15,204,strawberry yogurt,50,60,10,1,67,India
681882,2024-02-15,213,bisleri,6,15,9,1,260,India
681882,2024-02-15,201,paneer,210,340,130,1,260,India
541821,2024-02-15,201,paneer,210,340,130,1,331,India
541821,2024-02-15,207,coca cola,75,100,25,1,331,India
541821,2024-02-15,204,strawberry yogurt,50,60,10,1,331,India
541821,2024-02-15,212,amul cheese,250,315,65,1,331,India
384620,2024-02-15,213,bisleri,6,15,9,1,224,India
384620,2024-02-15,212,amul cheese,250,315,65,1,224,India
384620,2024-02-15,208,sprite,75,100,25,1,224,India
154318,2024-02-15,207,coca cola,75,100,25,1,442,India
154318,2024-02-15,213,bisleri,6,15,9,1,442,India
154318,2024-02-15,202,milk,12,27,15,1,442,India
346197,2024-02-15,213,bisleri,6,15,9,1,173,India
346197,2024-02-15,212,amul cheese,250,315,65,1,173,India
346197,2024-02-15,202,milk,12,27,15,1,173,India
346197,2024-02-15,207,coca cola,75,100,25,1,173,India
346197,2024-02-15,211,red bull,90,125,35,1,173,India
739622,2024-02-15,210,mountain dew,75,100,25,1,237,India
739622,2024-02-15,201,paneer,210,340,130,1,237,India
894622,2024-02-15,209,pepsi,75,100,25,1,21,India
866685,2024-02-15,207,coca cola,75,100,25,1,33,India
673563,2024-02-15,205,classic yogurt,45,60,15,1,339,India
673563,2024-02-15,202,milk,12,27,15,1,339,India
673563,2024-02-15,213,bisleri,6,15,9,1,339,India
673563,2024-02-15,208,sprite,75,100,25,1,339,India
402112,2024-02-15,210,mountain dew,75,100,25,1,63,India
170430,2024-02-15,201,paneer,210,340,130,1,74,India
656369,2024-02-15,207,coca cola,75,100,25,1,121,India
656369,2024-02-15,211,red bull,90,125,35,1,121,India
656369,2024-02-15,208,sprite,75,100,25,1,121,India
782805,2024-02-15,208,sprite,75,100,25,1,361,India
782805,2024-02-15,209,pepsi,75,100,25,1,361,India
383995,2024-02-15,203,mango yogurt,50,60,10,1,493,India
383995,2024-02-15,201,paneer,210,340,130,1,493,India
383995,2024-02-15,208,sprite,75,100,25,1,493,India
556987,2024-02-15,213,bisleri,6,15,9,1,297,India
556987,2024-02-15,202,milk,12,27,15,1,297,India
556987,2024-02-15,204,strawberry yogurt,50,60,10,1,297,India
556987,2024-02-15,208,sprite,75,100,25,1,297,India
990688,2024-02-15,208,sprite,75,100,25,1,176,India
990688,2024-02-15,210,mountain dew,75,100,25,1,176,India
990688,2024-02-15,207,coca cola,75,100,25,1,176,India
130692,2024-02-15,201,paneer,210,340,130,1,486,India
130692,2024-02-15,203,mango yogurt,50,60,10,1,486,India
395027,2024-02-15,207,coca cola,75,100,25,1,464,India
395027,2024-02-15,210,mountain dew,75,100,25,1,464,India
428563,2024-02-15,209,pepsi,75,100,25,1,473,India
988703,2024-02-15,209,pepsi,75,100,25,1,424,India
988703,2024-02-15,211,red bull,90,125,35,1,424,India
988703,2024-02-15,206,yakult,360,400,40,1,424,India
154607,2024-02-15,203,mango yogurt,50,60,10,1,174,India
154607,2024-02-15,210,mountain dew,75,100,25,1,174,India
154607,2024-02-15,212,amul cheese,250,315,65,1,174,India
154607,2024-02-15,206,yakult,360,400,40,1,174,India
484367,2024-02-15,209,pepsi,75,100,25,1,357,India
484367,2024-02-15,206,yakult,360,400,40,1,357,India
484367,2024-02-15,210,mountain dew,75,100,25,1,357,India
484367,2024-02-15,208,sprite,75,100,25,1,357,India
484367,2024-02-15,203,mango yogurt,50,60,10,1,357,India
913374,2024-02-15,210,mountain dew,75,100,25,1,426,India
913374,2024-02-15,203,mango yogurt,50,60,10,1,426,India
913374,2024-02-15,213,bisleri,6,15,9,1,426,India
267932,2024-02-15,206,yakult,360,400,40,1,175,India
267932,2024-02-15,202,milk,12,27,15,1,175,India
317396,2024-02-15,201,paneer,210,340,130,1,226,India
317396,2024-02-15,204,strawberry yogurt,50,60,10,1,226,India
317396,2024-02-15,209,pepsi,75,100,25,1,226,India
388183,2024-02-15,208,sprite,75,100,25,1,33,India
388183,2024-02-15,207,coca cola,75,100,25,1,33,India
747621,2024-02-15,203,mango yogurt,50,60,10,1,15,India
747621,2024-02-15,210,mountain dew,75,100,25,1,15,India
747621,2024-02-15,209,pepsi,75,100,25,1,15,India
882088,2024-02-15,213,bisleri,6,15,9,1,282,India
882088,2024-02-15,203,mango yogurt,50,60,10,1,282,India
453745,2024-02-15,201,paneer,210,340,130,1,180,India
453745,2024-02-15,209,pepsi,75,100,25,1,180,India
453745,2024-02-15,203,mango yogurt,50,60,10,1,180,India
850978,2024-02-15,203,mango yogurt,50,60,10,1,63,India
850978,2024-02-15,208,sprite,75,100,25,1,63,India
850978,2024-02-15,202,milk,12,27,15,1,63,India
289310,2024-02-15,209,pepsi,75,100,25,1,351,India
466618,2024-02-15,202,milk,12,27,15,1,144,India
466618,2024-02-15,211,red bull,90,125,35,1,144,India
466618,2024-02-15,207,coca cola,75,100,25,1,144,India
466618,2024-02-15,203,mango yogurt,50,60,10,1,144,India
466618,2024-02-15,209,pepsi,75,100,25,1,144,India
275970,2024-02-15,201,paneer,210,340,130,1,303,India
275970,2024-02-15,212,amul cheese,250,315,65,1,303,India
275970,2024-02-15,207,coca cola,75,100,25,1,303,India
282682,2024-02-15,209,pepsi,75,100,25,1,93,India
863256,2024-02-15,206,yakult,360,400,40,1,341,India
863256,2024-02-15,202,milk,12,27,15,1,341,India
863256,2024-02-15,205,classic yogurt,45,60,15,1,341,India
863256,2024-02-15,209,pepsi,75,100,25,1,341,India
290021,2024-02-15,202,milk,12,27,15,1,37,India
290021,2024-02-15,205,classic yogurt,45,60,15,1,37,India
290021,2024-02-15,203,mango yogurt,50,60,10,1,37,India
790016,2024-02-15,211,red bull,90,125,35,1,241,India
790016,2024-02-15,206,yakult,360,400,40,1,241,India
790016,2024-02-15,210,mountain dew,75,100,25,1,241,India
961600,2024-02-15,203,mango yogurt,50,60,10,1,104,India
961600,2024-02-15,205,classic yogurt,45,60,15,1,104,India
748092,2024-02-15,212,amul cheese,250,315,65,1,118,India
748092,2024-02-15,203,mango yogurt,50,60,10,1,118,India
159516,2024-02-15,202,milk,12,27,15,1,374,India
873265,2024-02-15,208,sprite,75,100,25,1,72,India
873265,2024-02-15,209,pepsi,75,100,25,1,72,India
873265,2024-02-15,204,strawberry yogurt,50,60,10,1,72,India
873265,2024-02-15,203,mango yogurt,50,60,10,1,72,India
215883,2024-02-15,211,red bull,90,125,35,1,181,India
522070,2024-02-15,211,red bull,90,125,35,1,140,India
959642,2024-02-15,205,classic yogurt,45,60,15,1,462,India
959642,2024-02-15,213,bisleri,6,15,9,1,462,India
959642,2024-02-15,209,pepsi,75,100,25,1,462,India
959642,2024-02-15,208,sprite,75,100,25,1,462,India
576019,2024-02-15,202,milk,12,27,15,1,139,India
576019,2024-02-15,206,yakult,360,400,40,1,139,India
576019,2024-02-15,210,mountain dew,75,100,25,1,139,India
576019,2024-02-15,209,pepsi,75,100,25,1,139,India
340803,2024-02-15,207,coca cola,75,100,25,1,42,India
340803,2024-02-15,204,strawberry yogurt,50,60,10,1,42,India
340803,2024-02-15,201,paneer,210,340,130,1,42,India
340803,2024-02-15,203,mango yogurt,50,60,10,1,42,India
340803,2024-02-15,208,sprite,75,100,25,1,42,India
671444,2024-02-15,211,red bull,90,125,35,1,318,India
430631,2024-02-15,204,strawberry yogurt,50,60,10,1,258,India
430631,2024-02-15,213,bisleri,6,15,9,1,258,India
669951,2024-02-15,213,bisleri,6,15,9,1,186,India
374439,2024-02-15,211,red bull,90,125,35,1,141,India
374439,2024-02-15,210,mountain dew,75,100,25,1,141,India
374439,2024-02-15,206,yakult,360,400,40,1,141,India
989028,2024-02-15,211,red bull,90,125,35,1,18,India
989028,2024-02-15,205,classic yogurt,45,60,15,1,18,India
989028,2024-02-15,213,bisleri,6,15,9,1,18,India
637209,2024-02-15,202,milk,12,27,15,1,481,India
751458,2024-02-15,205,classic yogurt,45,60,15,1,468,India
894195,2024-02-15,201,paneer,210,340,130,1,85,India
894195,2024-02-15,213,bisleri,6,15,9,1,85,India
130893,2024-02-15,203,mango yogurt,50,60,10,1,387,India
130893,2024-02-15,213,bisleri,6,15,9,1,387,India
130893,2024-02-15,204,strawberry yogurt,50,60,10,1,387,India
580560,2024-02-15,208,sprite,75,100,25,1,311,India
580560,2024-02-15,209,pepsi,75,100,25,1,311,India
580560,2024-02-15,204,strawberry yogurt,50,60,10,1,311,India
580560,2024-02-15,201,paneer,210,340,130,1,311,India
601971,2024-02-15,208,sprite,75,100,25,1,373,India
601971,2024-02-15,206,yakult,360,400,40,1,373,India
601971,2024-02-15,213,bisleri,6,15,9,1,373,India
161350,2024-02-15,204,strawberry yogurt,50,60,10,1,467,India
161350,2024-02-15,207,coca cola,75,100,25,1,467,India
177539,2024-02-15,204,strawberry yogurt,50,60,10,1,487,India
177539,2024-02-15,206,yakult,360,400,40,1,487,India
177539,2024-02-15,209,pepsi,75,100,25,1,487,India
177539,2024-02-15,201,paneer,210,340,130,1,487,India
506328,2024-02-15,202,milk,12,27,15,1,426,India
506328,2024-02-15,208,sprite,75,100,25,1,426,India
506328,2024-02-15,212,amul cheese,250,315,65,1,426,India
148632,2024-02-15,213,bisleri,6,15,9,1,314,India
705971,2024-02-15,202,milk,12,27,15,1,194,India
705971,2024-02-15,203,mango yogurt,50,60,10,1,194,India
705971,2024-02-15,206,yakult,360,400,40,1,194,India
705971,2024-02-15,205,classic yogurt,45,60,15,1,194,India
661410,2024-02-15,212,amul cheese,250,315,65,1,270,India
661410,2024-02-15,202,milk,12,27,15,1,270,India
661410,2024-02-15,213,bisleri,6,15,9,1,270,India
170984,2024-02-15,212,amul cheese,250,315,65,1,133,India
170984,2024-02-15,209,pepsi,75,100,25,1,133,India
170984,2024-02-15,204,strawberry yogurt,50,60,10,1,133,India
962187,2024-02-15,211,red bull,90,125,35,1,183,India
962187,2024-02-15,208,sprite,75,100,25,1,183,India
962187,2024-02-15,206,yakult,360,400,40,1,183,India
962187,2024-02-15,204,strawberry yogurt,50,60,10,1,183,India
166853,2024-02-15,204,strawberry yogurt,50,60,10,1,414,India
166853,2024-02-15,208,sprite,75,100,25,1,414,India
774212,2024-02-16,213,bisleri,6,15,9,1,356,India
774212,2024-02-16,211,red bull,90,125,35,1,356,India
888947,2024-02-16,212,amul cheese,250,315,65,1,153,India
888947,2024-02-16,204,strawberry yogurt,50,60,10,1,153,India
888947,2024-02-16,202,milk,12,27,15,1,153,India
311346,2024-02-16,210,mountain dew,75,100,25,1,312,India
949991,2024-02-16,202,milk,12,27,15,1,63,India
949991,2024-02-16,212,amul cheese,250,315,65,1,63,India
949991,2024-02-16,207,coca cola,75,100,25,1,63,India
560777,2024-02-16,209,pepsi,75,100,25,1,387,India
560777,2024-02-16,206,yakult,360,400,40,1,387,India
843297,2024-02-16,207,coca cola,75,100,25,1,500,India
428496,2024-02-16,210,mountain dew,75,100,25,1,114,India
798770,2024-02-16,211,red bull,90,125,35,1,390,India
942945,2024-02-16,208,sprite,75,100,25,1,416,India
942945,2024-02-16,205,classic yogurt,45,60,15,1,416,India
942945,2024-02-16,206,yakult,360,400,40,1,416,India
115218,2024-02-16,203,mango yogurt,50,60,10,1,456,India
115218,2024-02-16,202,milk,12,27,15,1,456,India
115218,2024-02-16,209,pepsi,75,100,25,1,456,India
115218,2024-02-16,206,yakult,360,400,40,1,456,India
153354,2024-02-16,211,red bull,90,125,35,1,435,India
153354,2024-02-16,209,pepsi,75,100,25,1,435,India
153354,2024-02-16,210,mountain dew,75,100,25,1,435,India
153354,2024-02-16,204,strawberry yogurt,50,60,10,1,435,India
297233,2024-02-16,208,sprite,75,100,25,1,59,India
297233,2024-02-16,213,bisleri,6,15,9,1,59,India
297233,2024-02-16,212,amul cheese,250,315,65,1,59,India
297233,2024-02-16,204,strawberry yogurt,50,60,10,1,59,India
463400,2024-02-16,203,mango yogurt,50,60,10,1,188,India
463400,2024-02-16,202,milk,12,27,15,1,188,India
463400,2024-02-16,213,bisleri,6,15,9,1,188,India
463400,2024-02-16,208,sprite,75,100,25,1,188,India
144089,2024-02-16,209,pepsi,75,100,25,1,76,India
144089,2024-02-16,205,classic yogurt,45,60,15,1,76,India
144089,2024-02-16,206,yakult,360,400,40,1,76,India
144089,2024-02-16,201,paneer,210,340,130,1,76,India
353248,2024-02-16,208,sprite,75,100,25,1,474,India
353248,2024-02-16,202,milk,12,27,15,1,474,India
353248,2024-02-16,206,yakult,360,400,40,1,474,India
353248,2024-02-16,204,strawberry yogurt,50,60,10,1,474,India
819239,2024-02-16,211,red bull,90,125,35,1,58,India
819239,2024-02-16,213,bisleri,6,15,9,1,58,India
460923,2024-02-16,201,paneer,210,340,130,1,59,India
460923,2024-02-16,208,sprite,75,100,25,1,59,India
460923,2024-02-16,205,classic yogurt,45,60,15,1,59,India
903053,2024-02-16,206,yakult,360,400,40,1,478,India
903053,2024-02-16,213,bisleri,6,15,9,1,478,India
903053,2024-02-16,203,mango yogurt,50,60,10,1,478,India
903053,2024-02-16,212,amul cheese,250,315,65,1,478,India
703960,2024-02-16,202,milk,12,27,15,1,202,India
703960,2024-02-16,205,classic yogurt,45,60,15,1,202,India
735176,2024-02-16,209,pepsi,75,100,25,1,256,India
735176,2024-02-16,208,sprite,75,100,25,1,256,India
735176,2024-02-16,210,mountain dew,75,100,25,1,256,India
117486,2024-02-16,207,coca cola,75,100,25,1,214,India
117486,2024-02-16,201,paneer,210,340,130,1,214,India
596252,2024-02-16,208,sprite,75,100,25,1,496,India
596252,2024-02-16,205,classic yogurt,45,60,15,1,496,India
596252,2024-02-16,201,paneer,210,340,130,1,496,India
596252,2024-02-16,203,mango yogurt,50,60,10,1,496,India
572632,2024-02-16,208,sprite,75,100,25,1,129,India
691523,2024-02-16,204,strawberry yogurt,50,60,10,1,43,India
750768,2024-02-16,209,pepsi,75,100,25,1,465,India
750768,2024-02-16,207,coca cola,75,100,25,1,465,India
750768,2024-02-16,204,strawberry yogurt,50,60,10,1,465,India
750768,2024-02-16,208,sprite,75,100,25,1,465,India
413287,2024-02-16,205,classic yogurt,45,60,15,1,285,India
413287,2024-02-16,208,sprite,75,100,25,1,285,India
413287,2024-02-16,204,strawberry yogurt,50,60,10,1,285,India
442901,2024-02-16,211,red bull,90,125,35,1,86,India
442901,2024-02-16,204,strawberry yogurt,50,60,10,1,86,India
442901,2024-02-16,212,amul cheese,250,315,65,1,86,India
848568,2024-02-16,208,sprite,75,100,25,1,326,India
848568,2024-02-16,213,bisleri,6,15,9,1,326,India
848568,2024-02-16,207,coca cola,75,100,25,1,326,India
848568,2024-02-16,212,amul cheese,250,315,65,1,326,India
718420,2024-02-16,204,strawberry yogurt,50,60,10,1,60,India
718420,2024-02-16,211,red bull,90,125,35,1,60,India
718420,2024-02-16,213,bisleri,6,15,9,1,60,India
718420,2024-02-16,210,mountain dew,75,100,25,1,60,India
237315,2024-02-16,207,coca cola,75,100,25,1,23,India
237315,2024-02-16,204,strawberry yogurt,50,60,10,1,23,India
186785,2024-02-16,209,pepsi,75,100,25,1,14,India
528361,2024-02-16,203,mango yogurt,50,60,10,1,348,India
528361,2024-02-16,213,bisleri,6,15,9,1,348,India
307464,2024-02-16,209,pepsi,75,100,25,1,483,India
307464,2024-02-16,202,milk,12,27,15,1,483,India
307464,2024-02-16,212,amul cheese,250,315,65,1,483,India
307464,2024-02-16,201,paneer,210,340,130,1,483,India
240647,2024-02-16,212,amul cheese,250,315,65,1,142,India
240647,2024-02-16,201,paneer,210,340,130,1,142,India
240647,2024-02-16,209,pepsi,75,100,25,1,142,India
151022,2024-02-16,202,milk,12,27,15,1,99,India
151022,2024-02-16,213,bisleri,6,15,9,1,99,India
167472,2024-02-16,212,amul cheese,250,315,65,1,351,India
167472,2024-02-16,204,strawberry yogurt,50,60,10,1,351,India
167472,2024-02-16,201,paneer,210,340,130,1,351,India
167472,2024-02-16,210,mountain dew,75,100,25,1,351,India
451300,2024-02-16,208,sprite,75,100,25,1,348,India
451300,2024-02-16,202,milk,12,27,15,1,348,India
451300,2024-02-16,209,pepsi,75,100,25,1,348,India
322881,2024-02-16,205,classic yogurt,45,60,15,1,145,India
322881,2024-02-16,207,coca cola,75,100,25,1,145,India
322881,2024-02-16,211,red bull,90,125,35,1,145,India
322881,2024-02-16,213,bisleri,6,15,9,1,145,India
979945,2024-02-16,208,sprite,75,100,25,1,318,India
979945,2024-02-16,213,bisleri,6,15,9,1,318,India
979945,2024-02-16,206,yakult,360,400,40,1,318,India
195195,2024-02-16,207,coca cola,75,100,25,1,204,India
195195,2024-02-16,205,classic yogurt,45,60,15,1,204,India
551075,2024-02-16,212,amul cheese,250,315,65,1,272,India
551075,2024-02-16,208,sprite,75,100,25,1,272,India
551075,2024-02-16,204,strawberry yogurt,50,60,10,1,272,India
551075,2024-02-16,202,milk,12,27,15,1,272,India
181708,2024-02-16,202,milk,12,27,15,1,231,India
291628,2024-02-16,212,amul cheese,250,315,65,1,116,India
291628,2024-02-16,204,strawberry yogurt,50,60,10,1,116,India
291628,2024-02-16,210,mountain dew,75,100,25,1,116,India
291628,2024-02-16,203,mango yogurt,50,60,10,1,116,India
292942,2024-02-16,212,amul cheese,250,315,65,1,124,India
594344,2024-02-16,201,paneer,210,340,130,1,22,India
594344,2024-02-16,205,classic yogurt,45,60,15,1,22,India
594344,2024-02-16,212,amul cheese,250,315,65,1,22,India
594344,2024-02-16,204,strawberry yogurt,50,60,10,1,22,India
260212,2024-02-16,210,mountain dew,75,100,25,1,64,India
260212,2024-02-16,213,bisleri,6,15,9,1,64,India
260212,2024-02-16,201,paneer,210,340,130,1,64,India
260212,2024-02-16,204,strawberry yogurt,50,60,10,1,64,India
995124,2024-02-16,210,mountain dew,75,100,25,1,333,India
995124,2024-02-16,204,strawberry yogurt,50,60,10,1,333,India
995124,2024-02-16,203,mango yogurt,50,60,10,1,333,India
995124,2024-02-16,212,amul cheese,250,315,65,1,333,India
995124,2024-02-16,206,yakult,360,400,40,1,333,India
768300,2024-02-16,203,mango yogurt,50,60,10,1,84,India
780593,2024-02-16,213,bisleri,6,15,9,1,19,India
780593,2024-02-16,201,paneer,210,340,130,1,19,India
642944,2024-02-16,208,sprite,75,100,25,1,63,India
642944,2024-02-16,211,red bull,90,125,35,1,63,India
642944,2024-02-16,212,amul cheese,250,315,65,1,63,India
608609,2024-02-16,205,classic yogurt,45,60,15,1,276,India
608609,2024-02-16,207,coca cola,75,100,25,1,276,India
608609,2024-02-16,212,amul cheese,250,315,65,1,276,India
461724,2024-02-16,210,mountain dew,75,100,25,1,95,India
373730,2024-02-16,205,classic yogurt,45,60,15,1,297,India
646764,2024-02-16,210,mountain dew,75,100,25,1,36,India
646764,2024-02-16,209,pepsi,75,100,25,1,36,India
646764,2024-02-16,207,coca cola,75,100,25,1,36,India
646764,2024-02-16,202,milk,12,27,15,1,36,India
646764,2024-02-16,203,mango yogurt,50,60,10,1,36,India
358243,2024-02-16,207,coca cola,75,100,25,1,216,India
358243,2024-02-16,211,red bull,90,125,35,1,216,India
358243,2024-02-16,204,strawberry yogurt,50,60,10,1,216,India
683352,2024-02-16,204,strawberry yogurt,50,60,10,1,98,India
683352,2024-02-16,208,sprite,75,100,25,1,98,India
683352,2024-02-16,212,amul cheese,250,315,65,1,98,India
531419,2024-02-16,205,classic yogurt,45,60,15,1,284,India
531419,2024-02-16,209,pepsi,75,100,25,1,284,India
531419,2024-02-16,211,red bull,90,125,35,1,284,India
531419,2024-02-16,213,bisleri,6,15,9,1,284,India
537703,2024-02-16,208,sprite,75,100,25,1,358,India
537703,2024-02-16,202,milk,12,27,15,1,358,India
234788,2024-02-16,209,pepsi,75,100,25,1,429,India
234788,2024-02-16,207,coca cola,75,100,25,1,429,India
234788,2024-02-16,210,mountain dew,75,100,25,1,429,India
552453,2024-02-16,203,mango yogurt,50,60,10,1,288,India
552453,2024-02-16,208,sprite,75,100,25,1,288,India
552453,2024-02-16,210,mountain dew,75,100,25,1,288,India
892216,2024-02-16,206,yakult,360,400,40,1,74,India
892216,2024-02-16,207,coca cola,75,100,25,1,74,India
892216,2024-02-16,210,mountain dew,75,100,25,1,74,India
892216,2024-02-16,201,paneer,210,340,130,1,74,India
219303,2024-02-16,205,classic yogurt,45,60,15,1,331,India
219303,2024-02-16,210,mountain dew,75,100,25,1,331,India
219303,2024-02-16,212,amul cheese,250,315,65,1,331,India
549197,2024-02-16,212,amul cheese,250,315,65,1,44,India
549197,2024-02-16,210,mountain dew,75,100,25,1,44,India
549197,2024-02-16,207,coca cola,75,100,25,1,44,India
403725,2024-02-16,201,paneer,210,340,130,1,478,India
403725,2024-02-16,206,yakult,360,400,40,1,478,India
945001,2024-02-16,204,strawberry yogurt,50,60,10,1,341,India
580271,2024-02-16,209,pepsi,75,100,25,1,115,India
436509,2024-02-16,202,milk,12,27,15,1,307,India
436509,2024-02-16,210,mountain dew,75,100,25,1,307,India
743104,2024-02-16,210,mountain dew,75,100,25,1,10,India
743104,2024-02-16,201,paneer,210,340,130,1,10,India
743104,2024-02-16,209,pepsi,75,100,25,1,10,India
743104,2024-02-16,202,milk,12,27,15,1,10,India
743104,2024-02-16,208,sprite,75,100,25,1,10,India
904024,2024-02-16,212,amul cheese,250,315,65,1,174,India
904024,2024-02-16,203,mango yogurt,50,60,10,1,174,India
904024,2024-02-16,211,red bull,90,125,35,1,174,India
904024,2024-02-16,205,classic yogurt,45,60,15,1,174,India
133670,2024-02-16,211,red bull,90,125,35,1,102,India
133670,2024-02-16,201,paneer,210,340,130,1,102,India
133670,2024-02-16,212,amul cheese,250,315,65,1,102,India
721174,2024-02-16,206,yakult,360,400,40,1,315,India
175085,2024-02-16,206,yakult,360,400,40,1,489,India
175085,2024-02-16,201,paneer,210,340,130,1,489,India
175085,2024-02-16,203,mango yogurt,50,60,10,1,489,India
175085,2024-02-16,213,bisleri,6,15,9,1,489,India
241659,2024-02-17,213,bisleri,6,15,9,1,117,India
241659,2024-02-17,212,amul cheese,250,315,65,1,117,India
241659,2024-02-17,211,red bull,90,125,35,1,117,India
241659,2024-02-17,208,sprite,75,100,25,1,117,India
431563,2024-02-17,202,milk,12,27,15,1,325,India
431563,2024-02-17,209,pepsi,75,100,25,1,325,India
928304,2024-02-17,203,mango yogurt,50,60,10,1,94,India
928304,2024-02-17,210,mountain dew,75,100,25,1,94,India
720515,2024-02-17,202,milk,12,27,15,1,199,India
720515,2024-02-17,212,amul cheese,250,315,65,1,199,India
720515,2024-02-17,205,classic yogurt,45,60,15,1,199,India
720515,2024-02-17,203,mango yogurt,50,60,10,1,199,India
289258,2024-02-17,211,red bull,90,125,35,1,282,India
289258,2024-02-17,210,mountain dew,75,100,25,1,282,India
289258,2024-02-17,209,pepsi,75,100,25,1,282,India
289258,2024-02-17,204,strawberry yogurt,50,60,10,1,282,India
323919,2024-02-17,208,sprite,75,100,25,1,472,India
323919,2024-02-17,209,pepsi,75,100,25,1,472,India
255094,2024-02-17,206,yakult,360,400,40,1,317,India
255094,2024-02-17,210,mountain dew,75,100,25,1,317,India
255094,2024-02-17,209,pepsi,75,100,25,1,317,India
440194,2024-02-17,203,mango yogurt,50,60,10,1,225,India
440194,2024-02-17,208,sprite,75,100,25,1,225,India
440194,2024-02-17,202,milk,12,27,15,1,225,India
440194,2024-02-17,209,pepsi,75,100,25,1,225,India
508533,2024-02-17,213,bisleri,6,15,9,1,73,India
508533,2024-02-17,202,milk,12,27,15,1,73,India
508533,2024-02-17,209,pepsi,75,100,25,1,73,India
775408,2024-02-17,208,sprite,75,100,25,1,459,India
775408,2024-02-17,207,coca cola,75,100,25,1,459,India
775408,2024-02-17,212,amul cheese,250,315,65,1,459,India
775408,2024-02-17,211,red bull,90,125,35,1,459,India
744769,2024-02-17,211,red bull,90,125,35,1,57,India
744769,2024-02-17,206,yakult,360,400,40,1,57,India
744769,2024-02-17,204,strawberry yogurt,50,60,10,1,57,India
744769,2024-02-17,212,amul cheese,250,315,65,1,57,India
576446,2024-02-17,208,sprite,75,100,25,1,145,India
576446,2024-02-17,203,mango yogurt,50,60,10,1,145,India
576446,2024-02-17,211,red bull,90,125,35,1,145,India
576446,2024-02-17,212,amul cheese,250,315,65,1,145,India
576446,2024-02-17,205,classic yogurt,45,60,15,1,145,India
179109,2024-02-17,212,amul cheese,250,315,65,1,119,India
456244,2024-02-17,207,coca cola,75,100,25,1,244,India
456244,2024-02-17,203,mango yogurt,50,60,10,1,244,India
456244,2024-02-17,210,mountain dew,75,100,25,1,244,India
819303,2024-02-17,205,classic yogurt,45,60,15,1,196,India
819303,2024-02-17,210,mountain dew,75,100,25,1,196,India
968478,2024-02-17,206,yakult,360,400,40,1,254,India
968478,2024-02-17,205,classic yogurt,45,60,15,1,254,India
968478,2024-02-17,203,mango yogurt,50,60,10,1,254,India
968478,2024-02-17,204,strawberry yogurt,50,60,10,1,254,India
968478,2024-02-17,207,coca cola,75,100,25,1,254,India
521131,2024-02-17,203,mango yogurt,50,60,10,1,107,India
521131,2024-02-17,209,pepsi,75,100,25,1,107,India
521131,2024-02-17,201,paneer,210,340,130,1,107,India
568695,2024-02-17,202,milk,12,27,15,1,206,India
929263,2024-02-17,208,sprite,75,100,25,1,225,India
929263,2024-02-17,201,paneer,210,340,130,1,225,India
394931,2024-02-17,208,sprite,75,100,25,1,409,India
394931,2024-02-17,211,red bull,90,125,35,1,409,India
740740,2024-02-17,205,classic yogurt,45,60,15,1,47,India
740740,2024-02-17,201,paneer,210,340,130,1,47,India
740740,2024-02-17,206,yakult,360,400,40,1,47,India
728966,2024-02-17,211,red bull,90,125,35,1,247,India
728966,2024-02-17,203,mango yogurt,50,60,10,1,247,India
858779,2024-02-17,206,yakult,360,400,40,1,385,India
858779,2024-02-17,210,mountain dew,75,100,25,1,385,India
858779,2024-02-17,201,paneer,210,340,130,1,385,India
599820,2024-02-17,201,paneer,210,340,130,1,324,India
599820,2024-02-17,205,classic yogurt,45,60,15,1,324,India
599820,2024-02-17,206,yakult,360,400,40,1,324,India
599820,2024-02-17,209,pepsi,75,100,25,1,324,India
589883,2024-02-17,202,milk,12,27,15,1,271,India
589883,2024-02-17,211,red bull,90,125,35,1,271,India
589883,2024-02-17,208,sprite,75,100,25,1,271,India
589883,2024-02-17,201,paneer,210,340,130,1,271,India
979842,2024-02-17,203,mango yogurt,50,60,10,1,163,India
979842,2024-02-17,212,amul cheese,250,315,65,1,163,India
979842,2024-02-17,202,milk,12,27,15,1,163,India
667284,2024-02-17,210,mountain dew,75,100,25,1,466,India
667284,2024-02-17,203,mango yogurt,50,60,10,1,466,India
667284,2024-02-17,207,coca cola,75,100,25,1,466,India
537513,2024-02-17,206,yakult,360,400,40,1,95,India
537513,2024-02-17,204,strawberry yogurt,50,60,10,1,95,India
537513,2024-02-17,201,paneer,210,340,130,1,95,India
731650,2024-02-17,211,red bull,90,125,35,1,125,India
731650,2024-02-17,202,milk,12,27,15,1,125,India
731650,2024-02-17,209,pepsi,75,100,25,1,125,India
731650,2024-02-17,203,mango yogurt,50,60,10,1,125,India
731650,2024-02-17,205,classic yogurt,45,60,15,1,125,India
525173,2024-02-17,203,mango yogurt,50,60,10,1,243,India
525173,2024-02-17,206,yakult,360,400,40,1,243,India
525173,2024-02-17,205,classic yogurt,45,60,15,1,243,India
940316,2024-02-17,203,mango yogurt,50,60,10,1,150,India
940316,2024-02-17,213,bisleri,6,15,9,1,150,India
940316,2024-02-17,211,red bull,90,125,35,1,150,India
949551,2024-02-17,207,coca cola,75,100,25,1,161,India
949551,2024-02-17,211,red bull,90,125,35,1,161,India
949551,2024-02-17,202,milk,12,27,15,1,161,India
142187,2024-02-17,212,amul cheese,250,315,65,1,61,India
536494,2024-02-17,209,pepsi,75,100,25,1,368,India
536494,2024-02-17,212,amul cheese,250,315,65,1,368,India
536494,2024-02-17,206,yakult,360,400,40,1,368,India
536494,2024-02-17,208,sprite,75,100,25,1,368,India
876912,2024-02-17,211,red bull,90,125,35,1,245,India
876912,2024-02-17,201,paneer,210,340,130,1,245,India
876912,2024-02-17,212,amul cheese,250,315,65,1,245,India
876912,2024-02-17,202,milk,12,27,15,1,245,India
875589,2024-02-17,202,milk,12,27,15,1,199,India
875589,2024-02-17,211,red bull,90,125,35,1,199,India
875589,2024-02-17,203,mango yogurt,50,60,10,1,199,India
979072,2024-02-17,209,pepsi,75,100,25,1,166,India
979072,2024-02-17,210,mountain dew,75,100,25,1,166,India
979072,2024-02-17,206,yakult,360,400,40,1,166,India
979072,2024-02-17,207,coca cola,75,100,25,1,166,India
289036,2024-02-17,207,coca cola,75,100,25,1,348,India
289036,2024-02-17,211,red bull,90,125,35,1,348,India
610016,2024-02-17,201,paneer,210,340,130,1,289,India
646037,2024-02-17,206,yakult,360,400,40,1,231,India
646037,2024-02-17,211,red bull,90,125,35,1,231,India
646037,2024-02-17,205,classic yogurt,45,60,15,1,231,India
646037,2024-02-17,203,mango yogurt,50,60,10,1,231,India
646037,2024-02-17,212,amul cheese,250,315,65,1,231,India
581982,2024-02-17,201,paneer,210,340,130,1,246,India
633825,2024-02-17,202,milk,12,27,15,1,307,India
198786,2024-02-17,205,classic yogurt,45,60,15,1,95,India
421772,2024-02-17,209,pepsi,75,100,25,1,55,India
421772,2024-02-17,204,strawberry yogurt,50,60,10,1,55,India
446301,2024-02-17,206,yakult,360,400,40,1,114,India
446301,2024-02-17,213,bisleri,6,15,9,1,114,India
532005,2024-02-17,206,yakult,360,400,40,1,208,India
349230,2024-02-17,202,milk,12,27,15,1,43,India
961224,2024-02-17,207,coca cola,75,100,25,1,491,India
367011,2024-02-17,203,mango yogurt,50,60,10,1,10,India
367011,2024-02-17,209,pepsi,75,100,25,1,10,India
367011,2024-02-17,211,red bull,90,125,35,1,10,India
367011,2024-02-17,213,bisleri,6,15,9,1,10,India
177193,2024-02-17,201,paneer,210,340,130,1,309,India
686793,2024-02-17,203,mango yogurt,50,60,10,1,456,India
686793,2024-02-17,208,sprite,75,100,25,1,456,India
940799,2024-02-17,212,amul cheese,250,315,65,1,467,India
940799,2024-02-17,207,coca cola,75,100,25,1,467,India
940799,2024-02-17,205,classic yogurt,45,60,15,1,467,India
644144,2024-02-17,205,classic yogurt,45,60,15,1,410,India
644144,2024-02-17,212,amul cheese,250,315,65,1,410,India
644144,2024-02-17,204,strawberry yogurt,50,60,10,1,410,India
644144,2024-02-17,206,yakult,360,400,40,1,410,India
100997,2024-02-17,204,strawberry yogurt,50,60,10,1,409,India
100997,2024-02-17,205,classic yogurt,45,60,15,1,409,India
100997,2024-02-17,211,red bull,90,125,35,1,409,India
100997,2024-02-17,206,yakult,360,400,40,1,409,India
100997,2024-02-17,212,amul cheese,250,315,65,1,409,India
652964,2024-02-17,202,milk,12,27,15,1,356,India
652964,2024-02-17,206,yakult,360,400,40,1,356,India
510013,2024-02-17,208,sprite,75,100,25,1,230,India
510013,2024-02-17,203,mango yogurt,50,60,10,1,230,India
724320,2024-02-17,202,milk,12,27,15,1,143,India
724320,2024-02-17,211,red bull,90,125,35,1,143,India
724320,2024-02-17,201,paneer,210,340,130,1,143,India
943114,2024-02-17,207,coca cola,75,100,25,1,11,India
943114,2024-02-17,204,strawberry yogurt,50,60,10,1,11,India
907940,2024-02-17,208,sprite,75,100,25,1,403,India
283220,2024-02-17,202,milk,12,27,15,1,281,India
156863,2024-02-17,207,coca cola,75,100,25,1,369,India
156863,2024-02-17,205,classic yogurt,45,60,15,1,369,India
156863,2024-02-17,204,strawberry yogurt,50,60,10,1,369,India
203286,2024-02-17,205,classic yogurt,45,60,15,1,406,India
203286,2024-02-17,207,coca cola,75,100,25,1,406,India
891003,2024-02-17,213,bisleri,6,15,9,1,346,India
891003,2024-02-17,207,coca cola,75,100,25,1,346,India
891003,2024-02-17,204,strawberry yogurt,50,60,10,1,346,India
942139,2024-02-17,202,milk,12,27,15,1,179,India
942139,2024-02-17,208,sprite,75,100,25,1,179,India
942139,2024-02-17,205,classic yogurt,45,60,15,1,179,India
942139,2024-02-17,209,pepsi,75,100,25,1,179,India
451606,2024-02-17,210,mountain dew,75,100,25,1,99,India
451606,2024-02-17,205,classic yogurt,45,60,15,1,99,India
352840,2024-02-17,207,coca cola,75,100,25,1,393,India
352840,2024-02-17,205,classic yogurt,45,60,15,1,393,India
352840,2024-02-17,201,paneer,210,340,130,1,393,India
352840,2024-02-17,208,sprite,75,100,25,1,393,India
352840,2024-02-17,211,red bull,90,125,35,1,393,India
394496,2024-02-17,206,yakult,360,400,40,1,71,India
394496,2024-02-17,201,paneer,210,340,130,1,71,India
394496,2024-02-17,202,milk,12,27,15,1,71,India
646402,2024-02-17,204,strawberry yogurt,50,60,10,1,181,India
646402,2024-02-17,203,mango yogurt,50,60,10,1,181,India
646402,2024-02-17,201,paneer,210,340,130,1,181,India
646402,2024-02-17,207,coca cola,75,100,25,1,181,India
797708,2024-02-17,202,milk,12,27,15,1,229,India
797708,2024-02-17,205,classic yogurt,45,60,15,1,229,India
797708,2024-02-17,201,paneer,210,340,130,1,229,India
797708,2024-02-17,209,pepsi,75,100,25,1,229,India
933458,2024-02-17,211,red bull,90,125,35,1,498,India
933458,2024-02-17,201,paneer,210,340,130,1,498,India
361189,2024-02-18,202,milk,12,27,15,1,12,India
361189,2024-02-18,211,red bull,90,125,35,1,12,India
361189,2024-02-18,208,sprite,75,100,25,1,12,India
940551,2024-02-18,207,coca cola,75,100,25,1,32,India
889513,2024-02-18,202,milk,12,27,15,1,262,India
889513,2024-02-18,212,amul cheese,250,315,65,1,262,India
889513,2024-02-18,209,pepsi,75,100,25,1,262,India
889513,2024-02-18,203,mango yogurt,50,60,10,1,262,India
598007,2024-02-18,205,classic yogurt,45,60,15,1,195,India
598007,2024-02-18,208,sprite,75,100,25,1,195,India
598007,2024-02-18,203,mango yogurt,50,60,10,1,195,India
736406,2024-02-18,207,coca cola,75,100,25,1,233,India
144711,2024-02-18,211,red bull,90,125,35,1,470,India
144711,2024-02-18,208,sprite,75,100,25,1,470,India
144711,2024-02-18,207,coca cola,75,100,25,1,470,India
144711,2024-02-18,212,amul cheese,250,315,65,1,470,India
386345,2024-02-18,204,strawberry yogurt,50,60,10,1,173,India
412638,2024-02-18,212,amul cheese,250,315,65,1,381,India
412638,2024-02-18,201,paneer,210,340,130,1,381,India
412638,2024-02-18,213,bisleri,6,15,9,1,381,India
412638,2024-02-18,211,red bull,90,125,35,1,381,India
292600,2024-02-18,201,paneer,210,340,130,1,187,India
218684,2024-02-18,201,paneer,210,340,130,1,333,India
218684,2024-02-18,207,coca cola,75,100,25,1,333,India
218684,2024-02-18,202,milk,12,27,15,1,333,India
944298,2024-02-18,201,paneer,210,340,130,1,317,India
944298,2024-02-18,209,pepsi,75,100,25,1,317,India
873352,2024-02-18,211,red bull,90,125,35,1,219,India
873352,2024-02-18,208,sprite,75,100,25,1,219,India
873352,2024-02-18,206,yakult,360,400,40,1,219,India
715239,2024-02-18,207,coca cola,75,100,25,1,116,India
715239,2024-02-18,208,sprite,75,100,25,1,116,India
715239,2024-02-18,211,red bull,90,125,35,1,116,India
647518,2024-02-18,210,mountain dew,75,100,25,1,200,India
303614,2024-02-18,201,paneer,210,340,130,1,304,India
303614,2024-02-18,205,classic yogurt,45,60,15,1,304,India
303614,2024-02-18,212,amul cheese,250,315,65,1,304,India
303614,2024-02-18,209,pepsi,75,100,25,1,304,India
303614,2024-02-18,210,mountain dew,75,100,25,1,304,India
934933,2024-02-18,203,mango yogurt,50,60,10,1,386,India
466455,2024-02-18,201,paneer,210,340,130,1,216,India
466455,2024-02-18,203,mango yogurt,50,60,10,1,216,India
372226,2024-02-18,203,mango yogurt,50,60,10,1,304,India
372226,2024-02-18,205,classic yogurt,45,60,15,1,304,India
167972,2024-02-18,202,milk,12,27,15,1,403,India
167972,2024-02-18,204,strawberry yogurt,50,60,10,1,403,India
167972,2024-02-18,211,red bull,90,125,35,1,403,India
336832,2024-02-18,201,paneer,210,340,130,1,231,India
336832,2024-02-18,203,mango yogurt,50,60,10,1,231,India
780062,2024-02-18,212,amul cheese,250,315,65,1,264,India
780062,2024-02-18,204,strawberry yogurt,50,60,10,1,264,India
780062,2024-02-18,207,coca cola,75,100,25,1,264,India
780062,2024-02-18,205,classic yogurt,45,60,15,1,264,India
780062,2024-02-18,208,sprite,75,100,25,1,264,India
716283,2024-02-18,210,mountain dew,75,100,25,1,111,India
716283,2024-02-18,212,amul cheese,250,315,65,1,111,India
716283,2024-02-18,209,pepsi,75,100,25,1,111,India
633770,2024-02-18,203,mango yogurt,50,60,10,1,236,India
325686,2024-02-18,206,yakult,360,400,40,1,291,India
325686,2024-02-18,205,classic yogurt,45,60,15,1,291,India
821036,2024-02-18,204,strawberry yogurt,50,60,10,1,465,India
821036,2024-02-18,211,red bull,90,125,35,1,465,India
653717,2024-02-18,211,red bull,90,125,35,1,19,India
587540,2024-02-18,213,bisleri,6,15,9,1,365,India
587540,2024-02-18,206,yakult,360,400,40,1,365,India
547416,2024-02-18,203,mango yogurt,50,60,10,1,443,India
547416,2024-02-18,201,paneer,210,340,130,1,443,India
547416,2024-02-18,213,bisleri,6,15,9,1,443,India
221338,2024-02-18,210,mountain dew,75,100,25,1,94,India
221338,2024-02-18,207,coca cola,75,100,25,1,94,India
221338,2024-02-18,211,red bull,90,125,35,1,94,India
894148,2024-02-18,209,pepsi,75,100,25,1,432,India
894148,2024-02-18,213,bisleri,6,15,9,1,432,India
762031,2024-02-18,213,bisleri,6,15,9,1,86,India
762031,2024-02-18,211,red bull,90,125,35,1,86,India
762031,2024-02-18,209,pepsi,75,100,25,1,86,India
480906,2024-02-18,203,mango yogurt,50,60,10,1,496,India
480906,2024-02-18,210,mountain dew,75,100,25,1,496,India
932395,2024-02-18,205,classic yogurt,45,60,15,1,364,India
932395,2024-02-18,210,mountain dew,75,100,25,1,364,India
772039,2024-02-18,208,sprite,75,100,25,1,46,India
772039,2024-02-18,202,milk,12,27,15,1,46,India
772039,2024-02-18,203,mango yogurt,50,60,10,1,46,India
772039,2024-02-18,213,bisleri,6,15,9,1,46,India
598689,2024-02-18,207,coca cola,75,100,25,1,257,India
357379,2024-02-18,206,yakult,360,400,40,1,80,India
357379,2024-02-18,210,mountain dew,75,100,25,1,80,India
357379,2024-02-18,207,coca cola,75,100,25,1,80,India
883050,2024-02-18,205,classic yogurt,45,60,15,1,411,India
883050,2024-02-18,201,paneer,210,340,130,1,411,India
883050,2024-02-18,208,sprite,75,100,25,1,411,India
795246,2024-02-18,205,classic yogurt,45,60,15,1,284,India
795246,2024-02-18,206,yakult,360,400,40,1,284,India
795246,2024-02-18,210,mountain dew,75,100,25,1,284,India
279849,2024-02-18,204,strawberry yogurt,50,60,10,1,493,India
279849,2024-02-18,208,sprite,75,100,25,1,493,India
279849,2024-02-18,213,bisleri,6,15,9,1,493,India
279849,2024-02-18,206,yakult,360,400,40,1,493,India
301153,2024-02-18,201,paneer,210,340,130,1,139,India
548696,2024-02-18,206,yakult,360,400,40,1,61,India
548696,2024-02-18,211,red bull,90,125,35,1,61,India
548696,2024-02-18,201,paneer,210,340,130,1,61,India
548696,2024-02-18,208,sprite,75,100,25,1,61,India
657565,2024-02-18,205,classic yogurt,45,60,15,1,493,India
657565,2024-02-18,206,yakult,360,400,40,1,493,India
382501,2024-02-18,204,strawberry yogurt,50,60,10,1,141,India
593541,2024-02-18,207,coca cola,75,100,25,1,488,India
593541,2024-02-18,206,yakult,360,400,40,1,488,India
593541,2024-02-18,204,strawberry yogurt,50,60,10,1,488,India
534624,2024-02-18,201,paneer,210,340,130,1,147,India
677538,2024-02-18,201,paneer,210,340,130,1,285,India
677538,2024-02-18,208,sprite,75,100,25,1,285,India
677538,2024-02-18,209,pepsi,75,100,25,1,285,India
677538,2024-02-18,210,mountain dew,75,100,25,1,285,India
704736,2024-02-18,203,mango yogurt,50,60,10,1,53,India
704736,2024-02-18,202,milk,12,27,15,1,53,India
536747,2024-02-18,212,amul cheese,250,315,65,1,132,India
536747,2024-02-18,207,coca cola,75,100,25,1,132,India
536747,2024-02-18,208,sprite,75,100,25,1,132,India
671626,2024-02-18,205,classic yogurt,45,60,15,1,241,India
671626,2024-02-18,204,strawberry yogurt,50,60,10,1,241,India
671626,2024-02-18,201,paneer,210,340,130,1,241,India
551355,2024-02-18,206,yakult,360,400,40,1,324,India
551355,2024-02-18,210,mountain dew,75,100,25,1,324,India
970549,2024-02-18,207,coca cola,75,100,25,1,432,India
970549,2024-02-18,204,strawberry yogurt,50,60,10,1,432,India
970549,2024-02-18,209,pepsi,75,100,25,1,432,India
900110,2024-02-18,206,yakult,360,400,40,1,269,India
391908,2024-02-18,211,red bull,90,125,35,1,45,India
308030,2024-02-18,206,yakult,360,400,40,1,309,India
308030,2024-02-18,204,strawberry yogurt,50,60,10,1,309,India
572671,2024-02-18,203,mango yogurt,50,60,10,1,119,India
572671,2024-02-18,201,paneer,210,340,130,1,119,India
250305,2024-02-18,202,milk,12,27,15,1,214,India
250305,2024-02-18,204,strawberry yogurt,50,60,10,1,214,India
333108,2024-02-18,209,pepsi,75,100,25,1,51,India
333108,2024-02-18,204,strawberry yogurt,50,60,10,1,51,India
333108,2024-02-18,206,yakult,360,400,40,1,51,India
333108,2024-02-18,207,coca cola,75,100,25,1,51,India
333108,2024-02-18,205,classic yogurt,45,60,15,1,51,India
949724,2024-02-18,204,strawberry yogurt,50,60,10,1,278,India
949724,2024-02-18,209,pepsi,75,100,25,1,278,India
949724,2024-02-18,212,amul cheese,250,315,65,1,278,India
949724,2024-02-18,202,milk,12,27,15,1,278,India
669909,2024-02-18,210,mountain dew,75,100,25,1,131,India
669909,2024-02-18,204,strawberry yogurt,50,60,10,1,131,India
669909,2024-02-18,205,classic yogurt,45,60,15,1,131,India
669909,2024-02-18,208,sprite,75,100,25,1,131,India
460723,2024-02-18,212,amul cheese,250,315,65,1,409,India
460723,2024-02-18,201,paneer,210,340,130,1,409,India
460723,2024-02-18,211,red bull,90,125,35,1,409,India
514866,2024-02-18,207,coca cola,75,100,25,1,50,India
367746,2024-02-18,208,sprite,75,100,25,1,203,India
367746,2024-02-18,204,strawberry yogurt,50,60,10,1,203,India
367746,2024-02-18,211,red bull,90,125,35,1,203,India
194106,2024-02-18,206,yakult,360,400,40,1,109,India
194106,2024-02-18,207,coca cola,75,100,25,1,109,India
194106,2024-02-18,212,amul cheese,250,315,65,1,109,India
194106,2024-02-18,209,pepsi,75,100,25,1,109,India
194106,2024-02-18,201,paneer,210,340,130,1,109,India
294470,2024-02-18,206,yakult,360,400,40,1,494,India
294470,2024-02-18,211,red bull,90,125,35,1,494,India
294470,2024-02-18,207,coca cola,75,100,25,1,494,India
294470,2024-02-18,212,amul cheese,250,315,65,1,494,India
285347,2024-02-18,204,strawberry yogurt,50,60,10,1,93,India
285347,2024-02-18,209,pepsi,75,100,25,1,93,India
943050,2024-02-18,212,amul cheese,250,315,65,1,187,India
921649,2024-02-18,203,mango yogurt,50,60,10,1,234,India
921649,2024-02-18,202,milk,12,27,15,1,234,India
921649,2024-02-18,212,amul cheese,250,315,65,1,234,India
921649,2024-02-18,211,red bull,90,125,35,1,234,India
383859,2024-02-18,204,strawberry yogurt,50,60,10,1,368,India
383859,2024-02-18,211,red bull,90,125,35,1,368,India
733947,2024-02-18,212,amul cheese,250,315,65,1,209,India
733947,2024-02-18,208,sprite,75,100,25,1,209,India
733947,2024-02-18,204,strawberry yogurt,50,60,10,1,209,India
733947,2024-02-18,207,coca cola,75,100,25,1,209,India
382210,2024-02-18,211,red bull,90,125,35,1,91,India
382210,2024-02-18,204,strawberry yogurt,50,60,10,1,91,India
551351,2024-02-18,202,milk,12,27,15,1,365,India
551351,2024-02-18,201,paneer,210,340,130,1,365,India
582483,2024-02-18,201,paneer,210,340,130,1,231,India
582483,2024-02-18,212,amul cheese,250,315,65,1,231,India
582483,2024-02-18,211,red bull,90,125,35,1,231,India
582483,2024-02-18,204,strawberry yogurt,50,60,10,1,231,India
637995,2024-02-18,213,bisleri,6,15,9,1,479,India
637995,2024-02-18,208,sprite,75,100,25,1,479,India
637995,2024-02-18,206,yakult,360,400,40,1,479,India
362042,2024-02-18,201,paneer,210,340,130,1,478,India
362042,2024-02-18,208,sprite,75,100,25,1,478,India
362042,2024-02-18,206,yakult,360,400,40,1,478,India
399250,2024-02-18,211,red bull,90,125,35,1,195,India
399250,2024-02-18,203,mango yogurt,50,60,10,1,195,India
399250,2024-02-18,213,bisleri,6,15,9,1,195,India
988004,2024-02-18,208,sprite,75,100,25,1,328,India
988004,2024-02-18,203,mango yogurt,50,60,10,1,328,India
988004,2024-02-18,212,amul cheese,250,315,65,1,328,India
988004,2024-02-18,202,milk,12,27,15,1,328,India
988004,2024-02-18,210,mountain dew,75,100,25,1,328,India
264951,2024-02-18,203,mango yogurt,50,60,10,1,149,India
403924,2024-02-18,205,classic yogurt,45,60,15,1,349,India
403924,2024-02-18,207,coca cola,75,100,25,1,349,India
642948,2024-02-18,202,milk,12,27,15,1,47,India
644701,2024-02-18,204,strawberry yogurt,50,60,10,1,157,India
644701,2024-02-18,207,coca cola,75,100,25,1,157,India
644701,2024-02-18,211,red bull,90,125,35,1,157,India
644701,2024-02-18,208,sprite,75,100,25,1,157,India
478844,2024-02-18,207,coca cola,75,100,25,1,376,India
478844,2024-02-18,205,classic yogurt,45,60,15,1,376,India
303912,2024-02-18,206,yakult,360,400,40,1,409,India
303912,2024-02-18,209,pepsi,75,100,25,1,409,India
303912,2024-02-18,207,coca cola,75,100,25,1,409,India
303912,2024-02-18,205,classic yogurt,45,60,15,1,409,India
882004,2024-02-18,213,bisleri,6,15,9,1,61,India
882004,2024-02-18,202,milk,12,27,15,1,61,India
882004,2024-02-18,204,strawberry yogurt,50,60,10,1,61,India
882004,2024-02-18,203,mango yogurt,50,60,10,1,61,India
116108,2024-02-18,213,bisleri,6,15,9,1,338,India
116108,2024-02-18,211,red bull,90,125,35,1,338,India
116108,2024-02-18,212,amul cheese,250,315,65,1,338,India
116108,2024-02-18,209,pepsi,75,100,25,1,338,India
116108,2024-02-18,205,classic yogurt,45,60,15,1,338,India
800896,2024-02-18,207,coca cola,75,100,25,1,209,India
800896,2024-02-18,211,red bull,90,125,35,1,209,India
800896,2024-02-18,204,strawberry yogurt,50,60,10,1,209,India
800896,2024-02-18,213,bisleri,6,15,9,1,209,India
482268,2024-02-18,203,mango yogurt,50,60,10,1,479,India
214238,2024-02-18,210,mountain dew,75,100,25,1,110,India
214238,2024-02-18,212,amul cheese,250,315,65,1,110,India
214238,2024-02-18,213,bisleri,6,15,9,1,110,India
293688,2024-02-18,201,paneer,210,340,130,1,386,India
293688,2024-02-18,206,yakult,360,400,40,1,386,India
293688,2024-02-18,202,milk,12,27,15,1,386,India
516065,2024-02-18,209,pepsi,75,100,25,1,417,India
804796,2024-02-18,201,paneer,210,340,130,1,57,India
351830,2024-02-18,208,sprite,75,100,25,1,237,India
979278,2024-02-18,207,coca cola,75,100,25,1,36,India
979278,2024-02-18,204,strawberry yogurt,50,60,10,1,36,India
824523,2024-02-18,207,coca cola,75,100,25,1,210,India
824523,2024-02-18,211,red bull,90,125,35,1,210,India
824523,2024-02-18,213,bisleri,6,15,9,1,210,India
261672,2024-02-18,210,mountain dew,75,100,25,1,221,India
537886,2024-02-18,206,yakult,360,400,40,1,147,India
537886,2024-02-18,212,amul cheese,250,315,65,1,147,India
537886,2024-02-18,208,sprite,75,100,25,1,147,India
537886,2024-02-18,211,red bull,90,125,35,1,147,India
537886,2024-02-18,205,classic yogurt,45,60,15,1,147,India
473040,2024-02-18,209,pepsi,75,100,25,1,146,India
473040,2024-02-18,205,classic yogurt,45,60,15,1,146,India
473040,2024-02-18,201,paneer,210,340,130,1,146,India
814253,2024-02-18,206,yakult,360,400,40,1,443,India
786453,2024-02-18,209,pepsi,75,100,25,1,279,India
786453,2024-02-18,201,paneer,210,340,130,1,279,India
786453,2024-02-18,205,classic yogurt,45,60,15,1,279,India
867241,2024-02-18,201,paneer,210,340,130,1,92,India
541290,2024-02-19,210,mountain dew,75,100,25,1,294,India
541290,2024-02-19,207,coca cola,75,100,25,1,294,India
541290,2024-02-19,204,strawberry yogurt,50,60,10,1,294,India
843787,2024-02-19,212,amul cheese,250,315,65,1,181,India
843787,2024-02-19,208,sprite,75,100,25,1,181,India
843787,2024-02-19,209,pepsi,75,100,25,1,181,India
467657,2024-02-19,212,amul cheese,250,315,65,1,455,India
252479,2024-02-19,208,sprite,75,100,25,1,140,India
252479,2024-02-19,202,milk,12,27,15,1,140,India
252479,2024-02-19,203,mango yogurt,50,60,10,1,140,India
858258,2024-02-19,202,milk,12,27,15,1,186,India
858258,2024-02-19,205,classic yogurt,45,60,15,1,186,India
858258,2024-02-19,208,sprite,75,100,25,1,186,India
648928,2024-02-19,201,paneer,210,340,130,1,176,India
711201,2024-02-19,212,amul cheese,250,315,65,1,242,India
188570,2024-02-19,208,sprite,75,100,25,1,164,India
188570,2024-02-19,205,classic yogurt,45,60,15,1,164,India
188570,2024-02-19,206,yakult,360,400,40,1,164,India
712901,2024-02-19,207,coca cola,75,100,25,1,258,India
712901,2024-02-19,203,mango yogurt,50,60,10,1,258,India
712901,2024-02-19,201,paneer,210,340,130,1,258,India
712901,2024-02-19,202,milk,12,27,15,1,258,India
419201,2024-02-19,208,sprite,75,100,25,1,491,India
935091,2024-02-19,201,paneer,210,340,130,1,2,India
935091,2024-02-19,208,sprite,75,100,25,1,2,India
935091,2024-02-19,203,mango yogurt,50,60,10,1,2,India
935091,2024-02-19,213,bisleri,6,15,9,1,2,India
935091,2024-02-19,204,strawberry yogurt,50,60,10,1,2,India
924119,2024-02-19,211,red bull,90,125,35,1,472,India
924119,2024-02-19,203,mango yogurt,50,60,10,1,472,India
149392,2024-02-19,209,pepsi,75,100,25,1,22,India
149392,2024-02-19,205,classic yogurt,45,60,15,1,22,India
149392,2024-02-19,212,amul cheese,250,315,65,1,22,India
149392,2024-02-19,204,strawberry yogurt,50,60,10,1,22,India
525508,2024-02-19,204,strawberry yogurt,50,60,10,1,487,India
525508,2024-02-19,207,coca cola,75,100,25,1,487,India
525508,2024-02-19,213,bisleri,6,15,9,1,487,India
525508,2024-02-19,209,pepsi,75,100,25,1,487,India
920529,2024-02-19,209,pepsi,75,100,25,1,178,India
920529,2024-02-19,205,classic yogurt,45,60,15,1,178,India
954369,2024-02-19,210,mountain dew,75,100,25,1,56,India
954369,2024-02-19,205,classic yogurt,45,60,15,1,56,India
954369,2024-02-19,208,sprite,75,100,25,1,56,India
588436,2024-02-19,204,strawberry yogurt,50,60,10,1,156,India
588436,2024-02-19,210,mountain dew,75,100,25,1,156,India
588436,2024-02-19,203,mango yogurt,50,60,10,1,156,India
588436,2024-02-19,205,classic yogurt,45,60,15,1,156,India
742851,2024-02-19,210,mountain dew,75,100,25,1,128,India
742851,2024-02-19,206,yakult,360,400,40,1,128,India
742851,2024-02-19,207,coca cola,75,100,25,1,128,India
742851,2024-02-19,213,bisleri,6,15,9,1,128,India
717641,2024-02-19,211,red bull,90,125,35,1,86,India
717641,2024-02-19,203,mango yogurt,50,60,10,1,86,India
717641,2024-02-19,209,pepsi,75,100,25,1,86,India
717641,2024-02-19,205,classic yogurt,45,60,15,1,86,India
717641,2024-02-19,204,strawberry yogurt,50,60,10,1,86,India
479622,2024-02-19,211,red bull,90,125,35,1,165,India
479622,2024-02-19,201,paneer,210,340,130,1,165,India
479622,2024-02-19,208,sprite,75,100,25,1,165,India
479622,2024-02-19,204,strawberry yogurt,50,60,10,1,165,India
479622,2024-02-19,206,yakult,360,400,40,1,165,India
236871,2024-02-19,208,sprite,75,100,25,1,161,India
236871,2024-02-19,210,mountain dew,75,100,25,1,161,India
612861,2024-02-19,212,amul cheese,250,315,65,1,492,India
612861,2024-02-19,207,coca cola,75,100,25,1,492,India
333811,2024-02-19,213,bisleri,6,15,9,1,86,India
333811,2024-02-19,209,pepsi,75,100,25,1,86,India
333811,2024-02-19,207,coca cola,75,100,25,1,86,India
170316,2024-02-19,211,red bull,90,125,35,1,116,India
326396,2024-02-19,209,pepsi,75,100,25,1,98,India
326396,2024-02-19,207,coca cola,75,100,25,1,98,India
326396,2024-02-19,210,mountain dew,75,100,25,1,98,India
747387,2024-02-19,201,paneer,210,340,130,1,386,India
747387,2024-02-19,209,pepsi,75,100,25,1,386,India
316466,2024-02-19,212,amul cheese,250,315,65,1,11,India
316466,2024-02-19,201,paneer,210,340,130,1,11,India
316466,2024-02-19,203,mango yogurt,50,60,10,1,11,India
316466,2024-02-19,207,coca cola,75,100,25,1,11,India
316466,2024-02-19,209,pepsi,75,100,25,1,11,India
957574,2024-02-19,204,strawberry yogurt,50,60,10,1,229,India
815360,2024-02-19,204,strawberry yogurt,50,60,10,1,413,India
815360,2024-02-19,210,mountain dew,75,100,25,1,413,India
815360,2024-02-19,205,classic yogurt,45,60,15,1,413,India
815360,2024-02-19,202,milk,12,27,15,1,413,India
876303,2024-02-19,205,classic yogurt,45,60,15,1,356,India
876303,2024-02-19,212,amul cheese,250,315,65,1,356,India
876303,2024-02-19,209,pepsi,75,100,25,1,356,India
763951,2024-02-19,204,strawberry yogurt,50,60,10,1,336,India
763951,2024-02-19,201,paneer,210,340,130,1,336,India
763951,2024-02-19,206,yakult,360,400,40,1,336,India
763951,2024-02-19,203,mango yogurt,50,60,10,1,336,India
594610,2024-02-19,208,sprite,75,100,25,1,285,India
526301,2024-02-19,208,sprite,75,100,25,1,348,India
938619,2024-02-19,202,milk,12,27,15,1,378,India
938619,2024-02-19,208,sprite,75,100,25,1,378,India
850185,2024-02-19,210,mountain dew,75,100,25,1,452,India
902421,2024-02-19,202,milk,12,27,15,1,386,India
902421,2024-02-19,211,red bull,90,125,35,1,386,India
838116,2024-02-19,205,classic yogurt,45,60,15,1,127,India
647931,2024-02-19,210,mountain dew,75,100,25,1,379,India
647931,2024-02-19,212,amul cheese,250,315,65,1,379,India
547222,2024-02-19,204,strawberry yogurt,50,60,10,1,306,India
547222,2024-02-19,203,mango yogurt,50,60,10,1,306,India
484340,2024-02-19,210,mountain dew,75,100,25,1,435,India
230749,2024-02-19,213,bisleri,6,15,9,1,191,India
217939,2024-02-19,212,amul cheese,250,315,65,1,144,India
217939,2024-02-19,210,mountain dew,75,100,25,1,144,India
217939,2024-02-19,211,red bull,90,125,35,1,144,India
217939,2024-02-19,201,paneer,210,340,130,1,144,India
797523,2024-02-19,201,paneer,210,340,130,1,261,India
976310,2024-02-19,204,strawberry yogurt,50,60,10,1,5,India
976310,2024-02-19,211,red bull,90,125,35,1,5,India
976310,2024-02-19,201,paneer,210,340,130,1,5,India
189065,2024-02-19,210,mountain dew,75,100,25,1,49,India
189065,2024-02-19,202,milk,12,27,15,1,49,India
189065,2024-02-19,207,coca cola,75,100,25,1,49,India
189065,2024-02-19,212,amul cheese,250,315,65,1,49,India
849176,2024-02-19,203,mango yogurt,50,60,10,1,13,India
849176,2024-02-19,204,strawberry yogurt,50,60,10,1,13,India
849176,2024-02-19,201,paneer,210,340,130,1,13,India
995340,2024-02-19,208,sprite,75,100,25,1,444,India
995340,2024-02-19,213,bisleri,6,15,9,1,444,India
995340,2024-02-19,210,mountain dew,75,100,25,1,444,India
995340,2024-02-19,204,strawberry yogurt,50,60,10,1,444,India
439606,2024-02-19,201,paneer,210,340,130,1,194,India
439606,2024-02-19,212,amul cheese,250,315,65,1,194,India
439606,2024-02-19,211,red bull,90,125,35,1,194,India
439606,2024-02-19,213,bisleri,6,15,9,1,194,India
285795,2024-02-19,213,bisleri,6,15,9,1,43,India
285795,2024-02-19,212,amul cheese,250,315,65,1,43,India
285795,2024-02-19,208,sprite,75,100,25,1,43,India
284609,2024-02-19,211,red bull,90,125,35,1,140,India
363004,2024-02-19,205,classic yogurt,45,60,15,1,279,India
257513,2024-02-19,206,yakult,360,400,40,1,283,India
667323,2024-02-19,203,mango yogurt,50,60,10,1,39,India
683283,2024-02-19,207,coca cola,75,100,25,1,338,India
544390,2024-02-19,210,mountain dew,75,100,25,1,33,India
544390,2024-02-19,205,classic yogurt,45,60,15,1,33,India
544390,2024-02-19,201,paneer,210,340,130,1,33,India
544390,2024-02-19,212,amul cheese,250,315,65,1,33,India
291356,2024-02-19,210,mountain dew,75,100,25,1,61,India
291356,2024-02-19,209,pepsi,75,100,25,1,61,India
558258,2024-02-19,210,mountain dew,75,100,25,1,221,India
558258,2024-02-19,204,strawberry yogurt,50,60,10,1,221,India
558258,2024-02-19,202,milk,12,27,15,1,221,India
558258,2024-02-19,201,paneer,210,340,130,1,221,India
395855,2024-02-19,209,pepsi,75,100,25,1,104,India
794051,2024-02-19,212,amul cheese,250,315,65,1,469,India
794051,2024-02-19,208,sprite,75,100,25,1,469,India
794051,2024-02-19,211,red bull,90,125,35,1,469,India
794051,2024-02-19,213,bisleri,6,15,9,1,469,India
911469,2024-02-19,205,classic yogurt,45,60,15,1,181,India
406507,2024-02-19,212,amul cheese,250,315,65,1,62,India
374182,2024-02-19,205,classic yogurt,45,60,15,1,56,India
374182,2024-02-19,209,pepsi,75,100,25,1,56,India
518987,2024-02-19,206,yakult,360,400,40,1,453,India
518987,2024-02-19,207,coca cola,75,100,25,1,453,India
518987,2024-02-19,211,red bull,90,125,35,1,453,India
118614,2024-02-19,213,bisleri,6,15,9,1,455,India
118614,2024-02-19,204,strawberry yogurt,50,60,10,1,455,India
118614,2024-02-19,211,red bull,90,125,35,1,455,India
341704,2024-02-19,201,paneer,210,340,130,1,233,India
325032,2024-02-19,208,sprite,75,100,25,1,78,India
325032,2024-02-19,203,mango yogurt,50,60,10,1,78,India
325032,2024-02-19,205,classic yogurt,45,60,15,1,78,India
170344,2024-02-19,210,mountain dew,75,100,25,1,454,India
238205,2024-02-19,207,coca cola,75,100,25,1,150,India
442688,2024-02-19,208,sprite,75,100,25,1,417,India
442688,2024-02-19,213,bisleri,6,15,9,1,417,India
442688,2024-02-19,201,paneer,210,340,130,1,417,India
442688,2024-02-19,209,pepsi,75,100,25,1,417,India
516360,2024-02-19,212,amul cheese,250,315,65,1,458,India
516360,2024-02-19,201,paneer,210,340,130,1,458,India
516360,2024-02-19,202,milk,12,27,15,1,458,India
516360,2024-02-19,209,pepsi,75,100,25,1,458,India
516360,2024-02-19,213,bisleri,6,15,9,1,458,India
639489,2024-02-19,211,red bull,90,125,35,1,76,India
639489,2024-02-19,201,paneer,210,340,130,1,76,India
639489,2024-02-19,207,coca cola,75,100,25,1,76,India
639489,2024-02-19,205,classic yogurt,45,60,15,1,76,India
270482,2024-02-19,204,strawberry yogurt,50,60,10,1,83,India
270482,2024-02-19,207,coca cola,75,100,25,1,83,India
270482,2024-02-19,212,amul cheese,250,315,65,1,83,India
270482,2024-02-19,208,sprite,75,100,25,1,83,India
289221,2024-02-19,205,classic yogurt,45,60,15,1,385,India
289221,2024-02-19,204,strawberry yogurt,50,60,10,1,385,India
513520,2024-02-19,210,mountain dew,75,100,25,1,10,India
493007,2024-02-19,204,strawberry yogurt,50,60,10,1,256,India
493007,2024-02-19,208,sprite,75,100,25,1,256,India
283454,2024-02-19,213,bisleri,6,15,9,1,111,India
283454,2024-02-19,211,red bull,90,125,35,1,111,India
283454,2024-02-19,212,amul cheese,250,315,65,1,111,India
283454,2024-02-19,205,classic yogurt,45,60,15,1,111,India
958859,2024-02-19,207,coca cola,75,100,25,1,58,India
958859,2024-02-19,208,sprite,75,100,25,1,58,India
958859,2024-02-19,211,red bull,90,125,35,1,58,India
464253,2024-02-19,212,amul cheese,250,315,65,1,427,India
416131,2024-02-19,212,amul cheese,250,315,65,1,344,India
416131,2024-02-19,201,paneer,210,340,130,1,344,India
769872,2024-02-19,205,classic yogurt,45,60,15,1,274,India
769872,2024-02-19,201,paneer,210,340,130,1,274,India
769872,2024-02-19,203,mango yogurt,50,60,10,1,274,India
970417,2024-02-19,211,red bull,90,125,35,1,452,India
232382,2024-02-19,212,amul cheese,250,315,65,1,145,India
232382,2024-02-19,211,red bull,90,125,35,1,145,India
232382,2024-02-19,206,yakult,360,400,40,1,145,India
232382,2024-02-19,205,classic yogurt,45,60,15,1,145,India
382166,2024-02-19,210,mountain dew,75,100,25,1,494,India
382166,2024-02-19,211,red bull,90,125,35,1,494,India
382166,2024-02-19,205,classic yogurt,45,60,15,1,494,India
759425,2024-02-19,213,bisleri,6,15,9,1,126,India
669311,2024-02-19,213,bisleri,6,15,9,1,24,India
108028,2024-02-20,203,mango yogurt,50,60,10,1,394,India
265176,2024-02-20,212,amul cheese,250,315,65,1,103,India
265176,2024-02-20,211,red bull,90,125,35,1,103,India
265176,2024-02-20,208,sprite,75,100,25,1,103,India
899804,2024-02-20,213,bisleri,6,15,9,1,230,India
899804,2024-02-20,201,paneer,210,340,130,1,230,India
899804,2024-02-20,205,classic yogurt,45,60,15,1,230,India
184150,2024-02-20,201,paneer,210,340,130,1,283,India
184150,2024-02-20,207,coca cola,75,100,25,1,283,India
184150,2024-02-20,212,amul cheese,250,315,65,1,283,India
184150,2024-02-20,204,strawberry yogurt,50,60,10,1,283,India
144034,2024-02-20,208,sprite,75,100,25,1,49,India
241050,2024-02-20,211,red bull,90,125,35,1,270,India
241050,2024-02-20,212,amul cheese,250,315,65,1,270,India
241050,2024-02-20,213,bisleri,6,15,9,1,270,India
241050,2024-02-20,206,yakult,360,400,40,1,270,India
944015,2024-02-20,203,mango yogurt,50,60,10,1,192,India
944015,2024-02-20,211,red bull,90,125,35,1,192,India
944015,2024-02-20,212,amul cheese,250,315,65,1,192,India
575188,2024-02-20,201,paneer,210,340,130,1,329,India
262869,2024-02-20,207,coca cola,75,100,25,1,130,India
262869,2024-02-20,212,amul cheese,250,315,65,1,130,India
262869,2024-02-20,209,pepsi,75,100,25,1,130,India
262869,2024-02-20,201,paneer,210,340,130,1,130,India
262869,2024-02-20,206,yakult,360,400,40,1,130,India
702997,2024-02-20,209,pepsi,75,100,25,1,449,India
702997,2024-02-20,202,milk,12,27,15,1,449,India
702997,2024-02-20,206,yakult,360,400,40,1,449,India
702997,2024-02-20,203,mango yogurt,50,60,10,1,449,India
192135,2024-02-20,202,milk,12,27,15,1,25,India
192135,2024-02-20,209,pepsi,75,100,25,1,25,India
192135,2024-02-20,211,red bull,90,125,35,1,25,India
225499,2024-02-20,203,mango yogurt,50,60,10,1,115,India
225499,2024-02-20,202,milk,12,27,15,1,115,India
225499,2024-02-20,207,coca cola,75,100,25,1,115,India
537424,2024-02-20,204,strawberry yogurt,50,60,10,1,290,India
537424,2024-02-20,201,paneer,210,340,130,1,290,India
317353,2024-02-20,212,amul cheese,250,315,65,1,7,India
194685,2024-02-20,208,sprite,75,100,25,1,430,India
194685,2024-02-20,201,paneer,210,340,130,1,430,India
194685,2024-02-20,210,mountain dew,75,100,25,1,430,India
194685,2024-02-20,202,milk,12,27,15,1,430,India
194685,2024-02-20,212,amul cheese,250,315,65,1,430,India
223157,2024-02-20,209,pepsi,75,100,25,1,183,India
223157,2024-02-20,203,mango yogurt,50,60,10,1,183,India
223157,2024-02-20,207,coca cola,75,100,25,1,183,India
223157,2024-02-20,205,classic yogurt,45,60,15,1,183,India
727682,2024-02-20,210,mountain dew,75,100,25,1,443,India
727682,2024-02-20,203,mango yogurt,50,60,10,1,443,India
727682,2024-02-20,207,coca cola,75,100,25,1,443,India
928408,2024-02-20,203,mango yogurt,50,60,10,1,282,India
928408,2024-02-20,209,pepsi,75,100,25,1,282,India
235517,2024-02-20,203,mango yogurt,50,60,10,1,187,India
235517,2024-02-20,210,mountain dew,75,100,25,1,187,India
235517,2024-02-20,206,yakult,360,400,40,1,187,India
277448,2024-02-20,202,milk,12,27,15,1,294,India
976383,2024-02-20,213,bisleri,6,15,9,1,237,India
976383,2024-02-20,204,strawberry yogurt,50,60,10,1,237,India
728764,2024-02-20,202,milk,12,27,15,1,158,India
728764,2024-02-20,203,mango yogurt,50,60,10,1,158,India
728764,2024-02-20,208,sprite,75,100,25,1,158,India
994461,2024-02-20,206,yakult,360,400,40,1,344,India
994461,2024-02-20,213,bisleri,6,15,9,1,344,India
994461,2024-02-20,201,paneer,210,340,130,1,344,India
562726,2024-02-20,213,bisleri,6,15,9,1,341,India
562726,2024-02-20,202,milk,12,27,15,1,341,India
562726,2024-02-20,203,mango yogurt,50,60,10,1,341,India
562726,2024-02-20,211,red bull,90,125,35,1,341,India
629856,2024-02-20,210,mountain dew,75,100,25,1,449,India
629856,2024-02-20,201,paneer,210,340,130,1,449,India
629856,2024-02-20,212,amul cheese,250,315,65,1,449,India
525869,2024-02-20,212,amul cheese,250,315,65,1,171,India
525869,2024-02-20,206,yakult,360,400,40,1,171,India
525869,2024-02-20,209,pepsi,75,100,25,1,171,India
489862,2024-02-20,206,yakult,360,400,40,1,460,India
489862,2024-02-20,204,strawberry yogurt,50,60,10,1,460,India
489862,2024-02-20,205,classic yogurt,45,60,15,1,460,India
860112,2024-02-20,205,classic yogurt,45,60,15,1,380,India
471375,2024-02-20,213,bisleri,6,15,9,1,102,India
606829,2024-02-20,206,yakult,360,400,40,1,417,India
606829,2024-02-20,203,mango yogurt,50,60,10,1,417,India
606829,2024-02-20,211,red bull,90,125,35,1,417,India
939101,2024-02-20,207,coca cola,75,100,25,1,110,India
939101,2024-02-20,210,mountain dew,75,100,25,1,110,India
572379,2024-02-20,201,paneer,210,340,130,1,373,India
572379,2024-02-20,210,mountain dew,75,100,25,1,373,India
572379,2024-02-20,206,yakult,360,400,40,1,373,India
572379,2024-02-20,204,strawberry yogurt,50,60,10,1,373,India
904005,2024-02-20,204,strawberry yogurt,50,60,10,1,271,India
904005,2024-02-20,202,milk,12,27,15,1,271,India
904005,2024-02-20,205,classic yogurt,45,60,15,1,271,India
904005,2024-02-20,212,amul cheese,250,315,65,1,271,India
124283,2024-02-20,201,paneer,210,340,130,1,28,India
463105,2024-02-20,204,strawberry yogurt,50,60,10,1,70,India
463105,2024-02-20,212,amul cheese,250,315,65,1,70,India
463105,2024-02-20,208,sprite,75,100,25,1,70,India
463105,2024-02-20,211,red bull,90,125,35,1,70,India
750211,2024-02-20,203,mango yogurt,50,60,10,1,299,India
750211,2024-02-20,207,coca cola,75,100,25,1,299,India
415731,2024-02-20,206,yakult,360,400,40,1,167,India
978196,2024-02-20,212,amul cheese,250,315,65,1,154,India
978196,2024-02-20,203,mango yogurt,50,60,10,1,154,India
978196,2024-02-20,207,coca cola,75,100,25,1,154,India
816954,2024-02-20,209,pepsi,75,100,25,1,48,India
816954,2024-02-20,212,amul cheese,250,315,65,1,48,India
273316,2024-02-20,207,coca cola,75,100,25,1,298,India
273316,2024-02-20,213,bisleri,6,15,9,1,298,India
273316,2024-02-20,210,mountain dew,75,100,25,1,298,India
248689,2024-02-20,201,paneer,210,340,130,1,231,India
248689,2024-02-20,207,coca cola,75,100,25,1,231,India
248689,2024-02-20,205,classic yogurt,45,60,15,1,231,India
960318,2024-02-20,211,red bull,90,125,35,1,459,India
960318,2024-02-20,210,mountain dew,75,100,25,1,459,India
960318,2024-02-20,203,mango yogurt,50,60,10,1,459,India
200391,2024-02-20,210,mountain dew,75,100,25,1,447,India
825533,2024-02-20,205,classic yogurt,45,60,15,1,444,India
825533,2024-02-20,212,amul cheese,250,315,65,1,444,India
825533,2024-02-20,201,paneer,210,340,130,1,444,India
825533,2024-02-20,213,bisleri,6,15,9,1,444,India
227277,2024-02-20,205,classic yogurt,45,60,15,1,328,India
227277,2024-02-20,204,strawberry yogurt,50,60,10,1,328,India
227277,2024-02-20,201,paneer,210,340,130,1,328,India
227277,2024-02-20,209,pepsi,75,100,25,1,328,India
227277,2024-02-20,207,coca cola,75,100,25,1,328,India
635382,2024-02-20,208,sprite,75,100,25,1,224,India
635382,2024-02-20,210,mountain dew,75,100,25,1,224,India
635382,2024-02-20,209,pepsi,75,100,25,1,224,India
635382,2024-02-20,201,paneer,210,340,130,1,224,India
715208,2024-02-20,210,mountain dew,75,100,25,1,129,India
715208,2024-02-20,209,pepsi,75,100,25,1,129,India
534518,2024-02-20,208,sprite,75,100,25,1,470,India
534518,2024-02-20,210,mountain dew,75,100,25,1,470,India
534518,2024-02-20,211,red bull,90,125,35,1,470,India
646848,2024-02-20,205,classic yogurt,45,60,15,1,497,India
452958,2024-02-20,211,red bull,90,125,35,1,45,India
452958,2024-02-20,207,coca cola,75,100,25,1,45,India
452958,2024-02-20,205,classic yogurt,45,60,15,1,45,India
452958,2024-02-20,212,amul cheese,250,315,65,1,45,India
603404,2024-02-20,209,pepsi,75,100,25,1,267,India
603404,2024-02-20,206,yakult,360,400,40,1,267,India
603404,2024-02-20,202,milk,12,27,15,1,267,India
603404,2024-02-20,212,amul cheese,250,315,65,1,267,India
603404,2024-02-20,201,paneer,210,340,130,1,267,India
541103,2024-02-20,206,yakult,360,400,40,1,70,India
541103,2024-02-20,211,red bull,90,125,35,1,70,India
516278,2024-02-20,209,pepsi,75,100,25,1,170,India
140882,2024-02-20,202,milk,12,27,15,1,448,India
140882,2024-02-20,213,bisleri,6,15,9,1,448,India
140882,2024-02-20,207,coca cola,75,100,25,1,448,India
492793,2024-02-20,201,paneer,210,340,130,1,82,India
492793,2024-02-20,212,amul cheese,250,315,65,1,82,India
956590,2024-02-20,209,pepsi,75,100,25,1,281,India
956590,2024-02-20,201,paneer,210,340,130,1,281,India
902528,2024-02-20,205,classic yogurt,45,60,15,1,434,India
902528,2024-02-20,212,amul cheese,250,315,65,1,434,India
902528,2024-02-20,202,milk,12,27,15,1,434,India
902528,2024-02-20,209,pepsi,75,100,25,1,434,India
957357,2024-02-20,201,paneer,210,340,130,1,454,India
435522,2024-02-20,205,classic yogurt,45,60,15,1,491,India
435522,2024-02-20,204,strawberry yogurt,50,60,10,1,491,India
435522,2024-02-20,201,paneer,210,340,130,1,491,India
979244,2024-02-20,203,mango yogurt,50,60,10,1,143,India
886654,2024-02-20,201,paneer,210,340,130,1,136,India
886654,2024-02-20,202,milk,12,27,15,1,136,India
886654,2024-02-20,211,red bull,90,125,35,1,136,India
923312,2024-02-20,212,amul cheese,250,315,65,1,277,India
923312,2024-02-20,208,sprite,75,100,25,1,277,India
923312,2024-02-20,209,pepsi,75,100,25,1,277,India
923312,2024-02-20,201,paneer,210,340,130,1,277,India
761963,2024-02-20,212,amul cheese,250,315,65,1,255,India
761963,2024-02-20,211,red bull,90,125,35,1,255,India
761963,2024-02-20,202,milk,12,27,15,1,255,India
761963,2024-02-20,204,strawberry yogurt,50,60,10,1,255,India
483509,2024-02-20,209,pepsi,75,100,25,1,65,India
483509,2024-02-20,206,yakult,360,400,40,1,65,India
483509,2024-02-20,202,milk,12,27,15,1,65,India
956559,2024-02-20,204,strawberry yogurt,50,60,10,1,384,India
956559,2024-02-20,213,bisleri,6,15,9,1,384,India
956559,2024-02-20,211,red bull,90,125,35,1,384,India
829887,2024-02-20,203,mango yogurt,50,60,10,1,234,India
829887,2024-02-20,207,coca cola,75,100,25,1,234,India
732994,2024-02-20,209,pepsi,75,100,25,1,209,India
130881,2024-02-20,212,amul cheese,250,315,65,1,196,India
130881,2024-02-20,203,mango yogurt,50,60,10,1,196,India
130881,2024-02-20,209,pepsi,75,100,25,1,196,India
130881,2024-02-20,211,red bull,90,125,35,1,196,India
608833,2024-02-20,206,yakult,360,400,40,1,198,India
608833,2024-02-20,207,coca cola,75,100,25,1,198,India
608833,2024-02-20,201,paneer,210,340,130,1,198,India
778771,2024-02-20,207,coca cola,75,100,25,1,311,India
778771,2024-02-20,213,bisleri,6,15,9,1,311,India
778771,2024-02-20,204,strawberry yogurt,50,60,10,1,311,India
778771,2024-02-20,208,sprite,75,100,25,1,311,India
240408,2024-02-20,206,yakult,360,400,40,1,31,India
240408,2024-02-20,210,mountain dew,75,100,25,1,31,India
240408,2024-02-20,211,red bull,90,125,35,1,31,India
414239,2024-02-20,201,paneer,210,340,130,1,369,India
414239,2024-02-20,210,mountain dew,75,100,25,1,369,India
414239,2024-02-20,212,amul cheese,250,315,65,1,369,India
777053,2024-02-20,208,sprite,75,100,25,1,358,India
439296,2024-02-20,206,yakult,360,400,40,1,388,India
439296,2024-02-20,203,mango yogurt,50,60,10,1,388,India
735941,2024-02-20,207,coca cola,75,100,25,1,488,India
669756,2024-02-20,205,classic yogurt,45,60,15,1,104,India
669756,2024-02-20,209,pepsi,75,100,25,1,104,India
737157,2024-02-20,213,bisleri,6,15,9,1,345,India
737157,2024-02-20,212,amul cheese,250,315,65,1,345,India
431500,2024-02-20,206,yakult,360,400,40,1,54,India
431500,2024-02-20,203,mango yogurt,50,60,10,1,54,India
431500,2024-02-20,202,milk,12,27,15,1,54,India
931892,2024-02-20,207,coca cola,75,100,25,1,362,India
931892,2024-02-20,201,paneer,210,340,130,1,362,India
931892,2024-02-20,206,yakult,360,400,40,1,362,India
730934,2024-02-20,213,bisleri,6,15,9,1,494,India
