InvoiceNo,InvoiceDate,StockCode,Description,Cost_Price,UnitPrice,Profit,Quantity,CustomerID,Country
911033,2023-02-20,608,football,298,1099,801,1,00001,India
911033,2023-02-20,606,badminton rackets,180,499,319,1,00001,India
911033,2023-02-20,603,tennis ball,25,60,35,1,00001,India
266961,2023-02-20,603,tennis ball,25,60,35,1,00002,India
266961,2023-02-20,602,cricket ball,125,260,135,1,00002,India
519401,2023-02-20,611,helmet,200,400,200,1,00003,India
501247,2023-02-20,607,table tennis table,20000,26500,6500,1,00004,India
501247,2023-02-20,609,basketball,298,679,381,1,00004,India
501247,2023-02-20,602,cricket ball,125,260,135,1,00004,India
957480,2023-02-20,601,cricket bat,400,1500,1100,1,00005,India
957480,2023-02-20,611,helmet,200,400,200,1,00005,India
395219,2023-02-20,608,football,298,1099,801,1,00006,India
395219,2023-02-20,611,helmet,200,400,200,1,00006,India
980866,2023-02-20,611,helmet,200,400,200,1,00007,India
980866,2023-02-20,603,tennis ball,25,60,35,1,00007,India
963146,2023-02-20,604,tennis racket,1200,1800,600,1,00008,India
963146,2023-02-20,605,badminton shuttlecocks,180,300,120,1,00008,India
963146,2023-02-20,611,helmet,200,400,200,1,00008,India
102119,2023-02-20,603,tennis ball,25,60,35,1,00009,India
102119,2023-02-20,609,basketball,298,679,381,1,00009,India
102119,2023-02-20,601,cricket bat,400,1500,1100,1,00009,India
300994,2023-02-20,601,cricket bat,400,1500,1100,1,00010,India
300994,2023-02-20,602,cricket ball,125,260,135,1,00010,India
300994,2023-02-20,609,basketball,298,679,381,1,00010,India
300994,2023-02-20,604,tennis racket,1200,1800,600,1,00010,India
247912,2023-02-21,604,tennis racket,1200,1800,600,1,00011,India
112776,2023-02-21,611,helmet,200,400,200,1,00012,India
112776,2023-02-21,602,cricket ball,125,260,135,1,00012,India
464640,2023-02-21,603,tennis ball,25,60,35,1,00013,India
464640,2023-02-21,606,badminton rackets,180,499,319,1,00013,India
464640,2023-02-21,604,tennis racket,1200,1800,600,1,00013,India
464640,2023-02-21,611,helmet,200,400,200,1,00013,India
458248,2023-02-21,610,golf clubs,27000,42000,15000,1,00014,India
458248,2023-02-21,601,cricket bat,400,1500,1100,1,00014,India
458248,2023-02-21,605,badminton shuttlecocks,180,300,120,1,00014,India
165570,2023-02-22,605,badminton shuttlecocks,180,300,120,1,00015,India
165570,2023-02-22,608,football,298,1099,801,1,00015,India
656802,2023-02-22,603,tennis ball,25,60,35,1,00016,India
656802,2023-02-22,607,table tennis table,20000,26500,6500,1,00016,India
656802,2023-02-22,609,basketball,298,679,381,1,00016,India
314355,2023-02-22,609,basketball,298,679,381,1,00017,India
431526,2023-02-22,601,cricket bat,400,1500,1100,1,00018,India
431526,2023-02-22,603,tennis ball,25,60,35,1,00018,India
586352,2023-02-22,609,basketball,298,679,381,1,00019,India
586352,2023-02-22,608,football,298,1099,801,1,00019,India
586352,2023-02-22,602,cricket ball,125,260,135,1,00019,India
586352,2023-02-22,603,tennis ball,25,60,35,1,00019,India
586352,2023-02-22,606,badminton rackets,180,499,319,1,00019,India
133662,2023-02-22,605,badminton shuttlecocks,180,300,120,1,00020,India
133662,2023-02-22,604,tennis racket,1200,1800,600,1,00020,India
133662,2023-02-22,601,cricket bat,400,1500,1100,1,00020,India
133662,2023-02-22,609,basketball,298,679,381,1,00020,India
774669,2023-02-22,608,football,298,1099,801,1,00021,India
774669,2023-02-22,605,badminton shuttlecocks,180,300,120,1,00021,India
774669,2023-02-22,611,helmet,200,400,200,1,00021,India
774669,2023-02-22,603,tennis ball,25,60,35,1,00021,India
774669,2023-02-22,601,cricket bat,400,1500,1100,1,00021,India
598907,2023-02-23,608,football,298,1099,801,1,00022,India
598907,2023-02-23,606,badminton rackets,180,499,319,1,00022,India
598907,2023-02-23,602,cricket ball,125,260,135,1,00022,India
598907,2023-02-23,607,table tennis table,20000,26500,6500,1,00022,India
236735,2023-02-23,609,basketball,298,679,381,1,00023,India
159239,2023-02-23,601,cricket bat,400,1500,1100,1,00024,India
159239,2023-02-23,607,table tennis table,20000,26500,6500,1,00024,India
321128,2023-02-23,604,tennis racket,1200,1800,600,1,00025,India
321128,2023-02-23,602,cricket ball,125,260,135,1,00025,India
321128,2023-02-23,608,football,298,1099,801,1,00025,India
321128,2023-02-23,601,cricket bat,400,1500,1100,1,00025,India
321128,2023-02-23,606,badminton rackets,180,499,319,1,00025,India
802308,2023-02-23,606,badminton rackets,180,499,319,1,00026,India
802308,2023-02-23,605,badminton shuttlecocks,180,300,120,1,00026,India
558468,2023-02-24,610,golf clubs,27000,42000,15000,1,00027,India
558468,2023-02-24,603,tennis ball,25,60,35,1,00027,India
558468,2023-02-24,609,basketball,298,679,381,1,00027,India
558468,2023-02-24,602,cricket ball,125,260,135,1,00027,India
558468,2023-02-24,608,football,298,1099,801,1,00027,India
385587,2023-02-24,606,badminton rackets,180,499,319,1,00028,India
385587,2023-02-24,602,cricket ball,125,260,135,1,00028,India
385587,2023-02-24,609,basketball,298,679,381,1,00028,India
385587,2023-02-24,605,badminton shuttlecocks,180,300,120,1,00028,India
385587,2023-02-24,608,football,298,1099,801,1,00028,India
761523,2023-02-24,607,table tennis table,20000,26500,6500,1,00029,India
953445,2023-02-24,609,basketball,298,679,381,1,00030,India
953445,2023-02-24,605,badminton shuttlecocks,180,300,120,1,00030,India
953445,2023-02-24,610,golf clubs,27000,42000,15000,1,00030,India
138983,2023-02-24,602,cricket ball,125,260,135,1,00031,India
138983,2023-02-24,610,golf clubs,27000,42000,15000,1,00031,India
138983,2023-02-24,604,tennis racket,1200,1800,600,1,00031,India
206155,2023-02-24,609,basketball,298,679,381,1,00032,India
603905,2023-02-24,608,football,298,1099,801,1,00033,India
603905,2023-02-24,606,badminton rackets,180,499,319,1,00033,India
603905,2023-02-24,609,basketball,298,679,381,1,00033,India
679127,2023-02-25,605,badminton shuttlecocks,180,300,120,1,00034,India
679127,2023-02-25,604,tennis racket,1200,1800,600,1,00034,India
679127,2023-02-25,602,cricket ball,125,260,135,1,00034,India
679127,2023-02-25,611,helmet,200,400,200,1,00034,India
861000,2023-02-25,606,badminton rackets,180,499,319,1,00035,India
861000,2023-02-25,603,tennis ball,25,60,35,1,00035,India
906533,2023-02-25,606,badminton rackets,180,499,319,1,00036,India
906533,2023-02-25,603,tennis ball,25,60,35,1,00036,India
846209,2023-02-25,604,tennis racket,1200,1800,600,1,00037,India
846209,2023-02-25,609,basketball,298,679,381,1,00037,India
846209,2023-02-25,603,tennis ball,25,60,35,1,00037,India
795868,2023-02-25,602,cricket ball,125,260,135,1,00038,India
795868,2023-02-25,606,badminton rackets,180,499,319,1,00038,India
188518,2023-02-25,608,football,298,1099,801,1,00039,India
188518,2023-02-25,611,helmet,200,400,200,1,00039,India
188518,2023-02-25,604,tennis racket,1200,1800,600,1,00039,India
188518,2023-02-25,607,table tennis table,20000,26500,6500,1,00039,India
761290,2023-02-25,611,helmet,200,400,200,1,00040,India
931673,2023-02-25,602,cricket ball,125,260,135,1,00041,India
931673,2023-02-25,609,basketball,298,679,381,1,00041,India
789763,2023-02-25,602,cricket ball,125,260,135,1,00042,India
789763,2023-02-25,607,table tennis table,20000,26500,6500,1,00042,India
789763,2023-02-25,601,cricket bat,400,1500,1100,1,00042,India
452781,2023-02-26,609,basketball,298,679,381,1,00043,India
452781,2023-02-26,603,tennis ball,25,60,35,1,00043,India
790227,2023-02-26,601,cricket bat,400,1500,1100,1,00044,India
790227,2023-02-26,607,table tennis table,20000,26500,6500,1,00044,India
790227,2023-02-26,610,golf clubs,27000,42000,15000,1,00044,India
199671,2023-02-27,606,badminton rackets,180,499,319,1,00045,India
935122,2023-02-27,610,golf clubs,27000,42000,15000,1,00046,India
935122,2023-02-27,602,cricket ball,125,260,135,1,00046,India
725210,2023-02-27,602,cricket ball,125,260,135,1,00047,India
725210,2023-02-27,607,table tennis table,20000,26500,6500,1,00047,India
984674,2023-02-27,609,basketball,298,679,381,1,00048,India
984674,2023-02-27,603,tennis ball,25,60,35,1,00048,India
524668,2023-02-27,611,helmet,200,400,200,1,00049,India
524668,2023-02-27,601,cricket bat,400,1500,1100,1,00049,India
524668,2023-02-27,602,cricket ball,125,260,135,1,00049,India
524668,2023-02-27,607,table tennis table,20000,26500,6500,1,00049,India
524668,2023-02-27,605,badminton shuttlecocks,180,300,120,1,00049,India
935609,2023-02-27,611,helmet,200,400,200,1,00050,India
935609,2023-02-27,604,tennis racket,1200,1800,600,1,00050,India
573270,2023-02-27,608,football,298,1099,801,1,00051,India
573270,2023-02-27,605,badminton shuttlecocks,180,300,120,1,00051,India
573270,2023-02-27,601,cricket bat,400,1500,1100,1,00051,India
748160,2023-02-27,610,golf clubs,27000,42000,15000,1,00052,India
748160,2023-02-27,607,table tennis table,20000,26500,6500,1,00052,India
748160,2023-02-27,609,basketball,298,679,381,1,00052,India
947442,2023-02-28,604,tennis racket,1200,1800,600,1,00053,India
796679,2023-03-01,607,table tennis table,20000,26500,6500,1,00054,India
796679,2023-03-01,606,badminton rackets,180,499,319,1,00054,India
796679,2023-03-01,611,helmet,200,400,200,1,00054,India
796679,2023-03-01,605,badminton shuttlecocks,180,300,120,1,00054,India
962282,2023-03-03,602,cricket ball,125,260,135,1,00055,India
962282,2023-03-03,610,golf clubs,27000,42000,15000,1,00055,India
610013,2023-03-04,604,tennis racket,1200,1800,600,1,00056,India
702578,2023-03-04,602,cricket ball,125,260,135,1,00057,India
702578,2023-03-04,610,golf clubs,27000,42000,15000,1,00057,India
643398,2023-03-04,601,cricket bat,400,1500,1100,1,00058,India
643398,2023-03-04,607,table tennis table,20000,26500,6500,1,00058,India
929798,2023-03-04,610,golf clubs,27000,42000,15000,1,00059,India
929798,2023-03-04,605,badminton shuttlecocks,180,300,120,1,00059,India
517606,2023-03-04,610,golf clubs,27000,42000,15000,1,00060,India
517606,2023-03-04,604,tennis racket,1200,1800,600,1,00060,India
517606,2023-03-04,609,basketball,298,679,381,1,00060,India
994144,2023-03-05,607,table tennis table,20000,26500,6500,1,00061,India
915794,2023-03-05,609,basketball,298,679,381,1,00062,India
915794,2023-03-05,602,cricket ball,125,260,135,1,00062,India
492328,2023-03-05,606,badminton rackets,180,499,319,1,00063,India
398339,2023-03-05,602,cricket ball,125,260,135,1,00064,India
267431,2023-03-05,602,cricket ball,125,260,135,1,00065,India
267431,2023-03-05,610,golf clubs,27000,42000,15000,1,00065,India
267431,2023-03-05,603,tennis ball,25,60,35,1,00065,India
557490,2023-03-06,602,cricket ball,125,260,135,1,00066,India
557490,2023-03-06,605,badminton shuttlecocks,180,300,120,1,00066,India
275577,2023-03-06,601,cricket bat,400,1500,1100,1,00067,India
275577,2023-03-06,609,basketball,298,679,381,1,00067,India
659110,2023-03-06,610,golf clubs,27000,42000,15000,1,00068,India
659110,2023-03-06,607,table tennis table,20000,26500,6500,1,00068,India
794567,2023-03-06,609,basketball,298,679,381,1,00069,India
794567,2023-03-06,606,badminton rackets,180,499,319,1,00069,India
794567,2023-03-06,611,helmet,200,400,200,1,00069,India
722119,2023-03-06,611,helmet,200,400,200,1,00070,India
722119,2023-03-06,605,badminton shuttlecocks,180,300,120,1,00070,India
788042,2023-03-07,604,tennis racket,1200,1800,600,1,00071,India
788042,2023-03-07,602,cricket ball,125,260,135,1,00071,India
788042,2023-03-07,603,tennis ball,25,60,35,1,00071,India
788042,2023-03-07,610,golf clubs,27000,42000,15000,1,00071,India
549182,2023-03-07,608,football,298,1099,801,1,00072,India
549182,2023-03-07,601,cricket bat,400,1500,1100,1,00072,India
549182,2023-03-07,609,basketball,298,679,381,1,00072,India
549182,2023-03-07,611,helmet,200,400,200,1,00072,India
549182,2023-03-07,607,table tennis table,20000,26500,6500,1,00072,India
400517,2023-03-07,602,cricket ball,125,260,135,1,00073,India
400517,2023-03-07,601,cricket bat,400,1500,1100,1,00073,India
591394,2023-03-07,610,golf clubs,27000,42000,15000,1,00074,India
591394,2023-03-07,602,cricket ball,125,260,135,1,00074,India
591394,2023-03-07,606,badminton rackets,180,499,319,1,00074,India
591394,2023-03-07,604,tennis racket,1200,1800,600,1,00074,India
920013,2023-03-07,603,tennis ball,25,60,35,1,00075,India
920013,2023-03-07,607,table tennis table,20000,26500,6500,1,00075,India
288205,2023-03-07,601,cricket bat,400,1500,1100,1,00076,India
288205,2023-03-07,607,table tennis table,20000,26500,6500,1,00076,India
288205,2023-03-07,604,tennis racket,1200,1800,600,1,00076,India
288205,2023-03-07,603,tennis ball,25,60,35,1,00076,India
945217,2023-03-07,608,football,298,1099,801,1,00077,India
945217,2023-03-07,603,tennis ball,25,60,35,1,00077,India
294216,2023-03-07,610,golf clubs,27000,42000,15000,1,00078,India
294216,2023-03-07,606,badminton rackets,180,499,319,1,00078,India
864605,2023-03-07,601,cricket bat,400,1500,1100,1,00079,India
436680,2023-03-07,601,cricket bat,400,1500,1100,1,00080,India
436680,2023-03-07,609,basketball,298,679,381,1,00080,India
436680,2023-03-07,606,badminton rackets,180,499,319,1,00080,India
436680,2023-03-07,605,badminton shuttlecocks,180,300,120,1,00080,India
619918,2023-03-08,607,table tennis table,20000,26500,6500,1,00081,India
619918,2023-03-08,605,badminton shuttlecocks,180,300,120,1,00081,India
835082,2023-03-08,605,badminton shuttlecocks,180,300,120,1,00082,India
835082,2023-03-08,602,cricket ball,125,260,135,1,00082,India
835082,2023-03-08,606,badminton rackets,180,499,319,1,00082,India
835082,2023-03-08,607,table tennis table,20000,26500,6500,1,00082,India
929810,2023-03-08,603,tennis ball,25,60,35,1,00083,India
714131,2023-03-08,602,cricket ball,125,260,135,1,00084,India
714131,2023-03-08,603,tennis ball,25,60,35,1,00084,India
714131,2023-03-08,607,table tennis table,20000,26500,6500,1,00084,India
714131,2023-03-08,601,cricket bat,400,1500,1100,1,00084,India
520210,2023-03-09,611,helmet,200,400,200,1,00085,India
520210,2023-03-09,606,badminton rackets,180,499,319,1,00085,India
373024,2023-03-09,603,tennis ball,25,60,35,1,00086,India
373024,2023-03-09,608,football,298,1099,801,1,00086,India
373024,2023-03-09,607,table tennis table,20000,26500,6500,1,00086,India
694325,2023-03-09,603,tennis ball,25,60,35,1,00087,India
694325,2023-03-09,609,basketball,298,679,381,1,00087,India
237007,2023-03-09,607,table tennis table,20000,26500,6500,1,00088,India
237007,2023-03-09,606,badminton rackets,180,499,319,1,00088,India
662665,2023-03-09,605,badminton shuttlecocks,180,300,120,1,00089,India
662665,2023-03-09,609,basketball,298,679,381,1,00089,India
468793,2023-03-10,604,tennis racket,1200,1800,600,1,00090,India
468793,2023-03-10,608,football,298,1099,801,1,00090,India
468793,2023-03-10,609,basketball,298,679,381,1,00090,India
451268,2023-03-10,602,cricket ball,125,260,135,1,00091,India
451268,2023-03-10,605,badminton shuttlecocks,180,300,120,1,00091,India
451268,2023-03-10,609,basketball,298,679,381,1,00091,India
451268,2023-03-10,603,tennis ball,25,60,35,1,00091,India
451268,2023-03-10,608,football,298,1099,801,1,00091,India
867020,2023-03-10,604,tennis racket,1200,1800,600,1,00092,India
867020,2023-03-10,609,basketball,298,679,381,1,00092,India
883287,2023-03-10,603,tennis ball,25,60,35,1,00093,India
883287,2023-03-10,606,badminton rackets,180,499,319,1,00093,India
883287,2023-03-10,601,cricket bat,400,1500,1100,1,00093,India
883287,2023-03-10,609,basketball,298,679,381,1,00093,India
309639,2023-03-10,606,badminton rackets,180,499,319,1,00094,India
309639,2023-03-10,608,football,298,1099,801,1,00094,India
309639,2023-03-10,605,badminton shuttlecocks,180,300,120,1,00094,India
309639,2023-03-10,611,helmet,200,400,200,1,00094,India
778498,2023-03-11,603,tennis ball,25,60,35,1,00095,India
607057,2023-03-12,603,tennis ball,25,60,35,1,00096,India
607057,2023-03-12,605,badminton shuttlecocks,180,300,120,1,00096,India
607057,2023-03-12,608,football,298,1099,801,1,00096,India
902083,2023-03-12,608,football,298,1099,801,1,00097,India
902083,2023-03-12,604,tennis racket,1200,1800,600,1,00097,India
346321,2023-03-12,601,cricket bat,400,1500,1100,1,00098,India
346321,2023-03-12,603,tennis ball,25,60,35,1,00098,India
346321,2023-03-12,609,basketball,298,679,381,1,00098,India
346321,2023-03-12,608,football,298,1099,801,1,00098,India
165303,2023-03-12,605,badminton shuttlecocks,180,300,120,1,00099,India
165303,2023-03-12,610,golf clubs,27000,42000,15000,1,00099,India
567824,2023-03-13,609,basketball,298,679,381,1,00100,India
567824,2023-03-13,605,badminton shuttlecocks,180,300,120,1,00100,India
567824,2023-03-13,603,tennis ball,25,60,35,1,00100,India
567824,2023-03-13,607,table tennis table,20000,26500,6500,1,00100,India
567824,2023-03-13,610,golf clubs,27000,42000,15000,1,00100,India
375942,2023-03-13,609,basketball,298,679,381,1,00101,India
375942,2023-03-13,611,helmet,200,400,200,1,00101,India
375942,2023-03-13,610,golf clubs,27000,42000,15000,1,00101,India
375942,2023-03-13,601,cricket bat,400,1500,1100,1,00101,India
152493,2023-03-13,606,badminton rackets,180,499,319,1,00102,India
152493,2023-03-13,610,golf clubs,27000,42000,15000,1,00102,India
152493,2023-03-13,601,cricket bat,400,1500,1100,1,00102,India
152493,2023-03-13,605,badminton shuttlecocks,180,300,120,1,00102,India
833405,2023-03-13,608,football,298,1099,801,1,00103,India
833405,2023-03-13,609,basketball,298,679,381,1,00103,India
730618,2023-03-13,610,golf clubs,27000,42000,15000,1,00104,India
730618,2023-03-13,603,tennis ball,25,60,35,1,00104,India
818211,2023-03-13,610,golf clubs,27000,42000,15000,1,00105,India
657497,2023-03-13,607,table tennis table,20000,26500,6500,1,00106,India
657497,2023-03-13,606,badminton rackets,180,499,319,1,00106,India
657497,2023-03-13,604,tennis racket,1200,1800,600,1,00106,India
455014,2023-03-14,606,badminton rackets,180,499,319,1,00107,India
999301,2023-03-14,606,badminton rackets,180,499,319,1,00108,India
999301,2023-03-14,601,cricket bat,400,1500,1100,1,00108,India
999301,2023-03-14,610,golf clubs,27000,42000,15000,1,00108,India
783886,2023-03-14,609,basketball,298,679,381,1,00109,India
783886,2023-03-14,606,badminton rackets,180,499,319,1,00109,India
783886,2023-03-14,603,tennis ball,25,60,35,1,00109,India
783886,2023-03-14,601,cricket bat,400,1500,1100,1,00109,India
815196,2023-03-14,609,basketball,298,679,381,1,00110,India
815196,2023-03-14,604,tennis racket,1200,1800,600,1,00110,India
815196,2023-03-14,602,cricket ball,125,260,135,1,00110,India
815196,2023-03-14,606,badminton rackets,180,499,319,1,00110,India
815196,2023-03-14,603,tennis ball,25,60,35,1,00110,India
536089,2023-03-14,605,badminton shuttlecocks,180,300,120,1,00111,India
536089,2023-03-14,602,cricket ball,125,260,135,1,00111,India
536089,2023-03-14,607,table tennis table,20000,26500,6500,1,00111,India
536089,2023-03-14,611,helmet,200,400,200,1,00111,India
536089,2023-03-14,603,tennis ball,25,60,35,1,00111,India
360537,2023-03-14,601,cricket bat,400,1500,1100,1,00112,India
600227,2023-03-14,603,tennis ball,25,60,35,1,00113,India
600227,2023-03-14,610,golf clubs,27000,42000,15000,1,00113,India
436096,2023-03-15,610,golf clubs,27000,42000,15000,1,00114,India
436096,2023-03-15,608,football,298,1099,801,1,00114,India
436096,2023-03-15,603,tennis ball,25,60,35,1,00114,India
694214,2023-03-15,610,golf clubs,27000,42000,15000,1,00115,India
694214,2023-03-15,608,football,298,1099,801,1,00115,India
694214,2023-03-15,605,badminton shuttlecocks,180,300,120,1,00115,India
953512,2023-03-15,603,tennis ball,25,60,35,1,00116,India
953512,2023-03-15,601,cricket bat,400,1500,1100,1,00116,India
953512,2023-03-15,607,table tennis table,20000,26500,6500,1,00116,India
593381,2023-03-15,608,football,298,1099,801,1,00117,India
593381,2023-03-15,601,cricket bat,400,1500,1100,1,00117,India
593381,2023-03-15,610,golf clubs,27000,42000,15000,1,00117,India
443164,2023-03-15,606,badminton rackets,180,499,319,1,00118,India
443164,2023-03-15,610,golf clubs,27000,42000,15000,1,00118,India
443164,2023-03-15,604,tennis racket,1200,1800,600,1,00118,India
177941,2023-03-15,602,cricket ball,125,260,135,1,00119,India
177941,2023-03-15,601,cricket bat,400,1500,1100,1,00119,India
177941,2023-03-15,604,tennis racket,1200,1800,600,1,00119,India
875504,2023-03-15,610,golf clubs,27000,42000,15000,1,00120,India
875504,2023-03-15,602,cricket ball,125,260,135,1,00120,India
438279,2023-03-17,603,tennis ball,25,60,35,1,00121,India
438279,2023-03-17,605,badminton shuttlecocks,180,300,120,1,00121,India
438279,2023-03-17,602,cricket ball,125,260,135,1,00121,India
438279,2023-03-17,608,football,298,1099,801,1,00121,India
438279,2023-03-17,609,basketball,298,679,381,1,00121,India
154552,2023-03-17,602,cricket ball,125,260,135,1,00122,India
154552,2023-03-17,603,tennis ball,25,60,35,1,00122,India
154552,2023-03-17,611,helmet,200,400,200,1,00122,India
564623,2023-03-18,605,badminton shuttlecocks,180,300,120,1,00123,India
564623,2023-03-18,607,table tennis table,20000,26500,6500,1,00123,India
564623,2023-03-18,603,tennis ball,25,60,35,1,00123,India
776976,2023-03-18,602,cricket ball,125,260,135,1,00124,India
776976,2023-03-18,609,basketball,298,679,381,1,00124,India
776976,2023-03-18,606,badminton rackets,180,499,319,1,00124,India
718891,2023-03-18,608,football,298,1099,801,1,00125,India
718891,2023-03-18,611,helmet,200,400,200,1,00125,India
718891,2023-03-18,610,golf clubs,27000,42000,15000,1,00125,India
718891,2023-03-18,603,tennis ball,25,60,35,1,00125,India
118611,2023-03-18,607,table tennis table,20000,26500,6500,1,00126,India
118611,2023-03-18,609,basketball,298,679,381,1,00126,India
118611,2023-03-18,602,cricket ball,125,260,135,1,00126,India
118611,2023-03-18,611,helmet,200,400,200,1,00126,India
118611,2023-03-18,606,badminton rackets,180,499,319,1,00126,India
317508,2023-03-18,606,badminton rackets,180,499,319,1,00127,India
317508,2023-03-18,604,tennis racket,1200,1800,600,1,00127,India
317508,2023-03-18,602,cricket ball,125,260,135,1,00127,India
150764,2023-03-18,604,tennis racket,1200,1800,600,1,00128,India
150764,2023-03-18,602,cricket ball,125,260,135,1,00128,India
923434,2023-03-18,602,cricket ball,125,260,135,1,00129,India
884232,2023-03-19,603,tennis ball,25,60,35,1,00130,India
352361,2023-03-19,601,cricket bat,400,1500,1100,1,00131,India
352361,2023-03-19,610,golf clubs,27000,42000,15000,1,00131,India
352361,2023-03-19,607,table tennis table,20000,26500,6500,1,00131,India
782792,2023-03-19,606,badminton rackets,180,499,319,1,00132,India
782792,2023-03-19,609,basketball,298,679,381,1,00132,India
782792,2023-03-19,603,tennis ball,25,60,35,1,00132,India
515494,2023-03-19,601,cricket bat,400,1500,1100,1,00133,India
515494,2023-03-19,606,badminton rackets,180,499,319,1,00133,India
515494,2023-03-19,611,helmet,200,400,200,1,00133,India
214068,2023-03-20,602,cricket ball,125,260,135,1,00134,India
214068,2023-03-20,610,golf clubs,27000,42000,15000,1,00134,India
214068,2023-03-20,607,table tennis table,20000,26500,6500,1,00134,India
214068,2023-03-20,606,badminton rackets,180,499,319,1,00134,India
926432,2023-03-20,602,cricket ball,125,260,135,1,00135,India
926432,2023-03-20,604,tennis racket,1200,1800,600,1,00135,India
926432,2023-03-20,605,badminton shuttlecocks,180,300,120,1,00135,India
926432,2023-03-20,606,badminton rackets,180,499,319,1,00135,India
173542,2023-03-20,611,helmet,200,400,200,1,00136,India
776025,2023-03-20,611,helmet,200,400,200,1,00137,India
776025,2023-03-20,603,tennis ball,25,60,35,1,00137,India
448586,2023-03-20,602,cricket ball,125,260,135,1,00138,India
236281,2023-03-20,602,cricket ball,125,260,135,1,00139,India
295432,2023-03-20,605,badminton shuttlecocks,180,300,120,1,00140,India
295432,2023-03-20,603,tennis ball,25,60,35,1,00140,India
295432,2023-03-20,604,tennis racket,1200,1800,600,1,00140,India
971497,2023-03-21,606,badminton rackets,180,499,319,1,00141,India
157007,2023-03-21,607,table tennis table,20000,26500,6500,1,00142,India
975201,2023-03-21,602,cricket ball,125,260,135,1,00143,India
975201,2023-03-21,604,tennis racket,1200,1800,600,1,00143,India
975201,2023-03-21,601,cricket bat,400,1500,1100,1,00143,India
975201,2023-03-21,605,badminton shuttlecocks,180,300,120,1,00143,India
423642,2023-03-21,603,tennis ball,25,60,35,1,00144,India
423642,2023-03-21,607,table tennis table,20000,26500,6500,1,00144,India
423642,2023-03-21,609,basketball,298,679,381,1,00144,India
423642,2023-03-21,608,football,298,1099,801,1,00144,India
376282,2023-03-21,607,table tennis table,20000,26500,6500,1,00145,India
376282,2023-03-21,609,basketball,298,679,381,1,00145,India
376282,2023-03-21,603,tennis ball,25,60,35,1,00145,India
376282,2023-03-21,611,helmet,200,400,200,1,00145,India
688616,2023-03-22,611,helmet,200,400,200,1,00146,India
543881,2023-03-22,601,cricket bat,400,1500,1100,1,00147,India
543881,2023-03-22,606,badminton rackets,180,499,319,1,00147,India
141667,2023-03-22,611,helmet,200,400,200,1,00148,India
998986,2023-03-22,609,basketball,298,679,381,1,00149,India
998986,2023-03-22,610,golf clubs,27000,42000,15000,1,00149,India
998986,2023-03-22,602,cricket ball,125,260,135,1,00149,India
998986,2023-03-22,605,badminton shuttlecocks,180,300,120,1,00149,India
294894,2023-03-23,606,badminton rackets,180,499,319,1,00150,India
294894,2023-03-23,607,table tennis table,20000,26500,6500,1,00150,India
971013,2023-03-23,601,cricket bat,400,1500,1100,1,00151,India
971013,2023-03-23,608,football,298,1099,801,1,00151,India
971013,2023-03-23,604,tennis racket,1200,1800,600,1,00151,India
484241,2023-03-24,607,table tennis table,20000,26500,6500,1,00152,India
607688,2023-03-24,602,cricket ball,125,260,135,1,00153,India
607688,2023-03-24,608,football,298,1099,801,1,00153,India
324421,2023-03-24,609,basketball,298,679,381,1,00154,India
324421,2023-03-24,602,cricket ball,125,260,135,1,00154,India
558336,2023-03-24,606,badminton rackets,180,499,319,1,00155,India
425713,2023-03-24,607,table tennis table,20000,26500,6500,1,00156,India
268471,2023-03-24,611,helmet,200,400,200,1,00157,India
268471,2023-03-24,605,badminton shuttlecocks,180,300,120,1,00157,India
268471,2023-03-24,607,table tennis table,20000,26500,6500,1,00157,India
268471,2023-03-24,608,football,298,1099,801,1,00157,India
109109,2023-03-24,609,basketball,298,679,381,1,00158,India
777442,2023-03-25,609,basketball,298,679,381,1,00159,India
777442,2023-03-25,604,tennis racket,1200,1800,600,1,00159,India
777442,2023-03-25,603,tennis ball,25,60,35,1,00159,India
350044,2023-03-25,601,cricket bat,400,1500,1100,1,00160,India
350044,2023-03-25,602,cricket ball,125,260,135,1,00160,India
350044,2023-03-25,603,tennis ball,25,60,35,1,00160,India
350044,2023-03-25,610,golf clubs,27000,42000,15000,1,00160,India
706213,2023-03-25,601,cricket bat,400,1500,1100,1,00161,India
706213,2023-03-25,604,tennis racket,1200,1800,600,1,00161,India
706213,2023-03-25,608,football,298,1099,801,1,00161,India
706213,2023-03-25,602,cricket ball,125,260,135,1,00161,India
310131,2023-03-26,607,table tennis table,20000,26500,6500,1,00162,India
310131,2023-03-26,608,football,298,1099,801,1,00162,India
210026,2023-03-26,604,tennis racket,1200,1800,600,1,00163,India
210026,2023-03-26,609,basketball,298,679,381,1,00163,India
210026,2023-03-26,610,golf clubs,27000,42000,15000,1,00163,India
653332,2023-03-26,608,football,298,1099,801,1,00164,India
653332,2023-03-26,601,cricket bat,400,1500,1100,1,00164,India
653332,2023-03-26,605,badminton shuttlecocks,180,300,120,1,00164,India
653332,2023-03-26,607,table tennis table,20000,26500,6500,1,00164,India
944659,2023-03-27,603,tennis ball,25,60,35,1,00165,India
314905,2023-03-27,610,golf clubs,27000,42000,15000,1,00166,India
314905,2023-03-27,605,badminton shuttlecocks,180,300,120,1,00166,India
314905,2023-03-27,602,cricket ball,125,260,135,1,00166,India
314905,2023-03-27,606,badminton rackets,180,499,319,1,00166,India
921388,2023-03-27,608,football,298,1099,801,1,00167,India
921388,2023-03-27,602,cricket ball,125,260,135,1,00167,India
956176,2023-03-27,604,tennis racket,1200,1800,600,1,00168,India
956176,2023-03-27,605,badminton shuttlecocks,180,300,120,1,00168,India
306256,2023-03-27,602,cricket ball,125,260,135,1,00169,India
306256,2023-03-27,610,golf clubs,27000,42000,15000,1,00169,India
806456,2023-03-27,606,badminton rackets,180,499,319,1,00170,India
806456,2023-03-27,602,cricket ball,125,260,135,1,00170,India
806456,2023-03-27,601,cricket bat,400,1500,1100,1,00170,India
806456,2023-03-27,604,tennis racket,1200,1800,600,1,00170,India
129153,2023-03-27,610,golf clubs,27000,42000,15000,1,00171,India
129153,2023-03-27,607,table tennis table,20000,26500,6500,1,00171,India
746699,2023-03-27,602,cricket ball,125,260,135,1,00172,India
584834,2023-03-29,602,cricket ball,125,260,135,1,00173,India
584834,2023-03-29,606,badminton rackets,180,499,319,1,00173,India
584834,2023-03-29,607,table tennis table,20000,26500,6500,1,00173,India
584834,2023-03-29,609,basketball,298,679,381,1,00173,India
342617,2023-03-29,602,cricket ball,125,260,135,1,00174,India
269230,2023-03-29,607,table tennis table,20000,26500,6500,1,00175,India
269230,2023-03-29,610,golf clubs,27000,42000,15000,1,00175,India
709162,2023-03-29,602,cricket ball,125,260,135,1,00176,India
709162,2023-03-29,610,golf clubs,27000,42000,15000,1,00176,India
801972,2023-03-29,603,tennis ball,25,60,35,1,00177,India
157851,2023-03-29,605,badminton shuttlecocks,180,300,120,1,00178,India
157851,2023-03-29,602,cricket ball,125,260,135,1,00178,India
278887,2023-03-29,611,helmet,200,400,200,1,00179,India
606826,2023-03-29,603,tennis ball,25,60,35,1,00180,India
606826,2023-03-29,605,badminton shuttlecocks,180,300,120,1,00180,India
606826,2023-03-29,608,football,298,1099,801,1,00180,India
865850,2023-03-30,604,tennis racket,1200,1800,600,1,00181,India
865850,2023-03-30,607,table tennis table,20000,26500,6500,1,00181,India
865850,2023-03-30,603,tennis ball,25,60,35,1,00181,India
235759,2023-03-30,607,table tennis table,20000,26500,6500,1,00182,India
235759,2023-03-30,605,badminton shuttlecocks,180,300,120,1,00182,India
235759,2023-03-30,609,basketball,298,679,381,1,00182,India
292390,2023-03-30,603,tennis ball,25,60,35,1,00183,India
292390,2023-03-30,611,helmet,200,400,200,1,00183,India
292390,2023-03-30,602,cricket ball,125,260,135,1,00183,India
636199,2023-03-30,611,helmet,200,400,200,1,00184,India
636199,2023-03-30,606,badminton rackets,180,499,319,1,00184,India
636199,2023-03-30,607,table tennis table,20000,26500,6500,1,00184,India
636199,2023-03-30,610,golf clubs,27000,42000,15000,1,00184,India
347681,2023-03-31,610,golf clubs,27000,42000,15000,1,00185,India
347681,2023-03-31,611,helmet,200,400,200,1,00185,India
871979,2023-03-31,607,table tennis table,20000,26500,6500,1,00186,India
871979,2023-03-31,603,tennis ball,25,60,35,1,00186,India
871979,2023-03-31,602,cricket ball,125,260,135,1,00186,India
636033,2023-03-31,603,tennis ball,25,60,35,1,00187,India
109444,2023-03-31,604,tennis racket,1200,1800,600,1,00188,India
526439,2023-04-01,611,helmet,200,400,200,2,00189,India
526439,2023-04-01,608,football,298,1099,801,2,00189,India
526439,2023-04-01,602,cricket ball,125,260,135,3,00189,India
161386,2023-04-01,608,football,298,1099,801,2,00190,India
387445,2023-04-01,601,cricket bat,400,1500,1100,2,00191,India
387445,2023-04-01,607,table tennis table,20000,26500,6500,2,00191,India
678322,2023-04-01,602,cricket ball,125,260,135,3,00192,India
627706,2023-04-01,609,basketball,298,679,381,2,00193,India
804880,2023-04-01,606,badminton rackets,180,499,319,2,00194,India
255354,2023-04-01,611,helmet,200,400,200,2,00195,India
255354,2023-04-01,608,football,298,1099,801,2,00195,India
255354,2023-04-01,603,tennis ball,25,60,35,3,00195,India
620834,2023-04-01,604,tennis racket,1200,1800,600,2,00196,India
620834,2023-04-01,610,golf clubs,27000,42000,15000,2,00196,India
620834,2023-04-01,607,table tennis table,20000,26500,6500,2,00196,India
620834,2023-04-01,609,basketball,298,679,381,2,00196,India
370498,2023-04-01,605,badminton shuttlecocks,180,300,120,2,00197,India
370498,2023-04-01,604,tennis racket,1200,1800,600,2,00197,India
370498,2023-04-01,608,football,298,1099,801,2,00197,India
370498,2023-04-01,609,basketball,298,679,381,2,00197,India
235618,2023-04-01,609,basketball,298,679,381,2,00198,India
235618,2023-04-01,602,cricket ball,125,260,135,3,00198,India
590502,2023-04-02,606,badminton rackets,180,499,319,2,00199,India
590502,2023-04-02,602,cricket ball,125,260,135,3,00199,India
161187,2023-04-03,604,tennis racket,1200,1800,600,2,00200,India
161187,2023-04-03,607,table tennis table,20000,26500,6500,2,00200,India
161187,2023-04-03,611,helmet,200,400,200,2,00200,India
161187,2023-04-03,603,tennis ball,25,60,35,3,00200,India
316302,2023-04-03,601,cricket bat,400,1500,1100,2,00201,India
941014,2023-04-03,605,badminton shuttlecocks,180,300,120,2,00202,India
941014,2023-04-03,610,golf clubs,27000,42000,15000,2,00202,India
371372,2023-04-04,610,golf clubs,27000,42000,15000,2,00203,India
928964,2023-04-04,603,tennis ball,25,60,35,3,00204,India
928964,2023-04-04,607,table tennis table,20000,26500,6500,2,00204,India
928964,2023-04-04,611,helmet,200,400,200,2,00204,India
428638,2023-04-05,603,tennis ball,25,60,35,3,00205,India
898442,2023-04-05,606,badminton rackets,180,499,319,2,00206,India
898442,2023-04-05,603,tennis ball,25,60,35,3,00206,India
898442,2023-04-05,605,badminton shuttlecocks,180,300,120,2,00206,India
898442,2023-04-05,607,table tennis table,20000,26500,6500,2,00206,India
968641,2023-04-05,608,football,298,1099,801,2,00207,India
968641,2023-04-05,607,table tennis table,20000,26500,6500,2,00207,India
968641,2023-04-05,610,golf clubs,27000,42000,15000,2,00207,India
968641,2023-04-05,603,tennis ball,25,60,35,3,00207,India
833517,2023-04-05,609,basketball,298,679,381,2,00208,India
833517,2023-04-05,603,tennis ball,25,60,35,3,00208,India
980631,2023-04-05,602,cricket ball,125,260,135,3,00209,India
980631,2023-04-05,601,cricket bat,400,1500,1100,2,00209,India
980631,2023-04-05,608,football,298,1099,801,2,00209,India
316871,2023-04-06,607,table tennis table,20000,26500,6500,2,00210,India
851041,2023-04-06,611,helmet,200,400,200,2,00211,India
625510,2023-04-06,607,table tennis table,20000,26500,6500,2,00212,India
625510,2023-04-06,601,cricket bat,400,1500,1100,2,00212,India
625510,2023-04-06,603,tennis ball,25,60,35,3,00212,India
625510,2023-04-06,602,cricket ball,125,260,135,3,00212,India
568851,2023-04-06,609,basketball,298,679,381,2,00213,India
721957,2023-04-06,609,basketball,298,679,381,2,00214,India
721957,2023-04-06,608,football,298,1099,801,2,00214,India
721957,2023-04-06,610,golf clubs,27000,42000,15000,2,00214,India
721957,2023-04-06,606,badminton rackets,180,499,319,2,00214,India
936487,2023-04-06,603,tennis ball,25,60,35,3,00215,India
936487,2023-04-06,607,table tennis table,20000,26500,6500,2,00215,India
936487,2023-04-06,609,basketball,298,679,381,2,00215,India
285743,2023-04-06,610,golf clubs,27000,42000,15000,2,00216,India
285743,2023-04-06,601,cricket bat,400,1500,1100,2,00216,India
285743,2023-04-06,602,cricket ball,125,260,135,3,00216,India
285743,2023-04-06,609,basketball,298,679,381,2,00216,India
390849,2023-04-06,603,tennis ball,25,60,35,3,00217,India
390849,2023-04-06,611,helmet,200,400,200,2,00217,India
390849,2023-04-06,604,tennis racket,1200,1800,600,2,00217,India
587065,2023-04-06,601,cricket bat,400,1500,1100,2,00218,India
587065,2023-04-06,609,basketball,298,679,381,2,00218,India
786466,2023-04-06,611,helmet,200,400,200,2,00219,India
786466,2023-04-06,608,football,298,1099,801,2,00219,India
355137,2023-04-07,607,table tennis table,20000,26500,6500,2,00220,India
355137,2023-04-07,610,golf clubs,27000,42000,15000,2,00220,India
656410,2023-04-07,608,football,298,1099,801,2,00221,India
656410,2023-04-07,601,cricket bat,400,1500,1100,2,00221,India
656410,2023-04-07,610,golf clubs,27000,42000,15000,2,00221,India
615709,2023-04-08,611,helmet,200,400,200,2,00222,India
615709,2023-04-08,605,badminton shuttlecocks,180,300,120,2,00222,India
615709,2023-04-08,606,badminton rackets,180,499,319,2,00222,India
804011,2023-04-08,606,badminton rackets,180,499,319,2,00223,India
804011,2023-04-08,604,tennis racket,1200,1800,600,2,00223,India
388005,2023-04-08,610,golf clubs,27000,42000,15000,2,00224,India
388005,2023-04-08,605,badminton shuttlecocks,180,300,120,2,00224,India
388005,2023-04-08,611,helmet,200,400,200,2,00224,India
388005,2023-04-08,602,cricket ball,125,260,135,3,00224,India
686343,2023-04-08,604,tennis racket,1200,1800,600,2,00225,India
686343,2023-04-08,609,basketball,298,679,381,2,00225,India
686343,2023-04-08,605,badminton shuttlecocks,180,300,120,2,00225,India
686343,2023-04-08,602,cricket ball,125,260,135,3,00225,India
351963,2023-04-08,601,cricket bat,400,1500,1100,2,00226,India
884042,2023-04-08,601,cricket bat,400,1500,1100,2,00227,India
884042,2023-04-08,606,badminton rackets,180,499,319,2,00227,India
884042,2023-04-08,602,cricket ball,125,260,135,3,00227,India
176811,2023-04-08,604,tennis racket,1200,1800,600,2,00228,India
681548,2023-04-08,604,tennis racket,1200,1800,600,2,00229,India
119132,2023-04-08,609,basketball,298,679,381,2,00230,India
119132,2023-04-08,602,cricket ball,125,260,135,3,00230,India
238625,2023-04-09,607,table tennis table,20000,26500,6500,2,00231,India
238625,2023-04-09,604,tennis racket,1200,1800,600,2,00231,India
238625,2023-04-09,609,basketball,298,679,381,2,00231,India
238625,2023-04-09,610,golf clubs,27000,42000,15000,2,00231,India
357641,2023-04-09,603,tennis ball,25,60,35,3,00232,India
655241,2023-04-09,605,badminton shuttlecocks,180,300,120,2,00233,India
655241,2023-04-09,601,cricket bat,400,1500,1100,2,00233,India
655241,2023-04-09,610,golf clubs,27000,42000,15000,2,00233,India
836956,2023-04-09,610,golf clubs,27000,42000,15000,2,00234,India
836956,2023-04-09,604,tennis racket,1200,1800,600,2,00234,India
524222,2023-04-09,608,football,298,1099,801,2,00235,India
524222,2023-04-09,605,badminton shuttlecocks,180,300,120,2,00235,India
524222,2023-04-09,603,tennis ball,25,60,35,3,00235,India
524222,2023-04-09,604,tennis racket,1200,1800,600,2,00235,India
608311,2023-04-09,606,badminton rackets,180,499,319,2,00236,India
608311,2023-04-09,605,badminton shuttlecocks,180,300,120,2,00236,India
955973,2023-04-09,601,cricket bat,400,1500,1100,2,00237,India
955973,2023-04-09,606,badminton rackets,180,499,319,2,00237,India
247761,2023-04-10,605,badminton shuttlecocks,180,300,120,2,00238,India
247761,2023-04-10,608,football,298,1099,801,2,00238,India
247761,2023-04-10,601,cricket bat,400,1500,1100,2,00238,India
331893,2023-04-10,608,football,298,1099,801,2,00239,India
327107,2023-04-10,605,badminton shuttlecocks,180,300,120,2,00240,India
327107,2023-04-10,601,cricket bat,400,1500,1100,2,00240,India
327107,2023-04-10,611,helmet,200,400,200,2,00240,India
327107,2023-04-10,607,table tennis table,20000,26500,6500,2,00240,India
327107,2023-04-10,608,football,298,1099,801,2,00240,India
781956,2023-04-10,611,helmet,200,400,200,2,00241,India
248916,2023-04-10,611,helmet,200,400,200,2,00242,India
248916,2023-04-10,602,cricket ball,125,260,135,3,00242,India
248916,2023-04-10,605,badminton shuttlecocks,180,300,120,2,00242,India
248916,2023-04-10,610,golf clubs,27000,42000,15000,2,00242,India
734281,2023-04-10,603,tennis ball,25,60,35,3,00243,India
734281,2023-04-10,602,cricket ball,125,260,135,3,00243,India
734281,2023-04-10,606,badminton rackets,180,499,319,2,00243,India
734281,2023-04-10,601,cricket bat,400,1500,1100,2,00243,India
317827,2023-04-10,603,tennis ball,25,60,35,3,00244,India
317827,2023-04-10,608,football,298,1099,801,2,00244,India
317827,2023-04-10,606,badminton rackets,180,499,319,2,00244,India
317827,2023-04-10,610,golf clubs,27000,42000,15000,2,00244,India
485464,2023-04-10,611,helmet,200,400,200,2,00245,India
529103,2023-04-11,604,tennis racket,1200,1800,600,2,00246,India
529103,2023-04-11,611,helmet,200,400,200,2,00246,India
529103,2023-04-11,603,tennis ball,25,60,35,3,00246,India
926535,2023-04-11,611,helmet,200,400,200,2,00247,India
926535,2023-04-11,604,tennis racket,1200,1800,600,2,00247,India
820404,2023-04-11,610,golf clubs,27000,42000,15000,2,00248,India
820404,2023-04-11,608,football,298,1099,801,2,00248,India
726275,2023-04-11,606,badminton rackets,180,499,319,2,00249,India
726275,2023-04-11,605,badminton shuttlecocks,180,300,120,2,00249,India
726275,2023-04-11,607,table tennis table,20000,26500,6500,2,00249,India
726275,2023-04-11,609,basketball,298,679,381,2,00249,India
517748,2023-04-11,602,cricket ball,125,260,135,3,00250,India
517748,2023-04-11,601,cricket bat,400,1500,1100,2,00250,India
517748,2023-04-11,604,tennis racket,1200,1800,600,2,00250,India
423119,2023-04-11,611,helmet,200,400,200,2,00251,India
423119,2023-04-11,604,tennis racket,1200,1800,600,2,00251,India
862668,2023-04-11,603,tennis ball,25,60,35,3,00252,India
540147,2023-04-11,605,badminton shuttlecocks,180,300,120,2,00253,India
540147,2023-04-11,609,basketball,298,679,381,2,00253,India
540147,2023-04-11,602,cricket ball,125,260,135,3,00253,India
249667,2023-04-12,604,tennis racket,1200,1800,600,2,00254,India
249667,2023-04-12,609,basketball,298,679,381,2,00254,India
249667,2023-04-12,606,badminton rackets,180,499,319,2,00254,India
249667,2023-04-12,603,tennis ball,25,60,35,3,00254,India
218282,2023-04-12,601,cricket bat,400,1500,1100,2,00255,India
218282,2023-04-12,606,badminton rackets,180,499,319,2,00255,India
218282,2023-04-12,604,tennis racket,1200,1800,600,2,00255,India
799021,2023-04-12,610,golf clubs,27000,42000,15000,2,00256,India
799021,2023-04-12,611,helmet,200,400,200,2,00256,India
799021,2023-04-12,607,table tennis table,20000,26500,6500,2,00256,India
488156,2023-04-12,604,tennis racket,1200,1800,600,2,00257,India
488156,2023-04-12,606,badminton rackets,180,499,319,2,00257,India
488156,2023-04-12,611,helmet,200,400,200,2,00257,India
488156,2023-04-12,607,table tennis table,20000,26500,6500,2,00257,India
451251,2023-04-13,609,basketball,298,679,381,2,00258,India
451251,2023-04-13,606,badminton rackets,180,499,319,2,00258,India
426279,2023-04-13,603,tennis ball,25,60,35,3,00259,India
873149,2023-04-13,608,football,298,1099,801,2,00260,India
873149,2023-04-13,604,tennis racket,1200,1800,600,2,00260,India
873149,2023-04-13,606,badminton rackets,180,499,319,2,00260,India
616506,2023-04-13,611,helmet,200,400,200,2,00261,India
616506,2023-04-13,607,table tennis table,20000,26500,6500,2,00261,India
933327,2023-04-13,602,cricket ball,125,260,135,3,00262,India
692356,2023-04-13,608,football,298,1099,801,2,00263,India
711934,2023-04-13,607,table tennis table,20000,26500,6500,2,00264,India
711934,2023-04-13,602,cricket ball,125,260,135,3,00264,India
626824,2023-04-13,605,badminton shuttlecocks,180,300,120,2,00265,India
370585,2023-04-13,608,football,298,1099,801,2,00266,India
274949,2023-04-13,606,badminton rackets,180,499,319,2,00267,India
274949,2023-04-13,601,cricket bat,400,1500,1100,2,00267,India
808056,2023-04-14,608,football,298,1099,801,2,00268,India
808056,2023-04-14,602,cricket ball,125,260,135,3,00268,India
808056,2023-04-14,611,helmet,200,400,200,2,00268,India
724236,2023-04-14,604,tennis racket,1200,1800,600,2,00269,India
724236,2023-04-14,609,basketball,298,679,381,2,00269,India
940618,2023-04-14,607,table tennis table,20000,26500,6500,2,00270,India
940618,2023-04-14,605,badminton shuttlecocks,180,300,120,2,00270,India
615487,2023-04-14,607,table tennis table,20000,26500,6500,2,00271,India
615487,2023-04-14,601,cricket bat,400,1500,1100,2,00271,India
615487,2023-04-14,603,tennis ball,25,60,35,3,00271,India
530636,2023-04-14,610,golf clubs,27000,42000,15000,2,00272,India
530636,2023-04-14,604,tennis racket,1200,1800,600,2,00272,India
242369,2023-04-15,603,tennis ball,25,60,35,3,00273,India
242369,2023-04-15,604,tennis racket,1200,1800,600,2,00273,India
242369,2023-04-15,608,football,298,1099,801,2,00273,India
518777,2023-04-15,603,tennis ball,25,60,35,3,00274,India
518777,2023-04-15,611,helmet,200,400,200,2,00274,India
518777,2023-04-15,605,badminton shuttlecocks,180,300,120,2,00274,India
518777,2023-04-15,606,badminton rackets,180,499,319,2,00274,India
186839,2023-04-15,605,badminton shuttlecocks,180,300,120,2,00275,India
186839,2023-04-15,609,basketball,298,679,381,2,00275,India
186839,2023-04-15,610,golf clubs,27000,42000,15000,2,00275,India
186839,2023-04-15,603,tennis ball,25,60,35,3,00275,India
186839,2023-04-15,604,tennis racket,1200,1800,600,2,00275,India
359205,2023-04-16,609,basketball,298,679,381,2,00276,India
229748,2023-04-16,603,tennis ball,25,60,35,3,00277,India
538780,2023-04-16,601,cricket bat,400,1500,1100,2,00278,India
538780,2023-04-16,610,golf clubs,27000,42000,15000,2,00278,India
538780,2023-04-16,607,table tennis table,20000,26500,6500,2,00278,India
339194,2023-04-16,611,helmet,200,400,200,2,00279,India
339194,2023-04-16,608,football,298,1099,801,2,00279,India
339194,2023-04-16,604,tennis racket,1200,1800,600,2,00279,India
339194,2023-04-16,605,badminton shuttlecocks,180,300,120,2,00279,India
339194,2023-04-16,606,badminton rackets,180,499,319,2,00279,India
430416,2023-04-16,608,football,298,1099,801,2,00280,India
430416,2023-04-16,609,basketball,298,679,381,2,00280,India
430416,2023-04-16,605,badminton shuttlecocks,180,300,120,2,00280,India
430416,2023-04-16,607,table tennis table,20000,26500,6500,2,00280,India
430416,2023-04-16,604,tennis racket,1200,1800,600,2,00280,India
325099,2023-04-16,608,football,298,1099,801,2,00281,India
526831,2023-04-16,608,football,298,1099,801,2,00282,India
526831,2023-04-16,610,golf clubs,27000,42000,15000,2,00282,India
526831,2023-04-16,603,tennis ball,25,60,35,3,00282,India
526831,2023-04-16,604,tennis racket,1200,1800,600,2,00282,India
238999,2023-04-16,611,helmet,200,400,200,2,00283,India
238999,2023-04-16,601,cricket bat,400,1500,1100,2,00283,India
835679,2023-04-16,608,football,298,1099,801,2,00284,India
835679,2023-04-16,601,cricket bat,400,1500,1100,2,00284,India
112535,2023-04-16,603,tennis ball,25,60,35,3,00285,India
112535,2023-04-16,602,cricket ball,125,260,135,3,00285,India
112535,2023-04-16,608,football,298,1099,801,2,00285,India
112535,2023-04-16,607,table tennis table,20000,26500,6500,2,00285,India
112535,2023-04-16,604,tennis racket,1200,1800,600,2,00285,India
780389,2023-04-17,601,cricket bat,400,1500,1100,2,00286,India
780389,2023-04-17,610,golf clubs,27000,42000,15000,2,00286,India
780389,2023-04-17,606,badminton rackets,180,499,319,2,00286,India
997969,2023-04-17,607,table tennis table,20000,26500,6500,2,00287,India
997969,2023-04-17,602,cricket ball,125,260,135,3,00287,India
890031,2023-04-17,603,tennis ball,25,60,35,3,00288,India
890031,2023-04-17,604,tennis racket,1200,1800,600,2,00288,India
890031,2023-04-17,610,golf clubs,27000,42000,15000,2,00288,India
321996,2023-04-17,608,football,298,1099,801,2,00289,India
321996,2023-04-17,605,badminton shuttlecocks,180,300,120,2,00289,India
321996,2023-04-17,611,helmet,200,400,200,2,00289,India
321996,2023-04-17,603,tennis ball,25,60,35,3,00289,India
321996,2023-04-17,601,cricket bat,400,1500,1100,2,00289,India
708442,2023-04-18,601,cricket bat,400,1500,1100,2,00290,India
708442,2023-04-18,609,basketball,298,679,381,2,00290,India
364684,2023-04-18,605,badminton shuttlecocks,180,300,120,2,00291,India
364684,2023-04-18,611,helmet,200,400,200,2,00291,India
639381,2023-04-18,611,helmet,200,400,200,2,00292,India
639381,2023-04-18,604,tennis racket,1200,1800,600,2,00292,India
906971,2023-04-20,608,football,298,1099,801,2,00293,India
906971,2023-04-20,611,helmet,200,400,200,2,00293,India
906971,2023-04-20,604,tennis racket,1200,1800,600,2,00293,India
906971,2023-04-20,601,cricket bat,400,1500,1100,2,00293,India
368401,2023-04-20,609,basketball,298,679,381,2,00294,India
368401,2023-04-20,604,tennis racket,1200,1800,600,2,00294,India
368401,2023-04-20,605,badminton shuttlecocks,180,300,120,2,00294,India
452416,2023-04-20,604,tennis racket,1200,1800,600,2,00295,India
452416,2023-04-20,608,football,298,1099,801,2,00295,India
973381,2023-04-20,611,helmet,200,400,200,2,00296,India
973381,2023-04-20,605,badminton shuttlecocks,180,300,120,2,00296,India
627139,2023-04-20,601,cricket bat,400,1500,1100,2,00297,India
627139,2023-04-20,602,cricket ball,125,260,135,3,00297,India
627139,2023-04-20,604,tennis racket,1200,1800,600,2,00297,India
358049,2023-04-20,608,football,298,1099,801,2,00298,India
358049,2023-04-20,606,badminton rackets,180,499,319,2,00298,India
358049,2023-04-20,607,table tennis table,20000,26500,6500,2,00298,India
583714,2023-04-20,610,golf clubs,27000,42000,15000,2,00299,India
583714,2023-04-20,602,cricket ball,125,260,135,3,00299,India
583714,2023-04-20,601,cricket bat,400,1500,1100,2,00299,India
583714,2023-04-20,603,tennis ball,25,60,35,3,00299,India
929685,2023-04-20,608,football,298,1099,801,2,00300,India
929685,2023-04-20,602,cricket ball,125,260,135,3,00300,India
929685,2023-04-20,609,basketball,298,679,381,2,00300,India
929685,2023-04-20,610,golf clubs,27000,42000,15000,2,00300,India
819127,2023-04-20,609,basketball,298,679,381,2,00301,India
819127,2023-04-20,610,golf clubs,27000,42000,15000,2,00301,India
819127,2023-04-20,606,badminton rackets,180,499,319,2,00301,India
143706,2023-04-21,605,badminton shuttlecocks,180,300,120,2,00302,India
143706,2023-04-21,611,helmet,200,400,200,2,00302,India
143706,2023-04-21,604,tennis racket,1200,1800,600,2,00302,India
143706,2023-04-21,602,cricket ball,125,260,135,3,00302,India
912655,2023-04-21,607,table tennis table,20000,26500,6500,2,00303,India
912655,2023-04-21,609,basketball,298,679,381,2,00303,India
912655,2023-04-21,606,badminton rackets,180,499,319,2,00303,India
912655,2023-04-21,603,tennis ball,25,60,35,3,00303,India
912655,2023-04-21,605,badminton shuttlecocks,180,300,120,2,00303,India
571817,2023-04-21,605,badminton shuttlecocks,180,300,120,2,00304,India
261264,2023-04-21,602,cricket ball,125,260,135,3,00305,India
315400,2023-04-21,608,football,298,1099,801,2,00306,India
315400,2023-04-21,606,badminton rackets,180,499,319,2,00306,India
778182,2023-04-22,611,helmet,200,400,200,2,00307,India
814417,2023-04-22,607,table tennis table,20000,26500,6500,2,00308,India
814417,2023-04-22,605,badminton shuttlecocks,180,300,120,2,00308,India
814417,2023-04-22,601,cricket bat,400,1500,1100,2,00308,India
815913,2023-04-22,606,badminton rackets,180,499,319,2,00309,India
522148,2023-04-22,601,cricket bat,400,1500,1100,2,00310,India
522148,2023-04-22,610,golf clubs,27000,42000,15000,2,00310,India
551920,2023-04-22,603,tennis ball,25,60,35,3,00311,India
551920,2023-04-22,605,badminton shuttlecocks,180,300,120,2,00311,India
551920,2023-04-22,611,helmet,200,400,200,2,00311,India
551920,2023-04-22,604,tennis racket,1200,1800,600,2,00311,India
836923,2023-04-22,609,basketball,298,679,381,2,00312,India
836923,2023-04-22,602,cricket ball,125,260,135,3,00312,India
836923,2023-04-22,601,cricket bat,400,1500,1100,2,00312,India
836923,2023-04-22,607,table tennis table,20000,26500,6500,2,00312,India
422294,2023-04-22,610,golf clubs,27000,42000,15000,2,00313,India
422294,2023-04-22,606,badminton rackets,180,499,319,2,00313,India
422294,2023-04-22,607,table tennis table,20000,26500,6500,2,00313,India
107748,2023-04-22,604,tennis racket,1200,1800,600,2,00314,India
107748,2023-04-22,601,cricket bat,400,1500,1100,2,00314,India
107748,2023-04-22,603,tennis ball,25,60,35,3,00314,India
107748,2023-04-22,611,helmet,200,400,200,2,00314,India
359320,2023-04-22,611,helmet,200,400,200,2,00315,India
359320,2023-04-22,606,badminton rackets,180,499,319,2,00315,India
359320,2023-04-22,605,badminton shuttlecocks,180,300,120,2,00315,India
742217,2023-04-22,605,badminton shuttlecocks,180,300,120,2,00316,India
742217,2023-04-22,608,football,298,1099,801,2,00316,India
742217,2023-04-22,601,cricket bat,400,1500,1100,2,00316,India
655010,2023-04-23,604,tennis racket,1200,1800,600,2,00317,India
655010,2023-04-23,609,basketball,298,679,381,2,00317,India
655010,2023-04-23,602,cricket ball,125,260,135,3,00317,India
544607,2023-04-23,610,golf clubs,27000,42000,15000,2,00318,India
487591,2023-04-23,611,helmet,200,400,200,2,00319,India
487591,2023-04-23,602,cricket ball,125,260,135,3,00319,India
487591,2023-04-23,608,football,298,1099,801,2,00319,India
487591,2023-04-23,601,cricket bat,400,1500,1100,2,00319,India
151971,2023-04-23,611,helmet,200,400,200,2,00320,India
151971,2023-04-23,604,tennis racket,1200,1800,600,2,00320,India
752861,2023-04-24,605,badminton shuttlecocks,180,300,120,2,00321,India
752861,2023-04-24,610,golf clubs,27000,42000,15000,2,00321,India
101061,2023-04-24,611,helmet,200,400,200,2,00322,India
101061,2023-04-24,608,football,298,1099,801,2,00322,India
101061,2023-04-24,609,basketball,298,679,381,2,00322,India
101061,2023-04-24,601,cricket bat,400,1500,1100,2,00322,India
511607,2023-04-24,605,badminton shuttlecocks,180,300,120,2,00323,India
511607,2023-04-24,603,tennis ball,25,60,35,3,00323,India
511607,2023-04-24,611,helmet,200,400,200,2,00323,India
511607,2023-04-24,609,basketball,298,679,381,2,00323,India
511607,2023-04-24,608,football,298,1099,801,2,00323,India
517888,2023-04-24,606,badminton rackets,180,499,319,2,00324,India
517888,2023-04-24,605,badminton shuttlecocks,180,300,120,2,00324,India
517888,2023-04-24,603,tennis ball,25,60,35,3,00324,India
867927,2023-04-24,608,football,298,1099,801,2,00325,India
277815,2023-04-24,601,cricket bat,400,1500,1100,2,00326,India
277815,2023-04-24,608,football,298,1099,801,2,00326,India
277815,2023-04-24,609,basketball,298,679,381,2,00326,India
277815,2023-04-24,605,badminton shuttlecocks,180,300,120,2,00326,India
277815,2023-04-24,606,badminton rackets,180,499,319,2,00326,India
302088,2023-04-24,608,football,298,1099,801,2,00327,India
967400,2023-04-25,607,table tennis table,20000,26500,6500,2,00328,India
967400,2023-04-25,609,basketball,298,679,381,2,00328,India
967400,2023-04-25,601,cricket bat,400,1500,1100,2,00328,India
331465,2023-04-25,607,table tennis table,20000,26500,6500,2,00329,India
331465,2023-04-25,606,badminton rackets,180,499,319,2,00329,India
331465,2023-04-25,608,football,298,1099,801,2,00329,India
511555,2023-04-25,606,badminton rackets,180,499,319,2,00330,India
499807,2023-04-25,602,cricket ball,125,260,135,3,00331,India
355016,2023-04-25,608,football,298,1099,801,2,00332,India
355016,2023-04-25,606,badminton rackets,180,499,319,2,00332,India
835739,2023-04-25,602,cricket ball,125,260,135,3,00333,India
835739,2023-04-25,605,badminton shuttlecocks,180,300,120,2,00333,India
129099,2023-04-25,601,cricket bat,400,1500,1100,2,00334,India
129099,2023-04-25,602,cricket ball,125,260,135,3,00334,India
129099,2023-04-25,607,table tennis table,20000,26500,6500,2,00334,India
618920,2023-04-25,605,badminton shuttlecocks,180,300,120,2,00335,India
618920,2023-04-25,601,cricket bat,400,1500,1100,2,00335,India
154209,2023-04-25,609,basketball,298,679,381,2,00336,India
154209,2023-04-25,601,cricket bat,400,1500,1100,2,00336,India
764907,2023-04-26,611,helmet,200,400,200,2,00337,India
764907,2023-04-26,603,tennis ball,25,60,35,3,00337,India
764907,2023-04-26,606,badminton rackets,180,499,319,2,00337,India
458561,2023-04-26,606,badminton rackets,180,499,319,2,00338,India
458561,2023-04-26,611,helmet,200,400,200,2,00338,India
458561,2023-04-26,602,cricket ball,125,260,135,3,00338,India
194849,2023-04-26,607,table tennis table,20000,26500,6500,2,00339,India
614921,2023-04-26,611,helmet,200,400,200,2,00340,India
614921,2023-04-26,610,golf clubs,27000,42000,15000,2,00340,India
614921,2023-04-26,601,cricket bat,400,1500,1100,2,00340,India
614921,2023-04-26,603,tennis ball,25,60,35,3,00340,India
493772,2023-04-26,608,football,298,1099,801,2,00341,India
493772,2023-04-26,601,cricket bat,400,1500,1100,2,00341,India
493772,2023-04-26,609,basketball,298,679,381,2,00341,India
493772,2023-04-26,602,cricket ball,125,260,135,3,00341,India
493772,2023-04-26,604,tennis racket,1200,1800,600,2,00341,India
199439,2023-04-26,609,basketball,298,679,381,2,00342,India
199439,2023-04-26,603,tennis ball,25,60,35,3,00342,India
199439,2023-04-26,601,cricket bat,400,1500,1100,2,00342,India
199439,2023-04-26,605,badminton shuttlecocks,180,300,120,2,00342,India
976319,2023-04-26,601,cricket bat,400,1500,1100,2,00343,India
976319,2023-04-26,607,table tennis table,20000,26500,6500,2,00343,India
704334,2023-04-27,603,tennis ball,25,60,35,3,00344,India
704334,2023-04-27,602,cricket ball,125,260,135,3,00344,India
704334,2023-04-27,610,golf clubs,27000,42000,15000,2,00344,India
704334,2023-04-27,607,table tennis table,20000,26500,6500,2,00344,India
704334,2023-04-27,609,basketball,298,679,381,2,00344,India
577478,2023-04-27,608,football,298,1099,801,2,00345,India
577478,2023-04-27,601,cricket bat,400,1500,1100,2,00345,India
893240,2023-04-27,609,basketball,298,679,381,2,00346,India
803286,2023-04-27,608,football,298,1099,801,2,00347,India
803286,2023-04-27,609,basketball,298,679,381,2,00347,India
231454,2023-04-29,602,cricket ball,125,260,135,3,00348,India
231454,2023-04-29,609,basketball,298,679,381,2,00348,India
231454,2023-04-29,603,tennis ball,25,60,35,3,00348,India
231454,2023-04-29,607,table tennis table,20000,26500,6500,2,00348,India
231454,2023-04-29,611,helmet,200,400,200,2,00348,India
568415,2023-04-29,603,tennis ball,25,60,35,3,00349,India
559857,2023-04-30,608,football,298,1099,801,2,00350,India
465409,2023-04-30,609,basketball,298,679,381,2,00351,India
333294,2023-05-01,609,basketball,298,679,381,2,00352,India
333294,2023-05-01,604,tennis racket,1200,1800,600,2,00352,India
333294,2023-05-01,603,tennis ball,25,60,35,3,00352,India
691832,2023-05-01,604,tennis racket,1200,1800,600,2,00353,India
691832,2023-05-01,609,basketball,298,679,381,2,00353,India
691832,2023-05-01,610,golf clubs,27000,42000,15000,2,00353,India
691832,2023-05-01,601,cricket bat,400,1500,1100,2,00353,India
184547,2023-05-01,611,helmet,200,400,200,2,00354,India
327418,2023-05-01,609,basketball,298,679,381,2,00355,India
982625,2023-05-01,605,badminton shuttlecocks,180,300,120,2,00356,India
982625,2023-05-01,601,cricket bat,400,1500,1100,2,00356,India
982625,2023-05-01,607,table tennis table,20000,26500,6500,2,00356,India
982625,2023-05-01,609,basketball,298,679,381,2,00356,India
982625,2023-05-01,610,golf clubs,27000,42000,15000,2,00356,India
922065,2023-05-01,605,badminton shuttlecocks,180,300,120,2,00357,India
922065,2023-05-01,607,table tennis table,20000,26500,6500,2,00357,India
475709,2023-05-01,604,tennis racket,1200,1800,600,2,00358,India
475709,2023-05-01,601,cricket bat,400,1500,1100,2,00358,India
475709,2023-05-01,611,helmet,200,400,200,2,00358,India
438492,2023-05-01,608,football,298,1099,801,2,00359,India
438492,2023-05-01,601,cricket bat,400,1500,1100,2,00359,India
438492,2023-05-01,604,tennis racket,1200,1800,600,2,00359,India
275565,2023-05-02,602,cricket ball,125,260,135,3,00360,India
802912,2023-05-02,609,basketball,298,679,381,2,00361,India
802912,2023-05-02,608,football,298,1099,801,2,00361,India
802912,2023-05-02,607,table tennis table,20000,26500,6500,2,00361,India
414321,2023-05-02,607,table tennis table,20000,26500,6500,2,00362,India
414321,2023-05-02,601,cricket bat,400,1500,1100,2,00362,India
414321,2023-05-02,609,basketball,298,679,381,2,00362,India
414321,2023-05-02,608,football,298,1099,801,2,00362,India
921563,2023-05-02,608,football,298,1099,801,2,00363,India
921563,2023-05-02,605,badminton shuttlecocks,180,300,120,2,00363,India
232482,2023-05-02,602,cricket ball,125,260,135,3,00364,India
232482,2023-05-02,607,table tennis table,20000,26500,6500,2,00364,India
232482,2023-05-02,610,golf clubs,27000,42000,15000,2,00364,India
655126,2023-05-03,605,badminton shuttlecocks,180,300,120,2,00365,India
973564,2023-05-03,603,tennis ball,25,60,35,3,00366,India
297481,2023-05-03,601,cricket bat,400,1500,1100,2,00367,India
131680,2023-05-03,605,badminton shuttlecocks,180,300,120,2,00368,India
131680,2023-05-03,604,tennis racket,1200,1800,600,2,00368,India
131680,2023-05-03,608,football,298,1099,801,2,00368,India
466088,2023-05-03,609,basketball,298,679,381,2,00369,India
466088,2023-05-03,605,badminton shuttlecocks,180,300,120,2,00369,India
466088,2023-05-03,610,golf clubs,27000,42000,15000,2,00369,India
466088,2023-05-03,611,helmet,200,400,200,2,00369,India
611207,2023-05-03,607,table tennis table,20000,26500,6500,2,00370,India
611207,2023-05-03,606,badminton rackets,180,499,319,2,00370,India
576746,2023-05-03,609,basketball,298,679,381,2,00371,India
183407,2023-05-04,606,badminton rackets,180,499,319,2,00372,India
183407,2023-05-04,601,cricket bat,400,1500,1100,2,00372,India
183407,2023-05-04,609,basketball,298,679,381,2,00372,India
735797,2023-05-04,603,tennis ball,25,60,35,3,00373,India
735797,2023-05-04,607,table tennis table,20000,26500,6500,2,00373,India
798170,2023-05-04,609,basketball,298,679,381,2,00374,India
820273,2023-05-04,609,basketball,298,679,381,2,00375,India
820273,2023-05-04,601,cricket bat,400,1500,1100,2,00375,India
906040,2023-05-04,609,basketball,298,679,381,2,00376,India
977913,2023-05-04,608,football,298,1099,801,2,00377,India
977913,2023-05-04,606,badminton rackets,180,499,319,2,00377,India
977913,2023-05-04,611,helmet,200,400,200,2,00377,India
638693,2023-05-05,605,badminton shuttlecocks,180,300,120,2,00378,India
970226,2023-05-05,605,badminton shuttlecocks,180,300,120,2,00379,India
970226,2023-05-05,609,basketball,298,679,381,2,00379,India
828794,2023-05-05,607,table tennis table,20000,26500,6500,2,00380,India
144683,2023-05-05,607,table tennis table,20000,26500,6500,2,00381,India
144683,2023-05-05,605,badminton shuttlecocks,180,300,120,2,00381,India
144683,2023-05-05,604,tennis racket,1200,1800,600,2,00381,India
144683,2023-05-05,610,golf clubs,27000,42000,15000,2,00381,India
586560,2023-05-05,607,table tennis table,20000,26500,6500,2,00382,India
586560,2023-05-05,611,helmet,200,400,200,2,00382,India
647267,2023-05-05,604,tennis racket,1200,1800,600,2,00383,India
647267,2023-05-05,603,tennis ball,25,60,35,3,00383,India
647267,2023-05-05,606,badminton rackets,180,499,319,2,00383,India
964903,2023-05-05,611,helmet,200,400,200,2,00384,India
964903,2023-05-05,609,basketball,298,679,381,2,00384,India
964903,2023-05-05,604,tennis racket,1200,1800,600,2,00384,India
964903,2023-05-05,610,golf clubs,27000,42000,15000,2,00384,India
875553,2023-05-05,604,tennis racket,1200,1800,600,2,00385,India
875553,2023-05-05,602,cricket ball,125,260,135,3,00385,India
875553,2023-05-05,608,football,298,1099,801,2,00385,India
875553,2023-05-05,605,badminton shuttlecocks,180,300,120,2,00385,India
875553,2023-05-05,607,table tennis table,20000,26500,6500,2,00385,India
389136,2023-05-05,608,football,298,1099,801,2,00386,India
389136,2023-05-05,601,cricket bat,400,1500,1100,2,00386,India
326591,2023-05-06,607,table tennis table,20000,26500,6500,2,00387,India
326591,2023-05-06,605,badminton shuttlecocks,180,300,120,2,00387,India
726516,2023-05-06,607,table tennis table,20000,26500,6500,2,00388,India
726516,2023-05-06,608,football,298,1099,801,2,00388,India
726516,2023-05-06,603,tennis ball,25,60,35,3,00388,India
726516,2023-05-06,602,cricket ball,125,260,135,3,00388,India
606817,2023-05-06,610,golf clubs,27000,42000,15000,2,00389,India
411475,2023-05-06,608,football,298,1099,801,2,00390,India
411475,2023-05-06,611,helmet,200,400,200,2,00390,India
411475,2023-05-06,602,cricket ball,125,260,135,3,00390,India
616453,2023-05-06,611,helmet,200,400,200,2,00391,India
199758,2023-05-06,606,badminton rackets,180,499,319,2,00392,India
199758,2023-05-06,601,cricket bat,400,1500,1100,2,00392,India
199758,2023-05-06,611,helmet,200,400,200,2,00392,India
199758,2023-05-06,604,tennis racket,1200,1800,600,2,00392,India
254000,2023-05-06,601,cricket bat,400,1500,1100,2,00393,India
254000,2023-05-06,608,football,298,1099,801,2,00393,India
254000,2023-05-06,610,golf clubs,27000,42000,15000,2,00393,India
254000,2023-05-06,606,badminton rackets,180,499,319,2,00393,India
887172,2023-05-06,606,badminton rackets,180,499,319,2,00394,India
887172,2023-05-06,607,table tennis table,20000,26500,6500,2,00394,India
624284,2023-05-08,611,helmet,200,400,200,2,00395,India
624284,2023-05-08,605,badminton shuttlecocks,180,300,120,2,00395,India
426368,2023-05-08,605,badminton shuttlecocks,180,300,120,2,00396,India
235909,2023-05-08,601,cricket bat,400,1500,1100,2,00397,India
166456,2023-05-08,605,badminton shuttlecocks,180,300,120,2,00398,India
166456,2023-05-08,606,badminton rackets,180,499,319,2,00398,India
166456,2023-05-08,611,helmet,200,400,200,2,00398,India
899163,2023-05-10,605,badminton shuttlecocks,180,300,120,2,00399,India
899163,2023-05-10,604,tennis racket,1200,1800,600,2,00399,India
899163,2023-05-10,608,football,298,1099,801,2,00399,India
899163,2023-05-10,607,table tennis table,20000,26500,6500,2,00399,India
581772,2023-05-11,604,tennis racket,1200,1800,600,2,00400,India
581772,2023-05-11,611,helmet,200,400,200,2,00400,India
581772,2023-05-11,609,basketball,298,679,381,2,00400,India
447805,2023-05-11,601,cricket bat,400,1500,1100,2,00401,India
447805,2023-05-11,609,basketball,298,679,381,2,00401,India
447805,2023-05-11,603,tennis ball,25,60,35,3,00401,India
338181,2023-05-11,606,badminton rackets,180,499,319,2,00402,India
338181,2023-05-11,611,helmet,200,400,200,2,00402,India
338181,2023-05-11,610,golf clubs,27000,42000,15000,2,00402,India
338181,2023-05-11,607,table tennis table,20000,26500,6500,2,00402,India
257603,2023-05-11,606,badminton rackets,180,499,319,2,00403,India
257603,2023-05-11,601,cricket bat,400,1500,1100,2,00403,India
257603,2023-05-11,603,tennis ball,25,60,35,3,00403,India
476082,2023-05-11,604,tennis racket,1200,1800,600,2,00404,India
476082,2023-05-11,605,badminton shuttlecocks,180,300,120,2,00404,India
951837,2023-05-11,601,cricket bat,400,1500,1100,2,00405,India
951837,2023-05-11,610,golf clubs,27000,42000,15000,2,00405,India
762499,2023-05-11,610,golf clubs,27000,42000,15000,2,00406,India
762499,2023-05-11,611,helmet,200,400,200,2,00406,India
762499,2023-05-11,608,football,298,1099,801,2,00406,India
117612,2023-05-11,603,tennis ball,25,60,35,3,00407,India
117612,2023-05-11,602,cricket ball,125,260,135,3,00407,India
117612,2023-05-11,610,golf clubs,27000,42000,15000,2,00407,India
748148,2023-05-11,604,tennis racket,1200,1800,600,2,00408,India
748148,2023-05-11,603,tennis ball,25,60,35,3,00408,India
748148,2023-05-11,601,cricket bat,400,1500,1100,2,00408,India
283179,2023-05-11,606,badminton rackets,180,499,319,2,00409,India
298842,2023-05-12,607,table tennis table,20000,26500,6500,2,00410,India
298842,2023-05-12,604,tennis racket,1200,1800,600,2,00410,India
298842,2023-05-12,605,badminton shuttlecocks,180,300,120,2,00410,India
298842,2023-05-12,601,cricket bat,400,1500,1100,2,00410,India
298842,2023-05-12,602,cricket ball,125,260,135,3,00410,India
377753,2023-05-12,608,football,298,1099,801,2,00411,India
377753,2023-05-12,602,cricket ball,125,260,135,3,00411,India
713750,2023-05-12,602,cricket ball,125,260,135,3,00412,India
713750,2023-05-12,605,badminton shuttlecocks,180,300,120,2,00412,India
713750,2023-05-12,604,tennis racket,1200,1800,600,2,00412,India
713750,2023-05-12,607,table tennis table,20000,26500,6500,2,00412,India
542802,2023-05-13,608,football,298,1099,801,2,00413,India
542802,2023-05-13,604,tennis racket,1200,1800,600,2,00413,India
542802,2023-05-13,602,cricket ball,125,260,135,3,00413,India
254313,2023-05-13,604,tennis racket,1200,1800,600,2,00414,India
254313,2023-05-13,606,badminton rackets,180,499,319,2,00414,India
727942,2023-05-13,601,cricket bat,400,1500,1100,2,00415,India
785016,2023-05-13,608,football,298,1099,801,2,00416,India
166610,2023-05-14,602,cricket ball,125,260,135,3,00417,India
166610,2023-05-14,604,tennis racket,1200,1800,600,2,00417,India
711220,2023-05-14,604,tennis racket,1200,1800,600,2,00418,India
848181,2023-05-14,609,basketball,298,679,381,2,00419,India
848181,2023-05-14,608,football,298,1099,801,2,00419,India
848181,2023-05-14,607,table tennis table,20000,26500,6500,2,00419,India
300859,2023-05-14,610,golf clubs,27000,42000,15000,2,00420,India
300859,2023-05-14,607,table tennis table,20000,26500,6500,2,00420,India
294542,2023-05-14,601,cricket bat,400,1500,1100,2,00421,India
294542,2023-05-14,607,table tennis table,20000,26500,6500,2,00421,India
294542,2023-05-14,605,badminton shuttlecocks,180,300,120,2,00421,India
555301,2023-05-14,606,badminton rackets,180,499,319,2,00422,India
346098,2023-05-14,608,football,298,1099,801,2,00423,India
430619,2023-05-14,607,table tennis table,20000,26500,6500,2,00424,India
430619,2023-05-14,611,helmet,200,400,200,2,00424,India
430619,2023-05-14,604,tennis racket,1200,1800,600,2,00424,India
430619,2023-05-14,609,basketball,298,679,381,2,00424,India
430619,2023-05-14,606,badminton rackets,180,499,319,2,00424,India
334136,2023-05-14,603,tennis ball,25,60,35,3,00425,India
334136,2023-05-14,609,basketball,298,679,381,2,00425,India
581703,2023-05-15,604,tennis racket,1200,1800,600,2,00426,India
581703,2023-05-15,607,table tennis table,20000,26500,6500,2,00426,India
581703,2023-05-15,605,badminton shuttlecocks,180,300,120,2,00426,India
792179,2023-05-15,607,table tennis table,20000,26500,6500,2,00427,India
792179,2023-05-15,604,tennis racket,1200,1800,600,2,00427,India
762748,2023-05-15,607,table tennis table,20000,26500,6500,2,00428,India
762748,2023-05-15,604,tennis racket,1200,1800,600,2,00428,India
762748,2023-05-15,601,cricket bat,400,1500,1100,2,00428,India
762748,2023-05-15,602,cricket ball,125,260,135,3,00428,India
672349,2023-05-15,601,cricket bat,400,1500,1100,2,00429,India
672349,2023-05-15,603,tennis ball,25,60,35,3,00429,India
672349,2023-05-15,602,cricket ball,125,260,135,3,00429,India
637334,2023-05-15,601,cricket bat,400,1500,1100,2,00430,India
870666,2023-05-15,603,tennis ball,25,60,35,3,00431,India
870666,2023-05-15,608,football,298,1099,801,2,00431,India
827945,2023-05-17,608,football,298,1099,801,2,00432,India
827945,2023-05-17,605,badminton shuttlecocks,180,300,120,2,00432,India
819414,2023-05-17,610,golf clubs,27000,42000,15000,2,00433,India
952195,2023-05-17,605,badminton shuttlecocks,180,300,120,2,00434,India
523575,2023-05-17,601,cricket bat,400,1500,1100,2,00435,India
523575,2023-05-17,603,tennis ball,25,60,35,3,00435,India
523575,2023-05-17,605,badminton shuttlecocks,180,300,120,2,00435,India
206406,2023-05-17,602,cricket ball,125,260,135,3,00436,India
206406,2023-05-17,601,cricket bat,400,1500,1100,2,00436,India
206406,2023-05-17,603,tennis ball,25,60,35,3,00436,India
206406,2023-05-17,606,badminton rackets,180,499,319,2,00436,India
414321,2023-05-17,610,golf clubs,27000,42000,15000,2,00362,India
414321,2023-05-17,607,table tennis table,20000,26500,6500,2,00362,India
133155,2023-05-17,609,basketball,298,679,381,2,00437,India
133155,2023-05-17,608,football,298,1099,801,2,00437,India
133155,2023-05-17,605,badminton shuttlecocks,180,300,120,2,00437,India
369841,2023-05-17,611,helmet,200,400,200,2,00438,India
369841,2023-05-17,606,badminton rackets,180,499,319,2,00438,India
369841,2023-05-17,603,tennis ball,25,60,35,3,00438,India
369841,2023-05-17,605,badminton shuttlecocks,180,300,120,2,00438,India
578958,2023-05-18,608,football,298,1099,801,2,00439,India
578958,2023-05-18,602,cricket ball,125,260,135,3,00439,India
578958,2023-05-18,604,tennis racket,1200,1800,600,2,00439,India
397873,2023-05-18,607,table tennis table,20000,26500,6500,2,00440,India
329496,2023-05-18,601,cricket bat,400,1500,1100,2,00441,India
329496,2023-05-18,606,badminton rackets,180,499,319,2,00441,India
329496,2023-05-18,609,basketball,298,679,381,2,00441,India
329496,2023-05-18,608,football,298,1099,801,2,00441,India
329496,2023-05-18,610,golf clubs,27000,42000,15000,2,00441,India
830455,2023-05-18,602,cricket ball,125,260,135,3,00442,India
830455,2023-05-18,601,cricket bat,400,1500,1100,2,00442,India
891952,2023-05-18,605,badminton shuttlecocks,180,300,120,2,00443,India
617581,2023-05-18,611,helmet,200,400,200,2,00444,India
617581,2023-05-18,607,table tennis table,20000,26500,6500,2,00444,India
617581,2023-05-18,602,cricket ball,125,260,135,3,00444,India
617581,2023-05-18,609,basketball,298,679,381,2,00444,India
681354,2023-05-18,607,table tennis table,20000,26500,6500,2,00445,India
681354,2023-05-18,604,tennis racket,1200,1800,600,2,00445,India
857196,2023-05-18,601,cricket bat,400,1500,1100,2,00446,India
857196,2023-05-18,609,basketball,298,679,381,2,00446,India
223365,2023-05-18,606,badminton rackets,180,499,319,2,00447,India
223365,2023-05-18,608,football,298,1099,801,2,00447,India
477031,2023-05-18,611,helmet,200,400,200,2,00448,India
477031,2023-05-18,602,cricket ball,125,260,135,3,00448,India
873359,2023-05-19,610,golf clubs,27000,42000,15000,2,00449,India
873359,2023-05-19,601,cricket bat,400,1500,1100,2,00449,India
873359,2023-05-19,602,cricket ball,125,260,135,3,00449,India
524929,2023-05-19,604,tennis racket,1200,1800,600,2,00450,India
524929,2023-05-19,602,cricket ball,125,260,135,3,00450,India
705736,2023-05-19,608,football,298,1099,801,2,00451,India
705736,2023-05-19,606,badminton rackets,180,499,319,2,00451,India
705736,2023-05-19,611,helmet,200,400,200,2,00451,India
867887,2023-05-19,606,badminton rackets,180,499,319,2,00452,India
867887,2023-05-19,602,cricket ball,125,260,135,3,00452,India
453340,2023-05-19,608,football,298,1099,801,2,00453,India
453340,2023-05-19,609,basketball,298,679,381,2,00453,India
453340,2023-05-19,605,badminton shuttlecocks,180,300,120,2,00453,India
501299,2023-05-19,609,basketball,298,679,381,2,00454,India
501299,2023-05-19,607,table tennis table,20000,26500,6500,2,00454,India
201789,2023-05-19,611,helmet,200,400,200,2,00455,India
201789,2023-05-19,609,basketball,298,679,381,2,00455,India
242555,2023-05-19,608,football,298,1099,801,2,00456,India
242555,2023-05-19,610,golf clubs,27000,42000,15000,2,00456,India
242555,2023-05-19,604,tennis racket,1200,1800,600,2,00456,India
769728,2023-05-19,611,helmet,200,400,200,2,00457,India
667963,2023-05-19,603,tennis ball,25,60,35,3,00458,India
343970,2023-05-20,602,cricket ball,125,260,135,3,00459,India
343970,2023-05-20,606,badminton rackets,180,499,319,2,00459,India
343970,2023-05-20,608,football,298,1099,801,2,00459,India
340324,2023-05-20,601,cricket bat,400,1500,1100,2,00460,India
340324,2023-05-20,605,badminton shuttlecocks,180,300,120,2,00460,India
340324,2023-05-20,606,badminton rackets,180,499,319,2,00460,India
340324,2023-05-20,609,basketball,298,679,381,2,00460,India
254374,2023-05-20,604,tennis racket,1200,1800,600,2,00461,India
254374,2023-05-20,606,badminton rackets,180,499,319,2,00461,India
702273,2023-05-20,603,tennis ball,25,60,35,3,00462,India
702273,2023-05-20,606,badminton rackets,180,499,319,2,00462,India
847621,2023-05-20,602,cricket ball,125,260,135,3,00463,India
398663,2023-05-20,602,cricket ball,125,260,135,3,00464,India
398663,2023-05-20,611,helmet,200,400,200,2,00464,India
398663,2023-05-20,608,football,298,1099,801,2,00464,India
398663,2023-05-20,606,badminton rackets,180,499,319,2,00464,India
709890,2023-05-20,601,cricket bat,400,1500,1100,2,00465,India
342131,2023-05-20,602,cricket ball,125,260,135,3,00466,India
342131,2023-05-20,607,table tennis table,20000,26500,6500,2,00466,India
342131,2023-05-20,608,football,298,1099,801,2,00466,India
342131,2023-05-20,604,tennis racket,1200,1800,600,2,00466,India
577540,2023-05-22,611,helmet,200,400,200,2,00467,India
577540,2023-05-22,601,cricket bat,400,1500,1100,2,00467,India
577540,2023-05-22,605,badminton shuttlecocks,180,300,120,2,00467,India
207734,2023-05-22,602,cricket ball,125,260,135,3,00468,India
207734,2023-05-22,606,badminton rackets,180,499,319,2,00468,India
822676,2023-05-22,609,basketball,298,679,381,2,00469,India
513920,2023-05-22,606,badminton rackets,180,499,319,2,00470,India
513920,2023-05-22,610,golf clubs,27000,42000,15000,2,00470,India
513920,2023-05-22,611,helmet,200,400,200,2,00470,India
663825,2023-05-23,611,helmet,200,400,200,2,00471,India
663825,2023-05-23,610,golf clubs,27000,42000,15000,2,00471,India
670018,2023-05-24,601,cricket bat,400,1500,1100,2,00472,India
670018,2023-05-24,611,helmet,200,400,200,2,00472,India
670018,2023-05-24,607,table tennis table,20000,26500,6500,2,00472,India
191406,2023-05-24,606,badminton rackets,180,499,319,2,00473,India
191406,2023-05-24,602,cricket ball,125,260,135,3,00473,India
191406,2023-05-24,605,badminton shuttlecocks,180,300,120,2,00473,India
191406,2023-05-24,601,cricket bat,400,1500,1100,2,00473,India
986725,2023-05-24,609,basketball,298,679,381,2,00474,India
986725,2023-05-24,604,tennis racket,1200,1800,600,2,00474,India
986725,2023-05-24,610,golf clubs,27000,42000,15000,2,00474,India
986725,2023-05-24,602,cricket ball,125,260,135,3,00474,India
863619,2023-05-24,610,golf clubs,27000,42000,15000,2,00475,India
673314,2023-05-24,601,cricket bat,400,1500,1100,2,00476,India
673314,2023-05-24,611,helmet,200,400,200,2,00476,India
219334,2023-05-24,609,basketball,298,679,381,2,00477,India
219334,2023-05-24,602,cricket ball,125,260,135,3,00477,India
708912,2023-05-25,605,badminton shuttlecocks,180,300,120,2,00478,India
708912,2023-05-25,604,tennis racket,1200,1800,600,2,00478,India
708912,2023-05-25,603,tennis ball,25,60,35,3,00478,India
708912,2023-05-25,610,golf clubs,27000,42000,15000,2,00478,India
697858,2023-05-25,611,helmet,200,400,200,2,00479,India
697858,2023-05-25,606,badminton rackets,180,499,319,2,00479,India
697858,2023-05-25,607,table tennis table,20000,26500,6500,2,00479,India
751830,2023-05-25,609,basketball,298,679,381,2,00480,India
751830,2023-05-25,608,football,298,1099,801,2,00480,India
751830,2023-05-25,602,cricket ball,125,260,135,3,00480,India
412830,2023-05-25,604,tennis racket,1200,1800,600,2,00481,India
412830,2023-05-25,603,tennis ball,25,60,35,3,00481,India
412830,2023-05-25,601,cricket bat,400,1500,1100,2,00481,India
924919,2023-05-25,611,helmet,200,400,200,2,00482,India
924919,2023-05-25,610,golf clubs,27000,42000,15000,2,00482,India
344183,2023-05-26,610,golf clubs,27000,42000,15000,2,00483,India
344183,2023-05-26,607,table tennis table,20000,26500,6500,2,00483,India
344183,2023-05-26,606,badminton rackets,180,499,319,2,00483,India
344183,2023-05-26,609,basketball,298,679,381,2,00483,India
344183,2023-05-26,602,cricket ball,125,260,135,3,00483,India
130034,2023-05-26,603,tennis ball,25,60,35,3,00484,India
130034,2023-05-26,608,football,298,1099,801,2,00484,India
211141,2023-05-27,604,tennis racket,1200,1800,600,2,00485,India
211141,2023-05-27,605,badminton shuttlecocks,180,300,120,2,00485,India
291447,2023-05-27,604,tennis racket,1200,1800,600,2,00486,India
291447,2023-05-27,602,cricket ball,125,260,135,3,00486,India
291447,2023-05-27,611,helmet,200,400,200,2,00486,India
570466,2023-05-27,601,cricket bat,400,1500,1100,2,00487,India
570466,2023-05-27,607,table tennis table,20000,26500,6500,2,00487,India
570466,2023-05-27,606,badminton rackets,180,499,319,2,00487,India
106281,2023-05-28,611,helmet,200,400,200,2,00488,India
106281,2023-05-28,603,tennis ball,25,60,35,3,00488,India
106281,2023-05-28,609,basketball,298,679,381,2,00488,India
106281,2023-05-28,606,badminton rackets,180,499,319,2,00488,India
194263,2023-05-28,604,tennis racket,1200,1800,600,2,00489,India
194263,2023-05-28,606,badminton rackets,180,499,319,2,00489,India
286671,2023-05-28,601,cricket bat,400,1500,1100,2,00490,India
286671,2023-05-28,611,helmet,200,400,200,2,00490,India
286671,2023-05-28,609,basketball,298,679,381,2,00490,India
286671,2023-05-28,607,table tennis table,20000,26500,6500,2,00490,India
286671,2023-05-28,608,football,298,1099,801,2,00490,India
784745,2023-05-28,608,football,298,1099,801,2,00491,India
605297,2023-05-28,602,cricket ball,125,260,135,3,00492,India
605297,2023-05-28,604,tennis racket,1200,1800,600,2,00492,India
400679,2023-05-29,606,badminton rackets,180,499,319,2,00493,India
771523,2023-05-30,605,badminton shuttlecocks,180,300,120,2,00494,India
771523,2023-05-30,607,table tennis table,20000,26500,6500,2,00494,India
771523,2023-05-30,608,football,298,1099,801,2,00494,India
771523,2023-05-30,611,helmet,200,400,200,2,00494,India
233418,2023-06-01,601,cricket bat,400,1500,1100,1,00495,India
233418,2023-06-01,607,table tennis table,20000,26500,6500,1,00495,India
233418,2023-06-01,608,football,298,1099,801,1,00495,India
233418,2023-06-01,611,helmet,200,400,200,1,00495,India
233418,2023-06-01,610,golf clubs,27000,42000,15000,1,00495,India
651045,2023-06-01,601,cricket bat,400,1500,1100,1,00496,India
405549,2023-06-01,605,badminton shuttlecocks,180,300,120,1,00497,India
405549,2023-06-01,601,cricket bat,400,1500,1100,1,00497,India
405549,2023-06-01,603,tennis ball,25,60,35,1,00497,India
349122,2023-06-01,604,tennis racket,1200,1800,600,1,00498,India
871355,2023-06-02,605,badminton shuttlecocks,180,300,120,1,00499,India
212323,2023-06-02,606,badminton rackets,180,499,319,1,00500,India
212323,2023-06-02,609,basketball,298,679,381,1,00500,India
661970,2023-06-02,611,helmet,200,400,200,1,00173,India
118286,2023-06-02,602,cricket ball,125,260,135,1,00085,India
118286,2023-06-02,607,table tennis table,20000,26500,6500,1,00085,India
118286,2023-06-02,605,badminton shuttlecocks,180,300,120,1,00085,India
118286,2023-06-02,611,helmet,200,400,200,1,00085,India
337378,2023-06-02,604,tennis racket,1200,1800,600,1,00234,India
337378,2023-06-02,603,tennis ball,25,60,35,1,00234,India
337378,2023-06-02,605,badminton shuttlecocks,180,300,120,1,00234,India
337378,2023-06-02,601,cricket bat,400,1500,1100,1,00234,India
634718,2023-06-02,608,football,298,1099,801,1,00324,India
634718,2023-06-02,604,tennis racket,1200,1800,600,1,00324,India
634718,2023-06-02,609,basketball,298,679,381,1,00324,India
634718,2023-06-02,610,golf clubs,27000,42000,15000,1,00324,India
634718,2023-06-02,607,table tennis table,20000,26500,6500,1,00324,India
242604,2023-06-02,610,golf clubs,27000,42000,15000,1,00247,India
242604,2023-06-02,606,badminton rackets,180,499,319,1,00247,India
245564,2023-06-02,611,helmet,200,400,200,1,00275,India
504643,2023-06-02,611,helmet,200,400,200,1,00385,India
504643,2023-06-02,604,tennis racket,1200,1800,600,1,00385,India
504643,2023-06-02,607,table tennis table,20000,26500,6500,1,00385,India
504643,2023-06-02,610,golf clubs,27000,42000,15000,1,00385,India
853493,2023-06-03,604,tennis racket,1200,1800,600,1,00486,India
853493,2023-06-03,602,cricket ball,125,260,135,1,00486,India
853493,2023-06-03,605,badminton shuttlecocks,180,300,120,1,00486,India
853493,2023-06-03,601,cricket bat,400,1500,1100,1,00486,India
613288,2023-06-03,609,basketball,298,679,381,1,00075,India
613288,2023-06-03,606,badminton rackets,180,499,319,1,00075,India
613288,2023-06-03,608,football,298,1099,801,1,00075,India
542589,2023-06-03,607,table tennis table,20000,26500,6500,1,00487,India
542589,2023-06-03,601,cricket bat,400,1500,1100,1,00487,India
542589,2023-06-03,602,cricket ball,125,260,135,1,00487,India
542589,2023-06-03,604,tennis racket,1200,1800,600,1,00487,India
542589,2023-06-03,608,football,298,1099,801,1,00487,India
682588,2023-06-03,605,badminton shuttlecocks,180,300,120,1,00075,India
682588,2023-06-03,610,golf clubs,27000,42000,15000,1,00075,India
682588,2023-06-03,609,basketball,298,679,381,1,00075,India
682588,2023-06-03,601,cricket bat,400,1500,1100,1,00075,India
782413,2023-06-03,606,badminton rackets,180,499,319,1,00381,India
782413,2023-06-03,604,tennis racket,1200,1800,600,1,00381,India
782413,2023-06-03,601,cricket bat,400,1500,1100,1,00381,India
782413,2023-06-03,603,tennis ball,25,60,35,1,00381,India
782413,2023-06-03,607,table tennis table,20000,26500,6500,1,00381,India
679325,2023-06-03,608,football,298,1099,801,1,00294,India
679325,2023-06-03,607,table tennis table,20000,26500,6500,1,00294,India
679325,2023-06-03,606,badminton rackets,180,499,319,1,00294,India
679325,2023-06-03,609,basketball,298,679,381,1,00294,India
707724,2023-06-03,606,badminton rackets,180,499,319,1,00418,India
136559,2023-06-04,607,table tennis table,20000,26500,6500,1,00312,India
600709,2023-06-04,606,badminton rackets,180,499,319,1,00003,India
704996,2023-06-04,604,tennis racket,1200,1800,600,1,00364,India
704996,2023-06-04,601,cricket bat,400,1500,1100,1,00364,India
742903,2023-06-04,604,tennis racket,1200,1800,600,1,00061,India
608402,2023-06-04,611,helmet,200,400,200,1,00223,India
101420,2023-06-04,603,tennis ball,25,60,35,1,00010,India
322543,2023-06-04,601,cricket bat,400,1500,1100,1,00168,India
322543,2023-06-04,602,cricket ball,125,260,135,1,00168,India
322543,2023-06-04,610,golf clubs,27000,42000,15000,1,00168,India
322543,2023-06-04,609,basketball,298,679,381,1,00168,India
861159,2023-06-04,606,badminton rackets,180,499,319,1,00031,India
861159,2023-06-04,602,cricket ball,125,260,135,1,00031,India
373652,2023-06-04,607,table tennis table,20000,26500,6500,1,00252,India
373652,2023-06-04,601,cricket bat,400,1500,1100,1,00252,India
215603,2023-06-05,603,tennis ball,25,60,35,1,00257,India
215603,2023-06-05,608,football,298,1099,801,1,00257,India
215603,2023-06-05,606,badminton rackets,180,499,319,1,00257,India
441162,2023-06-05,601,cricket bat,400,1500,1100,1,00387,India
441162,2023-06-05,604,tennis racket,1200,1800,600,1,00387,India
880220,2023-06-05,602,cricket ball,125,260,135,1,00383,India
880220,2023-06-05,611,helmet,200,400,200,1,00383,India
880220,2023-06-05,608,football,298,1099,801,1,00383,India
880220,2023-06-05,610,golf clubs,27000,42000,15000,1,00383,India
623129,2023-06-05,609,basketball,298,679,381,1,00314,India
623129,2023-06-05,611,helmet,200,400,200,1,00314,India
391587,2023-06-05,609,basketball,298,679,381,1,00335,India
282808,2023-06-06,603,tennis ball,25,60,35,1,00471,India
282808,2023-06-06,606,badminton rackets,180,499,319,1,00471,India
282808,2023-06-06,602,cricket ball,125,260,135,1,00471,India
792400,2023-06-06,601,cricket bat,400,1500,1100,1,00335,India
870295,2023-06-06,601,cricket bat,400,1500,1100,1,00284,India
870295,2023-06-06,604,tennis racket,1200,1800,600,1,00284,India
870295,2023-06-06,605,badminton shuttlecocks,180,300,120,1,00284,India
870295,2023-06-06,607,table tennis table,20000,26500,6500,1,00284,India
711107,2023-06-06,608,football,298,1099,801,1,00253,India
842949,2023-06-06,605,badminton shuttlecocks,180,300,120,1,00443,India
842949,2023-06-06,610,golf clubs,27000,42000,15000,1,00443,India
842949,2023-06-06,608,football,298,1099,801,1,00443,India
842949,2023-06-06,602,cricket ball,125,260,135,1,00443,India
641869,2023-06-06,607,table tennis table,20000,26500,6500,1,00224,India
641869,2023-06-06,611,helmet,200,400,200,1,00224,India
331795,2023-06-06,606,badminton rackets,180,499,319,1,00115,India
331795,2023-06-06,604,tennis racket,1200,1800,600,1,00115,India
331795,2023-06-06,611,helmet,200,400,200,1,00115,India
331795,2023-06-06,607,table tennis table,20000,26500,6500,1,00115,India
165142,2023-06-06,610,golf clubs,27000,42000,15000,1,00213,India
165142,2023-06-06,611,helmet,200,400,200,1,00213,India
136585,2023-06-07,608,football,298,1099,801,1,00086,India
136585,2023-06-07,605,badminton shuttlecocks,180,300,120,1,00086,India
136585,2023-06-07,601,cricket bat,400,1500,1100,1,00086,India
136585,2023-06-07,602,cricket ball,125,260,135,1,00086,India
858957,2023-06-07,604,tennis racket,1200,1800,600,1,00081,India
858957,2023-06-07,609,basketball,298,679,381,1,00081,India
858957,2023-06-07,605,badminton shuttlecocks,180,300,120,1,00081,India
235392,2023-06-07,601,cricket bat,400,1500,1100,1,00154,India
235392,2023-06-07,609,basketball,298,679,381,1,00154,India
235392,2023-06-07,604,tennis racket,1200,1800,600,1,00154,India
989541,2023-06-07,603,tennis ball,25,60,35,1,00013,India
989541,2023-06-07,602,cricket ball,125,260,135,1,00013,India
989541,2023-06-07,610,golf clubs,27000,42000,15000,1,00013,India
989541,2023-06-07,609,basketball,298,679,381,1,00013,India
249366,2023-06-09,610,golf clubs,27000,42000,15000,1,00147,India
249366,2023-06-09,609,basketball,298,679,381,1,00147,India
810001,2023-06-09,607,table tennis table,20000,26500,6500,1,00476,India
810001,2023-06-09,609,basketball,298,679,381,1,00476,India
810001,2023-06-09,606,badminton rackets,180,499,319,1,00476,India
810001,2023-06-09,605,badminton shuttlecocks,180,300,120,1,00476,India
425041,2023-06-09,607,table tennis table,20000,26500,6500,1,00080,India
162132,2023-06-09,601,cricket bat,400,1500,1100,1,00022,India
399310,2023-06-09,603,tennis ball,25,60,35,1,00439,India
399310,2023-06-09,611,helmet,200,400,200,1,00439,India
399310,2023-06-09,605,badminton shuttlecocks,180,300,120,1,00439,India
399310,2023-06-09,602,cricket ball,125,260,135,1,00439,India
307905,2023-06-09,607,table tennis table,20000,26500,6500,1,00019,India
109051,2023-06-10,609,basketball,298,679,381,1,00485,India
109051,2023-06-10,606,badminton rackets,180,499,319,1,00485,India
109051,2023-06-10,608,football,298,1099,801,1,00485,India
676518,2023-06-11,607,table tennis table,20000,26500,6500,1,00225,India
676518,2023-06-11,608,football,298,1099,801,1,00225,India
676518,2023-06-11,604,tennis racket,1200,1800,600,1,00225,India
942582,2023-06-11,601,cricket bat,400,1500,1100,1,00470,India
942582,2023-06-11,608,football,298,1099,801,1,00470,India
942582,2023-06-11,603,tennis ball,25,60,35,1,00470,India
942582,2023-06-11,611,helmet,200,400,200,1,00470,India
826008,2023-06-11,610,golf clubs,27000,42000,15000,1,00414,India
442663,2023-06-11,604,tennis racket,1200,1800,600,1,00164,India
320344,2023-06-11,608,football,298,1099,801,1,00439,India
320344,2023-06-11,607,table tennis table,20000,26500,6500,1,00439,India
320344,2023-06-11,609,basketball,298,679,381,1,00439,India
240860,2023-06-11,602,cricket ball,125,260,135,1,00284,India
240860,2023-06-11,601,cricket bat,400,1500,1100,1,00284,India
947939,2023-06-12,609,basketball,298,679,381,1,00051,India
947939,2023-06-12,606,badminton rackets,180,499,319,1,00051,India
741195,2023-06-12,602,cricket ball,125,260,135,1,00490,India
741195,2023-06-12,610,golf clubs,27000,42000,15000,1,00490,India
741195,2023-06-12,608,football,298,1099,801,1,00490,India
340509,2023-06-12,603,tennis ball,25,60,35,1,00386,India
340509,2023-06-12,602,cricket ball,125,260,135,1,00386,India
340509,2023-06-12,609,basketball,298,679,381,1,00386,India
453853,2023-06-12,606,badminton rackets,180,499,319,1,00158,India
453853,2023-06-12,610,golf clubs,27000,42000,15000,1,00158,India
453853,2023-06-12,601,cricket bat,400,1500,1100,1,00158,India
453853,2023-06-12,605,badminton shuttlecocks,180,300,120,1,00158,India
189090,2023-06-12,609,basketball,298,679,381,1,00112,India
189090,2023-06-12,605,badminton shuttlecocks,180,300,120,1,00112,India
728603,2023-06-12,604,tennis racket,1200,1800,600,1,00057,India
728603,2023-06-12,605,badminton shuttlecocks,180,300,120,1,00057,India
728603,2023-06-12,601,cricket bat,400,1500,1100,1,00057,India
728603,2023-06-12,606,badminton rackets,180,499,319,1,00057,India
169375,2023-06-13,605,badminton shuttlecocks,180,300,120,1,00147,India
169375,2023-06-13,602,cricket ball,125,260,135,1,00147,India
356316,2023-06-13,603,tennis ball,25,60,35,1,00413,India
356316,2023-06-13,602,cricket ball,125,260,135,1,00413,India
356316,2023-06-13,605,badminton shuttlecocks,180,300,120,1,00413,India
382504,2023-06-13,607,table tennis table,20000,26500,6500,1,00452,India
382504,2023-06-13,608,football,298,1099,801,1,00452,India
313550,2023-06-14,602,cricket ball,125,260,135,1,00092,India
270886,2023-06-14,604,tennis racket,1200,1800,600,1,00384,India
270886,2023-06-14,602,cricket ball,125,260,135,1,00384,India
270886,2023-06-14,603,tennis ball,25,60,35,1,00384,India
270886,2023-06-14,605,badminton shuttlecocks,180,300,120,1,00384,India
336335,2023-06-14,611,helmet,200,400,200,1,00130,India
336335,2023-06-14,601,cricket bat,400,1500,1100,1,00130,India
336335,2023-06-14,605,badminton shuttlecocks,180,300,120,1,00130,India
549538,2023-06-14,611,helmet,200,400,200,1,00231,India
549538,2023-06-14,605,badminton shuttlecocks,180,300,120,1,00231,India
395696,2023-06-14,609,basketball,298,679,381,1,00384,India
613230,2023-06-14,602,cricket ball,125,260,135,1,00408,India
613230,2023-06-14,601,cricket bat,400,1500,1100,1,00408,India
613230,2023-06-14,608,football,298,1099,801,1,00408,India
505672,2023-06-14,606,badminton rackets,180,499,319,1,00215,India
505672,2023-06-14,611,helmet,200,400,200,1,00215,India
164328,2023-06-15,611,helmet,200,400,200,1,00361,India
164328,2023-06-15,604,tennis racket,1200,1800,600,1,00361,India
176630,2023-06-15,609,basketball,298,679,381,1,00305,India
176630,2023-06-15,603,tennis ball,25,60,35,1,00305,India
632833,2023-06-15,602,cricket ball,125,260,135,1,00256,India
632833,2023-06-15,603,tennis ball,25,60,35,1,00256,India
632833,2023-06-15,606,badminton rackets,180,499,319,1,00256,India
632833,2023-06-15,604,tennis racket,1200,1800,600,1,00256,India
742799,2023-06-15,601,cricket bat,400,1500,1100,1,00019,India
742799,2023-06-15,607,table tennis table,20000,26500,6500,1,00019,India
742799,2023-06-15,608,football,298,1099,801,1,00019,India
483254,2023-06-15,606,badminton rackets,180,499,319,1,00338,India
483254,2023-06-15,608,football,298,1099,801,1,00338,India
483254,2023-06-15,605,badminton shuttlecocks,180,300,120,1,00338,India
483254,2023-06-15,602,cricket ball,125,260,135,1,00338,India
316139,2023-06-17,607,table tennis table,20000,26500,6500,1,00016,India
316139,2023-06-17,602,cricket ball,125,260,135,1,00016,India
316139,2023-06-17,601,cricket bat,400,1500,1100,1,00016,India
316139,2023-06-17,605,badminton shuttlecocks,180,300,120,1,00016,India
691180,2023-06-17,603,tennis ball,25,60,35,1,00403,India
408955,2023-06-17,611,helmet,200,400,200,1,00411,India
912374,2023-06-17,604,tennis racket,1200,1800,600,1,00136,India
912374,2023-06-17,602,cricket ball,125,260,135,1,00136,India
912374,2023-06-17,603,tennis ball,25,60,35,1,00136,India
535569,2023-06-17,609,basketball,298,679,381,1,00233,India
535569,2023-06-17,608,football,298,1099,801,1,00233,India
535569,2023-06-17,611,helmet,200,400,200,1,00233,India
575959,2023-06-17,603,tennis ball,25,60,35,1,00400,India
575959,2023-06-17,606,badminton rackets,180,499,319,1,00400,India
575959,2023-06-17,610,golf clubs,27000,42000,15000,1,00400,India
367632,2023-06-17,611,helmet,200,400,200,1,00096,India
392937,2023-06-17,602,cricket ball,125,260,135,1,00164,India
392937,2023-06-17,607,table tennis table,20000,26500,6500,1,00164,India
339649,2023-06-17,605,badminton shuttlecocks,180,300,120,1,00272,India
339649,2023-06-17,610,golf clubs,27000,42000,15000,1,00272,India
339649,2023-06-17,601,cricket bat,400,1500,1100,1,00272,India
339649,2023-06-17,607,table tennis table,20000,26500,6500,1,00272,India
339649,2023-06-17,606,badminton rackets,180,499,319,1,00272,India
136529,2023-06-17,601,cricket bat,400,1500,1100,1,00236,India
136529,2023-06-17,603,tennis ball,25,60,35,1,00236,India
136529,2023-06-17,602,cricket ball,125,260,135,1,00236,India
926348,2023-06-19,604,tennis racket,1200,1800,600,1,00109,India
926348,2023-06-19,606,badminton rackets,180,499,319,1,00109,India
926348,2023-06-19,605,badminton shuttlecocks,180,300,120,1,00109,India
334093,2023-06-19,608,football,298,1099,801,1,00451,India
334093,2023-06-19,610,golf clubs,27000,42000,15000,1,00451,India
770503,2023-06-19,611,helmet,200,400,200,1,00128,India
770503,2023-06-19,602,cricket ball,125,260,135,1,00128,India
770503,2023-06-19,603,tennis ball,25,60,35,1,00128,India
851526,2023-06-19,611,helmet,200,400,200,1,00188,India
851526,2023-06-19,601,cricket bat,400,1500,1100,1,00188,India
851526,2023-06-19,602,cricket ball,125,260,135,1,00188,India
851526,2023-06-19,609,basketball,298,679,381,1,00188,India
203202,2023-06-19,602,cricket ball,125,260,135,1,00420,India
203202,2023-06-19,609,basketball,298,679,381,1,00420,India
580738,2023-06-19,603,tennis ball,25,60,35,1,00238,India
580738,2023-06-19,605,badminton shuttlecocks,180,300,120,1,00238,India
234404,2023-06-19,605,badminton shuttlecocks,180,300,120,1,00355,India
234404,2023-06-19,607,table tennis table,20000,26500,6500,1,00355,India
234404,2023-06-19,604,tennis racket,1200,1800,600,1,00355,India
108555,2023-06-19,604,tennis racket,1200,1800,600,1,00268,India
108555,2023-06-19,603,tennis ball,25,60,35,1,00268,India
703043,2023-06-20,607,table tennis table,20000,26500,6500,1,00438,India
707712,2023-06-20,605,badminton shuttlecocks,180,300,120,1,00023,India
707712,2023-06-20,608,football,298,1099,801,1,00023,India
707712,2023-06-20,606,badminton rackets,180,499,319,1,00023,India
142738,2023-06-20,605,badminton shuttlecocks,180,300,120,1,00415,India
142738,2023-06-20,608,football,298,1099,801,1,00415,India
299950,2023-06-20,608,football,298,1099,801,1,00395,India
299950,2023-06-20,611,helmet,200,400,200,1,00395,India
299950,2023-06-20,606,badminton rackets,180,499,319,1,00395,India
299950,2023-06-20,609,basketball,298,679,381,1,00395,India
884315,2023-06-21,609,basketball,298,679,381,1,00294,India
884315,2023-06-21,608,football,298,1099,801,1,00294,India
884315,2023-06-21,611,helmet,200,400,200,1,00294,India
884315,2023-06-21,604,tennis racket,1200,1800,600,1,00294,India
798128,2023-06-21,603,tennis ball,25,60,35,1,00407,India
798128,2023-06-21,606,badminton rackets,180,499,319,1,00407,India
902063,2023-06-21,610,golf clubs,27000,42000,15000,1,00151,India
342875,2023-06-21,608,football,298,1099,801,1,00060,India
706468,2023-06-21,605,badminton shuttlecocks,180,300,120,1,00345,India
706468,2023-06-21,609,basketball,298,679,381,1,00345,India
706468,2023-06-21,611,helmet,200,400,200,1,00345,India
706468,2023-06-21,607,table tennis table,20000,26500,6500,1,00345,India
874938,2023-06-21,602,cricket ball,125,260,135,1,00281,India
874938,2023-06-21,609,basketball,298,679,381,1,00281,India
874938,2023-06-21,604,tennis racket,1200,1800,600,1,00281,India
338773,2023-06-22,601,cricket bat,400,1500,1100,1,00408,India
338773,2023-06-22,609,basketball,298,679,381,1,00408,India
338773,2023-06-22,610,golf clubs,27000,42000,15000,1,00408,India
338773,2023-06-22,605,badminton shuttlecocks,180,300,120,1,00408,India
282198,2023-06-22,609,basketball,298,679,381,1,00462,India
359433,2023-06-22,603,tennis ball,25,60,35,1,00090,India
359433,2023-06-22,611,helmet,200,400,200,1,00090,India
359433,2023-06-22,601,cricket bat,400,1500,1100,1,00090,India
323856,2023-06-23,610,golf clubs,27000,42000,15000,1,00489,India
323856,2023-06-23,602,cricket ball,125,260,135,1,00489,India
323856,2023-06-23,609,basketball,298,679,381,1,00489,India
164543,2023-06-23,606,badminton rackets,180,499,319,1,00362,India
164543,2023-06-23,607,table tennis table,20000,26500,6500,1,00362,India
377964,2023-06-23,608,football,298,1099,801,1,00139,India
377964,2023-06-23,602,cricket ball,125,260,135,1,00139,India
377964,2023-06-23,606,badminton rackets,180,499,319,1,00139,India
887778,2023-06-23,604,tennis racket,1200,1800,600,1,00255,India
887778,2023-06-23,605,badminton shuttlecocks,180,300,120,1,00255,India
233788,2023-06-23,604,tennis racket,1200,1800,600,1,00182,India
233788,2023-06-23,601,cricket bat,400,1500,1100,1,00182,India
680544,2023-06-23,608,football,298,1099,801,1,00346,India
588422,2023-06-23,609,basketball,298,679,381,1,00146,India
134218,2023-06-23,603,tennis ball,25,60,35,1,00048,India
323923,2023-06-23,604,tennis racket,1200,1800,600,1,00235,India
389256,2023-06-24,602,cricket ball,125,260,135,1,00380,India
389256,2023-06-24,606,badminton rackets,180,499,319,1,00380,India
389256,2023-06-24,601,cricket bat,400,1500,1100,1,00380,India
389256,2023-06-24,603,tennis ball,25,60,35,1,00380,India
323005,2023-06-24,606,badminton rackets,180,499,319,1,00045,India
323005,2023-06-24,602,cricket ball,125,260,135,1,00045,India
891338,2023-06-24,610,golf clubs,27000,42000,15000,1,00175,India
371125,2023-06-24,604,tennis racket,1200,1800,600,1,00361,India
964930,2023-06-24,611,helmet,200,400,200,1,00478,India
964930,2023-06-24,607,table tennis table,20000,26500,6500,1,00478,India
479369,2023-06-24,607,table tennis table,20000,26500,6500,1,00081,India
730407,2023-06-24,605,badminton shuttlecocks,180,300,120,1,00417,India
311089,2023-06-25,604,tennis racket,1200,1800,600,1,00019,India
311089,2023-06-25,601,cricket bat,400,1500,1100,1,00019,India
311089,2023-06-25,602,cricket ball,125,260,135,1,00019,India
311089,2023-06-25,611,helmet,200,400,200,1,00019,India
311089,2023-06-25,606,badminton rackets,180,499,319,1,00019,India
598445,2023-06-25,605,badminton shuttlecocks,180,300,120,1,00028,India
636084,2023-06-25,606,badminton rackets,180,499,319,1,00344,India
636084,2023-06-25,611,helmet,200,400,200,1,00344,India
532556,2023-06-25,609,basketball,298,679,381,1,00266,India
532556,2023-06-25,604,tennis racket,1200,1800,600,1,00266,India
691266,2023-06-25,611,helmet,200,400,200,1,00196,India
691266,2023-06-25,610,golf clubs,27000,42000,15000,1,00196,India
691266,2023-06-25,603,tennis ball,25,60,35,1,00196,India
691266,2023-06-25,602,cricket ball,125,260,135,1,00196,India
958863,2023-06-25,608,football,298,1099,801,1,00435,India
403801,2023-06-25,605,badminton shuttlecocks,180,300,120,1,00410,India
403801,2023-06-25,601,cricket bat,400,1500,1100,1,00410,India
403801,2023-06-25,610,golf clubs,27000,42000,15000,1,00410,India
403801,2023-06-25,604,tennis racket,1200,1800,600,1,00410,India
324438,2023-06-25,606,badminton rackets,180,499,319,1,00106,India
324438,2023-06-25,603,tennis ball,25,60,35,1,00106,India
324438,2023-06-25,604,tennis racket,1200,1800,600,1,00106,India
324438,2023-06-25,602,cricket ball,125,260,135,1,00106,India
324438,2023-06-25,609,basketball,298,679,381,1,00106,India
194009,2023-06-26,603,tennis ball,25,60,35,1,00244,India
194009,2023-06-26,608,football,298,1099,801,1,00244,India
868049,2023-06-26,607,table tennis table,20000,26500,6500,1,00454,India
868049,2023-06-26,608,football,298,1099,801,1,00454,India
868049,2023-06-26,602,cricket ball,125,260,135,1,00454,India
868049,2023-06-26,604,tennis racket,1200,1800,600,1,00454,India
868049,2023-06-26,611,helmet,200,400,200,1,00454,India
607297,2023-06-27,608,football,298,1099,801,1,00383,India
607297,2023-06-27,605,badminton shuttlecocks,180,300,120,1,00383,India
164794,2023-06-27,610,golf clubs,27000,42000,15000,1,00260,India
164794,2023-06-27,605,badminton shuttlecocks,180,300,120,1,00260,India
147548,2023-06-27,609,basketball,298,679,381,1,00106,India
147548,2023-06-27,605,badminton shuttlecocks,180,300,120,1,00106,India
147548,2023-06-27,601,cricket bat,400,1500,1100,1,00106,India
540165,2023-06-27,603,tennis ball,25,60,35,1,00298,India
541028,2023-06-27,605,badminton shuttlecocks,180,300,120,1,00248,India
541028,2023-06-27,611,helmet,200,400,200,1,00248,India
144412,2023-06-27,601,cricket bat,400,1500,1100,1,00403,India
144412,2023-06-27,608,football,298,1099,801,1,00403,India
144412,2023-06-27,611,helmet,200,400,200,1,00403,India
627275,2023-06-28,603,tennis ball,25,60,35,1,00162,India
627275,2023-06-28,605,badminton shuttlecocks,180,300,120,1,00162,India
627275,2023-06-28,606,badminton rackets,180,499,319,1,00162,India
627275,2023-06-28,607,table tennis table,20000,26500,6500,1,00162,India
567310,2023-06-28,604,tennis racket,1200,1800,600,1,00187,India
567310,2023-06-28,603,tennis ball,25,60,35,1,00187,India
439779,2023-06-29,610,golf clubs,27000,42000,15000,1,00490,India
439779,2023-06-29,606,badminton rackets,180,499,319,1,00490,India
439779,2023-06-29,603,tennis ball,25,60,35,1,00490,India
439779,2023-06-29,605,badminton shuttlecocks,180,300,120,1,00490,India
439779,2023-06-29,611,helmet,200,400,200,1,00490,India
546578,2023-06-29,609,basketball,298,679,381,1,00198,India
546578,2023-06-29,606,badminton rackets,180,499,319,1,00198,India
512713,2023-06-29,610,golf clubs,27000,42000,15000,1,00213,India
512713,2023-06-29,606,badminton rackets,180,499,319,1,00213,India
142577,2023-06-29,607,table tennis table,20000,26500,6500,1,00246,India
142577,2023-06-29,603,tennis ball,25,60,35,1,00246,India
142577,2023-06-29,610,golf clubs,27000,42000,15000,1,00246,India
889025,2023-06-29,611,helmet,200,400,200,1,00159,India
914242,2023-06-29,606,badminton rackets,180,499,319,1,00264,India
914242,2023-06-29,604,tennis racket,1200,1800,600,1,00264,India
567017,2023-06-29,601,cricket bat,400,1500,1100,1,00493,India
567017,2023-06-29,608,football,298,1099,801,1,00493,India
560404,2023-06-29,604,tennis racket,1200,1800,600,1,00334,India
560404,2023-06-29,611,helmet,200,400,200,1,00334,India
560404,2023-06-29,608,football,298,1099,801,1,00334,India
396200,2023-06-29,611,helmet,200,400,200,1,00061,India
396200,2023-06-29,602,cricket ball,125,260,135,1,00061,India
396200,2023-06-29,603,tennis ball,25,60,35,1,00061,India
396200,2023-06-29,606,badminton rackets,180,499,319,1,00061,India
245530,2023-06-29,610,golf clubs,27000,42000,15000,1,00020,India
245530,2023-06-29,603,tennis ball,25,60,35,1,00020,India
245530,2023-06-29,607,table tennis table,20000,26500,6500,1,00020,India
242031,2023-06-30,602,cricket ball,125,260,135,1,00358,India
242031,2023-06-30,604,tennis racket,1200,1800,600,1,00358,India
985618,2023-06-30,609,basketball,298,679,381,1,00002,India
985618,2023-06-30,608,football,298,1099,801,1,00002,India
985618,2023-06-30,602,cricket ball,125,260,135,1,00002,India
985618,2023-06-30,611,helmet,200,400,200,1,00002,India
186607,2023-06-30,602,cricket ball,125,260,135,1,00024,India
186607,2023-06-30,601,cricket bat,400,1500,1100,1,00024,India
186607,2023-06-30,604,tennis racket,1200,1800,600,1,00024,India
998448,2023-06-30,611,helmet,200,400,200,1,00204,India
998448,2023-06-30,609,basketball,298,679,381,1,00204,India
998448,2023-06-30,603,tennis ball,25,60,35,1,00204,India
998448,2023-06-30,604,tennis racket,1200,1800,600,1,00204,India
998448,2023-06-30,606,badminton rackets,180,499,319,1,00204,India
675809,2023-06-30,601,cricket bat,400,1500,1100,1,00128,India
675809,2023-06-30,604,tennis racket,1200,1800,600,1,00128,India
675809,2023-06-30,606,badminton rackets,180,499,319,1,00128,India
704027,2023-06-30,606,badminton rackets,180,499,319,1,00398,India
535058,2023-06-30,602,cricket ball,125,260,135,1,00234,India
535058,2023-06-30,609,basketball,298,679,381,1,00234,India
535058,2023-06-30,606,badminton rackets,180,499,319,1,00234,India
535058,2023-06-30,604,tennis racket,1200,1800,600,1,00234,India
570931,2023-07-01,602,cricket ball,125,260,135,1,00406,India
570931,2023-07-01,605,badminton shuttlecocks,180,300,120,1,00406,India
570931,2023-07-01,606,badminton rackets,180,499,319,1,00406,India
881621,2023-07-01,601,cricket bat,400,1500,1100,1,00069,India
881621,2023-07-01,607,table tennis table,20000,26500,6500,1,00069,India
948904,2023-07-01,610,golf clubs,27000,42000,15000,1,00218,India
948904,2023-07-01,602,cricket ball,125,260,135,1,00218,India
948904,2023-07-01,601,cricket bat,400,1500,1100,1,00218,India
524591,2023-07-01,607,table tennis table,20000,26500,6500,1,00027,India
524591,2023-07-01,611,helmet,200,400,200,1,00027,India
524591,2023-07-01,610,golf clubs,27000,42000,15000,1,00027,India
445934,2023-07-02,605,badminton shuttlecocks,180,300,120,1,00004,India
965168,2023-07-02,605,badminton shuttlecocks,180,300,120,1,00344,India
351975,2023-07-02,602,cricket ball,125,260,135,1,00337,India
351975,2023-07-02,609,basketball,298,679,381,1,00337,India
351975,2023-07-02,604,tennis racket,1200,1800,600,1,00337,India
351975,2023-07-02,603,tennis ball,25,60,35,1,00337,India
698561,2023-07-02,601,cricket bat,400,1500,1100,1,00083,India
698561,2023-07-02,607,table tennis table,20000,26500,6500,1,00083,India
698561,2023-07-02,611,helmet,200,400,200,1,00083,India
286849,2023-07-02,606,badminton rackets,180,499,319,1,00498,India
286849,2023-07-02,609,basketball,298,679,381,1,00498,India
286849,2023-07-02,607,table tennis table,20000,26500,6500,1,00498,India
286849,2023-07-02,605,badminton shuttlecocks,180,300,120,1,00498,India
673887,2023-07-02,602,cricket ball,125,260,135,1,00163,India
534997,2023-07-03,604,tennis racket,1200,1800,600,1,00014,India
534997,2023-07-03,603,tennis ball,25,60,35,1,00014,India
195372,2023-07-03,610,golf clubs,27000,42000,15000,1,00129,India
195372,2023-07-03,608,football,298,1099,801,1,00129,India
195372,2023-07-03,604,tennis racket,1200,1800,600,1,00129,India
195372,2023-07-03,605,badminton shuttlecocks,180,300,120,1,00129,India
550350,2023-07-03,605,badminton shuttlecocks,180,300,120,1,00322,India
550350,2023-07-03,607,table tennis table,20000,26500,6500,1,00322,India
550350,2023-07-03,606,badminton rackets,180,499,319,1,00322,India
725227,2023-07-03,610,golf clubs,27000,42000,15000,1,00092,India
725227,2023-07-03,611,helmet,200,400,200,1,00092,India
725227,2023-07-03,606,badminton rackets,180,499,319,1,00092,India
725227,2023-07-03,609,basketball,298,679,381,1,00092,India
132169,2023-07-03,610,golf clubs,27000,42000,15000,1,00032,India
132169,2023-07-03,607,table tennis table,20000,26500,6500,1,00032,India
132169,2023-07-03,603,tennis ball,25,60,35,1,00032,India
325517,2023-07-03,609,basketball,298,679,381,1,00272,India
240856,2023-07-03,602,cricket ball,125,260,135,1,00136,India
240856,2023-07-03,609,basketball,298,679,381,1,00136,India
240856,2023-07-03,611,helmet,200,400,200,1,00136,India
240856,2023-07-03,606,badminton rackets,180,499,319,1,00136,India
240856,2023-07-03,607,table tennis table,20000,26500,6500,1,00136,India
342007,2023-07-04,602,cricket ball,125,260,135,1,00153,India
342007,2023-07-04,608,football,298,1099,801,1,00153,India
342007,2023-07-04,603,tennis ball,25,60,35,1,00153,India
342007,2023-07-04,601,cricket bat,400,1500,1100,1,00153,India
342007,2023-07-04,611,helmet,200,400,200,1,00153,India
270863,2023-07-04,605,badminton shuttlecocks,180,300,120,1,00121,India
270863,2023-07-04,610,golf clubs,27000,42000,15000,1,00121,India
270863,2023-07-04,604,tennis racket,1200,1800,600,1,00121,India
605103,2023-07-04,601,cricket bat,400,1500,1100,1,00176,India
605103,2023-07-04,608,football,298,1099,801,1,00176,India
605103,2023-07-04,603,tennis ball,25,60,35,1,00176,India
227090,2023-07-04,611,helmet,200,400,200,1,00163,India
227090,2023-07-04,604,tennis racket,1200,1800,600,1,00163,India
227090,2023-07-04,606,badminton rackets,180,499,319,1,00163,India
716252,2023-07-04,601,cricket bat,400,1500,1100,1,00449,India
716252,2023-07-04,610,golf clubs,27000,42000,15000,1,00449,India
716252,2023-07-04,606,badminton rackets,180,499,319,1,00449,India
716252,2023-07-04,605,badminton shuttlecocks,180,300,120,1,00449,India
902226,2023-07-04,604,tennis racket,1200,1800,600,1,00206,India
902226,2023-07-04,608,football,298,1099,801,1,00206,India
902226,2023-07-04,610,golf clubs,27000,42000,15000,1,00206,India
902226,2023-07-04,602,cricket ball,125,260,135,1,00206,India
187562,2023-07-04,609,basketball,298,679,381,1,00189,India
187562,2023-07-04,608,football,298,1099,801,1,00189,India
187562,2023-07-04,606,badminton rackets,180,499,319,1,00189,India
187562,2023-07-04,611,helmet,200,400,200,1,00189,India
980702,2023-07-04,602,cricket ball,125,260,135,1,00228,India
719869,2023-07-04,605,badminton shuttlecocks,180,300,120,1,00142,India
719869,2023-07-04,607,table tennis table,20000,26500,6500,1,00142,India
719869,2023-07-04,609,basketball,298,679,381,1,00142,India
719869,2023-07-04,602,cricket ball,125,260,135,1,00142,India
719869,2023-07-04,611,helmet,200,400,200,1,00142,India
701776,2023-07-04,611,helmet,200,400,200,1,00101,India
701776,2023-07-04,608,football,298,1099,801,1,00101,India
701776,2023-07-04,607,table tennis table,20000,26500,6500,1,00101,India
138087,2023-07-05,611,helmet,200,400,200,1,00306,India
138087,2023-07-05,605,badminton shuttlecocks,180,300,120,1,00306,India
138087,2023-07-05,604,tennis racket,1200,1800,600,1,00306,India
138087,2023-07-05,603,tennis ball,25,60,35,1,00306,India
960152,2023-07-05,601,cricket bat,400,1500,1100,1,00280,India
960152,2023-07-05,611,helmet,200,400,200,1,00280,India
966436,2023-07-05,608,football,298,1099,801,1,00232,India
966436,2023-07-05,607,table tennis table,20000,26500,6500,1,00232,India
514463,2023-07-05,607,table tennis table,20000,26500,6500,1,00196,India
514463,2023-07-05,603,tennis ball,25,60,35,1,00196,India
514463,2023-07-05,604,tennis racket,1200,1800,600,1,00196,India
322831,2023-07-05,610,golf clubs,27000,42000,15000,1,00060,India
359359,2023-07-06,604,tennis racket,1200,1800,600,1,00248,India
359359,2023-07-06,611,helmet,200,400,200,1,00248,India
359359,2023-07-06,608,football,298,1099,801,1,00248,India
348811,2023-07-06,602,cricket ball,125,260,135,1,00238,India
348811,2023-07-06,605,badminton shuttlecocks,180,300,120,1,00238,India
348811,2023-07-06,601,cricket bat,400,1500,1100,1,00238,India
982946,2023-07-06,609,basketball,298,679,381,1,00326,India
982946,2023-07-06,606,badminton rackets,180,499,319,1,00326,India
769623,2023-07-06,601,cricket bat,400,1500,1100,1,00459,India
572302,2023-07-06,611,helmet,200,400,200,1,00279,India
572302,2023-07-06,601,cricket bat,400,1500,1100,1,00279,India
321192,2023-07-06,608,football,298,1099,801,1,00055,India
321192,2023-07-06,607,table tennis table,20000,26500,6500,1,00055,India
321192,2023-07-06,606,badminton rackets,180,499,319,1,00055,India
641892,2023-07-06,603,tennis ball,25,60,35,1,00057,India
899998,2023-07-06,602,cricket ball,125,260,135,1,00375,India
899998,2023-07-06,604,tennis racket,1200,1800,600,1,00375,India
899998,2023-07-06,606,badminton rackets,180,499,319,1,00375,India
902430,2023-07-06,603,tennis ball,25,60,35,1,00044,India
147133,2023-07-07,607,table tennis table,20000,26500,6500,1,00130,India
147133,2023-07-07,602,cricket ball,125,260,135,1,00130,India
297488,2023-07-07,609,basketball,298,679,381,1,00196,India
510259,2023-07-07,605,badminton shuttlecocks,180,300,120,1,00236,India
510259,2023-07-07,602,cricket ball,125,260,135,1,00236,India
828706,2023-07-07,611,helmet,200,400,200,1,00266,India
828706,2023-07-07,607,table tennis table,20000,26500,6500,1,00266,India
828706,2023-07-07,605,badminton shuttlecocks,180,300,120,1,00266,India
828706,2023-07-07,608,football,298,1099,801,1,00266,India
711313,2023-07-07,608,football,298,1099,801,1,00005,India
732629,2023-07-07,606,badminton rackets,180,499,319,1,00353,India
436332,2023-07-07,603,tennis ball,25,60,35,1,00295,India
436332,2023-07-07,605,badminton shuttlecocks,180,300,120,1,00295,India
436332,2023-07-07,607,table tennis table,20000,26500,6500,1,00295,India
436332,2023-07-07,606,badminton rackets,180,499,319,1,00295,India
436332,2023-07-07,610,golf clubs,27000,42000,15000,1,00295,India
468389,2023-07-07,609,basketball,298,679,381,1,00247,India
468389,2023-07-07,604,tennis racket,1200,1800,600,1,00247,India
468389,2023-07-07,608,football,298,1099,801,1,00247,India
468389,2023-07-07,606,badminton rackets,180,499,319,1,00247,India
591610,2023-07-08,603,tennis ball,25,60,35,1,00494,India
591610,2023-07-08,605,badminton shuttlecocks,180,300,120,1,00494,India
591610,2023-07-08,610,golf clubs,27000,42000,15000,1,00494,India
723658,2023-07-08,611,helmet,200,400,200,1,00413,India
723658,2023-07-08,610,golf clubs,27000,42000,15000,1,00413,India
699284,2023-07-09,611,helmet,200,400,200,1,00451,India
699284,2023-07-09,606,badminton rackets,180,499,319,1,00451,India
699284,2023-07-09,602,cricket ball,125,260,135,1,00451,India
139011,2023-07-09,604,tennis racket,1200,1800,600,1,00313,India
139011,2023-07-09,603,tennis ball,25,60,35,1,00313,India
768920,2023-07-09,605,badminton shuttlecocks,180,300,120,1,00066,India
768920,2023-07-09,607,table tennis table,20000,26500,6500,1,00066,India
768920,2023-07-09,606,badminton rackets,180,499,319,1,00066,India
542847,2023-07-09,602,cricket ball,125,260,135,1,00308,India
542847,2023-07-09,606,badminton rackets,180,499,319,1,00308,India
542847,2023-07-09,603,tennis ball,25,60,35,1,00308,India
542847,2023-07-09,611,helmet,200,400,200,1,00308,India
730508,2023-07-09,608,football,298,1099,801,1,00016,India
730508,2023-07-09,605,badminton shuttlecocks,180,300,120,1,00016,India
169071,2023-07-09,609,basketball,298,679,381,1,00024,India
472257,2023-07-09,605,badminton shuttlecocks,180,300,120,1,00483,India
472257,2023-07-09,603,tennis ball,25,60,35,1,00483,India
472257,2023-07-09,610,golf clubs,27000,42000,15000,1,00483,India
472257,2023-07-09,601,cricket bat,400,1500,1100,1,00483,India
234288,2023-07-10,611,helmet,200,400,200,1,00309,India
508136,2023-07-10,602,cricket ball,125,260,135,1,00500,India
508136,2023-07-10,607,table tennis table,20000,26500,6500,1,00500,India
508136,2023-07-10,609,basketball,298,679,381,1,00500,India
508136,2023-07-10,610,golf clubs,27000,42000,15000,1,00500,India
567545,2023-07-10,602,cricket ball,125,260,135,1,00477,India
567545,2023-07-10,609,basketball,298,679,381,1,00477,India
567545,2023-07-10,606,badminton rackets,180,499,319,1,00477,India
567545,2023-07-10,601,cricket bat,400,1500,1100,1,00477,India
127387,2023-07-10,605,badminton shuttlecocks,180,300,120,1,00006,India
127387,2023-07-10,606,badminton rackets,180,499,319,1,00006,India
127387,2023-07-10,602,cricket ball,125,260,135,1,00006,India
810126,2023-07-10,602,cricket ball,125,260,135,1,00488,India
517738,2023-07-11,605,badminton shuttlecocks,180,300,120,1,00373,India
495589,2023-07-11,602,cricket ball,125,260,135,1,00308,India
495589,2023-07-11,610,golf clubs,27000,42000,15000,1,00308,India
526870,2023-07-11,603,tennis ball,25,60,35,1,00251,India
526870,2023-07-11,609,basketball,298,679,381,1,00251,India
526870,2023-07-11,610,golf clubs,27000,42000,15000,1,00251,India
201713,2023-07-11,609,basketball,298,679,381,1,00175,India
201713,2023-07-11,601,cricket bat,400,1500,1100,1,00175,India
201713,2023-07-11,603,tennis ball,25,60,35,1,00175,India
109962,2023-07-11,603,tennis ball,25,60,35,1,00217,India
109962,2023-07-11,607,table tennis table,20000,26500,6500,1,00217,India
355201,2023-07-11,611,helmet,200,400,200,1,00291,India
355201,2023-07-11,601,cricket bat,400,1500,1100,1,00291,India
355201,2023-07-11,604,tennis racket,1200,1800,600,1,00291,India
745433,2023-07-11,601,cricket bat,400,1500,1100,1,00252,India
745433,2023-07-11,604,tennis racket,1200,1800,600,1,00252,India
362379,2023-07-11,605,badminton shuttlecocks,180,300,120,1,00431,India
362379,2023-07-11,603,tennis ball,25,60,35,1,00431,India
362379,2023-07-11,607,table tennis table,20000,26500,6500,1,00431,India
362379,2023-07-11,610,golf clubs,27000,42000,15000,1,00431,India
870653,2023-07-11,607,table tennis table,20000,26500,6500,1,00261,India
870653,2023-07-11,606,badminton rackets,180,499,319,1,00261,India
821700,2023-07-12,606,badminton rackets,180,499,319,1,00274,India
821700,2023-07-12,609,basketball,298,679,381,1,00274,India
166484,2023-07-13,608,football,298,1099,801,1,00103,India
673311,2023-07-13,607,table tennis table,20000,26500,6500,1,00049,India
673311,2023-07-13,606,badminton rackets,180,499,319,1,00049,India
345522,2023-07-13,602,cricket ball,125,260,135,1,00182,India
345522,2023-07-13,606,badminton rackets,180,499,319,1,00182,India
289874,2023-07-13,601,cricket bat,400,1500,1100,1,00312,India
289874,2023-07-13,603,tennis ball,25,60,35,1,00312,India
289874,2023-07-13,604,tennis racket,1200,1800,600,1,00312,India
289874,2023-07-13,611,helmet,200,400,200,1,00312,India
868464,2023-07-13,607,table tennis table,20000,26500,6500,1,00113,India
868464,2023-07-13,608,football,298,1099,801,1,00113,India
868464,2023-07-13,611,helmet,200,400,200,1,00113,India
868464,2023-07-13,601,cricket bat,400,1500,1100,1,00113,India
645250,2023-07-13,602,cricket ball,125,260,135,1,00321,India
444505,2023-07-13,610,golf clubs,27000,42000,15000,1,00156,India
444505,2023-07-13,608,football,298,1099,801,1,00156,India
444505,2023-07-13,611,helmet,200,400,200,1,00156,India
444505,2023-07-13,604,tennis racket,1200,1800,600,1,00156,India
186330,2023-07-14,606,badminton rackets,180,499,319,1,00308,India
186330,2023-07-14,605,badminton shuttlecocks,180,300,120,1,00308,India
186330,2023-07-14,610,golf clubs,27000,42000,15000,1,00308,India
132403,2023-07-14,601,cricket bat,400,1500,1100,1,00070,India
132403,2023-07-14,608,football,298,1099,801,1,00070,India
132403,2023-07-14,611,helmet,200,400,200,1,00070,India
820920,2023-07-14,608,football,298,1099,801,1,00145,India
820920,2023-07-14,606,badminton rackets,180,499,319,1,00145,India
595901,2023-07-14,604,tennis racket,1200,1800,600,1,00473,India
595901,2023-07-14,602,cricket ball,125,260,135,1,00473,India
252782,2023-07-14,611,helmet,200,400,200,1,00190,India
252782,2023-07-14,606,badminton rackets,180,499,319,1,00190,India
252782,2023-07-14,610,golf clubs,27000,42000,15000,1,00190,India
676536,2023-07-14,611,helmet,200,400,200,1,00105,India
676536,2023-07-14,602,cricket ball,125,260,135,1,00105,India
676536,2023-07-14,607,table tennis table,20000,26500,6500,1,00105,India
676536,2023-07-14,609,basketball,298,679,381,1,00105,India
676536,2023-07-14,606,badminton rackets,180,499,319,1,00105,India
773505,2023-07-14,605,badminton shuttlecocks,180,300,120,1,00180,India
773505,2023-07-14,607,table tennis table,20000,26500,6500,1,00180,India
435066,2023-07-14,607,table tennis table,20000,26500,6500,1,00143,India
435066,2023-07-14,603,tennis ball,25,60,35,1,00143,India
435066,2023-07-14,604,tennis racket,1200,1800,600,1,00143,India
603178,2023-07-14,609,basketball,298,679,381,1,00123,India
603178,2023-07-14,610,golf clubs,27000,42000,15000,1,00123,India
613497,2023-07-14,607,table tennis table,20000,26500,6500,1,00145,India
613497,2023-07-14,605,badminton shuttlecocks,180,300,120,1,00145,India
613497,2023-07-14,602,cricket ball,125,260,135,1,00145,India
613497,2023-07-14,609,basketball,298,679,381,1,00145,India
613497,2023-07-14,610,golf clubs,27000,42000,15000,1,00145,India
529142,2023-07-15,602,cricket ball,125,260,135,1,00428,India
529142,2023-07-15,604,tennis racket,1200,1800,600,1,00428,India
529142,2023-07-15,603,tennis ball,25,60,35,1,00428,India
529142,2023-07-15,606,badminton rackets,180,499,319,1,00428,India
644292,2023-07-15,605,badminton shuttlecocks,180,300,120,1,00415,India
644292,2023-07-15,601,cricket bat,400,1500,1100,1,00415,India
644292,2023-07-15,611,helmet,200,400,200,1,00415,India
644292,2023-07-15,602,cricket ball,125,260,135,1,00415,India
644292,2023-07-15,603,tennis ball,25,60,35,1,00415,India
507915,2023-07-15,610,golf clubs,27000,42000,15000,1,00398,India
507915,2023-07-15,607,table tennis table,20000,26500,6500,1,00398,India
427535,2023-07-15,601,cricket bat,400,1500,1100,1,00117,India
732522,2023-07-16,606,badminton rackets,180,499,319,1,00119,India
732522,2023-07-16,608,football,298,1099,801,1,00119,India
732522,2023-07-16,607,table tennis table,20000,26500,6500,1,00119,India
732522,2023-07-16,601,cricket bat,400,1500,1100,1,00119,India
741252,2023-07-16,604,tennis racket,1200,1800,600,1,00310,India
759276,2023-07-17,605,badminton shuttlecocks,180,300,120,1,00170,India
759276,2023-07-17,611,helmet,200,400,200,1,00170,India
759276,2023-07-17,601,cricket bat,400,1500,1100,1,00170,India
759276,2023-07-17,609,basketball,298,679,381,1,00170,India
551391,2023-07-17,611,helmet,200,400,200,1,00467,India
255419,2023-07-17,610,golf clubs,27000,42000,15000,1,00046,India
255419,2023-07-17,602,cricket ball,125,260,135,1,00046,India
255419,2023-07-17,604,tennis racket,1200,1800,600,1,00046,India
255419,2023-07-17,609,basketball,298,679,381,1,00046,India
801405,2023-07-17,605,badminton shuttlecocks,180,300,120,1,00151,India
801405,2023-07-17,601,cricket bat,400,1500,1100,1,00151,India
801405,2023-07-17,606,badminton rackets,180,499,319,1,00151,India
232306,2023-07-17,610,golf clubs,27000,42000,15000,1,00361,India
232306,2023-07-17,611,helmet,200,400,200,1,00361,India
232306,2023-07-17,605,badminton shuttlecocks,180,300,120,1,00361,India
287958,2023-07-17,604,tennis racket,1200,1800,600,1,00064,India
287958,2023-07-17,610,golf clubs,27000,42000,15000,1,00064,India
287958,2023-07-17,605,badminton shuttlecocks,180,300,120,1,00064,India
287958,2023-07-17,611,helmet,200,400,200,1,00064,India
220644,2023-07-17,605,badminton shuttlecocks,180,300,120,1,00196,India
220644,2023-07-17,603,tennis ball,25,60,35,1,00196,India
220644,2023-07-17,604,tennis racket,1200,1800,600,1,00196,India
220644,2023-07-17,602,cricket ball,125,260,135,1,00196,India
900748,2023-07-17,607,table tennis table,20000,26500,6500,1,00012,India
739182,2023-07-19,609,basketball,298,679,381,1,00061,India
739182,2023-07-19,610,golf clubs,27000,42000,15000,1,00061,India
974267,2023-07-20,611,helmet,200,400,200,1,00170,India
974267,2023-07-20,601,cricket bat,400,1500,1100,1,00170,India
605170,2023-07-20,610,golf clubs,27000,42000,15000,1,00299,India
605170,2023-07-20,605,badminton shuttlecocks,180,300,120,1,00299,India
605170,2023-07-20,602,cricket ball,125,260,135,1,00299,India
475061,2023-07-21,607,table tennis table,20000,26500,6500,1,00338,India
475061,2023-07-21,610,golf clubs,27000,42000,15000,1,00338,India
475061,2023-07-21,611,helmet,200,400,200,1,00338,India
563142,2023-07-21,602,cricket ball,125,260,135,1,00305,India
563142,2023-07-21,610,golf clubs,27000,42000,15000,1,00305,India
563142,2023-07-21,607,table tennis table,20000,26500,6500,1,00305,India
563142,2023-07-21,609,basketball,298,679,381,1,00305,India
868710,2023-07-21,607,table tennis table,20000,26500,6500,1,00280,India
187612,2023-07-22,604,tennis racket,1200,1800,600,1,00286,India
545164,2023-07-22,601,cricket bat,400,1500,1100,1,00134,India
356134,2023-07-22,611,helmet,200,400,200,1,00331,India
356134,2023-07-22,606,badminton rackets,180,499,319,1,00331,India
356134,2023-07-22,608,football,298,1099,801,1,00331,India
533101,2023-07-22,608,football,298,1099,801,1,00242,India
533101,2023-07-22,604,tennis racket,1200,1800,600,1,00242,India
140931,2023-07-22,601,cricket bat,400,1500,1100,1,00238,India
140931,2023-07-22,602,cricket ball,125,260,135,1,00238,India
610627,2023-07-22,610,golf clubs,27000,42000,15000,1,00182,India
610627,2023-07-22,601,cricket bat,400,1500,1100,1,00182,India
292488,2023-07-22,610,golf clubs,27000,42000,15000,1,00420,India
292488,2023-07-22,607,table tennis table,20000,26500,6500,1,00420,India
399695,2023-07-22,603,tennis ball,25,60,35,1,00361,India
399695,2023-07-22,606,badminton rackets,180,499,319,1,00361,India
815404,2023-07-22,608,football,298,1099,801,1,00451,India
815404,2023-07-22,607,table tennis table,20000,26500,6500,1,00451,India
815404,2023-07-22,604,tennis racket,1200,1800,600,1,00451,India
285820,2023-07-23,605,badminton shuttlecocks,180,300,120,1,00443,India
285820,2023-07-23,607,table tennis table,20000,26500,6500,1,00443,India
285820,2023-07-23,610,golf clubs,27000,42000,15000,1,00443,India
593854,2023-07-24,610,golf clubs,27000,42000,15000,1,00168,India
593854,2023-07-24,608,football,298,1099,801,1,00168,India
593854,2023-07-24,607,table tennis table,20000,26500,6500,1,00168,India
426441,2023-07-24,605,badminton shuttlecocks,180,300,120,1,00269,India
426441,2023-07-24,610,golf clubs,27000,42000,15000,1,00269,India
426441,2023-07-24,603,tennis ball,25,60,35,1,00269,India
622641,2023-07-24,607,table tennis table,20000,26500,6500,1,00201,India
622641,2023-07-24,602,cricket ball,125,260,135,1,00201,India
622641,2023-07-24,608,football,298,1099,801,1,00201,India
622641,2023-07-24,609,basketball,298,679,381,1,00201,India
233497,2023-07-24,610,golf clubs,27000,42000,15000,1,00389,India
233497,2023-07-24,606,badminton rackets,180,499,319,1,00389,India
505039,2023-07-24,605,badminton shuttlecocks,180,300,120,1,00304,India
505039,2023-07-24,611,helmet,200,400,200,1,00304,India
505039,2023-07-24,607,table tennis table,20000,26500,6500,1,00304,India
968590,2023-07-24,609,basketball,298,679,381,1,00353,India
772177,2023-07-25,602,cricket ball,125,260,135,1,00304,India
772177,2023-07-25,608,football,298,1099,801,1,00304,India
772177,2023-07-25,610,golf clubs,27000,42000,15000,1,00304,India
772177,2023-07-25,605,badminton shuttlecocks,180,300,120,1,00304,India
772177,2023-07-25,604,tennis racket,1200,1800,600,1,00304,India
474200,2023-07-25,605,badminton shuttlecocks,180,300,120,1,00474,India
474200,2023-07-25,604,tennis racket,1200,1800,600,1,00474,India
474200,2023-07-25,607,table tennis table,20000,26500,6500,1,00474,India
474200,2023-07-25,601,cricket bat,400,1500,1100,1,00474,India
360164,2023-07-25,606,badminton rackets,180,499,319,1,00225,India
360164,2023-07-25,605,badminton shuttlecocks,180,300,120,1,00225,India
360164,2023-07-25,603,tennis ball,25,60,35,1,00225,India
452200,2023-07-25,607,table tennis table,20000,26500,6500,1,00138,India
452200,2023-07-25,606,badminton rackets,180,499,319,1,00138,India
452200,2023-07-25,608,football,298,1099,801,1,00138,India
458529,2023-07-25,601,cricket bat,400,1500,1100,1,00026,India
458529,2023-07-25,606,badminton rackets,180,499,319,1,00026,India
705508,2023-07-25,601,cricket bat,400,1500,1100,1,00095,India
705508,2023-07-25,602,cricket ball,125,260,135,1,00095,India
705508,2023-07-25,605,badminton shuttlecocks,180,300,120,1,00095,India
705508,2023-07-25,604,tennis racket,1200,1800,600,1,00095,India
447988,2023-07-25,606,badminton rackets,180,499,319,1,00158,India
447988,2023-07-25,602,cricket ball,125,260,135,1,00158,India
791220,2023-07-25,611,helmet,200,400,200,1,00367,India
791220,2023-07-25,610,golf clubs,27000,42000,15000,1,00367,India
791220,2023-07-25,609,basketball,298,679,381,1,00367,India
791220,2023-07-25,604,tennis racket,1200,1800,600,1,00367,India
791220,2023-07-25,605,badminton shuttlecocks,180,300,120,1,00367,India
848708,2023-07-25,607,table tennis table,20000,26500,6500,1,00177,India
848708,2023-07-25,611,helmet,200,400,200,1,00177,India
848708,2023-07-25,609,basketball,298,679,381,1,00177,India
848708,2023-07-25,605,badminton shuttlecocks,180,300,120,1,00177,India
519363,2023-07-25,602,cricket ball,125,260,135,1,00415,India
519363,2023-07-25,610,golf clubs,27000,42000,15000,1,00415,India
519363,2023-07-25,606,badminton rackets,180,499,319,1,00415,India
939468,2023-07-26,607,table tennis table,20000,26500,6500,1,00054,India
237345,2023-07-26,606,badminton rackets,180,499,319,1,00369,India
237345,2023-07-26,604,tennis racket,1200,1800,600,1,00369,India
237345,2023-07-26,602,cricket ball,125,260,135,1,00369,India
407417,2023-07-26,601,cricket bat,400,1500,1100,1,00145,India
407417,2023-07-26,611,helmet,200,400,200,1,00145,India
407417,2023-07-26,603,tennis ball,25,60,35,1,00145,India
151623,2023-07-27,604,tennis racket,1200,1800,600,1,00009,India
151623,2023-07-27,606,badminton rackets,180,499,319,1,00009,India
979465,2023-07-27,601,cricket bat,400,1500,1100,1,00182,India
979465,2023-07-27,607,table tennis table,20000,26500,6500,1,00182,India
818020,2023-07-27,611,helmet,200,400,200,1,00026,India
317331,2023-07-27,605,badminton shuttlecocks,180,300,120,1,00209,India
955565,2023-07-27,609,basketball,298,679,381,1,00043,India
955565,2023-07-27,608,football,298,1099,801,1,00043,India
757650,2023-07-27,606,badminton rackets,180,499,319,1,00026,India
757650,2023-07-27,607,table tennis table,20000,26500,6500,1,00026,India
992775,2023-07-27,601,cricket bat,400,1500,1100,1,00152,India
992775,2023-07-27,609,basketball,298,679,381,1,00152,India
700847,2023-07-27,611,helmet,200,400,200,1,00176,India
700847,2023-07-27,601,cricket bat,400,1500,1100,1,00176,India
700847,2023-07-27,609,basketball,298,679,381,1,00176,India
700847,2023-07-27,604,tennis racket,1200,1800,600,1,00176,India
549212,2023-07-28,610,golf clubs,27000,42000,15000,1,00045,India
549212,2023-07-28,602,cricket ball,125,260,135,1,00045,India
549212,2023-07-28,604,tennis racket,1200,1800,600,1,00045,India
549212,2023-07-28,603,tennis ball,25,60,35,1,00045,India
549212,2023-07-28,611,helmet,200,400,200,1,00045,India
558038,2023-07-28,602,cricket ball,125,260,135,1,00434,India
558038,2023-07-28,606,badminton rackets,180,499,319,1,00434,India
558038,2023-07-28,603,tennis ball,25,60,35,1,00434,India
779238,2023-07-28,606,badminton rackets,180,499,319,1,00461,India
779238,2023-07-28,607,table tennis table,20000,26500,6500,1,00461,India
779238,2023-07-28,605,badminton shuttlecocks,180,300,120,1,00461,India
779238,2023-07-28,604,tennis racket,1200,1800,600,1,00461,India
984471,2023-07-28,608,football,298,1099,801,1,00211,India
984471,2023-07-28,601,cricket bat,400,1500,1100,1,00211,India
251241,2023-07-28,609,basketball,298,679,381,1,00255,India
251241,2023-07-28,601,cricket bat,400,1500,1100,1,00255,India
622358,2023-07-28,609,basketball,298,679,381,1,00257,India
332027,2023-07-28,608,football,298,1099,801,1,00054,India
332027,2023-07-28,602,cricket ball,125,260,135,1,00054,India
731631,2023-07-28,608,football,298,1099,801,1,00425,India
731631,2023-07-28,601,cricket bat,400,1500,1100,1,00425,India
731631,2023-07-28,605,badminton shuttlecocks,180,300,120,1,00425,India
836797,2023-07-28,608,football,298,1099,801,1,00069,India
836797,2023-07-28,606,badminton rackets,180,499,319,1,00069,India
836797,2023-07-28,601,cricket bat,400,1500,1100,1,00069,India
605775,2023-07-30,608,football,298,1099,801,1,00466,India
605775,2023-07-30,610,golf clubs,27000,42000,15000,1,00466,India
605775,2023-07-30,611,helmet,200,400,200,1,00466,India
605775,2023-07-30,609,basketball,298,679,381,1,00466,India
211231,2023-07-30,602,cricket ball,125,260,135,1,00133,India
211231,2023-07-30,608,football,298,1099,801,1,00133,India
211231,2023-07-30,607,table tennis table,20000,26500,6500,1,00133,India
978130,2023-07-30,605,badminton shuttlecocks,180,300,120,1,00334,India
978130,2023-07-30,610,golf clubs,27000,42000,15000,1,00334,India
679267,2023-07-30,604,tennis racket,1200,1800,600,1,00268,India
679267,2023-07-30,603,tennis ball,25,60,35,1,00268,India
679267,2023-07-30,606,badminton rackets,180,499,319,1,00268,India
679267,2023-07-30,608,football,298,1099,801,1,00268,India
679267,2023-07-30,607,table tennis table,20000,26500,6500,1,00268,India
936483,2023-07-31,610,golf clubs,27000,42000,15000,1,00099,India
936483,2023-07-31,601,cricket bat,400,1500,1100,1,00099,India
936483,2023-07-31,603,tennis ball,25,60,35,1,00099,India
451941,2023-07-31,602,cricket ball,125,260,135,1,00301,India
451941,2023-07-31,609,basketball,298,679,381,1,00301,India
535213,2023-08-01,604,tennis racket,1200,1800,600,1,00472,India
535213,2023-08-01,601,cricket bat,400,1500,1100,1,00472,India
535213,2023-08-01,608,football,298,1099,801,1,00472,India
535213,2023-08-01,611,helmet,200,400,200,1,00472,India
738383,2023-08-01,601,cricket bat,400,1500,1100,1,00372,India
844301,2023-08-01,610,golf clubs,27000,42000,15000,1,00131,India
844301,2023-08-01,611,helmet,200,400,200,1,00131,India
844301,2023-08-01,604,tennis racket,1200,1800,600,1,00131,India
844301,2023-08-01,607,table tennis table,20000,26500,6500,1,00131,India
735303,2023-08-01,606,badminton rackets,180,499,319,1,00169,India
735303,2023-08-01,605,badminton shuttlecocks,180,300,120,1,00169,India
425233,2023-08-02,601,cricket bat,400,1500,1100,1,00325,India
425233,2023-08-02,610,golf clubs,27000,42000,15000,1,00325,India
425233,2023-08-02,604,tennis racket,1200,1800,600,1,00325,India
162620,2023-08-02,609,basketball,298,679,381,1,00360,India
162620,2023-08-02,603,tennis ball,25,60,35,1,00360,India
162620,2023-08-02,601,cricket bat,400,1500,1100,1,00360,India
162620,2023-08-02,611,helmet,200,400,200,1,00360,India
883873,2023-08-02,608,football,298,1099,801,1,00292,India
883873,2023-08-02,611,helmet,200,400,200,1,00292,India
883873,2023-08-02,603,tennis ball,25,60,35,1,00292,India
883873,2023-08-02,602,cricket ball,125,260,135,1,00292,India
883873,2023-08-02,606,badminton rackets,180,499,319,1,00292,India
947852,2023-08-02,611,helmet,200,400,200,1,00446,India
947852,2023-08-02,606,badminton rackets,180,499,319,1,00446,India
535311,2023-08-02,609,basketball,298,679,381,1,00273,India
535311,2023-08-02,606,badminton rackets,180,499,319,1,00273,India
535311,2023-08-02,603,tennis ball,25,60,35,1,00273,India
969994,2023-08-02,611,helmet,200,400,200,1,00357,India
969994,2023-08-02,603,tennis ball,25,60,35,1,00357,India
968236,2023-08-02,609,basketball,298,679,381,1,00121,India
968236,2023-08-02,608,football,298,1099,801,1,00121,India
105062,2023-08-03,608,football,298,1099,801,1,00092,India
105062,2023-08-03,607,table tennis table,20000,26500,6500,1,00092,India
222921,2023-08-03,609,basketball,298,679,381,1,00151,India
222921,2023-08-03,603,tennis ball,25,60,35,1,00151,India
222921,2023-08-03,605,badminton shuttlecocks,180,300,120,1,00151,India
222921,2023-08-03,611,helmet,200,400,200,1,00151,India
384124,2023-08-03,607,table tennis table,20000,26500,6500,1,00398,India
755366,2023-08-03,604,tennis racket,1200,1800,600,1,00054,India
755366,2023-08-03,608,football,298,1099,801,1,00054,India
244921,2023-08-03,605,badminton shuttlecocks,180,300,120,1,00262,India
550862,2023-08-03,610,golf clubs,27000,42000,15000,1,00071,India
550862,2023-08-03,608,football,298,1099,801,1,00071,India
865279,2023-08-03,601,cricket bat,400,1500,1100,1,00215,India
865279,2023-08-03,606,badminton rackets,180,499,319,1,00215,India
865279,2023-08-03,607,table tennis table,20000,26500,6500,1,00215,India
896519,2023-08-03,607,table tennis table,20000,26500,6500,1,00362,India
896519,2023-08-03,606,badminton rackets,180,499,319,1,00362,India
370616,2023-08-03,610,golf clubs,27000,42000,15000,1,00315,India
370616,2023-08-03,609,basketball,298,679,381,1,00315,India
131750,2023-08-03,609,basketball,298,679,381,1,00370,India
131750,2023-08-03,601,cricket bat,400,1500,1100,1,00370,India
131750,2023-08-03,607,table tennis table,20000,26500,6500,1,00370,India
131750,2023-08-03,602,cricket ball,125,260,135,1,00370,India
691377,2023-08-04,606,badminton rackets,180,499,319,1,00182,India
691377,2023-08-04,601,cricket bat,400,1500,1100,1,00182,India
691377,2023-08-04,610,golf clubs,27000,42000,15000,1,00182,India
691377,2023-08-04,603,tennis ball,25,60,35,1,00182,India
691377,2023-08-04,607,table tennis table,20000,26500,6500,1,00182,India
155335,2023-08-04,611,helmet,200,400,200,1,00188,India
155335,2023-08-04,601,cricket bat,400,1500,1100,1,00188,India
155335,2023-08-04,608,football,298,1099,801,1,00188,India
155335,2023-08-04,610,golf clubs,27000,42000,15000,1,00188,India
796247,2023-08-04,607,table tennis table,20000,26500,6500,1,00138,India
796247,2023-08-04,611,helmet,200,400,200,1,00138,India
705111,2023-08-04,608,football,298,1099,801,1,00220,India
705111,2023-08-04,604,tennis racket,1200,1800,600,1,00220,India
705111,2023-08-04,606,badminton rackets,180,499,319,1,00220,India
513024,2023-08-04,611,helmet,200,400,200,1,00395,India
513024,2023-08-04,604,tennis racket,1200,1800,600,1,00395,India
513024,2023-08-04,601,cricket bat,400,1500,1100,1,00395,India
513024,2023-08-04,606,badminton rackets,180,499,319,1,00395,India
256580,2023-08-04,609,basketball,298,679,381,1,00083,India
326286,2023-08-04,603,tennis ball,25,60,35,1,00068,India
326286,2023-08-04,602,cricket ball,125,260,135,1,00068,India
326286,2023-08-04,610,golf clubs,27000,42000,15000,1,00068,India
326286,2023-08-04,608,football,298,1099,801,1,00068,India
409902,2023-08-04,602,cricket ball,125,260,135,1,00371,India
409902,2023-08-04,608,football,298,1099,801,1,00371,India
409902,2023-08-04,603,tennis ball,25,60,35,1,00371,India
594475,2023-08-05,609,basketball,298,679,381,1,00401,India
594475,2023-08-05,610,golf clubs,27000,42000,15000,1,00401,India
594475,2023-08-05,607,table tennis table,20000,26500,6500,1,00401,India
348822,2023-08-05,610,golf clubs,27000,42000,15000,1,00482,India
348822,2023-08-05,602,cricket ball,125,260,135,1,00482,India
348822,2023-08-05,605,badminton shuttlecocks,180,300,120,1,00482,India
348822,2023-08-05,601,cricket bat,400,1500,1100,1,00482,India
809111,2023-08-05,608,football,298,1099,801,1,00234,India
809111,2023-08-05,610,golf clubs,27000,42000,15000,1,00234,India
809111,2023-08-05,606,badminton rackets,180,499,319,1,00234,India
988850,2023-08-05,606,badminton rackets,180,499,319,1,00171,India
988850,2023-08-05,609,basketball,298,679,381,1,00171,India
988850,2023-08-05,604,tennis racket,1200,1800,600,1,00171,India
882194,2023-08-05,611,helmet,200,400,200,1,00180,India
882194,2023-08-05,604,tennis racket,1200,1800,600,1,00180,India
882194,2023-08-05,602,cricket ball,125,260,135,1,00180,India
882194,2023-08-05,607,table tennis table,20000,26500,6500,1,00180,India
773798,2023-08-06,607,table tennis table,20000,26500,6500,1,00426,India
756511,2023-08-06,604,tennis racket,1200,1800,600,1,00463,India
438525,2023-08-06,602,cricket ball,125,260,135,1,00431,India
438525,2023-08-06,608,football,298,1099,801,1,00431,India
438525,2023-08-06,605,badminton shuttlecocks,180,300,120,1,00431,India
438525,2023-08-06,607,table tennis table,20000,26500,6500,1,00431,India
116240,2023-08-06,606,badminton rackets,180,499,319,1,00223,India
116240,2023-08-06,601,cricket bat,400,1500,1100,1,00223,India
116240,2023-08-06,603,tennis ball,25,60,35,1,00223,India
669747,2023-08-06,611,helmet,200,400,200,1,00333,India
669747,2023-08-06,601,cricket bat,400,1500,1100,1,00333,India
349314,2023-08-06,607,table tennis table,20000,26500,6500,1,00449,India
934203,2023-08-07,606,badminton rackets,180,499,319,1,00073,India
122552,2023-08-07,611,helmet,200,400,200,1,00028,India
552315,2023-08-07,611,helmet,200,400,200,1,00485,India
552315,2023-08-07,606,badminton rackets,180,499,319,1,00485,India
552315,2023-08-07,607,table tennis table,20000,26500,6500,1,00485,India
883149,2023-08-08,610,golf clubs,27000,42000,15000,1,00472,India
883149,2023-08-08,611,helmet,200,400,200,1,00472,India
883149,2023-08-08,604,tennis racket,1200,1800,600,1,00472,India
715021,2023-08-08,610,golf clubs,27000,42000,15000,1,00023,India
715021,2023-08-08,601,cricket bat,400,1500,1100,1,00023,India
213812,2023-08-08,611,helmet,200,400,200,1,00215,India
213812,2023-08-08,609,basketball,298,679,381,1,00215,India
988676,2023-08-08,603,tennis ball,25,60,35,1,00011,India
988676,2023-08-08,609,basketball,298,679,381,1,00011,India
988676,2023-08-08,602,cricket ball,125,260,135,1,00011,India
988676,2023-08-08,605,badminton shuttlecocks,180,300,120,1,00011,India
712002,2023-08-09,609,basketball,298,679,381,1,00377,India
136587,2023-08-09,603,tennis ball,25,60,35,1,00132,India
136587,2023-08-09,606,badminton rackets,180,499,319,1,00132,India
136587,2023-08-09,604,tennis racket,1200,1800,600,1,00132,India
602379,2023-08-09,606,badminton rackets,180,499,319,1,00149,India
602379,2023-08-09,605,badminton shuttlecocks,180,300,120,1,00149,India
602379,2023-08-09,610,golf clubs,27000,42000,15000,1,00149,India
602379,2023-08-09,603,tennis ball,25,60,35,1,00149,India
525679,2023-08-09,605,badminton shuttlecocks,180,300,120,1,00409,India
525679,2023-08-09,611,helmet,200,400,200,1,00409,India
525679,2023-08-09,608,football,298,1099,801,1,00409,India
525679,2023-08-09,610,golf clubs,27000,42000,15000,1,00409,India
805242,2023-08-09,610,golf clubs,27000,42000,15000,1,00193,India
832451,2023-08-09,603,tennis ball,25,60,35,1,00374,India
253126,2023-08-09,601,cricket bat,400,1500,1100,1,00031,India
253126,2023-08-09,608,football,298,1099,801,1,00031,India
253126,2023-08-09,609,basketball,298,679,381,1,00031,India
253126,2023-08-09,603,tennis ball,25,60,35,1,00031,India
785002,2023-08-10,602,cricket ball,125,260,135,1,00037,India
785002,2023-08-10,608,football,298,1099,801,1,00037,India
785002,2023-08-10,609,basketball,298,679,381,1,00037,India
785002,2023-08-10,603,tennis ball,25,60,35,1,00037,India
785002,2023-08-10,610,golf clubs,27000,42000,15000,1,00037,India
889870,2023-08-10,606,badminton rackets,180,499,319,1,00298,India
889870,2023-08-10,609,basketball,298,679,381,1,00298,India
889870,2023-08-10,610,golf clubs,27000,42000,15000,1,00298,India
889870,2023-08-10,604,tennis racket,1200,1800,600,1,00298,India
382144,2023-08-10,605,badminton shuttlecocks,180,300,120,1,00036,India
382144,2023-08-10,610,golf clubs,27000,42000,15000,1,00036,India
382144,2023-08-10,611,helmet,200,400,200,1,00036,India
382144,2023-08-10,602,cricket ball,125,260,135,1,00036,India
382144,2023-08-10,608,football,298,1099,801,1,00036,India
268687,2023-08-10,605,badminton shuttlecocks,180,300,120,1,00360,India
374947,2023-08-10,611,helmet,200,400,200,1,00135,India
374947,2023-08-10,609,basketball,298,679,381,1,00135,India
223632,2023-08-10,609,basketball,298,679,381,1,00443,India
223632,2023-08-10,610,golf clubs,27000,42000,15000,1,00443,India
223632,2023-08-10,605,badminton shuttlecocks,180,300,120,1,00443,India
162447,2023-08-10,606,badminton rackets,180,499,319,1,00153,India
711332,2023-08-10,605,badminton shuttlecocks,180,300,120,1,00098,India
711332,2023-08-10,611,helmet,200,400,200,1,00098,India
614421,2023-08-10,611,helmet,200,400,200,1,00500,India
145825,2023-08-11,603,tennis ball,25,60,35,1,00307,India
145825,2023-08-11,608,football,298,1099,801,1,00307,India
145825,2023-08-11,602,cricket ball,125,260,135,1,00307,India
145825,2023-08-11,607,table tennis table,20000,26500,6500,1,00307,India
145825,2023-08-11,604,tennis racket,1200,1800,600,1,00307,India
802741,2023-08-11,611,helmet,200,400,200,1,00271,India
569717,2023-08-11,611,helmet,200,400,200,1,00208,India
569717,2023-08-11,605,badminton shuttlecocks,180,300,120,1,00208,India
569717,2023-08-11,610,golf clubs,27000,42000,15000,1,00208,India
208698,2023-08-11,611,helmet,200,400,200,1,00302,India
706420,2023-08-12,609,basketball,298,679,381,1,00193,India
706420,2023-08-12,611,helmet,200,400,200,1,00193,India
706420,2023-08-12,610,golf clubs,27000,42000,15000,1,00193,India
706420,2023-08-12,604,tennis racket,1200,1800,600,1,00193,India
515932,2023-08-12,605,badminton shuttlecocks,180,300,120,1,00120,India
515932,2023-08-12,604,tennis racket,1200,1800,600,1,00120,India
765186,2023-08-12,601,cricket bat,400,1500,1100,1,00458,India
589095,2023-08-13,606,badminton rackets,180,499,319,1,00004,India
589095,2023-08-13,604,tennis racket,1200,1800,600,1,00004,India
589095,2023-08-13,607,table tennis table,20000,26500,6500,1,00004,India
589095,2023-08-13,603,tennis ball,25,60,35,1,00004,India
502522,2023-08-13,610,golf clubs,27000,42000,15000,1,00429,India
502522,2023-08-13,607,table tennis table,20000,26500,6500,1,00429,India
405869,2023-08-13,607,table tennis table,20000,26500,6500,1,00147,India
672159,2023-08-13,604,tennis racket,1200,1800,600,1,00317,India
425236,2023-08-13,606,badminton rackets,180,499,319,1,00320,India
513391,2023-08-13,607,table tennis table,20000,26500,6500,1,00009,India
513391,2023-08-13,611,helmet,200,400,200,1,00009,India
170213,2023-08-13,610,golf clubs,27000,42000,15000,1,00141,India
170213,2023-08-13,602,cricket ball,125,260,135,1,00141,India
777388,2023-08-13,610,golf clubs,27000,42000,15000,1,00282,India
777388,2023-08-13,606,badminton rackets,180,499,319,1,00282,India
536272,2023-08-14,605,badminton shuttlecocks,180,300,120,1,00313,India
117938,2023-08-14,601,cricket bat,400,1500,1100,1,00080,India
117938,2023-08-14,602,cricket ball,125,260,135,1,00080,India
117938,2023-08-14,611,helmet,200,400,200,1,00080,India
117938,2023-08-14,607,table tennis table,20000,26500,6500,1,00080,India
117938,2023-08-14,605,badminton shuttlecocks,180,300,120,1,00080,India
267103,2023-08-14,603,tennis ball,25,60,35,1,00028,India
267103,2023-08-14,609,basketball,298,679,381,1,00028,India
344075,2023-08-14,604,tennis racket,1200,1800,600,1,00297,India
125186,2023-08-14,603,tennis ball,25,60,35,1,00426,India
839768,2023-08-14,611,helmet,200,400,200,1,00046,India
839768,2023-08-14,607,table tennis table,20000,26500,6500,1,00046,India
909078,2023-08-14,608,football,298,1099,801,1,00214,India
338667,2023-08-14,604,tennis racket,1200,1800,600,1,00047,India
262400,2023-08-14,604,tennis racket,1200,1800,600,1,00310,India
262400,2023-08-14,602,cricket ball,125,260,135,1,00310,India
262400,2023-08-14,601,cricket bat,400,1500,1100,1,00310,India
262400,2023-08-14,608,football,298,1099,801,1,00310,India
262400,2023-08-14,609,basketball,298,679,381,1,00310,India
594515,2023-08-15,608,football,298,1099,801,1,00489,India
594515,2023-08-15,605,badminton shuttlecocks,180,300,120,1,00489,India
796419,2023-08-15,611,helmet,200,400,200,1,00376,India
796419,2023-08-15,608,football,298,1099,801,1,00376,India
796419,2023-08-15,607,table tennis table,20000,26500,6500,1,00376,India
665517,2023-08-15,608,football,298,1099,801,1,00296,India
665517,2023-08-15,611,helmet,200,400,200,1,00296,India
388340,2023-08-15,607,table tennis table,20000,26500,6500,1,00144,India
743201,2023-08-15,610,golf clubs,27000,42000,15000,1,00202,India
743201,2023-08-15,603,tennis ball,25,60,35,1,00202,India
743201,2023-08-15,609,basketball,298,679,381,1,00202,India
743201,2023-08-15,601,cricket bat,400,1500,1100,1,00202,India
743201,2023-08-15,602,cricket ball,125,260,135,1,00202,India
395490,2023-08-15,604,tennis racket,1200,1800,600,1,00346,India
395490,2023-08-15,605,badminton shuttlecocks,180,300,120,1,00346,India
395490,2023-08-15,606,badminton rackets,180,499,319,1,00346,India
395490,2023-08-15,602,cricket ball,125,260,135,1,00346,India
381060,2023-08-15,603,tennis ball,25,60,35,1,00264,India
381060,2023-08-15,608,football,298,1099,801,1,00264,India
381060,2023-08-15,609,basketball,298,679,381,1,00264,India
381060,2023-08-15,606,badminton rackets,180,499,319,1,00264,India
278478,2023-08-15,609,basketball,298,679,381,1,00253,India
278478,2023-08-15,605,badminton shuttlecocks,180,300,120,1,00253,India
437743,2023-08-16,611,helmet,200,400,200,1,00092,India
564919,2023-08-16,601,cricket bat,400,1500,1100,1,00280,India
564919,2023-08-16,610,golf clubs,27000,42000,15000,1,00280,India
564919,2023-08-16,606,badminton rackets,180,499,319,1,00280,India
564919,2023-08-16,603,tennis ball,25,60,35,1,00280,India
564919,2023-08-16,604,tennis racket,1200,1800,600,1,00280,India
731943,2023-08-16,611,helmet,200,400,200,1,00321,India
731943,2023-08-16,601,cricket bat,400,1500,1100,1,00321,India
731943,2023-08-16,603,tennis ball,25,60,35,1,00321,India
731943,2023-08-16,608,football,298,1099,801,1,00321,India
704199,2023-08-16,608,football,298,1099,801,1,00430,India
704199,2023-08-16,609,basketball,298,679,381,1,00430,India
704199,2023-08-16,604,tennis racket,1200,1800,600,1,00430,India
182726,2023-08-16,605,badminton shuttlecocks,180,300,120,1,00180,India
182726,2023-08-16,601,cricket bat,400,1500,1100,1,00180,India
182726,2023-08-16,604,tennis racket,1200,1800,600,1,00180,India
182726,2023-08-16,607,table tennis table,20000,26500,6500,1,00180,India
657379,2023-08-16,610,golf clubs,27000,42000,15000,1,00295,India
966957,2023-08-16,608,football,298,1099,801,1,00354,India
966957,2023-08-16,610,golf clubs,27000,42000,15000,1,00354,India
966957,2023-08-16,602,cricket ball,125,260,135,1,00354,India
434514,2023-08-16,607,table tennis table,20000,26500,6500,1,00259,India
924443,2023-08-16,601,cricket bat,400,1500,1100,1,00382,India
924443,2023-08-16,603,tennis ball,25,60,35,1,00382,India
924443,2023-08-16,609,basketball,298,679,381,1,00382,India
924443,2023-08-16,605,badminton shuttlecocks,180,300,120,1,00382,India
657098,2023-08-16,601,cricket bat,400,1500,1100,1,00155,India
657098,2023-08-16,605,badminton shuttlecocks,180,300,120,1,00155,India
130831,2023-08-17,601,cricket bat,400,1500,1100,1,00413,India
188678,2023-08-17,611,helmet,200,400,200,1,00303,India
188678,2023-08-17,607,table tennis table,20000,26500,6500,1,00303,India
188678,2023-08-17,608,football,298,1099,801,1,00303,India
188678,2023-08-17,606,badminton rackets,180,499,319,1,00303,India
453486,2023-08-17,609,basketball,298,679,381,1,00446,India
453486,2023-08-17,607,table tennis table,20000,26500,6500,1,00446,India
352236,2023-08-17,603,tennis ball,25,60,35,1,00094,India
653235,2023-08-18,607,table tennis table,20000,26500,6500,1,00452,India
653235,2023-08-18,601,cricket bat,400,1500,1100,1,00452,India
329945,2023-08-18,604,tennis racket,1200,1800,600,1,00245,India
329945,2023-08-18,608,football,298,1099,801,1,00245,India
329945,2023-08-18,603,tennis ball,25,60,35,1,00245,India
329945,2023-08-18,601,cricket bat,400,1500,1100,1,00245,India
424411,2023-08-18,606,badminton rackets,180,499,319,1,00176,India
399075,2023-08-18,604,tennis racket,1200,1800,600,1,00211,India
399075,2023-08-18,601,cricket bat,400,1500,1100,1,00211,India
420222,2023-08-18,610,golf clubs,27000,42000,15000,1,00078,India
502515,2023-08-19,607,table tennis table,20000,26500,6500,1,00164,India
502515,2023-08-19,605,badminton shuttlecocks,180,300,120,1,00164,India
329752,2023-08-19,602,cricket ball,125,260,135,1,00034,India
796438,2023-08-19,611,helmet,200,400,200,1,00349,India
796438,2023-08-19,603,tennis ball,25,60,35,1,00349,India
796438,2023-08-19,610,golf clubs,27000,42000,15000,1,00349,India
536481,2023-08-19,611,helmet,200,400,200,1,00204,India
536481,2023-08-19,610,golf clubs,27000,42000,15000,1,00204,India
536481,2023-08-19,605,badminton shuttlecocks,180,300,120,1,00204,India
913031,2023-08-19,611,helmet,200,400,200,1,00316,India
480906,2023-08-19,609,basketball,298,679,381,1,00315,India
480906,2023-08-19,603,tennis ball,25,60,35,1,00315,India
480906,2023-08-19,607,table tennis table,20000,26500,6500,1,00315,India
480906,2023-08-19,605,badminton shuttlecocks,180,300,120,1,00315,India
480906,2023-08-19,604,tennis racket,1200,1800,600,1,00315,India
984032,2023-08-19,610,golf clubs,27000,42000,15000,1,00083,India
984032,2023-08-19,603,tennis ball,25,60,35,1,00083,India
848165,2023-08-19,611,helmet,200,400,200,1,00123,India
867502,2023-08-19,611,helmet,200,400,200,1,00260,India
197711,2023-08-20,611,helmet,200,400,200,1,00324,India
197711,2023-08-20,608,football,298,1099,801,1,00324,India
541448,2023-08-21,609,basketball,298,679,381,1,00325,India
541448,2023-08-21,605,badminton shuttlecocks,180,300,120,1,00325,India
541448,2023-08-21,608,football,298,1099,801,1,00325,India
797637,2023-08-21,611,helmet,200,400,200,1,00436,India
797637,2023-08-21,609,basketball,298,679,381,1,00436,India
797637,2023-08-21,607,table tennis table,20000,26500,6500,1,00436,India
490877,2023-08-21,605,badminton shuttlecocks,180,300,120,1,00069,India
490877,2023-08-21,607,table tennis table,20000,26500,6500,1,00069,India
490877,2023-08-21,604,tennis racket,1200,1800,600,1,00069,India
686758,2023-08-22,608,football,298,1099,801,1,00018,India
686758,2023-08-22,609,basketball,298,679,381,1,00018,India
249001,2023-08-22,602,cricket ball,125,260,135,1,00223,India
249001,2023-08-22,606,badminton rackets,180,499,319,1,00223,India
249001,2023-08-22,601,cricket bat,400,1500,1100,1,00223,India
249001,2023-08-22,609,basketball,298,679,381,1,00223,India
249001,2023-08-22,608,football,298,1099,801,1,00223,India
257431,2023-08-22,609,basketball,298,679,381,1,00056,India
257431,2023-08-22,601,cricket bat,400,1500,1100,1,00056,India
257431,2023-08-22,608,football,298,1099,801,1,00056,India
869127,2023-08-22,611,helmet,200,400,200,1,00473,India
869127,2023-08-22,604,tennis racket,1200,1800,600,1,00473,India
869127,2023-08-22,609,basketball,298,679,381,1,00473,India
572497,2023-08-22,608,football,298,1099,801,1,00223,India
572497,2023-08-22,607,table tennis table,20000,26500,6500,1,00223,India
572497,2023-08-22,606,badminton rackets,180,499,319,1,00223,India
572497,2023-08-22,604,tennis racket,1200,1800,600,1,00223,India
138943,2023-08-22,602,cricket ball,125,260,135,1,00360,India
138943,2023-08-22,608,football,298,1099,801,1,00360,India
319593,2023-08-22,607,table tennis table,20000,26500,6500,1,00261,India
319593,2023-08-22,604,tennis racket,1200,1800,600,1,00261,India
599700,2023-08-22,603,tennis ball,25,60,35,1,00094,India
599700,2023-08-22,601,cricket bat,400,1500,1100,1,00094,India
419604,2023-08-23,605,badminton shuttlecocks,180,300,120,1,00215,India
419604,2023-08-23,604,tennis racket,1200,1800,600,1,00215,India
896896,2023-08-23,610,golf clubs,27000,42000,15000,1,00025,India
896896,2023-08-23,601,cricket bat,400,1500,1100,1,00025,India
896896,2023-08-23,608,football,298,1099,801,1,00025,India
373117,2023-08-23,605,badminton shuttlecocks,180,300,120,1,00485,India
373117,2023-08-23,603,tennis ball,25,60,35,1,00485,India
373117,2023-08-23,610,golf clubs,27000,42000,15000,1,00485,India
484808,2023-08-23,607,table tennis table,20000,26500,6500,1,00232,India
484808,2023-08-23,609,basketball,298,679,381,1,00232,India
484808,2023-08-23,602,cricket ball,125,260,135,1,00232,India
951246,2023-08-23,606,badminton rackets,180,499,319,1,00259,India
951246,2023-08-23,604,tennis racket,1200,1800,600,1,00259,India
951246,2023-08-23,601,cricket bat,400,1500,1100,1,00259,India
610823,2023-08-24,605,badminton shuttlecocks,180,300,120,1,00143,India
610823,2023-08-24,610,golf clubs,27000,42000,15000,1,00143,India
184130,2023-08-24,607,table tennis table,20000,26500,6500,1,00366,India
184130,2023-08-24,602,cricket ball,125,260,135,1,00366,India
184130,2023-08-24,611,helmet,200,400,200,1,00366,India
184130,2023-08-24,603,tennis ball,25,60,35,1,00366,India
184130,2023-08-24,606,badminton rackets,180,499,319,1,00366,India
879791,2023-08-24,603,tennis ball,25,60,35,1,00104,India
879791,2023-08-24,607,table tennis table,20000,26500,6500,1,00104,India
892113,2023-08-24,605,badminton shuttlecocks,180,300,120,1,00326,India
892113,2023-08-24,604,tennis racket,1200,1800,600,1,00326,India
437542,2023-08-25,611,helmet,200,400,200,1,00094,India
437542,2023-08-25,610,golf clubs,27000,42000,15000,1,00094,India
437542,2023-08-25,601,cricket bat,400,1500,1100,1,00094,India
542432,2023-08-25,603,tennis ball,25,60,35,1,00456,India
542432,2023-08-25,602,cricket ball,125,260,135,1,00456,India
542432,2023-08-25,610,golf clubs,27000,42000,15000,1,00456,India
371208,2023-08-25,603,tennis ball,25,60,35,1,00203,India
371208,2023-08-25,608,football,298,1099,801,1,00203,India
371208,2023-08-25,606,badminton rackets,180,499,319,1,00203,India
371208,2023-08-25,610,golf clubs,27000,42000,15000,1,00203,India
371208,2023-08-25,611,helmet,200,400,200,1,00203,India
748620,2023-08-25,607,table tennis table,20000,26500,6500,1,00489,India
748620,2023-08-25,608,football,298,1099,801,1,00489,India
748620,2023-08-25,605,badminton shuttlecocks,180,300,120,1,00489,India
343577,2023-08-25,605,badminton shuttlecocks,180,300,120,1,00314,India
929923,2023-08-25,603,tennis ball,25,60,35,1,00429,India
929923,2023-08-25,609,basketball,298,679,381,1,00429,India
929923,2023-08-25,608,football,298,1099,801,1,00429,India
929923,2023-08-25,605,badminton shuttlecocks,180,300,120,1,00429,India
257551,2023-08-25,603,tennis ball,25,60,35,1,00014,India
991067,2023-08-25,609,basketball,298,679,381,1,00489,India
991067,2023-08-25,605,badminton shuttlecocks,180,300,120,1,00489,India
864632,2023-08-26,609,basketball,298,679,381,1,00247,India
864632,2023-08-26,611,helmet,200,400,200,1,00247,India
632098,2023-08-26,606,badminton rackets,180,499,319,1,00176,India
632098,2023-08-26,602,cricket ball,125,260,135,1,00176,India
632098,2023-08-26,611,helmet,200,400,200,1,00176,India
632098,2023-08-26,608,football,298,1099,801,1,00176,India
906825,2023-08-26,603,tennis ball,25,60,35,1,00405,India
906825,2023-08-26,606,badminton rackets,180,499,319,1,00405,India
906825,2023-08-26,611,helmet,200,400,200,1,00405,India
906825,2023-08-26,607,table tennis table,20000,26500,6500,1,00405,India
906825,2023-08-26,605,badminton shuttlecocks,180,300,120,1,00405,India
354129,2023-08-26,608,football,298,1099,801,1,00159,India
159877,2023-08-26,602,cricket ball,125,260,135,1,00128,India
588423,2023-08-27,610,golf clubs,27000,42000,15000,1,00327,India
872461,2023-08-27,602,cricket ball,125,260,135,1,00348,India
872461,2023-08-27,609,basketball,298,679,381,1,00348,India
493003,2023-08-27,607,table tennis table,20000,26500,6500,1,00253,India
493003,2023-08-27,610,golf clubs,27000,42000,15000,1,00253,India
493003,2023-08-27,602,cricket ball,125,260,135,1,00253,India
493003,2023-08-27,603,tennis ball,25,60,35,1,00253,India
431376,2023-08-27,607,table tennis table,20000,26500,6500,1,00465,India
431376,2023-08-27,608,football,298,1099,801,1,00465,India
431376,2023-08-27,609,basketball,298,679,381,1,00465,India
431376,2023-08-27,610,golf clubs,27000,42000,15000,1,00465,India
654575,2023-08-27,608,football,298,1099,801,1,00284,India
507735,2023-08-27,608,football,298,1099,801,1,00029,India
507735,2023-08-27,609,basketball,298,679,381,1,00029,India
507735,2023-08-27,604,tennis racket,1200,1800,600,1,00029,India
507735,2023-08-27,602,cricket ball,125,260,135,1,00029,India
632527,2023-08-28,603,tennis ball,25,60,35,1,00415,India
632527,2023-08-28,606,badminton rackets,180,499,319,1,00415,India
632527,2023-08-28,604,tennis racket,1200,1800,600,1,00415,India
140296,2023-08-30,604,tennis racket,1200,1800,600,1,00145,India
140296,2023-08-30,607,table tennis table,20000,26500,6500,1,00145,India
398894,2023-08-30,604,tennis racket,1200,1800,600,1,00025,India
398894,2023-08-30,603,tennis ball,25,60,35,1,00025,India
398894,2023-08-30,605,badminton shuttlecocks,180,300,120,1,00025,India
113165,2023-08-30,604,tennis racket,1200,1800,600,1,00152,India
235634,2023-08-30,606,badminton rackets,180,499,319,1,00471,India
235634,2023-08-30,610,golf clubs,27000,42000,15000,1,00471,India
235634,2023-08-30,608,football,298,1099,801,1,00471,India
154641,2023-08-30,607,table tennis table,20000,26500,6500,1,00012,India
154641,2023-08-30,604,tennis racket,1200,1800,600,1,00012,India
154641,2023-08-30,608,football,298,1099,801,1,00012,India
659089,2023-08-30,606,badminton rackets,180,499,319,1,00451,India
659089,2023-08-30,601,cricket bat,400,1500,1100,1,00451,India
456610,2023-08-31,607,table tennis table,20000,26500,6500,1,00191,India
456610,2023-08-31,605,badminton shuttlecocks,180,300,120,1,00191,India
456610,2023-08-31,608,football,298,1099,801,1,00191,India
278985,2023-08-31,611,helmet,200,400,200,1,00178,India
278985,2023-08-31,610,golf clubs,27000,42000,15000,1,00178,India
278985,2023-08-31,602,cricket ball,125,260,135,1,00178,India
278985,2023-08-31,608,football,298,1099,801,1,00178,India
732021,2023-08-31,604,tennis racket,1200,1800,600,1,00137,India
732021,2023-08-31,606,badminton rackets,180,499,319,1,00137,India
732021,2023-08-31,601,cricket bat,400,1500,1100,1,00137,India
732021,2023-08-31,607,table tennis table,20000,26500,6500,1,00137,India
265215,2023-08-31,601,cricket bat,400,1500,1100,1,00312,India
613412,2023-08-31,609,basketball,298,679,381,1,00307,India
613412,2023-08-31,602,cricket ball,125,260,135,1,00307,India
613412,2023-08-31,610,golf clubs,27000,42000,15000,1,00307,India
500062,2023-08-31,610,golf clubs,27000,42000,15000,1,00078,India
980734,2023-08-31,607,table tennis table,20000,26500,6500,1,00416,India
980734,2023-08-31,605,badminton shuttlecocks,180,300,120,1,00416,India
980734,2023-08-31,609,basketball,298,679,381,1,00416,India
980734,2023-08-31,601,cricket bat,400,1500,1100,1,00416,India
648739,2023-08-31,601,cricket bat,400,1500,1100,1,00408,India
648739,2023-08-31,606,badminton rackets,180,499,319,1,00408,India
554694,2023-08-31,610,golf clubs,27000,42000,15000,1,00372,India
554694,2023-08-31,609,basketball,298,679,381,1,00372,India
554694,2023-08-31,602,cricket ball,125,260,135,1,00372,India
995804,2023-09-01,607,table tennis table,20000,26500,6500,1,00285,India
724511,2023-09-01,609,basketball,298,679,381,1,00335,India
724511,2023-09-01,608,football,298,1099,801,1,00335,India
489040,2023-09-01,603,tennis ball,25,60,35,1,00318,India
489040,2023-09-01,605,badminton shuttlecocks,180,300,120,1,00318,India
129701,2023-09-01,606,badminton rackets,180,499,319,1,00311,India
129701,2023-09-01,601,cricket bat,400,1500,1100,1,00311,India
129701,2023-09-01,609,basketball,298,679,381,1,00311,India
129701,2023-09-01,610,golf clubs,27000,42000,15000,1,00311,India
867096,2023-09-01,601,cricket bat,400,1500,1100,1,00205,India
867096,2023-09-01,604,tennis racket,1200,1800,600,1,00205,India
867096,2023-09-01,608,football,298,1099,801,1,00205,India
587367,2023-09-01,609,basketball,298,679,381,1,00362,India
587367,2023-09-01,602,cricket ball,125,260,135,1,00362,India
665849,2023-09-02,605,badminton shuttlecocks,180,300,120,1,00172,India
897593,2023-09-02,606,badminton rackets,180,499,319,1,00129,India
831352,2023-09-02,601,cricket bat,400,1500,1100,1,00133,India
831352,2023-09-02,606,badminton rackets,180,499,319,1,00133,India
831352,2023-09-02,608,football,298,1099,801,1,00133,India
709618,2023-09-02,601,cricket bat,400,1500,1100,1,00236,India
709618,2023-09-02,611,helmet,200,400,200,1,00236,India
709618,2023-09-02,609,basketball,298,679,381,1,00236,India
709618,2023-09-02,604,tennis racket,1200,1800,600,1,00236,India
463437,2023-09-02,603,tennis ball,25,60,35,1,00333,India
821419,2023-09-02,610,golf clubs,27000,42000,15000,1,00461,India
821419,2023-09-02,602,cricket ball,125,260,135,1,00461,India
241625,2023-09-02,610,golf clubs,27000,42000,15000,1,00060,India
241625,2023-09-02,607,table tennis table,20000,26500,6500,1,00060,India
322426,2023-09-02,603,tennis ball,25,60,35,1,00484,India
322426,2023-09-02,609,basketball,298,679,381,1,00484,India
322426,2023-09-02,608,football,298,1099,801,1,00484,India
743285,2023-09-02,601,cricket bat,400,1500,1100,1,00452,India
743285,2023-09-02,605,badminton shuttlecocks,180,300,120,1,00452,India
743285,2023-09-02,609,basketball,298,679,381,1,00452,India
743285,2023-09-02,603,tennis ball,25,60,35,1,00452,India
687754,2023-09-02,604,tennis racket,1200,1800,600,1,00106,India
687754,2023-09-02,608,football,298,1099,801,1,00106,India
687754,2023-09-02,610,golf clubs,27000,42000,15000,1,00106,India
687754,2023-09-02,611,helmet,200,400,200,1,00106,India
421855,2023-09-03,607,table tennis table,20000,26500,6500,1,00002,India
404850,2023-09-03,603,tennis ball,25,60,35,1,00440,India
108781,2023-09-03,609,basketball,298,679,381,1,00076,India
108781,2023-09-03,601,cricket bat,400,1500,1100,1,00076,India
108781,2023-09-03,607,table tennis table,20000,26500,6500,1,00076,India
751543,2023-09-03,610,golf clubs,27000,42000,15000,1,00250,India
751543,2023-09-03,606,badminton rackets,180,499,319,1,00250,India
751543,2023-09-03,611,helmet,200,400,200,1,00250,India
356157,2023-09-03,606,badminton rackets,180,499,319,1,00021,India
356157,2023-09-03,603,tennis ball,25,60,35,1,00021,India
356157,2023-09-03,609,basketball,298,679,381,1,00021,India
356157,2023-09-03,602,cricket ball,125,260,135,1,00021,India
735939,2023-09-03,608,football,298,1099,801,1,00155,India
735939,2023-09-03,605,badminton shuttlecocks,180,300,120,1,00155,India
735939,2023-09-03,602,cricket ball,125,260,135,1,00155,India
513418,2023-09-03,602,cricket ball,125,260,135,1,00183,India
513418,2023-09-03,601,cricket bat,400,1500,1100,1,00183,India
513418,2023-09-03,606,badminton rackets,180,499,319,1,00183,India
587157,2023-09-03,601,cricket bat,400,1500,1100,1,00080,India
587157,2023-09-03,607,table tennis table,20000,26500,6500,1,00080,India
587157,2023-09-03,602,cricket ball,125,260,135,1,00080,India
646915,2023-09-03,602,cricket ball,125,260,135,1,00394,India
646915,2023-09-03,607,table tennis table,20000,26500,6500,1,00394,India
646915,2023-09-03,611,helmet,200,400,200,1,00394,India
572277,2023-09-03,611,helmet,200,400,200,1,00495,India
572277,2023-09-03,607,table tennis table,20000,26500,6500,1,00495,India
407594,2023-09-04,610,golf clubs,27000,42000,15000,1,00419,India
407594,2023-09-04,608,football,298,1099,801,1,00419,India
881342,2023-09-04,602,cricket ball,125,260,135,1,00399,India
881342,2023-09-04,606,badminton rackets,180,499,319,1,00399,India
526526,2023-09-04,611,helmet,200,400,200,1,00022,India
438103,2023-09-04,608,football,298,1099,801,1,00446,India
438103,2023-09-04,606,badminton rackets,180,499,319,1,00446,India
660238,2023-09-04,610,golf clubs,27000,42000,15000,1,00199,India
660238,2023-09-04,608,football,298,1099,801,1,00199,India
660238,2023-09-04,611,helmet,200,400,200,1,00199,India
660238,2023-09-04,609,basketball,298,679,381,1,00199,India
281318,2023-09-04,606,badminton rackets,180,499,319,1,00202,India
657863,2023-09-04,603,tennis ball,25,60,35,1,00225,India
657863,2023-09-04,610,golf clubs,27000,42000,15000,1,00225,India
820960,2023-09-04,608,football,298,1099,801,1,00149,India
820960,2023-09-04,605,badminton shuttlecocks,180,300,120,1,00149,India
946965,2023-09-05,606,badminton rackets,180,499,319,1,00316,India
946965,2023-09-05,611,helmet,200,400,200,1,00316,India
946965,2023-09-05,610,golf clubs,27000,42000,15000,1,00316,India
654982,2023-09-05,605,badminton shuttlecocks,180,300,120,1,00441,India
654982,2023-09-05,608,football,298,1099,801,1,00441,India
654982,2023-09-05,601,cricket bat,400,1500,1100,1,00441,India
654982,2023-09-05,604,tennis racket,1200,1800,600,1,00441,India
524482,2023-09-05,604,tennis racket,1200,1800,600,1,00211,India
524482,2023-09-05,607,table tennis table,20000,26500,6500,1,00211,India
524482,2023-09-05,605,badminton shuttlecocks,180,300,120,1,00211,India
524482,2023-09-05,610,golf clubs,27000,42000,15000,1,00211,India
865754,2023-09-05,604,tennis racket,1200,1800,600,1,00477,India
865754,2023-09-05,608,football,298,1099,801,1,00477,India
865754,2023-09-05,606,badminton rackets,180,499,319,1,00477,India
865754,2023-09-05,609,basketball,298,679,381,1,00477,India
983065,2023-09-05,611,helmet,200,400,200,1,00110,India
983065,2023-09-05,610,golf clubs,27000,42000,15000,1,00110,India
190650,2023-09-06,608,football,298,1099,801,1,00286,India
190650,2023-09-06,606,badminton rackets,180,499,319,1,00286,India
190650,2023-09-06,604,tennis racket,1200,1800,600,1,00286,India
905978,2023-09-06,608,football,298,1099,801,1,00144,India
905978,2023-09-06,607,table tennis table,20000,26500,6500,1,00144,India
905978,2023-09-06,604,tennis racket,1200,1800,600,1,00144,India
905978,2023-09-06,605,badminton shuttlecocks,180,300,120,1,00144,India
299033,2023-09-06,603,tennis ball,25,60,35,1,00421,India
299033,2023-09-06,609,basketball,298,679,381,1,00421,India
299033,2023-09-06,611,helmet,200,400,200,1,00421,India
299033,2023-09-06,604,tennis racket,1200,1800,600,1,00421,India
299033,2023-09-06,607,table tennis table,20000,26500,6500,1,00421,India
380041,2023-09-06,606,badminton rackets,180,499,319,1,00268,India
380041,2023-09-06,605,badminton shuttlecocks,180,300,120,1,00268,India
949648,2023-09-06,605,badminton shuttlecocks,180,300,120,1,00246,India
949648,2023-09-06,609,basketball,298,679,381,1,00246,India
434092,2023-09-06,604,tennis racket,1200,1800,600,1,00458,India
434092,2023-09-06,607,table tennis table,20000,26500,6500,1,00458,India
434092,2023-09-06,610,golf clubs,27000,42000,15000,1,00458,India
434092,2023-09-06,608,football,298,1099,801,1,00458,India
264427,2023-09-06,606,badminton rackets,180,499,319,1,00038,India
264427,2023-09-06,601,cricket bat,400,1500,1100,1,00038,India
191305,2023-09-06,607,table tennis table,20000,26500,6500,1,00275,India
191305,2023-09-06,610,golf clubs,27000,42000,15000,1,00275,India
191305,2023-09-06,608,football,298,1099,801,1,00275,India
191305,2023-09-06,611,helmet,200,400,200,1,00275,India
287755,2023-09-06,601,cricket bat,400,1500,1100,1,00168,India
109554,2023-09-06,603,tennis ball,25,60,35,1,00167,India
109554,2023-09-06,607,table tennis table,20000,26500,6500,1,00167,India
109554,2023-09-06,610,golf clubs,27000,42000,15000,1,00167,India
687515,2023-09-08,603,tennis ball,25,60,35,1,00487,India
687515,2023-09-08,602,cricket ball,125,260,135,1,00487,India
687515,2023-09-08,601,cricket bat,400,1500,1100,1,00487,India
687515,2023-09-08,606,badminton rackets,180,499,319,1,00487,India
952387,2023-09-08,608,football,298,1099,801,1,00374,India
952387,2023-09-08,604,tennis racket,1200,1800,600,1,00374,India
952387,2023-09-08,605,badminton shuttlecocks,180,300,120,1,00374,India
952387,2023-09-08,602,cricket ball,125,260,135,1,00374,India
850982,2023-09-08,605,badminton shuttlecocks,180,300,120,1,00149,India
850982,2023-09-08,610,golf clubs,27000,42000,15000,1,00149,India
850982,2023-09-08,603,tennis ball,25,60,35,1,00149,India
850982,2023-09-08,604,tennis racket,1200,1800,600,1,00149,India
454818,2023-09-08,604,tennis racket,1200,1800,600,1,00085,India
454818,2023-09-08,608,football,298,1099,801,1,00085,India
881153,2023-09-08,606,badminton rackets,180,499,319,1,00337,India
881153,2023-09-08,608,football,298,1099,801,1,00337,India
665669,2023-09-08,606,badminton rackets,180,499,319,1,00163,India
665669,2023-09-08,601,cricket bat,400,1500,1100,1,00163,India
665669,2023-09-08,604,tennis racket,1200,1800,600,1,00163,India
665669,2023-09-08,605,badminton shuttlecocks,180,300,120,1,00163,India
516667,2023-09-08,610,golf clubs,27000,42000,15000,1,00296,India
516667,2023-09-08,601,cricket bat,400,1500,1100,1,00296,India
516667,2023-09-08,602,cricket ball,125,260,135,1,00296,India
516667,2023-09-08,611,helmet,200,400,200,1,00296,India
169128,2023-09-08,605,badminton shuttlecocks,180,300,120,1,00455,India
169128,2023-09-08,609,basketball,298,679,381,1,00455,India
169128,2023-09-08,604,tennis racket,1200,1800,600,1,00455,India
169128,2023-09-08,607,table tennis table,20000,26500,6500,1,00455,India
181565,2023-09-08,601,cricket bat,400,1500,1100,1,00470,India
639462,2023-09-08,604,tennis racket,1200,1800,600,1,00016,India
639462,2023-09-08,605,badminton shuttlecocks,180,300,120,1,00016,India
639462,2023-09-08,611,helmet,200,400,200,1,00016,India
528696,2023-09-09,611,helmet,200,400,200,1,00040,India
340704,2023-09-09,609,basketball,298,679,381,1,00047,India
340704,2023-09-09,606,badminton rackets,180,499,319,1,00047,India
340704,2023-09-09,603,tennis ball,25,60,35,1,00047,India
950119,2023-09-09,601,cricket bat,400,1500,1100,1,00077,India
950119,2023-09-09,611,helmet,200,400,200,1,00077,India
950119,2023-09-09,603,tennis ball,25,60,35,1,00077,India
146189,2023-09-09,610,golf clubs,27000,42000,15000,1,00102,India
146189,2023-09-09,604,tennis racket,1200,1800,600,1,00102,India
146189,2023-09-09,606,badminton rackets,180,499,319,1,00102,India
146189,2023-09-09,602,cricket ball,125,260,135,1,00102,India
274478,2023-09-09,606,badminton rackets,180,499,319,1,00073,India
274478,2023-09-09,604,tennis racket,1200,1800,600,1,00073,India
274478,2023-09-09,605,badminton shuttlecocks,180,300,120,1,00073,India
341757,2023-09-09,609,basketball,298,679,381,1,00129,India
341757,2023-09-09,607,table tennis table,20000,26500,6500,1,00129,India
341757,2023-09-09,606,badminton rackets,180,499,319,1,00129,India
661278,2023-09-09,606,badminton rackets,180,499,319,1,00383,India
661278,2023-09-09,604,tennis racket,1200,1800,600,1,00383,India
661278,2023-09-09,605,badminton shuttlecocks,180,300,120,1,00383,India
812597,2023-09-09,602,cricket ball,125,260,135,1,00194,India
812597,2023-09-09,604,tennis racket,1200,1800,600,1,00194,India
812597,2023-09-09,607,table tennis table,20000,26500,6500,1,00194,India
745999,2023-09-10,602,cricket ball,125,260,135,1,00019,India
745999,2023-09-10,605,badminton shuttlecocks,180,300,120,1,00019,India
745999,2023-09-10,601,cricket bat,400,1500,1100,1,00019,India
334807,2023-09-10,606,badminton rackets,180,499,319,1,00043,India
334807,2023-09-10,609,basketball,298,679,381,1,00043,India
334807,2023-09-10,604,tennis racket,1200,1800,600,1,00043,India
786562,2023-09-10,604,tennis racket,1200,1800,600,1,00318,India
786562,2023-09-10,608,football,298,1099,801,1,00318,India
150310,2023-09-10,604,tennis racket,1200,1800,600,1,00010,India
150310,2023-09-10,605,badminton shuttlecocks,180,300,120,1,00010,India
150310,2023-09-10,607,table tennis table,20000,26500,6500,1,00010,India
244982,2023-09-10,606,badminton rackets,180,499,319,1,00369,India
244982,2023-09-10,611,helmet,200,400,200,1,00369,India
244982,2023-09-10,610,golf clubs,27000,42000,15000,1,00369,India
256549,2023-09-10,609,basketball,298,679,381,1,00071,India
256549,2023-09-10,603,tennis ball,25,60,35,1,00071,India
256549,2023-09-10,601,cricket bat,400,1500,1100,1,00071,India
256549,2023-09-10,602,cricket ball,125,260,135,1,00071,India
355494,2023-09-10,608,football,298,1099,801,1,00477,India
355494,2023-09-10,611,helmet,200,400,200,1,00477,India
355494,2023-09-10,601,cricket bat,400,1500,1100,1,00477,India
465400,2023-09-10,609,basketball,298,679,381,1,00222,India
465400,2023-09-10,604,tennis racket,1200,1800,600,1,00222,India
465400,2023-09-10,601,cricket bat,400,1500,1100,1,00222,India
465400,2023-09-10,611,helmet,200,400,200,1,00222,India
895050,2023-09-11,605,badminton shuttlecocks,180,300,120,1,00461,India
936442,2023-09-11,610,golf clubs,27000,42000,15000,1,00076,India
936442,2023-09-11,606,badminton rackets,180,499,319,1,00076,India
627372,2023-09-12,603,tennis ball,25,60,35,1,00118,India
627372,2023-09-12,611,helmet,200,400,200,1,00118,India
627372,2023-09-12,604,tennis racket,1200,1800,600,1,00118,India
627372,2023-09-12,606,badminton rackets,180,499,319,1,00118,India
717618,2023-09-12,609,basketball,298,679,381,1,00178,India
780814,2023-09-12,611,helmet,200,400,200,1,00211,India
780814,2023-09-12,601,cricket bat,400,1500,1100,1,00211,India
780814,2023-09-12,610,golf clubs,27000,42000,15000,1,00211,India
249988,2023-09-12,608,football,298,1099,801,1,00009,India
771346,2023-09-12,610,golf clubs,27000,42000,15000,1,00071,India
141995,2023-09-12,607,table tennis table,20000,26500,6500,1,00401,India
141995,2023-09-12,603,tennis ball,25,60,35,1,00401,India
689135,2023-09-13,607,table tennis table,20000,26500,6500,1,00454,India
689135,2023-09-13,602,cricket ball,125,260,135,1,00454,India
689135,2023-09-13,605,badminton shuttlecocks,180,300,120,1,00454,India
188840,2023-09-13,605,badminton shuttlecocks,180,300,120,1,00253,India
979813,2023-09-13,609,basketball,298,679,381,1,00357,India
148658,2023-09-13,607,table tennis table,20000,26500,6500,1,00304,India
148658,2023-09-13,606,badminton rackets,180,499,319,1,00304,India
148658,2023-09-13,602,cricket ball,125,260,135,1,00304,India
395328,2023-09-13,604,tennis racket,1200,1800,600,1,00134,India
395328,2023-09-13,606,badminton rackets,180,499,319,1,00134,India
403689,2023-09-15,608,football,298,1099,801,1,00438,India
403689,2023-09-15,610,golf clubs,27000,42000,15000,1,00438,India
403689,2023-09-15,609,basketball,298,679,381,1,00438,India
753876,2023-09-15,604,tennis racket,1200,1800,600,1,00150,India
753876,2023-09-15,610,golf clubs,27000,42000,15000,1,00150,India
753876,2023-09-15,609,basketball,298,679,381,1,00150,India
747467,2023-09-15,608,football,298,1099,801,1,00102,India
747467,2023-09-15,611,helmet,200,400,200,1,00102,India
747467,2023-09-15,606,badminton rackets,180,499,319,1,00102,India
234084,2023-09-15,611,helmet,200,400,200,1,00341,India
234084,2023-09-15,608,football,298,1099,801,1,00341,India
204861,2023-09-15,610,golf clubs,27000,42000,15000,1,00153,India
204861,2023-09-15,602,cricket ball,125,260,135,1,00153,India
204861,2023-09-15,604,tennis racket,1200,1800,600,1,00153,India
204861,2023-09-15,601,cricket bat,400,1500,1100,1,00153,India
849053,2023-09-15,609,basketball,298,679,381,1,00353,India
849053,2023-09-15,608,football,298,1099,801,1,00353,India
654427,2023-09-16,606,badminton rackets,180,499,319,1,00081,India
654427,2023-09-16,605,badminton shuttlecocks,180,300,120,1,00081,India
668696,2023-09-17,610,golf clubs,27000,42000,15000,1,00297,India
668696,2023-09-17,609,basketball,298,679,381,1,00297,India
139563,2023-09-18,611,helmet,200,400,200,1,00039,India
139563,2023-09-18,601,cricket bat,400,1500,1100,1,00039,India
559974,2023-09-18,608,football,298,1099,801,1,00458,India
559974,2023-09-18,602,cricket ball,125,260,135,1,00458,India
559974,2023-09-18,611,helmet,200,400,200,1,00458,India
787348,2023-09-18,611,helmet,200,400,200,1,00201,India
787348,2023-09-18,601,cricket bat,400,1500,1100,1,00201,India
786162,2023-09-18,605,badminton shuttlecocks,180,300,120,1,00461,India
132404,2023-09-18,603,tennis ball,25,60,35,1,00498,India
132404,2023-09-18,605,badminton shuttlecocks,180,300,120,1,00498,India
132404,2023-09-18,608,football,298,1099,801,1,00498,India
132404,2023-09-18,607,table tennis table,20000,26500,6500,1,00498,India
132404,2023-09-18,604,tennis racket,1200,1800,600,1,00498,India
215487,2023-09-18,606,badminton rackets,180,499,319,1,00361,India
215487,2023-09-18,605,badminton shuttlecocks,180,300,120,1,00361,India
626214,2023-09-18,611,helmet,200,400,200,1,00174,India
626214,2023-09-18,601,cricket bat,400,1500,1100,1,00174,India
972756,2023-09-18,608,football,298,1099,801,1,00193,India
972756,2023-09-18,604,tennis racket,1200,1800,600,1,00193,India
452358,2023-09-19,610,golf clubs,27000,42000,15000,1,00425,India
452358,2023-09-19,606,badminton rackets,180,499,319,1,00425,India
452358,2023-09-19,607,table tennis table,20000,26500,6500,1,00425,India
452358,2023-09-19,609,basketball,298,679,381,1,00425,India
646177,2023-09-19,608,football,298,1099,801,1,00479,India
526704,2023-09-19,604,tennis racket,1200,1800,600,1,00059,India
526704,2023-09-19,601,cricket bat,400,1500,1100,1,00059,India
526704,2023-09-19,610,golf clubs,27000,42000,15000,1,00059,India
400663,2023-09-19,605,badminton shuttlecocks,180,300,120,1,00031,India
400663,2023-09-19,611,helmet,200,400,200,1,00031,India
400663,2023-09-19,604,tennis racket,1200,1800,600,1,00031,India
400663,2023-09-19,608,football,298,1099,801,1,00031,India
247430,2023-09-19,610,golf clubs,27000,42000,15000,1,00077,India
247430,2023-09-19,606,badminton rackets,180,499,319,1,00077,India
247430,2023-09-19,607,table tennis table,20000,26500,6500,1,00077,India
461638,2023-09-19,602,cricket ball,125,260,135,1,00386,India
461638,2023-09-19,611,helmet,200,400,200,1,00386,India
491905,2023-09-20,609,basketball,298,679,381,1,00241,India
491905,2023-09-20,611,helmet,200,400,200,1,00241,India
491905,2023-09-20,603,tennis ball,25,60,35,1,00241,India
491905,2023-09-20,602,cricket ball,125,260,135,1,00241,India
337523,2023-09-20,610,golf clubs,27000,42000,15000,1,00311,India
337523,2023-09-20,606,badminton rackets,180,499,319,1,00311,India
337523,2023-09-20,604,tennis racket,1200,1800,600,1,00311,India
337523,2023-09-20,607,table tennis table,20000,26500,6500,1,00311,India
337523,2023-09-20,603,tennis ball,25,60,35,1,00311,India
424095,2023-09-20,605,badminton shuttlecocks,180,300,120,1,00054,India
553514,2023-09-20,606,badminton rackets,180,499,319,1,00488,India
553514,2023-09-20,609,basketball,298,679,381,1,00488,India
553514,2023-09-20,610,golf clubs,27000,42000,15000,1,00488,India
688158,2023-09-21,609,basketball,298,679,381,1,00315,India
916679,2023-09-21,611,helmet,200,400,200,1,00056,India
916679,2023-09-21,601,cricket bat,400,1500,1100,1,00056,India
916679,2023-09-21,606,badminton rackets,180,499,319,1,00056,India
381192,2023-09-21,608,football,298,1099,801,1,00096,India
381192,2023-09-21,610,golf clubs,27000,42000,15000,1,00096,India
718818,2023-09-21,608,football,298,1099,801,1,00445,India
448102,2023-09-22,606,badminton rackets,180,499,319,1,00168,India
308578,2023-09-22,604,tennis racket,1200,1800,600,1,00123,India
308578,2023-09-22,601,cricket bat,400,1500,1100,1,00123,India
308578,2023-09-22,608,football,298,1099,801,1,00123,India
308578,2023-09-22,606,badminton rackets,180,499,319,1,00123,India
541766,2023-09-22,609,basketball,298,679,381,1,00470,India
820207,2023-09-22,610,golf clubs,27000,42000,15000,1,00032,India
820207,2023-09-22,603,tennis ball,25,60,35,1,00032,India
447826,2023-09-22,605,badminton shuttlecocks,180,300,120,1,00468,India
447826,2023-09-22,608,football,298,1099,801,1,00468,India
278523,2023-09-22,602,cricket ball,125,260,135,1,00484,India
673782,2023-09-22,603,tennis ball,25,60,35,1,00342,India
673782,2023-09-22,604,tennis racket,1200,1800,600,1,00342,India
835156,2023-09-23,611,helmet,200,400,200,1,00129,India
835156,2023-09-23,601,cricket bat,400,1500,1100,1,00129,India
835156,2023-09-23,602,cricket ball,125,260,135,1,00129,India
835156,2023-09-23,605,badminton shuttlecocks,180,300,120,1,00129,India
835156,2023-09-23,604,tennis racket,1200,1800,600,1,00129,India
214038,2023-09-23,602,cricket ball,125,260,135,1,00205,India
214038,2023-09-23,608,football,298,1099,801,1,00205,India
214038,2023-09-23,609,basketball,298,679,381,1,00205,India
360793,2023-09-23,609,basketball,298,679,381,1,00442,India
958068,2023-09-23,608,football,298,1099,801,1,00273,India
958068,2023-09-23,609,basketball,298,679,381,1,00273,India
958068,2023-09-23,603,tennis ball,25,60,35,1,00273,India
455035,2023-09-24,611,helmet,200,400,200,1,00351,India
352100,2023-09-24,605,badminton shuttlecocks,180,300,120,1,00325,India
352100,2023-09-24,607,table tennis table,20000,26500,6500,1,00325,India
352100,2023-09-24,601,cricket bat,400,1500,1100,1,00325,India
352100,2023-09-24,609,basketball,298,679,381,1,00325,India
489201,2023-09-24,602,cricket ball,125,260,135,1,00268,India
489201,2023-09-24,604,tennis racket,1200,1800,600,1,00268,India
545759,2023-09-24,607,table tennis table,20000,26500,6500,1,00011,India
545759,2023-09-24,605,badminton shuttlecocks,180,300,120,1,00011,India
545759,2023-09-24,603,tennis ball,25,60,35,1,00011,India
917690,2023-09-24,603,tennis ball,25,60,35,1,00383,India
917690,2023-09-24,606,badminton rackets,180,499,319,1,00383,India
917690,2023-09-24,602,cricket ball,125,260,135,1,00383,India
917690,2023-09-24,607,table tennis table,20000,26500,6500,1,00383,India
960089,2023-09-24,602,cricket ball,125,260,135,1,00446,India
960089,2023-09-24,601,cricket bat,400,1500,1100,1,00446,India
960089,2023-09-24,611,helmet,200,400,200,1,00446,India
960089,2023-09-24,605,badminton shuttlecocks,180,300,120,1,00446,India
920146,2023-09-24,601,cricket bat,400,1500,1100,1,00194,India
920146,2023-09-24,603,tennis ball,25,60,35,1,00194,India
569363,2023-09-24,601,cricket bat,400,1500,1100,1,00006,India
569363,2023-09-24,605,badminton shuttlecocks,180,300,120,1,00006,India
969343,2023-09-24,603,tennis ball,25,60,35,1,00246,India
969343,2023-09-24,602,cricket ball,125,260,135,1,00246,India
929415,2023-09-25,610,golf clubs,27000,42000,15000,1,00264,India
402608,2023-09-25,601,cricket bat,400,1500,1100,1,00030,India
402608,2023-09-25,607,table tennis table,20000,26500,6500,1,00030,India
402608,2023-09-25,602,cricket ball,125,260,135,1,00030,India
983702,2023-09-26,609,basketball,298,679,381,1,00012,India
983702,2023-09-26,605,badminton shuttlecocks,180,300,120,1,00012,India
983702,2023-09-26,604,tennis racket,1200,1800,600,1,00012,India
983702,2023-09-26,603,tennis ball,25,60,35,1,00012,India
102723,2023-09-26,607,table tennis table,20000,26500,6500,1,00091,India
102723,2023-09-26,606,badminton rackets,180,499,319,1,00091,India
102723,2023-09-26,602,cricket ball,125,260,135,1,00091,India
102723,2023-09-26,608,football,298,1099,801,1,00091,India
302261,2023-09-26,606,badminton rackets,180,499,319,1,00492,India
962667,2023-09-26,602,cricket ball,125,260,135,1,00404,India
805711,2023-09-26,602,cricket ball,125,260,135,1,00376,India
805711,2023-09-26,606,badminton rackets,180,499,319,1,00376,India
805711,2023-09-26,608,football,298,1099,801,1,00376,India
970534,2023-09-26,601,cricket bat,400,1500,1100,1,00075,India
970534,2023-09-26,603,tennis ball,25,60,35,1,00075,India
970534,2023-09-26,609,basketball,298,679,381,1,00075,India
970534,2023-09-26,604,tennis racket,1200,1800,600,1,00075,India
648716,2023-09-26,610,golf clubs,27000,42000,15000,1,00237,India
119410,2023-09-26,607,table tennis table,20000,26500,6500,1,00320,India
119410,2023-09-26,601,cricket bat,400,1500,1100,1,00320,India
119410,2023-09-26,609,basketball,298,679,381,1,00320,India
854954,2023-09-26,601,cricket bat,400,1500,1100,1,00274,India
889480,2023-09-27,602,cricket ball,125,260,135,1,00187,India
889480,2023-09-27,605,badminton shuttlecocks,180,300,120,1,00187,India
889480,2023-09-27,609,basketball,298,679,381,1,00187,India
889480,2023-09-27,607,table tennis table,20000,26500,6500,1,00187,India
640916,2023-09-27,607,table tennis table,20000,26500,6500,1,00277,India
640916,2023-09-27,608,football,298,1099,801,1,00277,India
972481,2023-09-27,611,helmet,200,400,200,1,00006,India
972481,2023-09-27,610,golf clubs,27000,42000,15000,1,00006,India
248755,2023-09-27,605,badminton shuttlecocks,180,300,120,1,00379,India
248755,2023-09-27,608,football,298,1099,801,1,00379,India
132282,2023-09-27,605,badminton shuttlecocks,180,300,120,1,00383,India
782667,2023-09-27,607,table tennis table,20000,26500,6500,1,00423,India
782667,2023-09-27,601,cricket bat,400,1500,1100,1,00423,India
782667,2023-09-27,609,basketball,298,679,381,1,00423,India
482755,2023-09-27,604,tennis racket,1200,1800,600,1,00465,India
482755,2023-09-27,601,cricket bat,400,1500,1100,1,00465,India
482755,2023-09-27,608,football,298,1099,801,1,00465,India
471699,2023-09-28,611,helmet,200,400,200,1,00086,India
471699,2023-09-28,610,golf clubs,27000,42000,15000,1,00086,India
471699,2023-09-28,605,badminton shuttlecocks,180,300,120,1,00086,India
914578,2023-09-28,601,cricket bat,400,1500,1100,1,00223,India
914578,2023-09-28,607,table tennis table,20000,26500,6500,1,00223,India
914578,2023-09-28,611,helmet,200,400,200,1,00223,India
914578,2023-09-28,609,basketball,298,679,381,1,00223,India
109878,2023-09-28,608,football,298,1099,801,1,00389,India
109878,2023-09-28,602,cricket ball,125,260,135,1,00389,India
179326,2023-09-29,604,tennis racket,1200,1800,600,1,00332,India
179326,2023-09-29,605,badminton shuttlecocks,180,300,120,1,00332,India
179326,2023-09-29,607,table tennis table,20000,26500,6500,1,00332,India
681535,2023-09-29,601,cricket bat,400,1500,1100,1,00140,India
913055,2023-09-29,608,football,298,1099,801,1,00340,India
954380,2023-09-29,607,table tennis table,20000,26500,6500,1,00016,India
954380,2023-09-29,609,basketball,298,679,381,1,00016,India
833633,2023-09-29,605,badminton shuttlecocks,180,300,120,1,00046,India
833633,2023-09-29,601,cricket bat,400,1500,1100,1,00046,India
833633,2023-09-29,607,table tennis table,20000,26500,6500,1,00046,India
833633,2023-09-29,602,cricket ball,125,260,135,1,00046,India
993996,2023-09-29,601,cricket bat,400,1500,1100,1,00444,India
993996,2023-09-29,607,table tennis table,20000,26500,6500,1,00444,India
623734,2023-09-30,605,badminton shuttlecocks,180,300,120,1,00245,India
160867,2023-09-30,607,table tennis table,20000,26500,6500,1,00213,India
160867,2023-09-30,602,cricket ball,125,260,135,1,00213,India
570893,2023-09-30,601,cricket bat,400,1500,1100,1,00215,India
570893,2023-09-30,606,badminton rackets,180,499,319,1,00215,India
791356,2023-09-30,607,table tennis table,20000,26500,6500,1,00232,India
791356,2023-09-30,606,badminton rackets,180,499,319,1,00232,India
791356,2023-09-30,609,basketball,298,679,381,1,00232,India
805459,2023-09-30,602,cricket ball,125,260,135,1,00425,India
805459,2023-09-30,609,basketball,298,679,381,1,00425,India
995089,2023-09-30,609,basketball,298,679,381,1,00082,India
995089,2023-09-30,601,cricket bat,400,1500,1100,1,00082,India
995089,2023-09-30,606,badminton rackets,180,499,319,1,00082,India
995089,2023-09-30,603,tennis ball,25,60,35,1,00082,India
958444,2023-09-30,606,badminton rackets,180,499,319,1,00113,India
958444,2023-09-30,601,cricket bat,400,1500,1100,1,00113,India
958444,2023-09-30,603,tennis ball,25,60,35,1,00113,India
146754,2023-09-30,601,cricket bat,400,1500,1100,1,00208,India
146754,2023-09-30,609,basketball,298,679,381,1,00208,India
478343,2023-09-30,601,cricket bat,400,1500,1100,1,00323,India
675740,2023-10-01,610,golf clubs,27000,42000,15000,1,00219,India
675740,2023-10-01,605,badminton shuttlecocks,180,300,120,1,00219,India
799226,2023-10-01,604,tennis racket,1200,1800,600,1,00075,India
799226,2023-10-01,605,badminton shuttlecocks,180,300,120,1,00075,India
175360,2023-10-01,607,table tennis table,20000,26500,6500,1,00304,India
563879,2023-10-01,606,badminton rackets,180,499,319,1,00021,India
563879,2023-10-01,608,football,298,1099,801,1,00021,India
563879,2023-10-01,605,badminton shuttlecocks,180,300,120,1,00021,India
991142,2023-10-02,608,football,298,1099,801,1,00455,India
251209,2023-10-02,606,badminton rackets,180,499,319,1,00004,India
493250,2023-10-02,604,tennis racket,1200,1800,600,1,00013,India
392939,2023-10-02,606,badminton rackets,180,499,319,1,00087,India
392939,2023-10-02,607,table tennis table,20000,26500,6500,1,00087,India
392939,2023-10-02,609,basketball,298,679,381,1,00087,India
579964,2023-10-02,603,tennis ball,25,60,35,1,00496,India
579964,2023-10-02,608,football,298,1099,801,1,00496,India
579964,2023-10-02,607,table tennis table,20000,26500,6500,1,00496,India
436321,2023-10-03,601,cricket bat,400,1500,1100,1,00376,India
436321,2023-10-03,606,badminton rackets,180,499,319,1,00376,India
858547,2023-10-03,608,football,298,1099,801,1,00001,India
897022,2023-10-03,607,table tennis table,20000,26500,6500,1,00352,India
897022,2023-10-03,605,badminton shuttlecocks,180,300,120,1,00352,India
856274,2023-10-03,604,tennis racket,1200,1800,600,1,00413,India
856274,2023-10-03,609,basketball,298,679,381,1,00413,India
712515,2023-10-03,611,helmet,200,400,200,1,00234,India
498921,2023-10-03,602,cricket ball,125,260,135,1,00214,India
177662,2023-10-03,602,cricket ball,125,260,135,1,00084,India
177662,2023-10-03,610,golf clubs,27000,42000,15000,1,00084,India
703106,2023-10-03,607,table tennis table,20000,26500,6500,1,00154,India
703106,2023-10-03,609,basketball,298,679,381,1,00154,India
703106,2023-10-03,606,badminton rackets,180,499,319,1,00154,India
703106,2023-10-03,603,tennis ball,25,60,35,1,00154,India
728086,2023-10-03,610,golf clubs,27000,42000,15000,1,00375,India
728086,2023-10-03,606,badminton rackets,180,499,319,1,00375,India
674648,2023-10-04,602,cricket ball,125,260,135,1,00294,India
267347,2023-10-04,606,badminton rackets,180,499,319,1,00259,India
267347,2023-10-04,607,table tennis table,20000,26500,6500,1,00259,India
267347,2023-10-04,605,badminton shuttlecocks,180,300,120,1,00259,India
835130,2023-10-04,606,badminton rackets,180,499,319,1,00054,India
835130,2023-10-04,604,tennis racket,1200,1800,600,1,00054,India
835130,2023-10-04,607,table tennis table,20000,26500,6500,1,00054,India
657325,2023-10-04,603,tennis ball,25,60,35,1,00436,India
657325,2023-10-04,601,cricket bat,400,1500,1100,1,00436,India
657325,2023-10-04,606,badminton rackets,180,499,319,1,00436,India
435810,2023-10-04,605,badminton shuttlecocks,180,300,120,1,00064,India
435810,2023-10-04,606,badminton rackets,180,499,319,1,00064,India
435810,2023-10-04,604,tennis racket,1200,1800,600,1,00064,India
202225,2023-10-04,606,badminton rackets,180,499,319,1,00206,India
202225,2023-10-04,608,football,298,1099,801,1,00206,India
202225,2023-10-04,610,golf clubs,27000,42000,15000,1,00206,India
578505,2023-10-04,606,badminton rackets,180,499,319,1,00217,India
578505,2023-10-04,607,table tennis table,20000,26500,6500,1,00217,India
326778,2023-10-04,606,badminton rackets,180,499,319,1,00493,India
389460,2023-10-04,601,cricket bat,400,1500,1100,1,00262,India
389460,2023-10-04,604,tennis racket,1200,1800,600,1,00262,India
389460,2023-10-04,603,tennis ball,25,60,35,1,00262,India
697844,2023-10-05,601,cricket bat,400,1500,1100,1,00012,India
880761,2023-10-05,604,tennis racket,1200,1800,600,1,00308,India
880761,2023-10-05,611,helmet,200,400,200,1,00308,India
880761,2023-10-05,602,cricket ball,125,260,135,1,00308,India
645209,2023-10-05,609,basketball,298,679,381,1,00124,India
645209,2023-10-05,608,football,298,1099,801,1,00124,India
480524,2023-10-05,601,cricket bat,400,1500,1100,1,00455,India
480524,2023-10-05,609,basketball,298,679,381,1,00455,India
916181,2023-10-05,609,basketball,298,679,381,1,00361,India
916181,2023-10-05,602,cricket ball,125,260,135,1,00361,India
970595,2023-10-06,611,helmet,200,400,200,1,00205,India
196277,2023-10-06,602,cricket ball,125,260,135,1,00228,India
196277,2023-10-06,607,table tennis table,20000,26500,6500,1,00228,India
196277,2023-10-06,601,cricket bat,400,1500,1100,1,00228,India
567944,2023-10-06,602,cricket ball,125,260,135,1,00174,India
567944,2023-10-06,604,tennis racket,1200,1800,600,1,00174,India
567944,2023-10-06,607,table tennis table,20000,26500,6500,1,00174,India
567944,2023-10-06,606,badminton rackets,180,499,319,1,00174,India
567944,2023-10-06,611,helmet,200,400,200,1,00174,India
512764,2023-10-06,604,tennis racket,1200,1800,600,1,00289,India
512764,2023-10-06,608,football,298,1099,801,1,00289,India
502060,2023-10-06,603,tennis ball,25,60,35,1,00303,India
502060,2023-10-06,602,cricket ball,125,260,135,1,00303,India
723247,2023-10-06,609,basketball,298,679,381,1,00174,India
723247,2023-10-06,607,table tennis table,20000,26500,6500,1,00174,India
723247,2023-10-06,605,badminton shuttlecocks,180,300,120,1,00174,India
723247,2023-10-06,603,tennis ball,25,60,35,1,00174,India
558420,2023-10-06,606,badminton rackets,180,499,319,1,00484,India
558420,2023-10-06,608,football,298,1099,801,1,00484,India
334929,2023-10-06,605,badminton shuttlecocks,180,300,120,1,00051,India
334929,2023-10-06,609,basketball,298,679,381,1,00051,India
334929,2023-10-06,602,cricket ball,125,260,135,1,00051,India
564136,2023-10-06,610,golf clubs,27000,42000,15000,1,00375,India
975495,2023-10-07,602,cricket ball,125,260,135,1,00072,India
975495,2023-10-07,601,cricket bat,400,1500,1100,1,00072,India
975495,2023-10-07,605,badminton shuttlecocks,180,300,120,1,00072,India
975495,2023-10-07,607,table tennis table,20000,26500,6500,1,00072,India
480413,2023-10-07,608,football,298,1099,801,1,00078,India
693061,2023-10-07,610,golf clubs,27000,42000,15000,1,00009,India
693061,2023-10-07,607,table tennis table,20000,26500,6500,1,00009,India
693061,2023-10-07,611,helmet,200,400,200,1,00009,India
159329,2023-10-07,607,table tennis table,20000,26500,6500,1,00167,India
159329,2023-10-07,608,football,298,1099,801,1,00167,India
159329,2023-10-07,606,badminton rackets,180,499,319,1,00167,India
159329,2023-10-07,603,tennis ball,25,60,35,1,00167,India
564782,2023-10-07,602,cricket ball,125,260,135,1,00001,India
564782,2023-10-07,608,football,298,1099,801,1,00001,India
564782,2023-10-07,605,badminton shuttlecocks,180,300,120,1,00001,India
178892,2023-10-07,606,badminton rackets,180,499,319,1,00050,India
103791,2023-10-07,611,helmet,200,400,200,1,00118,India
103791,2023-10-07,605,badminton shuttlecocks,180,300,120,1,00118,India
884642,2023-10-07,611,helmet,200,400,200,1,00032,India
884642,2023-10-07,606,badminton rackets,180,499,319,1,00032,India
884642,2023-10-07,601,cricket bat,400,1500,1100,1,00032,India
571782,2023-10-07,605,badminton shuttlecocks,180,300,120,1,00478,India
571782,2023-10-07,604,tennis racket,1200,1800,600,1,00478,India
841517,2023-10-07,605,badminton shuttlecocks,180,300,120,1,00269,India
596401,2023-10-08,609,basketball,298,679,381,1,00004,India
596401,2023-10-08,611,helmet,200,400,200,1,00004,India
895464,2023-10-08,610,golf clubs,27000,42000,15000,1,00036,India
895464,2023-10-08,611,helmet,200,400,200,1,00036,India
895464,2023-10-08,606,badminton rackets,180,499,319,1,00036,India
743300,2023-10-08,609,basketball,298,679,381,1,00394,India
743300,2023-10-08,601,cricket bat,400,1500,1100,1,00394,India
680915,2023-10-08,605,badminton shuttlecocks,180,300,120,1,00058,India
680915,2023-10-08,607,table tennis table,20000,26500,6500,1,00058,India
680915,2023-10-08,610,golf clubs,27000,42000,15000,1,00058,India
680915,2023-10-08,601,cricket bat,400,1500,1100,1,00058,India
918906,2023-10-08,606,badminton rackets,180,499,319,1,00133,India
393572,2023-10-08,603,tennis ball,25,60,35,1,00406,India
393572,2023-10-08,604,tennis racket,1200,1800,600,1,00406,India
393572,2023-10-08,606,badminton rackets,180,499,319,1,00406,India
502250,2023-10-09,609,basketball,298,679,381,1,00171,India
422521,2023-10-09,604,tennis racket,1200,1800,600,1,00085,India
422521,2023-10-09,610,golf clubs,27000,42000,15000,1,00085,India
422521,2023-10-09,611,helmet,200,400,200,1,00085,India
422521,2023-10-09,607,table tennis table,20000,26500,6500,1,00085,India
422521,2023-10-09,602,cricket ball,125,260,135,1,00085,India
691337,2023-10-09,610,golf clubs,27000,42000,15000,1,00465,India
432009,2023-10-09,608,football,298,1099,801,1,00470,India
432009,2023-10-09,601,cricket bat,400,1500,1100,1,00470,India
890736,2023-10-09,605,badminton shuttlecocks,180,300,120,1,00088,India
890736,2023-10-09,609,basketball,298,679,381,1,00088,India
890736,2023-10-09,603,tennis ball,25,60,35,1,00088,India
360537,2023-10-09,608,football,298,1099,801,1,00112,India
360537,2023-10-09,609,basketball,298,679,381,1,00112,India
642164,2023-10-10,604,tennis racket,1200,1800,600,1,00206,India
642164,2023-10-10,605,badminton shuttlecocks,180,300,120,1,00206,India
642164,2023-10-10,608,football,298,1099,801,1,00206,India
546804,2023-10-10,605,badminton shuttlecocks,180,300,120,1,00384,India
546804,2023-10-10,603,tennis ball,25,60,35,1,00384,India
546804,2023-10-10,601,cricket bat,400,1500,1100,1,00384,India
728857,2023-10-12,609,basketball,298,679,381,1,00485,India
728857,2023-10-12,610,golf clubs,27000,42000,15000,1,00485,India
728857,2023-10-12,611,helmet,200,400,200,1,00485,India
728857,2023-10-12,602,cricket ball,125,260,135,1,00485,India
810229,2023-10-12,603,tennis ball,25,60,35,1,00333,India
810229,2023-10-12,607,table tennis table,20000,26500,6500,1,00333,India
162617,2023-10-12,610,golf clubs,27000,42000,15000,1,00259,India
669647,2023-10-12,604,tennis racket,1200,1800,600,1,00353,India
595848,2023-10-12,601,cricket bat,400,1500,1100,1,00043,India
709336,2023-10-13,605,badminton shuttlecocks,180,300,120,1,00258,India
709336,2023-10-13,603,tennis ball,25,60,35,1,00258,India
725755,2023-10-13,609,basketball,298,679,381,1,00362,India
725755,2023-10-13,602,cricket ball,125,260,135,1,00362,India
725755,2023-10-13,608,football,298,1099,801,1,00362,India
725755,2023-10-13,603,tennis ball,25,60,35,1,00362,India
725755,2023-10-13,610,golf clubs,27000,42000,15000,1,00362,India
899163,2023-10-13,610,golf clubs,27000,42000,15000,1,00399,India
244003,2023-10-13,607,table tennis table,20000,26500,6500,1,00366,India
244003,2023-10-13,602,cricket ball,125,260,135,1,00366,India
121731,2023-10-13,609,basketball,298,679,381,1,00385,India
528500,2023-10-13,608,football,298,1099,801,1,00257,India
528500,2023-10-13,610,golf clubs,27000,42000,15000,1,00257,India
366820,2023-10-13,604,tennis racket,1200,1800,600,1,00105,India
125923,2023-10-13,606,badminton rackets,180,499,319,1,00334,India
125923,2023-10-13,609,basketball,298,679,381,1,00334,India
577175,2023-10-14,610,golf clubs,27000,42000,15000,1,00500,India
391732,2023-10-14,602,cricket ball,125,260,135,1,00238,India
391732,2023-10-14,601,cricket bat,400,1500,1100,1,00238,India
560828,2023-10-14,602,cricket ball,125,260,135,1,00338,India
560828,2023-10-14,609,basketball,298,679,381,1,00338,India
560828,2023-10-14,603,tennis ball,25,60,35,1,00338,India
932453,2023-10-14,602,cricket ball,125,260,135,1,00327,India
932453,2023-10-14,607,table tennis table,20000,26500,6500,1,00327,India
932453,2023-10-14,611,helmet,200,400,200,1,00327,India
932453,2023-10-14,609,basketball,298,679,381,1,00327,India
569245,2023-10-14,604,tennis racket,1200,1800,600,1,00095,India
569245,2023-10-14,606,badminton rackets,180,499,319,1,00095,India
422376,2023-10-14,609,basketball,298,679,381,1,00230,India
422376,2023-10-14,604,tennis racket,1200,1800,600,1,00230,India
361962,2023-10-14,602,cricket ball,125,260,135,1,00105,India
769546,2023-10-14,610,golf clubs,27000,42000,15000,1,00071,India
769546,2023-10-14,604,tennis racket,1200,1800,600,1,00071,India
769546,2023-10-14,607,table tennis table,20000,26500,6500,1,00071,India
769546,2023-10-14,602,cricket ball,125,260,135,1,00071,India
769546,2023-10-14,608,football,298,1099,801,1,00071,India
969222,2023-10-14,601,cricket bat,400,1500,1100,1,00444,India
969222,2023-10-14,611,helmet,200,400,200,1,00444,India
969222,2023-10-14,604,tennis racket,1200,1800,600,1,00444,India
665367,2023-10-14,610,golf clubs,27000,42000,15000,1,00254,India
665367,2023-10-14,606,badminton rackets,180,499,319,1,00254,India
665367,2023-10-14,605,badminton shuttlecocks,180,300,120,1,00254,India
836135,2023-10-15,611,helmet,200,400,200,1,00061,India
836135,2023-10-15,609,basketball,298,679,381,1,00061,India
836135,2023-10-15,606,badminton rackets,180,499,319,1,00061,India
484400,2023-10-15,603,tennis ball,25,60,35,1,00479,India
484400,2023-10-15,606,badminton rackets,180,499,319,1,00479,India
484400,2023-10-15,601,cricket bat,400,1500,1100,1,00479,India
519796,2023-10-15,608,football,298,1099,801,1,00118,India
519796,2023-10-15,610,golf clubs,27000,42000,15000,1,00118,India
519796,2023-10-15,611,helmet,200,400,200,1,00118,India
284202,2023-10-15,606,badminton rackets,180,499,319,1,00236,India
284202,2023-10-15,610,golf clubs,27000,42000,15000,1,00236,India
284202,2023-10-15,605,badminton shuttlecocks,180,300,120,1,00236,India
650377,2023-10-15,606,badminton rackets,180,499,319,1,00283,India
650377,2023-10-15,609,basketball,298,679,381,1,00283,India
650377,2023-10-15,611,helmet,200,400,200,1,00283,India
382557,2023-10-15,608,football,298,1099,801,1,00404,India
382557,2023-10-15,604,tennis racket,1200,1800,600,1,00404,India
382557,2023-10-15,609,basketball,298,679,381,1,00404,India
816342,2023-10-17,610,golf clubs,27000,42000,15000,1,00321,India
816342,2023-10-17,601,cricket bat,400,1500,1100,1,00321,India
816342,2023-10-17,609,basketball,298,679,381,1,00321,India
816342,2023-10-17,607,table tennis table,20000,26500,6500,1,00321,India
688576,2023-10-17,603,tennis ball,25,60,35,1,00156,India
688576,2023-10-17,605,badminton shuttlecocks,180,300,120,1,00156,India
291603,2023-10-17,602,cricket ball,125,260,135,1,00118,India
291603,2023-10-17,611,helmet,200,400,200,1,00118,India
888452,2023-10-17,609,basketball,298,679,381,1,00186,India
888452,2023-10-17,611,helmet,200,400,200,1,00186,India
337328,2023-10-17,608,football,298,1099,801,1,00264,India
130633,2023-10-17,601,cricket bat,400,1500,1100,1,00354,India
130633,2023-10-17,604,tennis racket,1200,1800,600,1,00354,India
674389,2023-10-17,610,golf clubs,27000,42000,15000,1,00352,India
674389,2023-10-17,605,badminton shuttlecocks,180,300,120,1,00352,India
530540,2023-10-18,608,football,298,1099,801,1,00085,India
530540,2023-10-18,611,helmet,200,400,200,1,00085,India
530540,2023-10-18,602,cricket ball,125,260,135,1,00085,India
223572,2023-10-18,606,badminton rackets,180,499,319,1,00391,India
223572,2023-10-18,610,golf clubs,27000,42000,15000,1,00391,India
581293,2023-10-18,605,badminton shuttlecocks,180,300,120,1,00369,India
581293,2023-10-18,608,football,298,1099,801,1,00369,India
581293,2023-10-18,607,table tennis table,20000,26500,6500,1,00369,India
564386,2023-10-18,605,badminton shuttlecocks,180,300,120,1,00031,India
564386,2023-10-18,604,tennis racket,1200,1800,600,1,00031,India
494471,2023-10-18,604,tennis racket,1200,1800,600,1,00443,India
494471,2023-10-18,608,football,298,1099,801,1,00443,India
494471,2023-10-18,601,cricket bat,400,1500,1100,1,00443,India
494471,2023-10-18,607,table tennis table,20000,26500,6500,1,00443,India
903811,2023-10-18,604,tennis racket,1200,1800,600,1,00365,India
903811,2023-10-18,606,badminton rackets,180,499,319,1,00365,India
903811,2023-10-18,605,badminton shuttlecocks,180,300,120,1,00365,India
903811,2023-10-18,608,football,298,1099,801,1,00365,India
679814,2023-10-18,608,football,298,1099,801,1,00117,India
229890,2023-10-18,606,badminton rackets,180,499,319,1,00372,India
229890,2023-10-18,605,badminton shuttlecocks,180,300,120,1,00372,India
652439,2023-10-18,604,tennis racket,1200,1800,600,1,00248,India
532351,2023-10-19,605,badminton shuttlecocks,180,300,120,1,00349,India
356023,2023-10-19,607,table tennis table,20000,26500,6500,1,00431,India
209793,2023-10-19,608,football,298,1099,801,1,00112,India
364407,2023-10-19,601,cricket bat,400,1500,1100,1,00470,India
364407,2023-10-19,610,golf clubs,27000,42000,15000,1,00470,India
214531,2023-10-19,610,golf clubs,27000,42000,15000,1,00174,India
214531,2023-10-19,608,football,298,1099,801,1,00174,India
214531,2023-10-19,611,helmet,200,400,200,1,00174,India
571838,2023-10-19,608,football,298,1099,801,1,00292,India
571838,2023-10-19,604,tennis racket,1200,1800,600,1,00292,India
571838,2023-10-19,609,basketball,298,679,381,1,00292,India
867254,2023-10-19,604,tennis racket,1200,1800,600,1,00264,India
867254,2023-10-19,601,cricket bat,400,1500,1100,1,00264,India
867254,2023-10-19,609,basketball,298,679,381,1,00264,India
867254,2023-10-19,607,table tennis table,20000,26500,6500,1,00264,India
867254,2023-10-19,602,cricket ball,125,260,135,1,00264,India
525303,2023-10-20,601,cricket bat,400,1500,1100,1,00459,India
525303,2023-10-20,603,tennis ball,25,60,35,1,00459,India
207552,2023-10-20,601,cricket bat,400,1500,1100,1,00452,India
620716,2023-10-20,611,helmet,200,400,200,1,00284,India
620716,2023-10-20,603,tennis ball,25,60,35,1,00284,India
422343,2023-10-20,602,cricket ball,125,260,135,1,00031,India
594383,2023-10-20,611,helmet,200,400,200,1,00231,India
594383,2023-10-20,604,tennis racket,1200,1800,600,1,00231,India
594383,2023-10-20,610,golf clubs,27000,42000,15000,1,00231,India
594383,2023-10-20,601,cricket bat,400,1500,1100,1,00231,India
332275,2023-10-20,608,football,298,1099,801,1,00318,India
884321,2023-10-21,606,badminton rackets,180,499,319,1,00280,India
884321,2023-10-21,603,tennis ball,25,60,35,1,00280,India
884321,2023-10-21,608,football,298,1099,801,1,00280,India
635548,2023-10-21,610,golf clubs,27000,42000,15000,1,00463,India
635548,2023-10-21,604,tennis racket,1200,1800,600,1,00463,India
635548,2023-10-21,609,basketball,298,679,381,1,00463,India
635548,2023-10-21,606,badminton rackets,180,499,319,1,00463,India
635548,2023-10-21,602,cricket ball,125,260,135,1,00463,India
509469,2023-10-21,609,basketball,298,679,381,1,00089,India
869864,2023-10-21,608,football,298,1099,801,1,00343,India
869864,2023-10-21,605,badminton shuttlecocks,180,300,120,1,00343,India
869864,2023-10-21,601,cricket bat,400,1500,1100,1,00343,India
248231,2023-10-21,606,badminton rackets,180,499,319,1,00337,India
248231,2023-10-21,611,helmet,200,400,200,1,00337,India
248231,2023-10-21,609,basketball,298,679,381,1,00337,India
248231,2023-10-21,605,badminton shuttlecocks,180,300,120,1,00337,India
898921,2023-10-21,610,golf clubs,27000,42000,15000,1,00270,India
662292,2023-10-21,601,cricket bat,400,1500,1100,1,00011,India
301944,2023-10-21,608,football,298,1099,801,1,00430,India
301944,2023-10-21,605,badminton shuttlecocks,180,300,120,1,00430,India
301944,2023-10-21,611,helmet,200,400,200,1,00430,India
301944,2023-10-21,602,cricket ball,125,260,135,1,00430,India
343094,2023-10-21,603,tennis ball,25,60,35,1,00139,India
104794,2023-10-21,604,tennis racket,1200,1800,600,1,00163,India
104794,2023-10-21,611,helmet,200,400,200,1,00163,India
104794,2023-10-21,610,golf clubs,27000,42000,15000,1,00163,India
104794,2023-10-21,606,badminton rackets,180,499,319,1,00163,India
381148,2023-10-22,606,badminton rackets,180,499,319,1,00199,India
381148,2023-10-22,611,helmet,200,400,200,1,00199,India
381148,2023-10-22,605,badminton shuttlecocks,180,300,120,1,00199,India
381148,2023-10-22,608,football,298,1099,801,1,00199,India
875271,2023-10-22,601,cricket bat,400,1500,1100,1,00135,India
875271,2023-10-22,607,table tennis table,20000,26500,6500,1,00135,India
875271,2023-10-22,609,basketball,298,679,381,1,00135,India
332999,2023-10-22,605,badminton shuttlecocks,180,300,120,1,00477,India
719902,2023-10-22,609,basketball,298,679,381,1,00205,India
719902,2023-10-22,604,tennis racket,1200,1800,600,1,00205,India
719902,2023-10-22,611,helmet,200,400,200,1,00205,India
911134,2023-10-22,606,badminton rackets,180,499,319,1,00481,India
911134,2023-10-22,611,helmet,200,400,200,1,00481,India
911134,2023-10-22,601,cricket bat,400,1500,1100,1,00481,India
911134,2023-10-22,610,golf clubs,27000,42000,15000,1,00481,India
911134,2023-10-22,605,badminton shuttlecocks,180,300,120,1,00481,India
898997,2023-10-22,611,helmet,200,400,200,1,00119,India
898997,2023-10-22,607,table tennis table,20000,26500,6500,1,00119,India
898997,2023-10-22,609,basketball,298,679,381,1,00119,India
898997,2023-10-22,604,tennis racket,1200,1800,600,1,00119,India
926890,2023-10-22,605,badminton shuttlecocks,180,300,120,1,00306,India
926890,2023-10-22,607,table tennis table,20000,26500,6500,1,00306,India
926890,2023-10-22,604,tennis racket,1200,1800,600,1,00306,India
187105,2023-10-22,604,tennis racket,1200,1800,600,1,00295,India
187105,2023-10-22,607,table tennis table,20000,26500,6500,1,00295,India
187105,2023-10-22,602,cricket ball,125,260,135,1,00295,India
187105,2023-10-22,610,golf clubs,27000,42000,15000,1,00295,India
256748,2023-10-23,604,tennis racket,1200,1800,600,1,00482,India
256748,2023-10-23,610,golf clubs,27000,42000,15000,1,00482,India
256748,2023-10-23,611,helmet,200,400,200,1,00482,India
950453,2023-10-23,609,basketball,298,679,381,1,00412,India
377407,2023-10-23,605,badminton shuttlecocks,180,300,120,1,00352,India
377407,2023-10-23,604,tennis racket,1200,1800,600,1,00352,India
377407,2023-10-23,610,golf clubs,27000,42000,15000,1,00352,India
753114,2023-10-23,606,badminton rackets,180,499,319,1,00311,India
836432,2023-10-23,610,golf clubs,27000,42000,15000,1,00303,India
836432,2023-10-23,603,tennis ball,25,60,35,1,00303,India
349737,2023-10-23,601,cricket bat,400,1500,1100,1,00357,India
349737,2023-10-23,603,tennis ball,25,60,35,1,00357,India
349737,2023-10-23,611,helmet,200,400,200,1,00357,India
349737,2023-10-23,602,cricket ball,125,260,135,1,00357,India
349737,2023-10-23,609,basketball,298,679,381,1,00357,India
905077,2023-10-23,607,table tennis table,20000,26500,6500,1,00286,India
905077,2023-10-23,604,tennis racket,1200,1800,600,1,00286,India
905077,2023-10-23,602,cricket ball,125,260,135,1,00286,India
830707,2023-10-23,601,cricket bat,400,1500,1100,1,00002,India
151420,2023-10-23,604,tennis racket,1200,1800,600,1,00089,India
151420,2023-10-23,610,golf clubs,27000,42000,15000,1,00089,India
151420,2023-10-23,607,table tennis table,20000,26500,6500,1,00089,India
151420,2023-10-23,601,cricket bat,400,1500,1100,1,00089,India
150422,2023-10-24,603,tennis ball,25,60,35,1,00492,India
150422,2023-10-24,610,golf clubs,27000,42000,15000,1,00492,India
150422,2023-10-24,609,basketball,298,679,381,1,00492,India
338181,2023-10-24,603,tennis ball,25,60,35,1,00402,India
338181,2023-10-24,610,golf clubs,27000,42000,15000,1,00402,India
804147,2023-10-24,604,tennis racket,1200,1800,600,1,00156,India
804147,2023-10-24,608,football,298,1099,801,1,00156,India
804147,2023-10-24,610,golf clubs,27000,42000,15000,1,00156,India
405258,2023-10-24,607,table tennis table,20000,26500,6500,1,00127,India
405258,2023-10-24,604,tennis racket,1200,1800,600,1,00127,India
341304,2023-10-24,609,basketball,298,679,381,1,00317,India
430924,2023-10-24,603,tennis ball,25,60,35,1,00450,India
250678,2023-10-24,607,table tennis table,20000,26500,6500,1,00173,India
250678,2023-10-24,606,badminton rackets,180,499,319,1,00173,India
250678,2023-10-24,609,basketball,298,679,381,1,00173,India
250678,2023-10-24,611,helmet,200,400,200,1,00173,India
769120,2023-10-24,603,tennis ball,25,60,35,1,00328,India
769120,2023-10-24,605,badminton shuttlecocks,180,300,120,1,00328,India
346648,2023-10-24,611,helmet,200,400,200,1,00319,India
346648,2023-10-24,601,cricket bat,400,1500,1100,1,00319,India
346648,2023-10-24,605,badminton shuttlecocks,180,300,120,1,00319,India
346648,2023-10-24,602,cricket ball,125,260,135,1,00319,India
346648,2023-10-24,603,tennis ball,25,60,35,1,00319,India
277246,2023-10-25,608,football,298,1099,801,1,00060,India
277246,2023-10-25,601,cricket bat,400,1500,1100,1,00060,India
593913,2023-10-25,607,table tennis table,20000,26500,6500,1,00153,India
153283,2023-10-25,604,tennis racket,1200,1800,600,1,00050,India
153283,2023-10-25,601,cricket bat,400,1500,1100,1,00050,India
855054,2023-10-25,607,table tennis table,20000,26500,6500,1,00402,India
855054,2023-10-25,606,badminton rackets,180,499,319,1,00402,India
855054,2023-10-25,602,cricket ball,125,260,135,1,00402,India
855054,2023-10-25,611,helmet,200,400,200,1,00402,India
277028,2023-10-26,606,badminton rackets,180,499,319,1,00473,India
731128,2023-10-26,603,tennis ball,25,60,35,1,00403,India
731128,2023-10-26,609,basketball,298,679,381,1,00403,India
731128,2023-10-26,604,tennis racket,1200,1800,600,1,00403,India
699594,2023-10-26,601,cricket bat,400,1500,1100,1,00407,India
699594,2023-10-26,602,cricket ball,125,260,135,1,00407,India
699594,2023-10-26,603,tennis ball,25,60,35,1,00407,India
936366,2023-10-26,609,basketball,298,679,381,1,00310,India
936366,2023-10-26,603,tennis ball,25,60,35,1,00310,India
936366,2023-10-26,607,table tennis table,20000,26500,6500,1,00310,India
333093,2023-10-26,611,helmet,200,400,200,1,00315,India
333093,2023-10-26,608,football,298,1099,801,1,00315,India
333093,2023-10-26,602,cricket ball,125,260,135,1,00315,India
639041,2023-10-26,608,football,298,1099,801,1,00387,India
639041,2023-10-26,604,tennis racket,1200,1800,600,1,00387,India
639041,2023-10-26,601,cricket bat,400,1500,1100,1,00387,India
479863,2023-10-26,609,basketball,298,679,381,1,00384,India
479863,2023-10-26,606,badminton rackets,180,499,319,1,00384,India
479863,2023-10-26,605,badminton shuttlecocks,180,300,120,1,00384,India
479863,2023-10-26,604,tennis racket,1200,1800,600,1,00384,India
446096,2023-10-26,610,golf clubs,27000,42000,15000,1,00015,India
446096,2023-10-26,601,cricket bat,400,1500,1100,1,00015,India
446096,2023-10-26,605,badminton shuttlecocks,180,300,120,1,00015,India
446096,2023-10-26,609,basketball,298,679,381,1,00015,India
936981,2023-10-26,610,golf clubs,27000,42000,15000,1,00113,India
936981,2023-10-26,608,football,298,1099,801,1,00113,India
936981,2023-10-26,603,tennis ball,25,60,35,1,00113,India
936981,2023-10-26,604,tennis racket,1200,1800,600,1,00113,India
679078,2023-10-26,610,golf clubs,27000,42000,15000,1,00169,India
679078,2023-10-26,606,badminton rackets,180,499,319,1,00169,India
679078,2023-10-26,605,badminton shuttlecocks,180,300,120,1,00169,India
679078,2023-10-26,601,cricket bat,400,1500,1100,1,00169,India
679078,2023-10-26,607,table tennis table,20000,26500,6500,1,00169,India
769789,2023-10-27,607,table tennis table,20000,26500,6500,1,00392,India
769789,2023-10-27,606,badminton rackets,180,499,319,1,00392,India
769789,2023-10-27,611,helmet,200,400,200,1,00392,India
769789,2023-10-27,610,golf clubs,27000,42000,15000,1,00392,India
769789,2023-10-27,603,tennis ball,25,60,35,1,00392,India
279955,2023-10-27,607,table tennis table,20000,26500,6500,1,00092,India
279955,2023-10-27,605,badminton shuttlecocks,180,300,120,1,00092,India
903394,2023-10-27,611,helmet,200,400,200,1,00019,India
903394,2023-10-27,610,golf clubs,27000,42000,15000,1,00019,India
903394,2023-10-27,602,cricket ball,125,260,135,1,00019,India
903394,2023-10-27,606,badminton rackets,180,499,319,1,00019,India
903394,2023-10-27,601,cricket bat,400,1500,1100,1,00019,India
951762,2023-10-27,610,golf clubs,27000,42000,15000,1,00470,India
951762,2023-10-27,602,cricket ball,125,260,135,1,00470,India
951762,2023-10-27,606,badminton rackets,180,499,319,1,00470,India
969690,2023-10-27,607,table tennis table,20000,26500,6500,1,00347,India
969690,2023-10-27,605,badminton shuttlecocks,180,300,120,1,00347,India
969690,2023-10-27,610,golf clubs,27000,42000,15000,1,00347,India
668879,2023-10-27,610,golf clubs,27000,42000,15000,1,00050,India
668879,2023-10-27,603,tennis ball,25,60,35,1,00050,India
668879,2023-10-27,606,badminton rackets,180,499,319,1,00050,India
562073,2023-10-27,603,tennis ball,25,60,35,1,00434,India
811903,2023-10-28,603,tennis ball,25,60,35,1,00360,India
274287,2023-10-28,601,cricket bat,400,1500,1100,1,00489,India
274287,2023-10-28,609,basketball,298,679,381,1,00489,India
403046,2023-10-29,603,tennis ball,25,60,35,1,00231,India
189978,2023-10-29,605,badminton shuttlecocks,180,300,120,1,00443,India
189978,2023-10-29,601,cricket bat,400,1500,1100,1,00443,India
189978,2023-10-29,603,tennis ball,25,60,35,1,00443,India
189978,2023-10-29,604,tennis racket,1200,1800,600,1,00443,India
189978,2023-10-29,610,golf clubs,27000,42000,15000,1,00443,India
535379,2023-10-29,605,badminton shuttlecocks,180,300,120,1,00443,India
247034,2023-10-29,610,golf clubs,27000,42000,15000,1,00306,India
247034,2023-10-29,604,tennis racket,1200,1800,600,1,00306,India
543716,2023-10-29,602,cricket ball,125,260,135,1,00451,India
543716,2023-10-29,603,tennis ball,25,60,35,1,00451,India
543716,2023-10-29,601,cricket bat,400,1500,1100,1,00451,India
886289,2023-10-29,610,golf clubs,27000,42000,15000,1,00294,India
886289,2023-10-29,601,cricket bat,400,1500,1100,1,00294,India
886289,2023-10-29,608,football,298,1099,801,1,00294,India
886289,2023-10-29,606,badminton rackets,180,499,319,1,00294,India
832703,2023-10-29,607,table tennis table,20000,26500,6500,1,00438,India
832703,2023-10-29,610,golf clubs,27000,42000,15000,1,00438,India
832703,2023-10-29,605,badminton shuttlecocks,180,300,120,1,00438,India
900400,2023-10-29,608,football,298,1099,801,1,00271,India
900400,2023-10-29,604,tennis racket,1200,1800,600,1,00271,India
900400,2023-10-29,609,basketball,298,679,381,1,00271,India
632253,2023-10-29,610,golf clubs,27000,42000,15000,1,00420,India
190115,2023-10-30,606,badminton rackets,180,499,319,1,00236,India
190115,2023-10-30,611,helmet,200,400,200,1,00236,India
190115,2023-10-30,609,basketball,298,679,381,1,00236,India
190115,2023-10-30,603,tennis ball,25,60,35,1,00236,India
547118,2023-10-30,602,cricket ball,125,260,135,1,00458,India
547118,2023-10-30,605,badminton shuttlecocks,180,300,120,1,00458,India
287428,2023-10-30,603,tennis ball,25,60,35,1,00287,India
287428,2023-10-30,608,football,298,1099,801,1,00287,India
489565,2023-10-30,609,basketball,298,679,381,1,00448,India
886200,2023-11-01,610,golf clubs,27000,42000,15000,2,00088,India
886200,2023-11-01,605,badminton shuttlecocks,180,300,120,2,00088,India
886200,2023-11-01,606,badminton rackets,180,499,319,2,00088,India
886200,2023-11-01,603,tennis ball,25,60,35,3,00088,India
886200,2023-11-01,609,basketball,298,679,381,2,00088,India
938937,2023-11-01,609,basketball,298,679,381,2,00253,India
938937,2023-11-01,611,helmet,200,400,200,2,00253,India
938937,2023-11-01,601,cricket bat,400,1500,1100,2,00253,India
163103,2023-11-01,609,basketball,298,679,381,2,00290,India
163103,2023-11-01,608,football,298,1099,801,2,00290,India
163103,2023-11-01,605,badminton shuttlecocks,180,300,120,2,00290,India
163103,2023-11-01,603,tennis ball,25,60,35,3,00290,India
163103,2023-11-01,611,helmet,200,400,200,2,00290,India
972094,2023-11-01,609,basketball,298,679,381,2,00314,India
993629,2023-11-01,610,golf clubs,27000,42000,15000,2,00125,India
993629,2023-11-01,604,tennis racket,1200,1800,600,2,00125,India
993629,2023-11-01,605,badminton shuttlecocks,180,300,120,2,00125,India
667970,2023-11-01,608,football,298,1099,801,2,00205,India
667970,2023-11-01,611,helmet,200,400,200,2,00205,India
667970,2023-11-01,604,tennis racket,1200,1800,600,2,00205,India
541087,2023-11-01,603,tennis ball,25,60,35,3,00109,India
428589,2023-11-01,604,tennis racket,1200,1800,600,2,00488,India
428589,2023-11-01,606,badminton rackets,180,499,319,2,00488,India
428589,2023-11-01,601,cricket bat,400,1500,1100,2,00488,India
428589,2023-11-01,602,cricket ball,125,260,135,3,00488,India
511453,2023-11-02,603,tennis ball,25,60,35,3,00424,India
682771,2023-11-02,603,tennis ball,25,60,35,3,00362,India
682771,2023-11-02,609,basketball,298,679,381,2,00362,India
682771,2023-11-02,604,tennis racket,1200,1800,600,2,00362,India
682771,2023-11-02,608,football,298,1099,801,2,00362,India
682771,2023-11-02,607,table tennis table,20000,26500,6500,2,00362,India
388091,2023-11-03,601,cricket bat,400,1500,1100,2,00154,India
388091,2023-11-03,607,table tennis table,20000,26500,6500,2,00154,India
388091,2023-11-03,609,basketball,298,679,381,2,00154,India
388091,2023-11-03,606,badminton rackets,180,499,319,2,00154,India
963687,2023-11-03,606,badminton rackets,180,499,319,2,00180,India
963687,2023-11-03,611,helmet,200,400,200,2,00180,India
919671,2023-11-03,607,table tennis table,20000,26500,6500,2,00411,India
919671,2023-11-03,603,tennis ball,25,60,35,3,00411,India
919671,2023-11-03,604,tennis racket,1200,1800,600,2,00411,India
796170,2023-11-03,608,football,298,1099,801,2,00228,India
796170,2023-11-03,601,cricket bat,400,1500,1100,2,00228,India
796170,2023-11-03,607,table tennis table,20000,26500,6500,2,00228,India
594559,2023-11-03,610,golf clubs,27000,42000,15000,2,00120,India
594559,2023-11-03,601,cricket bat,400,1500,1100,2,00120,India
594559,2023-11-03,602,cricket ball,125,260,135,3,00120,India
959920,2023-11-03,605,badminton shuttlecocks,180,300,120,2,00008,India
959920,2023-11-03,606,badminton rackets,180,499,319,2,00008,India
421585,2023-11-04,603,tennis ball,25,60,35,3,00419,India
421585,2023-11-04,601,cricket bat,400,1500,1100,2,00419,India
270446,2023-11-04,601,cricket bat,400,1500,1100,2,00012,India
270446,2023-11-04,602,cricket ball,125,260,135,3,00012,India
270446,2023-11-04,611,helmet,200,400,200,2,00012,India
270446,2023-11-04,604,tennis racket,1200,1800,600,2,00012,India
270446,2023-11-04,607,table tennis table,20000,26500,6500,2,00012,India
323466,2023-11-04,603,tennis ball,25,60,35,3,00402,India
974806,2023-11-04,606,badminton rackets,180,499,319,2,00009,India
974806,2023-11-04,611,helmet,200,400,200,2,00009,India
974806,2023-11-04,608,football,298,1099,801,2,00009,India
839793,2023-11-04,603,tennis ball,25,60,35,3,00439,India
408463,2023-11-05,605,badminton shuttlecocks,180,300,120,2,00058,India
408463,2023-11-05,604,tennis racket,1200,1800,600,2,00058,India
737602,2023-11-05,602,cricket ball,125,260,135,3,00180,India
657015,2023-11-05,610,golf clubs,27000,42000,15000,2,00246,India
657015,2023-11-05,611,helmet,200,400,200,2,00246,India
657015,2023-11-05,608,football,298,1099,801,2,00246,India
729540,2023-11-05,605,badminton shuttlecocks,180,300,120,2,00289,India
729540,2023-11-05,608,football,298,1099,801,2,00289,India
765424,2023-11-05,601,cricket bat,400,1500,1100,2,00024,India
395558,2023-11-05,610,golf clubs,27000,42000,15000,2,00142,India
395558,2023-11-05,603,tennis ball,25,60,35,3,00142,India
395558,2023-11-05,605,badminton shuttlecocks,180,300,120,2,00142,India
253755,2023-11-05,606,badminton rackets,180,499,319,2,00478,India
253755,2023-11-05,603,tennis ball,25,60,35,3,00478,India
253755,2023-11-05,610,golf clubs,27000,42000,15000,2,00478,India
630996,2023-11-05,607,table tennis table,20000,26500,6500,2,00135,India
630996,2023-11-05,609,basketball,298,679,381,2,00135,India
612346,2023-11-06,609,basketball,298,679,381,2,00286,India
612346,2023-11-06,601,cricket bat,400,1500,1100,2,00286,India
612346,2023-11-06,611,helmet,200,400,200,2,00286,India
531629,2023-11-06,606,badminton rackets,180,499,319,2,00169,India
989567,2023-11-06,603,tennis ball,25,60,35,3,00272,India
989567,2023-11-06,607,table tennis table,20000,26500,6500,2,00272,India
989567,2023-11-06,604,tennis racket,1200,1800,600,2,00272,India
339963,2023-11-06,608,football,298,1099,801,2,00122,India
138418,2023-11-06,606,badminton rackets,180,499,319,2,00272,India
138418,2023-11-06,604,tennis racket,1200,1800,600,2,00272,India
138418,2023-11-06,603,tennis ball,25,60,35,3,00272,India
138418,2023-11-06,602,cricket ball,125,260,135,3,00272,India
783726,2023-11-06,603,tennis ball,25,60,35,3,00287,India
763526,2023-11-06,609,basketball,298,679,381,2,00267,India
763526,2023-11-06,601,cricket bat,400,1500,1100,2,00267,India
763526,2023-11-06,604,tennis racket,1200,1800,600,2,00267,India
763526,2023-11-06,610,golf clubs,27000,42000,15000,2,00267,India
763526,2023-11-06,603,tennis ball,25,60,35,3,00267,India
471249,2023-11-07,608,football,298,1099,801,2,00489,India
471249,2023-11-07,606,badminton rackets,180,499,319,2,00489,India
471249,2023-11-07,604,tennis racket,1200,1800,600,2,00489,India
471249,2023-11-07,609,basketball,298,679,381,2,00489,India
471249,2023-11-07,601,cricket bat,400,1500,1100,2,00489,India
704478,2023-11-07,602,cricket ball,125,260,135,3,00215,India
704478,2023-11-07,607,table tennis table,20000,26500,6500,2,00215,India
546659,2023-11-07,611,helmet,200,400,200,2,00031,India
546659,2023-11-07,610,golf clubs,27000,42000,15000,2,00031,India
546659,2023-11-07,603,tennis ball,25,60,35,3,00031,India
680333,2023-11-08,608,football,298,1099,801,2,00026,India
680333,2023-11-08,607,table tennis table,20000,26500,6500,2,00026,India
680333,2023-11-08,602,cricket ball,125,260,135,3,00026,India
430896,2023-11-09,602,cricket ball,125,260,135,3,00092,India
430896,2023-11-09,608,football,298,1099,801,2,00092,India
158678,2023-11-10,601,cricket bat,400,1500,1100,2,00067,India
158678,2023-11-10,609,basketball,298,679,381,2,00067,India
158678,2023-11-10,607,table tennis table,20000,26500,6500,2,00067,India
197387,2023-11-10,607,table tennis table,20000,26500,6500,2,00450,India
304134,2023-11-11,608,football,298,1099,801,2,00375,India
304134,2023-11-11,601,cricket bat,400,1500,1100,2,00375,India
304134,2023-11-11,610,golf clubs,27000,42000,15000,2,00375,India
546508,2023-11-11,601,cricket bat,400,1500,1100,2,00147,India
546508,2023-11-11,603,tennis ball,25,60,35,3,00147,India
807774,2023-11-11,610,golf clubs,27000,42000,15000,2,00240,India
807774,2023-11-11,607,table tennis table,20000,26500,6500,2,00240,India
807774,2023-11-11,608,football,298,1099,801,2,00240,India
807774,2023-11-11,601,cricket bat,400,1500,1100,2,00240,India
796959,2023-11-11,603,tennis ball,25,60,35,3,00132,India
688918,2023-11-11,604,tennis racket,1200,1800,600,2,00124,India
688918,2023-11-11,607,table tennis table,20000,26500,6500,2,00124,India
688918,2023-11-11,609,basketball,298,679,381,2,00124,India
688918,2023-11-11,606,badminton rackets,180,499,319,2,00124,India
736874,2023-11-11,608,football,298,1099,801,2,00415,India
736874,2023-11-11,606,badminton rackets,180,499,319,2,00415,India
252076,2023-11-11,609,basketball,298,679,381,2,00103,India
252076,2023-11-11,604,tennis racket,1200,1800,600,2,00103,India
252076,2023-11-11,606,badminton rackets,180,499,319,2,00103,India
798994,2023-11-11,606,badminton rackets,180,499,319,2,00199,India
774787,2023-11-11,602,cricket ball,125,260,135,3,00154,India
774787,2023-11-11,601,cricket bat,400,1500,1100,2,00154,India
875757,2023-11-11,606,badminton rackets,180,499,319,2,00489,India
875757,2023-11-11,602,cricket ball,125,260,135,3,00489,India
875757,2023-11-11,604,tennis racket,1200,1800,600,2,00489,India
875757,2023-11-11,611,helmet,200,400,200,2,00489,India
297804,2023-11-12,608,football,298,1099,801,2,00020,India
297804,2023-11-12,602,cricket ball,125,260,135,3,00020,India
297804,2023-11-12,607,table tennis table,20000,26500,6500,2,00020,India
297804,2023-11-12,603,tennis ball,25,60,35,3,00020,India
297804,2023-11-12,605,badminton shuttlecocks,180,300,120,2,00020,India
754338,2023-11-12,610,golf clubs,27000,42000,15000,2,00443,India
754338,2023-11-12,606,badminton rackets,180,499,319,2,00443,India
248382,2023-11-12,604,tennis racket,1200,1800,600,2,00440,India
248382,2023-11-12,608,football,298,1099,801,2,00440,India
911271,2023-11-12,605,badminton shuttlecocks,180,300,120,2,00124,India
911271,2023-11-12,602,cricket ball,125,260,135,3,00124,India
911271,2023-11-12,609,basketball,298,679,381,2,00124,India
527452,2023-11-12,610,golf clubs,27000,42000,15000,2,00212,India
527452,2023-11-12,604,tennis racket,1200,1800,600,2,00212,India
527452,2023-11-12,605,badminton shuttlecocks,180,300,120,2,00212,India
527452,2023-11-12,606,badminton rackets,180,499,319,2,00212,India
993939,2023-11-12,606,badminton rackets,180,499,319,2,00019,India
767629,2023-11-12,603,tennis ball,25,60,35,3,00374,India
767629,2023-11-12,605,badminton shuttlecocks,180,300,120,2,00374,India
767629,2023-11-12,609,basketball,298,679,381,2,00374,India
767629,2023-11-12,611,helmet,200,400,200,2,00374,India
536988,2023-11-13,601,cricket bat,400,1500,1100,2,00384,India
536988,2023-11-13,610,golf clubs,27000,42000,15000,2,00384,India
694077,2023-11-13,610,golf clubs,27000,42000,15000,2,00350,India
108917,2023-11-13,611,helmet,200,400,200,2,00110,India
108917,2023-11-13,607,table tennis table,20000,26500,6500,2,00110,India
108917,2023-11-13,603,tennis ball,25,60,35,3,00110,India
910882,2023-11-13,605,badminton shuttlecocks,180,300,120,2,00312,India
888012,2023-11-13,606,badminton rackets,180,499,319,2,00437,India
888012,2023-11-13,610,golf clubs,27000,42000,15000,2,00437,India
116835,2023-11-13,609,basketball,298,679,381,2,00102,India
116835,2023-11-13,605,badminton shuttlecocks,180,300,120,2,00102,India
242168,2023-11-13,601,cricket bat,400,1500,1100,2,00074,India
242168,2023-11-13,611,helmet,200,400,200,2,00074,India
242168,2023-11-13,603,tennis ball,25,60,35,3,00074,India
557287,2023-11-13,607,table tennis table,20000,26500,6500,2,00454,India
557287,2023-11-13,611,helmet,200,400,200,2,00454,India
557287,2023-11-13,605,badminton shuttlecocks,180,300,120,2,00454,India
557287,2023-11-13,601,cricket bat,400,1500,1100,2,00454,India
557287,2023-11-13,606,badminton rackets,180,499,319,2,00454,India
526224,2023-11-14,606,badminton rackets,180,499,319,2,00270,India
105793,2023-11-14,604,tennis racket,1200,1800,600,2,00256,India
105793,2023-11-14,601,cricket bat,400,1500,1100,2,00256,India
105793,2023-11-14,602,cricket ball,125,260,135,3,00256,India
105793,2023-11-14,603,tennis ball,25,60,35,3,00256,India
183104,2023-11-14,610,golf clubs,27000,42000,15000,2,00239,India
565543,2023-11-14,605,badminton shuttlecocks,180,300,120,2,00083,India
565543,2023-11-14,601,cricket bat,400,1500,1100,2,00083,India
565543,2023-11-14,610,golf clubs,27000,42000,15000,2,00083,India
745289,2023-11-14,610,golf clubs,27000,42000,15000,2,00350,India
763874,2023-11-14,607,table tennis table,20000,26500,6500,2,00228,India
763874,2023-11-14,611,helmet,200,400,200,2,00228,India
763874,2023-11-14,608,football,298,1099,801,2,00228,India
763874,2023-11-14,604,tennis racket,1200,1800,600,2,00228,India
629471,2023-11-15,605,badminton shuttlecocks,180,300,120,2,00312,India
629471,2023-11-15,611,helmet,200,400,200,2,00312,India
468169,2023-11-15,604,tennis racket,1200,1800,600,2,00064,India
468169,2023-11-15,610,golf clubs,27000,42000,15000,2,00064,India
813311,2023-11-15,610,golf clubs,27000,42000,15000,2,00217,India
813311,2023-11-15,603,tennis ball,25,60,35,3,00217,India
294089,2023-11-16,602,cricket ball,125,260,135,3,00326,India
294089,2023-11-16,611,helmet,200,400,200,2,00326,India
294089,2023-11-16,603,tennis ball,25,60,35,3,00326,India
429874,2023-11-16,601,cricket bat,400,1500,1100,2,00232,India
429874,2023-11-16,606,badminton rackets,180,499,319,2,00232,India
496958,2023-11-16,601,cricket bat,400,1500,1100,2,00218,India
496958,2023-11-16,602,cricket ball,125,260,135,3,00218,India
496958,2023-11-16,604,tennis racket,1200,1800,600,2,00218,India
437056,2023-11-16,602,cricket ball,125,260,135,3,00016,India
437056,2023-11-16,605,badminton shuttlecocks,180,300,120,2,00016,India
437056,2023-11-16,610,golf clubs,27000,42000,15000,2,00016,India
437056,2023-11-16,609,basketball,298,679,381,2,00016,India
437056,2023-11-16,603,tennis ball,25,60,35,3,00016,India
486159,2023-11-16,611,helmet,200,400,200,2,00307,India
481501,2023-11-17,604,tennis racket,1200,1800,600,2,00145,India
198415,2023-11-17,602,cricket ball,125,260,135,3,00143,India
198415,2023-11-17,611,helmet,200,400,200,2,00143,India
413243,2023-11-17,605,badminton shuttlecocks,180,300,120,2,00438,India
413243,2023-11-17,608,football,298,1099,801,2,00438,India
413243,2023-11-17,604,tennis racket,1200,1800,600,2,00438,India
493391,2023-11-17,601,cricket bat,400,1500,1100,2,00376,India
493391,2023-11-17,609,basketball,298,679,381,2,00376,India
389321,2023-11-17,608,football,298,1099,801,2,00425,India
389321,2023-11-17,611,helmet,200,400,200,2,00425,India
389321,2023-11-17,606,badminton rackets,180,499,319,2,00425,India
452454,2023-11-17,608,football,298,1099,801,2,00136,India
452454,2023-11-17,607,table tennis table,20000,26500,6500,2,00136,India
452454,2023-11-17,604,tennis racket,1200,1800,600,2,00136,India
452454,2023-11-17,609,basketball,298,679,381,2,00136,India
452454,2023-11-17,605,badminton shuttlecocks,180,300,120,2,00136,India
845618,2023-11-18,604,tennis racket,1200,1800,600,2,00027,India
845618,2023-11-18,607,table tennis table,20000,26500,6500,2,00027,India
360558,2023-11-19,604,tennis racket,1200,1800,600,2,00168,India
360558,2023-11-19,602,cricket ball,125,260,135,3,00168,India
360558,2023-11-19,610,golf clubs,27000,42000,15000,2,00168,India
987486,2023-11-19,610,golf clubs,27000,42000,15000,2,00477,India
987486,2023-11-19,608,football,298,1099,801,2,00477,India
987486,2023-11-19,611,helmet,200,400,200,2,00477,India
987486,2023-11-19,601,cricket bat,400,1500,1100,2,00477,India
249009,2023-11-19,601,cricket bat,400,1500,1100,2,00130,India
249009,2023-11-19,610,golf clubs,27000,42000,15000,2,00130,India
249009,2023-11-19,604,tennis racket,1200,1800,600,2,00130,India
249009,2023-11-19,606,badminton rackets,180,499,319,2,00130,India
514777,2023-11-19,610,golf clubs,27000,42000,15000,2,00373,India
951757,2023-11-19,602,cricket ball,125,260,135,3,00168,India
151133,2023-11-19,601,cricket bat,400,1500,1100,2,00264,India
151133,2023-11-19,611,helmet,200,400,200,2,00264,India
798238,2023-11-19,604,tennis racket,1200,1800,600,2,00147,India
798238,2023-11-19,611,helmet,200,400,200,2,00147,India
798238,2023-11-19,608,football,298,1099,801,2,00147,India
798238,2023-11-19,607,table tennis table,20000,26500,6500,2,00147,India
193526,2023-11-20,606,badminton rackets,180,499,319,2,00284,India
193526,2023-11-20,603,tennis ball,25,60,35,3,00284,India
431139,2023-11-20,601,cricket bat,400,1500,1100,2,00032,India
431139,2023-11-20,611,helmet,200,400,200,2,00032,India
402460,2023-11-22,604,tennis racket,1200,1800,600,2,00073,India
402460,2023-11-22,601,cricket bat,400,1500,1100,2,00073,India
402460,2023-11-22,609,basketball,298,679,381,2,00073,India
182455,2023-11-22,601,cricket bat,400,1500,1100,2,00033,India
182455,2023-11-22,606,badminton rackets,180,499,319,2,00033,India
182455,2023-11-22,605,badminton shuttlecocks,180,300,120,2,00033,India
182455,2023-11-22,604,tennis racket,1200,1800,600,2,00033,India
309162,2023-11-22,605,badminton shuttlecocks,180,300,120,2,00307,India
309162,2023-11-22,604,tennis racket,1200,1800,600,2,00307,India
309162,2023-11-22,611,helmet,200,400,200,2,00307,India
309162,2023-11-22,610,golf clubs,27000,42000,15000,2,00307,India
309162,2023-11-22,602,cricket ball,125,260,135,3,00307,India
172038,2023-11-22,610,golf clubs,27000,42000,15000,2,00047,India
172038,2023-11-22,604,tennis racket,1200,1800,600,2,00047,India
587449,2023-11-22,611,helmet,200,400,200,2,00265,India
587449,2023-11-22,604,tennis racket,1200,1800,600,2,00265,India
327216,2023-11-22,604,tennis racket,1200,1800,600,2,00466,India
327216,2023-11-22,601,cricket bat,400,1500,1100,2,00466,India
888687,2023-11-22,611,helmet,200,400,200,2,00159,India
888687,2023-11-22,605,badminton shuttlecocks,180,300,120,2,00159,India
568541,2023-11-23,602,cricket ball,125,260,135,3,00242,India
568541,2023-11-23,605,badminton shuttlecocks,180,300,120,2,00242,India
568541,2023-11-23,608,football,298,1099,801,2,00242,India
338405,2023-11-23,610,golf clubs,27000,42000,15000,2,00375,India
338405,2023-11-23,609,basketball,298,679,381,2,00375,India
338405,2023-11-23,605,badminton shuttlecocks,180,300,120,2,00375,India
800655,2023-11-23,606,badminton rackets,180,499,319,2,00422,India
382762,2023-11-23,606,badminton rackets,180,499,319,2,00314,India
259750,2023-11-23,611,helmet,200,400,200,2,00256,India
259750,2023-11-23,602,cricket ball,125,260,135,3,00256,India
259750,2023-11-23,603,tennis ball,25,60,35,3,00256,India
259750,2023-11-23,604,tennis racket,1200,1800,600,2,00256,India
793961,2023-11-23,607,table tennis table,20000,26500,6500,2,00060,India
793961,2023-11-23,609,basketball,298,679,381,2,00060,India
793961,2023-11-23,602,cricket ball,125,260,135,3,00060,India
793961,2023-11-23,606,badminton rackets,180,499,319,2,00060,India
793961,2023-11-23,603,tennis ball,25,60,35,3,00060,India
907226,2023-11-23,604,tennis racket,1200,1800,600,2,00139,India
907226,2023-11-23,609,basketball,298,679,381,2,00139,India
301630,2023-11-24,608,football,298,1099,801,2,00195,India
301630,2023-11-24,604,tennis racket,1200,1800,600,2,00195,India
933532,2023-11-24,610,golf clubs,27000,42000,15000,2,00029,India
933532,2023-11-24,611,helmet,200,400,200,2,00029,India
814981,2023-11-24,602,cricket ball,125,260,135,3,00444,India
226710,2023-11-24,603,tennis ball,25,60,35,3,00254,India
226710,2023-11-24,606,badminton rackets,180,499,319,2,00254,India
649055,2023-11-25,610,golf clubs,27000,42000,15000,2,00013,India
649055,2023-11-25,602,cricket ball,125,260,135,3,00013,India
649055,2023-11-25,601,cricket bat,400,1500,1100,2,00013,India
649055,2023-11-25,605,badminton shuttlecocks,180,300,120,2,00013,India
146025,2023-11-26,610,golf clubs,27000,42000,15000,2,00004,India
105584,2023-11-26,607,table tennis table,20000,26500,6500,2,00304,India
105584,2023-11-26,603,tennis ball,25,60,35,3,00304,India
105584,2023-11-26,604,tennis racket,1200,1800,600,2,00304,India
105584,2023-11-26,611,helmet,200,400,200,2,00304,India
479828,2023-11-26,610,golf clubs,27000,42000,15000,2,00310,India
677128,2023-11-26,607,table tennis table,20000,26500,6500,2,00023,India
677128,2023-11-26,608,football,298,1099,801,2,00023,India
954967,2023-11-26,602,cricket ball,125,260,135,3,00155,India
954967,2023-11-26,604,tennis racket,1200,1800,600,2,00155,India
954967,2023-11-26,605,badminton shuttlecocks,180,300,120,2,00155,India
954967,2023-11-26,603,tennis ball,25,60,35,3,00155,India
930440,2023-11-28,601,cricket bat,400,1500,1100,2,00348,India
930440,2023-11-28,603,tennis ball,25,60,35,3,00348,India
263498,2023-11-28,601,cricket bat,400,1500,1100,2,00004,India
973878,2023-11-28,605,badminton shuttlecocks,180,300,120,2,00002,India
210618,2023-11-28,611,helmet,200,400,200,2,00156,India
210618,2023-11-28,602,cricket ball,125,260,135,3,00156,India
751565,2023-11-28,609,basketball,298,679,381,2,00125,India
751565,2023-11-28,605,badminton shuttlecocks,180,300,120,2,00125,India
751565,2023-11-28,603,tennis ball,25,60,35,3,00125,India
751565,2023-11-28,601,cricket bat,400,1500,1100,2,00125,India
716884,2023-11-28,602,cricket ball,125,260,135,3,00016,India
716884,2023-11-28,609,basketball,298,679,381,2,00016,India
184185,2023-11-28,606,badminton rackets,180,499,319,2,00140,India
887037,2023-11-28,602,cricket ball,125,260,135,3,00433,India
162191,2023-11-28,610,golf clubs,27000,42000,15000,2,00360,India
162191,2023-11-28,604,tennis racket,1200,1800,600,2,00360,India
162191,2023-11-28,605,badminton shuttlecocks,180,300,120,2,00360,India
162191,2023-11-28,606,badminton rackets,180,499,319,2,00360,India
162191,2023-11-28,607,table tennis table,20000,26500,6500,2,00360,India
147604,2023-11-28,607,table tennis table,20000,26500,6500,2,00147,India
147604,2023-11-28,608,football,298,1099,801,2,00147,India
713198,2023-11-29,601,cricket bat,400,1500,1100,2,00083,India
713198,2023-11-29,608,football,298,1099,801,2,00083,India
100618,2023-11-29,605,badminton shuttlecocks,180,300,120,2,00414,India
100618,2023-11-29,610,golf clubs,27000,42000,15000,2,00414,India
100618,2023-11-29,607,table tennis table,20000,26500,6500,2,00414,India
100618,2023-11-29,608,football,298,1099,801,2,00414,India
402891,2023-11-29,605,badminton shuttlecocks,180,300,120,2,00248,India
402891,2023-11-29,602,cricket ball,125,260,135,3,00248,India
402891,2023-11-29,608,football,298,1099,801,2,00248,India
402891,2023-11-29,611,helmet,200,400,200,2,00248,India
201517,2023-11-29,608,football,298,1099,801,2,00208,India
680346,2023-11-30,608,football,298,1099,801,2,00080,India
680346,2023-11-30,609,basketball,298,679,381,2,00080,India
239692,2023-11-30,609,basketball,298,679,381,2,00104,India
239692,2023-11-30,610,golf clubs,27000,42000,15000,2,00104,India
239692,2023-11-30,606,badminton rackets,180,499,319,2,00104,India
239692,2023-11-30,605,badminton shuttlecocks,180,300,120,2,00104,India
863115,2023-11-30,602,cricket ball,125,260,135,3,00358,India
863115,2023-11-30,601,cricket bat,400,1500,1100,2,00358,India
502348,2023-11-30,604,tennis racket,1200,1800,600,2,00183,India
502348,2023-11-30,606,badminton rackets,180,499,319,2,00183,India
286030,2023-11-30,603,tennis ball,25,60,35,3,00389,India
286030,2023-11-30,602,cricket ball,125,260,135,3,00389,India
286030,2023-11-30,611,helmet,200,400,200,2,00389,India
286030,2023-11-30,610,golf clubs,27000,42000,15000,2,00389,India
447768,2023-11-30,602,cricket ball,125,260,135,3,00368,India
447768,2023-11-30,605,badminton shuttlecocks,180,300,120,2,00368,India
447768,2023-11-30,609,basketball,298,679,381,2,00368,India
447768,2023-11-30,604,tennis racket,1200,1800,600,2,00368,India
824630,2023-11-30,605,badminton shuttlecocks,180,300,120,2,00119,India
824630,2023-11-30,609,basketball,298,679,381,2,00119,India
871581,2023-11-30,601,cricket bat,400,1500,1100,2,00107,India
112669,2023-11-30,601,cricket bat,400,1500,1100,2,00085,India
112669,2023-11-30,604,tennis racket,1200,1800,600,2,00085,India
112669,2023-11-30,602,cricket ball,125,260,135,3,00085,India
985687,2023-12-01,602,cricket ball,125,260,135,3,00065,India
985687,2023-12-01,605,badminton shuttlecocks,180,300,120,2,00065,India
494448,2023-12-02,605,badminton shuttlecocks,180,300,120,2,00264,India
494448,2023-12-02,611,helmet,200,400,200,2,00264,India
329116,2023-12-02,603,tennis ball,25,60,35,3,00138,India
329116,2023-12-02,607,table tennis table,20000,26500,6500,2,00138,India
329116,2023-12-02,602,cricket ball,125,260,135,3,00138,India
329116,2023-12-02,610,golf clubs,27000,42000,15000,2,00138,India
455859,2023-12-02,602,cricket ball,125,260,135,3,00063,India
455859,2023-12-02,610,golf clubs,27000,42000,15000,2,00063,India
961951,2023-12-02,610,golf clubs,27000,42000,15000,2,00394,India
961951,2023-12-02,602,cricket ball,125,260,135,3,00394,India
961951,2023-12-02,603,tennis ball,25,60,35,3,00394,India
121879,2023-12-02,603,tennis ball,25,60,35,3,00067,India
121879,2023-12-02,609,basketball,298,679,381,2,00067,India
121879,2023-12-02,605,badminton shuttlecocks,180,300,120,2,00067,India
121879,2023-12-02,602,cricket ball,125,260,135,3,00067,India
847493,2023-12-03,611,helmet,200,400,200,2,00059,India
847493,2023-12-03,603,tennis ball,25,60,35,3,00059,India
847493,2023-12-03,609,basketball,298,679,381,2,00059,India
847493,2023-12-03,605,badminton shuttlecocks,180,300,120,2,00059,India
847493,2023-12-03,602,cricket ball,125,260,135,3,00059,India
511441,2023-12-03,609,basketball,298,679,381,2,00454,India
511441,2023-12-03,611,helmet,200,400,200,2,00454,India
511441,2023-12-03,607,table tennis table,20000,26500,6500,2,00454,India
511441,2023-12-03,610,golf clubs,27000,42000,15000,2,00454,India
514951,2023-12-03,605,badminton shuttlecocks,180,300,120,2,00188,India
514951,2023-12-03,607,table tennis table,20000,26500,6500,2,00188,India
442648,2023-12-03,609,basketball,298,679,381,2,00028,India
442648,2023-12-03,608,football,298,1099,801,2,00028,India
442648,2023-12-03,605,badminton shuttlecocks,180,300,120,2,00028,India
539642,2023-12-03,601,cricket bat,400,1500,1100,2,00343,India
647749,2023-12-03,604,tennis racket,1200,1800,600,2,00151,India
526216,2023-12-03,607,table tennis table,20000,26500,6500,2,00211,India
388823,2023-12-03,608,football,298,1099,801,2,00154,India
388823,2023-12-03,610,golf clubs,27000,42000,15000,2,00154,India
388823,2023-12-03,603,tennis ball,25,60,35,3,00154,India
711183,2023-12-03,611,helmet,200,400,200,2,00152,India
639370,2023-12-03,607,table tennis table,20000,26500,6500,2,00212,India
639370,2023-12-03,602,cricket ball,125,260,135,3,00212,India
556866,2023-12-04,608,football,298,1099,801,2,00315,India
751872,2023-12-04,601,cricket bat,400,1500,1100,2,00354,India
751872,2023-12-04,603,tennis ball,25,60,35,3,00354,India
751872,2023-12-04,602,cricket ball,125,260,135,3,00354,India
928408,2023-12-04,605,badminton shuttlecocks,180,300,120,2,00179,India
928408,2023-12-04,604,tennis racket,1200,1800,600,2,00179,India
928408,2023-12-04,611,helmet,200,400,200,2,00179,India
901002,2023-12-04,610,golf clubs,27000,42000,15000,2,00377,India
901002,2023-12-04,602,cricket ball,125,260,135,3,00377,India
375944,2023-12-04,606,badminton rackets,180,499,319,2,00318,India
375944,2023-12-04,601,cricket bat,400,1500,1100,2,00318,India
375944,2023-12-04,611,helmet,200,400,200,2,00318,India
375944,2023-12-04,610,golf clubs,27000,42000,15000,2,00318,India
738947,2023-12-05,602,cricket ball,125,260,135,3,00437,India
738947,2023-12-05,601,cricket bat,400,1500,1100,2,00437,India
862142,2023-12-05,608,football,298,1099,801,2,00308,India
862142,2023-12-05,609,basketball,298,679,381,2,00308,India
862142,2023-12-05,611,helmet,200,400,200,2,00308,India
769648,2023-12-05,607,table tennis table,20000,26500,6500,2,00378,India
769648,2023-12-05,609,basketball,298,679,381,2,00378,India
640052,2023-12-06,603,tennis ball,25,60,35,3,00218,India
640052,2023-12-06,609,basketball,298,679,381,2,00218,India
640052,2023-12-06,602,cricket ball,125,260,135,3,00218,India
640052,2023-12-06,607,table tennis table,20000,26500,6500,2,00218,India
775232,2023-12-06,603,tennis ball,25,60,35,3,00485,India
775232,2023-12-06,610,golf clubs,27000,42000,15000,2,00485,India
775232,2023-12-06,604,tennis racket,1200,1800,600,2,00485,India
775232,2023-12-06,609,basketball,298,679,381,2,00485,India
168911,2023-12-07,610,golf clubs,27000,42000,15000,2,00139,India
168911,2023-12-07,601,cricket bat,400,1500,1100,2,00139,India
168911,2023-12-07,611,helmet,200,400,200,2,00139,India
210061,2023-12-07,610,golf clubs,27000,42000,15000,2,00129,India
210061,2023-12-07,606,badminton rackets,180,499,319,2,00129,India
210061,2023-12-07,609,basketball,298,679,381,2,00129,India
210061,2023-12-07,608,football,298,1099,801,2,00129,India
615060,2023-12-07,611,helmet,200,400,200,2,00404,India
615060,2023-12-07,609,basketball,298,679,381,2,00404,India
615060,2023-12-07,610,golf clubs,27000,42000,15000,2,00404,India
519514,2023-12-07,604,tennis racket,1200,1800,600,2,00343,India
519514,2023-12-07,611,helmet,200,400,200,2,00343,India
146633,2023-12-07,601,cricket bat,400,1500,1100,2,00489,India
621980,2023-12-07,607,table tennis table,20000,26500,6500,2,00452,India
621980,2023-12-07,604,tennis racket,1200,1800,600,2,00452,India
621980,2023-12-07,601,cricket bat,400,1500,1100,2,00452,India
196431,2023-12-07,607,table tennis table,20000,26500,6500,2,00146,India
466858,2023-12-08,606,badminton rackets,180,499,319,2,00381,India
466858,2023-12-08,603,tennis ball,25,60,35,3,00381,India
466858,2023-12-08,610,golf clubs,27000,42000,15000,2,00381,India
466858,2023-12-08,607,table tennis table,20000,26500,6500,2,00381,India
101871,2023-12-08,611,helmet,200,400,200,2,00030,India
101871,2023-12-08,608,football,298,1099,801,2,00030,India
308524,2023-12-08,607,table tennis table,20000,26500,6500,2,00088,India
308524,2023-12-08,610,golf clubs,27000,42000,15000,2,00088,India
308524,2023-12-08,604,tennis racket,1200,1800,600,2,00088,India
308524,2023-12-08,611,helmet,200,400,200,2,00088,India
308524,2023-12-08,601,cricket bat,400,1500,1100,2,00088,India
311827,2023-12-08,605,badminton shuttlecocks,180,300,120,2,00186,India
311827,2023-12-08,602,cricket ball,125,260,135,3,00186,India
279804,2023-12-08,601,cricket bat,400,1500,1100,2,00213,India
279804,2023-12-08,610,golf clubs,27000,42000,15000,2,00213,India
279804,2023-12-08,604,tennis racket,1200,1800,600,2,00213,India
475911,2023-12-08,601,cricket bat,400,1500,1100,2,00034,India
475911,2023-12-08,606,badminton rackets,180,499,319,2,00034,India
475911,2023-12-08,611,helmet,200,400,200,2,00034,India
290719,2023-12-08,608,football,298,1099,801,2,00172,India
290719,2023-12-08,606,badminton rackets,180,499,319,2,00172,India
290719,2023-12-08,601,cricket bat,400,1500,1100,2,00172,India
290719,2023-12-08,611,helmet,200,400,200,2,00172,India
105643,2023-12-08,609,basketball,298,679,381,2,00062,India
687179,2023-12-08,604,tennis racket,1200,1800,600,2,00137,India
687179,2023-12-08,602,cricket ball,125,260,135,3,00137,India
326808,2023-12-09,603,tennis ball,25,60,35,3,00156,India
326808,2023-12-09,601,cricket bat,400,1500,1100,2,00156,India
326808,2023-12-09,607,table tennis table,20000,26500,6500,2,00156,India
977112,2023-12-09,605,badminton shuttlecocks,180,300,120,2,00092,India
977112,2023-12-09,608,football,298,1099,801,2,00092,India
977112,2023-12-09,609,basketball,298,679,381,2,00092,India
977112,2023-12-09,606,badminton rackets,180,499,319,2,00092,India
603213,2023-12-10,611,helmet,200,400,200,2,00208,India
162296,2023-12-10,604,tennis racket,1200,1800,600,2,00181,India
162296,2023-12-10,606,badminton rackets,180,499,319,2,00181,India
162296,2023-12-10,602,cricket ball,125,260,135,3,00181,India
522770,2023-12-10,610,golf clubs,27000,42000,15000,2,00352,India
522770,2023-12-10,609,basketball,298,679,381,2,00352,India
574800,2023-12-10,606,badminton rackets,180,499,319,2,00148,India
112852,2023-12-10,607,table tennis table,20000,26500,6500,2,00304,India
627988,2023-12-11,604,tennis racket,1200,1800,600,2,00475,India
779842,2023-12-11,601,cricket bat,400,1500,1100,2,00372,India
779842,2023-12-11,609,basketball,298,679,381,2,00372,India
779842,2023-12-11,605,badminton shuttlecocks,180,300,120,2,00372,India
400758,2023-12-11,608,football,298,1099,801,2,00293,India
400758,2023-12-11,607,table tennis table,20000,26500,6500,2,00293,India
400758,2023-12-11,610,golf clubs,27000,42000,15000,2,00293,India
400758,2023-12-11,603,tennis ball,25,60,35,3,00293,India
181826,2023-12-11,607,table tennis table,20000,26500,6500,2,00467,India
184467,2023-12-11,609,basketball,298,679,381,2,00226,India
528173,2023-12-11,610,golf clubs,27000,42000,15000,2,00189,India
528173,2023-12-11,607,table tennis table,20000,26500,6500,2,00189,India
528173,2023-12-11,601,cricket bat,400,1500,1100,2,00189,India
528173,2023-12-11,608,football,298,1099,801,2,00189,India
803382,2023-12-12,602,cricket ball,125,260,135,3,00141,India
803382,2023-12-12,607,table tennis table,20000,26500,6500,2,00141,India
803382,2023-12-12,605,badminton shuttlecocks,180,300,120,2,00141,India
803382,2023-12-12,606,badminton rackets,180,499,319,2,00141,India
937867,2023-12-12,607,table tennis table,20000,26500,6500,2,00230,India
937867,2023-12-12,611,helmet,200,400,200,2,00230,India
937867,2023-12-12,610,golf clubs,27000,42000,15000,2,00230,India
937867,2023-12-12,603,tennis ball,25,60,35,3,00230,India
836210,2023-12-12,607,table tennis table,20000,26500,6500,2,00328,India
836210,2023-12-12,604,tennis racket,1200,1800,600,2,00328,India
836210,2023-12-12,611,helmet,200,400,200,2,00328,India
739864,2023-12-12,610,golf clubs,27000,42000,15000,2,00144,India
739864,2023-12-12,607,table tennis table,20000,26500,6500,2,00144,India
739864,2023-12-12,601,cricket bat,400,1500,1100,2,00144,India
973241,2023-12-12,605,badminton shuttlecocks,180,300,120,2,00228,India
973241,2023-12-12,611,helmet,200,400,200,2,00228,India
973241,2023-12-12,607,table tennis table,20000,26500,6500,2,00228,India
852740,2023-12-12,608,football,298,1099,801,2,00164,India
852740,2023-12-12,609,basketball,298,679,381,2,00164,India
852740,2023-12-12,606,badminton rackets,180,499,319,2,00164,India
249667,2023-12-13,605,badminton shuttlecocks,180,300,120,2,00254,India
249667,2023-12-13,609,basketball,298,679,381,2,00254,India
249667,2023-12-13,604,tennis racket,1200,1800,600,2,00254,India
537801,2023-12-13,605,badminton shuttlecocks,180,300,120,2,00301,India
537801,2023-12-13,601,cricket bat,400,1500,1100,2,00301,India
537801,2023-12-13,606,badminton rackets,180,499,319,2,00301,India
537801,2023-12-13,603,tennis ball,25,60,35,3,00301,India
805034,2023-12-13,607,table tennis table,20000,26500,6500,2,00333,India
345638,2023-12-13,606,badminton rackets,180,499,319,2,00443,India
345638,2023-12-13,610,golf clubs,27000,42000,15000,2,00443,India
345638,2023-12-13,601,cricket bat,400,1500,1100,2,00443,India
481062,2023-12-13,603,tennis ball,25,60,35,3,00126,India
481062,2023-12-13,610,golf clubs,27000,42000,15000,2,00126,India
786579,2023-12-13,608,football,298,1099,801,2,00308,India
411180,2023-12-13,605,badminton shuttlecocks,180,300,120,2,00175,India
411180,2023-12-13,610,golf clubs,27000,42000,15000,2,00175,India
764000,2023-12-13,607,table tennis table,20000,26500,6500,2,00209,India
290994,2023-12-16,609,basketball,298,679,381,2,00077,India
290994,2023-12-16,611,helmet,200,400,200,2,00077,India
290994,2023-12-16,605,badminton shuttlecocks,180,300,120,2,00077,India
290994,2023-12-16,607,table tennis table,20000,26500,6500,2,00077,India
650440,2023-12-17,604,tennis racket,1200,1800,600,2,00142,India
650440,2023-12-17,602,cricket ball,125,260,135,3,00142,India
650440,2023-12-17,606,badminton rackets,180,499,319,2,00142,India
951692,2023-12-17,609,basketball,298,679,381,2,00105,India
364843,2023-12-17,609,basketball,298,679,381,2,00395,India
364843,2023-12-17,604,tennis racket,1200,1800,600,2,00395,India
364843,2023-12-17,608,football,298,1099,801,2,00395,India
319759,2023-12-17,605,badminton shuttlecocks,180,300,120,2,00434,India
319759,2023-12-17,611,helmet,200,400,200,2,00434,India
319759,2023-12-17,609,basketball,298,679,381,2,00434,India
669711,2023-12-17,611,helmet,200,400,200,2,00308,India
853799,2023-12-17,603,tennis ball,25,60,35,3,00381,India
853799,2023-12-17,609,basketball,298,679,381,2,00381,India
290696,2023-12-17,605,badminton shuttlecocks,180,300,120,2,00028,India
290696,2023-12-17,602,cricket ball,125,260,135,3,00028,India
290696,2023-12-17,611,helmet,200,400,200,2,00028,India
706446,2023-12-17,604,tennis racket,1200,1800,600,2,00480,India
706446,2023-12-17,611,helmet,200,400,200,2,00480,India
195885,2023-12-19,607,table tennis table,20000,26500,6500,2,00425,India
195885,2023-12-19,603,tennis ball,25,60,35,3,00425,India
195885,2023-12-19,608,football,298,1099,801,2,00425,India
890389,2023-12-19,608,football,298,1099,801,2,00122,India
890389,2023-12-19,610,golf clubs,27000,42000,15000,2,00122,India
890389,2023-12-19,601,cricket bat,400,1500,1100,2,00122,India
205199,2023-12-20,605,badminton shuttlecocks,180,300,120,2,00392,India
288344,2023-12-20,608,football,298,1099,801,2,00463,India
621693,2023-12-20,607,table tennis table,20000,26500,6500,2,00233,India
621693,2023-12-20,604,tennis racket,1200,1800,600,2,00233,India
621693,2023-12-20,605,badminton shuttlecocks,180,300,120,2,00233,India
621693,2023-12-20,611,helmet,200,400,200,2,00233,India
621693,2023-12-20,602,cricket ball,125,260,135,3,00233,India
273500,2023-12-20,603,tennis ball,25,60,35,3,00206,India
273500,2023-12-20,608,football,298,1099,801,2,00206,India
838614,2023-12-20,609,basketball,298,679,381,2,00007,India
838614,2023-12-20,606,badminton rackets,180,499,319,2,00007,India
838614,2023-12-20,605,badminton shuttlecocks,180,300,120,2,00007,India
871829,2023-12-20,603,tennis ball,25,60,35,3,00444,India
686048,2023-12-20,606,badminton rackets,180,499,319,2,00347,India
686048,2023-12-20,603,tennis ball,25,60,35,3,00347,India
686048,2023-12-20,604,tennis racket,1200,1800,600,2,00347,India
686048,2023-12-20,611,helmet,200,400,200,2,00347,India
970201,2023-12-20,608,football,298,1099,801,2,00125,India
970201,2023-12-20,604,tennis racket,1200,1800,600,2,00125,India
970201,2023-12-20,610,golf clubs,27000,42000,15000,2,00125,India
350297,2023-12-20,601,cricket bat,400,1500,1100,2,00242,India
350297,2023-12-20,610,golf clubs,27000,42000,15000,2,00242,India
350297,2023-12-20,609,basketball,298,679,381,2,00242,India
487571,2023-12-20,607,table tennis table,20000,26500,6500,2,00203,India
487571,2023-12-20,606,badminton rackets,180,499,319,2,00203,India
487571,2023-12-20,602,cricket ball,125,260,135,3,00203,India
757468,2023-12-21,606,badminton rackets,180,499,319,2,00085,India
757468,2023-12-21,610,golf clubs,27000,42000,15000,2,00085,India
757468,2023-12-21,605,badminton shuttlecocks,180,300,120,2,00085,India
272797,2023-12-21,606,badminton rackets,180,499,319,2,00034,India
272797,2023-12-21,605,badminton shuttlecocks,180,300,120,2,00034,India
289921,2023-12-21,606,badminton rackets,180,499,319,2,00246,India
289921,2023-12-21,601,cricket bat,400,1500,1100,2,00246,India
289921,2023-12-21,602,cricket ball,125,260,135,3,00246,India
947488,2023-12-21,609,basketball,298,679,381,2,00127,India
584841,2023-12-21,610,golf clubs,27000,42000,15000,2,00040,India
584841,2023-12-21,611,helmet,200,400,200,2,00040,India
164395,2023-12-21,606,badminton rackets,180,499,319,2,00367,India
164395,2023-12-21,602,cricket ball,125,260,135,3,00367,India
440190,2023-12-21,603,tennis ball,25,60,35,3,00269,India
440190,2023-12-21,604,tennis racket,1200,1800,600,2,00269,India
440190,2023-12-21,608,football,298,1099,801,2,00269,India
440190,2023-12-21,606,badminton rackets,180,499,319,2,00269,India
502315,2023-12-21,607,table tennis table,20000,26500,6500,2,00476,India
502315,2023-12-21,605,badminton shuttlecocks,180,300,120,2,00476,India
502315,2023-12-21,604,tennis racket,1200,1800,600,2,00476,India
294150,2023-12-21,602,cricket ball,125,260,135,3,00202,India
294150,2023-12-21,606,badminton rackets,180,499,319,2,00202,India
294150,2023-12-21,603,tennis ball,25,60,35,3,00202,India
294150,2023-12-21,604,tennis racket,1200,1800,600,2,00202,India
294150,2023-12-21,611,helmet,200,400,200,2,00202,India
442280,2023-12-22,611,helmet,200,400,200,2,00473,India
442280,2023-12-22,607,table tennis table,20000,26500,6500,2,00473,India
442280,2023-12-22,605,badminton shuttlecocks,180,300,120,2,00473,India
553228,2023-12-22,607,table tennis table,20000,26500,6500,2,00498,India
553228,2023-12-22,610,golf clubs,27000,42000,15000,2,00498,India
553228,2023-12-22,605,badminton shuttlecocks,180,300,120,2,00498,India
608805,2023-12-22,611,helmet,200,400,200,2,00214,India
539567,2023-12-22,602,cricket ball,125,260,135,3,00193,India
274118,2023-12-22,608,football,298,1099,801,2,00020,India
274118,2023-12-22,602,cricket ball,125,260,135,3,00020,India
274118,2023-12-22,609,basketball,298,679,381,2,00020,India
552470,2023-12-23,611,helmet,200,400,200,2,00127,India
552470,2023-12-23,606,badminton rackets,180,499,319,2,00127,India
552470,2023-12-23,603,tennis ball,25,60,35,3,00127,India
552470,2023-12-23,605,badminton shuttlecocks,180,300,120,2,00127,India
354813,2023-12-23,606,badminton rackets,180,499,319,2,00036,India
354813,2023-12-23,604,tennis racket,1200,1800,600,2,00036,India
354813,2023-12-23,611,helmet,200,400,200,2,00036,India
354813,2023-12-23,610,golf clubs,27000,42000,15000,2,00036,India
354813,2023-12-23,603,tennis ball,25,60,35,3,00036,India
526858,2023-12-23,610,golf clubs,27000,42000,15000,2,00091,India
526858,2023-12-23,607,table tennis table,20000,26500,6500,2,00091,India
526858,2023-12-23,609,basketball,298,679,381,2,00091,India
526858,2023-12-23,605,badminton shuttlecocks,180,300,120,2,00091,India
526858,2023-12-23,602,cricket ball,125,260,135,3,00091,India
567141,2023-12-23,610,golf clubs,27000,42000,15000,2,00304,India
567141,2023-12-23,605,badminton shuttlecocks,180,300,120,2,00304,India
567141,2023-12-23,609,basketball,298,679,381,2,00304,India
315178,2023-12-23,603,tennis ball,25,60,35,3,00381,India
468860,2023-12-23,610,golf clubs,27000,42000,15000,2,00195,India
468860,2023-12-23,602,cricket ball,125,260,135,3,00195,India
468860,2023-12-23,611,helmet,200,400,200,2,00195,India
978216,2023-12-23,602,cricket ball,125,260,135,3,00032,India
978216,2023-12-23,604,tennis racket,1200,1800,600,2,00032,India
923296,2023-12-23,605,badminton shuttlecocks,180,300,120,2,00058,India
923296,2023-12-23,601,cricket bat,400,1500,1100,2,00058,India
740757,2023-12-23,610,golf clubs,27000,42000,15000,2,00087,India
740757,2023-12-23,606,badminton rackets,180,499,319,2,00087,India
204972,2023-12-23,605,badminton shuttlecocks,180,300,120,2,00175,India
204972,2023-12-23,604,tennis racket,1200,1800,600,2,00175,India
204972,2023-12-23,610,golf clubs,27000,42000,15000,2,00175,India
182075,2023-12-24,601,cricket bat,400,1500,1100,2,00132,India
182075,2023-12-24,604,tennis racket,1200,1800,600,2,00132,India
382341,2023-12-24,611,helmet,200,400,200,2,00351,India
382341,2023-12-24,601,cricket bat,400,1500,1100,2,00351,India
382341,2023-12-24,602,cricket ball,125,260,135,3,00351,India
104397,2023-12-24,605,badminton shuttlecocks,180,300,120,2,00493,India
104397,2023-12-24,607,table tennis table,20000,26500,6500,2,00493,India
211948,2023-12-24,602,cricket ball,125,260,135,3,00275,India
211948,2023-12-24,605,badminton shuttlecocks,180,300,120,2,00275,India
808984,2023-12-24,604,tennis racket,1200,1800,600,2,00128,India
808984,2023-12-24,608,football,298,1099,801,2,00128,India
157606,2023-12-24,605,badminton shuttlecocks,180,300,120,2,00028,India
157606,2023-12-24,610,golf clubs,27000,42000,15000,2,00028,India
335823,2023-12-24,602,cricket ball,125,260,135,3,00067,India
335823,2023-12-24,610,golf clubs,27000,42000,15000,2,00067,India
335823,2023-12-24,611,helmet,200,400,200,2,00067,India
439513,2023-12-24,606,badminton rackets,180,499,319,2,00209,India
439513,2023-12-24,602,cricket ball,125,260,135,3,00209,India
414079,2023-12-24,601,cricket bat,400,1500,1100,2,00210,India
414079,2023-12-24,602,cricket ball,125,260,135,3,00210,India
414079,2023-12-24,605,badminton shuttlecocks,180,300,120,2,00210,India
877350,2023-12-24,609,basketball,298,679,381,2,00291,India
877350,2023-12-24,611,helmet,200,400,200,2,00291,India
877350,2023-12-24,607,table tennis table,20000,26500,6500,2,00291,India
861896,2023-12-25,604,tennis racket,1200,1800,600,2,00481,India
861896,2023-12-25,608,football,298,1099,801,2,00481,India
861896,2023-12-25,611,helmet,200,400,200,2,00481,India
861896,2023-12-25,607,table tennis table,20000,26500,6500,2,00481,India
861896,2023-12-25,602,cricket ball,125,260,135,3,00481,India
185285,2023-12-25,604,tennis racket,1200,1800,600,2,00120,India
185285,2023-12-25,603,tennis ball,25,60,35,3,00120,India
185285,2023-12-25,605,badminton shuttlecocks,180,300,120,2,00120,India
730749,2023-12-25,605,badminton shuttlecocks,180,300,120,2,00384,India
730749,2023-12-25,604,tennis racket,1200,1800,600,2,00384,India
179690,2023-12-26,601,cricket bat,400,1500,1100,2,00261,India
736377,2023-12-26,606,badminton rackets,180,499,319,2,00275,India
736377,2023-12-26,607,table tennis table,20000,26500,6500,2,00275,India
736377,2023-12-26,603,tennis ball,25,60,35,3,00275,India
736377,2023-12-26,605,badminton shuttlecocks,180,300,120,2,00275,India
463463,2023-12-26,605,badminton shuttlecocks,180,300,120,2,00286,India
463463,2023-12-26,608,football,298,1099,801,2,00286,India
463463,2023-12-26,610,golf clubs,27000,42000,15000,2,00286,India
463463,2023-12-26,601,cricket bat,400,1500,1100,2,00286,India
463463,2023-12-26,604,tennis racket,1200,1800,600,2,00286,India
155733,2023-12-26,603,tennis ball,25,60,35,3,00222,India
155733,2023-12-26,601,cricket bat,400,1500,1100,2,00222,India
155733,2023-12-26,608,football,298,1099,801,2,00222,India
362224,2023-12-26,606,badminton rackets,180,499,319,2,00059,India
362224,2023-12-26,604,tennis racket,1200,1800,600,2,00059,India
362224,2023-12-26,607,table tennis table,20000,26500,6500,2,00059,India
291220,2023-12-26,611,helmet,200,400,200,2,00406,India
620834,2023-12-26,606,badminton rackets,180,499,319,2,00196,India
620834,2023-12-26,602,cricket ball,125,260,135,3,00196,India
620834,2023-12-26,604,tennis racket,1200,1800,600,2,00196,India
770178,2023-12-26,610,golf clubs,27000,42000,15000,2,00318,India
770178,2023-12-26,611,helmet,200,400,200,2,00318,India
565254,2023-12-27,606,badminton rackets,180,499,319,2,00343,India
565254,2023-12-27,601,cricket bat,400,1500,1100,2,00343,India
763245,2023-12-27,608,football,298,1099,801,2,00231,India
763245,2023-12-27,609,basketball,298,679,381,2,00231,India
240510,2023-12-27,610,golf clubs,27000,42000,15000,2,00024,India
240510,2023-12-27,603,tennis ball,25,60,35,3,00024,India
240510,2023-12-27,606,badminton rackets,180,499,319,2,00024,India
654578,2023-12-27,610,golf clubs,27000,42000,15000,2,00215,India
654578,2023-12-27,606,badminton rackets,180,499,319,2,00215,India
349962,2023-12-27,606,badminton rackets,180,499,319,2,00059,India
570157,2023-12-27,610,golf clubs,27000,42000,15000,2,00150,India
570157,2023-12-27,606,badminton rackets,180,499,319,2,00150,India
570157,2023-12-27,602,cricket ball,125,260,135,3,00150,India
905421,2023-12-27,611,helmet,200,400,200,2,00182,India
905421,2023-12-27,603,tennis ball,25,60,35,3,00182,India
905421,2023-12-27,602,cricket ball,125,260,135,3,00182,India
905421,2023-12-27,604,tennis racket,1200,1800,600,2,00182,India
848158,2023-12-27,610,golf clubs,27000,42000,15000,2,00082,India
848158,2023-12-27,601,cricket bat,400,1500,1100,2,00082,India
411843,2023-12-27,606,badminton rackets,180,499,319,2,00192,India
459620,2023-12-27,604,tennis racket,1200,1800,600,2,00283,India
459620,2023-12-27,606,badminton rackets,180,499,319,2,00283,India
459620,2023-12-27,607,table tennis table,20000,26500,6500,2,00283,India
646288,2023-12-28,602,cricket ball,125,260,135,3,00010,India
162368,2023-12-28,602,cricket ball,125,260,135,3,00296,India
162368,2023-12-28,607,table tennis table,20000,26500,6500,2,00296,India
162368,2023-12-28,605,badminton shuttlecocks,180,300,120,2,00296,India
162368,2023-12-28,601,cricket bat,400,1500,1100,2,00296,India
162368,2023-12-28,606,badminton rackets,180,499,319,2,00296,India
462262,2023-12-28,607,table tennis table,20000,26500,6500,2,00261,India
462262,2023-12-28,609,basketball,298,679,381,2,00261,India
977482,2023-12-28,610,golf clubs,27000,42000,15000,2,00427,India
977482,2023-12-28,607,table tennis table,20000,26500,6500,2,00427,India
136632,2023-12-28,610,golf clubs,27000,42000,15000,2,00221,India
136632,2023-12-28,607,table tennis table,20000,26500,6500,2,00221,India
136632,2023-12-28,608,football,298,1099,801,2,00221,India
136632,2023-12-28,603,tennis ball,25,60,35,3,00221,India
417641,2023-12-28,607,table tennis table,20000,26500,6500,2,00351,India
417641,2023-12-28,602,cricket ball,125,260,135,3,00351,India
319752,2023-12-28,609,basketball,298,679,381,2,00089,India
319752,2023-12-28,604,tennis racket,1200,1800,600,2,00089,India
723274,2023-12-28,603,tennis ball,25,60,35,3,00313,India
723274,2023-12-28,606,badminton rackets,180,499,319,2,00313,India
774751,2023-12-29,606,badminton rackets,180,499,319,2,00408,India
774751,2023-12-29,603,tennis ball,25,60,35,3,00408,India
774751,2023-12-29,607,table tennis table,20000,26500,6500,2,00408,India
667123,2023-12-29,604,tennis racket,1200,1800,600,2,00030,India
667123,2023-12-29,608,football,298,1099,801,2,00030,India
667123,2023-12-29,610,golf clubs,27000,42000,15000,2,00030,India
667123,2023-12-29,605,badminton shuttlecocks,180,300,120,2,00030,India
667123,2023-12-29,606,badminton rackets,180,499,319,2,00030,India
959307,2023-12-29,603,tennis ball,25,60,35,3,00024,India
959307,2023-12-29,608,football,298,1099,801,2,00024,India
959307,2023-12-29,610,golf clubs,27000,42000,15000,2,00024,India
206808,2023-12-29,606,badminton rackets,180,499,319,2,00098,India
127929,2023-12-29,608,football,298,1099,801,2,00096,India
127929,2023-12-29,610,golf clubs,27000,42000,15000,2,00096,India
127929,2023-12-29,601,cricket bat,400,1500,1100,2,00096,India
650010,2023-12-29,601,cricket bat,400,1500,1100,2,00318,India
493009,2023-12-29,601,cricket bat,400,1500,1100,2,00370,India
493009,2023-12-29,607,table tennis table,20000,26500,6500,2,00370,India
204788,2023-12-30,606,badminton rackets,180,499,319,2,00157,India
204788,2023-12-30,605,badminton shuttlecocks,180,300,120,2,00157,India
271316,2023-12-30,604,tennis racket,1200,1800,600,2,00465,India
702588,2023-12-30,603,tennis ball,25,60,35,3,00104,India
702588,2023-12-30,605,badminton shuttlecocks,180,300,120,2,00104,India
394661,2023-12-30,609,basketball,298,679,381,2,00408,India
946208,2023-12-30,601,cricket bat,400,1500,1100,2,00201,India
946208,2023-12-30,606,badminton rackets,180,499,319,2,00201,India
946208,2023-12-30,611,helmet,200,400,200,2,00201,India
946208,2023-12-30,602,cricket ball,125,260,135,3,00201,India
946208,2023-12-30,608,football,298,1099,801,2,00201,India
472848,2023-12-30,610,golf clubs,27000,42000,15000,2,00208,India
472848,2023-12-30,601,cricket bat,400,1500,1100,2,00208,India
472848,2023-12-30,602,cricket ball,125,260,135,3,00208,India
472848,2023-12-30,608,football,298,1099,801,2,00208,India
242051,2023-12-30,607,table tennis table,20000,26500,6500,2,00413,India
242051,2023-12-30,602,cricket ball,125,260,135,3,00413,India
242051,2023-12-30,601,cricket bat,400,1500,1100,2,00413,India
242051,2023-12-30,605,badminton shuttlecocks,180,300,120,2,00413,India
242051,2023-12-30,604,tennis racket,1200,1800,600,2,00413,India
754048,2023-12-30,611,helmet,200,400,200,2,00037,India
754048,2023-12-30,610,golf clubs,27000,42000,15000,2,00037,India
754048,2023-12-30,603,tennis ball,25,60,35,3,00037,India
754048,2023-12-30,605,badminton shuttlecocks,180,300,120,2,00037,India
754048,2023-12-30,602,cricket ball,125,260,135,3,00037,India
642802,2023-12-30,603,tennis ball,25,60,35,3,00443,India
642802,2023-12-30,609,basketball,298,679,381,2,00443,India
642802,2023-12-30,606,badminton rackets,180,499,319,2,00443,India
642802,2023-12-30,602,cricket ball,125,260,135,3,00443,India
735285,2023-12-31,601,cricket bat,400,1500,1100,2,00473,India
775992,2023-12-31,602,cricket ball,125,260,135,3,00384,India
775992,2023-12-31,604,tennis racket,1200,1800,600,2,00384,India
775992,2023-12-31,608,football,298,1099,801,2,00384,India
846839,2023-12-31,602,cricket ball,125,260,135,3,00160,India
846839,2023-12-31,609,basketball,298,679,381,2,00160,India
846839,2023-12-31,608,football,298,1099,801,2,00160,India
587904,2023-12-31,609,basketball,298,679,381,2,00335,India
363059,2023-12-31,606,badminton rackets,180,499,319,2,00074,India
363059,2023-12-31,608,football,298,1099,801,2,00074,India
363059,2023-12-31,609,basketball,298,679,381,2,00074,India
144373,2023-12-31,609,basketball,298,679,381,2,00005,India
144373,2023-12-31,611,helmet,200,400,200,2,00005,India
150516,2023-12-31,605,badminton shuttlecocks,180,300,120,2,00176,India
150516,2023-12-31,607,table tennis table,20000,26500,6500,2,00176,India
150516,2023-12-31,606,badminton rackets,180,499,319,2,00176,India
572795,2024-01-01,602,cricket ball,125,260,135,1,00341,India
572795,2024-01-01,607,table tennis table,20000,26500,6500,1,00341,India
572795,2024-01-01,603,tennis ball,25,60,35,1,00341,India
277758,2024-01-01,611,helmet,200,400,200,1,00273,India
624450,2024-01-01,605,badminton shuttlecocks,180,300,120,1,00120,India
240444,2024-01-01,608,football,298,1099,801,1,00192,India
240444,2024-01-01,606,badminton rackets,180,499,319,1,00192,India
240444,2024-01-01,602,cricket ball,125,260,135,1,00192,India
240444,2024-01-01,604,tennis racket,1200,1800,600,1,00192,India
932584,2024-01-01,608,football,298,1099,801,1,00345,India
768880,2024-01-01,604,tennis racket,1200,1800,600,1,00439,India
704755,2024-01-01,608,football,298,1099,801,1,00143,India
704755,2024-01-01,602,cricket ball,125,260,135,1,00143,India
704755,2024-01-01,610,golf clubs,27000,42000,15000,1,00143,India
858118,2024-01-02,610,golf clubs,27000,42000,15000,1,00210,India
858118,2024-01-02,601,cricket bat,400,1500,1100,1,00210,India
858118,2024-01-02,608,football,298,1099,801,1,00210,India
803693,2024-01-02,611,helmet,200,400,200,1,00079,India
234448,2024-01-02,605,badminton shuttlecocks,180,300,120,1,00444,India
234448,2024-01-02,607,table tennis table,20000,26500,6500,1,00444,India
234448,2024-01-02,604,tennis racket,1200,1800,600,1,00444,India
234448,2024-01-02,608,football,298,1099,801,1,00444,India
296685,2024-01-02,602,cricket ball,125,260,135,1,00017,India
296685,2024-01-02,609,basketball,298,679,381,1,00017,India
296685,2024-01-02,601,cricket bat,400,1500,1100,1,00017,India
875913,2024-01-02,607,table tennis table,20000,26500,6500,1,00432,India
875913,2024-01-02,608,football,298,1099,801,1,00432,India
875913,2024-01-02,603,tennis ball,25,60,35,1,00432,India
135073,2024-01-02,608,football,298,1099,801,1,00426,India
135073,2024-01-02,606,badminton rackets,180,499,319,1,00426,India
135073,2024-01-02,602,cricket ball,125,260,135,1,00426,India
135073,2024-01-02,601,cricket bat,400,1500,1100,1,00426,India
312421,2024-01-02,611,helmet,200,400,200,1,00222,India
312421,2024-01-02,605,badminton shuttlecocks,180,300,120,1,00222,India
312421,2024-01-02,608,football,298,1099,801,1,00222,India
312421,2024-01-02,603,tennis ball,25,60,35,1,00222,India
166495,2024-01-03,610,golf clubs,27000,42000,15000,1,00198,India
166495,2024-01-03,602,cricket ball,125,260,135,1,00198,India
166495,2024-01-03,611,helmet,200,400,200,1,00198,India
166495,2024-01-03,603,tennis ball,25,60,35,1,00198,India
923986,2024-01-03,611,helmet,200,400,200,1,00130,India
923986,2024-01-03,603,tennis ball,25,60,35,1,00130,India
579498,2024-01-03,603,tennis ball,25,60,35,1,00075,India
214822,2024-01-03,608,football,298,1099,801,1,00063,India
214822,2024-01-03,601,cricket bat,400,1500,1100,1,00063,India
214822,2024-01-03,611,helmet,200,400,200,1,00063,India
731575,2024-01-03,604,tennis racket,1200,1800,600,1,00456,India
731575,2024-01-03,602,cricket ball,125,260,135,1,00456,India
731575,2024-01-03,608,football,298,1099,801,1,00456,India
196154,2024-01-03,611,helmet,200,400,200,1,00179,India
196154,2024-01-03,601,cricket bat,400,1500,1100,1,00179,India
196154,2024-01-03,609,basketball,298,679,381,1,00179,India
196154,2024-01-03,604,tennis racket,1200,1800,600,1,00179,India
750507,2024-01-04,602,cricket ball,125,260,135,1,00410,India
750507,2024-01-04,606,badminton rackets,180,499,319,1,00410,India
750507,2024-01-04,601,cricket bat,400,1500,1100,1,00410,India
750507,2024-01-04,604,tennis racket,1200,1800,600,1,00410,India
329319,2024-01-04,602,cricket ball,125,260,135,1,00268,India
329319,2024-01-04,607,table tennis table,20000,26500,6500,1,00268,India
329319,2024-01-04,610,golf clubs,27000,42000,15000,1,00268,India
499287,2024-01-04,611,helmet,200,400,200,1,00036,India
929873,2024-01-04,605,badminton shuttlecocks,180,300,120,1,00292,India
929873,2024-01-04,604,tennis racket,1200,1800,600,1,00292,India
929873,2024-01-04,609,basketball,298,679,381,1,00292,India
201195,2024-01-04,607,table tennis table,20000,26500,6500,1,00186,India
201195,2024-01-04,606,badminton rackets,180,499,319,1,00186,India
170423,2024-01-05,610,golf clubs,27000,42000,15000,1,00497,India
170423,2024-01-05,605,badminton shuttlecocks,180,300,120,1,00497,India
805116,2024-01-05,608,football,298,1099,801,1,00112,India
805116,2024-01-05,604,tennis racket,1200,1800,600,1,00112,India
805116,2024-01-05,601,cricket bat,400,1500,1100,1,00112,India
805116,2024-01-05,605,badminton shuttlecocks,180,300,120,1,00112,India
877021,2024-01-05,603,tennis ball,25,60,35,1,00262,India
877021,2024-01-05,602,cricket ball,125,260,135,1,00262,India
877021,2024-01-05,605,badminton shuttlecocks,180,300,120,1,00262,India
636474,2024-01-05,606,badminton rackets,180,499,319,1,00243,India
636474,2024-01-05,609,basketball,298,679,381,1,00243,India
636474,2024-01-05,608,football,298,1099,801,1,00243,India
636474,2024-01-05,602,cricket ball,125,260,135,1,00243,India
815614,2024-01-07,604,tennis racket,1200,1800,600,1,00398,India
871563,2024-01-07,606,badminton rackets,180,499,319,1,00241,India
871563,2024-01-07,603,tennis ball,25,60,35,1,00241,India
871563,2024-01-07,608,football,298,1099,801,1,00241,India
303421,2024-01-07,604,tennis racket,1200,1800,600,1,00360,India
136953,2024-01-07,606,badminton rackets,180,499,319,1,00365,India
136953,2024-01-07,608,football,298,1099,801,1,00365,India
136953,2024-01-07,609,basketball,298,679,381,1,00365,India
136953,2024-01-07,605,badminton shuttlecocks,180,300,120,1,00365,India
136953,2024-01-07,610,golf clubs,27000,42000,15000,1,00365,India
953622,2024-01-07,601,cricket bat,400,1500,1100,1,00476,India
269449,2024-01-07,609,basketball,298,679,381,1,00496,India
289255,2024-01-07,608,football,298,1099,801,1,00130,India
289255,2024-01-07,611,helmet,200,400,200,1,00130,India
289255,2024-01-07,607,table tennis table,20000,26500,6500,1,00130,India
868912,2024-01-07,607,table tennis table,20000,26500,6500,1,00031,India
868912,2024-01-07,602,cricket ball,125,260,135,1,00031,India
718640,2024-01-08,604,tennis racket,1200,1800,600,1,00132,India
718640,2024-01-08,601,cricket bat,400,1500,1100,1,00132,India
718640,2024-01-08,611,helmet,200,400,200,1,00132,India
957966,2024-01-08,609,basketball,298,679,381,1,00334,India
957966,2024-01-08,608,football,298,1099,801,1,00334,India
957966,2024-01-08,604,tennis racket,1200,1800,600,1,00334,India
594604,2024-01-08,609,basketball,298,679,381,1,00497,India
594604,2024-01-08,605,badminton shuttlecocks,180,300,120,1,00497,India
543791,2024-01-08,603,tennis ball,25,60,35,1,00455,India
543791,2024-01-08,609,basketball,298,679,381,1,00455,India
293551,2024-01-08,602,cricket ball,125,260,135,1,00289,India
293551,2024-01-08,611,helmet,200,400,200,1,00289,India
474476,2024-01-08,607,table tennis table,20000,26500,6500,1,00017,India
474476,2024-01-08,603,tennis ball,25,60,35,1,00017,India
474476,2024-01-08,605,badminton shuttlecocks,180,300,120,1,00017,India
474476,2024-01-08,606,badminton rackets,180,499,319,1,00017,India
474476,2024-01-08,601,cricket bat,400,1500,1100,1,00017,India
788095,2024-01-08,605,badminton shuttlecocks,180,300,120,1,00071,India
788095,2024-01-08,602,cricket ball,125,260,135,1,00071,India
748020,2024-01-09,603,tennis ball,25,60,35,1,00255,India
748020,2024-01-09,607,table tennis table,20000,26500,6500,1,00255,India
144154,2024-01-09,608,football,298,1099,801,1,00028,India
301266,2024-01-10,603,tennis ball,25,60,35,1,00223,India
301266,2024-01-10,610,golf clubs,27000,42000,15000,1,00223,India
301266,2024-01-10,601,cricket bat,400,1500,1100,1,00223,India
928572,2024-01-11,606,badminton rackets,180,499,319,1,00461,India
928572,2024-01-11,601,cricket bat,400,1500,1100,1,00461,India
928572,2024-01-11,608,football,298,1099,801,1,00461,India
928572,2024-01-11,609,basketball,298,679,381,1,00461,India
928572,2024-01-11,604,tennis racket,1200,1800,600,1,00461,India
766176,2024-01-11,609,basketball,298,679,381,1,00010,India
766176,2024-01-11,601,cricket bat,400,1500,1100,1,00010,India
766176,2024-01-11,606,badminton rackets,180,499,319,1,00010,India
942641,2024-01-11,603,tennis ball,25,60,35,1,00011,India
942641,2024-01-11,605,badminton shuttlecocks,180,300,120,1,00011,India
942641,2024-01-11,606,badminton rackets,180,499,319,1,00011,India
942641,2024-01-11,608,football,298,1099,801,1,00011,India
207592,2024-01-13,610,golf clubs,27000,42000,15000,1,00141,India
207592,2024-01-13,609,basketball,298,679,381,1,00141,India
207592,2024-01-13,606,badminton rackets,180,499,319,1,00141,India
221264,2024-01-13,607,table tennis table,20000,26500,6500,1,00253,India
221264,2024-01-13,602,cricket ball,125,260,135,1,00253,India
221264,2024-01-13,606,badminton rackets,180,499,319,1,00253,India
196063,2024-01-13,611,helmet,200,400,200,1,00187,India
196063,2024-01-13,609,basketball,298,679,381,1,00187,India
450474,2024-01-13,604,tennis racket,1200,1800,600,1,00047,India
450474,2024-01-13,610,golf clubs,27000,42000,15000,1,00047,India
450474,2024-01-13,601,cricket bat,400,1500,1100,1,00047,India
456396,2024-01-13,605,badminton shuttlecocks,180,300,120,1,00368,India
384146,2024-01-14,611,helmet,200,400,200,1,00132,India
504189,2024-01-14,603,tennis ball,25,60,35,1,00486,India
504189,2024-01-14,608,football,298,1099,801,1,00486,India
504189,2024-01-14,604,tennis racket,1200,1800,600,1,00486,India
533511,2024-01-14,604,tennis racket,1200,1800,600,1,00235,India
533511,2024-01-14,607,table tennis table,20000,26500,6500,1,00235,India
533511,2024-01-14,606,badminton rackets,180,499,319,1,00235,India
533511,2024-01-14,608,football,298,1099,801,1,00235,India
470493,2024-01-14,601,cricket bat,400,1500,1100,1,00219,India
566548,2024-01-14,607,table tennis table,20000,26500,6500,1,00464,India
566548,2024-01-14,601,cricket bat,400,1500,1100,1,00464,India
566548,2024-01-14,605,badminton shuttlecocks,180,300,120,1,00464,India
566548,2024-01-14,604,tennis racket,1200,1800,600,1,00464,India
289066,2024-01-14,606,badminton rackets,180,499,319,1,00318,India
289066,2024-01-14,610,golf clubs,27000,42000,15000,1,00318,India
289066,2024-01-14,608,football,298,1099,801,1,00318,India
168763,2024-01-15,604,tennis racket,1200,1800,600,1,00112,India
168763,2024-01-15,605,badminton shuttlecocks,180,300,120,1,00112,India
168763,2024-01-15,602,cricket ball,125,260,135,1,00112,India
168763,2024-01-15,611,helmet,200,400,200,1,00112,India
170089,2024-01-15,605,badminton shuttlecocks,180,300,120,1,00146,India
170089,2024-01-15,611,helmet,200,400,200,1,00146,India
170089,2024-01-15,609,basketball,298,679,381,1,00146,India
223369,2024-01-15,611,helmet,200,400,200,1,00186,India
223369,2024-01-15,607,table tennis table,20000,26500,6500,1,00186,India
655651,2024-01-15,611,helmet,200,400,200,1,00188,India
655651,2024-01-15,606,badminton rackets,180,499,319,1,00188,India
655651,2024-01-15,605,badminton shuttlecocks,180,300,120,1,00188,India
655651,2024-01-15,609,basketball,298,679,381,1,00188,India
655651,2024-01-15,601,cricket bat,400,1500,1100,1,00188,India
659879,2024-01-15,610,golf clubs,27000,42000,15000,1,00061,India
758576,2024-01-15,606,badminton rackets,180,499,319,1,00288,India
758576,2024-01-15,601,cricket bat,400,1500,1100,1,00288,India
631572,2024-01-15,602,cricket ball,125,260,135,1,00333,India
631572,2024-01-15,607,table tennis table,20000,26500,6500,1,00333,India
631572,2024-01-15,610,golf clubs,27000,42000,15000,1,00333,India
631572,2024-01-15,606,badminton rackets,180,499,319,1,00333,India
631572,2024-01-15,601,cricket bat,400,1500,1100,1,00333,India
876424,2024-01-15,611,helmet,200,400,200,1,00006,India
876424,2024-01-15,608,football,298,1099,801,1,00006,India
117967,2024-01-15,601,cricket bat,400,1500,1100,1,00164,India
117967,2024-01-15,609,basketball,298,679,381,1,00164,India
117967,2024-01-15,604,tennis racket,1200,1800,600,1,00164,India
117967,2024-01-15,602,cricket ball,125,260,135,1,00164,India
117967,2024-01-15,605,badminton shuttlecocks,180,300,120,1,00164,India
342744,2024-01-15,601,cricket bat,400,1500,1100,1,00219,India
342744,2024-01-15,610,golf clubs,27000,42000,15000,1,00219,India
631868,2024-01-16,602,cricket ball,125,260,135,1,00447,India
631868,2024-01-16,608,football,298,1099,801,1,00447,India
631868,2024-01-16,607,table tennis table,20000,26500,6500,1,00447,India
631868,2024-01-16,601,cricket bat,400,1500,1100,1,00447,India
631868,2024-01-16,609,basketball,298,679,381,1,00447,India
125617,2024-01-16,606,badminton rackets,180,499,319,1,00462,India
125617,2024-01-16,602,cricket ball,125,260,135,1,00462,India
125617,2024-01-16,604,tennis racket,1200,1800,600,1,00462,India
362010,2024-01-16,607,table tennis table,20000,26500,6500,1,00019,India
362010,2024-01-16,604,tennis racket,1200,1800,600,1,00019,India
362010,2024-01-16,611,helmet,200,400,200,1,00019,India
313935,2024-01-16,608,football,298,1099,801,1,00450,India
313935,2024-01-16,610,golf clubs,27000,42000,15000,1,00450,India
313935,2024-01-16,606,badminton rackets,180,499,319,1,00450,India
931704,2024-01-16,603,tennis ball,25,60,35,1,00435,India
931704,2024-01-16,611,helmet,200,400,200,1,00435,India
151998,2024-01-16,606,badminton rackets,180,499,319,1,00288,India
151998,2024-01-16,609,basketball,298,679,381,1,00288,India
151998,2024-01-16,602,cricket ball,125,260,135,1,00288,India
409341,2024-01-16,603,tennis ball,25,60,35,1,00052,India
364482,2024-01-16,607,table tennis table,20000,26500,6500,1,00439,India
364482,2024-01-16,606,badminton rackets,180,499,319,1,00439,India
364482,2024-01-16,611,helmet,200,400,200,1,00439,India
364482,2024-01-16,602,cricket ball,125,260,135,1,00439,India
301151,2024-01-16,610,golf clubs,27000,42000,15000,1,00366,India
301151,2024-01-16,605,badminton shuttlecocks,180,300,120,1,00366,India
301151,2024-01-16,602,cricket ball,125,260,135,1,00366,India
741982,2024-01-18,609,basketball,298,679,381,1,00348,India
741982,2024-01-18,604,tennis racket,1200,1800,600,1,00348,India
521884,2024-01-18,604,tennis racket,1200,1800,600,1,00065,India
521884,2024-01-18,610,golf clubs,27000,42000,15000,1,00065,India
521884,2024-01-18,601,cricket bat,400,1500,1100,1,00065,India
521884,2024-01-18,605,badminton shuttlecocks,180,300,120,1,00065,India
367953,2024-01-18,607,table tennis table,20000,26500,6500,1,00371,India
367953,2024-01-18,608,football,298,1099,801,1,00371,India
367953,2024-01-18,603,tennis ball,25,60,35,1,00371,India
792041,2024-01-18,607,table tennis table,20000,26500,6500,1,00039,India
792041,2024-01-18,604,tennis racket,1200,1800,600,1,00039,India
166528,2024-01-18,603,tennis ball,25,60,35,1,00033,India
166528,2024-01-18,609,basketball,298,679,381,1,00033,India
166528,2024-01-18,606,badminton rackets,180,499,319,1,00033,India
699403,2024-01-18,610,golf clubs,27000,42000,15000,1,00343,India
699403,2024-01-18,608,football,298,1099,801,1,00343,India
699403,2024-01-18,607,table tennis table,20000,26500,6500,1,00343,India
612612,2024-01-19,611,helmet,200,400,200,1,00315,India
612612,2024-01-19,601,cricket bat,400,1500,1100,1,00315,India
612612,2024-01-19,605,badminton shuttlecocks,180,300,120,1,00315,India
140005,2024-01-19,601,cricket bat,400,1500,1100,1,00011,India
811501,2024-01-19,610,golf clubs,27000,42000,15000,1,00391,India
811501,2024-01-19,602,cricket ball,125,260,135,1,00391,India
811501,2024-01-19,601,cricket bat,400,1500,1100,1,00391,India
811501,2024-01-19,603,tennis ball,25,60,35,1,00391,India
811501,2024-01-19,611,helmet,200,400,200,1,00391,India
692610,2024-01-19,610,golf clubs,27000,42000,15000,1,00172,India
704345,2024-01-19,604,tennis racket,1200,1800,600,1,00065,India
856399,2024-01-19,607,table tennis table,20000,26500,6500,1,00086,India
856399,2024-01-19,606,badminton rackets,180,499,319,1,00086,India
856399,2024-01-19,611,helmet,200,400,200,1,00086,India
829121,2024-01-19,603,tennis ball,25,60,35,1,00133,India
829121,2024-01-19,606,badminton rackets,180,499,319,1,00133,India
829121,2024-01-19,601,cricket bat,400,1500,1100,1,00133,India
829121,2024-01-19,608,football,298,1099,801,1,00133,India
847204,2024-01-20,606,badminton rackets,180,499,319,1,00382,India
847204,2024-01-20,604,tennis racket,1200,1800,600,1,00382,India
847204,2024-01-20,605,badminton shuttlecocks,180,300,120,1,00382,India
847204,2024-01-20,608,football,298,1099,801,1,00382,India
847204,2024-01-20,601,cricket bat,400,1500,1100,1,00382,India
648148,2024-01-20,606,badminton rackets,180,499,319,1,00086,India
648148,2024-01-20,610,golf clubs,27000,42000,15000,1,00086,India
608836,2024-01-21,605,badminton shuttlecocks,180,300,120,1,00117,India
897584,2024-01-21,609,basketball,298,679,381,1,00474,India
897584,2024-01-21,610,golf clubs,27000,42000,15000,1,00474,India
897584,2024-01-21,607,table tennis table,20000,26500,6500,1,00474,India
897584,2024-01-21,604,tennis racket,1200,1800,600,1,00474,India
918575,2024-01-21,610,golf clubs,27000,42000,15000,1,00048,India
749034,2024-01-21,604,tennis racket,1200,1800,600,1,00315,India
749034,2024-01-21,601,cricket bat,400,1500,1100,1,00315,India
749034,2024-01-21,603,tennis ball,25,60,35,1,00315,India
749034,2024-01-21,610,golf clubs,27000,42000,15000,1,00315,India
263394,2024-01-21,605,badminton shuttlecocks,180,300,120,1,00114,India
960148,2024-01-21,601,cricket bat,400,1500,1100,1,00225,India
960148,2024-01-21,609,basketball,298,679,381,1,00225,India
960148,2024-01-21,605,badminton shuttlecocks,180,300,120,1,00225,India
731552,2024-01-21,601,cricket bat,400,1500,1100,1,00437,India
454369,2024-01-21,605,badminton shuttlecocks,180,300,120,1,00119,India
321782,2024-01-21,611,helmet,200,400,200,1,00405,India
321782,2024-01-21,602,cricket ball,125,260,135,1,00405,India
744440,2024-01-21,610,golf clubs,27000,42000,15000,1,00310,India
744440,2024-01-21,602,cricket ball,125,260,135,1,00310,India
744440,2024-01-21,605,badminton shuttlecocks,180,300,120,1,00310,India
744440,2024-01-21,611,helmet,200,400,200,1,00310,India
744440,2024-01-21,604,tennis racket,1200,1800,600,1,00310,India
499066,2024-01-23,604,tennis racket,1200,1800,600,1,00387,India
499066,2024-01-23,606,badminton rackets,180,499,319,1,00387,India
499066,2024-01-23,609,basketball,298,679,381,1,00387,India
499066,2024-01-23,603,tennis ball,25,60,35,1,00387,India
947241,2024-01-23,609,basketball,298,679,381,1,00110,India
947241,2024-01-23,604,tennis racket,1200,1800,600,1,00110,India
947241,2024-01-23,607,table tennis table,20000,26500,6500,1,00110,India
947241,2024-01-23,608,football,298,1099,801,1,00110,India
947241,2024-01-23,602,cricket ball,125,260,135,1,00110,India
672975,2024-01-23,606,badminton rackets,180,499,319,1,00300,India
672975,2024-01-23,611,helmet,200,400,200,1,00300,India
672975,2024-01-23,601,cricket bat,400,1500,1100,1,00300,India
862172,2024-01-23,605,badminton shuttlecocks,180,300,120,1,00372,India
862172,2024-01-23,603,tennis ball,25,60,35,1,00372,India
862172,2024-01-23,607,table tennis table,20000,26500,6500,1,00372,India
862172,2024-01-23,611,helmet,200,400,200,1,00372,India
894259,2024-01-23,608,football,298,1099,801,1,00083,India
894259,2024-01-23,602,cricket ball,125,260,135,1,00083,India
894259,2024-01-23,607,table tennis table,20000,26500,6500,1,00083,India
458640,2024-01-24,601,cricket bat,400,1500,1100,1,00019,India
458640,2024-01-24,609,basketball,298,679,381,1,00019,India
458640,2024-01-24,611,helmet,200,400,200,1,00019,India
439128,2024-01-25,601,cricket bat,400,1500,1100,1,00180,India
679461,2024-01-25,606,badminton rackets,180,499,319,1,00004,India
679461,2024-01-25,601,cricket bat,400,1500,1100,1,00004,India
679461,2024-01-25,604,tennis racket,1200,1800,600,1,00004,India
679461,2024-01-25,602,cricket ball,125,260,135,1,00004,India
679461,2024-01-25,603,tennis ball,25,60,35,1,00004,India
507645,2024-01-25,607,table tennis table,20000,26500,6500,1,00467,India
507645,2024-01-25,611,helmet,200,400,200,1,00467,India
507645,2024-01-25,610,golf clubs,27000,42000,15000,1,00467,India
507645,2024-01-25,601,cricket bat,400,1500,1100,1,00467,India
507645,2024-01-25,609,basketball,298,679,381,1,00467,India
153547,2024-01-26,601,cricket bat,400,1500,1100,1,00440,India
383008,2024-01-26,609,basketball,298,679,381,1,00020,India
383008,2024-01-26,606,badminton rackets,180,499,319,1,00020,India
383008,2024-01-26,603,tennis ball,25,60,35,1,00020,India
383008,2024-01-26,605,badminton shuttlecocks,180,300,120,1,00020,India
902721,2024-01-27,605,badminton shuttlecocks,180,300,120,1,00385,India
902721,2024-01-27,603,tennis ball,25,60,35,1,00385,India
361958,2024-01-27,609,basketball,298,679,381,1,00353,India
361958,2024-01-27,605,badminton shuttlecocks,180,300,120,1,00353,India
363155,2024-01-27,603,tennis ball,25,60,35,1,00256,India
661072,2024-01-27,602,cricket ball,125,260,135,1,00349,India
661072,2024-01-27,611,helmet,200,400,200,1,00349,India
661072,2024-01-27,609,basketball,298,679,381,1,00349,India
661072,2024-01-27,603,tennis ball,25,60,35,1,00349,India
226207,2024-01-28,606,badminton rackets,180,499,319,1,00147,India
226207,2024-01-28,603,tennis ball,25,60,35,1,00147,India
226207,2024-01-28,610,golf clubs,27000,42000,15000,1,00147,India
613201,2024-01-28,608,football,298,1099,801,1,00183,India
613201,2024-01-28,610,golf clubs,27000,42000,15000,1,00183,India
328625,2024-01-28,611,helmet,200,400,200,1,00173,India
990764,2024-01-31,610,golf clubs,27000,42000,15000,1,00192,India
990764,2024-01-31,604,tennis racket,1200,1800,600,1,00192,India
990764,2024-01-31,611,helmet,200,400,200,1,00192,India
990764,2024-01-31,603,tennis ball,25,60,35,1,00192,India
388277,2024-01-31,611,helmet,200,400,200,1,00447,India
855776,2024-01-31,603,tennis ball,25,60,35,1,00415,India
855776,2024-01-31,605,badminton shuttlecocks,180,300,120,1,00415,India
371224,2024-02-01,606,badminton rackets,180,499,319,1,00281,India
371224,2024-02-01,609,basketball,298,679,381,1,00281,India
324621,2024-02-01,607,table tennis table,20000,26500,6500,1,00446,India
324621,2024-02-01,610,golf clubs,27000,42000,15000,1,00446,India
324621,2024-02-01,604,tennis racket,1200,1800,600,1,00446,India
364072,2024-02-02,608,football,298,1099,801,1,00438,India
478887,2024-02-03,602,cricket ball,125,260,135,1,00102,India
478887,2024-02-03,603,tennis ball,25,60,35,1,00102,India
478887,2024-02-03,605,badminton shuttlecocks,180,300,120,1,00102,India
576000,2024-02-03,608,football,298,1099,801,1,00272,India
576000,2024-02-03,606,badminton rackets,180,499,319,1,00272,India
576000,2024-02-03,604,tennis racket,1200,1800,600,1,00272,India
576000,2024-02-03,605,badminton shuttlecocks,180,300,120,1,00272,India
576000,2024-02-03,609,basketball,298,679,381,1,00272,India
154072,2024-02-03,604,tennis racket,1200,1800,600,1,00284,India
154072,2024-02-03,602,cricket ball,125,260,135,1,00284,India
154072,2024-02-03,605,badminton shuttlecocks,180,300,120,1,00284,India
154072,2024-02-03,610,golf clubs,27000,42000,15000,1,00284,India
154072,2024-02-03,608,football,298,1099,801,1,00284,India
182647,2024-02-03,610,golf clubs,27000,42000,15000,1,00012,India
182647,2024-02-03,601,cricket bat,400,1500,1100,1,00012,India
182647,2024-02-03,611,helmet,200,400,200,1,00012,India
984357,2024-02-03,603,tennis ball,25,60,35,1,00431,India
984357,2024-02-03,606,badminton rackets,180,499,319,1,00431,India
984357,2024-02-03,611,helmet,200,400,200,1,00431,India
487710,2024-02-03,607,table tennis table,20000,26500,6500,1,00123,India
908634,2024-02-04,609,basketball,298,679,381,1,00196,India
908634,2024-02-04,602,cricket ball,125,260,135,1,00196,India
908634,2024-02-04,611,helmet,200,400,200,1,00196,India
347376,2024-02-04,602,cricket ball,125,260,135,1,00238,India
347376,2024-02-04,607,table tennis table,20000,26500,6500,1,00238,India
789876,2024-02-04,608,football,298,1099,801,1,00139,India
780125,2024-02-04,611,helmet,200,400,200,1,00213,India
739698,2024-02-04,601,cricket bat,400,1500,1100,1,00208,India
739698,2024-02-04,606,badminton rackets,180,499,319,1,00208,India
739698,2024-02-04,610,golf clubs,27000,42000,15000,1,00208,India
739698,2024-02-04,607,table tennis table,20000,26500,6500,1,00208,India
802864,2024-02-04,610,golf clubs,27000,42000,15000,1,00273,India
802864,2024-02-04,603,tennis ball,25,60,35,1,00273,India
802864,2024-02-04,611,helmet,200,400,200,1,00273,India
718894,2024-02-04,608,football,298,1099,801,1,00355,India
482303,2024-02-04,605,badminton shuttlecocks,180,300,120,1,00024,India
482303,2024-02-04,609,basketball,298,679,381,1,00024,India
482303,2024-02-04,610,golf clubs,27000,42000,15000,1,00024,India
483161,2024-02-04,607,table tennis table,20000,26500,6500,1,00352,India
812231,2024-02-06,609,basketball,298,679,381,1,00236,India
812231,2024-02-06,603,tennis ball,25,60,35,1,00236,India
890744,2024-02-06,608,football,298,1099,801,1,00369,India
238006,2024-02-06,601,cricket bat,400,1500,1100,1,00434,India
238006,2024-02-06,610,golf clubs,27000,42000,15000,1,00434,India
969492,2024-02-06,601,cricket bat,400,1500,1100,1,00310,India
115815,2024-02-06,603,tennis ball,25,60,35,1,00377,India
115815,2024-02-06,608,football,298,1099,801,1,00377,India
115815,2024-02-06,605,badminton shuttlecocks,180,300,120,1,00377,India
115815,2024-02-06,606,badminton rackets,180,499,319,1,00377,India
751398,2024-02-07,602,cricket ball,125,260,135,1,00215,India
751398,2024-02-07,603,tennis ball,25,60,35,1,00215,India
376095,2024-02-07,603,tennis ball,25,60,35,1,00444,India
376095,2024-02-07,608,football,298,1099,801,1,00444,India
376095,2024-02-07,604,tennis racket,1200,1800,600,1,00444,India
376095,2024-02-07,601,cricket bat,400,1500,1100,1,00444,India
613879,2024-02-07,604,tennis racket,1200,1800,600,1,00498,India
613879,2024-02-07,601,cricket bat,400,1500,1100,1,00498,India
692702,2024-02-08,609,basketball,298,679,381,1,00234,India
467588,2024-02-08,605,badminton shuttlecocks,180,300,120,1,00312,India
467588,2024-02-08,603,tennis ball,25,60,35,1,00312,India
467588,2024-02-08,601,cricket bat,400,1500,1100,1,00312,India
467588,2024-02-08,606,badminton rackets,180,499,319,1,00312,India
739465,2024-02-08,604,tennis racket,1200,1800,600,1,00253,India
523793,2024-02-08,611,helmet,200,400,200,1,00406,India
523793,2024-02-08,610,golf clubs,27000,42000,15000,1,00406,India
150114,2024-02-08,602,cricket ball,125,260,135,1,00336,India
140679,2024-02-08,608,football,298,1099,801,1,00356,India
140679,2024-02-08,605,badminton shuttlecocks,180,300,120,1,00356,India
140679,2024-02-08,606,badminton rackets,180,499,319,1,00356,India
140679,2024-02-08,602,cricket ball,125,260,135,1,00356,India
512951,2024-02-08,604,tennis racket,1200,1800,600,1,00495,India
230083,2024-02-08,609,basketball,298,679,381,1,00260,India
230083,2024-02-08,604,tennis racket,1200,1800,600,1,00260,India
261657,2024-02-10,609,basketball,298,679,381,1,00055,India
212019,2024-02-10,609,basketball,298,679,381,1,00138,India
212019,2024-02-10,610,golf clubs,27000,42000,15000,1,00138,India
212019,2024-02-10,605,badminton shuttlecocks,180,300,120,1,00138,India
282447,2024-02-10,601,cricket bat,400,1500,1100,1,00233,India
282447,2024-02-10,608,football,298,1099,801,1,00233,India
282447,2024-02-10,607,table tennis table,20000,26500,6500,1,00233,India
837943,2024-02-10,610,golf clubs,27000,42000,15000,1,00049,India
837943,2024-02-10,607,table tennis table,20000,26500,6500,1,00049,India
837943,2024-02-10,601,cricket bat,400,1500,1100,1,00049,India
837943,2024-02-10,608,football,298,1099,801,1,00049,India
670461,2024-02-10,606,badminton rackets,180,499,319,1,00063,India
670461,2024-02-10,609,basketball,298,679,381,1,00063,India
670461,2024-02-10,603,tennis ball,25,60,35,1,00063,India
119862,2024-02-10,609,basketball,298,679,381,1,00433,India
119862,2024-02-10,607,table tennis table,20000,26500,6500,1,00433,India
742735,2024-02-11,604,tennis racket,1200,1800,600,1,00165,India
742735,2024-02-11,607,table tennis table,20000,26500,6500,1,00165,India
935333,2024-02-11,611,helmet,200,400,200,1,00171,India
578274,2024-02-11,608,football,298,1099,801,1,00494,India
578274,2024-02-11,610,golf clubs,27000,42000,15000,1,00494,India
578274,2024-02-11,611,helmet,200,400,200,1,00494,India
208318,2024-02-11,604,tennis racket,1200,1800,600,1,00068,India
956614,2024-02-11,605,badminton shuttlecocks,180,300,120,1,00385,India
956614,2024-02-11,604,tennis racket,1200,1800,600,1,00385,India
956614,2024-02-11,608,football,298,1099,801,1,00385,India
956614,2024-02-11,609,basketball,298,679,381,1,00385,India
729941,2024-02-11,606,badminton rackets,180,499,319,1,00400,India
729941,2024-02-11,605,badminton shuttlecocks,180,300,120,1,00400,India
527936,2024-02-12,604,tennis racket,1200,1800,600,1,00211,India
527936,2024-02-12,611,helmet,200,400,200,1,00211,India
527936,2024-02-12,610,golf clubs,27000,42000,15000,1,00211,India
946261,2024-02-12,607,table tennis table,20000,26500,6500,1,00390,India
946261,2024-02-12,602,cricket ball,125,260,135,1,00390,India
824607,2024-02-12,610,golf clubs,27000,42000,15000,1,00436,India
824607,2024-02-12,602,cricket ball,125,260,135,1,00436,India
824607,2024-02-12,609,basketball,298,679,381,1,00436,India
767773,2024-02-12,608,football,298,1099,801,1,00371,India
767773,2024-02-12,605,badminton shuttlecocks,180,300,120,1,00371,India
767773,2024-02-12,601,cricket bat,400,1500,1100,1,00371,India
767773,2024-02-12,609,basketball,298,679,381,1,00371,India
669961,2024-02-13,603,tennis ball,25,60,35,1,00226,India
663663,2024-02-13,610,golf clubs,27000,42000,15000,1,00225,India
663663,2024-02-13,603,tennis ball,25,60,35,1,00225,India
663663,2024-02-13,609,basketball,298,679,381,1,00225,India
663663,2024-02-13,607,table tennis table,20000,26500,6500,1,00225,India
308938,2024-02-13,602,cricket ball,125,260,135,1,00275,India
143383,2024-02-15,606,badminton rackets,180,499,319,1,00062,India
143383,2024-02-15,601,cricket bat,400,1500,1100,1,00062,India
143383,2024-02-15,609,basketball,298,679,381,1,00062,India
457370,2024-02-15,606,badminton rackets,180,499,319,1,00191,India
457370,2024-02-15,602,cricket ball,125,260,135,1,00191,India
457370,2024-02-15,611,helmet,200,400,200,1,00191,India
731701,2024-02-15,604,tennis racket,1200,1800,600,1,00128,India
731701,2024-02-15,605,badminton shuttlecocks,180,300,120,1,00128,India
731701,2024-02-15,606,badminton rackets,180,499,319,1,00128,India
731701,2024-02-15,611,helmet,200,400,200,1,00128,India
789750,2024-02-15,610,golf clubs,27000,42000,15000,1,00449,India
503613,2024-02-15,602,cricket ball,125,260,135,1,00198,India
503613,2024-02-15,608,football,298,1099,801,1,00198,India
503613,2024-02-15,604,tennis racket,1200,1800,600,1,00198,India
657073,2024-02-15,606,badminton rackets,180,499,319,1,00409,India
657073,2024-02-15,601,cricket bat,400,1500,1100,1,00409,India
657073,2024-02-15,605,badminton shuttlecocks,180,300,120,1,00409,India
857250,2024-02-15,604,tennis racket,1200,1800,600,1,00238,India
857250,2024-02-15,606,badminton rackets,180,499,319,1,00238,India
857250,2024-02-15,603,tennis ball,25,60,35,1,00238,India
857250,2024-02-15,607,table tennis table,20000,26500,6500,1,00238,India
562530,2024-02-15,608,football,298,1099,801,1,00401,India
562530,2024-02-15,607,table tennis table,20000,26500,6500,1,00401,India
562530,2024-02-15,611,helmet,200,400,200,1,00401,India
562530,2024-02-15,606,badminton rackets,180,499,319,1,00401,India
135542,2024-02-16,602,cricket ball,125,260,135,1,00078,India
135542,2024-02-16,605,badminton shuttlecocks,180,300,120,1,00078,India
135542,2024-02-16,610,golf clubs,27000,42000,15000,1,00078,India
135542,2024-02-16,607,table tennis table,20000,26500,6500,1,00078,India
538228,2024-02-17,604,tennis racket,1200,1800,600,1,00178,India
538228,2024-02-17,606,badminton rackets,180,499,319,1,00178,India
538228,2024-02-17,601,cricket bat,400,1500,1100,1,00178,India
622286,2024-02-17,604,tennis racket,1200,1800,600,1,00438,India
622286,2024-02-17,601,cricket bat,400,1500,1100,1,00438,India
622286,2024-02-17,605,badminton shuttlecocks,180,300,120,1,00438,India
696726,2024-02-17,611,helmet,200,400,200,1,00086,India
630811,2024-02-17,611,helmet,200,400,200,1,00336,India
630811,2024-02-17,602,cricket ball,125,260,135,1,00336,India
630811,2024-02-17,604,tennis racket,1200,1800,600,1,00336,India
630811,2024-02-17,603,tennis ball,25,60,35,1,00336,India
789676,2024-02-17,610,golf clubs,27000,42000,15000,1,00098,India
789676,2024-02-17,603,tennis ball,25,60,35,1,00098,India
789676,2024-02-17,601,cricket bat,400,1500,1100,1,00098,India
351256,2024-02-18,611,helmet,200,400,200,1,00219,India
351256,2024-02-18,605,badminton shuttlecocks,180,300,120,1,00219,India
146932,2024-02-18,605,badminton shuttlecocks,180,300,120,1,00265,India
146932,2024-02-18,602,cricket ball,125,260,135,1,00265,India
146932,2024-02-18,604,tennis racket,1200,1800,600,1,00265,India
543302,2024-02-18,609,basketball,298,679,381,1,00266,India
746363,2024-02-18,603,tennis ball,25,60,35,1,00300,India
834409,2024-02-19,601,cricket bat,400,1500,1100,1,00095,India
834409,2024-02-19,607,table tennis table,20000,26500,6500,1,00095,India
834409,2024-02-19,602,cricket ball,125,260,135,1,00095,India
834409,2024-02-19,608,football,298,1099,801,1,00095,India
834409,2024-02-19,603,tennis ball,25,60,35,1,00095,India
846015,2024-02-19,601,cricket bat,400,1500,1100,1,00348,India
562772,2024-02-19,610,golf clubs,27000,42000,15000,1,00381,India
562772,2024-02-19,603,tennis ball,25,60,35,1,00381,India
770403,2024-02-19,607,table tennis table,20000,26500,6500,1,00374,India
770403,2024-02-19,608,football,298,1099,801,1,00374,India
814617,2024-02-19,610,golf clubs,27000,42000,15000,1,00317,India
814617,2024-02-19,608,football,298,1099,801,1,00317,India
814617,2024-02-19,604,tennis racket,1200,1800,600,1,00317,India
814617,2024-02-19,601,cricket bat,400,1500,1100,1,00317,India
144016,2024-02-19,604,tennis racket,1200,1800,600,1,00371,India
144016,2024-02-19,605,badminton shuttlecocks,180,300,120,1,00371,India
144016,2024-02-19,609,basketball,298,679,381,1,00371,India
256352,2024-02-19,601,cricket bat,400,1500,1100,1,00152,India
660707,2024-02-19,611,helmet,200,400,200,1,00017,India
660707,2024-02-19,604,tennis racket,1200,1800,600,1,00017,India
231122,2024-02-19,611,helmet,200,400,200,1,00447,India
231122,2024-02-19,604,tennis racket,1200,1800,600,1,00447,India
362392,2024-02-19,610,golf clubs,27000,42000,15000,1,00190,India
362392,2024-02-19,607,table tennis table,20000,26500,6500,1,00190,India
362392,2024-02-19,602,cricket ball,125,260,135,1,00190,India
616632,2024-02-20,602,cricket ball,125,260,135,1,00439,India
616632,2024-02-20,609,basketball,298,679,381,1,00439,India
350306,2024-02-20,602,cricket ball,125,260,135,1,00218,India
350306,2024-02-20,603,tennis ball,25,60,35,1,00218,India
350306,2024-02-20,601,cricket bat,400,1500,1100,1,00218,India
877436,2024-02-20,604,tennis racket,1200,1800,600,1,00121,India
877436,2024-02-20,607,table tennis table,20000,26500,6500,1,00121,India
877436,2024-02-20,611,helmet,200,400,200,1,00121,India
877436,2024-02-20,609,basketball,298,679,381,1,00121,India