InvoiceNo,InvoiceDate,StockCode,Description,Cost_Price,UnitPrice,Profit,Quantity,CustomerID,Country
841030,2023-02-20,712,graph paper,20,40,20,1,00001,India
572543,2023-02-20,702,pencil,2,5,3,1,00002,India
572543,2023-02-20,706,sharpener,3,8,5,1,00002,India
572543,2023-02-20,713,ball pen,5,10,5,1,00002,India
206864,2023-02-20,703,eraser,1,3,2,1,00003,India
206864,2023-02-20,713,ball pen,5,10,5,1,00003,India
206864,2023-02-20,702,pencil,2,5,3,1,00003,India
206864,2023-02-20,715,folder,5,15,10,1,00003,India
810028,2023-02-20,706,sharpener,3,8,5,1,00004,India
810028,2023-02-20,710,geometry box,100,150,50,1,00004,India
810028,2023-02-20,704,scale,5,10,5,1,00004,India
851927,2023-02-20,704,scale,5,10,5,1,00005,India
851927,2023-02-20,714,carbon paper,15,30,15,1,00005,India
851927,2023-02-20,701,gel pen,5,10,5,1,00005,India
851927,2023-02-20,707,marker,20,40,20,1,00005,India
851927,2023-02-20,708,sketchpen,15,40,25,1,00005,India
686908,2023-02-20,717,spiral bound book,50,100,50,1,00006,India
686908,2023-02-20,709,notebook,30,60,30,1,00006,India
686908,2023-02-20,716,printing paper,200,400,200,1,00006,India
686908,2023-02-20,703,eraser,1,3,2,1,00006,India
513871,2023-02-20,710,geometry box,100,150,50,1,00007,India
513871,2023-02-20,709,notebook,30,60,30,1,00007,India
513871,2023-02-20,716,printing paper,200,400,200,1,00007,India
513871,2023-02-20,715,folder,5,15,10,1,00007,India
513871,2023-02-20,713,ball pen,5,10,5,1,00007,India
106706,2023-02-20,708,sketchpen,15,40,25,1,00008,India
106706,2023-02-20,707,marker,20,40,20,1,00008,India
106706,2023-02-20,702,pencil,2,5,3,1,00008,India
106706,2023-02-20,703,eraser,1,3,2,1,00008,India
896917,2023-02-20,702,pencil,2,5,3,1,00009,India
896917,2023-02-20,715,folder,5,15,10,1,00009,India
896917,2023-02-20,709,notebook,30,60,30,1,00009,India
896917,2023-02-20,717,spiral bound book,50,100,50,1,00009,India
896917,2023-02-20,704,scale,5,10,5,1,00009,India
912957,2023-02-20,703,eraser,1,3,2,1,00010,India
135741,2023-02-20,713,ball pen,5,10,5,1,00011,India
135741,2023-02-20,710,geometry box,100,150,50,1,00011,India
751601,2023-02-20,707,marker,20,40,20,1,00012,India
751601,2023-02-20,714,carbon paper,15,30,15,1,00012,India
751601,2023-02-20,701,gel pen,5,10,5,1,00012,India
915786,2023-02-20,712,graph paper,20,40,20,1,00013,India
915786,2023-02-20,716,printing paper,200,400,200,1,00013,India
915786,2023-02-20,709,notebook,30,60,30,1,00013,India
814186,2023-02-20,717,spiral bound book,50,100,50,1,00014,India
814186,2023-02-20,707,marker,20,40,20,1,00014,India
241976,2023-02-20,712,graph paper,20,40,20,1,00015,India
241976,2023-02-20,708,sketchpen,15,40,25,1,00015,India
241976,2023-02-20,715,folder,5,15,10,1,00015,India
747575,2023-02-20,702,pencil,2,5,3,1,00016,India
455720,2023-02-20,713,ball pen,5,10,5,1,00017,India
455720,2023-02-20,709,notebook,30,60,30,1,00017,India
455720,2023-02-20,705,stencil,10,20,10,1,00017,India
455720,2023-02-20,706,sharpener,3,8,5,1,00017,India
952243,2023-02-20,711,TD kit,150,300,150,1,00018,India
952243,2023-02-20,714,carbon paper,15,30,15,1,00018,India
952243,2023-02-20,710,geometry box,100,150,50,1,00018,India
868867,2023-02-20,711,TD kit,150,300,150,1,00019,India
868867,2023-02-20,713,ball pen,5,10,5,1,00019,India
868867,2023-02-20,708,sketchpen,15,40,25,1,00019,India
756441,2023-02-20,717,spiral bound book,50,100,50,1,00020,India
756441,2023-02-20,715,folder,5,15,10,1,00020,India
756441,2023-02-20,711,TD kit,150,300,150,1,00020,India
457337,2023-02-20,704,scale,5,10,5,1,00021,India
457337,2023-02-20,715,folder,5,15,10,1,00021,India
457337,2023-02-20,714,carbon paper,15,30,15,1,00021,India
802759,2023-02-20,702,pencil,2,5,3,1,00022,India
215822,2023-02-20,703,eraser,1,3,2,1,00023,India
215822,2023-02-20,709,notebook,30,60,30,1,00023,India
215822,2023-02-20,708,sketchpen,15,40,25,1,00023,India
796707,2023-02-20,711,TD kit,150,300,150,1,00024,India
796707,2023-02-20,705,stencil,10,20,10,1,00024,India
796707,2023-02-20,702,pencil,2,5,3,1,00024,India
140763,2023-02-20,701,gel pen,5,10,5,1,00025,India
140763,2023-02-20,709,notebook,30,60,30,1,00025,India
784633,2023-02-20,708,sketchpen,15,40,25,1,00026,India
784633,2023-02-20,707,marker,20,40,20,1,00026,India
784633,2023-02-20,713,ball pen,5,10,5,1,00026,India
784633,2023-02-20,704,scale,5,10,5,1,00026,India
382633,2023-02-20,715,folder,5,15,10,1,00027,India
382633,2023-02-20,705,stencil,10,20,10,1,00027,India
382633,2023-02-20,710,geometry box,100,150,50,1,00027,India
382633,2023-02-20,712,graph paper,20,40,20,1,00027,India
382633,2023-02-20,713,ball pen,5,10,5,1,00027,India
292968,2023-02-20,704,scale,5,10,5,1,00028,India
292968,2023-02-20,717,spiral bound book,50,100,50,1,00028,India
890965,2023-02-20,701,gel pen,5,10,5,1,00029,India
890965,2023-02-20,706,sharpener,3,8,5,1,00029,India
808785,2023-02-20,704,scale,5,10,5,1,00030,India
808785,2023-02-20,713,ball pen,5,10,5,1,00030,India
808785,2023-02-20,702,pencil,2,5,3,1,00030,India
417397,2023-02-20,708,sketchpen,15,40,25,1,00031,India
990363,2023-02-20,712,graph paper,20,40,20,1,00032,India
990363,2023-02-20,708,sketchpen,15,40,25,1,00032,India
990363,2023-02-20,704,scale,5,10,5,1,00032,India
990363,2023-02-20,717,spiral bound book,50,100,50,1,00032,India
987903,2023-02-20,712,graph paper,20,40,20,1,00033,India
571553,2023-02-20,716,printing paper,200,400,200,1,00034,India
571553,2023-02-20,710,geometry box,100,150,50,1,00034,India
571553,2023-02-20,708,sketchpen,15,40,25,1,00034,India
224769,2023-02-20,709,notebook,30,60,30,1,00035,India
224769,2023-02-20,715,folder,5,15,10,1,00035,India
224769,2023-02-20,711,TD kit,150,300,150,1,00035,India
224769,2023-02-20,717,spiral bound book,50,100,50,1,00035,India
950156,2023-02-20,704,scale,5,10,5,1,00036,India
950156,2023-02-20,705,stencil,10,20,10,1,00036,India
950156,2023-02-20,706,sharpener,3,8,5,1,00036,India
950156,2023-02-20,703,eraser,1,3,2,1,00036,India
227207,2023-02-20,707,marker,20,40,20,1,00037,India
227207,2023-02-20,713,ball pen,5,10,5,1,00037,India
534328,2023-02-20,707,marker,20,40,20,1,00038,India
534328,2023-02-20,708,sketchpen,15,40,25,1,00038,India
534328,2023-02-20,714,carbon paper,15,30,15,1,00038,India
955421,2023-02-20,703,eraser,1,3,2,1,00039,India
955421,2023-02-20,710,geometry box,100,150,50,1,00039,India
955421,2023-02-20,714,carbon paper,15,30,15,1,00039,India
955421,2023-02-20,716,printing paper,200,400,200,1,00039,India
955421,2023-02-20,705,stencil,10,20,10,1,00039,India
125752,2023-02-20,707,marker,20,40,20,1,00040,India
766535,2023-02-20,709,notebook,30,60,30,1,00041,India
766535,2023-02-20,711,TD kit,150,300,150,1,00041,India
766535,2023-02-20,717,spiral bound book,50,100,50,1,00041,India
766535,2023-02-20,707,marker,20,40,20,1,00041,India
127754,2023-02-20,712,graph paper,20,40,20,1,00042,India
127754,2023-02-20,716,printing paper,200,400,200,1,00042,India
203864,2023-02-20,708,sketchpen,15,40,25,1,00043,India
203864,2023-02-20,716,printing paper,200,400,200,1,00043,India
267725,2023-02-20,707,marker,20,40,20,1,00044,India
267725,2023-02-20,702,pencil,2,5,3,1,00044,India
267725,2023-02-20,715,folder,5,15,10,1,00044,India
267725,2023-02-20,708,sketchpen,15,40,25,1,00044,India
267725,2023-02-20,714,carbon paper,15,30,15,1,00044,India
718858,2023-02-21,717,spiral bound book,50,100,50,1,00045,India
718858,2023-02-21,704,scale,5,10,5,1,00045,India
838574,2023-02-21,702,pencil,2,5,3,1,00046,India
838574,2023-02-21,704,scale,5,10,5,1,00046,India
838574,2023-02-21,706,sharpener,3,8,5,1,00046,India
146545,2023-02-21,710,geometry box,100,150,50,1,00047,India
366304,2023-02-21,709,notebook,30,60,30,1,00048,India
391525,2023-02-21,711,TD kit,150,300,150,1,00049,India
391525,2023-02-21,706,sharpener,3,8,5,1,00049,India
391525,2023-02-21,717,spiral bound book,50,100,50,1,00049,India
391525,2023-02-21,715,folder,5,15,10,1,00049,India
126945,2023-02-21,713,ball pen,5,10,5,1,00050,India
530190,2023-02-21,709,notebook,30,60,30,1,00051,India
530190,2023-02-21,701,gel pen,5,10,5,1,00051,India
530190,2023-02-21,705,stencil,10,20,10,1,00051,India
530190,2023-02-21,711,TD kit,150,300,150,1,00051,India
704599,2023-02-21,709,notebook,30,60,30,1,00052,India
635618,2023-02-21,712,graph paper,20,40,20,1,00053,India
635618,2023-02-21,710,geometry box,100,150,50,1,00053,India
635618,2023-02-21,709,notebook,30,60,30,1,00053,India
637743,2023-02-21,703,eraser,1,3,2,1,00054,India
637743,2023-02-21,706,sharpener,3,8,5,1,00054,India
637743,2023-02-21,717,spiral bound book,50,100,50,1,00054,India
637743,2023-02-21,704,scale,5,10,5,1,00054,India
637743,2023-02-21,705,stencil,10,20,10,1,00054,India
952088,2023-02-21,701,gel pen,5,10,5,1,00055,India
952088,2023-02-21,704,scale,5,10,5,1,00055,India
952088,2023-02-21,712,graph paper,20,40,20,1,00055,India
554238,2023-02-21,707,marker,20,40,20,1,00056,India
554238,2023-02-21,708,sketchpen,15,40,25,1,00056,India
554238,2023-02-21,713,ball pen,5,10,5,1,00056,India
554238,2023-02-21,702,pencil,2,5,3,1,00056,India
129046,2023-02-21,708,sketchpen,15,40,25,1,00057,India
129046,2023-02-21,706,sharpener,3,8,5,1,00057,India
960803,2023-02-21,707,marker,20,40,20,1,00058,India
923673,2023-02-21,705,stencil,10,20,10,1,00059,India
923673,2023-02-21,712,graph paper,20,40,20,1,00059,India
923673,2023-02-21,711,TD kit,150,300,150,1,00059,India
829377,2023-02-21,709,notebook,30,60,30,1,00060,India
829377,2023-02-21,713,ball pen,5,10,5,1,00060,India
829377,2023-02-21,714,carbon paper,15,30,15,1,00060,India
829377,2023-02-21,710,geometry box,100,150,50,1,00060,India
829377,2023-02-21,702,pencil,2,5,3,1,00060,India
916171,2023-02-21,715,folder,5,15,10,1,00061,India
916171,2023-02-21,702,pencil,2,5,3,1,00061,India
916171,2023-02-21,712,graph paper,20,40,20,1,00061,India
916171,2023-02-21,706,sharpener,3,8,5,1,00061,India
916171,2023-02-21,703,eraser,1,3,2,1,00061,India
883979,2023-02-21,717,spiral bound book,50,100,50,1,00062,India
883979,2023-02-21,709,notebook,30,60,30,1,00062,India
762543,2023-02-21,715,folder,5,15,10,1,00063,India
762543,2023-02-21,702,pencil,2,5,3,1,00063,India
104648,2023-02-21,707,marker,20,40,20,1,00064,India
104648,2023-02-21,711,TD kit,150,300,150,1,00064,India
104648,2023-02-21,713,ball pen,5,10,5,1,00064,India
104648,2023-02-21,710,geometry box,100,150,50,1,00064,India
679341,2023-02-21,709,notebook,30,60,30,1,00065,India
679341,2023-02-21,712,graph paper,20,40,20,1,00065,India
679341,2023-02-21,715,folder,5,15,10,1,00065,India
596783,2023-02-21,715,folder,5,15,10,1,00066,India
596783,2023-02-21,710,geometry box,100,150,50,1,00066,India
596783,2023-02-21,706,sharpener,3,8,5,1,00066,India
596783,2023-02-21,708,sketchpen,15,40,25,1,00066,India
690420,2023-02-21,713,ball pen,5,10,5,1,00067,India
690420,2023-02-21,709,notebook,30,60,30,1,00067,India
690420,2023-02-21,714,carbon paper,15,30,15,1,00067,India
690420,2023-02-21,715,folder,5,15,10,1,00067,India
988536,2023-02-21,703,eraser,1,3,2,1,00068,India
988536,2023-02-21,711,TD kit,150,300,150,1,00068,India
988536,2023-02-21,717,spiral bound book,50,100,50,1,00068,India
988536,2023-02-21,714,carbon paper,15,30,15,1,00068,India
988536,2023-02-21,708,sketchpen,15,40,25,1,00068,India
146111,2023-02-21,705,stencil,10,20,10,1,00069,India
644434,2023-02-21,702,pencil,2,5,3,1,00070,India
644434,2023-02-21,708,sketchpen,15,40,25,1,00070,India
644434,2023-02-21,705,stencil,10,20,10,1,00070,India
491058,2023-02-21,710,geometry box,100,150,50,1,00071,India
491058,2023-02-21,709,notebook,30,60,30,1,00071,India
419630,2023-02-21,705,stencil,10,20,10,1,00072,India
419630,2023-02-21,709,notebook,30,60,30,1,00072,India
419630,2023-02-21,706,sharpener,3,8,5,1,00072,India
419630,2023-02-21,702,pencil,2,5,3,1,00072,India
362981,2023-02-21,702,pencil,2,5,3,1,00073,India
362981,2023-02-21,709,notebook,30,60,30,1,00073,India
362981,2023-02-21,706,sharpener,3,8,5,1,00073,India
362981,2023-02-21,714,carbon paper,15,30,15,1,00073,India
362981,2023-02-21,716,printing paper,200,400,200,1,00073,India
800862,2023-02-21,705,stencil,10,20,10,1,00074,India
800862,2023-02-21,710,geometry box,100,150,50,1,00074,India
800862,2023-02-21,703,eraser,1,3,2,1,00074,India
314704,2023-02-21,704,scale,5,10,5,1,00075,India
314704,2023-02-21,716,printing paper,200,400,200,1,00075,India
314704,2023-02-21,705,stencil,10,20,10,1,00075,India
314704,2023-02-21,717,spiral bound book,50,100,50,1,00075,India
429537,2023-02-21,714,carbon paper,15,30,15,1,00076,India
429537,2023-02-21,708,sketchpen,15,40,25,1,00076,India
115088,2023-02-21,706,sharpener,3,8,5,1,00077,India
115088,2023-02-21,713,ball pen,5,10,5,1,00077,India
115088,2023-02-21,716,printing paper,200,400,200,1,00077,India
649009,2023-02-21,702,pencil,2,5,3,1,00078,India
649009,2023-02-21,706,sharpener,3,8,5,1,00078,India
326498,2023-02-21,708,sketchpen,15,40,25,1,00079,India
326498,2023-02-21,702,pencil,2,5,3,1,00079,India
326498,2023-02-21,705,stencil,10,20,10,1,00079,India
496420,2023-02-21,711,TD kit,150,300,150,1,00080,India
496420,2023-02-21,706,sharpener,3,8,5,1,00080,India
233421,2023-02-21,705,stencil,10,20,10,1,00081,India
233421,2023-02-21,711,TD kit,150,300,150,1,00081,India
233421,2023-02-21,704,scale,5,10,5,1,00081,India
233421,2023-02-21,712,graph paper,20,40,20,1,00081,India
233421,2023-02-21,701,gel pen,5,10,5,1,00081,India
216505,2023-02-22,703,eraser,1,3,2,1,00082,India
827874,2023-02-22,716,printing paper,200,400,200,1,00083,India
827874,2023-02-22,714,carbon paper,15,30,15,1,00083,India
827874,2023-02-22,709,notebook,30,60,30,1,00083,India
702647,2023-02-22,717,spiral bound book,50,100,50,1,00084,India
702647,2023-02-22,711,TD kit,150,300,150,1,00084,India
702647,2023-02-22,712,graph paper,20,40,20,1,00084,India
200377,2023-02-22,706,sharpener,3,8,5,1,00085,India
200377,2023-02-22,702,pencil,2,5,3,1,00085,India
200377,2023-02-22,703,eraser,1,3,2,1,00085,India
200377,2023-02-22,701,gel pen,5,10,5,1,00085,India
200377,2023-02-22,713,ball pen,5,10,5,1,00085,India
481185,2023-02-22,708,sketchpen,15,40,25,1,00086,India
481185,2023-02-22,701,gel pen,5,10,5,1,00086,India
481185,2023-02-22,706,sharpener,3,8,5,1,00086,India
983551,2023-02-22,709,notebook,30,60,30,1,00087,India
983551,2023-02-22,707,marker,20,40,20,1,00087,India
983551,2023-02-22,710,geometry box,100,150,50,1,00087,India
983551,2023-02-22,702,pencil,2,5,3,1,00087,India
389308,2023-02-22,715,folder,5,15,10,1,00088,India
389308,2023-02-22,710,geometry box,100,150,50,1,00088,India
829392,2023-02-22,705,stencil,10,20,10,1,00089,India
829392,2023-02-22,713,ball pen,5,10,5,1,00089,India
757721,2023-02-22,702,pencil,2,5,3,1,00090,India
757721,2023-02-22,708,sketchpen,15,40,25,1,00090,India
938789,2023-02-22,709,notebook,30,60,30,1,00091,India
489594,2023-02-22,705,stencil,10,20,10,1,00092,India
489594,2023-02-22,704,scale,5,10,5,1,00092,India
951941,2023-02-22,710,geometry box,100,150,50,1,00093,India
951941,2023-02-22,708,sketchpen,15,40,25,1,00093,India
951941,2023-02-22,704,scale,5,10,5,1,00093,India
671667,2023-02-22,708,sketchpen,15,40,25,1,00094,India
671667,2023-02-22,707,marker,20,40,20,1,00094,India
671667,2023-02-22,716,printing paper,200,400,200,1,00094,India
671667,2023-02-22,704,scale,5,10,5,1,00094,India
671667,2023-02-22,710,geometry box,100,150,50,1,00094,India
822914,2023-02-22,716,printing paper,200,400,200,1,00095,India
700377,2023-02-22,710,geometry box,100,150,50,1,00096,India
840591,2023-02-22,705,stencil,10,20,10,1,00097,India
903665,2023-02-22,706,sharpener,3,8,5,1,00098,India
903665,2023-02-22,712,graph paper,20,40,20,1,00098,India
903665,2023-02-22,705,stencil,10,20,10,1,00098,India
903665,2023-02-22,703,eraser,1,3,2,1,00098,India
903665,2023-02-22,711,TD kit,150,300,150,1,00098,India
274267,2023-02-22,710,geometry box,100,150,50,1,00099,India
274267,2023-02-22,701,gel pen,5,10,5,1,00099,India
274267,2023-02-22,706,sharpener,3,8,5,1,00099,India
274267,2023-02-22,712,graph paper,20,40,20,1,00099,India
670064,2023-02-22,716,printing paper,200,400,200,1,00100,India
308627,2023-02-22,716,printing paper,200,400,200,1,00101,India
308627,2023-02-22,711,TD kit,150,300,150,1,00101,India
308627,2023-02-22,710,geometry box,100,150,50,1,00101,India
308627,2023-02-22,704,scale,5,10,5,1,00101,India
308627,2023-02-22,717,spiral bound book,50,100,50,1,00101,India
338948,2023-02-22,712,graph paper,20,40,20,1,00102,India
338948,2023-02-22,708,sketchpen,15,40,25,1,00102,India
338948,2023-02-22,703,eraser,1,3,2,1,00102,India
338948,2023-02-22,705,stencil,10,20,10,1,00102,India
338948,2023-02-22,706,sharpener,3,8,5,1,00102,India
708348,2023-02-22,703,eraser,1,3,2,1,00103,India
708348,2023-02-22,708,sketchpen,15,40,25,1,00103,India
708348,2023-02-22,704,scale,5,10,5,1,00103,India
525294,2023-02-22,702,pencil,2,5,3,1,00104,India
525294,2023-02-22,713,ball pen,5,10,5,1,00104,India
525294,2023-02-22,705,stencil,10,20,10,1,00104,India
525294,2023-02-22,701,gel pen,5,10,5,1,00104,India
525294,2023-02-22,707,marker,20,40,20,1,00104,India
535207,2023-02-22,702,pencil,2,5,3,1,00105,India
535207,2023-02-22,716,printing paper,200,400,200,1,00105,India
535207,2023-02-22,706,sharpener,3,8,5,1,00105,India
535207,2023-02-22,717,spiral bound book,50,100,50,1,00105,India
535207,2023-02-22,708,sketchpen,15,40,25,1,00105,India
408872,2023-02-22,713,ball pen,5,10,5,1,00106,India
408872,2023-02-22,705,stencil,10,20,10,1,00106,India
857222,2023-02-22,701,gel pen,5,10,5,1,00107,India
905115,2023-02-22,705,stencil,10,20,10,1,00108,India
987011,2023-02-22,706,sharpener,3,8,5,1,00109,India
987011,2023-02-22,702,pencil,2,5,3,1,00109,India
987011,2023-02-22,708,sketchpen,15,40,25,1,00109,India
481307,2023-02-22,706,sharpener,3,8,5,1,00110,India
902770,2023-02-22,701,gel pen,5,10,5,1,00111,India
406368,2023-02-22,705,stencil,10,20,10,1,00112,India
406368,2023-02-22,707,marker,20,40,20,1,00112,India
406368,2023-02-22,712,graph paper,20,40,20,1,00112,India
406368,2023-02-22,711,TD kit,150,300,150,1,00112,India
836194,2023-02-22,708,sketchpen,15,40,25,1,00113,India
836194,2023-02-22,703,eraser,1,3,2,1,00113,India
950342,2023-02-22,705,stencil,10,20,10,1,00114,India
950342,2023-02-22,711,TD kit,150,300,150,1,00114,India
512046,2023-02-22,706,sharpener,3,8,5,1,00115,India
512046,2023-02-22,702,pencil,2,5,3,1,00115,India
512046,2023-02-22,716,printing paper,200,400,200,1,00115,India
512046,2023-02-22,701,gel pen,5,10,5,1,00115,India
948530,2023-02-22,704,scale,5,10,5,1,00116,India
948530,2023-02-22,710,geometry box,100,150,50,1,00116,India
948530,2023-02-22,702,pencil,2,5,3,1,00116,India
948530,2023-02-22,715,folder,5,15,10,1,00116,India
975460,2023-02-22,703,eraser,1,3,2,1,00117,India
975460,2023-02-22,713,ball pen,5,10,5,1,00117,India
975460,2023-02-22,706,sharpener,3,8,5,1,00117,India
301729,2023-02-22,701,gel pen,5,10,5,1,00118,India
301729,2023-02-22,704,scale,5,10,5,1,00118,India
301729,2023-02-22,714,carbon paper,15,30,15,1,00118,India
301729,2023-02-22,708,sketchpen,15,40,25,1,00118,India
301729,2023-02-22,710,geometry box,100,150,50,1,00118,India
265911,2023-02-22,702,pencil,2,5,3,1,00119,India
265911,2023-02-22,708,sketchpen,15,40,25,1,00119,India
265911,2023-02-22,707,marker,20,40,20,1,00119,India
265911,2023-02-22,705,stencil,10,20,10,1,00119,India
265911,2023-02-22,713,ball pen,5,10,5,1,00119,India
899093,2023-02-22,703,eraser,1,3,2,1,00120,India
899093,2023-02-22,715,folder,5,15,10,1,00120,India
899093,2023-02-22,702,pencil,2,5,3,1,00120,India
899093,2023-02-22,706,sharpener,3,8,5,1,00120,India
465699,2023-02-22,713,ball pen,5,10,5,1,00121,India
977106,2023-02-22,706,sharpener,3,8,5,1,00122,India
122034,2023-02-22,706,sharpener,3,8,5,1,00123,India
122034,2023-02-22,717,spiral bound book,50,100,50,1,00123,India
122034,2023-02-22,702,pencil,2,5,3,1,00123,India
122034,2023-02-22,705,stencil,10,20,10,1,00123,India
122034,2023-02-22,710,geometry box,100,150,50,1,00123,India
842923,2023-02-22,715,folder,5,15,10,1,00124,India
842923,2023-02-22,705,stencil,10,20,10,1,00124,India
842923,2023-02-22,703,eraser,1,3,2,1,00124,India
842923,2023-02-22,712,graph paper,20,40,20,1,00124,India
842923,2023-02-22,714,carbon paper,15,30,15,1,00124,India
916496,2023-02-22,716,printing paper,200,400,200,1,00125,India
916496,2023-02-22,701,gel pen,5,10,5,1,00125,India
916496,2023-02-22,715,folder,5,15,10,1,00125,India
916496,2023-02-22,707,marker,20,40,20,1,00125,India
916496,2023-02-22,712,graph paper,20,40,20,1,00125,India
463446,2023-02-22,705,stencil,10,20,10,1,00126,India
463446,2023-02-22,704,scale,5,10,5,1,00126,India
463446,2023-02-22,717,spiral bound book,50,100,50,1,00126,India
785050,2023-02-22,706,sharpener,3,8,5,1,00127,India
785050,2023-02-22,701,gel pen,5,10,5,1,00127,India
785050,2023-02-22,713,ball pen,5,10,5,1,00127,India
785050,2023-02-22,712,graph paper,20,40,20,1,00127,India
782264,2023-02-22,703,eraser,1,3,2,1,00128,India
782264,2023-02-22,715,folder,5,15,10,1,00128,India
782264,2023-02-22,712,graph paper,20,40,20,1,00128,India
391255,2023-02-22,716,printing paper,200,400,200,1,00129,India
391255,2023-02-22,704,scale,5,10,5,1,00129,India
391255,2023-02-22,713,ball pen,5,10,5,1,00129,India
276837,2023-02-23,717,spiral bound book,50,100,50,1,00130,India
276837,2023-02-23,714,carbon paper,15,30,15,1,00130,India
571049,2023-02-23,712,graph paper,20,40,20,1,00131,India
571049,2023-02-23,707,marker,20,40,20,1,00131,India
571049,2023-02-23,709,notebook,30,60,30,1,00131,India
571049,2023-02-23,713,ball pen,5,10,5,1,00131,India
328634,2023-02-23,711,TD kit,150,300,150,1,00132,India
328634,2023-02-23,710,geometry box,100,150,50,1,00132,India
328634,2023-02-23,706,sharpener,3,8,5,1,00132,India
279097,2023-02-23,709,notebook,30,60,30,1,00133,India
279097,2023-02-23,704,scale,5,10,5,1,00133,India
279097,2023-02-23,703,eraser,1,3,2,1,00133,India
787233,2023-02-23,712,graph paper,20,40,20,1,00134,India
965407,2023-02-23,701,gel pen,5,10,5,1,00135,India
621633,2023-02-23,710,geometry box,100,150,50,1,00136,India
621633,2023-02-23,713,ball pen,5,10,5,1,00136,India
258850,2023-02-23,703,eraser,1,3,2,1,00137,India
258850,2023-02-23,708,sketchpen,15,40,25,1,00137,India
258850,2023-02-23,712,graph paper,20,40,20,1,00137,India
383584,2023-02-23,717,spiral bound book,50,100,50,1,00138,India
383584,2023-02-23,709,notebook,30,60,30,1,00138,India
383584,2023-02-23,710,geometry box,100,150,50,1,00138,India
119701,2023-02-23,707,marker,20,40,20,1,00139,India
119701,2023-02-23,708,sketchpen,15,40,25,1,00139,India
119701,2023-02-23,701,gel pen,5,10,5,1,00139,India
119701,2023-02-23,711,TD kit,150,300,150,1,00139,India
705667,2023-02-23,705,stencil,10,20,10,1,00140,India
705667,2023-02-23,703,eraser,1,3,2,1,00140,India
705667,2023-02-23,717,spiral bound book,50,100,50,1,00140,India
314796,2023-02-23,713,ball pen,5,10,5,1,00141,India
792368,2023-02-23,704,scale,5,10,5,1,00142,India
792368,2023-02-23,710,geometry box,100,150,50,1,00142,India
792368,2023-02-23,707,marker,20,40,20,1,00142,India
792368,2023-02-23,703,eraser,1,3,2,1,00142,India
792368,2023-02-23,714,carbon paper,15,30,15,1,00142,India
741790,2023-02-23,704,scale,5,10,5,1,00143,India
741790,2023-02-23,705,stencil,10,20,10,1,00143,India
741790,2023-02-23,710,geometry box,100,150,50,1,00143,India
741790,2023-02-23,714,carbon paper,15,30,15,1,00143,India
171456,2023-02-23,712,graph paper,20,40,20,1,00144,India
171456,2023-02-23,702,pencil,2,5,3,1,00144,India
867730,2023-02-23,713,ball pen,5,10,5,1,00145,India
867730,2023-02-23,707,marker,20,40,20,1,00145,India
867730,2023-02-23,715,folder,5,15,10,1,00145,India
867730,2023-02-23,716,printing paper,200,400,200,1,00145,India
950994,2023-02-23,715,folder,5,15,10,1,00146,India
950994,2023-02-23,716,printing paper,200,400,200,1,00146,India
593729,2023-02-23,711,TD kit,150,300,150,1,00147,India
237365,2023-02-23,704,scale,5,10,5,1,00148,India
237365,2023-02-23,713,ball pen,5,10,5,1,00148,India
237365,2023-02-23,714,carbon paper,15,30,15,1,00148,India
906247,2023-02-23,702,pencil,2,5,3,1,00149,India
906247,2023-02-23,707,marker,20,40,20,1,00149,India
906247,2023-02-23,709,notebook,30,60,30,1,00149,India
906247,2023-02-23,713,ball pen,5,10,5,1,00149,India
965348,2023-02-23,712,graph paper,20,40,20,1,00150,India
965348,2023-02-23,713,ball pen,5,10,5,1,00150,India
965348,2023-02-23,717,spiral bound book,50,100,50,1,00150,India
714863,2023-02-23,707,marker,20,40,20,1,00151,India
714863,2023-02-23,717,spiral bound book,50,100,50,1,00151,India
714863,2023-02-23,706,sharpener,3,8,5,1,00151,India
714863,2023-02-23,716,printing paper,200,400,200,1,00151,India
651860,2023-02-23,708,sketchpen,15,40,25,1,00152,India
651860,2023-02-23,702,pencil,2,5,3,1,00152,India
372445,2023-02-23,707,marker,20,40,20,1,00153,India
192816,2023-02-23,703,eraser,1,3,2,1,00154,India
893024,2023-02-23,703,eraser,1,3,2,1,00155,India
893024,2023-02-23,716,printing paper,200,400,200,1,00155,India
893024,2023-02-23,702,pencil,2,5,3,1,00155,India
893024,2023-02-23,705,stencil,10,20,10,1,00155,India
612874,2023-02-23,716,printing paper,200,400,200,1,00156,India
612874,2023-02-23,714,carbon paper,15,30,15,1,00156,India
612874,2023-02-23,705,stencil,10,20,10,1,00156,India
681500,2023-02-23,707,marker,20,40,20,1,00157,India
108222,2023-02-23,716,printing paper,200,400,200,1,00158,India
108222,2023-02-23,712,graph paper,20,40,20,1,00158,India
108222,2023-02-23,701,gel pen,5,10,5,1,00158,India
859725,2023-02-23,714,carbon paper,15,30,15,1,00159,India
905948,2023-02-23,703,eraser,1,3,2,1,00160,India
905948,2023-02-23,704,scale,5,10,5,1,00160,India
905948,2023-02-23,705,stencil,10,20,10,1,00160,India
905948,2023-02-23,717,spiral bound book,50,100,50,1,00160,India
610258,2023-02-23,704,scale,5,10,5,1,00161,India
610258,2023-02-23,707,marker,20,40,20,1,00161,India
610258,2023-02-23,717,spiral bound book,50,100,50,1,00161,India
688538,2023-02-23,705,stencil,10,20,10,1,00162,India
688538,2023-02-23,704,scale,5,10,5,1,00162,India
688538,2023-02-23,717,spiral bound book,50,100,50,1,00162,India
688538,2023-02-23,716,printing paper,200,400,200,1,00162,India
734775,2023-02-23,709,notebook,30,60,30,1,00163,India
369425,2023-02-23,707,marker,20,40,20,1,00164,India
369425,2023-02-23,703,eraser,1,3,2,1,00164,India
309845,2023-02-23,710,geometry box,100,150,50,1,00165,India
309845,2023-02-23,711,TD kit,150,300,150,1,00165,India
713919,2023-02-23,711,TD kit,150,300,150,1,00166,India
713919,2023-02-23,701,gel pen,5,10,5,1,00166,India
713919,2023-02-23,716,printing paper,200,400,200,1,00166,India
713919,2023-02-23,706,sharpener,3,8,5,1,00166,India
713919,2023-02-23,707,marker,20,40,20,1,00166,India
513150,2023-02-23,706,sharpener,3,8,5,1,00167,India
513150,2023-02-23,715,folder,5,15,10,1,00167,India
513150,2023-02-23,703,eraser,1,3,2,1,00167,India
513150,2023-02-23,704,scale,5,10,5,1,00167,India
513150,2023-02-23,712,graph paper,20,40,20,1,00167,India
423149,2023-02-23,703,eraser,1,3,2,1,00168,India
423149,2023-02-23,702,pencil,2,5,3,1,00168,India
423149,2023-02-23,707,marker,20,40,20,1,00168,India
423149,2023-02-23,708,sketchpen,15,40,25,1,00168,India
644656,2023-02-23,717,spiral bound book,50,100,50,1,00169,India
644656,2023-02-23,713,ball pen,5,10,5,1,00169,India
644656,2023-02-23,710,geometry box,100,150,50,1,00169,India
644656,2023-02-23,706,sharpener,3,8,5,1,00169,India
267209,2023-02-23,703,eraser,1,3,2,1,00170,India
267209,2023-02-23,707,marker,20,40,20,1,00170,India
267209,2023-02-23,702,pencil,2,5,3,1,00170,India
267209,2023-02-23,710,geometry box,100,150,50,1,00170,India
707984,2023-02-23,715,folder,5,15,10,1,00171,India
707984,2023-02-23,703,eraser,1,3,2,1,00171,India
688270,2023-02-24,709,notebook,30,60,30,1,00172,India
688270,2023-02-24,712,graph paper,20,40,20,1,00172,India
688270,2023-02-24,704,scale,5,10,5,1,00172,India
455729,2023-02-24,708,sketchpen,15,40,25,1,00173,India
455729,2023-02-24,711,TD kit,150,300,150,1,00173,India
455729,2023-02-24,714,carbon paper,15,30,15,1,00173,India
455729,2023-02-24,716,printing paper,200,400,200,1,00173,India
427289,2023-02-24,709,notebook,30,60,30,1,00174,India
572581,2023-02-24,716,printing paper,200,400,200,1,00175,India
572581,2023-02-24,704,scale,5,10,5,1,00175,India
828388,2023-02-24,716,printing paper,200,400,200,1,00176,India
828388,2023-02-24,706,sharpener,3,8,5,1,00176,India
443047,2023-02-24,712,graph paper,20,40,20,1,00177,India
443047,2023-02-24,707,marker,20,40,20,1,00177,India
443047,2023-02-24,703,eraser,1,3,2,1,00177,India
249486,2023-02-24,712,graph paper,20,40,20,1,00178,India
772582,2023-02-24,716,printing paper,200,400,200,1,00179,India
921226,2023-02-24,708,sketchpen,15,40,25,1,00180,India
921226,2023-02-24,703,eraser,1,3,2,1,00180,India
921226,2023-02-24,712,graph paper,20,40,20,1,00180,India
921226,2023-02-24,716,printing paper,200,400,200,1,00180,India
517321,2023-02-24,716,printing paper,200,400,200,1,00181,India
517321,2023-02-24,707,marker,20,40,20,1,00181,India
177219,2023-02-24,712,graph paper,20,40,20,1,00182,India
177219,2023-02-24,706,sharpener,3,8,5,1,00182,India
177219,2023-02-24,707,marker,20,40,20,1,00182,India
853915,2023-02-24,710,geometry box,100,150,50,1,00183,India
853915,2023-02-24,713,ball pen,5,10,5,1,00183,India
853915,2023-02-24,716,printing paper,200,400,200,1,00183,India
853915,2023-02-24,717,spiral bound book,50,100,50,1,00183,India
853915,2023-02-24,708,sketchpen,15,40,25,1,00183,India
344854,2023-02-24,709,notebook,30,60,30,1,00184,India
344854,2023-02-24,711,TD kit,150,300,150,1,00184,India
344854,2023-02-24,707,marker,20,40,20,1,00184,India
344854,2023-02-24,710,geometry box,100,150,50,1,00184,India
129869,2023-02-24,712,graph paper,20,40,20,1,00185,India
129869,2023-02-24,704,scale,5,10,5,1,00185,India
872178,2023-02-24,712,graph paper,20,40,20,1,00186,India
872178,2023-02-24,710,geometry box,100,150,50,1,00186,India
795068,2023-02-24,715,folder,5,15,10,1,00187,India
716200,2023-02-24,717,spiral bound book,50,100,50,1,00188,India
716200,2023-02-24,716,printing paper,200,400,200,1,00188,India
716200,2023-02-24,706,sharpener,3,8,5,1,00188,India
716200,2023-02-24,704,scale,5,10,5,1,00188,India
830996,2023-02-24,714,carbon paper,15,30,15,1,00189,India
866060,2023-02-24,705,stencil,10,20,10,1,00190,India
866060,2023-02-24,708,sketchpen,15,40,25,1,00190,India
866060,2023-02-24,709,notebook,30,60,30,1,00190,India
866060,2023-02-24,712,graph paper,20,40,20,1,00190,India
472005,2023-02-24,710,geometry box,100,150,50,1,00191,India
472005,2023-02-24,714,carbon paper,15,30,15,1,00191,India
472005,2023-02-24,707,marker,20,40,20,1,00191,India
170588,2023-02-24,702,pencil,2,5,3,1,00192,India
170588,2023-02-24,713,ball pen,5,10,5,1,00192,India
170588,2023-02-24,701,gel pen,5,10,5,1,00192,India
202356,2023-02-24,710,geometry box,100,150,50,1,00193,India
202356,2023-02-24,709,notebook,30,60,30,1,00193,India
202356,2023-02-24,714,carbon paper,15,30,15,1,00193,India
202356,2023-02-24,715,folder,5,15,10,1,00193,India
202356,2023-02-24,704,scale,5,10,5,1,00193,India
842971,2023-02-24,712,graph paper,20,40,20,1,00194,India
842971,2023-02-24,705,stencil,10,20,10,1,00194,India
519367,2023-02-24,701,gel pen,5,10,5,1,00195,India
516906,2023-02-24,702,pencil,2,5,3,1,00196,India
516906,2023-02-24,715,folder,5,15,10,1,00196,India
806083,2023-02-24,702,pencil,2,5,3,1,00197,India
433118,2023-02-24,706,sharpener,3,8,5,1,00198,India
433118,2023-02-24,705,stencil,10,20,10,1,00198,India
433118,2023-02-24,712,graph paper,20,40,20,1,00198,India
543335,2023-02-24,708,sketchpen,15,40,25,1,00199,India
543335,2023-02-24,713,ball pen,5,10,5,1,00199,India
543335,2023-02-24,714,carbon paper,15,30,15,1,00199,India
141547,2023-02-24,706,sharpener,3,8,5,1,00200,India
141547,2023-02-24,705,stencil,10,20,10,1,00200,India
141547,2023-02-24,702,pencil,2,5,3,1,00200,India
148564,2023-02-24,703,eraser,1,3,2,1,00201,India
558075,2023-02-24,711,TD kit,150,300,150,1,00202,India
558075,2023-02-24,717,spiral bound book,50,100,50,1,00202,India
558075,2023-02-24,708,sketchpen,15,40,25,1,00202,India
558075,2023-02-24,712,graph paper,20,40,20,1,00202,India
558075,2023-02-24,709,notebook,30,60,30,1,00202,India
475043,2023-02-24,713,ball pen,5,10,5,1,00203,India
475043,2023-02-24,714,carbon paper,15,30,15,1,00203,India
475043,2023-02-24,711,TD kit,150,300,150,1,00203,India
501257,2023-02-24,708,sketchpen,15,40,25,1,00204,India
501257,2023-02-24,717,spiral bound book,50,100,50,1,00204,India
501257,2023-02-24,712,graph paper,20,40,20,1,00204,India
642612,2023-02-25,710,geometry box,100,150,50,1,00205,India
642612,2023-02-25,716,printing paper,200,400,200,1,00205,India
642612,2023-02-25,715,folder,5,15,10,1,00205,India
642612,2023-02-25,702,pencil,2,5,3,1,00205,India
953869,2023-02-25,716,printing paper,200,400,200,1,00206,India
953869,2023-02-25,706,sharpener,3,8,5,1,00206,India
953869,2023-02-25,708,sketchpen,15,40,25,1,00206,India
915630,2023-02-25,705,stencil,10,20,10,1,00207,India
915630,2023-02-25,703,eraser,1,3,2,1,00207,India
855609,2023-02-25,709,notebook,30,60,30,1,00208,India
855609,2023-02-25,710,geometry box,100,150,50,1,00208,India
855609,2023-02-25,714,carbon paper,15,30,15,1,00208,India
855609,2023-02-25,713,ball pen,5,10,5,1,00208,India
322612,2023-02-25,714,carbon paper,15,30,15,1,00209,India
322612,2023-02-25,716,printing paper,200,400,200,1,00209,India
322612,2023-02-25,713,ball pen,5,10,5,1,00209,India
875381,2023-02-25,707,marker,20,40,20,1,00210,India
875381,2023-02-25,714,carbon paper,15,30,15,1,00210,India
875381,2023-02-25,708,sketchpen,15,40,25,1,00210,India
875381,2023-02-25,706,sharpener,3,8,5,1,00210,India
739426,2023-02-25,716,printing paper,200,400,200,1,00211,India
739426,2023-02-25,707,marker,20,40,20,1,00211,India
393675,2023-02-25,712,graph paper,20,40,20,1,00212,India
393675,2023-02-25,704,scale,5,10,5,1,00212,India
393675,2023-02-25,717,spiral bound book,50,100,50,1,00212,India
246250,2023-02-25,714,carbon paper,15,30,15,1,00213,India
217668,2023-02-25,705,stencil,10,20,10,1,00214,India
217668,2023-02-25,709,notebook,30,60,30,1,00214,India
694226,2023-02-25,704,scale,5,10,5,1,00215,India
694226,2023-02-25,715,folder,5,15,10,1,00215,India
608792,2023-02-25,713,ball pen,5,10,5,1,00216,India
665418,2023-02-25,711,TD kit,150,300,150,1,00217,India
665418,2023-02-25,714,carbon paper,15,30,15,1,00217,India
665418,2023-02-25,709,notebook,30,60,30,1,00217,India
523782,2023-02-25,707,marker,20,40,20,1,00218,India
523782,2023-02-25,708,sketchpen,15,40,25,1,00218,India
523782,2023-02-25,713,ball pen,5,10,5,1,00218,India
523782,2023-02-25,701,gel pen,5,10,5,1,00218,India
523782,2023-02-25,715,folder,5,15,10,1,00218,India
282645,2023-02-25,717,spiral bound book,50,100,50,1,00219,India
714460,2023-02-25,703,eraser,1,3,2,1,00220,India
714460,2023-02-25,710,geometry box,100,150,50,1,00220,India
714460,2023-02-25,716,printing paper,200,400,200,1,00220,India
953497,2023-02-25,705,stencil,10,20,10,1,00221,India
953497,2023-02-25,708,sketchpen,15,40,25,1,00221,India
953497,2023-02-25,703,eraser,1,3,2,1,00221,India
953497,2023-02-25,711,TD kit,150,300,150,1,00221,India
196606,2023-02-25,710,geometry box,100,150,50,1,00222,India
196606,2023-02-25,704,scale,5,10,5,1,00222,India
196606,2023-02-25,717,spiral bound book,50,100,50,1,00222,India
737921,2023-02-25,705,stencil,10,20,10,1,00223,India
737921,2023-02-25,702,pencil,2,5,3,1,00223,India
737921,2023-02-25,707,marker,20,40,20,1,00223,India
341204,2023-02-25,710,geometry box,100,150,50,1,00224,India
416380,2023-02-25,701,gel pen,5,10,5,1,00225,India
416380,2023-02-25,704,scale,5,10,5,1,00225,India
416380,2023-02-25,703,eraser,1,3,2,1,00225,India
416380,2023-02-25,706,sharpener,3,8,5,1,00225,India
960004,2023-02-25,706,sharpener,3,8,5,1,00226,India
960004,2023-02-25,701,gel pen,5,10,5,1,00226,India
960004,2023-02-25,703,eraser,1,3,2,1,00226,India
960004,2023-02-25,715,folder,5,15,10,1,00226,India
716547,2023-02-25,702,pencil,2,5,3,1,00227,India
716547,2023-02-25,716,printing paper,200,400,200,1,00227,India
716547,2023-02-25,715,folder,5,15,10,1,00227,India
305785,2023-02-25,702,pencil,2,5,3,1,00228,India
552827,2023-02-25,712,graph paper,20,40,20,1,00229,India
552827,2023-02-25,714,carbon paper,15,30,15,1,00229,India
708441,2023-02-25,703,eraser,1,3,2,1,00230,India
708441,2023-02-25,717,spiral bound book,50,100,50,1,00230,India
708441,2023-02-25,702,pencil,2,5,3,1,00230,India
646415,2023-02-25,701,gel pen,5,10,5,1,00231,India
646415,2023-02-25,706,sharpener,3,8,5,1,00231,India
971418,2023-02-25,716,printing paper,200,400,200,1,00232,India
971418,2023-02-25,709,notebook,30,60,30,1,00232,India
971418,2023-02-25,711,TD kit,150,300,150,1,00232,India
971418,2023-02-25,705,stencil,10,20,10,1,00232,India
608312,2023-02-25,714,carbon paper,15,30,15,1,00233,India
608312,2023-02-25,709,notebook,30,60,30,1,00233,India
608312,2023-02-25,703,eraser,1,3,2,1,00233,India
933977,2023-02-25,706,sharpener,3,8,5,1,00234,India
933977,2023-02-25,710,geometry box,100,150,50,1,00234,India
933977,2023-02-25,709,notebook,30,60,30,1,00234,India
933977,2023-02-25,707,marker,20,40,20,1,00234,India
100506,2023-02-25,711,TD kit,150,300,150,1,00235,India
100506,2023-02-25,713,ball pen,5,10,5,1,00235,India
100506,2023-02-25,704,scale,5,10,5,1,00235,India
974234,2023-02-25,704,scale,5,10,5,1,00236,India
311324,2023-02-25,712,graph paper,20,40,20,1,00237,India
311324,2023-02-25,711,TD kit,150,300,150,1,00237,India
311324,2023-02-25,704,scale,5,10,5,1,00237,India
311324,2023-02-25,710,geometry box,100,150,50,1,00237,India
516686,2023-02-25,704,scale,5,10,5,1,00238,India
516686,2023-02-25,712,graph paper,20,40,20,1,00238,India
516686,2023-02-25,706,sharpener,3,8,5,1,00238,India
516686,2023-02-25,703,eraser,1,3,2,1,00238,India
516686,2023-02-25,715,folder,5,15,10,1,00238,India
707872,2023-02-25,716,printing paper,200,400,200,1,00239,India
707872,2023-02-25,705,stencil,10,20,10,1,00239,India
707872,2023-02-25,715,folder,5,15,10,1,00239,India
139085,2023-02-25,701,gel pen,5,10,5,1,00240,India
139085,2023-02-25,715,folder,5,15,10,1,00240,India
139085,2023-02-25,707,marker,20,40,20,1,00240,India
608001,2023-02-25,715,folder,5,15,10,1,00241,India
608001,2023-02-25,701,gel pen,5,10,5,1,00241,India
608001,2023-02-25,706,sharpener,3,8,5,1,00241,India
429331,2023-02-25,710,geometry box,100,150,50,1,00242,India
429331,2023-02-25,707,marker,20,40,20,1,00242,India
429331,2023-02-25,715,folder,5,15,10,1,00242,India
429331,2023-02-25,714,carbon paper,15,30,15,1,00242,India
367870,2023-02-25,716,printing paper,200,400,200,1,00243,India
367870,2023-02-25,711,TD kit,150,300,150,1,00243,India
478305,2023-02-25,705,stencil,10,20,10,1,00244,India
165323,2023-02-25,702,pencil,2,5,3,1,00245,India
165323,2023-02-25,717,spiral bound book,50,100,50,1,00245,India
165323,2023-02-25,707,marker,20,40,20,1,00245,India
165323,2023-02-25,701,gel pen,5,10,5,1,00245,India
251702,2023-02-25,709,notebook,30,60,30,1,00246,India
251702,2023-02-25,707,marker,20,40,20,1,00246,India
251702,2023-02-25,710,geometry box,100,150,50,1,00246,India
552454,2023-02-26,710,geometry box,100,150,50,1,00247,India
552454,2023-02-26,707,marker,20,40,20,1,00247,India
883578,2023-02-26,716,printing paper,200,400,200,1,00248,India
883578,2023-02-26,709,notebook,30,60,30,1,00248,India
554130,2023-02-26,709,notebook,30,60,30,1,00249,India
641935,2023-02-26,709,notebook,30,60,30,1,00250,India
341625,2023-02-26,704,scale,5,10,5,1,00251,India
341625,2023-02-26,702,pencil,2,5,3,1,00251,India
341625,2023-02-26,710,geometry box,100,150,50,1,00251,India
341625,2023-02-26,708,sketchpen,15,40,25,1,00251,India
341625,2023-02-26,706,sharpener,3,8,5,1,00251,India
578641,2023-02-26,703,eraser,1,3,2,1,00252,India
578641,2023-02-26,709,notebook,30,60,30,1,00252,India
578641,2023-02-26,711,TD kit,150,300,150,1,00252,India
373796,2023-02-26,706,sharpener,3,8,5,1,00253,India
373796,2023-02-26,713,ball pen,5,10,5,1,00253,India
373796,2023-02-26,704,scale,5,10,5,1,00253,India
644427,2023-02-26,714,carbon paper,15,30,15,1,00254,India
644427,2023-02-26,704,scale,5,10,5,1,00254,India
644427,2023-02-26,705,stencil,10,20,10,1,00254,India
644427,2023-02-26,717,spiral bound book,50,100,50,1,00254,India
442783,2023-02-26,717,spiral bound book,50,100,50,1,00255,India
442783,2023-02-26,712,graph paper,20,40,20,1,00255,India
442783,2023-02-26,701,gel pen,5,10,5,1,00255,India
395341,2023-02-26,702,pencil,2,5,3,1,00256,India
426605,2023-02-26,702,pencil,2,5,3,1,00257,India
426605,2023-02-26,701,gel pen,5,10,5,1,00257,India
843203,2023-02-26,704,scale,5,10,5,1,00258,India
843203,2023-02-26,701,gel pen,5,10,5,1,00258,India
843203,2023-02-26,708,sketchpen,15,40,25,1,00258,India
843203,2023-02-26,711,TD kit,150,300,150,1,00258,India
271631,2023-02-26,703,eraser,1,3,2,1,00259,India
271631,2023-02-26,704,scale,5,10,5,1,00259,India
271631,2023-02-26,711,TD kit,150,300,150,1,00259,India
620643,2023-02-26,717,spiral bound book,50,100,50,1,00260,India
620643,2023-02-26,703,eraser,1,3,2,1,00260,India
124530,2023-02-26,709,notebook,30,60,30,1,00261,India
124530,2023-02-26,710,geometry box,100,150,50,1,00261,India
124530,2023-02-26,715,folder,5,15,10,1,00261,India
124530,2023-02-26,705,stencil,10,20,10,1,00261,India
380234,2023-02-26,713,ball pen,5,10,5,1,00262,India
380234,2023-02-26,704,scale,5,10,5,1,00262,India
380234,2023-02-26,709,notebook,30,60,30,1,00262,India
491874,2023-02-26,709,notebook,30,60,30,1,00263,India
491874,2023-02-26,702,pencil,2,5,3,1,00263,India
491874,2023-02-26,708,sketchpen,15,40,25,1,00263,India
491874,2023-02-26,705,stencil,10,20,10,1,00263,India
491874,2023-02-26,716,printing paper,200,400,200,1,00263,India
659088,2023-02-26,706,sharpener,3,8,5,1,00264,India
659088,2023-02-26,704,scale,5,10,5,1,00264,India
659088,2023-02-26,715,folder,5,15,10,1,00264,India
963746,2023-02-26,714,carbon paper,15,30,15,1,00265,India
287660,2023-02-26,712,graph paper,20,40,20,1,00266,India
287660,2023-02-26,701,gel pen,5,10,5,1,00266,India
287660,2023-02-26,715,folder,5,15,10,1,00266,India
287660,2023-02-26,717,spiral bound book,50,100,50,1,00266,India
581972,2023-02-26,704,scale,5,10,5,1,00267,India
869531,2023-02-26,704,scale,5,10,5,1,00268,India
869531,2023-02-26,715,folder,5,15,10,1,00268,India
869531,2023-02-26,712,graph paper,20,40,20,1,00268,India
869531,2023-02-26,717,spiral bound book,50,100,50,1,00268,India
419318,2023-02-26,709,notebook,30,60,30,1,00269,India
419318,2023-02-26,705,stencil,10,20,10,1,00269,India
419318,2023-02-26,701,gel pen,5,10,5,1,00269,India
419318,2023-02-26,703,eraser,1,3,2,1,00269,India
539753,2023-02-26,707,marker,20,40,20,1,00270,India
539753,2023-02-26,710,geometry box,100,150,50,1,00270,India
539753,2023-02-26,705,stencil,10,20,10,1,00270,India
539753,2023-02-26,716,printing paper,200,400,200,1,00270,India
539753,2023-02-26,713,ball pen,5,10,5,1,00270,India
862036,2023-02-26,702,pencil,2,5,3,1,00271,India
862036,2023-02-26,711,TD kit,150,300,150,1,00271,India
862036,2023-02-26,715,folder,5,15,10,1,00271,India
862036,2023-02-26,709,notebook,30,60,30,1,00271,India
713518,2023-02-26,702,pencil,2,5,3,1,00272,India
713518,2023-02-26,710,geometry box,100,150,50,1,00272,India
713518,2023-02-26,709,notebook,30,60,30,1,00272,India
146138,2023-02-26,709,notebook,30,60,30,1,00273,India
146138,2023-02-26,705,stencil,10,20,10,1,00273,India
601131,2023-02-26,715,folder,5,15,10,1,00274,India
601131,2023-02-26,704,scale,5,10,5,1,00274,India
601131,2023-02-26,702,pencil,2,5,3,1,00274,India
601131,2023-02-26,708,sketchpen,15,40,25,1,00274,India
676399,2023-02-26,702,pencil,2,5,3,1,00275,India
676399,2023-02-26,701,gel pen,5,10,5,1,00275,India
105637,2023-02-26,710,geometry box,100,150,50,1,00276,India
379521,2023-02-26,717,spiral bound book,50,100,50,1,00277,India
379521,2023-02-26,703,eraser,1,3,2,1,00277,India
379521,2023-02-26,708,sketchpen,15,40,25,1,00277,India
701069,2023-02-26,711,TD kit,150,300,150,1,00278,India
701069,2023-02-26,716,printing paper,200,400,200,1,00278,India
701069,2023-02-26,709,notebook,30,60,30,1,00278,India
701069,2023-02-26,707,marker,20,40,20,1,00278,India
185429,2023-02-26,708,sketchpen,15,40,25,1,00279,India
346589,2023-02-26,706,sharpener,3,8,5,1,00280,India
346589,2023-02-26,703,eraser,1,3,2,1,00280,India
346589,2023-02-26,711,TD kit,150,300,150,1,00280,India
346589,2023-02-26,701,gel pen,5,10,5,1,00280,India
403106,2023-02-26,702,pencil,2,5,3,1,00281,India
403106,2023-02-26,701,gel pen,5,10,5,1,00281,India
403106,2023-02-26,713,ball pen,5,10,5,1,00281,India
607277,2023-02-26,717,spiral bound book,50,100,50,1,00282,India
607277,2023-02-26,703,eraser,1,3,2,1,00282,India
607277,2023-02-26,714,carbon paper,15,30,15,1,00282,India
607277,2023-02-26,702,pencil,2,5,3,1,00282,India
731494,2023-02-26,714,carbon paper,15,30,15,1,00283,India
329933,2023-02-26,714,carbon paper,15,30,15,1,00284,India
329933,2023-02-26,701,gel pen,5,10,5,1,00284,India
329933,2023-02-26,709,notebook,30,60,30,1,00284,India
329933,2023-02-26,711,TD kit,150,300,150,1,00284,India
566525,2023-02-26,714,carbon paper,15,30,15,1,00285,India
566525,2023-02-26,705,stencil,10,20,10,1,00285,India
566525,2023-02-26,709,notebook,30,60,30,1,00285,India
566525,2023-02-26,717,spiral bound book,50,100,50,1,00285,India
161188,2023-02-26,711,TD kit,150,300,150,1,00286,India
161188,2023-02-26,713,ball pen,5,10,5,1,00286,India
161188,2023-02-26,705,stencil,10,20,10,1,00286,India
267672,2023-02-27,714,carbon paper,15,30,15,1,00287,India
267672,2023-02-27,715,folder,5,15,10,1,00287,India
267260,2023-02-27,708,sketchpen,15,40,25,1,00288,India
267260,2023-02-27,706,sharpener,3,8,5,1,00288,India
517979,2023-02-27,703,eraser,1,3,2,1,00289,India
517979,2023-02-27,701,gel pen,5,10,5,1,00289,India
517979,2023-02-27,711,TD kit,150,300,150,1,00289,India
517979,2023-02-27,704,scale,5,10,5,1,00289,India
517979,2023-02-27,708,sketchpen,15,40,25,1,00289,India
858650,2023-02-27,717,spiral bound book,50,100,50,1,00290,India
137825,2023-02-27,708,sketchpen,15,40,25,1,00291,India
137825,2023-02-27,713,ball pen,5,10,5,1,00291,India
137825,2023-02-27,701,gel pen,5,10,5,1,00291,India
508012,2023-02-27,710,geometry box,100,150,50,1,00292,India
508012,2023-02-27,714,carbon paper,15,30,15,1,00292,India
710885,2023-02-27,711,TD kit,150,300,150,1,00293,India
710885,2023-02-27,713,ball pen,5,10,5,1,00293,India
710885,2023-02-27,716,printing paper,200,400,200,1,00293,India
710885,2023-02-27,705,stencil,10,20,10,1,00293,India
159320,2023-02-27,706,sharpener,3,8,5,1,00294,India
159320,2023-02-27,713,ball pen,5,10,5,1,00294,India
620050,2023-02-27,704,scale,5,10,5,1,00295,India
397491,2023-02-27,707,marker,20,40,20,1,00296,India
210304,2023-02-27,704,scale,5,10,5,1,00297,India
210304,2023-02-27,715,folder,5,15,10,1,00297,India
210304,2023-02-27,716,printing paper,200,400,200,1,00297,India
210304,2023-02-27,707,marker,20,40,20,1,00297,India
869888,2023-02-27,715,folder,5,15,10,1,00298,India
869888,2023-02-27,708,sketchpen,15,40,25,1,00298,India
869888,2023-02-27,716,printing paper,200,400,200,1,00298,India
977346,2023-02-27,706,sharpener,3,8,5,1,00299,India
187610,2023-02-27,716,printing paper,200,400,200,1,00300,India
187610,2023-02-27,708,sketchpen,15,40,25,1,00300,India
187610,2023-02-27,710,geometry box,100,150,50,1,00300,India
601750,2023-02-27,706,sharpener,3,8,5,1,00301,India
601750,2023-02-27,701,gel pen,5,10,5,1,00301,India
896744,2023-02-27,716,printing paper,200,400,200,1,00302,India
896744,2023-02-27,715,folder,5,15,10,1,00302,India
991411,2023-02-27,703,eraser,1,3,2,1,00303,India
991411,2023-02-27,705,stencil,10,20,10,1,00303,India
734339,2023-02-27,705,stencil,10,20,10,1,00304,India
734339,2023-02-27,706,sharpener,3,8,5,1,00304,India
734339,2023-02-27,702,pencil,2,5,3,1,00304,India
734339,2023-02-27,710,geometry box,100,150,50,1,00304,India
125151,2023-02-27,709,notebook,30,60,30,1,00305,India
125151,2023-02-27,703,eraser,1,3,2,1,00305,India
125151,2023-02-27,711,TD kit,150,300,150,1,00305,India
125151,2023-02-27,713,ball pen,5,10,5,1,00305,India
125151,2023-02-27,715,folder,5,15,10,1,00305,India
719667,2023-02-27,712,graph paper,20,40,20,1,00306,India
284693,2023-02-27,715,folder,5,15,10,1,00307,India
284693,2023-02-27,717,spiral bound book,50,100,50,1,00307,India
284693,2023-02-27,704,scale,5,10,5,1,00307,India
284693,2023-02-27,709,notebook,30,60,30,1,00307,India
728208,2023-02-27,710,geometry box,100,150,50,1,00308,India
728208,2023-02-27,704,scale,5,10,5,1,00308,India
728208,2023-02-27,711,TD kit,150,300,150,1,00308,India
332965,2023-02-27,717,spiral bound book,50,100,50,1,00309,India
332965,2023-02-27,705,stencil,10,20,10,1,00309,India
833334,2023-02-27,704,scale,5,10,5,1,00310,India
300718,2023-02-27,706,sharpener,3,8,5,1,00311,India
779490,2023-02-27,704,scale,5,10,5,1,00312,India
779490,2023-02-27,708,sketchpen,15,40,25,1,00312,India
779490,2023-02-27,714,carbon paper,15,30,15,1,00312,India
779490,2023-02-27,702,pencil,2,5,3,1,00312,India
684142,2023-02-27,706,sharpener,3,8,5,1,00313,India
684142,2023-02-27,717,spiral bound book,50,100,50,1,00313,India
684142,2023-02-27,703,eraser,1,3,2,1,00313,India
684142,2023-02-27,709,notebook,30,60,30,1,00313,India
612198,2023-02-27,710,geometry box,100,150,50,1,00314,India
612198,2023-02-27,703,eraser,1,3,2,1,00314,India
612198,2023-02-27,704,scale,5,10,5,1,00314,India
612198,2023-02-27,705,stencil,10,20,10,1,00314,India
424396,2023-02-27,701,gel pen,5,10,5,1,00315,India
693246,2023-02-27,711,TD kit,150,300,150,1,00316,India
693246,2023-02-27,704,scale,5,10,5,1,00316,India
693246,2023-02-27,717,spiral bound book,50,100,50,1,00316,India
693246,2023-02-27,712,graph paper,20,40,20,1,00316,India
471691,2023-02-27,711,TD kit,150,300,150,1,00317,India
471691,2023-02-27,702,pencil,2,5,3,1,00317,India
471691,2023-02-27,710,geometry box,100,150,50,1,00317,India
151737,2023-02-27,704,scale,5,10,5,1,00318,India
151737,2023-02-27,706,sharpener,3,8,5,1,00318,India
853324,2023-02-27,707,marker,20,40,20,1,00319,India
853324,2023-02-27,706,sharpener,3,8,5,1,00319,India
853324,2023-02-27,711,TD kit,150,300,150,1,00319,India
853324,2023-02-27,704,scale,5,10,5,1,00319,India
320725,2023-02-27,713,ball pen,5,10,5,1,00320,India
120724,2023-02-27,713,ball pen,5,10,5,1,00321,India
120724,2023-02-27,705,stencil,10,20,10,1,00321,India
120724,2023-02-27,702,pencil,2,5,3,1,00321,India
120724,2023-02-27,712,graph paper,20,40,20,1,00321,India
663011,2023-02-27,716,printing paper,200,400,200,1,00322,India
116297,2023-02-27,701,gel pen,5,10,5,1,00323,India
116297,2023-02-27,713,ball pen,5,10,5,1,00323,India
685827,2023-02-27,706,sharpener,3,8,5,1,00324,India
685827,2023-02-27,705,stencil,10,20,10,1,00324,India
722817,2023-02-27,711,TD kit,150,300,150,1,00325,India
722817,2023-02-27,717,spiral bound book,50,100,50,1,00325,India
722817,2023-02-27,706,sharpener,3,8,5,1,00325,India
722817,2023-02-27,709,notebook,30,60,30,1,00325,India
426342,2023-02-27,717,spiral bound book,50,100,50,1,00326,India
426342,2023-02-27,714,carbon paper,15,30,15,1,00326,India
426342,2023-02-27,701,gel pen,5,10,5,1,00326,India
426342,2023-02-27,708,sketchpen,15,40,25,1,00326,India
426342,2023-02-27,704,scale,5,10,5,1,00326,India
403062,2023-02-27,701,gel pen,5,10,5,1,00327,India
403062,2023-02-27,713,ball pen,5,10,5,1,00327,India
403062,2023-02-27,714,carbon paper,15,30,15,1,00327,India
394325,2023-02-27,710,geometry box,100,150,50,1,00328,India
394325,2023-02-27,714,carbon paper,15,30,15,1,00328,India
344267,2023-02-27,716,printing paper,200,400,200,1,00329,India
344267,2023-02-27,713,ball pen,5,10,5,1,00329,India
344267,2023-02-27,705,stencil,10,20,10,1,00329,India
708825,2023-02-27,717,spiral bound book,50,100,50,1,00330,India
708825,2023-02-27,713,ball pen,5,10,5,1,00330,India
708825,2023-02-27,712,graph paper,20,40,20,1,00330,India
708825,2023-02-27,701,gel pen,5,10,5,1,00330,India
708825,2023-02-27,708,sketchpen,15,40,25,1,00330,India
566336,2023-02-28,708,sketchpen,15,40,25,1,00331,India
566336,2023-02-28,711,TD kit,150,300,150,1,00331,India
566336,2023-02-28,712,graph paper,20,40,20,1,00331,India
566336,2023-02-28,713,ball pen,5,10,5,1,00331,India
566336,2023-02-28,716,printing paper,200,400,200,1,00331,India
766395,2023-02-28,717,spiral bound book,50,100,50,1,00332,India
766395,2023-02-28,710,geometry box,100,150,50,1,00332,India
766395,2023-02-28,713,ball pen,5,10,5,1,00332,India
698136,2023-02-28,715,folder,5,15,10,1,00333,India
698136,2023-02-28,702,pencil,2,5,3,1,00333,India
698136,2023-02-28,705,stencil,10,20,10,1,00333,India
131542,2023-02-28,711,TD kit,150,300,150,1,00334,India
218232,2023-02-28,706,sharpener,3,8,5,1,00335,India
218232,2023-02-28,712,graph paper,20,40,20,1,00335,India
218232,2023-02-28,716,printing paper,200,400,200,1,00335,India
218232,2023-02-28,702,pencil,2,5,3,1,00335,India
218232,2023-02-28,713,ball pen,5,10,5,1,00335,India
716619,2023-02-28,703,eraser,1,3,2,1,00336,India
368504,2023-02-28,703,eraser,1,3,2,1,00337,India
709177,2023-02-28,717,spiral bound book,50,100,50,1,00338,India
709177,2023-02-28,704,scale,5,10,5,1,00338,India
869385,2023-02-28,713,ball pen,5,10,5,1,00339,India
869385,2023-02-28,712,graph paper,20,40,20,1,00339,India
869385,2023-02-28,708,sketchpen,15,40,25,1,00339,India
869385,2023-02-28,703,eraser,1,3,2,1,00339,India
869385,2023-02-28,706,sharpener,3,8,5,1,00339,India
398977,2023-02-28,705,stencil,10,20,10,1,00340,India
398977,2023-02-28,712,graph paper,20,40,20,1,00340,India
398977,2023-02-28,713,ball pen,5,10,5,1,00340,India
398977,2023-02-28,706,sharpener,3,8,5,1,00340,India
398977,2023-02-28,702,pencil,2,5,3,1,00340,India
292020,2023-02-28,716,printing paper,200,400,200,1,00341,India
292020,2023-02-28,708,sketchpen,15,40,25,1,00341,India
617439,2023-02-28,706,sharpener,3,8,5,1,00342,India
617439,2023-02-28,716,printing paper,200,400,200,1,00342,India
651024,2023-02-28,702,pencil,2,5,3,1,00343,India
651024,2023-02-28,714,carbon paper,15,30,15,1,00343,India
651024,2023-02-28,705,stencil,10,20,10,1,00343,India
373779,2023-02-28,708,sketchpen,15,40,25,1,00344,India
593583,2023-02-28,715,folder,5,15,10,1,00345,India
593583,2023-02-28,707,marker,20,40,20,1,00345,India
554772,2023-02-28,716,printing paper,200,400,200,1,00346,India
554772,2023-02-28,708,sketchpen,15,40,25,1,00346,India
554772,2023-02-28,705,stencil,10,20,10,1,00346,India
554772,2023-02-28,715,folder,5,15,10,1,00346,India
195433,2023-02-28,713,ball pen,5,10,5,1,00347,India
195433,2023-02-28,703,eraser,1,3,2,1,00347,India
195433,2023-02-28,706,sharpener,3,8,5,1,00347,India
195433,2023-02-28,717,spiral bound book,50,100,50,1,00347,India
526777,2023-02-28,702,pencil,2,5,3,1,00348,India
526777,2023-02-28,705,stencil,10,20,10,1,00348,India
526777,2023-02-28,708,sketchpen,15,40,25,1,00348,India
526777,2023-02-28,711,TD kit,150,300,150,1,00348,India
526777,2023-02-28,710,geometry box,100,150,50,1,00348,India
243011,2023-02-28,715,folder,5,15,10,1,00349,India
243011,2023-02-28,704,scale,5,10,5,1,00349,India
243011,2023-02-28,708,sketchpen,15,40,25,1,00349,India
243011,2023-02-28,703,eraser,1,3,2,1,00349,India
243011,2023-02-28,716,printing paper,200,400,200,1,00349,India
648714,2023-02-28,713,ball pen,5,10,5,1,00350,India
648714,2023-02-28,708,sketchpen,15,40,25,1,00350,India
843341,2023-02-28,706,sharpener,3,8,5,1,00351,India
843341,2023-02-28,716,printing paper,200,400,200,1,00351,India
412974,2023-02-28,717,spiral bound book,50,100,50,1,00352,India
412974,2023-02-28,706,sharpener,3,8,5,1,00352,India
474475,2023-02-28,716,printing paper,200,400,200,1,00353,India
474475,2023-02-28,708,sketchpen,15,40,25,1,00353,India
474475,2023-02-28,715,folder,5,15,10,1,00353,India
683891,2023-02-28,708,sketchpen,15,40,25,1,00354,India
683891,2023-02-28,711,TD kit,150,300,150,1,00354,India
359660,2023-02-28,705,stencil,10,20,10,1,00355,India
359660,2023-02-28,701,gel pen,5,10,5,1,00355,India
359660,2023-02-28,710,geometry box,100,150,50,1,00355,India
359660,2023-02-28,714,carbon paper,15,30,15,1,00355,India
359660,2023-02-28,704,scale,5,10,5,1,00355,India
274588,2023-02-28,707,marker,20,40,20,1,00356,India
274588,2023-02-28,711,TD kit,150,300,150,1,00356,India
274588,2023-02-28,702,pencil,2,5,3,1,00356,India
274588,2023-02-28,712,graph paper,20,40,20,1,00356,India
430952,2023-02-28,704,scale,5,10,5,1,00357,India
474580,2023-02-28,706,sharpener,3,8,5,1,00358,India
474580,2023-02-28,716,printing paper,200,400,200,1,00358,India
474580,2023-02-28,705,stencil,10,20,10,1,00358,India
474580,2023-02-28,703,eraser,1,3,2,1,00358,India
474580,2023-02-28,712,graph paper,20,40,20,1,00358,India
648651,2023-02-28,714,carbon paper,15,30,15,1,00359,India
648651,2023-02-28,706,sharpener,3,8,5,1,00359,India
648651,2023-02-28,709,notebook,30,60,30,1,00359,India
648651,2023-02-28,712,graph paper,20,40,20,1,00359,India
214038,2023-02-28,717,spiral bound book,50,100,50,1,00360,India
214038,2023-02-28,703,eraser,1,3,2,1,00360,India
834820,2023-02-28,711,TD kit,150,300,150,1,00361,India
834820,2023-02-28,706,sharpener,3,8,5,1,00361,India
879980,2023-02-28,707,marker,20,40,20,1,00362,India
879980,2023-02-28,716,printing paper,200,400,200,1,00362,India
766851,2023-02-28,705,stencil,10,20,10,1,00363,India
595840,2023-02-28,715,folder,5,15,10,1,00364,India
950404,2023-02-28,717,spiral bound book,50,100,50,1,00365,India
950404,2023-02-28,705,stencil,10,20,10,1,00365,India
950404,2023-02-28,707,marker,20,40,20,1,00365,India
950404,2023-02-28,711,TD kit,150,300,150,1,00365,India
667444,2023-02-28,715,folder,5,15,10,1,00366,India
667444,2023-02-28,707,marker,20,40,20,1,00366,India
667444,2023-02-28,717,spiral bound book,50,100,50,1,00366,India
590672,2023-02-28,702,pencil,2,5,3,1,00367,India
590672,2023-02-28,711,TD kit,150,300,150,1,00367,India
590672,2023-02-28,708,sketchpen,15,40,25,1,00367,India
590672,2023-02-28,703,eraser,1,3,2,1,00367,India
558833,2023-02-28,707,marker,20,40,20,1,00368,India
558833,2023-02-28,705,stencil,10,20,10,1,00368,India
558833,2023-02-28,702,pencil,2,5,3,1,00368,India
558833,2023-02-28,701,gel pen,5,10,5,1,00368,India
558833,2023-02-28,714,carbon paper,15,30,15,1,00368,India
277261,2023-02-28,716,printing paper,200,400,200,1,00369,India
277261,2023-02-28,709,notebook,30,60,30,1,00369,India
277261,2023-02-28,706,sharpener,3,8,5,1,00369,India
191651,2023-02-28,710,geometry box,100,150,50,1,00370,India
191651,2023-02-28,703,eraser,1,3,2,1,00370,India
376035,2023-02-28,708,sketchpen,15,40,25,1,00371,India
376035,2023-02-28,707,marker,20,40,20,1,00371,India
376035,2023-02-28,702,pencil,2,5,3,1,00371,India
337015,2023-02-28,711,TD kit,150,300,150,1,00372,India
337015,2023-02-28,714,carbon paper,15,30,15,1,00372,India
337015,2023-02-28,713,ball pen,5,10,5,1,00372,India
337015,2023-02-28,704,scale,5,10,5,1,00372,India
818473,2023-02-28,714,carbon paper,15,30,15,1,00373,India
818473,2023-02-28,716,printing paper,200,400,200,1,00373,India
818473,2023-02-28,702,pencil,2,5,3,1,00373,India
818473,2023-02-28,717,spiral bound book,50,100,50,1,00373,India
818473,2023-02-28,703,eraser,1,3,2,1,00373,India
424620,2023-02-28,701,gel pen,5,10,5,1,00374,India
424620,2023-02-28,702,pencil,2,5,3,1,00374,India
424620,2023-02-28,709,notebook,30,60,30,1,00374,India
424620,2023-02-28,716,printing paper,200,400,200,1,00374,India
424620,2023-02-28,713,ball pen,5,10,5,1,00374,India
393353,2023-02-28,713,ball pen,5,10,5,1,00375,India
393353,2023-02-28,710,geometry box,100,150,50,1,00375,India
555514,2023-02-28,706,sharpener,3,8,5,1,00376,India
555514,2023-02-28,713,ball pen,5,10,5,1,00376,India
555514,2023-02-28,709,notebook,30,60,30,1,00376,India
639980,2023-02-28,716,printing paper,200,400,200,1,00377,India
639980,2023-02-28,701,gel pen,5,10,5,1,00377,India
639980,2023-02-28,712,graph paper,20,40,20,1,00377,India
639980,2023-02-28,714,carbon paper,15,30,15,1,00377,India
951514,2023-03-01,704,scale,5,10,5,1,00378,India
951514,2023-03-01,711,TD kit,150,300,150,1,00378,India
951514,2023-03-01,713,ball pen,5,10,5,1,00378,India
951514,2023-03-01,712,graph paper,20,40,20,1,00378,India
951514,2023-03-01,715,folder,5,15,10,1,00378,India
373452,2023-03-01,713,ball pen,5,10,5,1,00379,India
373452,2023-03-01,708,sketchpen,15,40,25,1,00379,India
901377,2023-03-01,709,notebook,30,60,30,1,00380,India
901377,2023-03-01,707,marker,20,40,20,1,00380,India
901377,2023-03-01,706,sharpener,3,8,5,1,00380,India
628741,2023-03-01,707,marker,20,40,20,1,00381,India
628741,2023-03-01,702,pencil,2,5,3,1,00381,India
628741,2023-03-01,701,gel pen,5,10,5,1,00381,India
628741,2023-03-01,716,printing paper,200,400,200,1,00381,India
584986,2023-03-01,716,printing paper,200,400,200,1,00382,India
156664,2023-03-01,703,eraser,1,3,2,1,00383,India
156664,2023-03-01,716,printing paper,200,400,200,1,00383,India
156664,2023-03-01,709,notebook,30,60,30,1,00383,India
156664,2023-03-01,702,pencil,2,5,3,1,00383,India
156766,2023-03-01,717,spiral bound book,50,100,50,1,00384,India
156766,2023-03-01,702,pencil,2,5,3,1,00384,India
156766,2023-03-01,709,notebook,30,60,30,1,00384,India
234238,2023-03-01,707,marker,20,40,20,1,00385,India
234238,2023-03-01,716,printing paper,200,400,200,1,00385,India
234238,2023-03-01,708,sketchpen,15,40,25,1,00385,India
721875,2023-03-01,710,geometry box,100,150,50,1,00386,India
721875,2023-03-01,702,pencil,2,5,3,1,00386,India
721875,2023-03-01,706,sharpener,3,8,5,1,00386,India
719524,2023-03-01,707,marker,20,40,20,1,00387,India
383398,2023-03-01,701,gel pen,5,10,5,1,00388,India
383398,2023-03-01,702,pencil,2,5,3,1,00388,India
383398,2023-03-01,713,ball pen,5,10,5,1,00388,India
383398,2023-03-01,709,notebook,30,60,30,1,00388,India
192182,2023-03-01,714,carbon paper,15,30,15,1,00389,India
192182,2023-03-01,707,marker,20,40,20,1,00389,India
709176,2023-03-01,706,sharpener,3,8,5,1,00390,India
709176,2023-03-01,712,graph paper,20,40,20,1,00390,India
709176,2023-03-01,716,printing paper,200,400,200,1,00390,India
894908,2023-03-01,701,gel pen,5,10,5,1,00391,India
894908,2023-03-01,715,folder,5,15,10,1,00391,India
894908,2023-03-01,705,stencil,10,20,10,1,00391,India
894908,2023-03-01,712,graph paper,20,40,20,1,00391,India
454350,2023-03-01,707,marker,20,40,20,1,00392,India
854485,2023-03-01,709,notebook,30,60,30,1,00393,India
854485,2023-03-01,703,eraser,1,3,2,1,00393,India
854485,2023-03-01,715,folder,5,15,10,1,00393,India
346252,2023-03-01,712,graph paper,20,40,20,1,00394,India
584695,2023-03-01,706,sharpener,3,8,5,1,00395,India
584695,2023-03-01,711,TD kit,150,300,150,1,00395,India
734400,2023-03-01,715,folder,5,15,10,1,00396,India
186883,2023-03-01,704,scale,5,10,5,1,00397,India
186883,2023-03-01,714,carbon paper,15,30,15,1,00397,India
784833,2023-03-01,702,pencil,2,5,3,1,00398,India
784833,2023-03-01,707,marker,20,40,20,1,00398,India
784833,2023-03-01,701,gel pen,5,10,5,1,00398,India
784833,2023-03-01,710,geometry box,100,150,50,1,00398,India
549982,2023-03-01,715,folder,5,15,10,1,00399,India
549982,2023-03-01,708,sketchpen,15,40,25,1,00399,India
549982,2023-03-01,712,graph paper,20,40,20,1,00399,India
549982,2023-03-01,713,ball pen,5,10,5,1,00399,India
666928,2023-03-01,706,sharpener,3,8,5,1,00400,India
598676,2023-03-01,711,TD kit,150,300,150,1,00401,India
598676,2023-03-01,701,gel pen,5,10,5,1,00401,India
598676,2023-03-01,703,eraser,1,3,2,1,00401,India
777766,2023-03-01,704,scale,5,10,5,1,00402,India
296825,2023-03-01,716,printing paper,200,400,200,1,00403,India
457277,2023-03-01,714,carbon paper,15,30,15,1,00404,India
457277,2023-03-01,713,ball pen,5,10,5,1,00404,India
457277,2023-03-01,711,TD kit,150,300,150,1,00404,India
457277,2023-03-01,709,notebook,30,60,30,1,00404,India
520730,2023-03-01,711,TD kit,150,300,150,1,00405,India
520730,2023-03-01,702,pencil,2,5,3,1,00405,India
520730,2023-03-01,709,notebook,30,60,30,1,00405,India
520730,2023-03-01,704,scale,5,10,5,1,00405,India
183601,2023-03-01,705,stencil,10,20,10,1,00406,India
183601,2023-03-01,711,TD kit,150,300,150,1,00406,India
180520,2023-03-01,707,marker,20,40,20,1,00407,India
180520,2023-03-01,709,notebook,30,60,30,1,00407,India
408541,2023-03-01,706,sharpener,3,8,5,1,00408,India
663883,2023-03-01,711,TD kit,150,300,150,1,00409,India
663883,2023-03-01,710,geometry box,100,150,50,1,00409,India
663883,2023-03-01,703,eraser,1,3,2,1,00409,India
802441,2023-03-01,714,carbon paper,15,30,15,1,00410,India
232590,2023-03-01,704,scale,5,10,5,1,00411,India
927861,2023-03-01,705,stencil,10,20,10,1,00412,India
418056,2023-03-01,717,spiral bound book,50,100,50,1,00413,India
418056,2023-03-01,714,carbon paper,15,30,15,1,00413,India
418056,2023-03-01,705,stencil,10,20,10,1,00413,India
418056,2023-03-01,713,ball pen,5,10,5,1,00413,India
418056,2023-03-01,704,scale,5,10,5,1,00413,India
953893,2023-03-01,715,folder,5,15,10,1,00414,India
953893,2023-03-01,702,pencil,2,5,3,1,00414,India
953893,2023-03-01,710,geometry box,100,150,50,1,00414,India
953893,2023-03-01,703,eraser,1,3,2,1,00414,India
836190,2023-03-01,713,ball pen,5,10,5,1,00415,India
327095,2023-03-01,713,ball pen,5,10,5,1,00416,India
327095,2023-03-01,714,carbon paper,15,30,15,1,00416,India
164237,2023-03-01,704,scale,5,10,5,1,00417,India
164237,2023-03-01,717,spiral bound book,50,100,50,1,00417,India
164237,2023-03-01,702,pencil,2,5,3,1,00417,India
888962,2023-03-01,716,printing paper,200,400,200,1,00418,India
888962,2023-03-01,714,carbon paper,15,30,15,1,00418,India
888962,2023-03-01,712,graph paper,20,40,20,1,00418,India
706473,2023-03-01,713,ball pen,5,10,5,1,00419,India
706473,2023-03-01,717,spiral bound book,50,100,50,1,00419,India
626172,2023-03-01,714,carbon paper,15,30,15,1,00420,India
626172,2023-03-01,703,eraser,1,3,2,1,00420,India
734589,2023-03-01,706,sharpener,3,8,5,1,00421,India
734589,2023-03-01,707,marker,20,40,20,1,00421,India
734589,2023-03-01,709,notebook,30,60,30,1,00421,India
734589,2023-03-01,714,carbon paper,15,30,15,1,00421,India
720521,2023-03-01,708,sketchpen,15,40,25,1,00422,India
720521,2023-03-01,717,spiral bound book,50,100,50,1,00422,India
720521,2023-03-01,709,notebook,30,60,30,1,00422,India
918756,2023-03-01,708,sketchpen,15,40,25,1,00423,India
918756,2023-03-01,709,notebook,30,60,30,1,00423,India
923728,2023-03-01,709,notebook,30,60,30,1,00424,India
923728,2023-03-01,713,ball pen,5,10,5,1,00424,India
850645,2023-03-01,703,eraser,1,3,2,1,00425,India
850645,2023-03-01,717,spiral bound book,50,100,50,1,00425,India
950931,2023-03-01,713,ball pen,5,10,5,1,00426,India
799062,2023-03-02,711,TD kit,150,300,150,1,00427,India
799062,2023-03-02,705,stencil,10,20,10,1,00427,India
799062,2023-03-02,717,spiral bound book,50,100,50,1,00427,India
799062,2023-03-02,703,eraser,1,3,2,1,00427,India
746949,2023-03-02,702,pencil,2,5,3,1,00428,India
746949,2023-03-02,706,sharpener,3,8,5,1,00428,India
746949,2023-03-02,715,folder,5,15,10,1,00428,India
964511,2023-03-02,710,geometry box,100,150,50,1,00429,India
964511,2023-03-02,701,gel pen,5,10,5,1,00429,India
293309,2023-03-02,714,carbon paper,15,30,15,1,00430,India
293309,2023-03-02,701,gel pen,5,10,5,1,00430,India
528829,2023-03-02,717,spiral bound book,50,100,50,1,00431,India
528829,2023-03-02,715,folder,5,15,10,1,00431,India
615601,2023-03-02,701,gel pen,5,10,5,1,00432,India
615601,2023-03-02,717,spiral bound book,50,100,50,1,00432,India
615601,2023-03-02,708,sketchpen,15,40,25,1,00432,India
615601,2023-03-02,709,notebook,30,60,30,1,00432,India
615601,2023-03-02,705,stencil,10,20,10,1,00432,India
315630,2023-03-02,704,scale,5,10,5,1,00433,India
315630,2023-03-02,702,pencil,2,5,3,1,00433,India
526587,2023-03-02,704,scale,5,10,5,1,00434,India
989837,2023-03-02,716,printing paper,200,400,200,1,00435,India
989837,2023-03-02,703,eraser,1,3,2,1,00435,India
805614,2023-03-02,709,notebook,30,60,30,1,00436,India
183244,2023-03-02,703,eraser,1,3,2,1,00437,India
183244,2023-03-02,705,stencil,10,20,10,1,00437,India
406199,2023-03-02,704,scale,5,10,5,1,00438,India
406199,2023-03-02,715,folder,5,15,10,1,00438,India
442121,2023-03-02,703,eraser,1,3,2,1,00439,India
442121,2023-03-02,701,gel pen,5,10,5,1,00439,India
442121,2023-03-02,708,sketchpen,15,40,25,1,00439,India
442121,2023-03-02,702,pencil,2,5,3,1,00439,India
987989,2023-03-02,706,sharpener,3,8,5,1,00440,India
987989,2023-03-02,705,stencil,10,20,10,1,00440,India
987989,2023-03-02,711,TD kit,150,300,150,1,00440,India
705231,2023-03-02,704,scale,5,10,5,1,00441,India
705231,2023-03-02,706,sharpener,3,8,5,1,00441,India
705231,2023-03-02,707,marker,20,40,20,1,00441,India
235426,2023-03-02,702,pencil,2,5,3,1,00442,India
358357,2023-03-02,716,printing paper,200,400,200,1,00443,India
358357,2023-03-02,709,notebook,30,60,30,1,00443,India
358357,2023-03-02,717,spiral bound book,50,100,50,1,00443,India
358357,2023-03-02,714,carbon paper,15,30,15,1,00443,India
848467,2023-03-02,712,graph paper,20,40,20,1,00444,India
848467,2023-03-02,715,folder,5,15,10,1,00444,India
848467,2023-03-02,711,TD kit,150,300,150,1,00444,India
848467,2023-03-02,717,spiral bound book,50,100,50,1,00444,India
332608,2023-03-02,709,notebook,30,60,30,1,00445,India
332608,2023-03-02,708,sketchpen,15,40,25,1,00445,India
332608,2023-03-02,707,marker,20,40,20,1,00445,India
332608,2023-03-02,717,spiral bound book,50,100,50,1,00445,India
611591,2023-03-02,706,sharpener,3,8,5,1,00446,India
611591,2023-03-02,702,pencil,2,5,3,1,00446,India
603082,2023-03-02,712,graph paper,20,40,20,1,00447,India
229164,2023-03-02,705,stencil,10,20,10,1,00448,India
229164,2023-03-02,708,sketchpen,15,40,25,1,00448,India
118500,2023-03-02,701,gel pen,5,10,5,1,00449,India
118500,2023-03-02,707,marker,20,40,20,1,00449,India
118500,2023-03-02,711,TD kit,150,300,150,1,00449,India
848151,2023-03-02,714,carbon paper,15,30,15,1,00450,India
848151,2023-03-02,712,graph paper,20,40,20,1,00450,India
670491,2023-03-02,702,pencil,2,5,3,1,00451,India
225691,2023-03-02,709,notebook,30,60,30,1,00452,India
225691,2023-03-02,706,sharpener,3,8,5,1,00452,India
225691,2023-03-02,704,scale,5,10,5,1,00452,India
225691,2023-03-02,703,eraser,1,3,2,1,00452,India
741889,2023-03-02,702,pencil,2,5,3,1,00453,India
741889,2023-03-02,709,notebook,30,60,30,1,00453,India
741889,2023-03-02,717,spiral bound book,50,100,50,1,00453,India
741889,2023-03-02,701,gel pen,5,10,5,1,00453,India
741889,2023-03-02,707,marker,20,40,20,1,00453,India
294117,2023-03-02,703,eraser,1,3,2,1,00454,India
294117,2023-03-02,710,geometry box,100,150,50,1,00454,India
294117,2023-03-02,705,stencil,10,20,10,1,00454,India
513185,2023-03-02,708,sketchpen,15,40,25,1,00455,India
513185,2023-03-02,713,ball pen,5,10,5,1,00455,India
513185,2023-03-02,702,pencil,2,5,3,1,00455,India
513185,2023-03-02,716,printing paper,200,400,200,1,00455,India
944997,2023-03-02,715,folder,5,15,10,1,00456,India
944997,2023-03-02,712,graph paper,20,40,20,1,00456,India
944997,2023-03-02,706,sharpener,3,8,5,1,00456,India
944997,2023-03-02,701,gel pen,5,10,5,1,00456,India
944997,2023-03-02,702,pencil,2,5,3,1,00456,India
498472,2023-03-02,712,graph paper,20,40,20,1,00457,India
498472,2023-03-02,708,sketchpen,15,40,25,1,00457,India
374913,2023-03-02,706,sharpener,3,8,5,1,00458,India
374913,2023-03-02,704,scale,5,10,5,1,00458,India
995978,2023-03-02,704,scale,5,10,5,1,00459,India
962724,2023-03-02,713,ball pen,5,10,5,1,00460,India
962724,2023-03-02,709,notebook,30,60,30,1,00460,India
962724,2023-03-02,708,sketchpen,15,40,25,1,00460,India
962724,2023-03-02,717,spiral bound book,50,100,50,1,00460,India
962724,2023-03-02,712,graph paper,20,40,20,1,00460,India
831142,2023-03-02,712,graph paper,20,40,20,1,00461,India
831142,2023-03-02,701,gel pen,5,10,5,1,00461,India
144378,2023-03-02,716,printing paper,200,400,200,1,00462,India
144378,2023-03-02,717,spiral bound book,50,100,50,1,00462,India
144378,2023-03-02,713,ball pen,5,10,5,1,00462,India
334518,2023-03-02,707,marker,20,40,20,1,00463,India
334518,2023-03-02,701,gel pen,5,10,5,1,00463,India
334518,2023-03-02,717,spiral bound book,50,100,50,1,00463,India
334518,2023-03-02,708,sketchpen,15,40,25,1,00463,India
573995,2023-03-02,702,pencil,2,5,3,1,00464,India
573995,2023-03-02,711,TD kit,150,300,150,1,00464,India
573995,2023-03-02,705,stencil,10,20,10,1,00464,India
573995,2023-03-02,707,marker,20,40,20,1,00464,India
836351,2023-03-02,717,spiral bound book,50,100,50,1,00465,India
836351,2023-03-02,710,geometry box,100,150,50,1,00465,India
836351,2023-03-02,706,sharpener,3,8,5,1,00465,India
836351,2023-03-02,702,pencil,2,5,3,1,00465,India
836351,2023-03-02,712,graph paper,20,40,20,1,00465,India
319361,2023-03-02,706,sharpener,3,8,5,1,00466,India
591540,2023-03-02,708,sketchpen,15,40,25,1,00467,India
606589,2023-03-02,717,spiral bound book,50,100,50,1,00468,India
606589,2023-03-02,706,sharpener,3,8,5,1,00468,India
606589,2023-03-02,701,gel pen,5,10,5,1,00468,India
606589,2023-03-02,708,sketchpen,15,40,25,1,00468,India
606589,2023-03-02,711,TD kit,150,300,150,1,00468,India
940582,2023-03-02,703,eraser,1,3,2,1,00469,India
940582,2023-03-02,701,gel pen,5,10,5,1,00469,India
940582,2023-03-02,705,stencil,10,20,10,1,00469,India
940582,2023-03-02,707,marker,20,40,20,1,00469,India
181905,2023-03-02,713,ball pen,5,10,5,1,00470,India
181905,2023-03-02,703,eraser,1,3,2,1,00470,India
181905,2023-03-02,714,carbon paper,15,30,15,1,00470,India
181905,2023-03-02,716,printing paper,200,400,200,1,00470,India
176073,2023-03-02,714,carbon paper,15,30,15,1,00471,India
176073,2023-03-02,703,eraser,1,3,2,1,00471,India
176073,2023-03-02,711,TD kit,150,300,150,1,00471,India
302654,2023-03-02,705,stencil,10,20,10,1,00472,India
302654,2023-03-02,714,carbon paper,15,30,15,1,00472,India
397413,2023-03-02,706,sharpener,3,8,5,1,00473,India
601322,2023-03-02,713,ball pen,5,10,5,1,00474,India
601322,2023-03-02,711,TD kit,150,300,150,1,00474,India
601322,2023-03-02,714,carbon paper,15,30,15,1,00474,India
378001,2023-03-02,702,pencil,2,5,3,1,00475,India
378001,2023-03-02,708,sketchpen,15,40,25,1,00475,India
496231,2023-03-02,712,graph paper,20,40,20,1,00476,India
496231,2023-03-02,705,stencil,10,20,10,1,00476,India
731456,2023-03-03,707,marker,20,40,20,1,00477,India
731456,2023-03-03,714,carbon paper,15,30,15,1,00477,India
731456,2023-03-03,711,TD kit,150,300,150,1,00477,India
731456,2023-03-03,710,geometry box,100,150,50,1,00477,India
731456,2023-03-03,704,scale,5,10,5,1,00477,India
777973,2023-03-03,702,pencil,2,5,3,1,00478,India
777973,2023-03-03,709,notebook,30,60,30,1,00478,India
777973,2023-03-03,713,ball pen,5,10,5,1,00478,India
777973,2023-03-03,715,folder,5,15,10,1,00478,India
777973,2023-03-03,703,eraser,1,3,2,1,00478,India
907644,2023-03-03,714,carbon paper,15,30,15,1,00479,India
907644,2023-03-03,717,spiral bound book,50,100,50,1,00479,India
952551,2023-03-03,702,pencil,2,5,3,1,00480,India
952551,2023-03-03,703,eraser,1,3,2,1,00480,India
822020,2023-03-03,704,scale,5,10,5,1,00481,India
534607,2023-03-03,717,spiral bound book,50,100,50,1,00482,India
661687,2023-03-03,705,stencil,10,20,10,1,00483,India
420694,2023-03-03,704,scale,5,10,5,1,00484,India
420694,2023-03-03,703,eraser,1,3,2,1,00484,India
420694,2023-03-03,701,gel pen,5,10,5,1,00484,India
163272,2023-03-03,702,pencil,2,5,3,1,00485,India
731004,2023-03-03,710,geometry box,100,150,50,1,00486,India
731004,2023-03-03,701,gel pen,5,10,5,1,00486,India
469382,2023-03-03,712,graph paper,20,40,20,1,00487,India
469382,2023-03-03,717,spiral bound book,50,100,50,1,00487,India
469382,2023-03-03,709,notebook,30,60,30,1,00487,India
469382,2023-03-03,716,printing paper,200,400,200,1,00487,India
996782,2023-03-03,714,carbon paper,15,30,15,1,00488,India
996782,2023-03-03,701,gel pen,5,10,5,1,00488,India
996782,2023-03-03,707,marker,20,40,20,1,00488,India
983910,2023-03-03,712,graph paper,20,40,20,1,00489,India
983910,2023-03-03,711,TD kit,150,300,150,1,00489,India
420117,2023-03-03,703,eraser,1,3,2,1,00490,India
875394,2023-03-03,707,marker,20,40,20,1,00491,India
875394,2023-03-03,705,stencil,10,20,10,1,00491,India
875394,2023-03-03,706,sharpener,3,8,5,1,00491,India
875394,2023-03-03,715,folder,5,15,10,1,00491,India
828199,2023-03-03,701,gel pen,5,10,5,1,00492,India
319876,2023-03-03,717,spiral bound book,50,100,50,1,00493,India
322722,2023-03-03,703,eraser,1,3,2,1,00494,India
322722,2023-03-03,716,printing paper,200,400,200,1,00494,India
322722,2023-03-03,715,folder,5,15,10,1,00494,India
416969,2023-03-03,708,sketchpen,15,40,25,1,00495,India
416969,2023-03-03,712,graph paper,20,40,20,1,00495,India
416969,2023-03-03,704,scale,5,10,5,1,00495,India
416969,2023-03-03,702,pencil,2,5,3,1,00495,India
225084,2023-03-03,709,notebook,30,60,30,1,00496,India
537999,2023-03-03,703,eraser,1,3,2,1,00497,India
256546,2023-03-03,707,marker,20,40,20,1,00498,India
256546,2023-03-03,708,sketchpen,15,40,25,1,00498,India
256546,2023-03-03,710,geometry box,100,150,50,1,00498,India
256546,2023-03-03,701,gel pen,5,10,5,1,00498,India
256546,2023-03-03,712,graph paper,20,40,20,1,00498,India
435893,2023-03-03,706,sharpener,3,8,5,1,00499,India
108609,2023-03-03,714,carbon paper,15,30,15,1,00500,India
108609,2023-03-03,711,TD kit,150,300,150,1,00500,India
108609,2023-03-03,701,gel pen,5,10,5,1,00500,India
108609,2023-03-03,713,ball pen,5,10,5,1,00500,India
322258,2023-03-03,704,scale,5,10,5,1,00193,India
322258,2023-03-03,712,graph paper,20,40,20,1,00193,India
322258,2023-03-03,708,sketchpen,15,40,25,1,00193,India
618046,2023-03-03,710,geometry box,100,150,50,1,00206,India
618046,2023-03-03,703,eraser,1,3,2,1,00206,India
618046,2023-03-03,715,folder,5,15,10,1,00206,India
618046,2023-03-03,704,scale,5,10,5,1,00206,India
660612,2023-03-03,703,eraser,1,3,2,1,00336,India
660612,2023-03-03,709,notebook,30,60,30,1,00336,India
660612,2023-03-03,705,stencil,10,20,10,1,00336,India
660612,2023-03-03,704,scale,5,10,5,1,00336,India
557651,2023-03-03,717,spiral bound book,50,100,50,1,00183,India
557651,2023-03-03,707,marker,20,40,20,1,00183,India
557651,2023-03-03,712,graph paper,20,40,20,1,00183,India
557651,2023-03-03,714,carbon paper,15,30,15,1,00183,India
815115,2023-03-03,707,marker,20,40,20,1,00431,India
815115,2023-03-03,716,printing paper,200,400,200,1,00431,India
815115,2023-03-03,712,graph paper,20,40,20,1,00431,India
494438,2023-03-03,701,gel pen,5,10,5,1,00218,India
494438,2023-03-03,706,sharpener,3,8,5,1,00218,India
494438,2023-03-03,714,carbon paper,15,30,15,1,00218,India
494438,2023-03-03,715,folder,5,15,10,1,00218,India
265596,2023-03-03,706,sharpener,3,8,5,1,00111,India
761458,2023-03-03,704,scale,5,10,5,1,00441,India
451686,2023-03-03,710,geometry box,100,150,50,1,00380,India
451686,2023-03-03,713,ball pen,5,10,5,1,00380,India
451686,2023-03-03,705,stencil,10,20,10,1,00380,India
990453,2023-03-03,701,gel pen,5,10,5,1,00177,India
990453,2023-03-03,704,scale,5,10,5,1,00177,India
893926,2023-03-03,715,folder,5,15,10,1,00120,India
893926,2023-03-03,713,ball pen,5,10,5,1,00120,India
893926,2023-03-03,717,spiral bound book,50,100,50,1,00120,India
893926,2023-03-03,705,stencil,10,20,10,1,00120,India
445417,2023-03-03,715,folder,5,15,10,1,00143,India
445417,2023-03-03,709,notebook,30,60,30,1,00143,India
445417,2023-03-03,702,pencil,2,5,3,1,00143,India
445417,2023-03-03,705,stencil,10,20,10,1,00143,India
637848,2023-03-03,706,sharpener,3,8,5,1,00242,India
637848,2023-03-03,713,ball pen,5,10,5,1,00242,India
637848,2023-03-03,709,notebook,30,60,30,1,00242,India
637848,2023-03-03,717,spiral bound book,50,100,50,1,00242,India
691303,2023-03-03,706,sharpener,3,8,5,1,00109,India
691303,2023-03-03,709,notebook,30,60,30,1,00109,India
528219,2023-03-03,714,carbon paper,15,30,15,1,00269,India
528219,2023-03-03,706,sharpener,3,8,5,1,00269,India
528219,2023-03-03,705,stencil,10,20,10,1,00269,India
528219,2023-03-03,708,sketchpen,15,40,25,1,00269,India
747403,2023-03-03,716,printing paper,200,400,200,1,00333,India
747403,2023-03-03,703,eraser,1,3,2,1,00333,India
747403,2023-03-03,711,TD kit,150,300,150,1,00333,India
747403,2023-03-03,708,sketchpen,15,40,25,1,00333,India
961510,2023-03-03,708,sketchpen,15,40,25,1,00002,India
961510,2023-03-03,703,eraser,1,3,2,1,00002,India
961510,2023-03-03,714,carbon paper,15,30,15,1,00002,India
424746,2023-03-03,704,scale,5,10,5,1,00241,India
424746,2023-03-03,717,spiral bound book,50,100,50,1,00241,India
858731,2023-03-03,716,printing paper,200,400,200,1,00097,India
858731,2023-03-03,712,graph paper,20,40,20,1,00097,India
493093,2023-03-03,716,printing paper,200,400,200,1,00196,India
668669,2023-03-03,717,spiral bound book,50,100,50,1,00350,India
668669,2023-03-03,713,ball pen,5,10,5,1,00350,India
624338,2023-03-03,702,pencil,2,5,3,1,00413,India
624338,2023-03-03,704,scale,5,10,5,1,00413,India
624338,2023-03-03,717,spiral bound book,50,100,50,1,00413,India
543521,2023-03-03,711,TD kit,150,300,150,1,00441,India
543521,2023-03-03,702,pencil,2,5,3,1,00441,India
543521,2023-03-03,709,notebook,30,60,30,1,00441,India
543521,2023-03-03,715,folder,5,15,10,1,00441,India
302420,2023-03-03,706,sharpener,3,8,5,1,00049,India
302420,2023-03-03,709,notebook,30,60,30,1,00049,India
302420,2023-03-03,713,ball pen,5,10,5,1,00049,India
302420,2023-03-03,708,sketchpen,15,40,25,1,00049,India
302420,2023-03-03,704,scale,5,10,5,1,00049,India
410886,2023-03-03,709,notebook,30,60,30,1,00438,India
410886,2023-03-03,714,carbon paper,15,30,15,1,00438,India
410886,2023-03-03,701,gel pen,5,10,5,1,00438,India
592399,2023-03-03,709,notebook,30,60,30,1,00410,India
592399,2023-03-03,715,folder,5,15,10,1,00410,India
592399,2023-03-03,711,TD kit,150,300,150,1,00410,India
184044,2023-03-04,715,folder,5,15,10,1,00265,India
957819,2023-03-04,703,eraser,1,3,2,1,00458,India
957819,2023-03-04,709,notebook,30,60,30,1,00458,India
957819,2023-03-04,714,carbon paper,15,30,15,1,00458,India
957819,2023-03-04,717,spiral bound book,50,100,50,1,00458,India
957819,2023-03-04,712,graph paper,20,40,20,1,00458,India
584608,2023-03-04,715,folder,5,15,10,1,00146,India
991347,2023-03-04,705,stencil,10,20,10,1,00411,India
991347,2023-03-04,709,notebook,30,60,30,1,00411,India
291125,2023-03-04,708,sketchpen,15,40,25,1,00437,India
291125,2023-03-04,705,stencil,10,20,10,1,00437,India
291125,2023-03-04,707,marker,20,40,20,1,00437,India
291125,2023-03-04,713,ball pen,5,10,5,1,00437,India
379287,2023-03-04,705,stencil,10,20,10,1,00396,India
379287,2023-03-04,716,printing paper,200,400,200,1,00396,India
270706,2023-03-04,703,eraser,1,3,2,1,00189,India
270706,2023-03-04,701,gel pen,5,10,5,1,00189,India
270706,2023-03-04,716,printing paper,200,400,200,1,00189,India
270706,2023-03-04,712,graph paper,20,40,20,1,00189,India
555262,2023-03-04,715,folder,5,15,10,1,00445,India
723959,2023-03-04,706,sharpener,3,8,5,1,00024,India
110656,2023-03-04,703,eraser,1,3,2,1,00440,India
110656,2023-03-04,710,geometry box,100,150,50,1,00440,India
110656,2023-03-04,711,TD kit,150,300,150,1,00440,India
110656,2023-03-04,707,marker,20,40,20,1,00440,India
764897,2023-03-04,717,spiral bound book,50,100,50,1,00370,India
764897,2023-03-04,714,carbon paper,15,30,15,1,00370,India
764897,2023-03-04,710,geometry box,100,150,50,1,00370,India
764897,2023-03-04,706,sharpener,3,8,5,1,00370,India
428529,2023-03-04,705,stencil,10,20,10,1,00259,India
428529,2023-03-04,710,geometry box,100,150,50,1,00259,India
416862,2023-03-04,709,notebook,30,60,30,1,00298,India
416862,2023-03-04,716,printing paper,200,400,200,1,00298,India
416862,2023-03-04,711,TD kit,150,300,150,1,00298,India
284872,2023-03-04,711,TD kit,150,300,150,1,00323,India
284872,2023-03-04,705,stencil,10,20,10,1,00323,India
284872,2023-03-04,715,folder,5,15,10,1,00323,India
284872,2023-03-04,709,notebook,30,60,30,1,00323,India
636397,2023-03-04,704,scale,5,10,5,1,00090,India
636397,2023-03-04,712,graph paper,20,40,20,1,00090,India
636397,2023-03-04,708,sketchpen,15,40,25,1,00090,India
529450,2023-03-04,716,printing paper,200,400,200,1,00444,India
529450,2023-03-04,704,scale,5,10,5,1,00444,India
495794,2023-03-04,713,ball pen,5,10,5,1,00363,India
546338,2023-03-04,713,ball pen,5,10,5,1,00052,India
546338,2023-03-04,702,pencil,2,5,3,1,00052,India
546338,2023-03-04,708,sketchpen,15,40,25,1,00052,India
790069,2023-03-04,701,gel pen,5,10,5,1,00120,India
790069,2023-03-04,707,marker,20,40,20,1,00120,India
790069,2023-03-04,715,folder,5,15,10,1,00120,India
197571,2023-03-04,707,marker,20,40,20,1,00336,India
197571,2023-03-04,708,sketchpen,15,40,25,1,00336,India
197571,2023-03-04,701,gel pen,5,10,5,1,00336,India
197571,2023-03-04,715,folder,5,15,10,1,00336,India
844862,2023-03-04,708,sketchpen,15,40,25,1,00147,India
716935,2023-03-04,717,spiral bound book,50,100,50,1,00304,India
716935,2023-03-04,712,graph paper,20,40,20,1,00304,India
716935,2023-03-04,701,gel pen,5,10,5,1,00304,India
142896,2023-03-04,707,marker,20,40,20,1,00005,India
142896,2023-03-04,702,pencil,2,5,3,1,00005,India
330943,2023-03-04,709,notebook,30,60,30,1,00036,India
660652,2023-03-04,705,stencil,10,20,10,1,00268,India
660652,2023-03-04,714,carbon paper,15,30,15,1,00268,India
325512,2023-03-04,706,sharpener,3,8,5,1,00037,India
325512,2023-03-04,707,marker,20,40,20,1,00037,India
325512,2023-03-04,709,notebook,30,60,30,1,00037,India
821440,2023-03-04,714,carbon paper,15,30,15,1,00019,India
821440,2023-03-04,702,pencil,2,5,3,1,00019,India
821440,2023-03-04,708,sketchpen,15,40,25,1,00019,India
821440,2023-03-04,717,spiral bound book,50,100,50,1,00019,India
373679,2023-03-04,705,stencil,10,20,10,1,00019,India
255747,2023-03-04,709,notebook,30,60,30,1,00327,India
255747,2023-03-04,705,stencil,10,20,10,1,00327,India
255747,2023-03-04,701,gel pen,5,10,5,1,00327,India
491898,2023-03-04,710,geometry box,100,150,50,1,00300,India
870301,2023-03-04,703,eraser,1,3,2,1,00400,India
870301,2023-03-04,709,notebook,30,60,30,1,00400,India
870301,2023-03-04,701,gel pen,5,10,5,1,00400,India
870301,2023-03-04,715,folder,5,15,10,1,00400,India
974951,2023-03-05,708,sketchpen,15,40,25,1,00387,India
974951,2023-03-05,701,gel pen,5,10,5,1,00387,India
974951,2023-03-05,706,sharpener,3,8,5,1,00387,India
736054,2023-03-05,717,spiral bound book,50,100,50,1,00257,India
736054,2023-03-05,716,printing paper,200,400,200,1,00257,India
736054,2023-03-05,707,marker,20,40,20,1,00257,India
833222,2023-03-05,705,stencil,10,20,10,1,00223,India
833222,2023-03-05,716,printing paper,200,400,200,1,00223,India
833222,2023-03-05,717,spiral bound book,50,100,50,1,00223,India
427275,2023-03-05,705,stencil,10,20,10,1,00376,India
427275,2023-03-05,717,spiral bound book,50,100,50,1,00376,India
427275,2023-03-05,708,sketchpen,15,40,25,1,00376,India
183751,2023-03-05,711,TD kit,150,300,150,1,00182,India
552215,2023-03-05,705,stencil,10,20,10,1,00453,India
341987,2023-03-05,705,stencil,10,20,10,1,00030,India
341987,2023-03-05,716,printing paper,200,400,200,1,00030,India
538050,2023-03-05,712,graph paper,20,40,20,1,00183,India
538050,2023-03-05,708,sketchpen,15,40,25,1,00183,India
287499,2023-03-05,715,folder,5,15,10,1,00147,India
579258,2023-03-05,708,sketchpen,15,40,25,1,00167,India
199957,2023-03-05,704,scale,5,10,5,1,00110,India
997698,2023-03-05,711,TD kit,150,300,150,1,00276,India
997698,2023-03-05,716,printing paper,200,400,200,1,00276,India
997698,2023-03-05,701,gel pen,5,10,5,1,00276,India
997698,2023-03-05,703,eraser,1,3,2,1,00276,India
997698,2023-03-05,704,scale,5,10,5,1,00276,India
825474,2023-03-05,706,sharpener,3,8,5,1,00094,India
825474,2023-03-05,711,TD kit,150,300,150,1,00094,India
825474,2023-03-05,707,marker,20,40,20,1,00094,India
119581,2023-03-05,709,notebook,30,60,30,1,00137,India
119581,2023-03-05,706,sharpener,3,8,5,1,00137,India
119581,2023-03-05,713,ball pen,5,10,5,1,00137,India
537739,2023-03-05,708,sketchpen,15,40,25,1,00374,India
537739,2023-03-05,717,spiral bound book,50,100,50,1,00374,India
635377,2023-03-05,703,eraser,1,3,2,1,00042,India
635377,2023-03-05,712,graph paper,20,40,20,1,00042,India
635377,2023-03-05,702,pencil,2,5,3,1,00042,India
576129,2023-03-05,704,scale,5,10,5,1,00139,India
576129,2023-03-05,715,folder,5,15,10,1,00139,India
576129,2023-03-05,714,carbon paper,15,30,15,1,00139,India
576129,2023-03-05,706,sharpener,3,8,5,1,00139,India
576129,2023-03-05,707,marker,20,40,20,1,00139,India
242636,2023-03-05,706,sharpener,3,8,5,1,00068,India
242636,2023-03-05,714,carbon paper,15,30,15,1,00068,India
242636,2023-03-05,712,graph paper,20,40,20,1,00068,India
110051,2023-03-05,701,gel pen,5,10,5,1,00297,India
110051,2023-03-05,712,graph paper,20,40,20,1,00297,India
110051,2023-03-05,716,printing paper,200,400,200,1,00297,India
226049,2023-03-05,706,sharpener,3,8,5,1,00232,India
226049,2023-03-05,704,scale,5,10,5,1,00232,India
349258,2023-03-05,704,scale,5,10,5,1,00314,India
349258,2023-03-05,712,graph paper,20,40,20,1,00314,India
361030,2023-03-05,705,stencil,10,20,10,1,00050,India
361030,2023-03-05,716,printing paper,200,400,200,1,00050,India
414713,2023-03-05,711,TD kit,150,300,150,1,00197,India
266605,2023-03-05,708,sketchpen,15,40,25,1,00201,India
266605,2023-03-05,712,graph paper,20,40,20,1,00201,India
266605,2023-03-05,701,gel pen,5,10,5,1,00201,India
266605,2023-03-05,707,marker,20,40,20,1,00201,India
588488,2023-03-05,701,gel pen,5,10,5,1,00351,India
588488,2023-03-05,705,stencil,10,20,10,1,00351,India
588488,2023-03-05,707,marker,20,40,20,1,00351,India
360228,2023-03-05,701,gel pen,5,10,5,1,00468,India
360228,2023-03-05,711,TD kit,150,300,150,1,00468,India
360228,2023-03-05,709,notebook,30,60,30,1,00468,India
822482,2023-03-05,717,spiral bound book,50,100,50,1,00336,India
822482,2023-03-05,715,folder,5,15,10,1,00336,India
822482,2023-03-05,703,eraser,1,3,2,1,00336,India
822482,2023-03-05,705,stencil,10,20,10,1,00336,India
822482,2023-03-05,707,marker,20,40,20,1,00336,India
238097,2023-03-05,712,graph paper,20,40,20,1,00292,India
238097,2023-03-05,710,geometry box,100,150,50,1,00292,India
897170,2023-03-05,708,sketchpen,15,40,25,1,00206,India
922302,2023-03-05,714,carbon paper,15,30,15,1,00217,India
922302,2023-03-05,709,notebook,30,60,30,1,00217,India
866843,2023-03-05,713,ball pen,5,10,5,1,00378,India
866843,2023-03-05,705,stencil,10,20,10,1,00378,India
866843,2023-03-05,704,scale,5,10,5,1,00378,India
866843,2023-03-05,711,TD kit,150,300,150,1,00378,India
866843,2023-03-05,714,carbon paper,15,30,15,1,00378,India
134848,2023-03-05,710,geometry box,100,150,50,1,00017,India
134848,2023-03-05,703,eraser,1,3,2,1,00017,India
316532,2023-03-05,712,graph paper,20,40,20,1,00220,India
316532,2023-03-05,705,stencil,10,20,10,1,00220,India
316532,2023-03-05,707,marker,20,40,20,1,00220,India
338758,2023-03-05,712,graph paper,20,40,20,1,00472,India
673275,2023-03-05,701,gel pen,5,10,5,1,00439,India
673275,2023-03-05,710,geometry box,100,150,50,1,00439,India
673275,2023-03-05,708,sketchpen,15,40,25,1,00439,India
972281,2023-03-05,703,eraser,1,3,2,1,00354,India
681442,2023-03-05,717,spiral bound book,50,100,50,1,00030,India
681442,2023-03-05,716,printing paper,200,400,200,1,00030,India
910966,2023-03-05,716,printing paper,200,400,200,1,00248,India
910966,2023-03-05,715,folder,5,15,10,1,00248,India
910966,2023-03-05,711,TD kit,150,300,150,1,00248,India
910966,2023-03-05,712,graph paper,20,40,20,1,00248,India
824196,2023-03-05,709,notebook,30,60,30,1,00147,India
824196,2023-03-05,701,gel pen,5,10,5,1,00147,India
824196,2023-03-05,714,carbon paper,15,30,15,1,00147,India
824196,2023-03-05,713,ball pen,5,10,5,1,00147,India
289197,2023-03-05,711,TD kit,150,300,150,1,00093,India
289197,2023-03-05,707,marker,20,40,20,1,00093,India
707645,2023-03-05,705,stencil,10,20,10,1,00165,India
707645,2023-03-05,704,scale,5,10,5,1,00165,India
603327,2023-03-05,701,gel pen,5,10,5,1,00166,India
603327,2023-03-05,706,sharpener,3,8,5,1,00166,India
603327,2023-03-05,716,printing paper,200,400,200,1,00166,India
459225,2023-03-05,707,marker,20,40,20,1,00076,India
459225,2023-03-05,702,pencil,2,5,3,1,00076,India
459225,2023-03-05,717,spiral bound book,50,100,50,1,00076,India
614420,2023-03-05,712,graph paper,20,40,20,1,00180,India
614420,2023-03-05,707,marker,20,40,20,1,00180,India
614420,2023-03-05,708,sketchpen,15,40,25,1,00180,India
614420,2023-03-05,701,gel pen,5,10,5,1,00180,India
871389,2023-03-05,712,graph paper,20,40,20,1,00493,India
814102,2023-03-05,716,printing paper,200,400,200,1,00291,India
814102,2023-03-05,710,geometry box,100,150,50,1,00291,India
814102,2023-03-05,711,TD kit,150,300,150,1,00291,India
269574,2023-03-05,701,gel pen,5,10,5,1,00477,India
269574,2023-03-05,714,carbon paper,15,30,15,1,00477,India
269574,2023-03-05,715,folder,5,15,10,1,00477,India
461451,2023-03-05,703,eraser,1,3,2,1,00412,India
461451,2023-03-05,709,notebook,30,60,30,1,00412,India
510099,2023-03-05,716,printing paper,200,400,200,1,00109,India
510099,2023-03-05,709,notebook,30,60,30,1,00109,India
510099,2023-03-05,703,eraser,1,3,2,1,00109,India
510099,2023-03-05,714,carbon paper,15,30,15,1,00109,India
876331,2023-03-05,714,carbon paper,15,30,15,1,00466,India
876331,2023-03-05,703,eraser,1,3,2,1,00466,India
876331,2023-03-05,712,graph paper,20,40,20,1,00466,India
876331,2023-03-05,706,sharpener,3,8,5,1,00466,India
876331,2023-03-05,710,geometry box,100,150,50,1,00466,India
267400,2023-03-06,708,sketchpen,15,40,25,1,00441,India
267400,2023-03-06,709,notebook,30,60,30,1,00441,India
267400,2023-03-06,702,pencil,2,5,3,1,00441,India
503201,2023-03-06,707,marker,20,40,20,1,00231,India
503201,2023-03-06,709,notebook,30,60,30,1,00231,India
503201,2023-03-06,703,eraser,1,3,2,1,00231,India
522751,2023-03-06,717,spiral bound book,50,100,50,1,00302,India
522751,2023-03-06,702,pencil,2,5,3,1,00302,India
522751,2023-03-06,710,geometry box,100,150,50,1,00302,India
568548,2023-03-06,717,spiral bound book,50,100,50,1,00365,India
568548,2023-03-06,710,geometry box,100,150,50,1,00365,India
568548,2023-03-06,716,printing paper,200,400,200,1,00365,India
568548,2023-03-06,714,carbon paper,15,30,15,1,00365,India
678437,2023-03-06,714,carbon paper,15,30,15,1,00016,India
678437,2023-03-06,704,scale,5,10,5,1,00016,India
678437,2023-03-06,705,stencil,10,20,10,1,00016,India
678437,2023-03-06,710,geometry box,100,150,50,1,00016,India
146097,2023-03-06,711,TD kit,150,300,150,1,00028,India
146097,2023-03-06,715,folder,5,15,10,1,00028,India
146097,2023-03-06,712,graph paper,20,40,20,1,00028,India
146097,2023-03-06,706,sharpener,3,8,5,1,00028,India
816512,2023-03-06,714,carbon paper,15,30,15,1,00342,India
735836,2023-03-06,717,spiral bound book,50,100,50,1,00451,India
735836,2023-03-06,715,folder,5,15,10,1,00451,India
735836,2023-03-06,708,sketchpen,15,40,25,1,00451,India
735836,2023-03-06,706,sharpener,3,8,5,1,00451,India
272990,2023-03-06,701,gel pen,5,10,5,1,00065,India
272990,2023-03-06,707,marker,20,40,20,1,00065,India
272990,2023-03-06,708,sketchpen,15,40,25,1,00065,India
272990,2023-03-06,709,notebook,30,60,30,1,00065,India
395428,2023-03-06,711,TD kit,150,300,150,1,00200,India
395428,2023-03-06,701,gel pen,5,10,5,1,00200,India
833757,2023-03-06,712,graph paper,20,40,20,1,00243,India
501000,2023-03-06,706,sharpener,3,8,5,1,00211,India
501000,2023-03-06,704,scale,5,10,5,1,00211,India
501000,2023-03-06,701,gel pen,5,10,5,1,00211,India
535590,2023-03-06,709,notebook,30,60,30,1,00040,India
535590,2023-03-06,702,pencil,2,5,3,1,00040,India
535590,2023-03-06,704,scale,5,10,5,1,00040,India
535590,2023-03-06,710,geometry box,100,150,50,1,00040,India
996765,2023-03-06,717,spiral bound book,50,100,50,1,00177,India
595019,2023-03-06,712,graph paper,20,40,20,1,00087,India
595019,2023-03-06,711,TD kit,150,300,150,1,00087,India
595019,2023-03-06,717,spiral bound book,50,100,50,1,00087,India
862215,2023-03-06,707,marker,20,40,20,1,00355,India
862215,2023-03-06,716,printing paper,200,400,200,1,00355,India
862215,2023-03-06,703,eraser,1,3,2,1,00355,India
862215,2023-03-06,712,graph paper,20,40,20,1,00355,India
987210,2023-03-06,714,carbon paper,15,30,15,1,00243,India
987210,2023-03-06,701,gel pen,5,10,5,1,00243,India
987210,2023-03-06,705,stencil,10,20,10,1,00243,India
209465,2023-03-06,714,carbon paper,15,30,15,1,00033,India
209465,2023-03-06,712,graph paper,20,40,20,1,00033,India
209465,2023-03-06,710,geometry box,100,150,50,1,00033,India
209465,2023-03-06,711,TD kit,150,300,150,1,00033,India
209465,2023-03-06,715,folder,5,15,10,1,00033,India
192331,2023-03-06,710,geometry box,100,150,50,1,00311,India
192331,2023-03-06,705,stencil,10,20,10,1,00311,India
708452,2023-03-06,716,printing paper,200,400,200,1,00498,India
708452,2023-03-06,706,sharpener,3,8,5,1,00498,India
664679,2023-03-06,713,ball pen,5,10,5,1,00491,India
626182,2023-03-06,702,pencil,2,5,3,1,00262,India
626182,2023-03-06,701,gel pen,5,10,5,1,00262,India
160331,2023-03-06,715,folder,5,15,10,1,00416,India
552613,2023-03-06,701,gel pen,5,10,5,1,00197,India
552613,2023-03-06,702,pencil,2,5,3,1,00197,India
361037,2023-03-06,717,spiral bound book,50,100,50,1,00072,India
361037,2023-03-06,708,sketchpen,15,40,25,1,00072,India
361037,2023-03-06,709,notebook,30,60,30,1,00072,India
361037,2023-03-06,714,carbon paper,15,30,15,1,00072,India
361037,2023-03-06,703,eraser,1,3,2,1,00072,India
670815,2023-03-06,707,marker,20,40,20,1,00167,India
670815,2023-03-06,708,sketchpen,15,40,25,1,00167,India
670815,2023-03-06,711,TD kit,150,300,150,1,00167,India
714021,2023-03-06,712,graph paper,20,40,20,1,00296,India
714021,2023-03-06,707,marker,20,40,20,1,00296,India
714021,2023-03-06,703,eraser,1,3,2,1,00296,India
714021,2023-03-06,710,geometry box,100,150,50,1,00296,India
793747,2023-03-06,715,folder,5,15,10,1,00237,India
793747,2023-03-06,702,pencil,2,5,3,1,00237,India
793747,2023-03-06,710,geometry box,100,150,50,1,00237,India
793747,2023-03-06,703,eraser,1,3,2,1,00237,India
778261,2023-03-06,709,notebook,30,60,30,1,00091,India
778261,2023-03-06,703,eraser,1,3,2,1,00091,India
778261,2023-03-06,716,printing paper,200,400,200,1,00091,India
778261,2023-03-06,715,folder,5,15,10,1,00091,India
323975,2023-03-06,706,sharpener,3,8,5,1,00053,India
323975,2023-03-06,714,carbon paper,15,30,15,1,00053,India
795039,2023-03-06,701,gel pen,5,10,5,1,00264,India
795039,2023-03-06,706,sharpener,3,8,5,1,00264,India
795039,2023-03-06,714,carbon paper,15,30,15,1,00264,India
795039,2023-03-06,715,folder,5,15,10,1,00264,India
308583,2023-03-06,717,spiral bound book,50,100,50,1,00052,India
308583,2023-03-06,707,marker,20,40,20,1,00052,India
308583,2023-03-06,711,TD kit,150,300,150,1,00052,India
308583,2023-03-06,701,gel pen,5,10,5,1,00052,India
308583,2023-03-06,704,scale,5,10,5,1,00052,India
769356,2023-03-06,702,pencil,2,5,3,1,00420,India
769356,2023-03-06,708,sketchpen,15,40,25,1,00420,India
769356,2023-03-06,706,sharpener,3,8,5,1,00420,India
828010,2023-03-06,706,sharpener,3,8,5,1,00334,India
828010,2023-03-06,712,graph paper,20,40,20,1,00334,India
828010,2023-03-06,715,folder,5,15,10,1,00334,India
383947,2023-03-06,709,notebook,30,60,30,1,00392,India
383947,2023-03-06,704,scale,5,10,5,1,00392,India
383947,2023-03-06,712,graph paper,20,40,20,1,00392,India
907019,2023-03-06,716,printing paper,200,400,200,1,00074,India
907019,2023-03-06,709,notebook,30,60,30,1,00074,India
907019,2023-03-06,708,sketchpen,15,40,25,1,00074,India
885570,2023-03-06,716,printing paper,200,400,200,1,00413,India
502251,2023-03-06,711,TD kit,150,300,150,1,00252,India
502251,2023-03-06,712,graph paper,20,40,20,1,00252,India
502251,2023-03-06,702,pencil,2,5,3,1,00252,India
502251,2023-03-06,715,folder,5,15,10,1,00252,India
585414,2023-03-06,710,geometry box,100,150,50,1,00288,India
585414,2023-03-06,713,ball pen,5,10,5,1,00288,India
585414,2023-03-06,709,notebook,30,60,30,1,00288,India
888653,2023-03-06,702,pencil,2,5,3,1,00054,India
888653,2023-03-06,715,folder,5,15,10,1,00054,India
888653,2023-03-06,716,printing paper,200,400,200,1,00054,India
888653,2023-03-06,701,gel pen,5,10,5,1,00054,India
888653,2023-03-06,706,sharpener,3,8,5,1,00054,India
884495,2023-03-06,715,folder,5,15,10,1,00054,India
884495,2023-03-06,713,ball pen,5,10,5,1,00054,India
884495,2023-03-06,716,printing paper,200,400,200,1,00054,India
921266,2023-03-06,713,ball pen,5,10,5,1,00471,India
921266,2023-03-06,710,geometry box,100,150,50,1,00471,India
921266,2023-03-06,707,marker,20,40,20,1,00471,India
921266,2023-03-06,703,eraser,1,3,2,1,00471,India
190361,2023-03-06,708,sketchpen,15,40,25,1,00069,India
190361,2023-03-06,716,printing paper,200,400,200,1,00069,India
190361,2023-03-06,705,stencil,10,20,10,1,00069,India
190361,2023-03-06,706,sharpener,3,8,5,1,00069,India
190361,2023-03-06,717,spiral bound book,50,100,50,1,00069,India
558138,2023-03-06,704,scale,5,10,5,1,00325,India
558138,2023-03-06,702,pencil,2,5,3,1,00325,India
932253,2023-03-06,703,eraser,1,3,2,1,00476,India
932253,2023-03-06,704,scale,5,10,5,1,00476,India
932253,2023-03-06,712,graph paper,20,40,20,1,00476,India
932253,2023-03-06,713,ball pen,5,10,5,1,00476,India
932253,2023-03-06,714,carbon paper,15,30,15,1,00476,India
273444,2023-03-06,704,scale,5,10,5,1,00350,India
193549,2023-03-06,715,folder,5,15,10,1,00370,India
193549,2023-03-06,710,geometry box,100,150,50,1,00370,India
193549,2023-03-06,711,TD kit,150,300,150,1,00370,India
193549,2023-03-06,709,notebook,30,60,30,1,00370,India
213097,2023-03-06,713,ball pen,5,10,5,1,00357,India
213097,2023-03-06,702,pencil,2,5,3,1,00357,India
794080,2023-03-07,703,eraser,1,3,2,1,00080,India
794080,2023-03-07,713,ball pen,5,10,5,1,00080,India
409848,2023-03-07,705,stencil,10,20,10,1,00203,India
409848,2023-03-07,709,notebook,30,60,30,1,00203,India
409848,2023-03-07,706,sharpener,3,8,5,1,00203,India
409848,2023-03-07,707,marker,20,40,20,1,00203,India
605917,2023-03-07,702,pencil,2,5,3,1,00180,India
605917,2023-03-07,707,marker,20,40,20,1,00180,India
605917,2023-03-07,705,stencil,10,20,10,1,00180,India
605917,2023-03-07,701,gel pen,5,10,5,1,00180,India
605917,2023-03-07,712,graph paper,20,40,20,1,00180,India
629450,2023-03-07,708,sketchpen,15,40,25,1,00265,India
629450,2023-03-07,714,carbon paper,15,30,15,1,00265,India
629450,2023-03-07,701,gel pen,5,10,5,1,00265,India
179349,2023-03-07,712,graph paper,20,40,20,1,00312,India
179349,2023-03-07,714,carbon paper,15,30,15,1,00312,India
104024,2023-03-07,716,printing paper,200,400,200,1,00177,India
204940,2023-03-07,709,notebook,30,60,30,1,00142,India
204940,2023-03-07,707,marker,20,40,20,1,00142,India
708579,2023-03-07,708,sketchpen,15,40,25,1,00046,India
708579,2023-03-07,715,folder,5,15,10,1,00046,India
193520,2023-03-07,701,gel pen,5,10,5,1,00077,India
193520,2023-03-07,715,folder,5,15,10,1,00077,India
193520,2023-03-07,707,marker,20,40,20,1,00077,India
193520,2023-03-07,714,carbon paper,15,30,15,1,00077,India
129497,2023-03-07,714,carbon paper,15,30,15,1,00256,India
129497,2023-03-07,713,ball pen,5,10,5,1,00256,India
365548,2023-03-07,712,graph paper,20,40,20,1,00281,India
365548,2023-03-07,717,spiral bound book,50,100,50,1,00281,India
747355,2023-03-07,703,eraser,1,3,2,1,00358,India
747355,2023-03-07,707,marker,20,40,20,1,00358,India
747355,2023-03-07,706,sharpener,3,8,5,1,00358,India
747355,2023-03-07,716,printing paper,200,400,200,1,00358,India
494185,2023-03-07,701,gel pen,5,10,5,1,00237,India
757557,2023-03-07,711,TD kit,150,300,150,1,00002,India
757557,2023-03-07,702,pencil,2,5,3,1,00002,India
751414,2023-03-07,709,notebook,30,60,30,1,00385,India
751414,2023-03-07,704,scale,5,10,5,1,00385,India
751414,2023-03-07,707,marker,20,40,20,1,00385,India
755633,2023-03-07,703,eraser,1,3,2,1,00368,India
755633,2023-03-07,711,TD kit,150,300,150,1,00368,India
755633,2023-03-07,702,pencil,2,5,3,1,00368,India
755633,2023-03-07,705,stencil,10,20,10,1,00368,India
755633,2023-03-07,714,carbon paper,15,30,15,1,00368,India
423186,2023-03-07,710,geometry box,100,150,50,1,00211,India
423186,2023-03-07,703,eraser,1,3,2,1,00211,India
423186,2023-03-07,708,sketchpen,15,40,25,1,00211,India
423186,2023-03-07,711,TD kit,150,300,150,1,00211,India
278189,2023-03-07,713,ball pen,5,10,5,1,00426,India
542658,2023-03-07,703,eraser,1,3,2,1,00245,India
542658,2023-03-07,705,stencil,10,20,10,1,00245,India
693699,2023-03-07,716,printing paper,200,400,200,1,00337,India
693699,2023-03-07,704,scale,5,10,5,1,00337,India
848176,2023-03-07,702,pencil,2,5,3,1,00497,India
207621,2023-03-07,701,gel pen,5,10,5,1,00164,India
207621,2023-03-07,704,scale,5,10,5,1,00164,India
196890,2023-03-07,707,marker,20,40,20,1,00075,India
196890,2023-03-07,708,sketchpen,15,40,25,1,00075,India
196890,2023-03-07,701,gel pen,5,10,5,1,00075,India
196890,2023-03-07,704,scale,5,10,5,1,00075,India
196890,2023-03-07,712,graph paper,20,40,20,1,00075,India
809500,2023-03-07,706,sharpener,3,8,5,1,00002,India
241262,2023-03-07,715,folder,5,15,10,1,00133,India
241262,2023-03-07,711,TD kit,150,300,150,1,00133,India
745206,2023-03-07,703,eraser,1,3,2,1,00458,India
745206,2023-03-07,708,sketchpen,15,40,25,1,00458,India
745206,2023-03-07,704,scale,5,10,5,1,00458,India
745206,2023-03-07,706,sharpener,3,8,5,1,00458,India
966366,2023-03-07,715,folder,5,15,10,1,00266,India
966366,2023-03-07,703,eraser,1,3,2,1,00266,India
966366,2023-03-07,712,graph paper,20,40,20,1,00266,India
817775,2023-03-07,701,gel pen,5,10,5,1,00136,India
817775,2023-03-07,716,printing paper,200,400,200,1,00136,India
766873,2023-03-07,705,stencil,10,20,10,1,00117,India
766873,2023-03-07,716,printing paper,200,400,200,1,00117,India
262052,2023-03-07,712,graph paper,20,40,20,1,00169,India
262052,2023-03-07,714,carbon paper,15,30,15,1,00169,India
262052,2023-03-07,711,TD kit,150,300,150,1,00169,India
262052,2023-03-07,704,scale,5,10,5,1,00169,India
390267,2023-03-07,701,gel pen,5,10,5,1,00118,India
234853,2023-03-07,702,pencil,2,5,3,1,00483,India
234853,2023-03-07,715,folder,5,15,10,1,00483,India
770080,2023-03-07,715,folder,5,15,10,1,00276,India
770080,2023-03-07,712,graph paper,20,40,20,1,00276,India
770080,2023-03-07,708,sketchpen,15,40,25,1,00276,India
390108,2023-03-07,709,notebook,30,60,30,1,00232,India
390108,2023-03-07,715,folder,5,15,10,1,00232,India
390108,2023-03-07,716,printing paper,200,400,200,1,00232,India
933121,2023-03-07,702,pencil,2,5,3,1,00417,India
191798,2023-03-07,715,folder,5,15,10,1,00205,India
904955,2023-03-07,713,ball pen,5,10,5,1,00400,India
904955,2023-03-07,708,sketchpen,15,40,25,1,00400,India
904955,2023-03-07,714,carbon paper,15,30,15,1,00400,India
904955,2023-03-07,706,sharpener,3,8,5,1,00400,India
791031,2023-03-07,711,TD kit,150,300,150,1,00489,India
791031,2023-03-07,710,geometry box,100,150,50,1,00489,India
517684,2023-03-08,702,pencil,2,5,3,1,00012,India
517684,2023-03-08,706,sharpener,3,8,5,1,00012,India
470866,2023-03-08,714,carbon paper,15,30,15,1,00207,India
470866,2023-03-08,716,printing paper,200,400,200,1,00207,India
470866,2023-03-08,710,geometry box,100,150,50,1,00207,India
361412,2023-03-08,709,notebook,30,60,30,1,00018,India
361412,2023-03-08,717,spiral bound book,50,100,50,1,00018,India
361412,2023-03-08,707,marker,20,40,20,1,00018,India
578080,2023-03-08,717,spiral bound book,50,100,50,1,00481,India
578080,2023-03-08,713,ball pen,5,10,5,1,00481,India
578080,2023-03-08,704,scale,5,10,5,1,00481,India
792326,2023-03-08,711,TD kit,150,300,150,1,00096,India
792326,2023-03-08,704,scale,5,10,5,1,00096,India
792326,2023-03-08,702,pencil,2,5,3,1,00096,India
971839,2023-03-08,714,carbon paper,15,30,15,1,00344,India
971839,2023-03-08,709,notebook,30,60,30,1,00344,India
300742,2023-03-08,711,TD kit,150,300,150,1,00489,India
300742,2023-03-08,706,sharpener,3,8,5,1,00489,India
398056,2023-03-08,716,printing paper,200,400,200,1,00209,India
398056,2023-03-08,703,eraser,1,3,2,1,00209,India
398056,2023-03-08,715,folder,5,15,10,1,00209,India
398056,2023-03-08,704,scale,5,10,5,1,00209,India
398056,2023-03-08,717,spiral bound book,50,100,50,1,00209,India
299162,2023-03-08,711,TD kit,150,300,150,1,00349,India
299162,2023-03-08,713,ball pen,5,10,5,1,00349,India
299162,2023-03-08,709,notebook,30,60,30,1,00349,India
299162,2023-03-08,714,carbon paper,15,30,15,1,00349,India
299162,2023-03-08,715,folder,5,15,10,1,00349,India
859927,2023-03-08,715,folder,5,15,10,1,00439,India
859927,2023-03-08,702,pencil,2,5,3,1,00439,India
859927,2023-03-08,707,marker,20,40,20,1,00439,India
859927,2023-03-08,709,notebook,30,60,30,1,00439,India
906835,2023-03-08,702,pencil,2,5,3,1,00458,India
906835,2023-03-08,701,gel pen,5,10,5,1,00458,India
906835,2023-03-08,707,marker,20,40,20,1,00458,India
906835,2023-03-08,704,scale,5,10,5,1,00458,India
788132,2023-03-08,704,scale,5,10,5,1,00249,India
788132,2023-03-08,713,ball pen,5,10,5,1,00249,India
788132,2023-03-08,715,folder,5,15,10,1,00249,India
475602,2023-03-08,701,gel pen,5,10,5,1,00464,India
475602,2023-03-08,703,eraser,1,3,2,1,00464,India
898370,2023-03-08,702,pencil,2,5,3,1,00378,India
839914,2023-03-08,712,graph paper,20,40,20,1,00128,India
839914,2023-03-08,713,ball pen,5,10,5,1,00128,India
443707,2023-03-08,715,folder,5,15,10,1,00127,India
443707,2023-03-08,703,eraser,1,3,2,1,00127,India
443707,2023-03-08,714,carbon paper,15,30,15,1,00127,India
443707,2023-03-08,706,sharpener,3,8,5,1,00127,India
443707,2023-03-08,704,scale,5,10,5,1,00127,India
154942,2023-03-08,710,geometry box,100,150,50,1,00363,India
154942,2023-03-08,717,spiral bound book,50,100,50,1,00363,India
154942,2023-03-08,706,sharpener,3,8,5,1,00363,India
834484,2023-03-08,706,sharpener,3,8,5,1,00313,India
805006,2023-03-08,717,spiral bound book,50,100,50,1,00273,India
805006,2023-03-08,716,printing paper,200,400,200,1,00273,India
805006,2023-03-08,708,sketchpen,15,40,25,1,00273,India
805006,2023-03-08,714,carbon paper,15,30,15,1,00273,India
579006,2023-03-08,714,carbon paper,15,30,15,1,00282,India
579006,2023-03-08,703,eraser,1,3,2,1,00282,India
579006,2023-03-08,710,geometry box,100,150,50,1,00282,India
579006,2023-03-08,704,scale,5,10,5,1,00282,India
579006,2023-03-08,707,marker,20,40,20,1,00282,India
540076,2023-03-08,704,scale,5,10,5,1,00417,India
540076,2023-03-08,712,graph paper,20,40,20,1,00417,India
954146,2023-03-08,712,graph paper,20,40,20,1,00433,India
954146,2023-03-08,707,marker,20,40,20,1,00433,India
954146,2023-03-08,702,pencil,2,5,3,1,00433,India
966485,2023-03-08,705,stencil,10,20,10,1,00252,India
142184,2023-03-08,709,notebook,30,60,30,1,00289,India
142184,2023-03-08,706,sharpener,3,8,5,1,00289,India
270516,2023-03-08,714,carbon paper,15,30,15,1,00377,India
270516,2023-03-08,702,pencil,2,5,3,1,00377,India
270516,2023-03-08,715,folder,5,15,10,1,00377,India
270516,2023-03-08,703,eraser,1,3,2,1,00377,India
851231,2023-03-08,707,marker,20,40,20,1,00462,India
851231,2023-03-08,716,printing paper,200,400,200,1,00462,India
851231,2023-03-08,712,graph paper,20,40,20,1,00462,India
851231,2023-03-08,714,carbon paper,15,30,15,1,00462,India
860510,2023-03-08,708,sketchpen,15,40,25,1,00458,India
112807,2023-03-08,707,marker,20,40,20,1,00288,India
112807,2023-03-08,706,sharpener,3,8,5,1,00288,India
579123,2023-03-08,710,geometry box,100,150,50,1,00149,India
579123,2023-03-08,713,ball pen,5,10,5,1,00149,India
579123,2023-03-08,707,marker,20,40,20,1,00149,India
579123,2023-03-08,715,folder,5,15,10,1,00149,India
579123,2023-03-08,702,pencil,2,5,3,1,00149,India
941204,2023-03-08,701,gel pen,5,10,5,1,00339,India
941204,2023-03-08,706,sharpener,3,8,5,1,00339,India
941204,2023-03-08,703,eraser,1,3,2,1,00339,India
455536,2023-03-08,714,carbon paper,15,30,15,1,00283,India
789618,2023-03-08,703,eraser,1,3,2,1,00003,India
789618,2023-03-08,711,TD kit,150,300,150,1,00003,India
970936,2023-03-08,713,ball pen,5,10,5,1,00328,India
970936,2023-03-08,711,TD kit,150,300,150,1,00328,India
970936,2023-03-08,715,folder,5,15,10,1,00328,India
970936,2023-03-08,706,sharpener,3,8,5,1,00328,India
889382,2023-03-08,711,TD kit,150,300,150,1,00070,India
889382,2023-03-08,715,folder,5,15,10,1,00070,India
205722,2023-03-08,714,carbon paper,15,30,15,1,00337,India
372035,2023-03-09,708,sketchpen,15,40,25,1,00208,India
372035,2023-03-09,701,gel pen,5,10,5,1,00208,India
372035,2023-03-09,704,scale,5,10,5,1,00208,India
249200,2023-03-09,707,marker,20,40,20,1,00081,India
249200,2023-03-09,711,TD kit,150,300,150,1,00081,India
249200,2023-03-09,713,ball pen,5,10,5,1,00081,India
249200,2023-03-09,715,folder,5,15,10,1,00081,India
739873,2023-03-09,716,printing paper,200,400,200,1,00300,India
739873,2023-03-09,713,ball pen,5,10,5,1,00300,India
739873,2023-03-09,701,gel pen,5,10,5,1,00300,India
779538,2023-03-09,705,stencil,10,20,10,1,00446,India
779538,2023-03-09,704,scale,5,10,5,1,00446,India
779538,2023-03-09,711,TD kit,150,300,150,1,00446,India
779538,2023-03-09,701,gel pen,5,10,5,1,00446,India
383562,2023-03-09,711,TD kit,150,300,150,1,00188,India
383562,2023-03-09,717,spiral bound book,50,100,50,1,00188,India
383562,2023-03-09,703,eraser,1,3,2,1,00188,India
383562,2023-03-09,716,printing paper,200,400,200,1,00188,India
991332,2023-03-09,714,carbon paper,15,30,15,1,00336,India
575313,2023-03-09,710,geometry box,100,150,50,1,00440,India
575313,2023-03-09,702,pencil,2,5,3,1,00440,India
575313,2023-03-09,714,carbon paper,15,30,15,1,00440,India
575313,2023-03-09,708,sketchpen,15,40,25,1,00440,India
800865,2023-03-09,707,marker,20,40,20,1,00393,India
800865,2023-03-09,716,printing paper,200,400,200,1,00393,India
725039,2023-03-09,716,printing paper,200,400,200,1,00416,India
470910,2023-03-09,702,pencil,2,5,3,1,00053,India
580162,2023-03-09,702,pencil,2,5,3,1,00320,India
580162,2023-03-09,710,geometry box,100,150,50,1,00320,India
623876,2023-03-09,716,printing paper,200,400,200,1,00006,India
527049,2023-03-09,703,eraser,1,3,2,1,00168,India
814785,2023-03-09,702,pencil,2,5,3,1,00047,India
814785,2023-03-09,708,sketchpen,15,40,25,1,00047,India
814785,2023-03-09,712,graph paper,20,40,20,1,00047,India
814785,2023-03-09,714,carbon paper,15,30,15,1,00047,India
814785,2023-03-09,707,marker,20,40,20,1,00047,India
815966,2023-03-09,707,marker,20,40,20,1,00191,India
815966,2023-03-09,716,printing paper,200,400,200,1,00191,India
815966,2023-03-09,704,scale,5,10,5,1,00191,India
815966,2023-03-09,710,geometry box,100,150,50,1,00191,India
597925,2023-03-09,713,ball pen,5,10,5,1,00172,India
597925,2023-03-09,710,geometry box,100,150,50,1,00172,India
597925,2023-03-09,707,marker,20,40,20,1,00172,India
579236,2023-03-09,710,geometry box,100,150,50,1,00332,India
579236,2023-03-09,714,carbon paper,15,30,15,1,00332,India
579236,2023-03-09,708,sketchpen,15,40,25,1,00332,India
579236,2023-03-09,705,stencil,10,20,10,1,00332,India
141106,2023-03-09,701,gel pen,5,10,5,1,00091,India
141106,2023-03-09,708,sketchpen,15,40,25,1,00091,India
141106,2023-03-09,706,sharpener,3,8,5,1,00091,India
867368,2023-03-09,713,ball pen,5,10,5,1,00486,India
868990,2023-03-09,709,notebook,30,60,30,1,00004,India
868990,2023-03-09,701,gel pen,5,10,5,1,00004,India
868990,2023-03-09,717,spiral bound book,50,100,50,1,00004,India
633084,2023-03-09,705,stencil,10,20,10,1,00123,India
633084,2023-03-09,715,folder,5,15,10,1,00123,India
660718,2023-03-09,705,stencil,10,20,10,1,00073,India
660718,2023-03-09,715,folder,5,15,10,1,00073,India
660718,2023-03-09,704,scale,5,10,5,1,00073,India
151835,2023-03-09,717,spiral bound book,50,100,50,1,00451,India
151835,2023-03-09,715,folder,5,15,10,1,00451,India
151835,2023-03-09,709,notebook,30,60,30,1,00451,India
151835,2023-03-09,702,pencil,2,5,3,1,00451,India
408405,2023-03-09,707,marker,20,40,20,1,00347,India
408405,2023-03-09,702,pencil,2,5,3,1,00347,India
408405,2023-03-09,703,eraser,1,3,2,1,00347,India
232231,2023-03-09,705,stencil,10,20,10,1,00127,India
232231,2023-03-09,709,notebook,30,60,30,1,00127,India
232231,2023-03-09,715,folder,5,15,10,1,00127,India
537908,2023-03-09,713,ball pen,5,10,5,1,00426,India
537908,2023-03-09,710,geometry box,100,150,50,1,00426,India
537908,2023-03-09,708,sketchpen,15,40,25,1,00426,India
537908,2023-03-09,717,spiral bound book,50,100,50,1,00426,India
780265,2023-03-09,712,graph paper,20,40,20,1,00088,India
232061,2023-03-09,709,notebook,30,60,30,1,00275,India
232061,2023-03-09,712,graph paper,20,40,20,1,00275,India
685396,2023-03-09,708,sketchpen,15,40,25,1,00191,India
685396,2023-03-09,712,graph paper,20,40,20,1,00191,India
685396,2023-03-09,714,carbon paper,15,30,15,1,00191,India
604989,2023-03-09,707,marker,20,40,20,1,00224,India
604989,2023-03-09,702,pencil,2,5,3,1,00224,India
196635,2023-03-10,714,carbon paper,15,30,15,1,00490,India
196635,2023-03-10,715,folder,5,15,10,1,00490,India
196635,2023-03-10,710,geometry box,100,150,50,1,00490,India
383581,2023-03-10,712,graph paper,20,40,20,1,00272,India
630475,2023-03-10,701,gel pen,5,10,5,1,00085,India
630475,2023-03-10,716,printing paper,200,400,200,1,00085,India
630475,2023-03-10,706,sharpener,3,8,5,1,00085,India
630475,2023-03-10,711,TD kit,150,300,150,1,00085,India
586860,2023-03-10,702,pencil,2,5,3,1,00014,India
586860,2023-03-10,701,gel pen,5,10,5,1,00014,India
586860,2023-03-10,710,geometry box,100,150,50,1,00014,India
586860,2023-03-10,716,printing paper,200,400,200,1,00014,India
586860,2023-03-10,714,carbon paper,15,30,15,1,00014,India
452926,2023-03-10,713,ball pen,5,10,5,1,00379,India
452926,2023-03-10,709,notebook,30,60,30,1,00379,India
452926,2023-03-10,716,printing paper,200,400,200,1,00379,India
887649,2023-03-10,715,folder,5,15,10,1,00177,India
887649,2023-03-10,707,marker,20,40,20,1,00177,India
887649,2023-03-10,701,gel pen,5,10,5,1,00177,India
689162,2023-03-10,702,pencil,2,5,3,1,00080,India
689162,2023-03-10,713,ball pen,5,10,5,1,00080,India
689162,2023-03-10,710,geometry box,100,150,50,1,00080,India
689162,2023-03-10,715,folder,5,15,10,1,00080,India
394221,2023-03-10,701,gel pen,5,10,5,1,00434,India
394221,2023-03-10,702,pencil,2,5,3,1,00434,India
984582,2023-03-10,713,ball pen,5,10,5,1,00202,India
516850,2023-03-10,702,pencil,2,5,3,1,00443,India
516850,2023-03-10,708,sketchpen,15,40,25,1,00443,India
516850,2023-03-10,709,notebook,30,60,30,1,00443,India
516850,2023-03-10,715,folder,5,15,10,1,00443,India
823003,2023-03-10,709,notebook,30,60,30,1,00479,India
823003,2023-03-10,703,eraser,1,3,2,1,00479,India
823003,2023-03-10,701,gel pen,5,10,5,1,00479,India
823003,2023-03-10,714,carbon paper,15,30,15,1,00479,India
819295,2023-03-10,709,notebook,30,60,30,1,00338,India
819295,2023-03-10,715,folder,5,15,10,1,00338,India
819295,2023-03-10,707,marker,20,40,20,1,00338,India
819295,2023-03-10,703,eraser,1,3,2,1,00338,India
819295,2023-03-10,716,printing paper,200,400,200,1,00338,India
400045,2023-03-10,715,folder,5,15,10,1,00416,India
400045,2023-03-10,705,stencil,10,20,10,1,00416,India
400045,2023-03-10,716,printing paper,200,400,200,1,00416,India
558098,2023-03-10,704,scale,5,10,5,1,00431,India
558098,2023-03-10,701,gel pen,5,10,5,1,00431,India
558098,2023-03-10,708,sketchpen,15,40,25,1,00431,India
284916,2023-03-10,712,graph paper,20,40,20,1,00191,India
284916,2023-03-10,703,eraser,1,3,2,1,00191,India
284916,2023-03-10,701,gel pen,5,10,5,1,00191,India
284916,2023-03-10,709,notebook,30,60,30,1,00191,India
284916,2023-03-10,717,spiral bound book,50,100,50,1,00191,India
880581,2023-03-10,702,pencil,2,5,3,1,00332,India
880581,2023-03-10,715,folder,5,15,10,1,00332,India
880581,2023-03-10,706,sharpener,3,8,5,1,00332,India
792723,2023-03-10,713,ball pen,5,10,5,1,00217,India
792723,2023-03-10,716,printing paper,200,400,200,1,00217,India
646333,2023-03-10,708,sketchpen,15,40,25,1,00379,India
762761,2023-03-10,707,marker,20,40,20,1,00199,India
762761,2023-03-10,704,scale,5,10,5,1,00199,India
762761,2023-03-10,705,stencil,10,20,10,1,00199,India
762761,2023-03-10,717,spiral bound book,50,100,50,1,00199,India
613594,2023-03-10,702,pencil,2,5,3,1,00456,India
613594,2023-03-10,715,folder,5,15,10,1,00456,India
613594,2023-03-10,708,sketchpen,15,40,25,1,00456,India
194232,2023-03-10,711,TD kit,150,300,150,1,00119,India
194232,2023-03-10,715,folder,5,15,10,1,00119,India
194232,2023-03-10,709,notebook,30,60,30,1,00119,India
194232,2023-03-10,706,sharpener,3,8,5,1,00119,India
573805,2023-03-10,710,geometry box,100,150,50,1,00204,India
573805,2023-03-10,714,carbon paper,15,30,15,1,00204,India
573805,2023-03-10,709,notebook,30,60,30,1,00204,India
264399,2023-03-10,712,graph paper,20,40,20,1,00117,India
264399,2023-03-10,711,TD kit,150,300,150,1,00117,India
846318,2023-03-10,714,carbon paper,15,30,15,1,00325,India
846318,2023-03-10,716,printing paper,200,400,200,1,00325,India
846318,2023-03-10,715,folder,5,15,10,1,00325,India
758890,2023-03-10,717,spiral bound book,50,100,50,1,00330,India
758890,2023-03-10,710,geometry box,100,150,50,1,00330,India
383890,2023-03-10,712,graph paper,20,40,20,1,00102,India
383890,2023-03-10,705,stencil,10,20,10,1,00102,India
383890,2023-03-10,708,sketchpen,15,40,25,1,00102,India
668417,2023-03-10,712,graph paper,20,40,20,1,00217,India
668417,2023-03-10,707,marker,20,40,20,1,00217,India
668417,2023-03-10,716,printing paper,200,400,200,1,00217,India
668417,2023-03-10,702,pencil,2,5,3,1,00217,India
723919,2023-03-10,707,marker,20,40,20,1,00361,India
629988,2023-03-10,710,geometry box,100,150,50,1,00024,India
629988,2023-03-10,701,gel pen,5,10,5,1,00024,India
512238,2023-03-10,702,pencil,2,5,3,1,00010,India
512238,2023-03-10,705,stencil,10,20,10,1,00010,India
512238,2023-03-10,716,printing paper,200,400,200,1,00010,India
476596,2023-03-10,708,sketchpen,15,40,25,1,00139,India
476596,2023-03-10,703,eraser,1,3,2,1,00139,India
476596,2023-03-10,715,folder,5,15,10,1,00139,India
972687,2023-03-10,701,gel pen,5,10,5,1,00204,India
972687,2023-03-10,708,sketchpen,15,40,25,1,00204,India
972687,2023-03-10,705,stencil,10,20,10,1,00204,India
972687,2023-03-10,709,notebook,30,60,30,1,00204,India
795341,2023-03-10,717,spiral bound book,50,100,50,1,00445,India
742192,2023-03-10,702,pencil,2,5,3,1,00464,India
742192,2023-03-10,712,graph paper,20,40,20,1,00464,India
742192,2023-03-10,713,ball pen,5,10,5,1,00464,India
592940,2023-03-10,701,gel pen,5,10,5,1,00271,India
592940,2023-03-10,702,pencil,2,5,3,1,00271,India
256707,2023-03-10,714,carbon paper,15,30,15,1,00164,India
256707,2023-03-10,705,stencil,10,20,10,1,00164,India
256707,2023-03-10,716,printing paper,200,400,200,1,00164,India
256707,2023-03-10,704,scale,5,10,5,1,00164,India
383324,2023-03-10,710,geometry box,100,150,50,1,00236,India
517060,2023-03-10,716,printing paper,200,400,200,1,00177,India
273387,2023-03-10,707,marker,20,40,20,1,00384,India
273387,2023-03-10,701,gel pen,5,10,5,1,00384,India
273387,2023-03-10,716,printing paper,200,400,200,1,00384,India
273387,2023-03-10,702,pencil,2,5,3,1,00384,India
683261,2023-03-10,712,graph paper,20,40,20,1,00212,India
683261,2023-03-10,704,scale,5,10,5,1,00212,India
683261,2023-03-10,716,printing paper,200,400,200,1,00212,India
683261,2023-03-10,708,sketchpen,15,40,25,1,00212,India
250615,2023-03-10,711,TD kit,150,300,150,1,00353,India
250615,2023-03-10,701,gel pen,5,10,5,1,00353,India
250615,2023-03-10,705,stencil,10,20,10,1,00353,India
250615,2023-03-10,716,printing paper,200,400,200,1,00353,India
253042,2023-03-10,707,marker,20,40,20,1,00188,India
253042,2023-03-10,709,notebook,30,60,30,1,00188,India
599754,2023-03-10,710,geometry box,100,150,50,1,00368,India
599754,2023-03-10,705,stencil,10,20,10,1,00368,India
599754,2023-03-10,717,spiral bound book,50,100,50,1,00368,India
446715,2023-03-10,715,folder,5,15,10,1,00351,India
446715,2023-03-10,703,eraser,1,3,2,1,00351,India
191598,2023-03-11,703,eraser,1,3,2,1,00313,India
191598,2023-03-11,717,spiral bound book,50,100,50,1,00313,India
191598,2023-03-11,702,pencil,2,5,3,1,00313,India
442374,2023-03-11,710,geometry box,100,150,50,1,00460,India
442374,2023-03-11,714,carbon paper,15,30,15,1,00460,India
442374,2023-03-11,708,sketchpen,15,40,25,1,00460,India
442374,2023-03-11,717,spiral bound book,50,100,50,1,00460,India
264387,2023-03-11,713,ball pen,5,10,5,1,00500,India
751371,2023-03-11,712,graph paper,20,40,20,1,00344,India
751371,2023-03-11,707,marker,20,40,20,1,00344,India
330913,2023-03-11,713,ball pen,5,10,5,1,00036,India
330913,2023-03-11,716,printing paper,200,400,200,1,00036,India
330913,2023-03-11,715,folder,5,15,10,1,00036,India
330913,2023-03-11,703,eraser,1,3,2,1,00036,India
661360,2023-03-11,717,spiral bound book,50,100,50,1,00356,India
661360,2023-03-11,714,carbon paper,15,30,15,1,00356,India
686006,2023-03-11,712,graph paper,20,40,20,1,00259,India
686006,2023-03-11,709,notebook,30,60,30,1,00259,India
686006,2023-03-11,706,sharpener,3,8,5,1,00259,India
686006,2023-03-11,716,printing paper,200,400,200,1,00259,India
686006,2023-03-11,705,stencil,10,20,10,1,00259,India
813988,2023-03-11,706,sharpener,3,8,5,1,00031,India
813988,2023-03-11,717,spiral bound book,50,100,50,1,00031,India
813988,2023-03-11,715,folder,5,15,10,1,00031,India
758325,2023-03-11,709,notebook,30,60,30,1,00010,India
758325,2023-03-11,701,gel pen,5,10,5,1,00010,India
758325,2023-03-11,706,sharpener,3,8,5,1,00010,India
758325,2023-03-11,703,eraser,1,3,2,1,00010,India
758325,2023-03-11,716,printing paper,200,400,200,1,00010,India
585789,2023-03-11,708,sketchpen,15,40,25,1,00332,India
585789,2023-03-11,709,notebook,30,60,30,1,00332,India
585789,2023-03-11,705,stencil,10,20,10,1,00332,India
724784,2023-03-11,714,carbon paper,15,30,15,1,00202,India
125605,2023-03-11,706,sharpener,3,8,5,1,00125,India
713838,2023-03-11,703,eraser,1,3,2,1,00170,India
713838,2023-03-11,714,carbon paper,15,30,15,1,00170,India
713838,2023-03-11,701,gel pen,5,10,5,1,00170,India
652656,2023-03-11,702,pencil,2,5,3,1,00069,India
652656,2023-03-11,703,eraser,1,3,2,1,00069,India
652656,2023-03-11,705,stencil,10,20,10,1,00069,India
652656,2023-03-11,711,TD kit,150,300,150,1,00069,India
901258,2023-03-11,703,eraser,1,3,2,1,00466,India
901258,2023-03-11,706,sharpener,3,8,5,1,00466,India
901258,2023-03-11,717,spiral bound book,50,100,50,1,00466,India
274236,2023-03-11,708,sketchpen,15,40,25,1,00360,India
274236,2023-03-11,713,ball pen,5,10,5,1,00360,India
274236,2023-03-11,714,carbon paper,15,30,15,1,00360,India
274236,2023-03-11,711,TD kit,150,300,150,1,00360,India
211936,2023-03-11,715,folder,5,15,10,1,00177,India
211936,2023-03-11,717,spiral bound book,50,100,50,1,00177,India
295785,2023-03-11,709,notebook,30,60,30,1,00350,India
295785,2023-03-11,715,folder,5,15,10,1,00350,India
196197,2023-03-11,704,scale,5,10,5,1,00124,India
196197,2023-03-11,716,printing paper,200,400,200,1,00124,India
196197,2023-03-11,713,ball pen,5,10,5,1,00124,India
196197,2023-03-11,717,spiral bound book,50,100,50,1,00124,India
244529,2023-03-11,717,spiral bound book,50,100,50,1,00349,India
731384,2023-03-11,704,scale,5,10,5,1,00353,India
505384,2023-03-11,701,gel pen,5,10,5,1,00305,India
505384,2023-03-11,711,TD kit,150,300,150,1,00305,India
505384,2023-03-11,715,folder,5,15,10,1,00305,India
425409,2023-03-11,710,geometry box,100,150,50,1,00307,India
191706,2023-03-11,705,stencil,10,20,10,1,00090,India
466363,2023-03-11,708,sketchpen,15,40,25,1,00033,India
466363,2023-03-11,717,spiral bound book,50,100,50,1,00033,India
466363,2023-03-11,702,pencil,2,5,3,1,00033,India
682708,2023-03-11,705,stencil,10,20,10,1,00337,India
682708,2023-03-11,707,marker,20,40,20,1,00337,India
756870,2023-03-11,704,scale,5,10,5,1,00232,India
756870,2023-03-11,710,geometry box,100,150,50,1,00232,India
756870,2023-03-11,703,eraser,1,3,2,1,00232,India
756870,2023-03-11,716,printing paper,200,400,200,1,00232,India
756870,2023-03-11,709,notebook,30,60,30,1,00232,India
564860,2023-03-11,714,carbon paper,15,30,15,1,00183,India
564860,2023-03-11,712,graph paper,20,40,20,1,00183,India
564860,2023-03-11,704,scale,5,10,5,1,00183,India
250690,2023-03-11,712,graph paper,20,40,20,1,00141,India
589420,2023-03-11,710,geometry box,100,150,50,1,00425,India
589420,2023-03-11,701,gel pen,5,10,5,1,00425,India
589420,2023-03-11,715,folder,5,15,10,1,00425,India
216066,2023-03-11,707,marker,20,40,20,1,00007,India
216066,2023-03-11,706,sharpener,3,8,5,1,00007,India
216066,2023-03-11,716,printing paper,200,400,200,1,00007,India
830469,2023-03-11,715,folder,5,15,10,1,00312,India
830469,2023-03-11,701,gel pen,5,10,5,1,00312,India
830469,2023-03-11,704,scale,5,10,5,1,00312,India
830469,2023-03-11,707,marker,20,40,20,1,00312,India
189255,2023-03-12,712,graph paper,20,40,20,1,00283,India
189255,2023-03-12,701,gel pen,5,10,5,1,00283,India
189255,2023-03-12,702,pencil,2,5,3,1,00283,India
789663,2023-03-12,702,pencil,2,5,3,1,00477,India
789663,2023-03-12,705,stencil,10,20,10,1,00477,India
789663,2023-03-12,714,carbon paper,15,30,15,1,00477,India
730493,2023-03-12,706,sharpener,3,8,5,1,00445,India
730493,2023-03-12,704,scale,5,10,5,1,00445,India
730493,2023-03-12,709,notebook,30,60,30,1,00445,India
730493,2023-03-12,717,spiral bound book,50,100,50,1,00445,India
121017,2023-03-12,715,folder,5,15,10,1,00369,India
121017,2023-03-12,716,printing paper,200,400,200,1,00369,India
121017,2023-03-12,702,pencil,2,5,3,1,00369,India
121017,2023-03-12,708,sketchpen,15,40,25,1,00369,India
571468,2023-03-12,706,sharpener,3,8,5,1,00190,India
571468,2023-03-12,709,notebook,30,60,30,1,00190,India
433460,2023-03-12,701,gel pen,5,10,5,1,00269,India
433460,2023-03-12,712,graph paper,20,40,20,1,00269,India
699654,2023-03-12,704,scale,5,10,5,1,00224,India
699654,2023-03-12,713,ball pen,5,10,5,1,00224,India
699654,2023-03-12,707,marker,20,40,20,1,00224,India
699654,2023-03-12,716,printing paper,200,400,200,1,00224,India
903217,2023-03-12,712,graph paper,20,40,20,1,00279,India
903217,2023-03-12,708,sketchpen,15,40,25,1,00279,India
903217,2023-03-12,716,printing paper,200,400,200,1,00279,India
903217,2023-03-12,705,stencil,10,20,10,1,00279,India
903217,2023-03-12,703,eraser,1,3,2,1,00279,India
258696,2023-03-12,707,marker,20,40,20,1,00059,India
258696,2023-03-12,709,notebook,30,60,30,1,00059,India
148920,2023-03-12,715,folder,5,15,10,1,00182,India
945778,2023-03-12,714,carbon paper,15,30,15,1,00253,India
945778,2023-03-12,704,scale,5,10,5,1,00253,India
945778,2023-03-12,707,marker,20,40,20,1,00253,India
945778,2023-03-12,715,folder,5,15,10,1,00253,India
866268,2023-03-12,707,marker,20,40,20,1,00421,India
446217,2023-03-12,714,carbon paper,15,30,15,1,00469,India
446217,2023-03-12,707,marker,20,40,20,1,00469,India
446217,2023-03-12,703,eraser,1,3,2,1,00469,India
660255,2023-03-12,707,marker,20,40,20,1,00117,India
660255,2023-03-12,703,eraser,1,3,2,1,00117,India
931355,2023-03-12,701,gel pen,5,10,5,1,00169,India
931355,2023-03-12,712,graph paper,20,40,20,1,00169,India
931355,2023-03-12,706,sharpener,3,8,5,1,00169,India
264746,2023-03-12,709,notebook,30,60,30,1,00100,India
264746,2023-03-12,710,geometry box,100,150,50,1,00100,India
260180,2023-03-12,704,scale,5,10,5,1,00265,India
260180,2023-03-12,709,notebook,30,60,30,1,00265,India
202790,2023-03-12,708,sketchpen,15,40,25,1,00357,India
202790,2023-03-12,713,ball pen,5,10,5,1,00357,India
202790,2023-03-12,709,notebook,30,60,30,1,00357,India
181878,2023-03-12,711,TD kit,150,300,150,1,00469,India
181878,2023-03-12,704,scale,5,10,5,1,00469,India
496419,2023-03-12,708,sketchpen,15,40,25,1,00185,India
496419,2023-03-12,714,carbon paper,15,30,15,1,00185,India
496419,2023-03-12,706,sharpener,3,8,5,1,00185,India
496419,2023-03-12,711,TD kit,150,300,150,1,00185,India
496419,2023-03-12,709,notebook,30,60,30,1,00185,India
453432,2023-03-12,710,geometry box,100,150,50,1,00125,India
453432,2023-03-12,713,ball pen,5,10,5,1,00125,India
163199,2023-03-12,714,carbon paper,15,30,15,1,00390,India
985985,2023-03-12,708,sketchpen,15,40,25,1,00200,India
985985,2023-03-12,701,gel pen,5,10,5,1,00200,India
185772,2023-03-12,717,spiral bound book,50,100,50,1,00070,India
185772,2023-03-12,707,marker,20,40,20,1,00070,India
185772,2023-03-12,716,printing paper,200,400,200,1,00070,India
641765,2023-03-12,716,printing paper,200,400,200,1,00226,India
818085,2023-03-12,709,notebook,30,60,30,1,00342,India
818085,2023-03-12,705,stencil,10,20,10,1,00342,India
818085,2023-03-12,707,marker,20,40,20,1,00342,India
563903,2023-03-12,701,gel pen,5,10,5,1,00456,India
563903,2023-03-12,705,stencil,10,20,10,1,00456,India
793352,2023-03-12,713,ball pen,5,10,5,1,00053,India
793352,2023-03-12,716,printing paper,200,400,200,1,00053,India
343080,2023-03-12,705,stencil,10,20,10,1,00174,India
343080,2023-03-12,715,folder,5,15,10,1,00174,India
343080,2023-03-12,716,printing paper,200,400,200,1,00174,India
343080,2023-03-12,711,TD kit,150,300,150,1,00174,India
654407,2023-03-12,712,graph paper,20,40,20,1,00082,India
654407,2023-03-12,711,TD kit,150,300,150,1,00082,India
654407,2023-03-12,710,geometry box,100,150,50,1,00082,India
654407,2023-03-12,706,sharpener,3,8,5,1,00082,India
681830,2023-03-12,710,geometry box,100,150,50,1,00324,India
681830,2023-03-12,712,graph paper,20,40,20,1,00324,India
831037,2023-03-12,707,marker,20,40,20,1,00165,India
831037,2023-03-12,712,graph paper,20,40,20,1,00165,India
831037,2023-03-12,706,sharpener,3,8,5,1,00165,India
831037,2023-03-12,703,eraser,1,3,2,1,00165,India
876276,2023-03-12,712,graph paper,20,40,20,1,00487,India
876276,2023-03-12,703,eraser,1,3,2,1,00487,India
876276,2023-03-12,711,TD kit,150,300,150,1,00487,India
876276,2023-03-12,717,spiral bound book,50,100,50,1,00487,India
785959,2023-03-12,703,eraser,1,3,2,1,00025,India
785959,2023-03-12,706,sharpener,3,8,5,1,00025,India
785959,2023-03-12,713,ball pen,5,10,5,1,00025,India
785959,2023-03-12,717,spiral bound book,50,100,50,1,00025,India
607788,2023-03-12,713,ball pen,5,10,5,1,00315,India
607788,2023-03-12,708,sketchpen,15,40,25,1,00315,India
607788,2023-03-12,705,stencil,10,20,10,1,00315,India
607788,2023-03-12,712,graph paper,20,40,20,1,00315,India
818841,2023-03-13,708,sketchpen,15,40,25,1,00466,India
818841,2023-03-13,702,pencil,2,5,3,1,00466,India
705172,2023-03-13,717,spiral bound book,50,100,50,1,00394,India
705172,2023-03-13,708,sketchpen,15,40,25,1,00394,India
705172,2023-03-13,705,stencil,10,20,10,1,00394,India
705172,2023-03-13,702,pencil,2,5,3,1,00394,India
889796,2023-03-13,711,TD kit,150,300,150,1,00197,India
889796,2023-03-13,703,eraser,1,3,2,1,00197,India
889796,2023-03-13,701,gel pen,5,10,5,1,00197,India
304080,2023-03-13,715,folder,5,15,10,1,00142,India
304080,2023-03-13,717,spiral bound book,50,100,50,1,00142,India
304080,2023-03-13,713,ball pen,5,10,5,1,00142,India
514592,2023-03-13,710,geometry box,100,150,50,1,00369,India
514592,2023-03-13,712,graph paper,20,40,20,1,00369,India
514592,2023-03-13,704,scale,5,10,5,1,00369,India
453680,2023-03-13,705,stencil,10,20,10,1,00487,India
359166,2023-03-13,705,stencil,10,20,10,1,00247,India
462297,2023-03-13,703,eraser,1,3,2,1,00063,India
229528,2023-03-13,714,carbon paper,15,30,15,1,00437,India
229528,2023-03-13,704,scale,5,10,5,1,00437,India
229528,2023-03-13,711,TD kit,150,300,150,1,00437,India
229528,2023-03-13,710,geometry box,100,150,50,1,00437,India
229528,2023-03-13,708,sketchpen,15,40,25,1,00437,India
710210,2023-03-13,710,geometry box,100,150,50,1,00411,India
710210,2023-03-13,708,sketchpen,15,40,25,1,00411,India
710210,2023-03-13,715,folder,5,15,10,1,00411,India
283629,2023-03-13,706,sharpener,3,8,5,1,00367,India
283629,2023-03-13,707,marker,20,40,20,1,00367,India
283629,2023-03-13,716,printing paper,200,400,200,1,00367,India
283629,2023-03-13,703,eraser,1,3,2,1,00367,India
542477,2023-03-13,709,notebook,30,60,30,1,00374,India
469449,2023-03-13,710,geometry box,100,150,50,1,00215,India
469449,2023-03-13,707,marker,20,40,20,1,00215,India
369690,2023-03-13,712,graph paper,20,40,20,1,00389,India
930135,2023-03-13,710,geometry box,100,150,50,1,00315,India
109403,2023-03-13,701,gel pen,5,10,5,1,00324,India
647956,2023-03-13,716,printing paper,200,400,200,1,00013,India
647956,2023-03-13,717,spiral bound book,50,100,50,1,00013,India
647956,2023-03-13,714,carbon paper,15,30,15,1,00013,India
151175,2023-03-13,702,pencil,2,5,3,1,00020,India
151175,2023-03-13,709,notebook,30,60,30,1,00020,India
151175,2023-03-13,707,marker,20,40,20,1,00020,India
677854,2023-03-13,711,TD kit,150,300,150,1,00411,India
474868,2023-03-13,715,folder,5,15,10,1,00002,India
474868,2023-03-13,707,marker,20,40,20,1,00002,India
474868,2023-03-13,701,gel pen,5,10,5,1,00002,India
474868,2023-03-13,716,printing paper,200,400,200,1,00002,India
257990,2023-03-13,707,marker,20,40,20,1,00149,India
257990,2023-03-13,716,printing paper,200,400,200,1,00149,India
257990,2023-03-13,710,geometry box,100,150,50,1,00149,India
103247,2023-03-13,707,marker,20,40,20,1,00468,India
103247,2023-03-13,702,pencil,2,5,3,1,00468,India
110751,2023-03-13,710,geometry box,100,150,50,1,00388,India
110751,2023-03-13,714,carbon paper,15,30,15,1,00388,India
110751,2023-03-13,707,marker,20,40,20,1,00388,India
234085,2023-03-13,715,folder,5,15,10,1,00266,India
234085,2023-03-13,710,geometry box,100,150,50,1,00266,India
234085,2023-03-13,708,sketchpen,15,40,25,1,00266,India
234085,2023-03-13,717,spiral bound book,50,100,50,1,00266,India
523051,2023-03-13,713,ball pen,5,10,5,1,00382,India
523051,2023-03-13,707,marker,20,40,20,1,00382,India
523051,2023-03-13,709,notebook,30,60,30,1,00382,India
523051,2023-03-13,704,scale,5,10,5,1,00382,India
627047,2023-03-13,711,TD kit,150,300,150,1,00389,India
627047,2023-03-13,707,marker,20,40,20,1,00389,India
627047,2023-03-13,701,gel pen,5,10,5,1,00389,India
627047,2023-03-13,702,pencil,2,5,3,1,00389,India
281435,2023-03-13,708,sketchpen,15,40,25,1,00311,India
281435,2023-03-13,711,TD kit,150,300,150,1,00311,India
281435,2023-03-13,701,gel pen,5,10,5,1,00311,India
126298,2023-03-13,702,pencil,2,5,3,1,00020,India
126298,2023-03-13,712,graph paper,20,40,20,1,00020,India
126298,2023-03-13,717,spiral bound book,50,100,50,1,00020,India
903796,2023-03-13,711,TD kit,150,300,150,1,00124,India
903796,2023-03-13,708,sketchpen,15,40,25,1,00124,India
903796,2023-03-13,701,gel pen,5,10,5,1,00124,India
903796,2023-03-13,702,pencil,2,5,3,1,00124,India
459170,2023-03-13,712,graph paper,20,40,20,1,00022,India
459170,2023-03-13,715,folder,5,15,10,1,00022,India
459170,2023-03-13,711,TD kit,150,300,150,1,00022,India
459170,2023-03-13,703,eraser,1,3,2,1,00022,India
459170,2023-03-13,701,gel pen,5,10,5,1,00022,India
450352,2023-03-13,702,pencil,2,5,3,1,00125,India
450352,2023-03-13,707,marker,20,40,20,1,00125,India
450352,2023-03-13,713,ball pen,5,10,5,1,00125,India
450352,2023-03-13,714,carbon paper,15,30,15,1,00125,India
311644,2023-03-13,715,folder,5,15,10,1,00479,India
496992,2023-03-13,712,graph paper,20,40,20,1,00373,India
496992,2023-03-13,702,pencil,2,5,3,1,00373,India
496992,2023-03-13,716,printing paper,200,400,200,1,00373,India
496992,2023-03-13,704,scale,5,10,5,1,00373,India
496992,2023-03-13,715,folder,5,15,10,1,00373,India
950795,2023-03-13,716,printing paper,200,400,200,1,00071,India
950795,2023-03-13,707,marker,20,40,20,1,00071,India
950795,2023-03-13,708,sketchpen,15,40,25,1,00071,India
950795,2023-03-13,709,notebook,30,60,30,1,00071,India
307083,2023-03-13,707,marker,20,40,20,1,00180,India
307083,2023-03-13,704,scale,5,10,5,1,00180,India
778632,2023-03-13,704,scale,5,10,5,1,00223,India
778632,2023-03-13,713,ball pen,5,10,5,1,00223,India
487201,2023-03-13,713,ball pen,5,10,5,1,00251,India
487201,2023-03-13,717,spiral bound book,50,100,50,1,00251,India
487201,2023-03-13,710,geometry box,100,150,50,1,00251,India
487201,2023-03-13,701,gel pen,5,10,5,1,00251,India
428701,2023-03-13,715,folder,5,15,10,1,00200,India
936336,2023-03-13,705,stencil,10,20,10,1,00479,India
936336,2023-03-13,702,pencil,2,5,3,1,00479,India
936336,2023-03-13,703,eraser,1,3,2,1,00479,India
345467,2023-03-13,706,sharpener,3,8,5,1,00210,India
601717,2023-03-13,705,stencil,10,20,10,1,00438,India
601717,2023-03-13,717,spiral bound book,50,100,50,1,00438,India
192904,2023-03-13,711,TD kit,150,300,150,1,00311,India
192904,2023-03-13,715,folder,5,15,10,1,00311,India
192904,2023-03-13,714,carbon paper,15,30,15,1,00311,India
571885,2023-03-13,709,notebook,30,60,30,1,00327,India
571885,2023-03-13,704,scale,5,10,5,1,00327,India
571885,2023-03-13,702,pencil,2,5,3,1,00327,India
571885,2023-03-13,715,folder,5,15,10,1,00327,India
970160,2023-03-13,712,graph paper,20,40,20,1,00240,India
970160,2023-03-13,709,notebook,30,60,30,1,00240,India
212034,2023-03-13,708,sketchpen,15,40,25,1,00398,India
434899,2023-03-13,711,TD kit,150,300,150,1,00271,India
434899,2023-03-13,703,eraser,1,3,2,1,00271,India
434899,2023-03-13,702,pencil,2,5,3,1,00271,India
434899,2023-03-13,710,geometry box,100,150,50,1,00271,India
240978,2023-03-14,709,notebook,30,60,30,1,00049,India
240978,2023-03-14,707,marker,20,40,20,1,00049,India
240978,2023-03-14,708,sketchpen,15,40,25,1,00049,India
963301,2023-03-14,702,pencil,2,5,3,1,00141,India
963301,2023-03-14,704,scale,5,10,5,1,00141,India
963301,2023-03-14,712,graph paper,20,40,20,1,00141,India
963301,2023-03-14,703,eraser,1,3,2,1,00141,India
963301,2023-03-14,701,gel pen,5,10,5,1,00141,India
832102,2023-03-14,703,eraser,1,3,2,1,00465,India
269016,2023-03-14,703,eraser,1,3,2,1,00265,India
269016,2023-03-14,716,printing paper,200,400,200,1,00265,India
269016,2023-03-14,715,folder,5,15,10,1,00265,India
269016,2023-03-14,704,scale,5,10,5,1,00265,India
269016,2023-03-14,710,geometry box,100,150,50,1,00265,India
624394,2023-03-14,716,printing paper,200,400,200,1,00495,India
624394,2023-03-14,713,ball pen,5,10,5,1,00495,India
624394,2023-03-14,705,stencil,10,20,10,1,00495,India
128137,2023-03-14,709,notebook,30,60,30,1,00135,India
577590,2023-03-14,706,sharpener,3,8,5,1,00220,India
577590,2023-03-14,704,scale,5,10,5,1,00220,India
577590,2023-03-14,705,stencil,10,20,10,1,00220,India
474675,2023-03-14,711,TD kit,150,300,150,1,00156,India
474675,2023-03-14,707,marker,20,40,20,1,00156,India
474675,2023-03-14,717,spiral bound book,50,100,50,1,00156,India
474675,2023-03-14,715,folder,5,15,10,1,00156,India
474675,2023-03-14,709,notebook,30,60,30,1,00156,India
893061,2023-03-14,715,folder,5,15,10,1,00386,India
734476,2023-03-14,710,geometry box,100,150,50,1,00420,India
324443,2023-03-14,713,ball pen,5,10,5,1,00229,India
324443,2023-03-14,704,scale,5,10,5,1,00229,India
188962,2023-03-14,715,folder,5,15,10,1,00425,India
188962,2023-03-14,716,printing paper,200,400,200,1,00425,India
361198,2023-03-14,703,eraser,1,3,2,1,00387,India
361198,2023-03-14,701,gel pen,5,10,5,1,00387,India
361198,2023-03-14,715,folder,5,15,10,1,00387,India
361198,2023-03-14,708,sketchpen,15,40,25,1,00387,India
621112,2023-03-14,702,pencil,2,5,3,1,00176,India
621112,2023-03-14,707,marker,20,40,20,1,00176,India
886998,2023-03-14,705,stencil,10,20,10,1,00158,India
886998,2023-03-14,701,gel pen,5,10,5,1,00158,India
886998,2023-03-14,716,printing paper,200,400,200,1,00158,India
886998,2023-03-14,717,spiral bound book,50,100,50,1,00158,India
764407,2023-03-14,705,stencil,10,20,10,1,00075,India
764407,2023-03-14,713,ball pen,5,10,5,1,00075,India
764407,2023-03-14,708,sketchpen,15,40,25,1,00075,India
498775,2023-03-14,717,spiral bound book,50,100,50,1,00024,India
498775,2023-03-14,702,pencil,2,5,3,1,00024,India
526313,2023-03-14,708,sketchpen,15,40,25,1,00026,India
164443,2023-03-14,713,ball pen,5,10,5,1,00171,India
164443,2023-03-14,705,stencil,10,20,10,1,00171,India
164443,2023-03-14,715,folder,5,15,10,1,00171,India
164443,2023-03-14,717,spiral bound book,50,100,50,1,00171,India
164443,2023-03-14,711,TD kit,150,300,150,1,00171,India
508778,2023-03-14,706,sharpener,3,8,5,1,00189,India
508778,2023-03-14,705,stencil,10,20,10,1,00189,India
685199,2023-03-14,705,stencil,10,20,10,1,00268,India
685199,2023-03-14,710,geometry box,100,150,50,1,00268,India
685199,2023-03-14,708,sketchpen,15,40,25,1,00268,India
685199,2023-03-14,707,marker,20,40,20,1,00268,India
685199,2023-03-14,715,folder,5,15,10,1,00268,India
704153,2023-03-14,707,marker,20,40,20,1,00241,India
519024,2023-03-14,710,geometry box,100,150,50,1,00499,India
519024,2023-03-14,714,carbon paper,15,30,15,1,00499,India
519024,2023-03-14,711,TD kit,150,300,150,1,00499,India
177751,2023-03-14,702,pencil,2,5,3,1,00241,India
177751,2023-03-14,701,gel pen,5,10,5,1,00241,India
177751,2023-03-14,705,stencil,10,20,10,1,00241,India
332200,2023-03-14,716,printing paper,200,400,200,1,00048,India
332200,2023-03-14,717,spiral bound book,50,100,50,1,00048,India
448019,2023-03-14,706,sharpener,3,8,5,1,00323,India
448019,2023-03-14,704,scale,5,10,5,1,00323,India
448019,2023-03-14,702,pencil,2,5,3,1,00323,India
448019,2023-03-14,715,folder,5,15,10,1,00323,India
598643,2023-03-14,717,spiral bound book,50,100,50,1,00081,India
598643,2023-03-14,702,pencil,2,5,3,1,00081,India
598643,2023-03-14,713,ball pen,5,10,5,1,00081,India
185679,2023-03-14,708,sketchpen,15,40,25,1,00410,India
185679,2023-03-14,701,gel pen,5,10,5,1,00410,India
185679,2023-03-14,712,graph paper,20,40,20,1,00410,India
562052,2023-03-14,704,scale,5,10,5,1,00321,India
562052,2023-03-14,705,stencil,10,20,10,1,00321,India
495463,2023-03-14,701,gel pen,5,10,5,1,00472,India
495463,2023-03-14,710,geometry box,100,150,50,1,00472,India
495463,2023-03-14,708,sketchpen,15,40,25,1,00472,India
495463,2023-03-14,713,ball pen,5,10,5,1,00472,India
974848,2023-03-14,705,stencil,10,20,10,1,00158,India
974848,2023-03-14,706,sharpener,3,8,5,1,00158,India
220768,2023-03-14,705,stencil,10,20,10,1,00187,India
220768,2023-03-14,712,graph paper,20,40,20,1,00187,India
220768,2023-03-14,711,TD kit,150,300,150,1,00187,India
220768,2023-03-14,708,sketchpen,15,40,25,1,00187,India
345305,2023-03-14,717,spiral bound book,50,100,50,1,00201,India
345305,2023-03-14,716,printing paper,200,400,200,1,00201,India
345305,2023-03-14,713,ball pen,5,10,5,1,00201,India
787405,2023-03-14,712,graph paper,20,40,20,1,00276,India
787405,2023-03-14,702,pencil,2,5,3,1,00276,India
612252,2023-03-14,706,sharpener,3,8,5,1,00164,India
551998,2023-03-14,711,TD kit,150,300,150,1,00136,India
893286,2023-03-14,712,graph paper,20,40,20,1,00231,India
893286,2023-03-14,714,carbon paper,15,30,15,1,00231,India
893286,2023-03-14,702,pencil,2,5,3,1,00231,India
874036,2023-03-14,706,sharpener,3,8,5,1,00273,India
874036,2023-03-14,701,gel pen,5,10,5,1,00273,India
874036,2023-03-14,703,eraser,1,3,2,1,00273,India
874036,2023-03-14,715,folder,5,15,10,1,00273,India
874036,2023-03-14,704,scale,5,10,5,1,00273,India
229107,2023-03-14,709,notebook,30,60,30,1,00279,India
229107,2023-03-14,708,sketchpen,15,40,25,1,00279,India
229107,2023-03-14,712,graph paper,20,40,20,1,00279,India
835197,2023-03-14,714,carbon paper,15,30,15,1,00388,India
835197,2023-03-14,717,spiral bound book,50,100,50,1,00388,India
565910,2023-03-14,702,pencil,2,5,3,1,00467,India
565910,2023-03-14,701,gel pen,5,10,5,1,00467,India
565910,2023-03-14,711,TD kit,150,300,150,1,00467,India
565910,2023-03-14,712,graph paper,20,40,20,1,00467,India
746794,2023-03-15,701,gel pen,5,10,5,1,00301,India
746794,2023-03-15,708,sketchpen,15,40,25,1,00301,India
342388,2023-03-15,703,eraser,1,3,2,1,00096,India
342388,2023-03-15,717,spiral bound book,50,100,50,1,00096,India
822080,2023-03-15,717,spiral bound book,50,100,50,1,00299,India
822080,2023-03-15,701,gel pen,5,10,5,1,00299,India
822080,2023-03-15,710,geometry box,100,150,50,1,00299,India
383954,2023-03-15,717,spiral bound book,50,100,50,1,00459,India
383954,2023-03-15,712,graph paper,20,40,20,1,00459,India
383954,2023-03-15,703,eraser,1,3,2,1,00459,India
383954,2023-03-15,713,ball pen,5,10,5,1,00459,India
865988,2023-03-15,715,folder,5,15,10,1,00466,India
865988,2023-03-15,703,eraser,1,3,2,1,00466,India
865988,2023-03-15,714,carbon paper,15,30,15,1,00466,India
865988,2023-03-15,712,graph paper,20,40,20,1,00466,India
865988,2023-03-15,710,geometry box,100,150,50,1,00466,India
284859,2023-03-15,717,spiral bound book,50,100,50,1,00173,India
284859,2023-03-15,701,gel pen,5,10,5,1,00173,India
284859,2023-03-15,704,scale,5,10,5,1,00173,India
432351,2023-03-15,710,geometry box,100,150,50,1,00213,India
432351,2023-03-15,709,notebook,30,60,30,1,00213,India
432351,2023-03-15,711,TD kit,150,300,150,1,00213,India
950042,2023-03-15,710,geometry box,100,150,50,1,00355,India
950042,2023-03-15,704,scale,5,10,5,1,00355,India
950042,2023-03-15,701,gel pen,5,10,5,1,00355,India
588635,2023-03-15,711,TD kit,150,300,150,1,00114,India
588635,2023-03-15,716,printing paper,200,400,200,1,00114,India
870694,2023-03-15,715,folder,5,15,10,1,00186,India
870694,2023-03-15,705,stencil,10,20,10,1,00186,India
856108,2023-03-15,703,eraser,1,3,2,1,00209,India
856108,2023-03-15,712,graph paper,20,40,20,1,00209,India
178520,2023-03-15,716,printing paper,200,400,200,1,00111,India
178520,2023-03-15,713,ball pen,5,10,5,1,00111,India
178520,2023-03-15,707,marker,20,40,20,1,00111,India
124071,2023-03-15,713,ball pen,5,10,5,1,00021,India
124071,2023-03-15,715,folder,5,15,10,1,00021,India
124071,2023-03-15,702,pencil,2,5,3,1,00021,India
124071,2023-03-15,717,spiral bound book,50,100,50,1,00021,India
124071,2023-03-15,716,printing paper,200,400,200,1,00021,India
198600,2023-03-15,717,spiral bound book,50,100,50,1,00372,India
198600,2023-03-15,715,folder,5,15,10,1,00372,India
198600,2023-03-15,707,marker,20,40,20,1,00372,India
198600,2023-03-15,703,eraser,1,3,2,1,00372,India
829670,2023-03-15,712,graph paper,20,40,20,1,00256,India
117511,2023-03-15,712,graph paper,20,40,20,1,00241,India
117511,2023-03-15,713,ball pen,5,10,5,1,00241,India
117511,2023-03-15,701,gel pen,5,10,5,1,00241,India
307613,2023-03-15,709,notebook,30,60,30,1,00407,India
307613,2023-03-15,716,printing paper,200,400,200,1,00407,India
103029,2023-03-15,704,scale,5,10,5,1,00196,India
345405,2023-03-15,716,printing paper,200,400,200,1,00088,India
915810,2023-03-15,716,printing paper,200,400,200,1,00323,India
915810,2023-03-15,717,spiral bound book,50,100,50,1,00323,India
117312,2023-03-15,711,TD kit,150,300,150,1,00037,India
117312,2023-03-15,705,stencil,10,20,10,1,00037,India
872150,2023-03-15,708,sketchpen,15,40,25,1,00473,India
872150,2023-03-15,712,graph paper,20,40,20,1,00473,India
872150,2023-03-15,710,geometry box,100,150,50,1,00473,India
872150,2023-03-15,711,TD kit,150,300,150,1,00473,India
872150,2023-03-15,703,eraser,1,3,2,1,00473,India
908264,2023-03-15,709,notebook,30,60,30,1,00247,India
908264,2023-03-15,717,spiral bound book,50,100,50,1,00247,India
908264,2023-03-15,707,marker,20,40,20,1,00247,India
908264,2023-03-15,703,eraser,1,3,2,1,00247,India
908264,2023-03-15,713,ball pen,5,10,5,1,00247,India
301316,2023-03-15,704,scale,5,10,5,1,00041,India
301316,2023-03-15,714,carbon paper,15,30,15,1,00041,India
301316,2023-03-15,705,stencil,10,20,10,1,00041,India
301316,2023-03-15,717,spiral bound book,50,100,50,1,00041,India
301316,2023-03-15,713,ball pen,5,10,5,1,00041,India
115238,2023-03-15,705,stencil,10,20,10,1,00437,India
115238,2023-03-15,713,ball pen,5,10,5,1,00437,India
115238,2023-03-15,701,gel pen,5,10,5,1,00437,India
115238,2023-03-15,709,notebook,30,60,30,1,00437,India
115238,2023-03-15,714,carbon paper,15,30,15,1,00437,India
365158,2023-03-15,709,notebook,30,60,30,1,00376,India
365158,2023-03-15,717,spiral bound book,50,100,50,1,00376,India
768811,2023-03-15,704,scale,5,10,5,1,00173,India
768811,2023-03-15,703,eraser,1,3,2,1,00173,India
811342,2023-03-15,709,notebook,30,60,30,1,00143,India
811342,2023-03-15,708,sketchpen,15,40,25,1,00143,India
804945,2023-03-15,707,marker,20,40,20,1,00265,India
507921,2023-03-15,717,spiral bound book,50,100,50,1,00401,India
507921,2023-03-15,708,sketchpen,15,40,25,1,00401,India
507921,2023-03-15,702,pencil,2,5,3,1,00401,India
507921,2023-03-15,705,stencil,10,20,10,1,00401,India
703938,2023-03-15,709,notebook,30,60,30,1,00070,India
703938,2023-03-15,717,spiral bound book,50,100,50,1,00070,India
703938,2023-03-15,713,ball pen,5,10,5,1,00070,India
703938,2023-03-15,714,carbon paper,15,30,15,1,00070,India
232703,2023-03-16,712,graph paper,20,40,20,1,00248,India
232703,2023-03-16,709,notebook,30,60,30,1,00248,India
232703,2023-03-16,705,stencil,10,20,10,1,00248,India
129853,2023-03-16,709,notebook,30,60,30,1,00421,India
129853,2023-03-16,712,graph paper,20,40,20,1,00421,India
129853,2023-03-16,715,folder,5,15,10,1,00421,India
534274,2023-03-16,712,graph paper,20,40,20,1,00274,India
534274,2023-03-16,703,eraser,1,3,2,1,00274,India
534274,2023-03-16,711,TD kit,150,300,150,1,00274,India
534274,2023-03-16,705,stencil,10,20,10,1,00274,India
767882,2023-03-16,712,graph paper,20,40,20,1,00072,India
767882,2023-03-16,714,carbon paper,15,30,15,1,00072,India
767882,2023-03-16,711,TD kit,150,300,150,1,00072,India
767882,2023-03-16,710,geometry box,100,150,50,1,00072,India
767882,2023-03-16,703,eraser,1,3,2,1,00072,India
911385,2023-03-16,701,gel pen,5,10,5,1,00077,India
184462,2023-03-16,709,notebook,30,60,30,1,00349,India
184462,2023-03-16,716,printing paper,200,400,200,1,00349,India
184462,2023-03-16,712,graph paper,20,40,20,1,00349,India
184462,2023-03-16,706,sharpener,3,8,5,1,00349,India
244668,2023-03-16,710,geometry box,100,150,50,1,00353,India
244668,2023-03-16,707,marker,20,40,20,1,00353,India
244668,2023-03-16,708,sketchpen,15,40,25,1,00353,India
244668,2023-03-16,717,spiral bound book,50,100,50,1,00353,India
244668,2023-03-16,711,TD kit,150,300,150,1,00353,India
612135,2023-03-16,708,sketchpen,15,40,25,1,00461,India
612135,2023-03-16,717,spiral bound book,50,100,50,1,00461,India
612135,2023-03-16,715,folder,5,15,10,1,00461,India
992743,2023-03-16,712,graph paper,20,40,20,1,00421,India
342464,2023-03-16,711,TD kit,150,300,150,1,00098,India
342464,2023-03-16,703,eraser,1,3,2,1,00098,India
342464,2023-03-16,712,graph paper,20,40,20,1,00098,India
807016,2023-03-16,707,marker,20,40,20,1,00271,India
807016,2023-03-16,713,ball pen,5,10,5,1,00271,India
807016,2023-03-16,708,sketchpen,15,40,25,1,00271,India
340992,2023-03-16,703,eraser,1,3,2,1,00307,India
340992,2023-03-16,701,gel pen,5,10,5,1,00307,India
340992,2023-03-16,713,ball pen,5,10,5,1,00307,India
340992,2023-03-16,710,geometry box,100,150,50,1,00307,India
340992,2023-03-16,716,printing paper,200,400,200,1,00307,India
701633,2023-03-16,710,geometry box,100,150,50,1,00386,India
792908,2023-03-16,701,gel pen,5,10,5,1,00333,India
966057,2023-03-16,716,printing paper,200,400,200,1,00250,India
966057,2023-03-16,711,TD kit,150,300,150,1,00250,India
966057,2023-03-16,704,scale,5,10,5,1,00250,India
966057,2023-03-16,717,spiral bound book,50,100,50,1,00250,India
830612,2023-03-16,713,ball pen,5,10,5,1,00059,India
830612,2023-03-16,712,graph paper,20,40,20,1,00059,India
830612,2023-03-16,709,notebook,30,60,30,1,00059,India
830612,2023-03-16,708,sketchpen,15,40,25,1,00059,India
830612,2023-03-16,707,marker,20,40,20,1,00059,India
712364,2023-03-16,714,carbon paper,15,30,15,1,00321,India
712364,2023-03-16,711,TD kit,150,300,150,1,00321,India
209249,2023-03-16,715,folder,5,15,10,1,00089,India
209249,2023-03-16,708,sketchpen,15,40,25,1,00089,India
209249,2023-03-16,710,geometry box,100,150,50,1,00089,India
209249,2023-03-16,705,stencil,10,20,10,1,00089,India
209249,2023-03-16,717,spiral bound book,50,100,50,1,00089,India
583076,2023-03-16,712,graph paper,20,40,20,1,00214,India
583076,2023-03-16,705,stencil,10,20,10,1,00214,India
583076,2023-03-16,717,spiral bound book,50,100,50,1,00214,India
583076,2023-03-16,716,printing paper,200,400,200,1,00214,India
313714,2023-03-16,713,ball pen,5,10,5,1,00111,India
313714,2023-03-16,717,spiral bound book,50,100,50,1,00111,India
174005,2023-03-16,710,geometry box,100,150,50,1,00402,India
174005,2023-03-16,705,stencil,10,20,10,1,00402,India
174005,2023-03-16,717,spiral bound book,50,100,50,1,00402,India
174005,2023-03-16,702,pencil,2,5,3,1,00402,India
531025,2023-03-16,705,stencil,10,20,10,1,00319,India
531025,2023-03-16,711,TD kit,150,300,150,1,00319,India
531025,2023-03-16,717,spiral bound book,50,100,50,1,00319,India
719192,2023-03-16,705,stencil,10,20,10,1,00385,India
719192,2023-03-16,716,printing paper,200,400,200,1,00385,India
719192,2023-03-16,702,pencil,2,5,3,1,00385,India
719192,2023-03-16,704,scale,5,10,5,1,00385,India
400984,2023-03-16,709,notebook,30,60,30,1,00272,India
400984,2023-03-16,707,marker,20,40,20,1,00272,India
400984,2023-03-16,701,gel pen,5,10,5,1,00272,India
843479,2023-03-16,708,sketchpen,15,40,25,1,00267,India
843479,2023-03-16,703,eraser,1,3,2,1,00267,India
843479,2023-03-16,701,gel pen,5,10,5,1,00267,India
843479,2023-03-16,711,TD kit,150,300,150,1,00267,India
165999,2023-03-16,708,sketchpen,15,40,25,1,00221,India
165999,2023-03-16,702,pencil,2,5,3,1,00221,India
165999,2023-03-16,710,geometry box,100,150,50,1,00221,India
959350,2023-03-16,714,carbon paper,15,30,15,1,00138,India
959350,2023-03-16,713,ball pen,5,10,5,1,00138,India
959350,2023-03-16,708,sketchpen,15,40,25,1,00138,India
978354,2023-03-16,713,ball pen,5,10,5,1,00371,India
978354,2023-03-16,712,graph paper,20,40,20,1,00371,India
978354,2023-03-16,704,scale,5,10,5,1,00371,India
978354,2023-03-16,710,geometry box,100,150,50,1,00371,India
625243,2023-03-16,701,gel pen,5,10,5,1,00344,India
625243,2023-03-16,707,marker,20,40,20,1,00344,India
625243,2023-03-16,709,notebook,30,60,30,1,00344,India
902297,2023-03-16,709,notebook,30,60,30,1,00002,India
902297,2023-03-16,702,pencil,2,5,3,1,00002,India
902297,2023-03-16,707,marker,20,40,20,1,00002,India
189250,2023-03-16,704,scale,5,10,5,1,00357,India
591935,2023-03-16,703,eraser,1,3,2,1,00469,India
591935,2023-03-16,702,pencil,2,5,3,1,00469,India
591935,2023-03-16,701,gel pen,5,10,5,1,00469,India
591935,2023-03-16,711,TD kit,150,300,150,1,00469,India
815251,2023-03-16,709,notebook,30,60,30,1,00190,India
503989,2023-03-16,715,folder,5,15,10,1,00300,India
503989,2023-03-16,711,TD kit,150,300,150,1,00300,India
503989,2023-03-16,713,ball pen,5,10,5,1,00300,India
503989,2023-03-16,710,geometry box,100,150,50,1,00300,India
563505,2023-03-16,717,spiral bound book,50,100,50,1,00016,India
563505,2023-03-16,705,stencil,10,20,10,1,00016,India
563505,2023-03-16,711,TD kit,150,300,150,1,00016,India
563505,2023-03-16,712,graph paper,20,40,20,1,00016,India
856275,2023-03-16,708,sketchpen,15,40,25,1,00310,India
347374,2023-03-16,709,notebook,30,60,30,1,00285,India
347374,2023-03-16,713,ball pen,5,10,5,1,00285,India
347374,2023-03-16,704,scale,5,10,5,1,00285,India
837993,2023-03-16,713,ball pen,5,10,5,1,00261,India
837993,2023-03-16,702,pencil,2,5,3,1,00261,India
837993,2023-03-16,716,printing paper,200,400,200,1,00261,India
837993,2023-03-16,704,scale,5,10,5,1,00261,India
529439,2023-03-16,712,graph paper,20,40,20,1,00160,India
110645,2023-03-16,705,stencil,10,20,10,1,00067,India
964777,2023-03-16,707,marker,20,40,20,1,00473,India
964777,2023-03-16,701,gel pen,5,10,5,1,00473,India
964777,2023-03-16,712,graph paper,20,40,20,1,00473,India
686583,2023-03-16,709,notebook,30,60,30,1,00193,India
630986,2023-03-16,701,gel pen,5,10,5,1,00261,India
630986,2023-03-16,715,folder,5,15,10,1,00261,India
630986,2023-03-16,706,sharpener,3,8,5,1,00261,India
431281,2023-03-16,713,ball pen,5,10,5,1,00036,India
431281,2023-03-16,712,graph paper,20,40,20,1,00036,India
897621,2023-03-17,714,carbon paper,15,30,15,1,00409,India
897621,2023-03-17,713,ball pen,5,10,5,1,00409,India
897621,2023-03-17,705,stencil,10,20,10,1,00409,India
897621,2023-03-17,703,eraser,1,3,2,1,00409,India
112283,2023-03-17,711,TD kit,150,300,150,1,00494,India
112283,2023-03-17,705,stencil,10,20,10,1,00494,India
112283,2023-03-17,714,carbon paper,15,30,15,1,00494,India
112283,2023-03-17,701,gel pen,5,10,5,1,00494,India
887100,2023-03-17,704,scale,5,10,5,1,00412,India
887100,2023-03-17,705,stencil,10,20,10,1,00412,India
536406,2023-03-17,702,pencil,2,5,3,1,00493,India
536406,2023-03-17,703,eraser,1,3,2,1,00493,India
536406,2023-03-17,704,scale,5,10,5,1,00493,India
961240,2023-03-17,708,sketchpen,15,40,25,1,00239,India
961240,2023-03-17,706,sharpener,3,8,5,1,00239,India
961240,2023-03-17,703,eraser,1,3,2,1,00239,India
961240,2023-03-17,717,spiral bound book,50,100,50,1,00239,India
244995,2023-03-17,707,marker,20,40,20,1,00302,India
244995,2023-03-17,712,graph paper,20,40,20,1,00302,India
278254,2023-03-17,707,marker,20,40,20,1,00322,India
278254,2023-03-17,712,graph paper,20,40,20,1,00322,India
278254,2023-03-17,705,stencil,10,20,10,1,00322,India
278254,2023-03-17,703,eraser,1,3,2,1,00322,India
278254,2023-03-17,709,notebook,30,60,30,1,00322,India
957216,2023-03-17,702,pencil,2,5,3,1,00309,India
626371,2023-03-17,701,gel pen,5,10,5,1,00058,India
626371,2023-03-17,713,ball pen,5,10,5,1,00058,India
626371,2023-03-17,710,geometry box,100,150,50,1,00058,India
626371,2023-03-17,703,eraser,1,3,2,1,00058,India
105180,2023-03-17,710,geometry box,100,150,50,1,00232,India
707276,2023-03-17,706,sharpener,3,8,5,1,00109,India
707276,2023-03-17,716,printing paper,200,400,200,1,00109,India
707276,2023-03-17,710,geometry box,100,150,50,1,00109,India
707276,2023-03-17,702,pencil,2,5,3,1,00109,India
321092,2023-03-17,713,ball pen,5,10,5,1,00164,India
321092,2023-03-17,706,sharpener,3,8,5,1,00164,India
521870,2023-03-17,714,carbon paper,15,30,15,1,00477,India
521870,2023-03-17,708,sketchpen,15,40,25,1,00477,India
534103,2023-03-17,716,printing paper,200,400,200,1,00421,India
454347,2023-03-17,701,gel pen,5,10,5,1,00004,India
454347,2023-03-17,709,notebook,30,60,30,1,00004,India
454347,2023-03-17,715,folder,5,15,10,1,00004,India
117476,2023-03-17,706,sharpener,3,8,5,1,00478,India
117476,2023-03-17,717,spiral bound book,50,100,50,1,00478,India
117476,2023-03-17,710,geometry box,100,150,50,1,00478,India
624088,2023-03-17,714,carbon paper,15,30,15,1,00466,India
624088,2023-03-17,709,notebook,30,60,30,1,00466,India
866201,2023-03-17,704,scale,5,10,5,1,00377,India
866201,2023-03-17,703,eraser,1,3,2,1,00377,India
866201,2023-03-17,717,spiral bound book,50,100,50,1,00377,India
866201,2023-03-17,710,geometry box,100,150,50,1,00377,India
866201,2023-03-17,705,stencil,10,20,10,1,00377,India
710975,2023-03-17,704,scale,5,10,5,1,00415,India
710975,2023-03-17,708,sketchpen,15,40,25,1,00415,India
710975,2023-03-17,711,TD kit,150,300,150,1,00415,India
710975,2023-03-17,707,marker,20,40,20,1,00415,India
126706,2023-03-17,709,notebook,30,60,30,1,00241,India
126706,2023-03-17,703,eraser,1,3,2,1,00241,India
126706,2023-03-17,705,stencil,10,20,10,1,00241,India
478534,2023-03-17,702,pencil,2,5,3,1,00368,India
478534,2023-03-17,706,sharpener,3,8,5,1,00368,India
478534,2023-03-17,703,eraser,1,3,2,1,00368,India
307526,2023-03-17,717,spiral bound book,50,100,50,1,00329,India
307526,2023-03-17,702,pencil,2,5,3,1,00329,India
307526,2023-03-17,709,notebook,30,60,30,1,00329,India
307526,2023-03-17,708,sketchpen,15,40,25,1,00329,India
982322,2023-03-17,714,carbon paper,15,30,15,1,00196,India
982322,2023-03-17,703,eraser,1,3,2,1,00196,India
158075,2023-03-17,707,marker,20,40,20,1,00437,India
158075,2023-03-17,711,TD kit,150,300,150,1,00437,India
158075,2023-03-17,717,spiral bound book,50,100,50,1,00437,India
146017,2023-03-17,710,geometry box,100,150,50,1,00045,India
533741,2023-03-17,707,marker,20,40,20,1,00442,India
734805,2023-03-17,707,marker,20,40,20,1,00195,India
734805,2023-03-17,708,sketchpen,15,40,25,1,00195,India
827916,2023-03-17,711,TD kit,150,300,150,1,00022,India
827916,2023-03-17,702,pencil,2,5,3,1,00022,India
827916,2023-03-17,707,marker,20,40,20,1,00022,India
463357,2023-03-17,712,graph paper,20,40,20,1,00290,India
463357,2023-03-17,709,notebook,30,60,30,1,00290,India
463357,2023-03-17,706,sharpener,3,8,5,1,00290,India
897777,2023-03-17,710,geometry box,100,150,50,1,00256,India
897777,2023-03-17,708,sketchpen,15,40,25,1,00256,India
604980,2023-03-17,710,geometry box,100,150,50,1,00042,India
604980,2023-03-17,702,pencil,2,5,3,1,00042,India
604980,2023-03-17,701,gel pen,5,10,5,1,00042,India
257760,2023-03-17,704,scale,5,10,5,1,00008,India
305188,2023-03-17,708,sketchpen,15,40,25,1,00026,India
305188,2023-03-17,716,printing paper,200,400,200,1,00026,India
368326,2023-03-17,704,scale,5,10,5,1,00374,India
368326,2023-03-17,714,carbon paper,15,30,15,1,00374,India
368326,2023-03-17,708,sketchpen,15,40,25,1,00374,India
368326,2023-03-17,705,stencil,10,20,10,1,00374,India
665074,2023-03-17,708,sketchpen,15,40,25,1,00031,India
618115,2023-03-18,705,stencil,10,20,10,1,00424,India
618115,2023-03-18,716,printing paper,200,400,200,1,00424,India
618115,2023-03-18,717,spiral bound book,50,100,50,1,00424,India
318736,2023-03-18,701,gel pen,5,10,5,1,00391,India
318736,2023-03-18,716,printing paper,200,400,200,1,00391,India
693121,2023-03-18,715,folder,5,15,10,1,00026,India
693121,2023-03-18,709,notebook,30,60,30,1,00026,India
801593,2023-03-18,710,geometry box,100,150,50,1,00351,India
801593,2023-03-18,702,pencil,2,5,3,1,00351,India
801593,2023-03-18,703,eraser,1,3,2,1,00351,India
801593,2023-03-18,704,scale,5,10,5,1,00351,India
571211,2023-03-18,705,stencil,10,20,10,1,00429,India
571211,2023-03-18,711,TD kit,150,300,150,1,00429,India
571211,2023-03-18,712,graph paper,20,40,20,1,00429,India
583047,2023-03-18,712,graph paper,20,40,20,1,00399,India
583047,2023-03-18,703,eraser,1,3,2,1,00399,India
583047,2023-03-18,704,scale,5,10,5,1,00399,India
583047,2023-03-18,716,printing paper,200,400,200,1,00399,India
245558,2023-03-18,712,graph paper,20,40,20,1,00292,India
245558,2023-03-18,714,carbon paper,15,30,15,1,00292,India
245558,2023-03-18,706,sharpener,3,8,5,1,00292,India
856287,2023-03-18,701,gel pen,5,10,5,1,00388,India
856287,2023-03-18,710,geometry box,100,150,50,1,00388,India
856287,2023-03-18,703,eraser,1,3,2,1,00388,India
324821,2023-03-18,703,eraser,1,3,2,1,00397,India
206537,2023-03-18,717,spiral bound book,50,100,50,1,00154,India
863034,2023-03-18,701,gel pen,5,10,5,1,00092,India
863034,2023-03-18,704,scale,5,10,5,1,00092,India
863034,2023-03-18,707,marker,20,40,20,1,00092,India
863034,2023-03-18,708,sketchpen,15,40,25,1,00092,India
482996,2023-03-18,704,scale,5,10,5,1,00186,India
482996,2023-03-18,706,sharpener,3,8,5,1,00186,India
482996,2023-03-18,712,graph paper,20,40,20,1,00186,India
482996,2023-03-18,701,gel pen,5,10,5,1,00186,India
320525,2023-03-18,711,TD kit,150,300,150,1,00009,India
320525,2023-03-18,715,folder,5,15,10,1,00009,India
320525,2023-03-18,708,sketchpen,15,40,25,1,00009,India
417437,2023-03-18,713,ball pen,5,10,5,1,00479,India
417437,2023-03-18,704,scale,5,10,5,1,00479,India
417437,2023-03-18,711,TD kit,150,300,150,1,00479,India
417437,2023-03-18,714,carbon paper,15,30,15,1,00479,India
977871,2023-03-18,714,carbon paper,15,30,15,1,00298,India
977871,2023-03-18,716,printing paper,200,400,200,1,00298,India
977871,2023-03-18,715,folder,5,15,10,1,00298,India
924714,2023-03-18,704,scale,5,10,5,1,00410,India
924714,2023-03-18,712,graph paper,20,40,20,1,00410,India
924714,2023-03-18,709,notebook,30,60,30,1,00410,India
847964,2023-03-18,711,TD kit,150,300,150,1,00373,India
847964,2023-03-18,706,sharpener,3,8,5,1,00373,India
100026,2023-03-18,705,stencil,10,20,10,1,00188,India
100026,2023-03-18,706,sharpener,3,8,5,1,00188,India
100026,2023-03-18,716,printing paper,200,400,200,1,00188,India
781045,2023-03-18,717,spiral bound book,50,100,50,1,00238,India
781045,2023-03-18,714,carbon paper,15,30,15,1,00238,India
921410,2023-03-18,711,TD kit,150,300,150,1,00214,India
921410,2023-03-18,701,gel pen,5,10,5,1,00214,India
753862,2023-03-18,707,marker,20,40,20,1,00441,India
753862,2023-03-18,717,spiral bound book,50,100,50,1,00441,India
753862,2023-03-18,704,scale,5,10,5,1,00441,India
125354,2023-03-18,706,sharpener,3,8,5,1,00191,India
125354,2023-03-18,717,spiral bound book,50,100,50,1,00191,India
125354,2023-03-18,713,ball pen,5,10,5,1,00191,India
677623,2023-03-18,716,printing paper,200,400,200,1,00033,India
677623,2023-03-18,707,marker,20,40,20,1,00033,India
677623,2023-03-18,714,carbon paper,15,30,15,1,00033,India
677623,2023-03-18,710,geometry box,100,150,50,1,00033,India
981907,2023-03-18,706,sharpener,3,8,5,1,00486,India
151048,2023-03-18,702,pencil,2,5,3,1,00009,India
151048,2023-03-18,705,stencil,10,20,10,1,00009,India
692930,2023-03-18,713,ball pen,5,10,5,1,00499,India
692930,2023-03-18,704,scale,5,10,5,1,00499,India
839478,2023-03-18,714,carbon paper,15,30,15,1,00360,India
839478,2023-03-18,704,scale,5,10,5,1,00360,India
839478,2023-03-18,715,folder,5,15,10,1,00360,India
839478,2023-03-18,701,gel pen,5,10,5,1,00360,India
471826,2023-03-18,708,sketchpen,15,40,25,1,00203,India
471826,2023-03-18,703,eraser,1,3,2,1,00203,India
983040,2023-03-18,711,TD kit,150,300,150,1,00214,India
983040,2023-03-18,717,spiral bound book,50,100,50,1,00214,India
983040,2023-03-18,703,eraser,1,3,2,1,00214,India
983040,2023-03-18,716,printing paper,200,400,200,1,00214,India
983040,2023-03-18,704,scale,5,10,5,1,00214,India
794158,2023-03-18,704,scale,5,10,5,1,00144,India
349189,2023-03-18,703,eraser,1,3,2,1,00070,India
412621,2023-03-19,711,TD kit,150,300,150,1,00472,India
412621,2023-03-19,707,marker,20,40,20,1,00472,India
412621,2023-03-19,713,ball pen,5,10,5,1,00472,India
376200,2023-03-19,715,folder,5,15,10,1,00042,India
376200,2023-03-19,716,printing paper,200,400,200,1,00042,India
376200,2023-03-19,703,eraser,1,3,2,1,00042,India
376200,2023-03-19,702,pencil,2,5,3,1,00042,India
394544,2023-03-19,710,geometry box,100,150,50,1,00152,India
394544,2023-03-19,703,eraser,1,3,2,1,00152,India
394544,2023-03-19,712,graph paper,20,40,20,1,00152,India
178285,2023-03-19,713,ball pen,5,10,5,1,00243,India
178285,2023-03-19,706,sharpener,3,8,5,1,00243,India
178285,2023-03-19,702,pencil,2,5,3,1,00243,India
178285,2023-03-19,712,graph paper,20,40,20,1,00243,India
228671,2023-03-19,707,marker,20,40,20,1,00450,India
205443,2023-03-19,712,graph paper,20,40,20,1,00214,India
205443,2023-03-19,702,pencil,2,5,3,1,00214,India
205443,2023-03-19,713,ball pen,5,10,5,1,00214,India
205443,2023-03-19,714,carbon paper,15,30,15,1,00214,India
205443,2023-03-19,710,geometry box,100,150,50,1,00214,India
715781,2023-03-19,702,pencil,2,5,3,1,00486,India
400971,2023-03-19,705,stencil,10,20,10,1,00003,India
400971,2023-03-19,709,notebook,30,60,30,1,00003,India
400971,2023-03-19,710,geometry box,100,150,50,1,00003,India
724834,2023-03-19,716,printing paper,200,400,200,1,00269,India
724834,2023-03-19,715,folder,5,15,10,1,00269,India
724834,2023-03-19,706,sharpener,3,8,5,1,00269,India
292275,2023-03-19,714,carbon paper,15,30,15,1,00176,India
292275,2023-03-19,717,spiral bound book,50,100,50,1,00176,India
292275,2023-03-19,704,scale,5,10,5,1,00176,India
292275,2023-03-19,706,sharpener,3,8,5,1,00176,India
292275,2023-03-19,711,TD kit,150,300,150,1,00176,India
134559,2023-03-19,710,geometry box,100,150,50,1,00069,India
408949,2023-03-19,707,marker,20,40,20,1,00464,India
408949,2023-03-19,701,gel pen,5,10,5,1,00464,India
408949,2023-03-19,703,eraser,1,3,2,1,00464,India
408949,2023-03-19,716,printing paper,200,400,200,1,00464,India
408949,2023-03-19,704,scale,5,10,5,1,00464,India
571829,2023-03-19,704,scale,5,10,5,1,00209,India
571829,2023-03-19,707,marker,20,40,20,1,00209,India
571829,2023-03-19,703,eraser,1,3,2,1,00209,India
739601,2023-03-19,705,stencil,10,20,10,1,00202,India
739601,2023-03-19,714,carbon paper,15,30,15,1,00202,India
739601,2023-03-19,703,eraser,1,3,2,1,00202,India
739601,2023-03-19,713,ball pen,5,10,5,1,00202,India
739601,2023-03-19,711,TD kit,150,300,150,1,00202,India
670277,2023-03-19,706,sharpener,3,8,5,1,00051,India
332451,2023-03-19,713,ball pen,5,10,5,1,00269,India
332451,2023-03-19,717,spiral bound book,50,100,50,1,00269,India
332451,2023-03-19,716,printing paper,200,400,200,1,00269,India
332451,2023-03-19,707,marker,20,40,20,1,00269,India
302475,2023-03-19,713,ball pen,5,10,5,1,00084,India
302475,2023-03-19,701,gel pen,5,10,5,1,00084,India
673325,2023-03-19,704,scale,5,10,5,1,00261,India
673325,2023-03-19,708,sketchpen,15,40,25,1,00261,India
673325,2023-03-19,710,geometry box,100,150,50,1,00261,India
193347,2023-03-19,701,gel pen,5,10,5,1,00240,India
614853,2023-03-19,707,marker,20,40,20,1,00218,India
614853,2023-03-19,701,gel pen,5,10,5,1,00218,India
614853,2023-03-19,712,graph paper,20,40,20,1,00218,India
692384,2023-03-19,717,spiral bound book,50,100,50,1,00404,India
692384,2023-03-19,708,sketchpen,15,40,25,1,00404,India
167483,2023-03-19,708,sketchpen,15,40,25,1,00228,India
167483,2023-03-19,714,carbon paper,15,30,15,1,00228,India
167483,2023-03-19,702,pencil,2,5,3,1,00228,India
167483,2023-03-19,703,eraser,1,3,2,1,00228,India
167483,2023-03-19,704,scale,5,10,5,1,00228,India
812372,2023-03-19,714,carbon paper,15,30,15,1,00158,India
812372,2023-03-19,707,marker,20,40,20,1,00158,India
812372,2023-03-19,702,pencil,2,5,3,1,00158,India
812372,2023-03-19,703,eraser,1,3,2,1,00158,India
875619,2023-03-19,702,pencil,2,5,3,1,00199,India
875619,2023-03-19,701,gel pen,5,10,5,1,00199,India
875619,2023-03-19,710,geometry box,100,150,50,1,00199,India
875619,2023-03-19,703,eraser,1,3,2,1,00199,India
875619,2023-03-19,707,marker,20,40,20,1,00199,India
118451,2023-03-19,715,folder,5,15,10,1,00414,India
118451,2023-03-19,702,pencil,2,5,3,1,00414,India
574309,2023-03-19,711,TD kit,150,300,150,1,00234,India
574309,2023-03-19,710,geometry box,100,150,50,1,00234,India
574309,2023-03-19,702,pencil,2,5,3,1,00234,India
760488,2023-03-19,705,stencil,10,20,10,1,00342,India
760488,2023-03-19,704,scale,5,10,5,1,00342,India
760488,2023-03-19,706,sharpener,3,8,5,1,00342,India
326855,2023-03-19,701,gel pen,5,10,5,1,00429,India
326855,2023-03-19,705,stencil,10,20,10,1,00429,India
326855,2023-03-19,713,ball pen,5,10,5,1,00429,India
976097,2023-03-19,712,graph paper,20,40,20,1,00445,India
976097,2023-03-19,710,geometry box,100,150,50,1,00445,India
735378,2023-03-19,703,eraser,1,3,2,1,00370,India
735378,2023-03-19,706,sharpener,3,8,5,1,00370,India
735378,2023-03-19,714,carbon paper,15,30,15,1,00370,India
735378,2023-03-19,713,ball pen,5,10,5,1,00370,India
809034,2023-03-19,703,eraser,1,3,2,1,00087,India
809034,2023-03-19,709,notebook,30,60,30,1,00087,India
809034,2023-03-19,701,gel pen,5,10,5,1,00087,India
147969,2023-03-19,702,pencil,2,5,3,1,00040,India
147969,2023-03-19,712,graph paper,20,40,20,1,00040,India
147969,2023-03-19,709,notebook,30,60,30,1,00040,India
147969,2023-03-19,717,spiral bound book,50,100,50,1,00040,India
147969,2023-03-19,705,stencil,10,20,10,1,00040,India
793162,2023-03-19,716,printing paper,200,400,200,1,00293,India
793162,2023-03-19,710,geometry box,100,150,50,1,00293,India
793162,2023-03-19,711,TD kit,150,300,150,1,00293,India
793162,2023-03-19,704,scale,5,10,5,1,00293,India
936005,2023-03-19,712,graph paper,20,40,20,1,00259,India
936005,2023-03-19,707,marker,20,40,20,1,00259,India
936005,2023-03-19,710,geometry box,100,150,50,1,00259,India
936005,2023-03-19,714,carbon paper,15,30,15,1,00259,India
513193,2023-03-19,715,folder,5,15,10,1,00121,India
513193,2023-03-19,706,sharpener,3,8,5,1,00121,India
513193,2023-03-19,702,pencil,2,5,3,1,00121,India
900737,2023-03-19,706,sharpener,3,8,5,1,00283,India
214362,2023-03-19,709,notebook,30,60,30,1,00389,India
214362,2023-03-19,703,eraser,1,3,2,1,00389,India
214362,2023-03-19,705,stencil,10,20,10,1,00389,India
214362,2023-03-19,714,carbon paper,15,30,15,1,00389,India
143129,2023-03-19,708,sketchpen,15,40,25,1,00450,India
143129,2023-03-19,707,marker,20,40,20,1,00450,India
152402,2023-03-19,707,marker,20,40,20,1,00324,India
152402,2023-03-19,705,stencil,10,20,10,1,00324,India
152402,2023-03-19,713,ball pen,5,10,5,1,00324,India
152402,2023-03-19,703,eraser,1,3,2,1,00324,India
275393,2023-03-19,707,marker,20,40,20,1,00325,India
275393,2023-03-19,717,spiral bound book,50,100,50,1,00325,India
275393,2023-03-19,708,sketchpen,15,40,25,1,00325,India
118799,2023-03-19,704,scale,5,10,5,1,00419,India
118799,2023-03-19,707,marker,20,40,20,1,00419,India
118799,2023-03-19,711,TD kit,150,300,150,1,00419,India
810021,2023-03-19,701,gel pen,5,10,5,1,00457,India
810021,2023-03-19,714,carbon paper,15,30,15,1,00457,India
810021,2023-03-19,710,geometry box,100,150,50,1,00457,India
810021,2023-03-19,716,printing paper,200,400,200,1,00457,India
350778,2023-03-20,702,pencil,2,5,3,1,00315,India
350778,2023-03-20,716,printing paper,200,400,200,1,00315,India
461861,2023-03-20,705,stencil,10,20,10,1,00267,India
461861,2023-03-20,702,pencil,2,5,3,1,00267,India
461861,2023-03-20,706,sharpener,3,8,5,1,00267,India
139534,2023-03-20,710,geometry box,100,150,50,1,00145,India
139534,2023-03-20,716,printing paper,200,400,200,1,00145,India
139534,2023-03-20,709,notebook,30,60,30,1,00145,India
139534,2023-03-20,707,marker,20,40,20,1,00145,India
319371,2023-03-20,709,notebook,30,60,30,1,00092,India
319371,2023-03-20,716,printing paper,200,400,200,1,00092,India
134590,2023-03-20,711,TD kit,150,300,150,1,00419,India
134590,2023-03-20,702,pencil,2,5,3,1,00419,India
134590,2023-03-20,703,eraser,1,3,2,1,00419,India
134590,2023-03-20,706,sharpener,3,8,5,1,00419,India
134590,2023-03-20,713,ball pen,5,10,5,1,00419,India
660159,2023-03-20,715,folder,5,15,10,1,00188,India
758589,2023-03-20,713,ball pen,5,10,5,1,00091,India
758589,2023-03-20,706,sharpener,3,8,5,1,00091,India
758589,2023-03-20,716,printing paper,200,400,200,1,00091,India
723762,2023-03-20,705,stencil,10,20,10,1,00191,India
745072,2023-03-20,717,spiral bound book,50,100,50,1,00017,India
745072,2023-03-20,705,stencil,10,20,10,1,00017,India
745072,2023-03-20,703,eraser,1,3,2,1,00017,India
745072,2023-03-20,713,ball pen,5,10,5,1,00017,India
319792,2023-03-20,715,folder,5,15,10,1,00049,India
122543,2023-03-20,713,ball pen,5,10,5,1,00454,India
122543,2023-03-20,710,geometry box,100,150,50,1,00454,India
122543,2023-03-20,711,TD kit,150,300,150,1,00454,India
122543,2023-03-20,716,printing paper,200,400,200,1,00454,India
911602,2023-03-20,704,scale,5,10,5,1,00464,India
411343,2023-03-20,712,graph paper,20,40,20,1,00313,India
411343,2023-03-20,702,pencil,2,5,3,1,00313,India
448062,2023-03-20,707,marker,20,40,20,1,00237,India
448062,2023-03-20,705,stencil,10,20,10,1,00237,India
448062,2023-03-20,710,geometry box,100,150,50,1,00237,India
565776,2023-03-20,712,graph paper,20,40,20,1,00313,India
565776,2023-03-20,708,sketchpen,15,40,25,1,00313,India
565776,2023-03-20,702,pencil,2,5,3,1,00313,India
565776,2023-03-20,714,carbon paper,15,30,15,1,00313,India
565776,2023-03-20,716,printing paper,200,400,200,1,00313,India
605287,2023-03-20,702,pencil,2,5,3,1,00091,India
605287,2023-03-20,711,TD kit,150,300,150,1,00091,India
605287,2023-03-20,701,gel pen,5,10,5,1,00091,India
605287,2023-03-20,706,sharpener,3,8,5,1,00091,India
605287,2023-03-20,712,graph paper,20,40,20,1,00091,India
170225,2023-03-20,712,graph paper,20,40,20,1,00185,India
170225,2023-03-20,707,marker,20,40,20,1,00185,India
861922,2023-03-20,707,marker,20,40,20,1,00292,India
288968,2023-03-20,703,eraser,1,3,2,1,00392,India
288968,2023-03-20,706,sharpener,3,8,5,1,00392,India
288968,2023-03-20,711,TD kit,150,300,150,1,00392,India
288968,2023-03-20,708,sketchpen,15,40,25,1,00392,India
609313,2023-03-20,709,notebook,30,60,30,1,00200,India
609313,2023-03-20,713,ball pen,5,10,5,1,00200,India
609313,2023-03-20,712,graph paper,20,40,20,1,00200,India
568619,2023-03-20,709,notebook,30,60,30,1,00039,India
568619,2023-03-20,705,stencil,10,20,10,1,00039,India
568619,2023-03-20,710,geometry box,100,150,50,1,00039,India
908873,2023-03-20,708,sketchpen,15,40,25,1,00445,India
908873,2023-03-20,715,folder,5,15,10,1,00445,India
908873,2023-03-20,711,TD kit,150,300,150,1,00445,India
865857,2023-03-20,717,spiral bound book,50,100,50,1,00489,India
865857,2023-03-20,714,carbon paper,15,30,15,1,00489,India
865857,2023-03-20,704,scale,5,10,5,1,00489,India
576458,2023-03-20,714,carbon paper,15,30,15,1,00135,India
576458,2023-03-20,703,eraser,1,3,2,1,00135,India
847669,2023-03-20,717,spiral bound book,50,100,50,1,00490,India
889134,2023-03-20,707,marker,20,40,20,1,00441,India
787225,2023-03-20,715,folder,5,15,10,1,00365,India
787225,2023-03-20,705,stencil,10,20,10,1,00365,India
190523,2023-03-20,701,gel pen,5,10,5,1,00307,India
883105,2023-03-20,704,scale,5,10,5,1,00062,India
969183,2023-03-20,702,pencil,2,5,3,1,00464,India
969183,2023-03-20,715,folder,5,15,10,1,00464,India
969183,2023-03-20,710,geometry box,100,150,50,1,00464,India
244804,2023-03-20,709,notebook,30,60,30,1,00230,India
117071,2023-03-20,707,marker,20,40,20,1,00133,India
756069,2023-03-20,707,marker,20,40,20,1,00402,India
756069,2023-03-20,708,sketchpen,15,40,25,1,00402,India
227316,2023-03-20,708,sketchpen,15,40,25,1,00124,India
332561,2023-03-20,708,sketchpen,15,40,25,1,00457,India
332561,2023-03-20,713,ball pen,5,10,5,1,00457,India
332561,2023-03-20,715,folder,5,15,10,1,00457,India
332561,2023-03-20,707,marker,20,40,20,1,00457,India
145253,2023-03-20,705,stencil,10,20,10,1,00438,India
654176,2023-03-20,708,sketchpen,15,40,25,1,00411,India
770990,2023-03-20,701,gel pen,5,10,5,1,00374,India
770990,2023-03-20,709,notebook,30,60,30,1,00374,India
770990,2023-03-20,712,graph paper,20,40,20,1,00374,India
770990,2023-03-20,705,stencil,10,20,10,1,00374,India
544682,2023-03-20,715,folder,5,15,10,1,00145,India
544682,2023-03-20,716,printing paper,200,400,200,1,00145,India
544682,2023-03-20,711,TD kit,150,300,150,1,00145,India
995119,2023-03-20,713,ball pen,5,10,5,1,00263,India
995119,2023-03-20,712,graph paper,20,40,20,1,00263,India
921387,2023-03-20,709,notebook,30,60,30,1,00009,India
921387,2023-03-20,715,folder,5,15,10,1,00009,India
921387,2023-03-20,711,TD kit,150,300,150,1,00009,India
727467,2023-03-20,708,sketchpen,15,40,25,1,00223,India
727467,2023-03-20,711,TD kit,150,300,150,1,00223,India
727467,2023-03-20,706,sharpener,3,8,5,1,00223,India
537544,2023-03-20,707,marker,20,40,20,1,00065,India
537544,2023-03-20,712,graph paper,20,40,20,1,00065,India
994760,2023-03-20,703,eraser,1,3,2,1,00207,India
994760,2023-03-20,713,ball pen,5,10,5,1,00207,India
890613,2023-03-20,713,ball pen,5,10,5,1,00135,India
285460,2023-03-20,708,sketchpen,15,40,25,1,00056,India
285460,2023-03-20,713,ball pen,5,10,5,1,00056,India
405484,2023-03-20,702,pencil,2,5,3,1,00386,India
405484,2023-03-20,714,carbon paper,15,30,15,1,00386,India
405484,2023-03-20,716,printing paper,200,400,200,1,00386,India
405484,2023-03-20,709,notebook,30,60,30,1,00386,India
311958,2023-03-20,703,eraser,1,3,2,1,00230,India
311958,2023-03-20,706,sharpener,3,8,5,1,00230,India
311958,2023-03-20,701,gel pen,5,10,5,1,00230,India
655930,2023-03-20,702,pencil,2,5,3,1,00387,India
655930,2023-03-20,708,sketchpen,15,40,25,1,00387,India
592002,2023-03-20,701,gel pen,5,10,5,1,00134,India
592002,2023-03-20,705,stencil,10,20,10,1,00134,India
592002,2023-03-20,710,geometry box,100,150,50,1,00134,India
592002,2023-03-20,706,sharpener,3,8,5,1,00134,India
592002,2023-03-20,703,eraser,1,3,2,1,00134,India
367037,2023-03-21,701,gel pen,5,10,5,1,00049,India
367037,2023-03-21,713,ball pen,5,10,5,1,00049,India
367037,2023-03-21,702,pencil,2,5,3,1,00049,India
367037,2023-03-21,716,printing paper,200,400,200,1,00049,India
971608,2023-03-21,711,TD kit,150,300,150,1,00224,India
971608,2023-03-21,708,sketchpen,15,40,25,1,00224,India
122548,2023-03-21,712,graph paper,20,40,20,1,00418,India
122548,2023-03-21,705,stencil,10,20,10,1,00418,India
122548,2023-03-21,701,gel pen,5,10,5,1,00418,India
304847,2023-03-21,708,sketchpen,15,40,25,1,00005,India
304847,2023-03-21,716,printing paper,200,400,200,1,00005,India
702676,2023-03-21,707,marker,20,40,20,1,00189,India
702676,2023-03-21,703,eraser,1,3,2,1,00189,India
702676,2023-03-21,702,pencil,2,5,3,1,00189,India
702676,2023-03-21,709,notebook,30,60,30,1,00189,India
702676,2023-03-21,713,ball pen,5,10,5,1,00189,India
582979,2023-03-21,706,sharpener,3,8,5,1,00090,India
582979,2023-03-21,714,carbon paper,15,30,15,1,00090,India
582979,2023-03-21,716,printing paper,200,400,200,1,00090,India
631352,2023-03-21,702,pencil,2,5,3,1,00467,India
631352,2023-03-21,705,stencil,10,20,10,1,00467,India
777928,2023-03-21,715,folder,5,15,10,1,00170,India
777928,2023-03-21,712,graph paper,20,40,20,1,00170,India
777928,2023-03-21,705,stencil,10,20,10,1,00170,India
777928,2023-03-21,708,sketchpen,15,40,25,1,00170,India
817926,2023-03-21,717,spiral bound book,50,100,50,1,00485,India
655309,2023-03-21,714,carbon paper,15,30,15,1,00177,India
655309,2023-03-21,716,printing paper,200,400,200,1,00177,India
655309,2023-03-21,703,eraser,1,3,2,1,00177,India
692542,2023-03-21,712,graph paper,20,40,20,1,00412,India
692542,2023-03-21,716,printing paper,200,400,200,1,00412,India
620146,2023-03-21,701,gel pen,5,10,5,1,00440,India
620146,2023-03-21,708,sketchpen,15,40,25,1,00440,India
620146,2023-03-21,711,TD kit,150,300,150,1,00440,India
620146,2023-03-21,709,notebook,30,60,30,1,00440,India
620146,2023-03-21,706,sharpener,3,8,5,1,00440,India
951290,2023-03-21,714,carbon paper,15,30,15,1,00006,India
951290,2023-03-21,716,printing paper,200,400,200,1,00006,India
951290,2023-03-21,715,folder,5,15,10,1,00006,India
423809,2023-03-21,708,sketchpen,15,40,25,1,00134,India
423809,2023-03-21,710,geometry box,100,150,50,1,00134,India
423809,2023-03-21,716,printing paper,200,400,200,1,00134,India
423809,2023-03-21,704,scale,5,10,5,1,00134,India
371405,2023-03-21,702,pencil,2,5,3,1,00452,India
371405,2023-03-21,703,eraser,1,3,2,1,00452,India
191959,2023-03-21,702,pencil,2,5,3,1,00352,India
191959,2023-03-21,715,folder,5,15,10,1,00352,India
191959,2023-03-21,701,gel pen,5,10,5,1,00352,India
191959,2023-03-21,709,notebook,30,60,30,1,00352,India
650584,2023-03-21,713,ball pen,5,10,5,1,00410,India
650584,2023-03-21,711,TD kit,150,300,150,1,00410,India
650584,2023-03-21,708,sketchpen,15,40,25,1,00410,India
650584,2023-03-21,705,stencil,10,20,10,1,00410,India
650584,2023-03-21,714,carbon paper,15,30,15,1,00410,India
950738,2023-03-21,707,marker,20,40,20,1,00250,India
950738,2023-03-21,705,stencil,10,20,10,1,00250,India
950738,2023-03-21,706,sharpener,3,8,5,1,00250,India
950738,2023-03-21,716,printing paper,200,400,200,1,00250,India
961907,2023-03-21,702,pencil,2,5,3,1,00289,India
961907,2023-03-21,713,ball pen,5,10,5,1,00289,India
961907,2023-03-21,708,sketchpen,15,40,25,1,00289,India
961907,2023-03-21,707,marker,20,40,20,1,00289,India
486098,2023-03-21,709,notebook,30,60,30,1,00105,India
954639,2023-03-21,702,pencil,2,5,3,1,00125,India
954639,2023-03-21,701,gel pen,5,10,5,1,00125,India
954639,2023-03-21,716,printing paper,200,400,200,1,00125,India
954639,2023-03-21,711,TD kit,150,300,150,1,00125,India
740582,2023-03-21,715,folder,5,15,10,1,00413,India
307876,2023-03-21,712,graph paper,20,40,20,1,00487,India
307876,2023-03-21,702,pencil,2,5,3,1,00487,India
954132,2023-03-21,702,pencil,2,5,3,1,00224,India
251899,2023-03-21,710,geometry box,100,150,50,1,00057,India
251899,2023-03-21,708,sketchpen,15,40,25,1,00057,India
251899,2023-03-21,715,folder,5,15,10,1,00057,India
251899,2023-03-21,711,TD kit,150,300,150,1,00057,India
174431,2023-03-21,708,sketchpen,15,40,25,1,00119,India
163103,2023-03-21,712,graph paper,20,40,20,1,00020,India
163103,2023-03-21,705,stencil,10,20,10,1,00020,India
163103,2023-03-21,703,eraser,1,3,2,1,00020,India
163103,2023-03-21,704,scale,5,10,5,1,00020,India
708897,2023-03-21,713,ball pen,5,10,5,1,00361,India
708897,2023-03-21,716,printing paper,200,400,200,1,00361,India
854681,2023-03-21,708,sketchpen,15,40,25,1,00057,India
854681,2023-03-21,707,marker,20,40,20,1,00057,India
833902,2023-03-21,713,ball pen,5,10,5,1,00364,India
833902,2023-03-21,715,folder,5,15,10,1,00364,India
833902,2023-03-21,705,stencil,10,20,10,1,00364,India
936900,2023-03-21,704,scale,5,10,5,1,00137,India
304093,2023-03-21,713,ball pen,5,10,5,1,00252,India
699539,2023-03-21,716,printing paper,200,400,200,1,00214,India
699539,2023-03-21,712,graph paper,20,40,20,1,00214,India
699539,2023-03-21,711,TD kit,150,300,150,1,00214,India
699539,2023-03-21,714,carbon paper,15,30,15,1,00214,India
695287,2023-03-22,704,scale,5,10,5,1,00161,India
695287,2023-03-22,715,folder,5,15,10,1,00161,India
135220,2023-03-22,703,eraser,1,3,2,1,00374,India
135220,2023-03-22,712,graph paper,20,40,20,1,00374,India
135220,2023-03-22,716,printing paper,200,400,200,1,00374,India
119589,2023-03-22,708,sketchpen,15,40,25,1,00110,India
119589,2023-03-22,711,TD kit,150,300,150,1,00110,India
119589,2023-03-22,717,spiral bound book,50,100,50,1,00110,India
538414,2023-03-22,708,sketchpen,15,40,25,1,00405,India
538414,2023-03-22,704,scale,5,10,5,1,00405,India
538414,2023-03-22,703,eraser,1,3,2,1,00405,India
538414,2023-03-22,717,spiral bound book,50,100,50,1,00405,India
538414,2023-03-22,713,ball pen,5,10,5,1,00405,India
760643,2023-03-22,703,eraser,1,3,2,1,00051,India
942971,2023-03-22,708,sketchpen,15,40,25,1,00192,India
942971,2023-03-22,715,folder,5,15,10,1,00192,India
942971,2023-03-22,711,TD kit,150,300,150,1,00192,India
398131,2023-03-22,712,graph paper,20,40,20,1,00385,India
398131,2023-03-22,717,spiral bound book,50,100,50,1,00385,India
642239,2023-03-22,706,sharpener,3,8,5,1,00360,India
115653,2023-03-22,711,TD kit,150,300,150,1,00120,India
115653,2023-03-22,705,stencil,10,20,10,1,00120,India
248026,2023-03-22,714,carbon paper,15,30,15,1,00326,India
248026,2023-03-22,712,graph paper,20,40,20,1,00326,India
248026,2023-03-22,715,folder,5,15,10,1,00326,India
603209,2023-03-22,707,marker,20,40,20,1,00266,India
603209,2023-03-22,715,folder,5,15,10,1,00266,India
603209,2023-03-22,701,gel pen,5,10,5,1,00266,India
750955,2023-03-22,717,spiral bound book,50,100,50,1,00021,India
750955,2023-03-22,705,stencil,10,20,10,1,00021,India
788857,2023-03-22,711,TD kit,150,300,150,1,00073,India
788857,2023-03-22,715,folder,5,15,10,1,00073,India
788857,2023-03-22,706,sharpener,3,8,5,1,00073,India
788857,2023-03-22,701,gel pen,5,10,5,1,00073,India
877689,2023-03-22,713,ball pen,5,10,5,1,00065,India
877689,2023-03-22,711,TD kit,150,300,150,1,00065,India
744339,2023-03-22,706,sharpener,3,8,5,1,00154,India
744339,2023-03-22,717,spiral bound book,50,100,50,1,00154,India
147996,2023-03-22,702,pencil,2,5,3,1,00131,India
884391,2023-03-22,708,sketchpen,15,40,25,1,00412,India
744359,2023-03-22,709,notebook,30,60,30,1,00180,India
744359,2023-03-22,708,sketchpen,15,40,25,1,00180,India
744359,2023-03-22,716,printing paper,200,400,200,1,00180,India
496748,2023-03-22,711,TD kit,150,300,150,1,00096,India
496748,2023-03-22,712,graph paper,20,40,20,1,00096,India
496748,2023-03-22,710,geometry box,100,150,50,1,00096,India
496748,2023-03-22,709,notebook,30,60,30,1,00096,India
496748,2023-03-22,715,folder,5,15,10,1,00096,India
588385,2023-03-22,702,pencil,2,5,3,1,00198,India
669007,2023-03-22,717,spiral bound book,50,100,50,1,00404,India
669007,2023-03-22,704,scale,5,10,5,1,00404,India
710660,2023-03-22,707,marker,20,40,20,1,00108,India
710660,2023-03-22,717,spiral bound book,50,100,50,1,00108,India
710660,2023-03-22,713,ball pen,5,10,5,1,00108,India
653704,2023-03-22,703,eraser,1,3,2,1,00106,India
653704,2023-03-22,707,marker,20,40,20,1,00106,India
258019,2023-03-22,712,graph paper,20,40,20,1,00155,India
258019,2023-03-22,706,sharpener,3,8,5,1,00155,India
258019,2023-03-22,705,stencil,10,20,10,1,00155,India
258019,2023-03-22,711,TD kit,150,300,150,1,00155,India
258019,2023-03-22,713,ball pen,5,10,5,1,00155,India
762247,2023-03-22,708,sketchpen,15,40,25,1,00327,India
688794,2023-03-22,716,printing paper,200,400,200,1,00010,India
744828,2023-03-22,708,sketchpen,15,40,25,1,00213,India
744828,2023-03-22,703,eraser,1,3,2,1,00213,India
650472,2023-03-22,702,pencil,2,5,3,1,00440,India
650472,2023-03-22,716,printing paper,200,400,200,1,00440,India
650472,2023-03-22,717,spiral bound book,50,100,50,1,00440,India
650472,2023-03-22,704,scale,5,10,5,1,00440,India
264191,2023-03-22,706,sharpener,3,8,5,1,00225,India
622811,2023-03-22,712,graph paper,20,40,20,1,00406,India
622811,2023-03-22,710,geometry box,100,150,50,1,00406,India
737445,2023-03-22,707,marker,20,40,20,1,00345,India
737445,2023-03-22,716,printing paper,200,400,200,1,00345,India
737445,2023-03-22,715,folder,5,15,10,1,00345,India
737445,2023-03-22,714,carbon paper,15,30,15,1,00345,India
993334,2023-03-22,701,gel pen,5,10,5,1,00090,India
993334,2023-03-22,706,sharpener,3,8,5,1,00090,India
993334,2023-03-22,709,notebook,30,60,30,1,00090,India
909494,2023-03-23,704,scale,5,10,5,1,00199,India
909494,2023-03-23,712,graph paper,20,40,20,1,00199,India
909494,2023-03-23,707,marker,20,40,20,1,00199,India
909494,2023-03-23,715,folder,5,15,10,1,00199,India
839750,2023-03-23,716,printing paper,200,400,200,1,00157,India
839750,2023-03-23,708,sketchpen,15,40,25,1,00157,India
839750,2023-03-23,705,stencil,10,20,10,1,00157,India
133030,2023-03-23,711,TD kit,150,300,150,1,00068,India
133030,2023-03-23,715,folder,5,15,10,1,00068,India
478766,2023-03-23,717,spiral bound book,50,100,50,1,00105,India
478766,2023-03-23,703,eraser,1,3,2,1,00105,India
597618,2023-03-23,711,TD kit,150,300,150,1,00490,India
597618,2023-03-23,715,folder,5,15,10,1,00490,India
597618,2023-03-23,703,eraser,1,3,2,1,00490,India
957751,2023-03-23,717,spiral bound book,50,100,50,1,00265,India
957751,2023-03-23,715,folder,5,15,10,1,00265,India
957751,2023-03-23,702,pencil,2,5,3,1,00265,India
957751,2023-03-23,714,carbon paper,15,30,15,1,00265,India
226136,2023-03-23,706,sharpener,3,8,5,1,00253,India
226136,2023-03-23,704,scale,5,10,5,1,00253,India
797535,2023-03-23,709,notebook,30,60,30,1,00448,India
797535,2023-03-23,712,graph paper,20,40,20,1,00448,India
797535,2023-03-23,717,spiral bound book,50,100,50,1,00448,India
797535,2023-03-23,713,ball pen,5,10,5,1,00448,India
917071,2023-03-23,716,printing paper,200,400,200,1,00035,India
917071,2023-03-23,702,pencil,2,5,3,1,00035,India
110570,2023-03-23,708,sketchpen,15,40,25,1,00431,India
110570,2023-03-23,716,printing paper,200,400,200,1,00431,India
855001,2023-03-23,712,graph paper,20,40,20,1,00244,India
855001,2023-03-23,713,ball pen,5,10,5,1,00244,India
855001,2023-03-23,716,printing paper,200,400,200,1,00244,India
855001,2023-03-23,717,spiral bound book,50,100,50,1,00244,India
217484,2023-03-23,707,marker,20,40,20,1,00458,India
324299,2023-03-23,704,scale,5,10,5,1,00084,India
324299,2023-03-23,701,gel pen,5,10,5,1,00084,India
324299,2023-03-23,710,geometry box,100,150,50,1,00084,India
503262,2023-03-23,706,sharpener,3,8,5,1,00284,India
503262,2023-03-23,717,spiral bound book,50,100,50,1,00284,India
503262,2023-03-23,703,eraser,1,3,2,1,00284,India
503262,2023-03-23,710,geometry box,100,150,50,1,00284,India
983074,2023-03-23,703,eraser,1,3,2,1,00496,India
674356,2023-03-23,710,geometry box,100,150,50,1,00157,India
674356,2023-03-23,704,scale,5,10,5,1,00157,India
674356,2023-03-23,711,TD kit,150,300,150,1,00157,India
750521,2023-03-23,702,pencil,2,5,3,1,00411,India
750521,2023-03-23,715,folder,5,15,10,1,00411,India
750521,2023-03-23,704,scale,5,10,5,1,00411,India
344750,2023-03-23,707,marker,20,40,20,1,00360,India
344750,2023-03-23,713,ball pen,5,10,5,1,00360,India
344750,2023-03-23,709,notebook,30,60,30,1,00360,India
453202,2023-03-23,715,folder,5,15,10,1,00465,India
453202,2023-03-23,706,sharpener,3,8,5,1,00465,India
453202,2023-03-23,701,gel pen,5,10,5,1,00465,India
453202,2023-03-23,702,pencil,2,5,3,1,00465,India
119372,2023-03-23,711,TD kit,150,300,150,1,00047,India
119372,2023-03-23,701,gel pen,5,10,5,1,00047,India
119372,2023-03-23,704,scale,5,10,5,1,00047,India
340798,2023-03-23,712,graph paper,20,40,20,1,00105,India
340798,2023-03-23,711,TD kit,150,300,150,1,00105,India
634268,2023-03-23,701,gel pen,5,10,5,1,00150,India
634268,2023-03-23,702,pencil,2,5,3,1,00150,India
634268,2023-03-23,715,folder,5,15,10,1,00150,India
634268,2023-03-23,711,TD kit,150,300,150,1,00150,India
959802,2023-03-23,704,scale,5,10,5,1,00105,India
804010,2023-03-23,702,pencil,2,5,3,1,00386,India
804010,2023-03-23,709,notebook,30,60,30,1,00386,India
178273,2023-03-23,714,carbon paper,15,30,15,1,00429,India
178273,2023-03-23,704,scale,5,10,5,1,00429,India
435091,2023-03-23,708,sketchpen,15,40,25,1,00123,India
988621,2023-03-23,701,gel pen,5,10,5,1,00164,India
988621,2023-03-23,706,sharpener,3,8,5,1,00164,India
988621,2023-03-23,713,ball pen,5,10,5,1,00164,India
839623,2023-03-23,711,TD kit,150,300,150,1,00469,India
348449,2023-03-23,713,ball pen,5,10,5,1,00025,India
348449,2023-03-23,702,pencil,2,5,3,1,00025,India
348449,2023-03-23,712,graph paper,20,40,20,1,00025,India
286201,2023-03-23,705,stencil,10,20,10,1,00498,India
286201,2023-03-23,709,notebook,30,60,30,1,00498,India
725424,2023-03-23,702,pencil,2,5,3,1,00422,India
725424,2023-03-23,708,sketchpen,15,40,25,1,00422,India
725424,2023-03-23,709,notebook,30,60,30,1,00422,India
725424,2023-03-23,710,geometry box,100,150,50,1,00422,India
371183,2023-03-23,708,sketchpen,15,40,25,1,00143,India
371183,2023-03-23,705,stencil,10,20,10,1,00143,India
371183,2023-03-23,707,marker,20,40,20,1,00143,India
371183,2023-03-23,711,TD kit,150,300,150,1,00143,India
371183,2023-03-23,710,geometry box,100,150,50,1,00143,India
341357,2023-03-23,712,graph paper,20,40,20,1,00489,India
341357,2023-03-23,705,stencil,10,20,10,1,00489,India
700048,2023-03-23,715,folder,5,15,10,1,00217,India
700048,2023-03-23,709,notebook,30,60,30,1,00217,India
700048,2023-03-23,714,carbon paper,15,30,15,1,00217,India
700048,2023-03-23,704,scale,5,10,5,1,00217,India
700048,2023-03-23,708,sketchpen,15,40,25,1,00217,India
865107,2023-03-23,711,TD kit,150,300,150,1,00460,India
865107,2023-03-23,707,marker,20,40,20,1,00460,India
913746,2023-03-23,705,stencil,10,20,10,1,00251,India
913746,2023-03-23,714,carbon paper,15,30,15,1,00251,India
913746,2023-03-23,702,pencil,2,5,3,1,00251,India
799486,2023-03-23,711,TD kit,150,300,150,1,00113,India
457359,2023-03-23,704,scale,5,10,5,1,00171,India
457359,2023-03-23,710,geometry box,100,150,50,1,00171,India
191098,2023-03-23,702,pencil,2,5,3,1,00115,India
191098,2023-03-23,706,sharpener,3,8,5,1,00115,India
235258,2023-03-23,713,ball pen,5,10,5,1,00336,India
441745,2023-03-23,706,sharpener,3,8,5,1,00027,India
441745,2023-03-23,710,geometry box,100,150,50,1,00027,India
441745,2023-03-23,711,TD kit,150,300,150,1,00027,India
441745,2023-03-23,703,eraser,1,3,2,1,00027,India
441745,2023-03-23,708,sketchpen,15,40,25,1,00027,India
796723,2023-03-23,711,TD kit,150,300,150,1,00474,India
796723,2023-03-23,717,spiral bound book,50,100,50,1,00474,India
796723,2023-03-23,716,printing paper,200,400,200,1,00474,India
796723,2023-03-23,708,sketchpen,15,40,25,1,00474,India
326393,2023-03-23,711,TD kit,150,300,150,1,00025,India
823697,2023-03-24,716,printing paper,200,400,200,1,00422,India
823697,2023-03-24,710,geometry box,100,150,50,1,00422,India
823697,2023-03-24,703,eraser,1,3,2,1,00422,India
823697,2023-03-24,711,TD kit,150,300,150,1,00422,India
823697,2023-03-24,704,scale,5,10,5,1,00422,India
630904,2023-03-24,717,spiral bound book,50,100,50,1,00299,India
630904,2023-03-24,716,printing paper,200,400,200,1,00299,India
630904,2023-03-24,710,geometry box,100,150,50,1,00299,India
630904,2023-03-24,704,scale,5,10,5,1,00299,India
233939,2023-03-24,705,stencil,10,20,10,1,00077,India
881022,2023-03-24,704,scale,5,10,5,1,00238,India
269573,2023-03-24,704,scale,5,10,5,1,00194,India
269573,2023-03-24,714,carbon paper,15,30,15,1,00194,India
269573,2023-03-24,701,gel pen,5,10,5,1,00194,India
269573,2023-03-24,709,notebook,30,60,30,1,00194,India
269573,2023-03-24,710,geometry box,100,150,50,1,00194,India
555751,2023-03-24,714,carbon paper,15,30,15,1,00152,India
555751,2023-03-24,704,scale,5,10,5,1,00152,India
555751,2023-03-24,709,notebook,30,60,30,1,00152,India
555751,2023-03-24,717,spiral bound book,50,100,50,1,00152,India
555751,2023-03-24,706,sharpener,3,8,5,1,00152,India
639703,2023-03-24,701,gel pen,5,10,5,1,00131,India
639703,2023-03-24,713,ball pen,5,10,5,1,00131,India
989782,2023-03-24,714,carbon paper,15,30,15,1,00295,India
989782,2023-03-24,703,eraser,1,3,2,1,00295,India
975729,2023-03-24,714,carbon paper,15,30,15,1,00482,India
975729,2023-03-24,708,sketchpen,15,40,25,1,00482,India
975729,2023-03-24,715,folder,5,15,10,1,00482,India
975729,2023-03-24,712,graph paper,20,40,20,1,00482,India
619581,2023-03-24,717,spiral bound book,50,100,50,1,00196,India
619581,2023-03-24,707,marker,20,40,20,1,00196,India
596203,2023-03-24,703,eraser,1,3,2,1,00253,India
596203,2023-03-24,702,pencil,2,5,3,1,00253,India
933850,2023-03-24,713,ball pen,5,10,5,1,00469,India
933850,2023-03-24,703,eraser,1,3,2,1,00469,India
933850,2023-03-24,702,pencil,2,5,3,1,00469,India
877867,2023-03-24,704,scale,5,10,5,1,00164,India
796405,2023-03-24,716,printing paper,200,400,200,1,00204,India
796405,2023-03-24,707,marker,20,40,20,1,00204,India
796405,2023-03-24,712,graph paper,20,40,20,1,00204,India
796405,2023-03-24,714,carbon paper,15,30,15,1,00204,India
707022,2023-03-24,712,graph paper,20,40,20,1,00122,India
707022,2023-03-24,714,carbon paper,15,30,15,1,00122,India
707022,2023-03-24,715,folder,5,15,10,1,00122,India
707022,2023-03-24,709,notebook,30,60,30,1,00122,India
329686,2023-03-24,705,stencil,10,20,10,1,00471,India
329686,2023-03-24,708,sketchpen,15,40,25,1,00471,India
329686,2023-03-24,701,gel pen,5,10,5,1,00471,India
329686,2023-03-24,706,sharpener,3,8,5,1,00471,India
554553,2023-03-24,715,folder,5,15,10,1,00354,India
285171,2023-03-24,710,geometry box,100,150,50,1,00498,India
285171,2023-03-24,711,TD kit,150,300,150,1,00498,India
285171,2023-03-24,708,sketchpen,15,40,25,1,00498,India
285171,2023-03-24,701,gel pen,5,10,5,1,00498,India
801517,2023-03-24,713,ball pen,5,10,5,1,00218,India
801517,2023-03-24,717,spiral bound book,50,100,50,1,00218,India
801517,2023-03-24,707,marker,20,40,20,1,00218,India
801517,2023-03-24,716,printing paper,200,400,200,1,00218,India
852626,2023-03-24,717,spiral bound book,50,100,50,1,00039,India
852626,2023-03-24,716,printing paper,200,400,200,1,00039,India
485051,2023-03-24,714,carbon paper,15,30,15,1,00397,India
485051,2023-03-24,708,sketchpen,15,40,25,1,00397,India
794363,2023-03-24,712,graph paper,20,40,20,1,00295,India
794363,2023-03-24,709,notebook,30,60,30,1,00295,India
365106,2023-03-24,714,carbon paper,15,30,15,1,00356,India
365106,2023-03-24,704,scale,5,10,5,1,00356,India
365106,2023-03-24,708,sketchpen,15,40,25,1,00356,India
365106,2023-03-24,712,graph paper,20,40,20,1,00356,India
592025,2023-03-24,703,eraser,1,3,2,1,00367,India
592025,2023-03-24,710,geometry box,100,150,50,1,00367,India
990339,2023-03-24,709,notebook,30,60,30,1,00017,India
990339,2023-03-24,708,sketchpen,15,40,25,1,00017,India
990339,2023-03-24,710,geometry box,100,150,50,1,00017,India
990339,2023-03-24,712,graph paper,20,40,20,1,00017,India
523948,2023-03-24,712,graph paper,20,40,20,1,00002,India
523948,2023-03-24,710,geometry box,100,150,50,1,00002,India
980843,2023-03-24,706,sharpener,3,8,5,1,00186,India
980843,2023-03-24,712,graph paper,20,40,20,1,00186,India
980843,2023-03-24,709,notebook,30,60,30,1,00186,India
980843,2023-03-24,701,gel pen,5,10,5,1,00186,India
936428,2023-03-24,711,TD kit,150,300,150,1,00278,India
936428,2023-03-24,701,gel pen,5,10,5,1,00278,India
936428,2023-03-24,713,ball pen,5,10,5,1,00278,India
355652,2023-03-24,705,stencil,10,20,10,1,00088,India
355652,2023-03-24,717,spiral bound book,50,100,50,1,00088,India
355652,2023-03-24,704,scale,5,10,5,1,00088,India
228431,2023-03-24,717,spiral bound book,50,100,50,1,00395,India
228431,2023-03-24,703,eraser,1,3,2,1,00395,India
228431,2023-03-24,711,TD kit,150,300,150,1,00395,India
228431,2023-03-24,701,gel pen,5,10,5,1,00395,India
228431,2023-03-24,708,sketchpen,15,40,25,1,00395,India
533117,2023-03-24,716,printing paper,200,400,200,1,00282,India
533117,2023-03-24,707,marker,20,40,20,1,00282,India
533117,2023-03-24,703,eraser,1,3,2,1,00282,India
855673,2023-03-24,714,carbon paper,15,30,15,1,00170,India
855673,2023-03-24,711,TD kit,150,300,150,1,00170,India
450561,2023-03-24,704,scale,5,10,5,1,00387,India
450561,2023-03-24,717,spiral bound book,50,100,50,1,00387,India
450561,2023-03-24,714,carbon paper,15,30,15,1,00387,India
450561,2023-03-24,712,graph paper,20,40,20,1,00387,India
468503,2023-03-24,704,scale,5,10,5,1,00060,India
468503,2023-03-24,708,sketchpen,15,40,25,1,00060,India
468503,2023-03-24,701,gel pen,5,10,5,1,00060,India
531419,2023-03-24,711,TD kit,150,300,150,1,00386,India
531419,2023-03-24,703,eraser,1,3,2,1,00386,India
531419,2023-03-24,713,ball pen,5,10,5,1,00386,India
531419,2023-03-24,710,geometry box,100,150,50,1,00386,India
531419,2023-03-24,716,printing paper,200,400,200,1,00386,India
202253,2023-03-24,705,stencil,10,20,10,1,00189,India
299896,2023-03-24,704,scale,5,10,5,1,00381,India
299896,2023-03-24,707,marker,20,40,20,1,00381,India
299896,2023-03-24,703,eraser,1,3,2,1,00381,India
154868,2023-03-24,701,gel pen,5,10,5,1,00253,India
154868,2023-03-24,708,sketchpen,15,40,25,1,00253,India
154868,2023-03-24,706,sharpener,3,8,5,1,00253,India
154868,2023-03-24,709,notebook,30,60,30,1,00253,India
686952,2023-03-24,716,printing paper,200,400,200,1,00075,India
686952,2023-03-24,703,eraser,1,3,2,1,00075,India
686952,2023-03-24,708,sketchpen,15,40,25,1,00075,India
686952,2023-03-24,711,TD kit,150,300,150,1,00075,India
386053,2023-03-24,710,geometry box,100,150,50,1,00221,India
386053,2023-03-24,709,notebook,30,60,30,1,00221,India
122981,2023-03-25,706,sharpener,3,8,5,1,00325,India
122981,2023-03-25,715,folder,5,15,10,1,00325,India
122981,2023-03-25,714,carbon paper,15,30,15,1,00325,India
480595,2023-03-25,717,spiral bound book,50,100,50,1,00213,India
480595,2023-03-25,710,geometry box,100,150,50,1,00213,India
480595,2023-03-25,714,carbon paper,15,30,15,1,00213,India
480595,2023-03-25,705,stencil,10,20,10,1,00213,India
904790,2023-03-25,707,marker,20,40,20,1,00183,India
904790,2023-03-25,708,sketchpen,15,40,25,1,00183,India
904790,2023-03-25,716,printing paper,200,400,200,1,00183,India
904790,2023-03-25,717,spiral bound book,50,100,50,1,00183,India
373899,2023-03-25,709,notebook,30,60,30,1,00353,India
373899,2023-03-25,712,graph paper,20,40,20,1,00353,India
373899,2023-03-25,714,carbon paper,15,30,15,1,00353,India
373899,2023-03-25,711,TD kit,150,300,150,1,00353,India
373899,2023-03-25,713,ball pen,5,10,5,1,00353,India
635253,2023-03-25,714,carbon paper,15,30,15,1,00369,India
807509,2023-03-25,706,sharpener,3,8,5,1,00078,India
807509,2023-03-25,704,scale,5,10,5,1,00078,India
807509,2023-03-25,701,gel pen,5,10,5,1,00078,India
411605,2023-03-25,707,marker,20,40,20,1,00051,India
411605,2023-03-25,706,sharpener,3,8,5,1,00051,India
411605,2023-03-25,708,sketchpen,15,40,25,1,00051,India
411605,2023-03-25,714,carbon paper,15,30,15,1,00051,India
411605,2023-03-25,715,folder,5,15,10,1,00051,India
846499,2023-03-25,708,sketchpen,15,40,25,1,00428,India
846499,2023-03-25,715,folder,5,15,10,1,00428,India
348686,2023-03-25,702,pencil,2,5,3,1,00350,India
348686,2023-03-25,712,graph paper,20,40,20,1,00350,India
348686,2023-03-25,708,sketchpen,15,40,25,1,00350,India
337035,2023-03-25,717,spiral bound book,50,100,50,1,00203,India
261593,2023-03-25,717,spiral bound book,50,100,50,1,00198,India
261593,2023-03-25,708,sketchpen,15,40,25,1,00198,India
526337,2023-03-25,701,gel pen,5,10,5,1,00264,India
526337,2023-03-25,717,spiral bound book,50,100,50,1,00264,India
526337,2023-03-25,715,folder,5,15,10,1,00264,India
526337,2023-03-25,711,TD kit,150,300,150,1,00264,India
260172,2023-03-25,716,printing paper,200,400,200,1,00046,India
260172,2023-03-25,706,sharpener,3,8,5,1,00046,India
956645,2023-03-25,708,sketchpen,15,40,25,1,00291,India
604927,2023-03-25,711,TD kit,150,300,150,1,00353,India
955314,2023-03-25,715,folder,5,15,10,1,00429,India
955314,2023-03-25,702,pencil,2,5,3,1,00429,India
955314,2023-03-25,714,carbon paper,15,30,15,1,00429,India
955314,2023-03-25,710,geometry box,100,150,50,1,00429,India
969830,2023-03-25,708,sketchpen,15,40,25,1,00499,India
969830,2023-03-25,702,pencil,2,5,3,1,00499,India
969830,2023-03-25,701,gel pen,5,10,5,1,00499,India
881811,2023-03-25,713,ball pen,5,10,5,1,00409,India
881811,2023-03-25,709,notebook,30,60,30,1,00409,India
881811,2023-03-25,710,geometry box,100,150,50,1,00409,India
885940,2023-03-25,703,eraser,1,3,2,1,00392,India
885940,2023-03-25,709,notebook,30,60,30,1,00392,India
342129,2023-03-25,705,stencil,10,20,10,1,00304,India
455888,2023-03-25,712,graph paper,20,40,20,1,00279,India
455888,2023-03-25,711,TD kit,150,300,150,1,00279,India
997642,2023-03-25,708,sketchpen,15,40,25,1,00053,India
997642,2023-03-25,711,TD kit,150,300,150,1,00053,India
997642,2023-03-25,714,carbon paper,15,30,15,1,00053,India
997642,2023-03-25,703,eraser,1,3,2,1,00053,India
673705,2023-03-25,710,geometry box,100,150,50,1,00116,India
673705,2023-03-25,712,graph paper,20,40,20,1,00116,India
673705,2023-03-25,707,marker,20,40,20,1,00116,India
673705,2023-03-25,708,sketchpen,15,40,25,1,00116,India
347651,2023-03-25,701,gel pen,5,10,5,1,00410,India
347651,2023-03-25,709,notebook,30,60,30,1,00410,India
347651,2023-03-25,710,geometry box,100,150,50,1,00410,India
494976,2023-03-25,708,sketchpen,15,40,25,1,00068,India
494976,2023-03-25,702,pencil,2,5,3,1,00068,India
494976,2023-03-25,714,carbon paper,15,30,15,1,00068,India
714731,2023-03-25,711,TD kit,150,300,150,1,00340,India
714731,2023-03-25,715,folder,5,15,10,1,00340,India
714731,2023-03-25,712,graph paper,20,40,20,1,00340,India
714731,2023-03-25,717,spiral bound book,50,100,50,1,00340,India
714731,2023-03-25,709,notebook,30,60,30,1,00340,India
195959,2023-03-25,710,geometry box,100,150,50,1,00141,India
195959,2023-03-25,707,marker,20,40,20,1,00141,India
195959,2023-03-25,709,notebook,30,60,30,1,00141,India
195959,2023-03-25,713,ball pen,5,10,5,1,00141,India
195959,2023-03-25,701,gel pen,5,10,5,1,00141,India
150685,2023-03-25,703,eraser,1,3,2,1,00441,India
150685,2023-03-25,704,scale,5,10,5,1,00441,India
150685,2023-03-25,705,stencil,10,20,10,1,00441,India
405619,2023-03-25,717,spiral bound book,50,100,50,1,00313,India
473133,2023-03-25,715,folder,5,15,10,1,00194,India
473133,2023-03-25,704,scale,5,10,5,1,00194,India
473133,2023-03-25,707,marker,20,40,20,1,00194,India
120459,2023-03-25,713,ball pen,5,10,5,1,00381,India
120459,2023-03-25,706,sharpener,3,8,5,1,00381,India
390328,2023-03-25,707,marker,20,40,20,1,00295,India
390328,2023-03-25,703,eraser,1,3,2,1,00295,India
390328,2023-03-25,708,sketchpen,15,40,25,1,00295,India
912893,2023-03-26,703,eraser,1,3,2,1,00160,India
912893,2023-03-26,711,TD kit,150,300,150,1,00160,India
912893,2023-03-26,716,printing paper,200,400,200,1,00160,India
912893,2023-03-26,705,stencil,10,20,10,1,00160,India
562231,2023-03-26,717,spiral bound book,50,100,50,1,00130,India
562231,2023-03-26,702,pencil,2,5,3,1,00130,India
562231,2023-03-26,711,TD kit,150,300,150,1,00130,India
725126,2023-03-26,717,spiral bound book,50,100,50,1,00076,India
725126,2023-03-26,712,graph paper,20,40,20,1,00076,India
812052,2023-03-26,710,geometry box,100,150,50,1,00380,India
159438,2023-03-26,708,sketchpen,15,40,25,1,00053,India
159438,2023-03-26,704,scale,5,10,5,1,00053,India
159438,2023-03-26,712,graph paper,20,40,20,1,00053,India
408356,2023-03-26,714,carbon paper,15,30,15,1,00244,India
408356,2023-03-26,710,geometry box,100,150,50,1,00244,India
408356,2023-03-26,712,graph paper,20,40,20,1,00244,India
408356,2023-03-26,707,marker,20,40,20,1,00244,India
408356,2023-03-26,708,sketchpen,15,40,25,1,00244,India
184962,2023-03-26,702,pencil,2,5,3,1,00048,India
184962,2023-03-26,706,sharpener,3,8,5,1,00048,India
459313,2023-03-26,709,notebook,30,60,30,1,00334,India
459313,2023-03-26,717,spiral bound book,50,100,50,1,00334,India
156987,2023-03-26,708,sketchpen,15,40,25,1,00407,India
156987,2023-03-26,717,spiral bound book,50,100,50,1,00407,India
156987,2023-03-26,707,marker,20,40,20,1,00407,India
933529,2023-03-26,707,marker,20,40,20,1,00171,India
933529,2023-03-26,711,TD kit,150,300,150,1,00171,India
933529,2023-03-26,709,notebook,30,60,30,1,00171,India
933529,2023-03-26,703,eraser,1,3,2,1,00171,India
933529,2023-03-26,710,geometry box,100,150,50,1,00171,India
220214,2023-03-26,716,printing paper,200,400,200,1,00488,India
220214,2023-03-26,705,stencil,10,20,10,1,00488,India
183454,2023-03-26,701,gel pen,5,10,5,1,00385,India
183454,2023-03-26,708,sketchpen,15,40,25,1,00385,India
183454,2023-03-26,710,geometry box,100,150,50,1,00385,India
763694,2023-03-26,717,spiral bound book,50,100,50,1,00464,India
763694,2023-03-26,716,printing paper,200,400,200,1,00464,India
763694,2023-03-26,711,TD kit,150,300,150,1,00464,India
763694,2023-03-26,705,stencil,10,20,10,1,00464,India
148490,2023-03-26,712,graph paper,20,40,20,1,00007,India
148490,2023-03-26,710,geometry box,100,150,50,1,00007,India
148490,2023-03-26,704,scale,5,10,5,1,00007,India
148490,2023-03-26,709,notebook,30,60,30,1,00007,India
148490,2023-03-26,703,eraser,1,3,2,1,00007,India
674924,2023-03-26,711,TD kit,150,300,150,1,00159,India
343093,2023-03-26,707,marker,20,40,20,1,00412,India
343093,2023-03-26,709,notebook,30,60,30,1,00412,India
343093,2023-03-26,708,sketchpen,15,40,25,1,00412,India
837058,2023-03-26,716,printing paper,200,400,200,1,00083,India
837058,2023-03-26,717,spiral bound book,50,100,50,1,00083,India
837058,2023-03-26,715,folder,5,15,10,1,00083,India
220402,2023-03-26,711,TD kit,150,300,150,1,00040,India
220402,2023-03-26,703,eraser,1,3,2,1,00040,India
354034,2023-03-26,702,pencil,2,5,3,1,00294,India
994015,2023-03-26,701,gel pen,5,10,5,1,00483,India
994015,2023-03-26,717,spiral bound book,50,100,50,1,00483,India
429262,2023-03-26,716,printing paper,200,400,200,1,00356,India
430552,2023-03-26,705,stencil,10,20,10,1,00161,India
430552,2023-03-26,713,ball pen,5,10,5,1,00161,India
430552,2023-03-26,709,notebook,30,60,30,1,00161,India
430552,2023-03-26,716,printing paper,200,400,200,1,00161,India
293838,2023-03-26,702,pencil,2,5,3,1,00451,India
293838,2023-03-26,711,TD kit,150,300,150,1,00451,India
293838,2023-03-26,705,stencil,10,20,10,1,00451,India
712871,2023-03-26,709,notebook,30,60,30,1,00098,India
712871,2023-03-26,704,scale,5,10,5,1,00098,India
712871,2023-03-26,706,sharpener,3,8,5,1,00098,India
121227,2023-03-26,716,printing paper,200,400,200,1,00013,India
121227,2023-03-26,711,TD kit,150,300,150,1,00013,India
121227,2023-03-26,717,spiral bound book,50,100,50,1,00013,India
121227,2023-03-26,702,pencil,2,5,3,1,00013,India
121227,2023-03-26,706,sharpener,3,8,5,1,00013,India
979999,2023-03-26,711,TD kit,150,300,150,1,00061,India
979999,2023-03-26,717,spiral bound book,50,100,50,1,00061,India
965288,2023-03-26,704,scale,5,10,5,1,00192,India
965288,2023-03-26,706,sharpener,3,8,5,1,00192,India
965288,2023-03-26,715,folder,5,15,10,1,00192,India
965288,2023-03-26,712,graph paper,20,40,20,1,00192,India
965288,2023-03-26,714,carbon paper,15,30,15,1,00192,India
721974,2023-03-26,709,notebook,30,60,30,1,00195,India
721974,2023-03-26,711,TD kit,150,300,150,1,00195,India
721974,2023-03-26,712,graph paper,20,40,20,1,00195,India
721974,2023-03-26,706,sharpener,3,8,5,1,00195,India
652091,2023-03-26,716,printing paper,200,400,200,1,00458,India
509106,2023-03-26,717,spiral bound book,50,100,50,1,00080,India
509106,2023-03-26,708,sketchpen,15,40,25,1,00080,India
509106,2023-03-26,713,ball pen,5,10,5,1,00080,India
277499,2023-03-26,715,folder,5,15,10,1,00426,India
884218,2023-03-26,713,ball pen,5,10,5,1,00067,India
521229,2023-03-26,711,TD kit,150,300,150,1,00193,India
521229,2023-03-26,715,folder,5,15,10,1,00193,India
160651,2023-03-26,713,ball pen,5,10,5,1,00399,India
160651,2023-03-26,716,printing paper,200,400,200,1,00399,India
160651,2023-03-26,709,notebook,30,60,30,1,00399,India
719245,2023-03-26,714,carbon paper,15,30,15,1,00351,India
719245,2023-03-26,715,folder,5,15,10,1,00351,India
719245,2023-03-26,710,geometry box,100,150,50,1,00351,India
502085,2023-03-27,711,TD kit,150,300,150,1,00498,India
502085,2023-03-27,705,stencil,10,20,10,1,00498,India
391118,2023-03-27,701,gel pen,5,10,5,1,00378,India
391118,2023-03-27,703,eraser,1,3,2,1,00378,India
171381,2023-03-27,704,scale,5,10,5,1,00060,India
171381,2023-03-27,716,printing paper,200,400,200,1,00060,India
463353,2023-03-27,715,folder,5,15,10,1,00346,India
463353,2023-03-27,704,scale,5,10,5,1,00346,India
463353,2023-03-27,705,stencil,10,20,10,1,00346,India
528821,2023-03-27,712,graph paper,20,40,20,1,00013,India
204268,2023-03-27,702,pencil,2,5,3,1,00149,India
204268,2023-03-27,711,TD kit,150,300,150,1,00149,India
921327,2023-03-27,701,gel pen,5,10,5,1,00323,India
921327,2023-03-27,705,stencil,10,20,10,1,00323,India
795084,2023-03-27,708,sketchpen,15,40,25,1,00185,India
795084,2023-03-27,712,graph paper,20,40,20,1,00185,India
795084,2023-03-27,713,ball pen,5,10,5,1,00185,India
193936,2023-03-27,716,printing paper,200,400,200,1,00414,India
193936,2023-03-27,705,stencil,10,20,10,1,00414,India
193936,2023-03-27,702,pencil,2,5,3,1,00414,India
587257,2023-03-27,701,gel pen,5,10,5,1,00478,India
587257,2023-03-27,707,marker,20,40,20,1,00478,India
587257,2023-03-27,708,sketchpen,15,40,25,1,00478,India
587257,2023-03-27,714,carbon paper,15,30,15,1,00478,India
284847,2023-03-27,705,stencil,10,20,10,1,00353,India
284847,2023-03-27,712,graph paper,20,40,20,1,00353,India
284847,2023-03-27,714,carbon paper,15,30,15,1,00353,India
852404,2023-03-27,709,notebook,30,60,30,1,00054,India
422638,2023-03-27,708,sketchpen,15,40,25,1,00246,India
422638,2023-03-27,703,eraser,1,3,2,1,00246,India
422638,2023-03-27,716,printing paper,200,400,200,1,00246,India
422638,2023-03-27,701,gel pen,5,10,5,1,00246,India
290857,2023-03-27,714,carbon paper,15,30,15,1,00355,India
290857,2023-03-27,715,folder,5,15,10,1,00355,India
204993,2023-03-27,701,gel pen,5,10,5,1,00485,India
204993,2023-03-27,711,TD kit,150,300,150,1,00485,India
204993,2023-03-27,717,spiral bound book,50,100,50,1,00485,India
204993,2023-03-27,710,geometry box,100,150,50,1,00485,India
681707,2023-03-27,701,gel pen,5,10,5,1,00142,India
434740,2023-03-27,703,eraser,1,3,2,1,00184,India
918476,2023-03-27,714,carbon paper,15,30,15,1,00331,India
918476,2023-03-27,705,stencil,10,20,10,1,00331,India
918476,2023-03-27,715,folder,5,15,10,1,00331,India
230578,2023-03-27,712,graph paper,20,40,20,1,00397,India
230578,2023-03-27,716,printing paper,200,400,200,1,00397,India
230578,2023-03-27,703,eraser,1,3,2,1,00397,India
230578,2023-03-27,701,gel pen,5,10,5,1,00397,India
230578,2023-03-27,709,notebook,30,60,30,1,00397,India
225275,2023-03-27,710,geometry box,100,150,50,1,00378,India
225275,2023-03-27,711,TD kit,150,300,150,1,00378,India
225275,2023-03-27,703,eraser,1,3,2,1,00378,India
286727,2023-03-27,717,spiral bound book,50,100,50,1,00051,India
286727,2023-03-27,706,sharpener,3,8,5,1,00051,India
286727,2023-03-27,703,eraser,1,3,2,1,00051,India
286727,2023-03-27,716,printing paper,200,400,200,1,00051,India
286727,2023-03-27,712,graph paper,20,40,20,1,00051,India
272002,2023-03-27,711,TD kit,150,300,150,1,00097,India
995872,2023-03-27,707,marker,20,40,20,1,00143,India
995872,2023-03-27,715,folder,5,15,10,1,00143,India
995872,2023-03-27,709,notebook,30,60,30,1,00143,India
517227,2023-03-27,705,stencil,10,20,10,1,00217,India
517227,2023-03-27,714,carbon paper,15,30,15,1,00217,India
517227,2023-03-27,710,geometry box,100,150,50,1,00217,India
827871,2023-03-27,716,printing paper,200,400,200,1,00034,India
827871,2023-03-27,701,gel pen,5,10,5,1,00034,India
827871,2023-03-27,709,notebook,30,60,30,1,00034,India
562054,2023-03-27,710,geometry box,100,150,50,1,00110,India
110430,2023-03-27,704,scale,5,10,5,1,00388,India
110430,2023-03-27,709,notebook,30,60,30,1,00388,India
110430,2023-03-27,710,geometry box,100,150,50,1,00388,India
110430,2023-03-27,711,TD kit,150,300,150,1,00388,India
835617,2023-03-27,705,stencil,10,20,10,1,00367,India
843435,2023-03-27,706,sharpener,3,8,5,1,00285,India
843435,2023-03-27,705,stencil,10,20,10,1,00285,India
843435,2023-03-27,712,graph paper,20,40,20,1,00285,India
843435,2023-03-27,716,printing paper,200,400,200,1,00285,India
712581,2023-03-27,706,sharpener,3,8,5,1,00004,India
712581,2023-03-27,716,printing paper,200,400,200,1,00004,India
712581,2023-03-27,702,pencil,2,5,3,1,00004,India
712581,2023-03-27,715,folder,5,15,10,1,00004,India
712581,2023-03-27,710,geometry box,100,150,50,1,00004,India
370215,2023-03-27,717,spiral bound book,50,100,50,1,00020,India
370215,2023-03-27,702,pencil,2,5,3,1,00020,India
805896,2023-03-27,705,stencil,10,20,10,1,00427,India
805896,2023-03-27,711,TD kit,150,300,150,1,00427,India
805896,2023-03-27,704,scale,5,10,5,1,00427,India
805896,2023-03-27,715,folder,5,15,10,1,00427,India
376038,2023-03-27,707,marker,20,40,20,1,00149,India
376038,2023-03-27,712,graph paper,20,40,20,1,00149,India
546348,2023-03-27,715,folder,5,15,10,1,00084,India
546348,2023-03-27,716,printing paper,200,400,200,1,00084,India
546348,2023-03-27,708,sketchpen,15,40,25,1,00084,India
887253,2023-03-27,711,TD kit,150,300,150,1,00276,India
887253,2023-03-27,706,sharpener,3,8,5,1,00276,India
887253,2023-03-27,707,marker,20,40,20,1,00276,India
872793,2023-03-27,708,sketchpen,15,40,25,1,00077,India
872793,2023-03-27,713,ball pen,5,10,5,1,00077,India
130889,2023-03-28,705,stencil,10,20,10,1,00074,India
130889,2023-03-28,701,gel pen,5,10,5,1,00074,India
130889,2023-03-28,702,pencil,2,5,3,1,00074,India
130889,2023-03-28,711,TD kit,150,300,150,1,00074,India
498133,2023-03-28,706,sharpener,3,8,5,1,00415,India
498133,2023-03-28,703,eraser,1,3,2,1,00415,India
498133,2023-03-28,705,stencil,10,20,10,1,00415,India
948442,2023-03-28,716,printing paper,200,400,200,1,00315,India
594185,2023-03-28,714,carbon paper,15,30,15,1,00216,India
594185,2023-03-28,711,TD kit,150,300,150,1,00216,India
594185,2023-03-28,701,gel pen,5,10,5,1,00216,India
693359,2023-03-28,705,stencil,10,20,10,1,00022,India
179843,2023-03-28,715,folder,5,15,10,1,00090,India
179843,2023-03-28,702,pencil,2,5,3,1,00090,India
583489,2023-03-28,701,gel pen,5,10,5,1,00448,India
583489,2023-03-28,713,ball pen,5,10,5,1,00448,India
583489,2023-03-28,712,graph paper,20,40,20,1,00448,India
759253,2023-03-28,701,gel pen,5,10,5,1,00316,India
858475,2023-03-28,704,scale,5,10,5,1,00072,India
858475,2023-03-28,717,spiral bound book,50,100,50,1,00072,India
858475,2023-03-28,709,notebook,30,60,30,1,00072,India
858475,2023-03-28,713,ball pen,5,10,5,1,00072,India
605553,2023-03-28,703,eraser,1,3,2,1,00154,India
605553,2023-03-28,711,TD kit,150,300,150,1,00154,India
605553,2023-03-28,709,notebook,30,60,30,1,00154,India
883516,2023-03-28,707,marker,20,40,20,1,00471,India
883516,2023-03-28,716,printing paper,200,400,200,1,00471,India
441707,2023-03-28,714,carbon paper,15,30,15,1,00451,India
441707,2023-03-28,705,stencil,10,20,10,1,00451,India
441707,2023-03-28,703,eraser,1,3,2,1,00451,India
613243,2023-03-28,710,geometry box,100,150,50,1,00447,India
564314,2023-03-28,716,printing paper,200,400,200,1,00457,India
564314,2023-03-28,702,pencil,2,5,3,1,00457,India
564314,2023-03-28,708,sketchpen,15,40,25,1,00457,India
605995,2023-03-28,713,ball pen,5,10,5,1,00364,India
605995,2023-03-28,702,pencil,2,5,3,1,00364,India
571499,2023-03-28,711,TD kit,150,300,150,1,00192,India
571499,2023-03-28,710,geometry box,100,150,50,1,00192,India
397678,2023-03-28,711,TD kit,150,300,150,1,00305,India
397678,2023-03-28,716,printing paper,200,400,200,1,00305,India
235517,2023-03-28,706,sharpener,3,8,5,1,00448,India
235517,2023-03-28,709,notebook,30,60,30,1,00448,India
235517,2023-03-28,712,graph paper,20,40,20,1,00448,India
235517,2023-03-28,717,spiral bound book,50,100,50,1,00448,India
235517,2023-03-28,708,sketchpen,15,40,25,1,00448,India
731241,2023-03-28,708,sketchpen,15,40,25,1,00153,India
761695,2023-03-28,714,carbon paper,15,30,15,1,00358,India
761695,2023-03-28,710,geometry box,100,150,50,1,00358,India
761695,2023-03-28,716,printing paper,200,400,200,1,00358,India
761695,2023-03-28,715,folder,5,15,10,1,00358,India
832604,2023-03-28,716,printing paper,200,400,200,1,00297,India
832604,2023-03-28,707,marker,20,40,20,1,00297,India
832604,2023-03-28,715,folder,5,15,10,1,00297,India
832604,2023-03-28,705,stencil,10,20,10,1,00297,India
832604,2023-03-28,713,ball pen,5,10,5,1,00297,India
767426,2023-03-28,710,geometry box,100,150,50,1,00390,India
200470,2023-03-28,710,geometry box,100,150,50,1,00105,India
200470,2023-03-28,714,carbon paper,15,30,15,1,00105,India
200470,2023-03-28,705,stencil,10,20,10,1,00105,India
200470,2023-03-28,715,folder,5,15,10,1,00105,India
348897,2023-03-28,702,pencil,2,5,3,1,00298,India
348897,2023-03-28,709,notebook,30,60,30,1,00298,India
348897,2023-03-28,713,ball pen,5,10,5,1,00298,India
970630,2023-03-28,707,marker,20,40,20,1,00253,India
970630,2023-03-28,717,spiral bound book,50,100,50,1,00253,India
970630,2023-03-28,703,eraser,1,3,2,1,00253,India
970630,2023-03-28,708,sketchpen,15,40,25,1,00253,India
970630,2023-03-28,704,scale,5,10,5,1,00253,India
173606,2023-03-28,702,pencil,2,5,3,1,00057,India
173606,2023-03-28,703,eraser,1,3,2,1,00057,India
173606,2023-03-28,701,gel pen,5,10,5,1,00057,India
173606,2023-03-28,704,scale,5,10,5,1,00057,India
658247,2023-03-28,710,geometry box,100,150,50,1,00086,India
658247,2023-03-28,709,notebook,30,60,30,1,00086,India
658247,2023-03-28,707,marker,20,40,20,1,00086,India
387204,2023-03-28,710,geometry box,100,150,50,1,00249,India
776308,2023-03-28,704,scale,5,10,5,1,00127,India
776308,2023-03-28,711,TD kit,150,300,150,1,00127,India
776308,2023-03-28,707,marker,20,40,20,1,00127,India
149828,2023-03-28,715,folder,5,15,10,1,00448,India
149828,2023-03-28,701,gel pen,5,10,5,1,00448,India
149828,2023-03-28,709,notebook,30,60,30,1,00448,India
149828,2023-03-28,712,graph paper,20,40,20,1,00448,India
171322,2023-03-28,706,sharpener,3,8,5,1,00026,India
171322,2023-03-28,717,spiral bound book,50,100,50,1,00026,India
171322,2023-03-28,713,ball pen,5,10,5,1,00026,India
927563,2023-03-29,703,eraser,1,3,2,1,00382,India
927563,2023-03-29,717,spiral bound book,50,100,50,1,00382,India
262746,2023-03-29,704,scale,5,10,5,1,00138,India
262746,2023-03-29,711,TD kit,150,300,150,1,00138,India
262746,2023-03-29,713,ball pen,5,10,5,1,00138,India
262746,2023-03-29,701,gel pen,5,10,5,1,00138,India
262746,2023-03-29,702,pencil,2,5,3,1,00138,India
440019,2023-03-29,701,gel pen,5,10,5,1,00317,India
440019,2023-03-29,717,spiral bound book,50,100,50,1,00317,India
410709,2023-03-29,703,eraser,1,3,2,1,00227,India
410709,2023-03-29,704,scale,5,10,5,1,00227,India
410709,2023-03-29,714,carbon paper,15,30,15,1,00227,India
265991,2023-03-29,712,graph paper,20,40,20,1,00009,India
265991,2023-03-29,709,notebook,30,60,30,1,00009,India
265991,2023-03-29,717,spiral bound book,50,100,50,1,00009,India
114342,2023-03-29,713,ball pen,5,10,5,1,00153,India
114342,2023-03-29,709,notebook,30,60,30,1,00153,India
355516,2023-03-29,716,printing paper,200,400,200,1,00394,India
204952,2023-03-29,716,printing paper,200,400,200,1,00219,India
204952,2023-03-29,713,ball pen,5,10,5,1,00219,India
204952,2023-03-29,701,gel pen,5,10,5,1,00219,India
204952,2023-03-29,715,folder,5,15,10,1,00219,India
208485,2023-03-29,701,gel pen,5,10,5,1,00334,India
208485,2023-03-29,706,sharpener,3,8,5,1,00334,India
402222,2023-03-29,715,folder,5,15,10,1,00071,India
402222,2023-03-29,709,notebook,30,60,30,1,00071,India
402222,2023-03-29,705,stencil,10,20,10,1,00071,India
518567,2023-03-29,709,notebook,30,60,30,1,00232,India
518567,2023-03-29,712,graph paper,20,40,20,1,00232,India
518567,2023-03-29,705,stencil,10,20,10,1,00232,India
518567,2023-03-29,711,TD kit,150,300,150,1,00232,India
765616,2023-03-29,712,graph paper,20,40,20,1,00408,India
421169,2023-03-29,706,sharpener,3,8,5,1,00433,India
421169,2023-03-29,717,spiral bound book,50,100,50,1,00433,India
421169,2023-03-29,704,scale,5,10,5,1,00433,India
959388,2023-03-29,705,stencil,10,20,10,1,00329,India
959388,2023-03-29,702,pencil,2,5,3,1,00329,India
826593,2023-03-29,714,carbon paper,15,30,15,1,00353,India
472699,2023-03-29,703,eraser,1,3,2,1,00423,India
472699,2023-03-29,710,geometry box,100,150,50,1,00423,India
472699,2023-03-29,715,folder,5,15,10,1,00423,India
472699,2023-03-29,707,marker,20,40,20,1,00423,India
472699,2023-03-29,711,TD kit,150,300,150,1,00423,India
474297,2023-03-29,710,geometry box,100,150,50,1,00139,India
474297,2023-03-29,712,graph paper,20,40,20,1,00139,India
474297,2023-03-29,705,stencil,10,20,10,1,00139,India
474297,2023-03-29,714,carbon paper,15,30,15,1,00139,India
661510,2023-03-29,712,graph paper,20,40,20,1,00207,India
661510,2023-03-29,708,sketchpen,15,40,25,1,00207,India
661510,2023-03-29,702,pencil,2,5,3,1,00207,India
661510,2023-03-29,716,printing paper,200,400,200,1,00207,India
407079,2023-03-29,703,eraser,1,3,2,1,00071,India
407079,2023-03-29,704,scale,5,10,5,1,00071,India
260825,2023-03-29,713,ball pen,5,10,5,1,00324,India
230660,2023-03-29,705,stencil,10,20,10,1,00311,India
963252,2023-03-29,704,scale,5,10,5,1,00249,India
963252,2023-03-29,716,printing paper,200,400,200,1,00249,India
963252,2023-03-29,707,marker,20,40,20,1,00249,India
963252,2023-03-29,705,stencil,10,20,10,1,00249,India
759346,2023-03-29,707,marker,20,40,20,1,00173,India
759346,2023-03-29,716,printing paper,200,400,200,1,00173,India
759346,2023-03-29,701,gel pen,5,10,5,1,00173,India
759346,2023-03-29,703,eraser,1,3,2,1,00173,India
856638,2023-03-29,717,spiral bound book,50,100,50,1,00059,India
856638,2023-03-29,715,folder,5,15,10,1,00059,India
978882,2023-03-29,714,carbon paper,15,30,15,1,00420,India
901128,2023-03-29,709,notebook,30,60,30,1,00159,India
901128,2023-03-29,701,gel pen,5,10,5,1,00159,India
901128,2023-03-29,716,printing paper,200,400,200,1,00159,India
388838,2023-03-29,707,marker,20,40,20,1,00081,India
388838,2023-03-29,702,pencil,2,5,3,1,00081,India
388838,2023-03-29,709,notebook,30,60,30,1,00081,India
388838,2023-03-29,712,graph paper,20,40,20,1,00081,India
221533,2023-03-29,711,TD kit,150,300,150,1,00377,India
221533,2023-03-29,704,scale,5,10,5,1,00377,India
726819,2023-03-29,701,gel pen,5,10,5,1,00337,India
726819,2023-03-29,713,ball pen,5,10,5,1,00337,India
726819,2023-03-29,702,pencil,2,5,3,1,00337,India
816433,2023-03-29,705,stencil,10,20,10,1,00430,India
339984,2023-03-29,715,folder,5,15,10,1,00077,India
339984,2023-03-29,704,scale,5,10,5,1,00077,India
339984,2023-03-29,713,ball pen,5,10,5,1,00077,India
339984,2023-03-29,702,pencil,2,5,3,1,00077,India
612800,2023-03-29,704,scale,5,10,5,1,00332,India
612800,2023-03-29,711,TD kit,150,300,150,1,00332,India
544519,2023-03-29,709,notebook,30,60,30,1,00427,India
503993,2023-03-29,706,sharpener,3,8,5,1,00192,India
503993,2023-03-29,709,notebook,30,60,30,1,00192,India
503993,2023-03-29,710,geometry box,100,150,50,1,00192,India
410119,2023-03-29,706,sharpener,3,8,5,1,00077,India
410119,2023-03-29,703,eraser,1,3,2,1,00077,India
171094,2023-03-29,701,gel pen,5,10,5,1,00079,India
171094,2023-03-29,712,graph paper,20,40,20,1,00079,India
171094,2023-03-29,704,scale,5,10,5,1,00079,India
171094,2023-03-29,703,eraser,1,3,2,1,00079,India
171094,2023-03-29,707,marker,20,40,20,1,00079,India
935249,2023-03-29,702,pencil,2,5,3,1,00359,India
935249,2023-03-29,710,geometry box,100,150,50,1,00359,India
728405,2023-03-29,708,sketchpen,15,40,25,1,00488,India
728405,2023-03-29,715,folder,5,15,10,1,00488,India
274821,2023-03-29,706,sharpener,3,8,5,1,00086,India
274821,2023-03-29,710,geometry box,100,150,50,1,00086,India
463896,2023-03-29,712,graph paper,20,40,20,1,00269,India
463896,2023-03-29,714,carbon paper,15,30,15,1,00269,India
463896,2023-03-29,701,gel pen,5,10,5,1,00269,India
463896,2023-03-29,708,sketchpen,15,40,25,1,00269,India
937194,2023-03-29,710,geometry box,100,150,50,1,00141,India
750663,2023-03-29,708,sketchpen,15,40,25,1,00251,India
750663,2023-03-29,717,spiral bound book,50,100,50,1,00251,India
750663,2023-03-29,714,carbon paper,15,30,15,1,00251,India
750663,2023-03-29,706,sharpener,3,8,5,1,00251,India
750663,2023-03-29,703,eraser,1,3,2,1,00251,India
499852,2023-03-29,708,sketchpen,15,40,25,1,00004,India
499852,2023-03-29,705,stencil,10,20,10,1,00004,India
499852,2023-03-29,715,folder,5,15,10,1,00004,India
194118,2023-03-29,703,eraser,1,3,2,1,00151,India
194118,2023-03-29,708,sketchpen,15,40,25,1,00151,India
708699,2023-03-29,713,ball pen,5,10,5,1,00239,India
708699,2023-03-29,701,gel pen,5,10,5,1,00239,India
708699,2023-03-29,714,carbon paper,15,30,15,1,00239,India
101772,2023-03-29,710,geometry box,100,150,50,1,00298,India
101772,2023-03-29,712,graph paper,20,40,20,1,00298,India
219665,2023-03-29,715,folder,5,15,10,1,00448,India
219665,2023-03-29,704,scale,5,10,5,1,00448,India
219665,2023-03-29,710,geometry box,100,150,50,1,00448,India
219665,2023-03-29,708,sketchpen,15,40,25,1,00448,India
872566,2023-03-29,715,folder,5,15,10,1,00210,India
872566,2023-03-29,701,gel pen,5,10,5,1,00210,India
872566,2023-03-29,710,geometry box,100,150,50,1,00210,India
872566,2023-03-29,716,printing paper,200,400,200,1,00210,India
872566,2023-03-29,702,pencil,2,5,3,1,00210,India
562731,2023-03-29,706,sharpener,3,8,5,1,00495,India
562731,2023-03-29,717,spiral bound book,50,100,50,1,00495,India
562731,2023-03-29,702,pencil,2,5,3,1,00495,India
282961,2023-03-29,714,carbon paper,15,30,15,1,00168,India
282961,2023-03-29,713,ball pen,5,10,5,1,00168,India
282961,2023-03-29,703,eraser,1,3,2,1,00168,India
282961,2023-03-29,704,scale,5,10,5,1,00168,India
931130,2023-03-30,710,geometry box,100,150,50,1,00450,India
452988,2023-03-30,705,stencil,10,20,10,1,00309,India
452988,2023-03-30,701,gel pen,5,10,5,1,00309,India
853956,2023-03-30,714,carbon paper,15,30,15,1,00384,India
853956,2023-03-30,710,geometry box,100,150,50,1,00384,India
997676,2023-03-30,716,printing paper,200,400,200,1,00114,India
997676,2023-03-30,715,folder,5,15,10,1,00114,India
997676,2023-03-30,713,ball pen,5,10,5,1,00114,India
997676,2023-03-30,714,carbon paper,15,30,15,1,00114,India
522095,2023-03-30,716,printing paper,200,400,200,1,00229,India
522095,2023-03-30,704,scale,5,10,5,1,00229,India
268574,2023-03-30,706,sharpener,3,8,5,1,00442,India
268574,2023-03-30,716,printing paper,200,400,200,1,00442,India
268574,2023-03-30,713,ball pen,5,10,5,1,00442,India
268574,2023-03-30,705,stencil,10,20,10,1,00442,India
268574,2023-03-30,702,pencil,2,5,3,1,00442,India
508137,2023-03-30,713,ball pen,5,10,5,1,00304,India
508137,2023-03-30,703,eraser,1,3,2,1,00304,India
508137,2023-03-30,707,marker,20,40,20,1,00304,India
491588,2023-03-30,709,notebook,30,60,30,1,00367,India
826760,2023-03-30,708,sketchpen,15,40,25,1,00227,India
281028,2023-03-30,715,folder,5,15,10,1,00368,India
281028,2023-03-30,701,gel pen,5,10,5,1,00368,India
281028,2023-03-30,702,pencil,2,5,3,1,00368,India
281028,2023-03-30,710,geometry box,100,150,50,1,00368,India
652329,2023-03-30,704,scale,5,10,5,1,00011,India
652329,2023-03-30,711,TD kit,150,300,150,1,00011,India
652329,2023-03-30,710,geometry box,100,150,50,1,00011,India
652329,2023-03-30,712,graph paper,20,40,20,1,00011,India
254296,2023-03-30,704,scale,5,10,5,1,00462,India
237245,2023-03-30,717,spiral bound book,50,100,50,1,00154,India
237245,2023-03-30,703,eraser,1,3,2,1,00154,India
237245,2023-03-30,710,geometry box,100,150,50,1,00154,India
237245,2023-03-30,709,notebook,30,60,30,1,00154,India
818779,2023-03-30,714,carbon paper,15,30,15,1,00254,India
818779,2023-03-30,705,stencil,10,20,10,1,00254,India
818779,2023-03-30,709,notebook,30,60,30,1,00254,India
818779,2023-03-30,712,graph paper,20,40,20,1,00254,India
582992,2023-03-30,717,spiral bound book,50,100,50,1,00213,India
582992,2023-03-30,716,printing paper,200,400,200,1,00213,India
582992,2023-03-30,705,stencil,10,20,10,1,00213,India
582992,2023-03-30,703,eraser,1,3,2,1,00213,India
581135,2023-03-30,707,marker,20,40,20,1,00119,India
581135,2023-03-30,714,carbon paper,15,30,15,1,00119,India
588428,2023-03-30,710,geometry box,100,150,50,1,00177,India
588428,2023-03-30,706,sharpener,3,8,5,1,00177,India
588428,2023-03-30,712,graph paper,20,40,20,1,00177,India
268950,2023-03-30,702,pencil,2,5,3,1,00028,India
268950,2023-03-30,701,gel pen,5,10,5,1,00028,India
134975,2023-03-30,703,eraser,1,3,2,1,00146,India
134975,2023-03-30,701,gel pen,5,10,5,1,00146,India
134975,2023-03-30,714,carbon paper,15,30,15,1,00146,India
374360,2023-03-30,706,sharpener,3,8,5,1,00194,India
374360,2023-03-30,710,geometry box,100,150,50,1,00194,India
405994,2023-03-30,713,ball pen,5,10,5,1,00222,India
405994,2023-03-30,711,TD kit,150,300,150,1,00222,India
405994,2023-03-30,707,marker,20,40,20,1,00222,India
405994,2023-03-30,703,eraser,1,3,2,1,00222,India
560773,2023-03-30,703,eraser,1,3,2,1,00121,India
560773,2023-03-30,702,pencil,2,5,3,1,00121,India
431016,2023-03-30,711,TD kit,150,300,150,1,00061,India
431016,2023-03-30,709,notebook,30,60,30,1,00061,India
462949,2023-03-30,714,carbon paper,15,30,15,1,00005,India
462949,2023-03-30,701,gel pen,5,10,5,1,00005,India
462949,2023-03-30,716,printing paper,200,400,200,1,00005,India
462949,2023-03-30,708,sketchpen,15,40,25,1,00005,India
462949,2023-03-30,713,ball pen,5,10,5,1,00005,India
952556,2023-03-30,712,graph paper,20,40,20,1,00344,India
952556,2023-03-30,705,stencil,10,20,10,1,00344,India
584762,2023-03-30,709,notebook,30,60,30,1,00312,India
108469,2023-03-30,714,carbon paper,15,30,15,1,00378,India
108469,2023-03-30,712,graph paper,20,40,20,1,00378,India
174073,2023-03-30,706,sharpener,3,8,5,1,00367,India
174073,2023-03-30,705,stencil,10,20,10,1,00367,India
174073,2023-03-30,711,TD kit,150,300,150,1,00367,India
174073,2023-03-30,703,eraser,1,3,2,1,00367,India
174073,2023-03-30,704,scale,5,10,5,1,00367,India
236271,2023-03-30,707,marker,20,40,20,1,00185,India
236271,2023-03-30,716,printing paper,200,400,200,1,00185,India
236271,2023-03-30,708,sketchpen,15,40,25,1,00185,India
236271,2023-03-30,714,carbon paper,15,30,15,1,00185,India
873428,2023-03-30,711,TD kit,150,300,150,1,00362,India
232817,2023-03-31,717,spiral bound book,50,100,50,1,00442,India
232817,2023-03-31,709,notebook,30,60,30,1,00442,India
392688,2023-03-31,701,gel pen,5,10,5,1,00136,India
653995,2023-03-31,711,TD kit,150,300,150,1,00307,India
653995,2023-03-31,703,eraser,1,3,2,1,00307,India
653995,2023-03-31,716,printing paper,200,400,200,1,00307,India
894590,2023-03-31,713,ball pen,5,10,5,1,00196,India
894590,2023-03-31,711,TD kit,150,300,150,1,00196,India
453060,2023-03-31,706,sharpener,3,8,5,1,00429,India
453060,2023-03-31,705,stencil,10,20,10,1,00429,India
453060,2023-03-31,711,TD kit,150,300,150,1,00429,India
453060,2023-03-31,712,graph paper,20,40,20,1,00429,India
523428,2023-03-31,716,printing paper,200,400,200,1,00362,India
668753,2023-03-31,712,graph paper,20,40,20,1,00185,India
668753,2023-03-31,716,printing paper,200,400,200,1,00185,India
668753,2023-03-31,709,notebook,30,60,30,1,00185,India
668753,2023-03-31,704,scale,5,10,5,1,00185,India
275995,2023-03-31,703,eraser,1,3,2,1,00449,India
275995,2023-03-31,716,printing paper,200,400,200,1,00449,India
275995,2023-03-31,705,stencil,10,20,10,1,00449,India
275995,2023-03-31,714,carbon paper,15,30,15,1,00449,India
472414,2023-03-31,708,sketchpen,15,40,25,1,00185,India
472414,2023-03-31,709,notebook,30,60,30,1,00185,India
472414,2023-03-31,705,stencil,10,20,10,1,00185,India
957626,2023-03-31,712,graph paper,20,40,20,1,00400,India
957626,2023-03-31,701,gel pen,5,10,5,1,00400,India
957626,2023-03-31,710,geometry box,100,150,50,1,00400,India
957626,2023-03-31,714,carbon paper,15,30,15,1,00400,India
701821,2023-03-31,709,notebook,30,60,30,1,00238,India
701821,2023-03-31,713,ball pen,5,10,5,1,00238,India
701821,2023-03-31,707,marker,20,40,20,1,00238,India
685323,2023-03-31,713,ball pen,5,10,5,1,00137,India
685323,2023-03-31,701,gel pen,5,10,5,1,00137,India
685323,2023-03-31,707,marker,20,40,20,1,00137,India
685323,2023-03-31,711,TD kit,150,300,150,1,00137,India
453290,2023-03-31,705,stencil,10,20,10,1,00359,India
453290,2023-03-31,707,marker,20,40,20,1,00359,India
453290,2023-03-31,716,printing paper,200,400,200,1,00359,India
147043,2023-03-31,710,geometry box,100,150,50,1,00485,India
864142,2023-03-31,701,gel pen,5,10,5,1,00337,India
864142,2023-03-31,707,marker,20,40,20,1,00337,India
864142,2023-03-31,717,spiral bound book,50,100,50,1,00337,India
840668,2023-03-31,712,graph paper,20,40,20,1,00430,India
840668,2023-03-31,711,TD kit,150,300,150,1,00430,India
383457,2023-03-31,716,printing paper,200,400,200,1,00405,India
383457,2023-03-31,702,pencil,2,5,3,1,00405,India
383457,2023-03-31,709,notebook,30,60,30,1,00405,India
882135,2023-03-31,709,notebook,30,60,30,1,00141,India
882135,2023-03-31,711,TD kit,150,300,150,1,00141,India
882135,2023-03-31,703,eraser,1,3,2,1,00141,India
882135,2023-03-31,714,carbon paper,15,30,15,1,00141,India
346360,2023-03-31,707,marker,20,40,20,1,00275,India
370278,2023-03-31,709,notebook,30,60,30,1,00003,India
370278,2023-03-31,711,TD kit,150,300,150,1,00003,India
370278,2023-03-31,704,scale,5,10,5,1,00003,India
370278,2023-03-31,716,printing paper,200,400,200,1,00003,India
540279,2023-03-31,707,marker,20,40,20,1,00374,India
540279,2023-03-31,702,pencil,2,5,3,1,00374,India
540279,2023-03-31,704,scale,5,10,5,1,00374,India
540279,2023-03-31,716,printing paper,200,400,200,1,00374,India
539591,2023-03-31,705,stencil,10,20,10,1,00419,India
539591,2023-03-31,710,geometry box,100,150,50,1,00419,India
539591,2023-03-31,708,sketchpen,15,40,25,1,00419,India
539591,2023-03-31,714,carbon paper,15,30,15,1,00419,India
952501,2023-03-31,711,TD kit,150,300,150,1,00020,India
739991,2023-03-31,710,geometry box,100,150,50,1,00178,India
739991,2023-03-31,706,sharpener,3,8,5,1,00178,India
739991,2023-03-31,709,notebook,30,60,30,1,00178,India
658789,2023-03-31,713,ball pen,5,10,5,1,00402,India
658789,2023-03-31,706,sharpener,3,8,5,1,00402,India
658789,2023-03-31,707,marker,20,40,20,1,00402,India
524174,2023-03-31,716,printing paper,200,400,200,1,00481,India
524174,2023-03-31,705,stencil,10,20,10,1,00481,India
524174,2023-03-31,709,notebook,30,60,30,1,00481,India
663976,2023-03-31,714,carbon paper,15,30,15,1,00389,India
663976,2023-03-31,712,graph paper,20,40,20,1,00389,India
729035,2023-03-31,708,sketchpen,15,40,25,1,00077,India
729035,2023-03-31,713,ball pen,5,10,5,1,00077,India
729035,2023-03-31,717,spiral bound book,50,100,50,1,00077,India
859518,2023-03-31,717,spiral bound book,50,100,50,1,00344,India
859518,2023-03-31,714,carbon paper,15,30,15,1,00344,India
859518,2023-03-31,705,stencil,10,20,10,1,00344,India
859518,2023-03-31,712,graph paper,20,40,20,1,00344,India
608499,2023-03-31,701,gel pen,5,10,5,1,00183,India
608499,2023-03-31,716,printing paper,200,400,200,1,00183,India
246435,2023-03-31,702,pencil,2,5,3,1,00081,India
246435,2023-03-31,706,sharpener,3,8,5,1,00081,India
246435,2023-03-31,705,stencil,10,20,10,1,00081,India
246435,2023-03-31,716,printing paper,200,400,200,1,00081,India
246435,2023-03-31,712,graph paper,20,40,20,1,00081,India
993811,2023-03-31,711,TD kit,150,300,150,1,00314,India
374780,2023-03-31,708,sketchpen,15,40,25,1,00470,India
799387,2023-03-31,701,gel pen,5,10,5,1,00128,India
799387,2023-03-31,709,notebook,30,60,30,1,00128,India
799387,2023-03-31,717,spiral bound book,50,100,50,1,00128,India
799387,2023-03-31,716,printing paper,200,400,200,1,00128,India
591356,2023-03-31,717,spiral bound book,50,100,50,1,00380,India
591356,2023-03-31,708,sketchpen,15,40,25,1,00380,India
591356,2023-03-31,703,eraser,1,3,2,1,00380,India
441627,2023-03-31,708,sketchpen,15,40,25,1,00117,India
441627,2023-03-31,702,pencil,2,5,3,1,00117,India
441627,2023-03-31,706,sharpener,3,8,5,1,00117,India
752585,2023-03-31,703,eraser,1,3,2,1,00301,India
689427,2023-04-01,705,stencil,10,20,10,2,00467,India
689427,2023-04-01,707,marker,20,40,20,1,00467,India
689427,2023-04-01,701,gel pen,5,10,5,2,00467,India
689427,2023-04-01,703,eraser,1,3,2,2,00467,India
689427,2023-04-01,704,scale,5,10,5,2,00467,India
151389,2023-04-01,704,scale,5,10,5,2,00004,India
151389,2023-04-01,706,sharpener,3,8,5,2,00004,India
151389,2023-04-01,710,geometry box,100,150,50,2,00004,India
888457,2023-04-01,707,marker,20,40,20,1,00337,India
304548,2023-04-01,716,printing paper,200,400,200,1,00443,India
304548,2023-04-01,709,notebook,30,60,30,2,00443,India
304548,2023-04-01,711,TD kit,150,300,150,1,00443,India
304548,2023-04-01,717,spiral bound book,50,100,50,1,00443,India
115164,2023-04-01,709,notebook,30,60,30,2,00206,India
638590,2023-04-01,715,folder,5,15,10,1,00491,India
638590,2023-04-01,711,TD kit,150,300,150,1,00491,India
638590,2023-04-01,712,graph paper,20,40,20,1,00491,India
638590,2023-04-01,713,ball pen,5,10,5,2,00491,India
638590,2023-04-01,706,sharpener,3,8,5,2,00491,India
543244,2023-04-01,704,scale,5,10,5,2,00466,India
504187,2023-04-01,705,stencil,10,20,10,2,00180,India
504187,2023-04-01,708,sketchpen,15,40,25,1,00180,India
504187,2023-04-01,712,graph paper,20,40,20,1,00180,India
504187,2023-04-01,706,sharpener,3,8,5,2,00180,India
967431,2023-04-01,711,TD kit,150,300,150,1,00298,India
162234,2023-04-01,708,sketchpen,15,40,25,1,00168,India
624628,2023-04-01,712,graph paper,20,40,20,1,00047,India
624628,2023-04-01,711,TD kit,150,300,150,1,00047,India
624628,2023-04-01,701,gel pen,5,10,5,2,00047,India
624628,2023-04-01,714,carbon paper,15,30,15,1,00047,India
147782,2023-04-01,702,pencil,2,5,3,2,00176,India
147782,2023-04-01,703,eraser,1,3,2,2,00176,India
147782,2023-04-01,701,gel pen,5,10,5,2,00176,India
147782,2023-04-01,707,marker,20,40,20,1,00176,India
231708,2023-04-01,714,carbon paper,15,30,15,1,00457,India
231708,2023-04-01,715,folder,5,15,10,1,00457,India
145835,2023-04-01,711,TD kit,150,300,150,1,00146,India
314635,2023-04-01,715,folder,5,15,10,1,00387,India
314635,2023-04-01,709,notebook,30,60,30,2,00387,India
314635,2023-04-01,717,spiral bound book,50,100,50,1,00387,India
314635,2023-04-01,712,graph paper,20,40,20,1,00387,India
314635,2023-04-01,703,eraser,1,3,2,2,00387,India
870635,2023-04-01,707,marker,20,40,20,1,00055,India
770471,2023-04-01,714,carbon paper,15,30,15,1,00363,India
770471,2023-04-01,705,stencil,10,20,10,2,00363,India
770471,2023-04-01,704,scale,5,10,5,2,00363,India
770471,2023-04-01,707,marker,20,40,20,1,00363,India
591338,2023-04-01,711,TD kit,150,300,150,1,00062,India
832528,2023-04-01,707,marker,20,40,20,1,00080,India
832528,2023-04-01,704,scale,5,10,5,2,00080,India
832528,2023-04-01,711,TD kit,150,300,150,1,00080,India
213903,2023-04-01,712,graph paper,20,40,20,1,00158,India
213903,2023-04-01,711,TD kit,150,300,150,1,00158,India
213903,2023-04-01,701,gel pen,5,10,5,2,00158,India
284020,2023-04-01,710,geometry box,100,150,50,2,00294,India
284020,2023-04-01,709,notebook,30,60,30,2,00294,India
284020,2023-04-01,708,sketchpen,15,40,25,1,00294,India
284020,2023-04-01,717,spiral bound book,50,100,50,1,00294,India
595441,2023-04-01,711,TD kit,150,300,150,1,00449,India
595441,2023-04-01,703,eraser,1,3,2,2,00449,India
104413,2023-04-01,715,folder,5,15,10,1,00352,India
104413,2023-04-01,712,graph paper,20,40,20,1,00352,India
104413,2023-04-01,702,pencil,2,5,3,2,00352,India
104413,2023-04-01,706,sharpener,3,8,5,2,00352,India
451591,2023-04-01,705,stencil,10,20,10,2,00041,India
451591,2023-04-01,716,printing paper,200,400,200,1,00041,India
451591,2023-04-01,707,marker,20,40,20,1,00041,India
159187,2023-04-01,713,ball pen,5,10,5,2,00075,India
159187,2023-04-01,707,marker,20,40,20,1,00075,India
159187,2023-04-01,704,scale,5,10,5,2,00075,India
159187,2023-04-01,701,gel pen,5,10,5,2,00075,India
159187,2023-04-01,716,printing paper,200,400,200,1,00075,India
332591,2023-04-01,712,graph paper,20,40,20,1,00066,India
332591,2023-04-01,715,folder,5,15,10,1,00066,India
332591,2023-04-01,711,TD kit,150,300,150,1,00066,India
332591,2023-04-01,706,sharpener,3,8,5,2,00066,India
332591,2023-04-01,714,carbon paper,15,30,15,1,00066,India
150921,2023-04-01,704,scale,5,10,5,2,00486,India
150921,2023-04-01,708,sketchpen,15,40,25,1,00486,India
150921,2023-04-01,709,notebook,30,60,30,2,00486,India
100238,2023-04-01,716,printing paper,200,400,200,1,00182,India
100238,2023-04-01,702,pencil,2,5,3,2,00182,India
961295,2023-04-01,713,ball pen,5,10,5,2,00430,India
961295,2023-04-01,715,folder,5,15,10,1,00430,India
152849,2023-04-01,708,sketchpen,15,40,25,1,00365,India
152849,2023-04-01,715,folder,5,15,10,1,00365,India
152849,2023-04-01,713,ball pen,5,10,5,2,00365,India
152849,2023-04-01,701,gel pen,5,10,5,2,00365,India
989493,2023-04-01,701,gel pen,5,10,5,2,00230,India
771008,2023-04-01,709,notebook,30,60,30,2,00022,India
771008,2023-04-01,713,ball pen,5,10,5,2,00022,India
771008,2023-04-01,715,folder,5,15,10,1,00022,India
771008,2023-04-01,703,eraser,1,3,2,2,00022,India
771008,2023-04-01,704,scale,5,10,5,2,00022,India
940821,2023-04-01,713,ball pen,5,10,5,2,00085,India
940821,2023-04-01,705,stencil,10,20,10,2,00085,India
881149,2023-04-01,707,marker,20,40,20,1,00340,India
881149,2023-04-01,711,TD kit,150,300,150,1,00340,India
881149,2023-04-01,713,ball pen,5,10,5,2,00340,India
881149,2023-04-01,714,carbon paper,15,30,15,1,00340,India
292378,2023-04-01,716,printing paper,200,400,200,1,00403,India
794302,2023-04-01,703,eraser,1,3,2,2,00209,India
794302,2023-04-01,705,stencil,10,20,10,2,00209,India
794302,2023-04-01,709,notebook,30,60,30,2,00209,India
794302,2023-04-01,716,printing paper,200,400,200,1,00209,India
767102,2023-04-01,717,spiral bound book,50,100,50,1,00440,India
767102,2023-04-01,714,carbon paper,15,30,15,1,00440,India
373309,2023-04-01,707,marker,20,40,20,1,00402,India
373309,2023-04-01,717,spiral bound book,50,100,50,1,00402,India
923182,2023-04-01,702,pencil,2,5,3,2,00180,India
923182,2023-04-01,706,sharpener,3,8,5,2,00180,India
923182,2023-04-01,705,stencil,10,20,10,2,00180,India
923182,2023-04-01,704,scale,5,10,5,2,00180,India
250977,2023-04-01,709,notebook,30,60,30,2,00425,India
250977,2023-04-01,707,marker,20,40,20,1,00425,India
250977,2023-04-01,701,gel pen,5,10,5,2,00425,India
250977,2023-04-01,711,TD kit,150,300,150,1,00425,India
250977,2023-04-01,715,folder,5,15,10,1,00425,India
964727,2023-04-01,710,geometry box,100,150,50,2,00400,India
964727,2023-04-01,709,notebook,30,60,30,2,00400,India
964727,2023-04-01,706,sharpener,3,8,5,2,00400,India
964727,2023-04-01,704,scale,5,10,5,2,00400,India
953167,2023-04-01,712,graph paper,20,40,20,1,00276,India
360767,2023-04-01,704,scale,5,10,5,2,00183,India
669102,2023-04-01,714,carbon paper,15,30,15,1,00090,India
669102,2023-04-01,716,printing paper,200,400,200,1,00090,India
669102,2023-04-01,705,stencil,10,20,10,2,00090,India
917208,2023-04-01,717,spiral bound book,50,100,50,1,00010,India
917208,2023-04-01,707,marker,20,40,20,1,00010,India
917208,2023-04-01,714,carbon paper,15,30,15,1,00010,India
579266,2023-04-01,710,geometry box,100,150,50,2,00137,India
579266,2023-04-01,702,pencil,2,5,3,2,00137,India
579266,2023-04-01,708,sketchpen,15,40,25,1,00137,India
470268,2023-04-01,706,sharpener,3,8,5,2,00204,India
470268,2023-04-01,705,stencil,10,20,10,2,00204,India
482134,2023-04-02,706,sharpener,3,8,5,2,00164,India
482134,2023-04-02,711,TD kit,150,300,150,1,00164,India
355963,2023-04-02,711,TD kit,150,300,150,1,00429,India
782827,2023-04-02,706,sharpener,3,8,5,2,00494,India
330903,2023-04-02,708,sketchpen,15,40,25,1,00451,India
330903,2023-04-02,702,pencil,2,5,3,2,00451,India
330903,2023-04-02,711,TD kit,150,300,150,1,00451,India
330903,2023-04-02,704,scale,5,10,5,2,00451,India
311507,2023-04-02,713,ball pen,5,10,5,2,00361,India
806757,2023-04-02,707,marker,20,40,20,1,00205,India
860957,2023-04-02,704,scale,5,10,5,2,00077,India
178301,2023-04-02,710,geometry box,100,150,50,2,00225,India
178301,2023-04-02,703,eraser,1,3,2,2,00225,India
178301,2023-04-02,701,gel pen,5,10,5,2,00225,India
641081,2023-04-02,712,graph paper,20,40,20,1,00253,India
641081,2023-04-02,707,marker,20,40,20,1,00253,India
338460,2023-04-02,702,pencil,2,5,3,2,00314,India
338460,2023-04-02,707,marker,20,40,20,1,00314,India
338460,2023-04-02,712,graph paper,20,40,20,1,00314,India
338460,2023-04-02,708,sketchpen,15,40,25,1,00314,India
498861,2023-04-02,702,pencil,2,5,3,2,00084,India
498861,2023-04-02,711,TD kit,150,300,150,1,00084,India
498861,2023-04-02,712,graph paper,20,40,20,1,00084,India
178849,2023-04-02,716,printing paper,200,400,200,1,00131,India
218711,2023-04-02,701,gel pen,5,10,5,2,00489,India
218711,2023-04-02,711,TD kit,150,300,150,1,00489,India
218711,2023-04-02,716,printing paper,200,400,200,1,00489,India
262195,2023-04-02,703,eraser,1,3,2,2,00383,India
262195,2023-04-02,715,folder,5,15,10,1,00383,India
262195,2023-04-02,706,sharpener,3,8,5,2,00383,India
262195,2023-04-02,707,marker,20,40,20,1,00383,India
413278,2023-04-02,705,stencil,10,20,10,2,00380,India
413278,2023-04-02,711,TD kit,150,300,150,1,00380,India
413278,2023-04-02,710,geometry box,100,150,50,2,00380,India
962261,2023-04-02,702,pencil,2,5,3,2,00073,India
837900,2023-04-02,703,eraser,1,3,2,2,00416,India
837900,2023-04-02,714,carbon paper,15,30,15,1,00416,India
837900,2023-04-02,707,marker,20,40,20,1,00416,India
837900,2023-04-02,716,printing paper,200,400,200,1,00416,India
796735,2023-04-02,712,graph paper,20,40,20,1,00339,India
110984,2023-04-02,712,graph paper,20,40,20,1,00033,India
110984,2023-04-02,703,eraser,1,3,2,2,00033,India
110984,2023-04-02,715,folder,5,15,10,1,00033,India
358928,2023-04-02,709,notebook,30,60,30,2,00332,India
358928,2023-04-02,711,TD kit,150,300,150,1,00332,India
883453,2023-04-02,704,scale,5,10,5,2,00281,India
458897,2023-04-02,701,gel pen,5,10,5,2,00313,India
458897,2023-04-02,713,ball pen,5,10,5,2,00313,India
458897,2023-04-02,714,carbon paper,15,30,15,1,00313,India
458897,2023-04-02,711,TD kit,150,300,150,1,00313,India
917591,2023-04-02,701,gel pen,5,10,5,2,00091,India
917591,2023-04-02,705,stencil,10,20,10,2,00091,India
917591,2023-04-02,704,scale,5,10,5,2,00091,India
958525,2023-04-02,709,notebook,30,60,30,2,00093,India
958525,2023-04-02,702,pencil,2,5,3,2,00093,India
958525,2023-04-02,701,gel pen,5,10,5,2,00093,India
958525,2023-04-02,704,scale,5,10,5,2,00093,India
958525,2023-04-02,707,marker,20,40,20,1,00093,India
462885,2023-04-02,713,ball pen,5,10,5,2,00340,India
462885,2023-04-02,712,graph paper,20,40,20,1,00340,India
462885,2023-04-02,714,carbon paper,15,30,15,1,00340,India
739069,2023-04-02,711,TD kit,150,300,150,1,00442,India
739069,2023-04-02,712,graph paper,20,40,20,1,00442,India
739069,2023-04-02,705,stencil,10,20,10,2,00442,India
962767,2023-04-02,715,folder,5,15,10,1,00151,India
962767,2023-04-02,707,marker,20,40,20,1,00151,India
962767,2023-04-02,702,pencil,2,5,3,2,00151,India
898074,2023-04-02,707,marker,20,40,20,1,00212,India
599310,2023-04-02,701,gel pen,5,10,5,2,00429,India
974964,2023-04-02,710,geometry box,100,150,50,2,00236,India
974964,2023-04-02,711,TD kit,150,300,150,1,00236,India
974964,2023-04-02,703,eraser,1,3,2,2,00236,India
974964,2023-04-02,705,stencil,10,20,10,2,00236,India
791377,2023-04-02,706,sharpener,3,8,5,2,00129,India
791377,2023-04-02,703,eraser,1,3,2,2,00129,India
791377,2023-04-02,702,pencil,2,5,3,2,00129,India
735378,2023-04-03,709,notebook,30,60,30,2,00370,India
735378,2023-04-03,717,spiral bound book,50,100,50,1,00370,India
735378,2023-04-03,705,stencil,10,20,10,2,00370,India
735378,2023-04-03,713,ball pen,5,10,5,2,00370,India
735378,2023-04-03,715,folder,5,15,10,1,00370,India
703528,2023-04-03,709,notebook,30,60,30,2,00256,India
703528,2023-04-03,704,scale,5,10,5,2,00256,India
576928,2023-04-03,709,notebook,30,60,30,2,00313,India
576928,2023-04-03,704,scale,5,10,5,2,00313,India
576928,2023-04-03,712,graph paper,20,40,20,1,00313,India
576928,2023-04-03,715,folder,5,15,10,1,00313,India
716160,2023-04-03,709,notebook,30,60,30,2,00045,India
716160,2023-04-03,710,geometry box,100,150,50,2,00045,India
716160,2023-04-03,716,printing paper,200,400,200,1,00045,India
716160,2023-04-03,713,ball pen,5,10,5,2,00045,India
951693,2023-04-03,701,gel pen,5,10,5,2,00401,India
951693,2023-04-03,715,folder,5,15,10,1,00401,India
951693,2023-04-03,707,marker,20,40,20,1,00401,India
951693,2023-04-03,709,notebook,30,60,30,2,00401,India
275331,2023-04-03,715,folder,5,15,10,1,00391,India
733769,2023-04-03,708,sketchpen,15,40,25,1,00217,India
733769,2023-04-03,716,printing paper,200,400,200,1,00217,India
945022,2023-04-03,706,sharpener,3,8,5,2,00366,India
945022,2023-04-03,707,marker,20,40,20,1,00366,India
945022,2023-04-03,715,folder,5,15,10,1,00366,India
390879,2023-04-03,710,geometry box,100,150,50,2,00067,India
390879,2023-04-03,709,notebook,30,60,30,2,00067,India
285485,2023-04-03,703,eraser,1,3,2,2,00065,India
800170,2023-04-03,703,eraser,1,3,2,2,00412,India
548152,2023-04-03,704,scale,5,10,5,2,00077,India
548152,2023-04-03,712,graph paper,20,40,20,1,00077,India
597322,2023-04-03,705,stencil,10,20,10,2,00013,India
597322,2023-04-03,712,graph paper,20,40,20,1,00013,India
869572,2023-04-03,715,folder,5,15,10,1,00441,India
869572,2023-04-03,714,carbon paper,15,30,15,1,00441,India
869572,2023-04-03,716,printing paper,200,400,200,1,00441,India
156068,2023-04-03,711,TD kit,150,300,150,1,00252,India
156068,2023-04-03,707,marker,20,40,20,1,00252,India
156068,2023-04-03,716,printing paper,200,400,200,1,00252,India
599161,2023-04-03,705,stencil,10,20,10,2,00038,India
599161,2023-04-03,709,notebook,30,60,30,2,00038,India
599161,2023-04-03,712,graph paper,20,40,20,1,00038,India
599161,2023-04-03,711,TD kit,150,300,150,1,00038,India
468764,2023-04-03,715,folder,5,15,10,1,00025,India
468764,2023-04-03,717,spiral bound book,50,100,50,1,00025,India
468764,2023-04-03,713,ball pen,5,10,5,2,00025,India
154089,2023-04-03,705,stencil,10,20,10,2,00310,India
154089,2023-04-03,710,geometry box,100,150,50,2,00310,India
154089,2023-04-03,715,folder,5,15,10,1,00310,India
154089,2023-04-03,712,graph paper,20,40,20,1,00310,India
613411,2023-04-03,704,scale,5,10,5,2,00366,India
613411,2023-04-03,714,carbon paper,15,30,15,1,00366,India
590364,2023-04-03,716,printing paper,200,400,200,1,00067,India
543128,2023-04-03,710,geometry box,100,150,50,2,00450,India
543128,2023-04-03,702,pencil,2,5,3,2,00450,India
781655,2023-04-03,708,sketchpen,15,40,25,1,00480,India
781655,2023-04-03,705,stencil,10,20,10,2,00480,India
580704,2023-04-03,712,graph paper,20,40,20,1,00324,India
580704,2023-04-03,715,folder,5,15,10,1,00324,India
580704,2023-04-03,703,eraser,1,3,2,2,00324,India
580704,2023-04-03,710,geometry box,100,150,50,2,00324,India
580704,2023-04-03,714,carbon paper,15,30,15,1,00324,India
890128,2023-04-03,705,stencil,10,20,10,2,00191,India
890128,2023-04-03,712,graph paper,20,40,20,1,00191,India
890128,2023-04-03,706,sharpener,3,8,5,2,00191,India
890128,2023-04-03,713,ball pen,5,10,5,2,00191,India
116487,2023-04-03,717,spiral bound book,50,100,50,1,00482,India
116487,2023-04-03,710,geometry box,100,150,50,2,00482,India
972381,2023-04-03,712,graph paper,20,40,20,1,00376,India
972381,2023-04-03,702,pencil,2,5,3,2,00376,India
408861,2023-04-03,710,geometry box,100,150,50,2,00090,India
408861,2023-04-03,712,graph paper,20,40,20,1,00090,India
408861,2023-04-03,716,printing paper,200,400,200,1,00090,India
730482,2023-04-03,705,stencil,10,20,10,2,00414,India
730482,2023-04-03,706,sharpener,3,8,5,2,00414,India
730482,2023-04-03,703,eraser,1,3,2,2,00414,India
730482,2023-04-03,714,carbon paper,15,30,15,1,00414,India
183934,2023-04-03,714,carbon paper,15,30,15,1,00336,India
245020,2023-04-03,715,folder,5,15,10,1,00285,India
245020,2023-04-03,714,carbon paper,15,30,15,1,00285,India
245020,2023-04-03,711,TD kit,150,300,150,1,00285,India
245020,2023-04-03,704,scale,5,10,5,2,00285,India
637058,2023-04-03,710,geometry box,100,150,50,2,00068,India
268085,2023-04-03,704,scale,5,10,5,2,00432,India
268085,2023-04-03,716,printing paper,200,400,200,1,00432,India
268085,2023-04-03,701,gel pen,5,10,5,2,00432,India
532343,2023-04-03,712,graph paper,20,40,20,1,00497,India
608502,2023-04-03,716,printing paper,200,400,200,1,00003,India
608502,2023-04-03,711,TD kit,150,300,150,1,00003,India
119718,2023-04-03,712,graph paper,20,40,20,1,00130,India
119718,2023-04-03,705,stencil,10,20,10,2,00130,India
119718,2023-04-03,707,marker,20,40,20,1,00130,India
119718,2023-04-03,713,ball pen,5,10,5,2,00130,India
119718,2023-04-03,714,carbon paper,15,30,15,1,00130,India
122877,2023-04-03,707,marker,20,40,20,1,00075,India
122877,2023-04-03,711,TD kit,150,300,150,1,00075,India
122877,2023-04-03,706,sharpener,3,8,5,2,00075,India
122877,2023-04-03,713,ball pen,5,10,5,2,00075,India
251937,2023-04-03,712,graph paper,20,40,20,1,00471,India
251937,2023-04-03,711,TD kit,150,300,150,1,00471,India
251937,2023-04-03,704,scale,5,10,5,2,00471,India
284756,2023-04-03,715,folder,5,15,10,1,00197,India
149445,2023-04-03,714,carbon paper,15,30,15,1,00053,India
149445,2023-04-03,710,geometry box,100,150,50,2,00053,India
149445,2023-04-03,716,printing paper,200,400,200,1,00053,India
149445,2023-04-03,711,TD kit,150,300,150,1,00053,India
679602,2023-04-03,717,spiral bound book,50,100,50,1,00308,India
679602,2023-04-03,704,scale,5,10,5,2,00308,India
679602,2023-04-03,712,graph paper,20,40,20,1,00308,India
679602,2023-04-03,716,printing paper,200,400,200,1,00308,India
821656,2023-04-03,714,carbon paper,15,30,15,1,00208,India
821656,2023-04-03,703,eraser,1,3,2,2,00208,India
609407,2023-04-03,706,sharpener,3,8,5,2,00305,India
609407,2023-04-03,710,geometry box,100,150,50,2,00305,India
609407,2023-04-03,711,TD kit,150,300,150,1,00305,India
609407,2023-04-03,716,printing paper,200,400,200,1,00305,India
234593,2023-04-03,710,geometry box,100,150,50,2,00439,India
530094,2023-04-03,713,ball pen,5,10,5,2,00382,India
222357,2023-04-04,707,marker,20,40,20,1,00043,India
260059,2023-04-04,709,notebook,30,60,30,2,00398,India
260059,2023-04-04,715,folder,5,15,10,1,00398,India
260059,2023-04-04,713,ball pen,5,10,5,2,00398,India
928846,2023-04-04,701,gel pen,5,10,5,2,00258,India
679071,2023-04-04,708,sketchpen,15,40,25,1,00122,India
403405,2023-04-04,707,marker,20,40,20,1,00002,India
403405,2023-04-04,711,TD kit,150,300,150,1,00002,India
403405,2023-04-04,710,geometry box,100,150,50,2,00002,India
446388,2023-04-04,716,printing paper,200,400,200,1,00435,India
283862,2023-04-04,710,geometry box,100,150,50,2,00446,India
283862,2023-04-04,709,notebook,30,60,30,2,00446,India
993313,2023-04-04,715,folder,5,15,10,1,00271,India
993313,2023-04-04,709,notebook,30,60,30,2,00271,India
696204,2023-04-04,714,carbon paper,15,30,15,1,00012,India
696204,2023-04-04,711,TD kit,150,300,150,1,00012,India
615415,2023-04-04,711,TD kit,150,300,150,1,00246,India
615415,2023-04-04,701,gel pen,5,10,5,2,00246,India
615415,2023-04-04,717,spiral bound book,50,100,50,1,00246,India
615415,2023-04-04,704,scale,5,10,5,2,00246,India
615415,2023-04-04,712,graph paper,20,40,20,1,00246,India
390323,2023-04-04,706,sharpener,3,8,5,2,00224,India
265095,2023-04-04,707,marker,20,40,20,1,00121,India
265095,2023-04-04,705,stencil,10,20,10,2,00121,India
265095,2023-04-04,706,sharpener,3,8,5,2,00121,India
169993,2023-04-04,709,notebook,30,60,30,2,00463,India
958723,2023-04-04,716,printing paper,200,400,200,1,00448,India
958723,2023-04-04,702,pencil,2,5,3,2,00448,India
958723,2023-04-04,701,gel pen,5,10,5,2,00448,India
958723,2023-04-04,704,scale,5,10,5,2,00448,India
473035,2023-04-04,717,spiral bound book,50,100,50,1,00140,India
473035,2023-04-04,716,printing paper,200,400,200,1,00140,India
473035,2023-04-04,707,marker,20,40,20,1,00140,India
539474,2023-04-04,704,scale,5,10,5,2,00396,India
539474,2023-04-04,712,graph paper,20,40,20,1,00396,India
539474,2023-04-04,702,pencil,2,5,3,2,00396,India
652875,2023-04-04,717,spiral bound book,50,100,50,1,00107,India
652875,2023-04-04,713,ball pen,5,10,5,2,00107,India
252179,2023-04-04,713,ball pen,5,10,5,2,00119,India
252179,2023-04-04,704,scale,5,10,5,2,00119,India
252179,2023-04-04,708,sketchpen,15,40,25,1,00119,India
252179,2023-04-04,710,geometry box,100,150,50,2,00119,India
252179,2023-04-04,701,gel pen,5,10,5,2,00119,India
679292,2023-04-04,712,graph paper,20,40,20,1,00223,India
679292,2023-04-04,707,marker,20,40,20,1,00223,India
679292,2023-04-04,715,folder,5,15,10,1,00223,India
679292,2023-04-04,717,spiral bound book,50,100,50,1,00223,India
739359,2023-04-04,703,eraser,1,3,2,2,00304,India
739359,2023-04-04,716,printing paper,200,400,200,1,00304,India
552322,2023-04-04,705,stencil,10,20,10,2,00067,India
755330,2023-04-04,704,scale,5,10,5,2,00126,India
755330,2023-04-04,702,pencil,2,5,3,2,00126,India
294886,2023-04-04,710,geometry box,100,150,50,2,00277,India
666229,2023-04-04,716,printing paper,200,400,200,1,00080,India
666229,2023-04-04,706,sharpener,3,8,5,2,00080,India
666229,2023-04-04,705,stencil,10,20,10,2,00080,India
666229,2023-04-04,702,pencil,2,5,3,2,00080,India
666229,2023-04-04,717,spiral bound book,50,100,50,1,00080,India
250246,2023-04-04,708,sketchpen,15,40,25,1,00123,India
614425,2023-04-04,705,stencil,10,20,10,2,00172,India
614425,2023-04-04,717,spiral bound book,50,100,50,1,00172,India
614425,2023-04-04,709,notebook,30,60,30,2,00172,India
563749,2023-04-04,706,sharpener,3,8,5,2,00352,India
563749,2023-04-04,707,marker,20,40,20,1,00352,India
563749,2023-04-04,713,ball pen,5,10,5,2,00352,India
767266,2023-04-04,713,ball pen,5,10,5,2,00076,India
767266,2023-04-04,716,printing paper,200,400,200,1,00076,India
767266,2023-04-04,712,graph paper,20,40,20,1,00076,India
767266,2023-04-04,705,stencil,10,20,10,2,00076,India
329489,2023-04-04,717,spiral bound book,50,100,50,1,00235,India
329489,2023-04-04,710,geometry box,100,150,50,2,00235,India
329489,2023-04-04,705,stencil,10,20,10,2,00235,India
619053,2023-04-04,713,ball pen,5,10,5,2,00218,India
619053,2023-04-04,705,stencil,10,20,10,2,00218,India
619053,2023-04-04,701,gel pen,5,10,5,2,00218,India
142725,2023-04-04,717,spiral bound book,50,100,50,1,00093,India
142725,2023-04-04,706,sharpener,3,8,5,2,00093,India
142725,2023-04-04,701,gel pen,5,10,5,2,00093,India
142725,2023-04-04,709,notebook,30,60,30,2,00093,India
142725,2023-04-04,712,graph paper,20,40,20,1,00093,India
845558,2023-04-04,712,graph paper,20,40,20,1,00108,India
845558,2023-04-04,705,stencil,10,20,10,2,00108,India
955805,2023-04-04,708,sketchpen,15,40,25,1,00321,India
955805,2023-04-04,715,folder,5,15,10,1,00321,India
955805,2023-04-04,707,marker,20,40,20,1,00321,India
590619,2023-04-04,713,ball pen,5,10,5,2,00162,India
590619,2023-04-04,701,gel pen,5,10,5,2,00162,India
590619,2023-04-04,703,eraser,1,3,2,2,00162,India
590619,2023-04-04,712,graph paper,20,40,20,1,00162,India
333589,2023-04-04,713,ball pen,5,10,5,2,00089,India
559904,2023-04-04,703,eraser,1,3,2,2,00206,India
559904,2023-04-04,711,TD kit,150,300,150,1,00206,India
559904,2023-04-04,705,stencil,10,20,10,2,00206,India
559904,2023-04-04,715,folder,5,15,10,1,00206,India
559904,2023-04-04,707,marker,20,40,20,1,00206,India
695059,2023-04-04,715,folder,5,15,10,1,00364,India
695059,2023-04-04,704,scale,5,10,5,2,00364,India
695059,2023-04-04,703,eraser,1,3,2,2,00364,India
179605,2023-04-04,710,geometry box,100,150,50,2,00089,India
179605,2023-04-04,715,folder,5,15,10,1,00089,India
698504,2023-04-04,716,printing paper,200,400,200,1,00472,India
698504,2023-04-04,711,TD kit,150,300,150,1,00472,India
698504,2023-04-04,705,stencil,10,20,10,2,00472,India
698504,2023-04-04,712,graph paper,20,40,20,1,00472,India
698504,2023-04-04,713,ball pen,5,10,5,2,00472,India
485223,2023-04-04,711,TD kit,150,300,150,1,00036,India
485223,2023-04-04,709,notebook,30,60,30,2,00036,India
224602,2023-04-04,713,ball pen,5,10,5,2,00394,India
224602,2023-04-04,717,spiral bound book,50,100,50,1,00394,India
686556,2023-04-04,702,pencil,2,5,3,2,00075,India
471627,2023-04-04,711,TD kit,150,300,150,1,00350,India
471627,2023-04-04,712,graph paper,20,40,20,1,00350,India
119587,2023-04-05,716,printing paper,200,400,200,1,00353,India
119587,2023-04-05,709,notebook,30,60,30,2,00353,India
119587,2023-04-05,703,eraser,1,3,2,2,00353,India
119587,2023-04-05,704,scale,5,10,5,2,00353,India
119587,2023-04-05,717,spiral bound book,50,100,50,1,00353,India
865165,2023-04-05,702,pencil,2,5,3,2,00400,India
967919,2023-04-05,701,gel pen,5,10,5,2,00369,India
967919,2023-04-05,716,printing paper,200,400,200,1,00369,India
967919,2023-04-05,708,sketchpen,15,40,25,1,00369,India
967919,2023-04-05,717,spiral bound book,50,100,50,1,00369,India
736356,2023-04-05,703,eraser,1,3,2,2,00121,India
736356,2023-04-05,709,notebook,30,60,30,2,00121,India
736356,2023-04-05,708,sketchpen,15,40,25,1,00121,India
736356,2023-04-05,705,stencil,10,20,10,2,00121,India
736356,2023-04-05,706,sharpener,3,8,5,2,00121,India
838226,2023-04-05,709,notebook,30,60,30,2,00361,India
838226,2023-04-05,717,spiral bound book,50,100,50,1,00361,India
838226,2023-04-05,713,ball pen,5,10,5,2,00361,India
274540,2023-04-05,715,folder,5,15,10,1,00125,India
274540,2023-04-05,717,spiral bound book,50,100,50,1,00125,India
303418,2023-04-05,711,TD kit,150,300,150,1,00019,India
303418,2023-04-05,703,eraser,1,3,2,2,00019,India
303418,2023-04-05,702,pencil,2,5,3,2,00019,India
303418,2023-04-05,712,graph paper,20,40,20,1,00019,India
870185,2023-04-05,704,scale,5,10,5,2,00177,India
870185,2023-04-05,714,carbon paper,15,30,15,1,00177,India
870185,2023-04-05,711,TD kit,150,300,150,1,00177,India
870185,2023-04-05,713,ball pen,5,10,5,2,00177,India
139877,2023-04-05,707,marker,20,40,20,1,00243,India
139877,2023-04-05,704,scale,5,10,5,2,00243,India
116413,2023-04-05,707,marker,20,40,20,1,00081,India
990094,2023-04-05,708,sketchpen,15,40,25,1,00054,India
990094,2023-04-05,715,folder,5,15,10,1,00054,India
767397,2023-04-05,706,sharpener,3,8,5,2,00394,India
767397,2023-04-05,708,sketchpen,15,40,25,1,00394,India
175566,2023-04-05,717,spiral bound book,50,100,50,1,00460,India
175566,2023-04-05,704,scale,5,10,5,2,00460,India
175566,2023-04-05,708,sketchpen,15,40,25,1,00460,India
604415,2023-04-05,705,stencil,10,20,10,2,00131,India
604415,2023-04-05,702,pencil,2,5,3,2,00131,India
604415,2023-04-05,710,geometry box,100,150,50,2,00131,India
604415,2023-04-05,708,sketchpen,15,40,25,1,00131,India
720036,2023-04-05,713,ball pen,5,10,5,2,00236,India
720036,2023-04-05,716,printing paper,200,400,200,1,00236,India
720036,2023-04-05,702,pencil,2,5,3,2,00236,India
720036,2023-04-05,714,carbon paper,15,30,15,1,00236,India
930695,2023-04-05,708,sketchpen,15,40,25,1,00014,India
930695,2023-04-05,715,folder,5,15,10,1,00014,India
930695,2023-04-05,716,printing paper,200,400,200,1,00014,India
930695,2023-04-05,711,TD kit,150,300,150,1,00014,India
188388,2023-04-05,708,sketchpen,15,40,25,1,00343,India
875517,2023-04-05,714,carbon paper,15,30,15,1,00141,India
875517,2023-04-05,711,TD kit,150,300,150,1,00141,India
875517,2023-04-05,701,gel pen,5,10,5,2,00141,India
604713,2023-04-05,711,TD kit,150,300,150,1,00380,India
604713,2023-04-05,707,marker,20,40,20,1,00380,India
604713,2023-04-05,717,spiral bound book,50,100,50,1,00380,India
604713,2023-04-05,706,sharpener,3,8,5,2,00380,India
497552,2023-04-05,708,sketchpen,15,40,25,1,00385,India
497552,2023-04-05,716,printing paper,200,400,200,1,00385,India
497552,2023-04-05,703,eraser,1,3,2,2,00385,India
497552,2023-04-05,707,marker,20,40,20,1,00385,India
459274,2023-04-05,712,graph paper,20,40,20,1,00117,India
459274,2023-04-05,717,spiral bound book,50,100,50,1,00117,India
459274,2023-04-05,716,printing paper,200,400,200,1,00117,India
459274,2023-04-05,704,scale,5,10,5,2,00117,India
358079,2023-04-05,702,pencil,2,5,3,2,00154,India
358079,2023-04-05,701,gel pen,5,10,5,2,00154,India
358079,2023-04-05,711,TD kit,150,300,150,1,00154,India
358079,2023-04-05,707,marker,20,40,20,1,00154,India
839428,2023-04-05,703,eraser,1,3,2,2,00023,India
839428,2023-04-05,713,ball pen,5,10,5,2,00023,India
839428,2023-04-05,706,sharpener,3,8,5,2,00023,India
839428,2023-04-05,716,printing paper,200,400,200,1,00023,India
656639,2023-04-05,703,eraser,1,3,2,2,00280,India
235004,2023-04-05,715,folder,5,15,10,1,00102,India
235004,2023-04-05,710,geometry box,100,150,50,2,00102,India
235004,2023-04-05,709,notebook,30,60,30,2,00102,India
235004,2023-04-05,716,printing paper,200,400,200,1,00102,India
361210,2023-04-05,710,geometry box,100,150,50,2,00314,India
361210,2023-04-05,715,folder,5,15,10,1,00314,India
361210,2023-04-05,703,eraser,1,3,2,2,00314,India
361210,2023-04-05,711,TD kit,150,300,150,1,00314,India
361210,2023-04-05,707,marker,20,40,20,1,00314,India
706357,2023-04-05,705,stencil,10,20,10,2,00379,India
706357,2023-04-05,713,ball pen,5,10,5,2,00379,India
706357,2023-04-05,715,folder,5,15,10,1,00379,India
108950,2023-04-05,707,marker,20,40,20,1,00238,India
108950,2023-04-05,703,eraser,1,3,2,2,00238,India
108950,2023-04-05,715,folder,5,15,10,1,00238,India
672127,2023-04-05,711,TD kit,150,300,150,1,00457,India
672127,2023-04-05,702,pencil,2,5,3,2,00457,India
672127,2023-04-05,709,notebook,30,60,30,2,00457,India
672127,2023-04-05,714,carbon paper,15,30,15,1,00457,India
672127,2023-04-05,710,geometry box,100,150,50,2,00457,India
460221,2023-04-05,711,TD kit,150,300,150,1,00026,India
460221,2023-04-05,717,spiral bound book,50,100,50,1,00026,India
524294,2023-04-05,717,spiral bound book,50,100,50,1,00201,India
524294,2023-04-05,713,ball pen,5,10,5,2,00201,India
893686,2023-04-05,714,carbon paper,15,30,15,1,00496,India
893686,2023-04-05,712,graph paper,20,40,20,1,00496,India
893686,2023-04-05,707,marker,20,40,20,1,00496,India
893686,2023-04-05,710,geometry box,100,150,50,2,00496,India
228120,2023-04-06,712,graph paper,20,40,20,1,00017,India
228120,2023-04-06,713,ball pen,5,10,5,2,00017,India
228120,2023-04-06,706,sharpener,3,8,5,2,00017,India
228120,2023-04-06,717,spiral bound book,50,100,50,1,00017,India
228120,2023-04-06,709,notebook,30,60,30,2,00017,India
288524,2023-04-06,709,notebook,30,60,30,2,00089,India
288524,2023-04-06,713,ball pen,5,10,5,2,00089,India
288524,2023-04-06,702,pencil,2,5,3,2,00089,India
288524,2023-04-06,707,marker,20,40,20,1,00089,India
288524,2023-04-06,703,eraser,1,3,2,2,00089,India
650427,2023-04-06,707,marker,20,40,20,1,00225,India
650427,2023-04-06,702,pencil,2,5,3,2,00225,India
950804,2023-04-06,710,geometry box,100,150,50,2,00328,India
950804,2023-04-06,704,scale,5,10,5,2,00328,India
950804,2023-04-06,714,carbon paper,15,30,15,1,00328,India
321291,2023-04-06,715,folder,5,15,10,1,00219,India
321291,2023-04-06,717,spiral bound book,50,100,50,1,00219,India
640004,2023-04-06,704,scale,5,10,5,2,00211,India
640004,2023-04-06,715,folder,5,15,10,1,00211,India
640004,2023-04-06,707,marker,20,40,20,1,00211,India
884547,2023-04-06,705,stencil,10,20,10,2,00209,India
355940,2023-04-06,714,carbon paper,15,30,15,1,00188,India
355940,2023-04-06,713,ball pen,5,10,5,2,00188,India
355940,2023-04-06,715,folder,5,15,10,1,00188,India
584847,2023-04-06,713,ball pen,5,10,5,2,00440,India
584847,2023-04-06,717,spiral bound book,50,100,50,1,00440,India
584847,2023-04-06,708,sketchpen,15,40,25,1,00440,India
700657,2023-04-06,716,printing paper,200,400,200,1,00245,India
700657,2023-04-06,703,eraser,1,3,2,2,00245,India
700657,2023-04-06,715,folder,5,15,10,1,00245,India
180451,2023-04-06,711,TD kit,150,300,150,1,00049,India
180451,2023-04-06,705,stencil,10,20,10,2,00049,India
180451,2023-04-06,712,graph paper,20,40,20,1,00049,India
858472,2023-04-06,711,TD kit,150,300,150,1,00332,India
858472,2023-04-06,714,carbon paper,15,30,15,1,00332,India
858472,2023-04-06,705,stencil,10,20,10,2,00332,India
858472,2023-04-06,706,sharpener,3,8,5,2,00332,India
515211,2023-04-06,703,eraser,1,3,2,2,00500,India
515211,2023-04-06,708,sketchpen,15,40,25,1,00500,India
515211,2023-04-06,716,printing paper,200,400,200,1,00500,India
892028,2023-04-06,704,scale,5,10,5,2,00155,India
892028,2023-04-06,712,graph paper,20,40,20,1,00155,India
892028,2023-04-06,702,pencil,2,5,3,2,00155,India
892028,2023-04-06,713,ball pen,5,10,5,2,00155,India
706765,2023-04-06,702,pencil,2,5,3,2,00221,India
706765,2023-04-06,712,graph paper,20,40,20,1,00221,India
903000,2023-04-06,714,carbon paper,15,30,15,1,00294,India
903000,2023-04-06,709,notebook,30,60,30,2,00294,India
903000,2023-04-06,707,marker,20,40,20,1,00294,India
903000,2023-04-06,703,eraser,1,3,2,2,00294,India
607661,2023-04-06,702,pencil,2,5,3,2,00297,India
607661,2023-04-06,712,graph paper,20,40,20,1,00297,India
607661,2023-04-06,710,geometry box,100,150,50,2,00297,India
170970,2023-04-06,708,sketchpen,15,40,25,1,00180,India
755510,2023-04-06,707,marker,20,40,20,1,00271,India
352077,2023-04-06,717,spiral bound book,50,100,50,1,00055,India
352077,2023-04-06,715,folder,5,15,10,1,00055,India
352077,2023-04-06,703,eraser,1,3,2,2,00055,India
972984,2023-04-06,710,geometry box,100,150,50,2,00046,India
972984,2023-04-06,714,carbon paper,15,30,15,1,00046,India
401719,2023-04-06,704,scale,5,10,5,2,00427,India
401719,2023-04-06,717,spiral bound book,50,100,50,1,00427,India
401719,2023-04-06,708,sketchpen,15,40,25,1,00427,India
401719,2023-04-06,711,TD kit,150,300,150,1,00427,India
401719,2023-04-06,712,graph paper,20,40,20,1,00427,India
251740,2023-04-06,714,carbon paper,15,30,15,1,00399,India
847588,2023-04-06,705,stencil,10,20,10,2,00015,India
847588,2023-04-06,707,marker,20,40,20,1,00015,India
847588,2023-04-06,701,gel pen,5,10,5,2,00015,India
172051,2023-04-06,712,graph paper,20,40,20,1,00146,India
172051,2023-04-06,703,eraser,1,3,2,2,00146,India
172051,2023-04-06,702,pencil,2,5,3,2,00146,India
172051,2023-04-06,716,printing paper,200,400,200,1,00146,India
172051,2023-04-06,711,TD kit,150,300,150,1,00146,India
521322,2023-04-06,712,graph paper,20,40,20,1,00426,India
521322,2023-04-06,702,pencil,2,5,3,2,00426,India
942867,2023-04-06,714,carbon paper,15,30,15,1,00126,India
942867,2023-04-06,707,marker,20,40,20,1,00126,India
942867,2023-04-06,715,folder,5,15,10,1,00126,India
942867,2023-04-06,703,eraser,1,3,2,2,00126,India
578548,2023-04-06,705,stencil,10,20,10,2,00040,India
578548,2023-04-06,706,sharpener,3,8,5,2,00040,India
578548,2023-04-06,710,geometry box,100,150,50,2,00040,India
253082,2023-04-06,702,pencil,2,5,3,2,00030,India
253082,2023-04-06,713,ball pen,5,10,5,2,00030,India
253082,2023-04-06,714,carbon paper,15,30,15,1,00030,India
942557,2023-04-06,702,pencil,2,5,3,2,00137,India
942557,2023-04-06,706,sharpener,3,8,5,2,00137,India
117396,2023-04-06,716,printing paper,200,400,200,1,00259,India
117396,2023-04-06,713,ball pen,5,10,5,2,00259,India
117396,2023-04-06,715,folder,5,15,10,1,00259,India
117396,2023-04-06,701,gel pen,5,10,5,2,00259,India
829962,2023-04-06,703,eraser,1,3,2,2,00201,India
829962,2023-04-06,716,printing paper,200,400,200,1,00201,India
750266,2023-04-06,702,pencil,2,5,3,2,00199,India
750266,2023-04-06,701,gel pen,5,10,5,2,00199,India
750266,2023-04-06,717,spiral bound book,50,100,50,1,00199,India
320634,2023-04-06,715,folder,5,15,10,1,00106,India
320634,2023-04-06,713,ball pen,5,10,5,2,00106,India
320634,2023-04-06,709,notebook,30,60,30,2,00106,India
320634,2023-04-06,710,geometry box,100,150,50,2,00106,India
320634,2023-04-06,707,marker,20,40,20,1,00106,India
646368,2023-04-06,712,graph paper,20,40,20,1,00316,India
646368,2023-04-06,703,eraser,1,3,2,2,00316,India
646368,2023-04-06,702,pencil,2,5,3,2,00316,India
646368,2023-04-06,706,sharpener,3,8,5,2,00316,India
998073,2023-04-06,708,sketchpen,15,40,25,1,00277,India
998073,2023-04-06,701,gel pen,5,10,5,2,00277,India
998073,2023-04-06,714,carbon paper,15,30,15,1,00277,India
998073,2023-04-06,713,ball pen,5,10,5,2,00277,India
464793,2023-04-06,713,ball pen,5,10,5,2,00324,India
464793,2023-04-06,701,gel pen,5,10,5,2,00324,India
464793,2023-04-06,710,geometry box,100,150,50,2,00324,India
263593,2023-04-06,702,pencil,2,5,3,2,00281,India
263593,2023-04-06,708,sketchpen,15,40,25,1,00281,India
320096,2023-04-06,708,sketchpen,15,40,25,1,00352,India
320096,2023-04-06,712,graph paper,20,40,20,1,00352,India
271866,2023-04-06,716,printing paper,200,400,200,1,00434,India
271866,2023-04-06,714,carbon paper,15,30,15,1,00434,India
271866,2023-04-06,704,scale,5,10,5,2,00434,India
271866,2023-04-06,709,notebook,30,60,30,2,00434,India
271866,2023-04-06,707,marker,20,40,20,1,00434,India
957283,2023-04-06,716,printing paper,200,400,200,1,00109,India
823614,2023-04-06,708,sketchpen,15,40,25,1,00338,India
823614,2023-04-06,715,folder,5,15,10,1,00338,India
707462,2023-04-06,714,carbon paper,15,30,15,1,00499,India
707462,2023-04-06,716,printing paper,200,400,200,1,00499,India
707462,2023-04-06,703,eraser,1,3,2,2,00499,India
192173,2023-04-06,705,stencil,10,20,10,2,00113,India
192173,2023-04-06,708,sketchpen,15,40,25,1,00113,India
478742,2023-04-07,705,stencil,10,20,10,2,00484,India
478742,2023-04-07,704,scale,5,10,5,2,00484,India
789507,2023-04-07,710,geometry box,100,150,50,2,00043,India
789507,2023-04-07,713,ball pen,5,10,5,2,00043,India
302923,2023-04-07,716,printing paper,200,400,200,1,00166,India
302923,2023-04-07,706,sharpener,3,8,5,2,00166,India
302923,2023-04-07,711,TD kit,150,300,150,1,00166,India
302923,2023-04-07,709,notebook,30,60,30,2,00166,India
302923,2023-04-07,704,scale,5,10,5,2,00166,India
761503,2023-04-07,713,ball pen,5,10,5,2,00252,India
761503,2023-04-07,706,sharpener,3,8,5,2,00252,India
977743,2023-04-07,706,sharpener,3,8,5,2,00407,India
977743,2023-04-07,702,pencil,2,5,3,2,00407,India
977743,2023-04-07,703,eraser,1,3,2,2,00407,India
565344,2023-04-07,702,pencil,2,5,3,2,00046,India
565344,2023-04-07,715,folder,5,15,10,1,00046,India
565344,2023-04-07,712,graph paper,20,40,20,1,00046,India
209779,2023-04-07,711,TD kit,150,300,150,1,00036,India
346565,2023-04-07,710,geometry box,100,150,50,2,00136,India
346565,2023-04-07,705,stencil,10,20,10,2,00136,India
346565,2023-04-07,708,sketchpen,15,40,25,1,00136,India
346565,2023-04-07,714,carbon paper,15,30,15,1,00136,India
298636,2023-04-07,704,scale,5,10,5,2,00056,India
298636,2023-04-07,701,gel pen,5,10,5,2,00056,India
298636,2023-04-07,708,sketchpen,15,40,25,1,00056,India
298636,2023-04-07,702,pencil,2,5,3,2,00056,India
298636,2023-04-07,716,printing paper,200,400,200,1,00056,India
804281,2023-04-07,704,scale,5,10,5,2,00053,India
804281,2023-04-07,705,stencil,10,20,10,2,00053,India
297469,2023-04-07,715,folder,5,15,10,1,00370,India
297469,2023-04-07,706,sharpener,3,8,5,2,00370,India
662063,2023-04-07,715,folder,5,15,10,1,00020,India
989785,2023-04-07,703,eraser,1,3,2,2,00032,India
989785,2023-04-07,708,sketchpen,15,40,25,1,00032,India
989785,2023-04-07,711,TD kit,150,300,150,1,00032,India
632289,2023-04-07,702,pencil,2,5,3,2,00368,India
529991,2023-04-07,703,eraser,1,3,2,2,00108,India
963601,2023-04-07,703,eraser,1,3,2,2,00289,India
817243,2023-04-07,708,sketchpen,15,40,25,1,00137,India
817243,2023-04-07,710,geometry box,100,150,50,2,00137,India
817243,2023-04-07,703,eraser,1,3,2,2,00137,India
817243,2023-04-07,714,carbon paper,15,30,15,1,00137,India
536146,2023-04-07,704,scale,5,10,5,2,00048,India
536146,2023-04-07,706,sharpener,3,8,5,2,00048,India
536146,2023-04-07,707,marker,20,40,20,1,00048,India
250343,2023-04-07,709,notebook,30,60,30,2,00084,India
250343,2023-04-07,703,eraser,1,3,2,2,00084,India
567453,2023-04-07,710,geometry box,100,150,50,2,00375,India
567453,2023-04-07,707,marker,20,40,20,1,00375,India
567453,2023-04-07,706,sharpener,3,8,5,2,00375,India
849319,2023-04-07,705,stencil,10,20,10,2,00154,India
849319,2023-04-07,716,printing paper,200,400,200,1,00154,India
849319,2023-04-07,702,pencil,2,5,3,2,00154,India
849319,2023-04-07,710,geometry box,100,150,50,2,00154,India
852274,2023-04-07,716,printing paper,200,400,200,1,00030,India
852274,2023-04-07,712,graph paper,20,40,20,1,00030,India
852274,2023-04-07,701,gel pen,5,10,5,2,00030,India
833016,2023-04-07,708,sketchpen,15,40,25,1,00135,India
833016,2023-04-07,706,sharpener,3,8,5,2,00135,India
833016,2023-04-07,712,graph paper,20,40,20,1,00135,India
833016,2023-04-07,713,ball pen,5,10,5,2,00135,India
200307,2023-04-07,716,printing paper,200,400,200,1,00197,India
200307,2023-04-07,710,geometry box,100,150,50,2,00197,India
200307,2023-04-07,705,stencil,10,20,10,2,00197,India
524774,2023-04-07,706,sharpener,3,8,5,2,00012,India
524774,2023-04-07,702,pencil,2,5,3,2,00012,India
524774,2023-04-07,705,stencil,10,20,10,2,00012,India
451793,2023-04-07,704,scale,5,10,5,2,00320,India
451793,2023-04-07,713,ball pen,5,10,5,2,00320,India
451793,2023-04-07,701,gel pen,5,10,5,2,00320,India
451793,2023-04-07,703,eraser,1,3,2,2,00320,India
638166,2023-04-07,705,stencil,10,20,10,2,00366,India
638166,2023-04-07,703,eraser,1,3,2,2,00366,India
638166,2023-04-07,716,printing paper,200,400,200,1,00366,India
110576,2023-04-07,716,printing paper,200,400,200,1,00247,India
800148,2023-04-07,715,folder,5,15,10,1,00285,India
800148,2023-04-07,712,graph paper,20,40,20,1,00285,India
988176,2023-04-07,715,folder,5,15,10,1,00189,India
988176,2023-04-07,714,carbon paper,15,30,15,1,00189,India
162787,2023-04-07,713,ball pen,5,10,5,2,00082,India
162787,2023-04-07,709,notebook,30,60,30,2,00082,India
795816,2023-04-07,716,printing paper,200,400,200,1,00210,India
795816,2023-04-07,711,TD kit,150,300,150,1,00210,India
795816,2023-04-07,714,carbon paper,15,30,15,1,00210,India
795816,2023-04-07,710,geometry box,100,150,50,2,00210,India
111004,2023-04-07,717,spiral bound book,50,100,50,1,00223,India
111004,2023-04-07,712,graph paper,20,40,20,1,00223,India
502606,2023-04-08,708,sketchpen,15,40,25,1,00464,India
718398,2023-04-08,709,notebook,30,60,30,2,00422,India
527997,2023-04-08,706,sharpener,3,8,5,2,00314,India
527997,2023-04-08,712,graph paper,20,40,20,1,00314,India
527997,2023-04-08,707,marker,20,40,20,1,00314,India
527997,2023-04-08,702,pencil,2,5,3,2,00314,India
800909,2023-04-08,712,graph paper,20,40,20,1,00494,India
800909,2023-04-08,706,sharpener,3,8,5,2,00494,India
800909,2023-04-08,704,scale,5,10,5,2,00494,India
695027,2023-04-08,703,eraser,1,3,2,2,00029,India
695027,2023-04-08,716,printing paper,200,400,200,1,00029,India
695027,2023-04-08,708,sketchpen,15,40,25,1,00029,India
695027,2023-04-08,707,marker,20,40,20,1,00029,India
695027,2023-04-08,709,notebook,30,60,30,2,00029,India
792733,2023-04-08,701,gel pen,5,10,5,2,00010,India
792733,2023-04-08,708,sketchpen,15,40,25,1,00010,India
143420,2023-04-08,710,geometry box,100,150,50,2,00450,India
143420,2023-04-08,714,carbon paper,15,30,15,1,00450,India
143420,2023-04-08,704,scale,5,10,5,2,00450,India
143420,2023-04-08,711,TD kit,150,300,150,1,00450,India
474161,2023-04-08,701,gel pen,5,10,5,2,00240,India
474161,2023-04-08,711,TD kit,150,300,150,1,00240,India
474161,2023-04-08,706,sharpener,3,8,5,2,00240,India
685925,2023-04-08,710,geometry box,100,150,50,2,00315,India
685925,2023-04-08,706,sharpener,3,8,5,2,00315,India
942496,2023-04-08,714,carbon paper,15,30,15,1,00236,India
285112,2023-04-08,711,TD kit,150,300,150,1,00166,India
285112,2023-04-08,707,marker,20,40,20,1,00166,India
285112,2023-04-08,713,ball pen,5,10,5,2,00166,India
318722,2023-04-08,701,gel pen,5,10,5,2,00432,India
318722,2023-04-08,708,sketchpen,15,40,25,1,00432,India
318722,2023-04-08,711,TD kit,150,300,150,1,00432,India
424731,2023-04-08,708,sketchpen,15,40,25,1,00292,India
424731,2023-04-08,711,TD kit,150,300,150,1,00292,India
424731,2023-04-08,705,stencil,10,20,10,2,00292,India
105213,2023-04-08,704,scale,5,10,5,2,00176,India
105213,2023-04-08,713,ball pen,5,10,5,2,00176,India
105213,2023-04-08,705,stencil,10,20,10,2,00176,India
105213,2023-04-08,717,spiral bound book,50,100,50,1,00176,India
940134,2023-04-08,703,eraser,1,3,2,2,00118,India
164741,2023-04-08,703,eraser,1,3,2,2,00427,India
164741,2023-04-08,706,sharpener,3,8,5,2,00427,India
164741,2023-04-08,717,spiral bound book,50,100,50,1,00427,India
164741,2023-04-08,712,graph paper,20,40,20,1,00427,India
423594,2023-04-08,712,graph paper,20,40,20,1,00497,India
423594,2023-04-08,713,ball pen,5,10,5,2,00497,India
777523,2023-04-08,705,stencil,10,20,10,2,00296,India
724645,2023-04-08,706,sharpener,3,8,5,2,00390,India
213723,2023-04-08,704,scale,5,10,5,2,00073,India
213723,2023-04-08,707,marker,20,40,20,1,00073,India
213723,2023-04-08,701,gel pen,5,10,5,2,00073,India
213723,2023-04-08,710,geometry box,100,150,50,2,00073,India
319973,2023-04-08,704,scale,5,10,5,2,00422,India
319973,2023-04-08,712,graph paper,20,40,20,1,00422,India
963720,2023-04-08,701,gel pen,5,10,5,2,00144,India
963720,2023-04-08,706,sharpener,3,8,5,2,00144,India
963720,2023-04-08,713,ball pen,5,10,5,2,00144,India
963720,2023-04-08,716,printing paper,200,400,200,1,00144,India
620166,2023-04-08,709,notebook,30,60,30,2,00366,India
620166,2023-04-08,701,gel pen,5,10,5,2,00366,India
939647,2023-04-08,711,TD kit,150,300,150,1,00111,India
939647,2023-04-08,717,spiral bound book,50,100,50,1,00111,India
939647,2023-04-08,705,stencil,10,20,10,2,00111,India
939647,2023-04-08,701,gel pen,5,10,5,2,00111,India
175879,2023-04-08,705,stencil,10,20,10,2,00462,India
175879,2023-04-08,717,spiral bound book,50,100,50,1,00462,India
175879,2023-04-08,716,printing paper,200,400,200,1,00462,India
175879,2023-04-08,709,notebook,30,60,30,2,00462,India
175879,2023-04-08,704,scale,5,10,5,2,00462,India
229450,2023-04-08,711,TD kit,150,300,150,1,00249,India
229450,2023-04-08,717,spiral bound book,50,100,50,1,00249,India
438810,2023-04-08,715,folder,5,15,10,1,00426,India
438810,2023-04-08,709,notebook,30,60,30,2,00426,India
438810,2023-04-08,710,geometry box,100,150,50,2,00426,India
438810,2023-04-08,716,printing paper,200,400,200,1,00426,India
438810,2023-04-08,704,scale,5,10,5,2,00426,India
382989,2023-04-08,716,printing paper,200,400,200,1,00434,India
646134,2023-04-08,708,sketchpen,15,40,25,1,00494,India
646134,2023-04-08,706,sharpener,3,8,5,2,00494,India
646134,2023-04-08,715,folder,5,15,10,1,00494,India
646134,2023-04-08,702,pencil,2,5,3,2,00494,India
646134,2023-04-08,705,stencil,10,20,10,2,00494,India
333823,2023-04-08,705,stencil,10,20,10,2,00455,India
333823,2023-04-08,702,pencil,2,5,3,2,00455,India
381263,2023-04-08,708,sketchpen,15,40,25,1,00065,India
381263,2023-04-08,702,pencil,2,5,3,2,00065,India
371743,2023-04-08,715,folder,5,15,10,1,00148,India
371743,2023-04-08,709,notebook,30,60,30,2,00148,India
371743,2023-04-08,702,pencil,2,5,3,2,00148,India
371743,2023-04-08,713,ball pen,5,10,5,2,00148,India
371743,2023-04-08,706,sharpener,3,8,5,2,00148,India
384914,2023-04-08,701,gel pen,5,10,5,2,00378,India
384914,2023-04-08,708,sketchpen,15,40,25,1,00378,India
384914,2023-04-08,702,pencil,2,5,3,2,00378,India
384914,2023-04-08,715,folder,5,15,10,1,00378,India
384914,2023-04-08,713,ball pen,5,10,5,2,00378,India
950570,2023-04-08,705,stencil,10,20,10,2,00075,India
950570,2023-04-08,715,folder,5,15,10,1,00075,India
950570,2023-04-08,713,ball pen,5,10,5,2,00075,India
950570,2023-04-08,717,spiral bound book,50,100,50,1,00075,India
611266,2023-04-08,706,sharpener,3,8,5,2,00334,India
611266,2023-04-08,716,printing paper,200,400,200,1,00334,India
611266,2023-04-08,707,marker,20,40,20,1,00334,India
611266,2023-04-08,715,folder,5,15,10,1,00334,India
626830,2023-04-08,716,printing paper,200,400,200,1,00126,India
626830,2023-04-08,709,notebook,30,60,30,2,00126,India
626830,2023-04-08,706,sharpener,3,8,5,2,00126,India
816746,2023-04-08,704,scale,5,10,5,2,00060,India
816746,2023-04-08,706,sharpener,3,8,5,2,00060,India
169718,2023-04-08,707,marker,20,40,20,1,00261,India
169718,2023-04-08,715,folder,5,15,10,1,00261,India
229405,2023-04-08,705,stencil,10,20,10,2,00056,India
229405,2023-04-08,713,ball pen,5,10,5,2,00056,India
750958,2023-04-09,705,stencil,10,20,10,2,00132,India
593673,2023-04-09,716,printing paper,200,400,200,1,00366,India
593673,2023-04-09,701,gel pen,5,10,5,2,00366,India
593673,2023-04-09,705,stencil,10,20,10,2,00366,India
540811,2023-04-09,701,gel pen,5,10,5,2,00335,India
380127,2023-04-09,705,stencil,10,20,10,2,00119,India
380127,2023-04-09,714,carbon paper,15,30,15,1,00119,India
122607,2023-04-09,712,graph paper,20,40,20,1,00091,India
122607,2023-04-09,708,sketchpen,15,40,25,1,00091,India
122607,2023-04-09,703,eraser,1,3,2,2,00091,India
863098,2023-04-09,702,pencil,2,5,3,2,00158,India
863098,2023-04-09,714,carbon paper,15,30,15,1,00158,India
863098,2023-04-09,712,graph paper,20,40,20,1,00158,India
115196,2023-04-09,703,eraser,1,3,2,2,00360,India
115196,2023-04-09,709,notebook,30,60,30,2,00360,India
115196,2023-04-09,705,stencil,10,20,10,2,00360,India
115196,2023-04-09,712,graph paper,20,40,20,1,00360,India
601189,2023-04-09,709,notebook,30,60,30,2,00221,India
601189,2023-04-09,701,gel pen,5,10,5,2,00221,India
457422,2023-04-09,715,folder,5,15,10,1,00186,India
280220,2023-04-09,704,scale,5,10,5,2,00010,India
280220,2023-04-09,712,graph paper,20,40,20,1,00010,India
280220,2023-04-09,706,sharpener,3,8,5,2,00010,India
503583,2023-04-09,710,geometry box,100,150,50,2,00286,India
503583,2023-04-09,701,gel pen,5,10,5,2,00286,India
698672,2023-04-09,710,geometry box,100,150,50,2,00453,India
773255,2023-04-09,717,spiral bound book,50,100,50,1,00303,India
773255,2023-04-09,706,sharpener,3,8,5,2,00303,India
538113,2023-04-09,703,eraser,1,3,2,2,00244,India
736582,2023-04-09,717,spiral bound book,50,100,50,1,00044,India
736582,2023-04-09,703,eraser,1,3,2,2,00044,India
736582,2023-04-09,714,carbon paper,15,30,15,1,00044,India
882449,2023-04-09,707,marker,20,40,20,1,00304,India
939205,2023-04-09,709,notebook,30,60,30,2,00141,India
939205,2023-04-09,705,stencil,10,20,10,2,00141,India
939205,2023-04-09,708,sketchpen,15,40,25,1,00141,India
939205,2023-04-09,714,carbon paper,15,30,15,1,00141,India
614226,2023-04-09,707,marker,20,40,20,1,00307,India
614226,2023-04-09,717,spiral bound book,50,100,50,1,00307,India
614226,2023-04-09,701,gel pen,5,10,5,2,00307,India
783725,2023-04-09,706,sharpener,3,8,5,2,00325,India
783725,2023-04-09,707,marker,20,40,20,1,00325,India
388482,2023-04-09,711,TD kit,150,300,150,1,00098,India
615568,2023-04-09,701,gel pen,5,10,5,2,00278,India
615568,2023-04-09,707,marker,20,40,20,1,00278,India
615568,2023-04-09,716,printing paper,200,400,200,1,00278,India
615568,2023-04-09,709,notebook,30,60,30,2,00278,India
309156,2023-04-09,713,ball pen,5,10,5,2,00228,India
309156,2023-04-09,706,sharpener,3,8,5,2,00228,India
309156,2023-04-09,703,eraser,1,3,2,2,00228,India
177827,2023-04-09,716,printing paper,200,400,200,1,00203,India
177827,2023-04-09,703,eraser,1,3,2,2,00203,India
244179,2023-04-09,710,geometry box,100,150,50,2,00266,India
244179,2023-04-09,712,graph paper,20,40,20,1,00266,India
244179,2023-04-09,705,stencil,10,20,10,2,00266,India
263619,2023-04-09,717,spiral bound book,50,100,50,1,00223,India
263619,2023-04-09,709,notebook,30,60,30,2,00223,India
294107,2023-04-09,711,TD kit,150,300,150,1,00416,India
294107,2023-04-09,709,notebook,30,60,30,2,00416,India
294107,2023-04-09,707,marker,20,40,20,1,00416,India
294107,2023-04-09,710,geometry box,100,150,50,2,00416,India
464051,2023-04-09,716,printing paper,200,400,200,1,00052,India
837717,2023-04-09,713,ball pen,5,10,5,2,00191,India
917286,2023-04-09,710,geometry box,100,150,50,2,00060,India
917286,2023-04-09,712,graph paper,20,40,20,1,00060,India
917286,2023-04-09,714,carbon paper,15,30,15,1,00060,India
216851,2023-04-09,702,pencil,2,5,3,2,00035,India
216851,2023-04-09,714,carbon paper,15,30,15,1,00035,India
794542,2023-04-09,715,folder,5,15,10,1,00276,India
794542,2023-04-09,711,TD kit,150,300,150,1,00276,India
794542,2023-04-09,706,sharpener,3,8,5,2,00276,India
461010,2023-04-09,704,scale,5,10,5,2,00229,India
461010,2023-04-09,708,sketchpen,15,40,25,1,00229,India
267280,2023-04-09,703,eraser,1,3,2,2,00317,India
267280,2023-04-09,706,sharpener,3,8,5,2,00317,India
966700,2023-04-09,716,printing paper,200,400,200,1,00189,India
966700,2023-04-09,708,sketchpen,15,40,25,1,00189,India
991204,2023-04-09,705,stencil,10,20,10,2,00134,India
991204,2023-04-09,714,carbon paper,15,30,15,1,00134,India
991204,2023-04-09,712,graph paper,20,40,20,1,00134,India
146232,2023-04-09,717,spiral bound book,50,100,50,1,00266,India
661900,2023-04-09,702,pencil,2,5,3,2,00048,India
661900,2023-04-09,714,carbon paper,15,30,15,1,00048,India
661900,2023-04-09,709,notebook,30,60,30,2,00048,India
901526,2023-04-09,703,eraser,1,3,2,2,00360,India
912384,2023-04-09,717,spiral bound book,50,100,50,1,00396,India
912384,2023-04-09,703,eraser,1,3,2,2,00396,India
842510,2023-04-09,704,scale,5,10,5,2,00183,India
842510,2023-04-09,707,marker,20,40,20,1,00183,India
842510,2023-04-09,708,sketchpen,15,40,25,1,00183,India
915407,2023-04-09,715,folder,5,15,10,1,00394,India
915407,2023-04-09,701,gel pen,5,10,5,2,00394,India
915407,2023-04-09,707,marker,20,40,20,1,00394,India
915407,2023-04-09,710,geometry box,100,150,50,2,00394,India
272799,2023-04-09,701,gel pen,5,10,5,2,00360,India
272799,2023-04-09,709,notebook,30,60,30,2,00360,India
272799,2023-04-09,707,marker,20,40,20,1,00360,India
916411,2023-04-09,707,marker,20,40,20,1,00095,India
916411,2023-04-09,708,sketchpen,15,40,25,1,00095,India
916411,2023-04-09,713,ball pen,5,10,5,2,00095,India
610046,2023-04-10,708,sketchpen,15,40,25,1,00140,India
610046,2023-04-10,713,ball pen,5,10,5,2,00140,India
610046,2023-04-10,715,folder,5,15,10,1,00140,India
610046,2023-04-10,703,eraser,1,3,2,2,00140,India
610046,2023-04-10,709,notebook,30,60,30,2,00140,India
717679,2023-04-10,717,spiral bound book,50,100,50,1,00172,India
717679,2023-04-10,716,printing paper,200,400,200,1,00172,India
717679,2023-04-10,701,gel pen,5,10,5,2,00172,India
717679,2023-04-10,707,marker,20,40,20,1,00172,India
717679,2023-04-10,704,scale,5,10,5,2,00172,India
375096,2023-04-10,710,geometry box,100,150,50,2,00149,India
375096,2023-04-10,707,marker,20,40,20,1,00149,India
375096,2023-04-10,702,pencil,2,5,3,2,00149,India
375096,2023-04-10,714,carbon paper,15,30,15,1,00149,India
299984,2023-04-10,709,notebook,30,60,30,2,00297,India
299984,2023-04-10,710,geometry box,100,150,50,2,00297,India
299984,2023-04-10,714,carbon paper,15,30,15,1,00297,India
299984,2023-04-10,706,sharpener,3,8,5,2,00297,India
407330,2023-04-10,703,eraser,1,3,2,2,00124,India
407330,2023-04-10,706,sharpener,3,8,5,2,00124,India
370673,2023-04-10,707,marker,20,40,20,1,00470,India
327883,2023-04-10,707,marker,20,40,20,1,00368,India
327883,2023-04-10,713,ball pen,5,10,5,2,00368,India
327883,2023-04-10,706,sharpener,3,8,5,2,00368,India
327883,2023-04-10,711,TD kit,150,300,150,1,00368,India
327883,2023-04-10,714,carbon paper,15,30,15,1,00368,India
543620,2023-04-10,709,notebook,30,60,30,2,00011,India
870241,2023-04-10,714,carbon paper,15,30,15,1,00151,India
870241,2023-04-10,704,scale,5,10,5,2,00151,India
946289,2023-04-10,701,gel pen,5,10,5,2,00366,India
469562,2023-04-10,712,graph paper,20,40,20,1,00235,India
130442,2023-04-10,714,carbon paper,15,30,15,1,00156,India
130442,2023-04-10,709,notebook,30,60,30,2,00156,India
732814,2023-04-10,711,TD kit,150,300,150,1,00101,India
918225,2023-04-10,706,sharpener,3,8,5,2,00293,India
918225,2023-04-10,704,scale,5,10,5,2,00293,India
918225,2023-04-10,716,printing paper,200,400,200,1,00293,India
918225,2023-04-10,713,ball pen,5,10,5,2,00293,India
293259,2023-04-10,702,pencil,2,5,3,2,00467,India
293259,2023-04-10,717,spiral bound book,50,100,50,1,00467,India
293259,2023-04-10,708,sketchpen,15,40,25,1,00467,India
293259,2023-04-10,712,graph paper,20,40,20,1,00467,India
523823,2023-04-10,707,marker,20,40,20,1,00007,India
523823,2023-04-10,710,geometry box,100,150,50,2,00007,India
523823,2023-04-10,713,ball pen,5,10,5,2,00007,India
523823,2023-04-10,705,stencil,10,20,10,2,00007,India
673193,2023-04-10,704,scale,5,10,5,2,00162,India
683672,2023-04-10,707,marker,20,40,20,1,00360,India
915220,2023-04-10,716,printing paper,200,400,200,1,00456,India
915220,2023-04-10,715,folder,5,15,10,1,00456,India
915220,2023-04-10,711,TD kit,150,300,150,1,00456,India
915220,2023-04-10,710,geometry box,100,150,50,2,00456,India
863210,2023-04-10,710,geometry box,100,150,50,2,00365,India
142122,2023-04-10,703,eraser,1,3,2,2,00036,India
142122,2023-04-10,707,marker,20,40,20,1,00036,India
142122,2023-04-10,717,spiral bound book,50,100,50,1,00036,India
912643,2023-04-10,704,scale,5,10,5,2,00010,India
912643,2023-04-10,709,notebook,30,60,30,2,00010,India
912643,2023-04-10,708,sketchpen,15,40,25,1,00010,India
639228,2023-04-10,717,spiral bound book,50,100,50,1,00028,India
639228,2023-04-10,711,TD kit,150,300,150,1,00028,India
585404,2023-04-10,717,spiral bound book,50,100,50,1,00471,India
585404,2023-04-10,714,carbon paper,15,30,15,1,00471,India
585404,2023-04-10,705,stencil,10,20,10,2,00471,India
585404,2023-04-10,704,scale,5,10,5,2,00471,India
582892,2023-04-10,706,sharpener,3,8,5,2,00045,India
582892,2023-04-10,716,printing paper,200,400,200,1,00045,India
582892,2023-04-10,704,scale,5,10,5,2,00045,India
582892,2023-04-10,714,carbon paper,15,30,15,1,00045,India
130929,2023-04-10,717,spiral bound book,50,100,50,1,00287,India
721618,2023-04-10,714,carbon paper,15,30,15,1,00436,India
721618,2023-04-10,704,scale,5,10,5,2,00436,India
721618,2023-04-10,701,gel pen,5,10,5,2,00436,India
607954,2023-04-10,707,marker,20,40,20,1,00317,India
890651,2023-04-10,706,sharpener,3,8,5,2,00056,India
890651,2023-04-10,705,stencil,10,20,10,2,00056,India
890651,2023-04-10,702,pencil,2,5,3,2,00056,India
890651,2023-04-10,716,printing paper,200,400,200,1,00056,India
246631,2023-04-10,713,ball pen,5,10,5,2,00469,India
246631,2023-04-10,710,geometry box,100,150,50,2,00469,India
755655,2023-04-10,704,scale,5,10,5,2,00046,India
755655,2023-04-10,703,eraser,1,3,2,2,00046,India
755655,2023-04-10,701,gel pen,5,10,5,2,00046,India
646331,2023-04-10,716,printing paper,200,400,200,1,00177,India
804370,2023-04-10,704,scale,5,10,5,2,00285,India
804370,2023-04-10,705,stencil,10,20,10,2,00285,India
804370,2023-04-10,713,ball pen,5,10,5,2,00285,India
861786,2023-04-10,706,sharpener,3,8,5,2,00329,India
861786,2023-04-10,712,graph paper,20,40,20,1,00329,India
861786,2023-04-10,716,printing paper,200,400,200,1,00329,India
186282,2023-04-10,711,TD kit,150,300,150,1,00359,India
983004,2023-04-10,706,sharpener,3,8,5,2,00172,India
983004,2023-04-10,709,notebook,30,60,30,2,00172,India
983004,2023-04-10,711,TD kit,150,300,150,1,00172,India
502232,2023-04-10,702,pencil,2,5,3,2,00004,India
502232,2023-04-10,716,printing paper,200,400,200,1,00004,India
716207,2023-04-10,701,gel pen,5,10,5,2,00160,India
998428,2023-04-10,707,marker,20,40,20,1,00255,India
742051,2023-04-10,709,notebook,30,60,30,2,00462,India
742051,2023-04-10,717,spiral bound book,50,100,50,1,00462,India
742051,2023-04-10,714,carbon paper,15,30,15,1,00462,India
742051,2023-04-10,706,sharpener,3,8,5,2,00462,India
353685,2023-04-10,706,sharpener,3,8,5,2,00467,India
353685,2023-04-10,701,gel pen,5,10,5,2,00467,India
353685,2023-04-10,703,eraser,1,3,2,2,00467,India
353685,2023-04-10,715,folder,5,15,10,1,00467,India
353685,2023-04-10,707,marker,20,40,20,1,00467,India
461973,2023-04-10,715,folder,5,15,10,1,00393,India
270331,2023-04-10,715,folder,5,15,10,1,00184,India
270331,2023-04-10,705,stencil,10,20,10,2,00184,India
270331,2023-04-10,712,graph paper,20,40,20,1,00184,India
223793,2023-04-10,707,marker,20,40,20,1,00052,India
223793,2023-04-10,705,stencil,10,20,10,2,00052,India
260159,2023-04-10,711,TD kit,150,300,150,1,00453,India
260159,2023-04-10,714,carbon paper,15,30,15,1,00453,India
260159,2023-04-10,717,spiral bound book,50,100,50,1,00453,India
260159,2023-04-10,709,notebook,30,60,30,2,00453,India
894566,2023-04-10,702,pencil,2,5,3,2,00260,India
894566,2023-04-10,716,printing paper,200,400,200,1,00260,India
894566,2023-04-10,701,gel pen,5,10,5,2,00260,India
894566,2023-04-10,706,sharpener,3,8,5,2,00260,India
233057,2023-04-10,701,gel pen,5,10,5,2,00098,India
233057,2023-04-10,703,eraser,1,3,2,2,00098,India
233057,2023-04-10,717,spiral bound book,50,100,50,1,00098,India
233057,2023-04-10,709,notebook,30,60,30,2,00098,India
753775,2023-04-10,706,sharpener,3,8,5,2,00482,India
437143,2023-04-10,709,notebook,30,60,30,2,00340,India
437143,2023-04-10,708,sketchpen,15,40,25,1,00340,India
437143,2023-04-10,706,sharpener,3,8,5,2,00340,India
437143,2023-04-10,707,marker,20,40,20,1,00340,India
437143,2023-04-10,716,printing paper,200,400,200,1,00340,India
632169,2023-04-11,713,ball pen,5,10,5,2,00095,India
632169,2023-04-11,716,printing paper,200,400,200,1,00095,India
632169,2023-04-11,715,folder,5,15,10,1,00095,India
632169,2023-04-11,714,carbon paper,15,30,15,1,00095,India
350593,2023-04-11,701,gel pen,5,10,5,2,00461,India
350593,2023-04-11,712,graph paper,20,40,20,1,00461,India
350593,2023-04-11,710,geometry box,100,150,50,2,00461,India
350593,2023-04-11,708,sketchpen,15,40,25,1,00461,India
855939,2023-04-11,707,marker,20,40,20,1,00304,India
531720,2023-04-11,702,pencil,2,5,3,2,00309,India
531720,2023-04-11,715,folder,5,15,10,1,00309,India
388153,2023-04-11,707,marker,20,40,20,1,00112,India
388153,2023-04-11,702,pencil,2,5,3,2,00112,India
388153,2023-04-11,711,TD kit,150,300,150,1,00112,India
388153,2023-04-11,715,folder,5,15,10,1,00112,India
357600,2023-04-11,705,stencil,10,20,10,2,00164,India
357600,2023-04-11,716,printing paper,200,400,200,1,00164,India
357600,2023-04-11,715,folder,5,15,10,1,00164,India
820665,2023-04-11,703,eraser,1,3,2,2,00212,India
820665,2023-04-11,715,folder,5,15,10,1,00212,India
981224,2023-04-11,715,folder,5,15,10,1,00399,India
981224,2023-04-11,716,printing paper,200,400,200,1,00399,India
981224,2023-04-11,705,stencil,10,20,10,2,00399,India
981224,2023-04-11,702,pencil,2,5,3,2,00399,India
400882,2023-04-11,715,folder,5,15,10,1,00324,India
400882,2023-04-11,708,sketchpen,15,40,25,1,00324,India
617406,2023-04-11,701,gel pen,5,10,5,2,00322,India
431750,2023-04-11,706,sharpener,3,8,5,2,00091,India
424677,2023-04-11,713,ball pen,5,10,5,2,00308,India
424677,2023-04-11,707,marker,20,40,20,1,00308,India
952834,2023-04-11,714,carbon paper,15,30,15,1,00379,India
316495,2023-04-11,711,TD kit,150,300,150,1,00449,India
461372,2023-04-11,706,sharpener,3,8,5,2,00099,India
461372,2023-04-11,713,ball pen,5,10,5,2,00099,India
461372,2023-04-11,716,printing paper,200,400,200,1,00099,India
386285,2023-04-11,710,geometry box,100,150,50,2,00424,India
386285,2023-04-11,702,pencil,2,5,3,2,00424,India
386285,2023-04-11,711,TD kit,150,300,150,1,00424,India
386285,2023-04-11,703,eraser,1,3,2,2,00424,India
386285,2023-04-11,704,scale,5,10,5,2,00424,India
963308,2023-04-11,717,spiral bound book,50,100,50,1,00095,India
963308,2023-04-11,705,stencil,10,20,10,2,00095,India
963308,2023-04-11,711,TD kit,150,300,150,1,00095,India
963308,2023-04-11,712,graph paper,20,40,20,1,00095,India
546620,2023-04-11,716,printing paper,200,400,200,1,00152,India
546620,2023-04-11,705,stencil,10,20,10,2,00152,India
546620,2023-04-11,713,ball pen,5,10,5,2,00152,India
546620,2023-04-11,707,marker,20,40,20,1,00152,India
199873,2023-04-11,716,printing paper,200,400,200,1,00317,India
174743,2023-04-11,704,scale,5,10,5,2,00017,India
174743,2023-04-11,709,notebook,30,60,30,2,00017,India
341014,2023-04-11,712,graph paper,20,40,20,1,00267,India
341014,2023-04-11,714,carbon paper,15,30,15,1,00267,India
341014,2023-04-11,702,pencil,2,5,3,2,00267,India
341014,2023-04-11,710,geometry box,100,150,50,2,00267,India
806527,2023-04-11,713,ball pen,5,10,5,2,00040,India
222101,2023-04-11,702,pencil,2,5,3,2,00021,India
222101,2023-04-11,717,spiral bound book,50,100,50,1,00021,India
307545,2023-04-11,712,graph paper,20,40,20,1,00423,India
307545,2023-04-11,714,carbon paper,15,30,15,1,00423,India
516388,2023-04-11,703,eraser,1,3,2,2,00067,India
516388,2023-04-11,710,geometry box,100,150,50,2,00067,India
326631,2023-04-11,713,ball pen,5,10,5,2,00026,India
326631,2023-04-11,714,carbon paper,15,30,15,1,00026,India
326631,2023-04-11,708,sketchpen,15,40,25,1,00026,India
326631,2023-04-11,702,pencil,2,5,3,2,00026,India
142860,2023-04-11,714,carbon paper,15,30,15,1,00472,India
142860,2023-04-11,717,spiral bound book,50,100,50,1,00472,India
142860,2023-04-11,716,printing paper,200,400,200,1,00472,India
751373,2023-04-11,701,gel pen,5,10,5,2,00271,India
231845,2023-04-11,714,carbon paper,15,30,15,1,00367,India
231845,2023-04-11,706,sharpener,3,8,5,2,00367,India
231845,2023-04-11,713,ball pen,5,10,5,2,00367,India
231845,2023-04-11,710,geometry box,100,150,50,2,00367,India
270375,2023-04-11,711,TD kit,150,300,150,1,00334,India
270375,2023-04-11,705,stencil,10,20,10,2,00334,India
270375,2023-04-11,706,sharpener,3,8,5,2,00334,India
270375,2023-04-11,702,pencil,2,5,3,2,00334,India
270375,2023-04-11,703,eraser,1,3,2,2,00334,India
853168,2023-04-11,702,pencil,2,5,3,2,00026,India
853168,2023-04-11,717,spiral bound book,50,100,50,1,00026,India
853168,2023-04-11,713,ball pen,5,10,5,2,00026,India
571044,2023-04-11,710,geometry box,100,150,50,2,00374,India
571044,2023-04-11,716,printing paper,200,400,200,1,00374,India
571044,2023-04-11,701,gel pen,5,10,5,2,00374,India
571044,2023-04-11,705,stencil,10,20,10,2,00374,India
571044,2023-04-11,713,ball pen,5,10,5,2,00374,India
958552,2023-04-11,705,stencil,10,20,10,2,00012,India
958552,2023-04-11,707,marker,20,40,20,1,00012,India
931913,2023-04-11,701,gel pen,5,10,5,2,00045,India
175123,2023-04-11,708,sketchpen,15,40,25,1,00304,India
175123,2023-04-11,713,ball pen,5,10,5,2,00304,India
175123,2023-04-11,709,notebook,30,60,30,2,00304,India
175123,2023-04-11,711,TD kit,150,300,150,1,00304,India
943729,2023-04-11,717,spiral bound book,50,100,50,1,00115,India
943729,2023-04-11,714,carbon paper,15,30,15,1,00115,India
943729,2023-04-11,708,sketchpen,15,40,25,1,00115,India
943729,2023-04-11,704,scale,5,10,5,2,00115,India
511984,2023-04-11,703,eraser,1,3,2,2,00472,India
511984,2023-04-11,708,sketchpen,15,40,25,1,00472,India
673240,2023-04-11,712,graph paper,20,40,20,1,00066,India
673240,2023-04-11,715,folder,5,15,10,1,00066,India
673240,2023-04-11,701,gel pen,5,10,5,2,00066,India
673240,2023-04-11,716,printing paper,200,400,200,1,00066,India
742637,2023-04-11,710,geometry box,100,150,50,2,00433,India
742637,2023-04-11,701,gel pen,5,10,5,2,00433,India
742637,2023-04-11,715,folder,5,15,10,1,00433,India
742637,2023-04-11,717,spiral bound book,50,100,50,1,00433,India
742637,2023-04-11,702,pencil,2,5,3,2,00433,India
359662,2023-04-11,707,marker,20,40,20,1,00313,India
359662,2023-04-11,701,gel pen,5,10,5,2,00313,India
359662,2023-04-11,717,spiral bound book,50,100,50,1,00313,India
359662,2023-04-11,715,folder,5,15,10,1,00313,India
359662,2023-04-11,703,eraser,1,3,2,2,00313,India
949301,2023-04-11,713,ball pen,5,10,5,2,00417,India
414102,2023-04-11,707,marker,20,40,20,1,00333,India
414102,2023-04-11,704,scale,5,10,5,2,00333,India
414102,2023-04-11,710,geometry box,100,150,50,2,00333,India
414102,2023-04-11,712,graph paper,20,40,20,1,00333,India
414102,2023-04-11,702,pencil,2,5,3,2,00333,India
342159,2023-04-11,701,gel pen,5,10,5,2,00191,India
695738,2023-04-11,707,marker,20,40,20,1,00437,India
695738,2023-04-11,702,pencil,2,5,3,2,00437,India
695738,2023-04-11,710,geometry box,100,150,50,2,00437,India
695738,2023-04-11,708,sketchpen,15,40,25,1,00437,India
695738,2023-04-11,712,graph paper,20,40,20,1,00437,India
406572,2023-04-11,707,marker,20,40,20,1,00462,India
406572,2023-04-11,701,gel pen,5,10,5,2,00462,India
406572,2023-04-11,704,scale,5,10,5,2,00462,India
406572,2023-04-11,717,spiral bound book,50,100,50,1,00462,India
406572,2023-04-11,706,sharpener,3,8,5,2,00462,India
880075,2023-04-11,704,scale,5,10,5,2,00194,India
880075,2023-04-11,712,graph paper,20,40,20,1,00194,India
880075,2023-04-11,707,marker,20,40,20,1,00194,India
880075,2023-04-11,702,pencil,2,5,3,2,00194,India
180384,2023-04-11,703,eraser,1,3,2,2,00023,India
180384,2023-04-11,716,printing paper,200,400,200,1,00023,India
180384,2023-04-11,701,gel pen,5,10,5,2,00023,India
180384,2023-04-11,704,scale,5,10,5,2,00023,India
361625,2023-04-11,701,gel pen,5,10,5,2,00295,India
361625,2023-04-11,712,graph paper,20,40,20,1,00295,India
361625,2023-04-11,707,marker,20,40,20,1,00295,India
991255,2023-04-12,708,sketchpen,15,40,25,1,00482,India
294241,2023-04-12,708,sketchpen,15,40,25,1,00143,India
294241,2023-04-12,709,notebook,30,60,30,2,00143,India
294241,2023-04-12,706,sharpener,3,8,5,2,00143,India
377505,2023-04-12,704,scale,5,10,5,2,00119,India
377505,2023-04-12,710,geometry box,100,150,50,2,00119,India
312461,2023-04-12,702,pencil,2,5,3,2,00051,India
312461,2023-04-12,707,marker,20,40,20,1,00051,India
312461,2023-04-12,716,printing paper,200,400,200,1,00051,India
784018,2023-04-12,709,notebook,30,60,30,2,00362,India
353919,2023-04-12,706,sharpener,3,8,5,2,00101,India
353919,2023-04-12,715,folder,5,15,10,1,00101,India
353919,2023-04-12,716,printing paper,200,400,200,1,00101,India
675862,2023-04-12,713,ball pen,5,10,5,2,00335,India
675862,2023-04-12,703,eraser,1,3,2,2,00335,India
289593,2023-04-12,701,gel pen,5,10,5,2,00295,India
289593,2023-04-12,714,carbon paper,15,30,15,1,00295,India
289593,2023-04-12,712,graph paper,20,40,20,1,00295,India
289593,2023-04-12,717,spiral bound book,50,100,50,1,00295,India
882571,2023-04-12,705,stencil,10,20,10,2,00392,India
882571,2023-04-12,716,printing paper,200,400,200,1,00392,India
882571,2023-04-12,702,pencil,2,5,3,2,00392,India
534655,2023-04-12,702,pencil,2,5,3,2,00358,India
534655,2023-04-12,711,TD kit,150,300,150,1,00358,India
534655,2023-04-12,705,stencil,10,20,10,2,00358,India
534655,2023-04-12,715,folder,5,15,10,1,00358,India
534655,2023-04-12,704,scale,5,10,5,2,00358,India
514869,2023-04-12,703,eraser,1,3,2,2,00202,India
514869,2023-04-12,714,carbon paper,15,30,15,1,00202,India
407611,2023-04-12,714,carbon paper,15,30,15,1,00002,India
407611,2023-04-12,704,scale,5,10,5,2,00002,India
586670,2023-04-12,707,marker,20,40,20,1,00268,India
586670,2023-04-12,702,pencil,2,5,3,2,00268,India
586670,2023-04-12,717,spiral bound book,50,100,50,1,00268,India
586670,2023-04-12,703,eraser,1,3,2,2,00268,India
921885,2023-04-12,707,marker,20,40,20,1,00427,India
921885,2023-04-12,708,sketchpen,15,40,25,1,00427,India
921885,2023-04-12,712,graph paper,20,40,20,1,00427,India
512484,2023-04-12,713,ball pen,5,10,5,2,00320,India
512484,2023-04-12,704,scale,5,10,5,2,00320,India
512484,2023-04-12,707,marker,20,40,20,1,00320,India
512484,2023-04-12,703,eraser,1,3,2,2,00320,India
451243,2023-04-12,706,sharpener,3,8,5,2,00216,India
451243,2023-04-12,707,marker,20,40,20,1,00216,India
451243,2023-04-12,715,folder,5,15,10,1,00216,India
451243,2023-04-12,703,eraser,1,3,2,2,00216,India
451243,2023-04-12,701,gel pen,5,10,5,2,00216,India
145900,2023-04-12,714,carbon paper,15,30,15,1,00219,India
531682,2023-04-12,707,marker,20,40,20,1,00320,India
531682,2023-04-12,713,ball pen,5,10,5,2,00320,India
531682,2023-04-12,717,spiral bound book,50,100,50,1,00320,India
531682,2023-04-12,714,carbon paper,15,30,15,1,00320,India
211369,2023-04-12,710,geometry box,100,150,50,2,00430,India
211369,2023-04-12,714,carbon paper,15,30,15,1,00430,India
291532,2023-04-12,702,pencil,2,5,3,2,00026,India
291532,2023-04-12,709,notebook,30,60,30,2,00026,India
291532,2023-04-12,708,sketchpen,15,40,25,1,00026,India
421882,2023-04-12,705,stencil,10,20,10,2,00487,India
240300,2023-04-12,713,ball pen,5,10,5,2,00027,India
240300,2023-04-12,712,graph paper,20,40,20,1,00027,India
897106,2023-04-12,711,TD kit,150,300,150,1,00080,India
897106,2023-04-12,714,carbon paper,15,30,15,1,00080,India
587522,2023-04-12,716,printing paper,200,400,200,1,00402,India
351296,2023-04-12,710,geometry box,100,150,50,2,00295,India
351296,2023-04-12,707,marker,20,40,20,1,00295,India
920147,2023-04-12,701,gel pen,5,10,5,2,00331,India
167374,2023-04-12,703,eraser,1,3,2,2,00045,India
167374,2023-04-12,710,geometry box,100,150,50,2,00045,India
167374,2023-04-12,717,spiral bound book,50,100,50,1,00045,India
167374,2023-04-12,714,carbon paper,15,30,15,1,00045,India
837106,2023-04-12,706,sharpener,3,8,5,2,00170,India
813681,2023-04-12,704,scale,5,10,5,2,00286,India
813681,2023-04-12,717,spiral bound book,50,100,50,1,00286,India
813681,2023-04-12,705,stencil,10,20,10,2,00286,India
344247,2023-04-12,707,marker,20,40,20,1,00249,India
344247,2023-04-12,713,ball pen,5,10,5,2,00249,India
344247,2023-04-12,710,geometry box,100,150,50,2,00249,India
344247,2023-04-12,705,stencil,10,20,10,2,00249,India
344247,2023-04-12,712,graph paper,20,40,20,1,00249,India
285121,2023-04-12,712,graph paper,20,40,20,1,00282,India
285121,2023-04-12,705,stencil,10,20,10,2,00282,India
285121,2023-04-12,702,pencil,2,5,3,2,00282,India
285121,2023-04-12,701,gel pen,5,10,5,2,00282,India
356081,2023-04-12,712,graph paper,20,40,20,1,00068,India
356081,2023-04-12,711,TD kit,150,300,150,1,00068,India
597507,2023-04-12,710,geometry box,100,150,50,2,00383,India
597507,2023-04-12,715,folder,5,15,10,1,00383,India
597507,2023-04-12,713,ball pen,5,10,5,2,00383,India
597507,2023-04-12,705,stencil,10,20,10,2,00383,India
597507,2023-04-12,703,eraser,1,3,2,2,00383,India
383575,2023-04-12,716,printing paper,200,400,200,1,00319,India
383575,2023-04-12,710,geometry box,100,150,50,2,00319,India
581513,2023-04-12,706,sharpener,3,8,5,2,00475,India
963084,2023-04-12,703,eraser,1,3,2,2,00384,India
963084,2023-04-12,708,sketchpen,15,40,25,1,00384,India
792077,2023-04-12,707,marker,20,40,20,1,00251,India
792077,2023-04-12,713,ball pen,5,10,5,2,00251,India
792077,2023-04-12,714,carbon paper,15,30,15,1,00251,India
410205,2023-04-13,703,eraser,1,3,2,2,00365,India
410205,2023-04-13,709,notebook,30,60,30,2,00365,India
410205,2023-04-13,711,TD kit,150,300,150,1,00365,India
410205,2023-04-13,710,geometry box,100,150,50,2,00365,India
862405,2023-04-13,704,scale,5,10,5,2,00229,India
862405,2023-04-13,707,marker,20,40,20,1,00229,India
862405,2023-04-13,714,carbon paper,15,30,15,1,00229,India
862405,2023-04-13,708,sketchpen,15,40,25,1,00229,India
315481,2023-04-13,716,printing paper,200,400,200,1,00448,India
315481,2023-04-13,701,gel pen,5,10,5,2,00448,India
315481,2023-04-13,706,sharpener,3,8,5,2,00448,India
315481,2023-04-13,704,scale,5,10,5,2,00448,India
303323,2023-04-13,712,graph paper,20,40,20,1,00012,India
303323,2023-04-13,716,printing paper,200,400,200,1,00012,India
303323,2023-04-13,711,TD kit,150,300,150,1,00012,India
578707,2023-04-13,713,ball pen,5,10,5,2,00150,India
358822,2023-04-13,711,TD kit,150,300,150,1,00473,India
358822,2023-04-13,714,carbon paper,15,30,15,1,00473,India
704319,2023-04-13,714,carbon paper,15,30,15,1,00394,India
704319,2023-04-13,704,scale,5,10,5,2,00394,India
704319,2023-04-13,708,sketchpen,15,40,25,1,00394,India
704319,2023-04-13,701,gel pen,5,10,5,2,00394,India
704319,2023-04-13,709,notebook,30,60,30,2,00394,India
856091,2023-04-13,710,geometry box,100,150,50,2,00315,India
856091,2023-04-13,703,eraser,1,3,2,2,00315,India
856091,2023-04-13,713,ball pen,5,10,5,2,00315,India
215201,2023-04-13,705,stencil,10,20,10,2,00464,India
788596,2023-04-13,703,eraser,1,3,2,2,00450,India
829104,2023-04-13,704,scale,5,10,5,2,00036,India
829104,2023-04-13,707,marker,20,40,20,1,00036,India
282450,2023-04-13,712,graph paper,20,40,20,1,00129,India
282450,2023-04-13,701,gel pen,5,10,5,2,00129,India
282450,2023-04-13,706,sharpener,3,8,5,2,00129,India
574411,2023-04-13,708,sketchpen,15,40,25,1,00368,India
574411,2023-04-13,703,eraser,1,3,2,2,00368,India
574411,2023-04-13,717,spiral bound book,50,100,50,1,00368,India
574411,2023-04-13,714,carbon paper,15,30,15,1,00368,India
574411,2023-04-13,705,stencil,10,20,10,2,00368,India
200700,2023-04-13,707,marker,20,40,20,1,00103,India
200700,2023-04-13,715,folder,5,15,10,1,00103,India
200700,2023-04-13,710,geometry box,100,150,50,2,00103,India
165098,2023-04-13,708,sketchpen,15,40,25,1,00185,India
165098,2023-04-13,711,TD kit,150,300,150,1,00185,India
165098,2023-04-13,714,carbon paper,15,30,15,1,00185,India
165098,2023-04-13,713,ball pen,5,10,5,2,00185,India
745796,2023-04-13,703,eraser,1,3,2,2,00137,India
745796,2023-04-13,713,ball pen,5,10,5,2,00137,India
745796,2023-04-13,708,sketchpen,15,40,25,1,00137,India
745796,2023-04-13,716,printing paper,200,400,200,1,00137,India
745796,2023-04-13,709,notebook,30,60,30,2,00137,India
292803,2023-04-13,709,notebook,30,60,30,2,00481,India
292803,2023-04-13,704,scale,5,10,5,2,00481,India
292803,2023-04-13,713,ball pen,5,10,5,2,00481,India
480499,2023-04-13,702,pencil,2,5,3,2,00239,India
480499,2023-04-13,703,eraser,1,3,2,2,00239,India
163492,2023-04-13,711,TD kit,150,300,150,1,00430,India
163492,2023-04-13,716,printing paper,200,400,200,1,00430,India
540951,2023-04-13,706,sharpener,3,8,5,2,00169,India
540951,2023-04-13,713,ball pen,5,10,5,2,00169,India
540951,2023-04-13,710,geometry box,100,150,50,2,00169,India
806359,2023-04-13,706,sharpener,3,8,5,2,00217,India
806359,2023-04-13,716,printing paper,200,400,200,1,00217,India
806359,2023-04-13,711,TD kit,150,300,150,1,00217,India
958775,2023-04-13,703,eraser,1,3,2,2,00003,India
958775,2023-04-13,708,sketchpen,15,40,25,1,00003,India
958775,2023-04-13,705,stencil,10,20,10,2,00003,India
547529,2023-04-13,701,gel pen,5,10,5,2,00278,India
547529,2023-04-13,705,stencil,10,20,10,2,00278,India
547529,2023-04-13,704,scale,5,10,5,2,00278,India
547529,2023-04-13,714,carbon paper,15,30,15,1,00278,India
103812,2023-04-13,705,stencil,10,20,10,2,00419,India
103812,2023-04-13,716,printing paper,200,400,200,1,00419,India
603317,2023-04-13,716,printing paper,200,400,200,1,00461,India
603317,2023-04-13,715,folder,5,15,10,1,00461,India
616487,2023-04-13,712,graph paper,20,40,20,1,00237,India
616487,2023-04-13,701,gel pen,5,10,5,2,00237,India
616487,2023-04-13,708,sketchpen,15,40,25,1,00237,India
283697,2023-04-13,715,folder,5,15,10,1,00207,India
105424,2023-04-13,716,printing paper,200,400,200,1,00121,India
105424,2023-04-13,717,spiral bound book,50,100,50,1,00121,India
105424,2023-04-13,706,sharpener,3,8,5,2,00121,India
534640,2023-04-13,712,graph paper,20,40,20,1,00466,India
534640,2023-04-13,702,pencil,2,5,3,2,00466,India
534640,2023-04-13,707,marker,20,40,20,1,00466,India
534640,2023-04-13,705,stencil,10,20,10,2,00466,India
280253,2023-04-13,714,carbon paper,15,30,15,1,00215,India
280253,2023-04-13,703,eraser,1,3,2,2,00215,India
578061,2023-04-13,711,TD kit,150,300,150,1,00267,India
578061,2023-04-13,710,geometry box,100,150,50,2,00267,India
578061,2023-04-13,717,spiral bound book,50,100,50,1,00267,India
578061,2023-04-13,701,gel pen,5,10,5,2,00267,India
561767,2023-04-13,717,spiral bound book,50,100,50,1,00116,India
288795,2023-04-13,712,graph paper,20,40,20,1,00118,India
288795,2023-04-13,717,spiral bound book,50,100,50,1,00118,India
288795,2023-04-13,711,TD kit,150,300,150,1,00118,India
288795,2023-04-13,708,sketchpen,15,40,25,1,00118,India
269674,2023-04-13,708,sketchpen,15,40,25,1,00156,India
269674,2023-04-13,705,stencil,10,20,10,2,00156,India
269674,2023-04-13,703,eraser,1,3,2,2,00156,India
269674,2023-04-13,701,gel pen,5,10,5,2,00156,India
899303,2023-04-13,716,printing paper,200,400,200,1,00477,India
369400,2023-04-13,709,notebook,30,60,30,2,00240,India
926087,2023-04-13,706,sharpener,3,8,5,2,00064,India
327413,2023-04-13,704,scale,5,10,5,2,00110,India
327413,2023-04-13,709,notebook,30,60,30,2,00110,India
325861,2023-04-13,713,ball pen,5,10,5,2,00179,India
325861,2023-04-13,715,folder,5,15,10,1,00179,India
485226,2023-04-14,705,stencil,10,20,10,2,00484,India
485226,2023-04-14,711,TD kit,150,300,150,1,00484,India
485226,2023-04-14,704,scale,5,10,5,2,00484,India
758703,2023-04-14,707,marker,20,40,20,1,00204,India
758703,2023-04-14,706,sharpener,3,8,5,2,00204,India
565057,2023-04-14,715,folder,5,15,10,1,00225,India
565057,2023-04-14,708,sketchpen,15,40,25,1,00225,India
565057,2023-04-14,709,notebook,30,60,30,2,00225,India
770322,2023-04-14,702,pencil,2,5,3,2,00238,India
770322,2023-04-14,709,notebook,30,60,30,2,00238,India
770322,2023-04-14,705,stencil,10,20,10,2,00238,India
770322,2023-04-14,712,graph paper,20,40,20,1,00238,India
447425,2023-04-14,710,geometry box,100,150,50,2,00058,India
447425,2023-04-14,714,carbon paper,15,30,15,1,00058,India
438845,2023-04-14,706,sharpener,3,8,5,2,00430,India
438845,2023-04-14,717,spiral bound book,50,100,50,1,00430,India
438845,2023-04-14,711,TD kit,150,300,150,1,00430,India
438845,2023-04-14,704,scale,5,10,5,2,00430,India
638697,2023-04-14,710,geometry box,100,150,50,2,00294,India
638697,2023-04-14,706,sharpener,3,8,5,2,00294,India
675815,2023-04-14,706,sharpener,3,8,5,2,00085,India
675815,2023-04-14,705,stencil,10,20,10,2,00085,India
675815,2023-04-14,701,gel pen,5,10,5,2,00085,India
675815,2023-04-14,702,pencil,2,5,3,2,00085,India
675815,2023-04-14,708,sketchpen,15,40,25,1,00085,India
897643,2023-04-14,716,printing paper,200,400,200,1,00345,India
897643,2023-04-14,714,carbon paper,15,30,15,1,00345,India
897643,2023-04-14,711,TD kit,150,300,150,1,00345,India
425664,2023-04-14,712,graph paper,20,40,20,1,00389,India
425664,2023-04-14,701,gel pen,5,10,5,2,00389,India
343168,2023-04-14,715,folder,5,15,10,1,00277,India
343168,2023-04-14,717,spiral bound book,50,100,50,1,00277,India
343168,2023-04-14,710,geometry box,100,150,50,2,00277,India
678552,2023-04-14,710,geometry box,100,150,50,2,00285,India
678552,2023-04-14,706,sharpener,3,8,5,2,00285,India
678552,2023-04-14,716,printing paper,200,400,200,1,00285,India
678552,2023-04-14,712,graph paper,20,40,20,1,00285,India
750084,2023-04-14,703,eraser,1,3,2,2,00499,India
750084,2023-04-14,716,printing paper,200,400,200,1,00499,India
851377,2023-04-14,706,sharpener,3,8,5,2,00138,India
851377,2023-04-14,713,ball pen,5,10,5,2,00138,India
453981,2023-04-14,716,printing paper,200,400,200,1,00426,India
453981,2023-04-14,706,sharpener,3,8,5,2,00426,India
754096,2023-04-14,701,gel pen,5,10,5,2,00120,India
754096,2023-04-14,713,ball pen,5,10,5,2,00120,India
754096,2023-04-14,703,eraser,1,3,2,2,00120,India
754096,2023-04-14,714,carbon paper,15,30,15,1,00120,India
603534,2023-04-14,706,sharpener,3,8,5,2,00255,India
603534,2023-04-14,701,gel pen,5,10,5,2,00255,India
603534,2023-04-14,710,geometry box,100,150,50,2,00255,India
603534,2023-04-14,713,ball pen,5,10,5,2,00255,India
748065,2023-04-14,710,geometry box,100,150,50,2,00050,India
748065,2023-04-14,716,printing paper,200,400,200,1,00050,India
340626,2023-04-14,705,stencil,10,20,10,2,00260,India
340626,2023-04-14,707,marker,20,40,20,1,00260,India
340626,2023-04-14,717,spiral bound book,50,100,50,1,00260,India
420072,2023-04-14,709,notebook,30,60,30,2,00031,India
420072,2023-04-14,711,TD kit,150,300,150,1,00031,India
420072,2023-04-14,714,carbon paper,15,30,15,1,00031,India
727685,2023-04-14,708,sketchpen,15,40,25,1,00106,India
164024,2023-04-14,704,scale,5,10,5,2,00271,India
164024,2023-04-14,714,carbon paper,15,30,15,1,00271,India
164024,2023-04-14,707,marker,20,40,20,1,00271,India
138138,2023-04-14,707,marker,20,40,20,1,00014,India
138138,2023-04-14,713,ball pen,5,10,5,2,00014,India
138138,2023-04-14,708,sketchpen,15,40,25,1,00014,India
138138,2023-04-14,703,eraser,1,3,2,2,00014,India
130751,2023-04-14,701,gel pen,5,10,5,2,00410,India
130751,2023-04-14,704,scale,5,10,5,2,00410,India
130751,2023-04-14,707,marker,20,40,20,1,00410,India
130751,2023-04-14,713,ball pen,5,10,5,2,00410,India
130751,2023-04-14,708,sketchpen,15,40,25,1,00410,India
831345,2023-04-14,711,TD kit,150,300,150,1,00400,India
831345,2023-04-14,715,folder,5,15,10,1,00400,India
831345,2023-04-14,717,spiral bound book,50,100,50,1,00400,India
831345,2023-04-14,703,eraser,1,3,2,2,00400,India
776798,2023-04-14,710,geometry box,100,150,50,2,00023,India
776798,2023-04-14,714,carbon paper,15,30,15,1,00023,India
776798,2023-04-14,707,marker,20,40,20,1,00023,India
776798,2023-04-14,708,sketchpen,15,40,25,1,00023,India
601469,2023-04-14,717,spiral bound book,50,100,50,1,00233,India
758004,2023-04-14,710,geometry box,100,150,50,2,00145,India
758004,2023-04-14,714,carbon paper,15,30,15,1,00145,India
758004,2023-04-14,706,sharpener,3,8,5,2,00145,India
758004,2023-04-14,715,folder,5,15,10,1,00145,India
639411,2023-04-14,705,stencil,10,20,10,2,00374,India
639411,2023-04-14,701,gel pen,5,10,5,2,00374,India
639411,2023-04-14,703,eraser,1,3,2,2,00374,India
639411,2023-04-14,717,spiral bound book,50,100,50,1,00374,India
953763,2023-04-14,705,stencil,10,20,10,2,00034,India
867914,2023-04-14,715,folder,5,15,10,1,00273,India
980270,2023-04-14,702,pencil,2,5,3,2,00313,India
980270,2023-04-14,704,scale,5,10,5,2,00313,India
980270,2023-04-14,706,sharpener,3,8,5,2,00313,India
980270,2023-04-14,705,stencil,10,20,10,2,00313,India
588223,2023-04-14,707,marker,20,40,20,1,00378,India
413783,2023-04-14,717,spiral bound book,50,100,50,1,00140,India
763661,2023-04-14,713,ball pen,5,10,5,2,00351,India
541658,2023-04-14,711,TD kit,150,300,150,1,00181,India
541658,2023-04-14,701,gel pen,5,10,5,2,00181,India
541658,2023-04-14,715,folder,5,15,10,1,00181,India
207303,2023-04-14,704,scale,5,10,5,2,00235,India
207303,2023-04-14,707,marker,20,40,20,1,00235,India
167448,2023-04-14,710,geometry box,100,150,50,2,00350,India
167448,2023-04-14,702,pencil,2,5,3,2,00350,India
167448,2023-04-14,717,spiral bound book,50,100,50,1,00350,India
715646,2023-04-14,714,carbon paper,15,30,15,1,00086,India
715646,2023-04-14,709,notebook,30,60,30,2,00086,India
655744,2023-04-14,710,geometry box,100,150,50,2,00404,India
655744,2023-04-14,714,carbon paper,15,30,15,1,00404,India
300219,2023-04-14,717,spiral bound book,50,100,50,1,00490,India
300219,2023-04-14,702,pencil,2,5,3,2,00490,India
300219,2023-04-14,714,carbon paper,15,30,15,1,00490,India
300219,2023-04-14,716,printing paper,200,400,200,1,00490,India
784739,2023-04-14,704,scale,5,10,5,2,00348,India
784739,2023-04-14,711,TD kit,150,300,150,1,00348,India
784739,2023-04-14,714,carbon paper,15,30,15,1,00348,India
784739,2023-04-14,702,pencil,2,5,3,2,00348,India
784739,2023-04-14,703,eraser,1,3,2,2,00348,India
894756,2023-04-15,715,folder,5,15,10,1,00388,India
894756,2023-04-15,708,sketchpen,15,40,25,1,00388,India
894756,2023-04-15,707,marker,20,40,20,1,00388,India
894756,2023-04-15,705,stencil,10,20,10,2,00388,India
683086,2023-04-15,706,sharpener,3,8,5,2,00270,India
683086,2023-04-15,711,TD kit,150,300,150,1,00270,India
683086,2023-04-15,701,gel pen,5,10,5,2,00270,India
683086,2023-04-15,709,notebook,30,60,30,2,00270,India
683086,2023-04-15,710,geometry box,100,150,50,2,00270,India
710469,2023-04-15,714,carbon paper,15,30,15,1,00246,India
710469,2023-04-15,702,pencil,2,5,3,2,00246,India
710469,2023-04-15,708,sketchpen,15,40,25,1,00246,India
118607,2023-04-15,713,ball pen,5,10,5,2,00012,India
321843,2023-04-15,703,eraser,1,3,2,2,00226,India
321843,2023-04-15,716,printing paper,200,400,200,1,00226,India
321843,2023-04-15,706,sharpener,3,8,5,2,00226,India
321843,2023-04-15,710,geometry box,100,150,50,2,00226,India
321843,2023-04-15,711,TD kit,150,300,150,1,00226,India
269382,2023-04-15,703,eraser,1,3,2,2,00248,India
667060,2023-04-15,710,geometry box,100,150,50,2,00133,India
667060,2023-04-15,709,notebook,30,60,30,2,00133,India
667060,2023-04-15,715,folder,5,15,10,1,00133,India
667060,2023-04-15,702,pencil,2,5,3,2,00133,India
513840,2023-04-15,714,carbon paper,15,30,15,1,00452,India
513840,2023-04-15,701,gel pen,5,10,5,2,00452,India
513840,2023-04-15,709,notebook,30,60,30,2,00452,India
494700,2023-04-15,717,spiral bound book,50,100,50,1,00125,India
494700,2023-04-15,704,scale,5,10,5,2,00125,India
494700,2023-04-15,712,graph paper,20,40,20,1,00125,India
494700,2023-04-15,706,sharpener,3,8,5,2,00125,India
942901,2023-04-15,710,geometry box,100,150,50,2,00368,India
942901,2023-04-15,716,printing paper,200,400,200,1,00368,India
942901,2023-04-15,702,pencil,2,5,3,2,00368,India
510207,2023-04-15,701,gel pen,5,10,5,2,00155,India
510207,2023-04-15,704,scale,5,10,5,2,00155,India
510207,2023-04-15,710,geometry box,100,150,50,2,00155,India
510207,2023-04-15,713,ball pen,5,10,5,2,00155,India
536057,2023-04-15,708,sketchpen,15,40,25,1,00279,India
536057,2023-04-15,711,TD kit,150,300,150,1,00279,India
160349,2023-04-15,707,marker,20,40,20,1,00266,India
160349,2023-04-15,712,graph paper,20,40,20,1,00266,India
160349,2023-04-15,701,gel pen,5,10,5,2,00266,India
479554,2023-04-15,713,ball pen,5,10,5,2,00456,India
479554,2023-04-15,714,carbon paper,15,30,15,1,00456,India
479554,2023-04-15,716,printing paper,200,400,200,1,00456,India
479554,2023-04-15,709,notebook,30,60,30,2,00456,India
702801,2023-04-15,710,geometry box,100,150,50,2,00318,India
702801,2023-04-15,709,notebook,30,60,30,2,00318,India
329276,2023-04-15,716,printing paper,200,400,200,1,00009,India
329276,2023-04-15,708,sketchpen,15,40,25,1,00009,India
329276,2023-04-15,707,marker,20,40,20,1,00009,India
329276,2023-04-15,711,TD kit,150,300,150,1,00009,India
329276,2023-04-15,713,ball pen,5,10,5,2,00009,India
663667,2023-04-15,714,carbon paper,15,30,15,1,00194,India
663667,2023-04-15,711,TD kit,150,300,150,1,00194,India
663667,2023-04-15,706,sharpener,3,8,5,2,00194,India
663667,2023-04-15,708,sketchpen,15,40,25,1,00194,India
663667,2023-04-15,703,eraser,1,3,2,2,00194,India
275342,2023-04-15,706,sharpener,3,8,5,2,00053,India
275342,2023-04-15,709,notebook,30,60,30,2,00053,India
275342,2023-04-15,714,carbon paper,15,30,15,1,00053,India
275342,2023-04-15,705,stencil,10,20,10,2,00053,India
890689,2023-04-15,715,folder,5,15,10,1,00445,India
890689,2023-04-15,709,notebook,30,60,30,2,00445,India
890689,2023-04-15,711,TD kit,150,300,150,1,00445,India
480160,2023-04-15,708,sketchpen,15,40,25,1,00286,India
480160,2023-04-15,710,geometry box,100,150,50,2,00286,India
480160,2023-04-15,705,stencil,10,20,10,2,00286,India
480160,2023-04-15,707,marker,20,40,20,1,00286,India
480160,2023-04-15,717,spiral bound book,50,100,50,1,00286,India
898254,2023-04-15,705,stencil,10,20,10,2,00315,India
898254,2023-04-15,717,spiral bound book,50,100,50,1,00315,India
898254,2023-04-15,702,pencil,2,5,3,2,00315,India
898254,2023-04-15,703,eraser,1,3,2,2,00315,India
412086,2023-04-15,712,graph paper,20,40,20,1,00246,India
412086,2023-04-15,709,notebook,30,60,30,2,00246,India
412086,2023-04-15,713,ball pen,5,10,5,2,00246,India
397904,2023-04-15,701,gel pen,5,10,5,2,00020,India
397904,2023-04-15,707,marker,20,40,20,1,00020,India
397904,2023-04-15,716,printing paper,200,400,200,1,00020,India
397904,2023-04-15,709,notebook,30,60,30,2,00020,India
397904,2023-04-15,714,carbon paper,15,30,15,1,00020,India
813168,2023-04-15,707,marker,20,40,20,1,00037,India
707543,2023-04-15,716,printing paper,200,400,200,1,00294,India
707543,2023-04-15,712,graph paper,20,40,20,1,00294,India
707543,2023-04-15,714,carbon paper,15,30,15,1,00294,India
707543,2023-04-15,706,sharpener,3,8,5,2,00294,India
634838,2023-04-15,702,pencil,2,5,3,2,00427,India
634838,2023-04-15,716,printing paper,200,400,200,1,00427,India
634838,2023-04-15,717,spiral bound book,50,100,50,1,00427,India
634838,2023-04-15,704,scale,5,10,5,2,00427,India
634838,2023-04-15,712,graph paper,20,40,20,1,00427,India
611775,2023-04-15,704,scale,5,10,5,2,00248,India
611775,2023-04-15,703,eraser,1,3,2,2,00248,India
611775,2023-04-15,709,notebook,30,60,30,2,00248,India
611775,2023-04-15,712,graph paper,20,40,20,1,00248,India
611775,2023-04-15,705,stencil,10,20,10,2,00248,India
933717,2023-04-15,705,stencil,10,20,10,2,00240,India
933717,2023-04-15,710,geometry box,100,150,50,2,00240,India
933717,2023-04-15,714,carbon paper,15,30,15,1,00240,India
207458,2023-04-15,715,folder,5,15,10,1,00308,India
628549,2023-04-15,715,folder,5,15,10,1,00445,India
628549,2023-04-15,709,notebook,30,60,30,2,00445,India
543832,2023-04-15,705,stencil,10,20,10,2,00308,India
543832,2023-04-15,702,pencil,2,5,3,2,00308,India
543832,2023-04-15,712,graph paper,20,40,20,1,00308,India
543832,2023-04-15,703,eraser,1,3,2,2,00308,India
491110,2023-04-15,704,scale,5,10,5,2,00374,India
491110,2023-04-15,710,geometry box,100,150,50,2,00374,India
491110,2023-04-15,701,gel pen,5,10,5,2,00374,India
733068,2023-04-15,715,folder,5,15,10,1,00399,India
733068,2023-04-15,717,spiral bound book,50,100,50,1,00399,India
733068,2023-04-15,707,marker,20,40,20,1,00399,India
733068,2023-04-15,703,eraser,1,3,2,2,00399,India
557170,2023-04-15,707,marker,20,40,20,1,00161,India
557170,2023-04-15,705,stencil,10,20,10,2,00161,India
557170,2023-04-15,704,scale,5,10,5,2,00161,India
557170,2023-04-15,711,TD kit,150,300,150,1,00161,India
885624,2023-04-15,701,gel pen,5,10,5,2,00211,India
750349,2023-04-15,707,marker,20,40,20,1,00315,India
750349,2023-04-15,709,notebook,30,60,30,2,00315,India
770034,2023-04-15,704,scale,5,10,5,2,00119,India
770034,2023-04-15,716,printing paper,200,400,200,1,00119,India
770034,2023-04-15,701,gel pen,5,10,5,2,00119,India
805000,2023-04-15,704,scale,5,10,5,2,00497,India
805000,2023-04-15,707,marker,20,40,20,1,00497,India
694656,2023-04-15,716,printing paper,200,400,200,1,00124,India
694656,2023-04-15,708,sketchpen,15,40,25,1,00124,India
694656,2023-04-15,715,folder,5,15,10,1,00124,India
143034,2023-04-15,716,printing paper,200,400,200,1,00461,India
135298,2023-04-15,706,sharpener,3,8,5,2,00127,India
221700,2023-04-15,704,scale,5,10,5,2,00313,India
946883,2023-04-15,705,stencil,10,20,10,2,00255,India
946883,2023-04-15,713,ball pen,5,10,5,2,00255,India
946883,2023-04-15,707,marker,20,40,20,1,00255,India
946883,2023-04-15,716,printing paper,200,400,200,1,00255,India
946883,2023-04-15,704,scale,5,10,5,2,00255,India
327733,2023-04-15,703,eraser,1,3,2,2,00216,India
327733,2023-04-15,712,graph paper,20,40,20,1,00216,India
327733,2023-04-15,708,sketchpen,15,40,25,1,00216,India
327733,2023-04-15,713,ball pen,5,10,5,2,00216,India
824406,2023-04-15,710,geometry box,100,150,50,2,00394,India
824406,2023-04-15,705,stencil,10,20,10,2,00394,India
824406,2023-04-15,703,eraser,1,3,2,2,00394,India
824406,2023-04-15,704,scale,5,10,5,2,00394,India
996846,2023-04-15,706,sharpener,3,8,5,2,00284,India
996846,2023-04-15,716,printing paper,200,400,200,1,00284,India
996846,2023-04-15,703,eraser,1,3,2,2,00284,India
576748,2023-04-16,715,folder,5,15,10,1,00285,India
603371,2023-04-16,714,carbon paper,15,30,15,1,00279,India
603371,2023-04-16,710,geometry box,100,150,50,2,00279,India
310362,2023-04-16,703,eraser,1,3,2,2,00441,India
310362,2023-04-16,701,gel pen,5,10,5,2,00441,India
310362,2023-04-16,712,graph paper,20,40,20,1,00441,India
310362,2023-04-16,717,spiral bound book,50,100,50,1,00441,India
784010,2023-04-16,715,folder,5,15,10,1,00119,India
784010,2023-04-16,712,graph paper,20,40,20,1,00119,India
792842,2023-04-16,710,geometry box,100,150,50,2,00297,India
792842,2023-04-16,711,TD kit,150,300,150,1,00297,India
792842,2023-04-16,713,ball pen,5,10,5,2,00297,India
902218,2023-04-16,712,graph paper,20,40,20,1,00080,India
902218,2023-04-16,705,stencil,10,20,10,2,00080,India
932701,2023-04-16,711,TD kit,150,300,150,1,00236,India
721133,2023-04-16,710,geometry box,100,150,50,2,00138,India
721133,2023-04-16,715,folder,5,15,10,1,00138,India
721133,2023-04-16,713,ball pen,5,10,5,2,00138,India
873884,2023-04-16,709,notebook,30,60,30,2,00424,India
873884,2023-04-16,704,scale,5,10,5,2,00424,India
911243,2023-04-16,701,gel pen,5,10,5,2,00495,India
368691,2023-04-16,707,marker,20,40,20,1,00121,India
368691,2023-04-16,708,sketchpen,15,40,25,1,00121,India
368691,2023-04-16,709,notebook,30,60,30,2,00121,India
368691,2023-04-16,712,graph paper,20,40,20,1,00121,India
368691,2023-04-16,702,pencil,2,5,3,2,00121,India
884478,2023-04-16,713,ball pen,5,10,5,2,00403,India
884478,2023-04-16,705,stencil,10,20,10,2,00403,India
884478,2023-04-16,706,sharpener,3,8,5,2,00403,India
294220,2023-04-16,711,TD kit,150,300,150,1,00313,India
294220,2023-04-16,703,eraser,1,3,2,2,00313,India
294220,2023-04-16,714,carbon paper,15,30,15,1,00313,India
475528,2023-04-16,715,folder,5,15,10,1,00422,India
475528,2023-04-16,714,carbon paper,15,30,15,1,00422,India
475528,2023-04-16,701,gel pen,5,10,5,2,00422,India
587582,2023-04-16,713,ball pen,5,10,5,2,00481,India
587582,2023-04-16,706,sharpener,3,8,5,2,00481,India
587582,2023-04-16,703,eraser,1,3,2,2,00481,India
951233,2023-04-16,707,marker,20,40,20,1,00346,India
951233,2023-04-16,701,gel pen,5,10,5,2,00346,India
951233,2023-04-16,714,carbon paper,15,30,15,1,00346,India
951233,2023-04-16,712,graph paper,20,40,20,1,00346,India
690079,2023-04-16,705,stencil,10,20,10,2,00407,India
690079,2023-04-16,706,sharpener,3,8,5,2,00407,India
521431,2023-04-16,704,scale,5,10,5,2,00034,India
521431,2023-04-16,706,sharpener,3,8,5,2,00034,India
521431,2023-04-16,713,ball pen,5,10,5,2,00034,India
521431,2023-04-16,711,TD kit,150,300,150,1,00034,India
739559,2023-04-16,716,printing paper,200,400,200,1,00491,India
588533,2023-04-16,701,gel pen,5,10,5,2,00421,India
588533,2023-04-16,714,carbon paper,15,30,15,1,00421,India
236561,2023-04-16,711,TD kit,150,300,150,1,00426,India
236561,2023-04-16,717,spiral bound book,50,100,50,1,00426,India
964376,2023-04-16,709,notebook,30,60,30,2,00202,India
743677,2023-04-16,709,notebook,30,60,30,2,00049,India
962834,2023-04-16,707,marker,20,40,20,1,00281,India
962834,2023-04-16,702,pencil,2,5,3,2,00281,India
732833,2023-04-16,705,stencil,10,20,10,2,00441,India
732833,2023-04-16,702,pencil,2,5,3,2,00441,India
732833,2023-04-16,704,scale,5,10,5,2,00441,India
965056,2023-04-16,706,sharpener,3,8,5,2,00474,India
965056,2023-04-16,713,ball pen,5,10,5,2,00474,India
965056,2023-04-16,708,sketchpen,15,40,25,1,00474,India
965056,2023-04-16,704,scale,5,10,5,2,00474,India
875582,2023-04-16,704,scale,5,10,5,2,00450,India
875582,2023-04-16,715,folder,5,15,10,1,00450,India
875582,2023-04-16,711,TD kit,150,300,150,1,00450,India
875582,2023-04-16,714,carbon paper,15,30,15,1,00450,India
875582,2023-04-16,703,eraser,1,3,2,2,00450,India
642259,2023-04-16,703,eraser,1,3,2,2,00103,India
642259,2023-04-16,709,notebook,30,60,30,2,00103,India
642259,2023-04-16,707,marker,20,40,20,1,00103,India
565483,2023-04-16,707,marker,20,40,20,1,00170,India
565483,2023-04-16,712,graph paper,20,40,20,1,00170,India
656355,2023-04-16,712,graph paper,20,40,20,1,00290,India
276018,2023-04-16,708,sketchpen,15,40,25,1,00300,India
202076,2023-04-16,702,pencil,2,5,3,2,00212,India
202076,2023-04-16,704,scale,5,10,5,2,00212,India
227615,2023-04-16,715,folder,5,15,10,1,00037,India
554062,2023-04-16,712,graph paper,20,40,20,1,00097,India
554062,2023-04-16,710,geometry box,100,150,50,2,00097,India
850538,2023-04-16,703,eraser,1,3,2,2,00088,India
978322,2023-04-16,703,eraser,1,3,2,2,00277,India
978322,2023-04-16,710,geometry box,100,150,50,2,00277,India
259596,2023-04-16,713,ball pen,5,10,5,2,00028,India
259596,2023-04-16,714,carbon paper,15,30,15,1,00028,India
259596,2023-04-16,701,gel pen,5,10,5,2,00028,India
583996,2023-04-16,715,folder,5,15,10,1,00083,India
583996,2023-04-16,708,sketchpen,15,40,25,1,00083,India
583996,2023-04-16,701,gel pen,5,10,5,2,00083,India
376846,2023-04-16,717,spiral bound book,50,100,50,1,00287,India
950187,2023-04-16,701,gel pen,5,10,5,2,00053,India
950187,2023-04-16,713,ball pen,5,10,5,2,00053,India
950187,2023-04-16,703,eraser,1,3,2,2,00053,India
950187,2023-04-16,705,stencil,10,20,10,2,00053,India
255124,2023-04-16,709,notebook,30,60,30,2,00030,India
255124,2023-04-16,714,carbon paper,15,30,15,1,00030,India
255124,2023-04-16,701,gel pen,5,10,5,2,00030,India
289619,2023-04-17,706,sharpener,3,8,5,2,00473,India
289619,2023-04-17,713,ball pen,5,10,5,2,00473,India
998120,2023-04-17,715,folder,5,15,10,1,00294,India
998120,2023-04-17,713,ball pen,5,10,5,2,00294,India
998120,2023-04-17,701,gel pen,5,10,5,2,00294,India
998120,2023-04-17,717,spiral bound book,50,100,50,1,00294,India
321537,2023-04-17,711,TD kit,150,300,150,1,00331,India
321537,2023-04-17,704,scale,5,10,5,2,00331,India
259671,2023-04-17,717,spiral bound book,50,100,50,1,00082,India
259671,2023-04-17,704,scale,5,10,5,2,00082,India
259671,2023-04-17,702,pencil,2,5,3,2,00082,India
259671,2023-04-17,707,marker,20,40,20,1,00082,India
259671,2023-04-17,710,geometry box,100,150,50,2,00082,India
636473,2023-04-17,703,eraser,1,3,2,2,00426,India
636473,2023-04-17,704,scale,5,10,5,2,00426,India
574598,2023-04-17,709,notebook,30,60,30,2,00076,India
574598,2023-04-17,707,marker,20,40,20,1,00076,India
269920,2023-04-17,704,scale,5,10,5,2,00166,India
269920,2023-04-17,708,sketchpen,15,40,25,1,00166,India
269920,2023-04-17,709,notebook,30,60,30,2,00166,India
493877,2023-04-17,717,spiral bound book,50,100,50,1,00133,India
493877,2023-04-17,708,sketchpen,15,40,25,1,00133,India
493877,2023-04-17,707,marker,20,40,20,1,00133,India
122106,2023-04-17,712,graph paper,20,40,20,1,00256,India
122106,2023-04-17,706,sharpener,3,8,5,2,00256,India
122106,2023-04-17,708,sketchpen,15,40,25,1,00256,India
122106,2023-04-17,704,scale,5,10,5,2,00256,India
674095,2023-04-17,717,spiral bound book,50,100,50,1,00406,India
699404,2023-04-17,715,folder,5,15,10,1,00441,India
699404,2023-04-17,708,sketchpen,15,40,25,1,00441,India
699404,2023-04-17,714,carbon paper,15,30,15,1,00441,India
568533,2023-04-17,715,folder,5,15,10,1,00351,India
459880,2023-04-17,713,ball pen,5,10,5,2,00271,India
459880,2023-04-17,716,printing paper,200,400,200,1,00271,India
459880,2023-04-17,708,sketchpen,15,40,25,1,00271,India
600422,2023-04-17,706,sharpener,3,8,5,2,00125,India
600422,2023-04-17,711,TD kit,150,300,150,1,00125,India
600422,2023-04-17,716,printing paper,200,400,200,1,00125,India
600422,2023-04-17,712,graph paper,20,40,20,1,00125,India
327603,2023-04-17,705,stencil,10,20,10,2,00488,India
643642,2023-04-17,703,eraser,1,3,2,2,00045,India
626561,2023-04-17,709,notebook,30,60,30,2,00095,India
626561,2023-04-17,710,geometry box,100,150,50,2,00095,India
308272,2023-04-17,707,marker,20,40,20,1,00155,India
308272,2023-04-17,716,printing paper,200,400,200,1,00155,India
308272,2023-04-17,710,geometry box,100,150,50,2,00155,India
308272,2023-04-17,708,sketchpen,15,40,25,1,00155,India
739313,2023-04-17,717,spiral bound book,50,100,50,1,00379,India
739313,2023-04-17,711,TD kit,150,300,150,1,00379,India
739313,2023-04-17,714,carbon paper,15,30,15,1,00379,India
739313,2023-04-17,713,ball pen,5,10,5,2,00379,India
831560,2023-04-17,705,stencil,10,20,10,2,00092,India
335618,2023-04-17,706,sharpener,3,8,5,2,00065,India
335618,2023-04-17,708,sketchpen,15,40,25,1,00065,India
335618,2023-04-17,717,spiral bound book,50,100,50,1,00065,India
485043,2023-04-17,715,folder,5,15,10,1,00068,India
886614,2023-04-17,714,carbon paper,15,30,15,1,00282,India
886614,2023-04-17,708,sketchpen,15,40,25,1,00282,India
455839,2023-04-17,710,geometry box,100,150,50,2,00074,India
455839,2023-04-17,702,pencil,2,5,3,2,00074,India
455839,2023-04-17,711,TD kit,150,300,150,1,00074,India
444562,2023-04-17,709,notebook,30,60,30,2,00171,India
903967,2023-04-17,715,folder,5,15,10,1,00017,India
903967,2023-04-17,706,sharpener,3,8,5,2,00017,India
903967,2023-04-17,716,printing paper,200,400,200,1,00017,India
903967,2023-04-17,713,ball pen,5,10,5,2,00017,India
207502,2023-04-17,705,stencil,10,20,10,2,00312,India
207502,2023-04-17,702,pencil,2,5,3,2,00312,India
207502,2023-04-17,716,printing paper,200,400,200,1,00312,India
604781,2023-04-17,710,geometry box,100,150,50,2,00265,India
604781,2023-04-17,705,stencil,10,20,10,2,00265,India
604781,2023-04-17,704,scale,5,10,5,2,00265,India
748591,2023-04-17,705,stencil,10,20,10,2,00171,India
748591,2023-04-17,707,marker,20,40,20,1,00171,India
748591,2023-04-17,709,notebook,30,60,30,2,00171,India
597237,2023-04-17,707,marker,20,40,20,1,00415,India
597237,2023-04-17,716,printing paper,200,400,200,1,00415,India
392082,2023-04-17,702,pencil,2,5,3,2,00160,India
392082,2023-04-17,716,printing paper,200,400,200,1,00160,India
392082,2023-04-17,712,graph paper,20,40,20,1,00160,India
392082,2023-04-17,711,TD kit,150,300,150,1,00160,India
392082,2023-04-17,704,scale,5,10,5,2,00160,India
930138,2023-04-17,702,pencil,2,5,3,2,00375,India
930138,2023-04-17,715,folder,5,15,10,1,00375,India
930138,2023-04-17,714,carbon paper,15,30,15,1,00375,India
930138,2023-04-17,708,sketchpen,15,40,25,1,00375,India
930138,2023-04-17,707,marker,20,40,20,1,00375,India
527587,2023-04-17,711,TD kit,150,300,150,1,00374,India
527587,2023-04-17,710,geometry box,100,150,50,2,00374,India
868890,2023-04-17,716,printing paper,200,400,200,1,00410,India
868890,2023-04-17,713,ball pen,5,10,5,2,00410,India
766776,2023-04-17,706,sharpener,3,8,5,2,00455,India
766776,2023-04-17,703,eraser,1,3,2,2,00455,India
766776,2023-04-17,711,TD kit,150,300,150,1,00455,India
499801,2023-04-17,715,folder,5,15,10,1,00099,India
499801,2023-04-17,703,eraser,1,3,2,2,00099,India
499801,2023-04-17,710,geometry box,100,150,50,2,00099,India
542384,2023-04-17,714,carbon paper,15,30,15,1,00350,India
542384,2023-04-17,717,spiral bound book,50,100,50,1,00350,India
288886,2023-04-17,708,sketchpen,15,40,25,1,00301,India
288886,2023-04-17,711,TD kit,150,300,150,1,00301,India
131767,2023-04-17,702,pencil,2,5,3,2,00335,India
607821,2023-04-17,715,folder,5,15,10,1,00368,India
607821,2023-04-17,705,stencil,10,20,10,2,00368,India
607821,2023-04-17,703,eraser,1,3,2,2,00368,India
979924,2023-04-17,701,gel pen,5,10,5,2,00279,India
979924,2023-04-17,707,marker,20,40,20,1,00279,India
979924,2023-04-17,704,scale,5,10,5,2,00279,India
609787,2023-04-17,712,graph paper,20,40,20,1,00481,India
609787,2023-04-17,709,notebook,30,60,30,2,00481,India
246306,2023-04-17,717,spiral bound book,50,100,50,1,00279,India
246306,2023-04-17,716,printing paper,200,400,200,1,00279,India
246306,2023-04-17,710,geometry box,100,150,50,2,00279,India
246306,2023-04-17,703,eraser,1,3,2,2,00279,India
975589,2023-04-18,713,ball pen,5,10,5,2,00463,India
975589,2023-04-18,705,stencil,10,20,10,2,00463,India
975589,2023-04-18,709,notebook,30,60,30,2,00463,India
975589,2023-04-18,716,printing paper,200,400,200,1,00463,India
653687,2023-04-18,703,eraser,1,3,2,2,00214,India
653687,2023-04-18,712,graph paper,20,40,20,1,00214,India
653687,2023-04-18,713,ball pen,5,10,5,2,00214,India
653687,2023-04-18,702,pencil,2,5,3,2,00214,India
635022,2023-04-18,704,scale,5,10,5,2,00315,India
635022,2023-04-18,702,pencil,2,5,3,2,00315,India
722350,2023-04-18,716,printing paper,200,400,200,1,00470,India
278123,2023-04-18,707,marker,20,40,20,1,00495,India
278123,2023-04-18,713,ball pen,5,10,5,2,00495,India
278123,2023-04-18,702,pencil,2,5,3,2,00495,India
278123,2023-04-18,710,geometry box,100,150,50,2,00495,India
278123,2023-04-18,705,stencil,10,20,10,2,00495,India
829344,2023-04-18,714,carbon paper,15,30,15,1,00062,India
595033,2023-04-18,710,geometry box,100,150,50,2,00183,India
595033,2023-04-18,702,pencil,2,5,3,2,00183,India
595033,2023-04-18,703,eraser,1,3,2,2,00183,India
595033,2023-04-18,713,ball pen,5,10,5,2,00183,India
782539,2023-04-18,708,sketchpen,15,40,25,1,00175,India
782539,2023-04-18,713,ball pen,5,10,5,2,00175,India
105647,2023-04-18,703,eraser,1,3,2,2,00263,India
105647,2023-04-18,705,stencil,10,20,10,2,00263,India
105647,2023-04-18,710,geometry box,100,150,50,2,00263,India
105647,2023-04-18,716,printing paper,200,400,200,1,00263,India
105647,2023-04-18,714,carbon paper,15,30,15,1,00263,India
746887,2023-04-18,708,sketchpen,15,40,25,1,00500,India
746887,2023-04-18,706,sharpener,3,8,5,2,00500,India
935893,2023-04-18,715,folder,5,15,10,1,00083,India
935893,2023-04-18,709,notebook,30,60,30,2,00083,India
841042,2023-04-18,708,sketchpen,15,40,25,1,00014,India
841042,2023-04-18,702,pencil,2,5,3,2,00014,India
841042,2023-04-18,704,scale,5,10,5,2,00014,India
841042,2023-04-18,716,printing paper,200,400,200,1,00014,India
841042,2023-04-18,715,folder,5,15,10,1,00014,India
273767,2023-04-18,715,folder,5,15,10,1,00133,India
273767,2023-04-18,711,TD kit,150,300,150,1,00133,India
231201,2023-04-18,713,ball pen,5,10,5,2,00270,India
231201,2023-04-18,710,geometry box,100,150,50,2,00270,India
718327,2023-04-18,713,ball pen,5,10,5,2,00239,India
718327,2023-04-18,705,stencil,10,20,10,2,00239,India
718327,2023-04-18,703,eraser,1,3,2,2,00239,India
139623,2023-04-18,707,marker,20,40,20,1,00282,India
355548,2023-04-18,707,marker,20,40,20,1,00119,India
355548,2023-04-18,715,folder,5,15,10,1,00119,India
355548,2023-04-18,714,carbon paper,15,30,15,1,00119,India
355548,2023-04-18,710,geometry box,100,150,50,2,00119,India
240998,2023-04-18,702,pencil,2,5,3,2,00253,India
909942,2023-04-18,706,sharpener,3,8,5,2,00058,India
909942,2023-04-18,701,gel pen,5,10,5,2,00058,India
909942,2023-04-18,714,carbon paper,15,30,15,1,00058,India
904217,2023-04-18,701,gel pen,5,10,5,2,00350,India
904217,2023-04-18,715,folder,5,15,10,1,00350,India
904217,2023-04-18,702,pencil,2,5,3,2,00350,India
433820,2023-04-18,708,sketchpen,15,40,25,1,00383,India
433820,2023-04-18,706,sharpener,3,8,5,2,00383,India
433820,2023-04-18,715,folder,5,15,10,1,00383,India
433820,2023-04-18,714,carbon paper,15,30,15,1,00383,India
581829,2023-04-18,715,folder,5,15,10,1,00080,India
581829,2023-04-18,714,carbon paper,15,30,15,1,00080,India
581829,2023-04-18,705,stencil,10,20,10,2,00080,India
581829,2023-04-18,707,marker,20,40,20,1,00080,India
633946,2023-04-18,713,ball pen,5,10,5,2,00005,India
633946,2023-04-18,708,sketchpen,15,40,25,1,00005,India
633946,2023-04-18,710,geometry box,100,150,50,2,00005,India
633946,2023-04-18,703,eraser,1,3,2,2,00005,India
738770,2023-04-18,714,carbon paper,15,30,15,1,00351,India
738770,2023-04-18,708,sketchpen,15,40,25,1,00351,India
462458,2023-04-18,712,graph paper,20,40,20,1,00321,India
462458,2023-04-18,704,scale,5,10,5,2,00321,India
462458,2023-04-18,702,pencil,2,5,3,2,00321,India
462458,2023-04-18,706,sharpener,3,8,5,2,00321,India
471091,2023-04-18,706,sharpener,3,8,5,2,00466,India
471091,2023-04-18,708,sketchpen,15,40,25,1,00466,India
471091,2023-04-18,702,pencil,2,5,3,2,00466,India
471091,2023-04-18,713,ball pen,5,10,5,2,00466,India
118693,2023-04-18,706,sharpener,3,8,5,2,00081,India
118693,2023-04-18,717,spiral bound book,50,100,50,1,00081,India
118693,2023-04-18,704,scale,5,10,5,2,00081,India
118693,2023-04-18,715,folder,5,15,10,1,00081,India
459987,2023-04-18,702,pencil,2,5,3,2,00029,India
459987,2023-04-18,713,ball pen,5,10,5,2,00029,India
459987,2023-04-18,717,spiral bound book,50,100,50,1,00029,India
459987,2023-04-18,716,printing paper,200,400,200,1,00029,India
865569,2023-04-18,704,scale,5,10,5,2,00422,India
865569,2023-04-18,717,spiral bound book,50,100,50,1,00422,India
865569,2023-04-18,708,sketchpen,15,40,25,1,00422,India
865569,2023-04-18,701,gel pen,5,10,5,2,00422,India
235448,2023-04-18,701,gel pen,5,10,5,2,00195,India
235448,2023-04-18,706,sharpener,3,8,5,2,00195,India
235448,2023-04-18,717,spiral bound book,50,100,50,1,00195,India
235448,2023-04-18,715,folder,5,15,10,1,00195,India
341982,2023-04-18,709,notebook,30,60,30,2,00329,India
341982,2023-04-18,703,eraser,1,3,2,2,00329,India
341982,2023-04-18,714,carbon paper,15,30,15,1,00329,India
237663,2023-04-18,706,sharpener,3,8,5,2,00250,India
237663,2023-04-18,704,scale,5,10,5,2,00250,India
647087,2023-04-18,706,sharpener,3,8,5,2,00201,India
647087,2023-04-18,701,gel pen,5,10,5,2,00201,India
647087,2023-04-18,704,scale,5,10,5,2,00201,India
112598,2023-04-18,705,stencil,10,20,10,2,00453,India
112598,2023-04-18,709,notebook,30,60,30,2,00453,India
112598,2023-04-18,703,eraser,1,3,2,2,00453,India
625486,2023-04-18,709,notebook,30,60,30,2,00226,India
625486,2023-04-18,706,sharpener,3,8,5,2,00226,India
513483,2023-04-18,706,sharpener,3,8,5,2,00294,India
513483,2023-04-18,714,carbon paper,15,30,15,1,00294,India
513483,2023-04-18,711,TD kit,150,300,150,1,00294,India
513483,2023-04-18,707,marker,20,40,20,1,00294,India
513483,2023-04-18,702,pencil,2,5,3,2,00294,India
144881,2023-04-18,712,graph paper,20,40,20,1,00167,India
144881,2023-04-18,706,sharpener,3,8,5,2,00167,India
144881,2023-04-18,701,gel pen,5,10,5,2,00167,India
144881,2023-04-18,715,folder,5,15,10,1,00167,India
258371,2023-04-18,705,stencil,10,20,10,2,00103,India
258371,2023-04-18,702,pencil,2,5,3,2,00103,India
126729,2023-04-18,704,scale,5,10,5,2,00002,India
126729,2023-04-18,715,folder,5,15,10,1,00002,India
415999,2023-04-18,708,sketchpen,15,40,25,1,00041,India
415999,2023-04-18,705,stencil,10,20,10,2,00041,India
525954,2023-04-18,703,eraser,1,3,2,2,00421,India
525954,2023-04-18,715,folder,5,15,10,1,00421,India
525954,2023-04-18,712,graph paper,20,40,20,1,00421,India
525954,2023-04-18,717,spiral bound book,50,100,50,1,00421,India
741055,2023-04-18,711,TD kit,150,300,150,1,00392,India
741055,2023-04-18,716,printing paper,200,400,200,1,00392,India
741055,2023-04-18,706,sharpener,3,8,5,2,00392,India
741055,2023-04-18,701,gel pen,5,10,5,2,00392,India
741055,2023-04-18,714,carbon paper,15,30,15,1,00392,India
930782,2023-04-18,703,eraser,1,3,2,2,00388,India
332261,2023-04-18,704,scale,5,10,5,2,00255,India
332261,2023-04-18,707,marker,20,40,20,1,00255,India
218355,2023-04-18,703,eraser,1,3,2,2,00156,India
560154,2023-04-18,713,ball pen,5,10,5,2,00469,India
560154,2023-04-18,714,carbon paper,15,30,15,1,00469,India
560154,2023-04-18,705,stencil,10,20,10,2,00469,India
560154,2023-04-18,712,graph paper,20,40,20,1,00469,India
560154,2023-04-18,703,eraser,1,3,2,2,00469,India
929096,2023-04-18,703,eraser,1,3,2,2,00315,India
929096,2023-04-18,711,TD kit,150,300,150,1,00315,India
480044,2023-04-19,713,ball pen,5,10,5,2,00487,India
480044,2023-04-19,703,eraser,1,3,2,2,00487,India
480044,2023-04-19,715,folder,5,15,10,1,00487,India
480044,2023-04-19,707,marker,20,40,20,1,00487,India
423355,2023-04-19,702,pencil,2,5,3,2,00167,India
423355,2023-04-19,709,notebook,30,60,30,2,00167,India
423355,2023-04-19,710,geometry box,100,150,50,2,00167,India
772089,2023-04-19,717,spiral bound book,50,100,50,1,00215,India
772089,2023-04-19,707,marker,20,40,20,1,00215,India
772089,2023-04-19,715,folder,5,15,10,1,00215,India
810545,2023-04-19,717,spiral bound book,50,100,50,1,00451,India
810545,2023-04-19,715,folder,5,15,10,1,00451,India
810545,2023-04-19,701,gel pen,5,10,5,2,00451,India
146373,2023-04-19,711,TD kit,150,300,150,1,00442,India
146373,2023-04-19,712,graph paper,20,40,20,1,00442,India
146373,2023-04-19,714,carbon paper,15,30,15,1,00442,India
932361,2023-04-19,717,spiral bound book,50,100,50,1,00497,India
932361,2023-04-19,706,sharpener,3,8,5,2,00497,India
932361,2023-04-19,716,printing paper,200,400,200,1,00497,India
774783,2023-04-19,708,sketchpen,15,40,25,1,00312,India
774783,2023-04-19,714,carbon paper,15,30,15,1,00312,India
774783,2023-04-19,706,sharpener,3,8,5,2,00312,India
669556,2023-04-19,712,graph paper,20,40,20,1,00059,India
669556,2023-04-19,701,gel pen,5,10,5,2,00059,India
669556,2023-04-19,714,carbon paper,15,30,15,1,00059,India
669556,2023-04-19,703,eraser,1,3,2,2,00059,India
262870,2023-04-19,706,sharpener,3,8,5,2,00419,India
262870,2023-04-19,709,notebook,30,60,30,2,00419,India
458872,2023-04-19,704,scale,5,10,5,2,00277,India
458872,2023-04-19,708,sketchpen,15,40,25,1,00277,India
212657,2023-04-19,713,ball pen,5,10,5,2,00272,India
212657,2023-04-19,701,gel pen,5,10,5,2,00272,India
212657,2023-04-19,717,spiral bound book,50,100,50,1,00272,India
679403,2023-04-19,714,carbon paper,15,30,15,1,00444,India
679403,2023-04-19,712,graph paper,20,40,20,1,00444,India
679403,2023-04-19,709,notebook,30,60,30,2,00444,India
525340,2023-04-19,704,scale,5,10,5,2,00350,India
525340,2023-04-19,707,marker,20,40,20,1,00350,India
525340,2023-04-19,716,printing paper,200,400,200,1,00350,India
525340,2023-04-19,715,folder,5,15,10,1,00350,India
347758,2023-04-19,716,printing paper,200,400,200,1,00411,India
347758,2023-04-19,708,sketchpen,15,40,25,1,00411,India
347758,2023-04-19,702,pencil,2,5,3,2,00411,India
611263,2023-04-19,713,ball pen,5,10,5,2,00015,India
619926,2023-04-19,715,folder,5,15,10,1,00206,India
619926,2023-04-19,713,ball pen,5,10,5,2,00206,India
619926,2023-04-19,711,TD kit,150,300,150,1,00206,India
506101,2023-04-19,706,sharpener,3,8,5,2,00325,India
206117,2023-04-19,711,TD kit,150,300,150,1,00264,India
206117,2023-04-19,714,carbon paper,15,30,15,1,00264,India
206117,2023-04-19,707,marker,20,40,20,1,00264,India
368697,2023-04-19,705,stencil,10,20,10,2,00348,India
368697,2023-04-19,704,scale,5,10,5,2,00348,India
368697,2023-04-19,703,eraser,1,3,2,2,00348,India
225593,2023-04-19,713,ball pen,5,10,5,2,00150,India
225593,2023-04-19,705,stencil,10,20,10,2,00150,India
207491,2023-04-19,706,sharpener,3,8,5,2,00409,India
185538,2023-04-19,715,folder,5,15,10,1,00105,India
185538,2023-04-19,706,sharpener,3,8,5,2,00105,India
185538,2023-04-19,716,printing paper,200,400,200,1,00105,India
185538,2023-04-19,707,marker,20,40,20,1,00105,India
861742,2023-04-19,715,folder,5,15,10,1,00448,India
861742,2023-04-19,708,sketchpen,15,40,25,1,00448,India
861742,2023-04-19,701,gel pen,5,10,5,2,00448,India
861742,2023-04-19,714,carbon paper,15,30,15,1,00448,India
322893,2023-04-19,705,stencil,10,20,10,2,00323,India
322893,2023-04-19,702,pencil,2,5,3,2,00323,India
241490,2023-04-19,711,TD kit,150,300,150,1,00199,India
161169,2023-04-19,713,ball pen,5,10,5,2,00356,India
242227,2023-04-19,708,sketchpen,15,40,25,1,00054,India
242227,2023-04-19,710,geometry box,100,150,50,2,00054,India
233985,2023-04-19,705,stencil,10,20,10,2,00251,India
233985,2023-04-19,717,spiral bound book,50,100,50,1,00251,India
233985,2023-04-19,712,graph paper,20,40,20,1,00251,India
233985,2023-04-19,711,TD kit,150,300,150,1,00251,India
312533,2023-04-19,703,eraser,1,3,2,2,00389,India
312533,2023-04-19,713,ball pen,5,10,5,2,00389,India
312533,2023-04-19,712,graph paper,20,40,20,1,00389,India
312533,2023-04-19,705,stencil,10,20,10,2,00389,India
311019,2023-04-19,710,geometry box,100,150,50,2,00084,India
311019,2023-04-19,713,ball pen,5,10,5,2,00084,India
608705,2023-04-19,708,sketchpen,15,40,25,1,00413,India
910915,2023-04-19,713,ball pen,5,10,5,2,00278,India
651130,2023-04-19,716,printing paper,200,400,200,1,00004,India
938513,2023-04-19,714,carbon paper,15,30,15,1,00298,India
938513,2023-04-19,715,folder,5,15,10,1,00298,India
938513,2023-04-19,713,ball pen,5,10,5,2,00298,India
669386,2023-04-19,701,gel pen,5,10,5,2,00123,India
669386,2023-04-19,705,stencil,10,20,10,2,00123,India
669386,2023-04-19,713,ball pen,5,10,5,2,00123,India
222939,2023-04-19,711,TD kit,150,300,150,1,00157,India
222939,2023-04-19,705,stencil,10,20,10,2,00157,India
222939,2023-04-19,717,spiral bound book,50,100,50,1,00157,India
222939,2023-04-19,701,gel pen,5,10,5,2,00157,India
572930,2023-04-19,715,folder,5,15,10,1,00116,India
572930,2023-04-19,716,printing paper,200,400,200,1,00116,India
156740,2023-04-19,716,printing paper,200,400,200,1,00062,India
586444,2023-04-19,704,scale,5,10,5,2,00168,India
586444,2023-04-19,717,spiral bound book,50,100,50,1,00168,India
577815,2023-04-19,702,pencil,2,5,3,2,00445,India
981391,2023-04-19,703,eraser,1,3,2,2,00442,India
981391,2023-04-19,706,sharpener,3,8,5,2,00442,India
981391,2023-04-19,702,pencil,2,5,3,2,00442,India
794789,2023-04-20,709,notebook,30,60,30,2,00108,India
794789,2023-04-20,711,TD kit,150,300,150,1,00108,India
593546,2023-04-20,702,pencil,2,5,3,2,00152,India
593546,2023-04-20,705,stencil,10,20,10,2,00152,India
593546,2023-04-20,701,gel pen,5,10,5,2,00152,India
814072,2023-04-20,717,spiral bound book,50,100,50,1,00332,India
814072,2023-04-20,704,scale,5,10,5,2,00332,India
814072,2023-04-20,705,stencil,10,20,10,2,00332,India
518999,2023-04-20,702,pencil,2,5,3,2,00481,India
518999,2023-04-20,712,graph paper,20,40,20,1,00481,India
675210,2023-04-20,715,folder,5,15,10,1,00123,India
675210,2023-04-20,716,printing paper,200,400,200,1,00123,India
675210,2023-04-20,706,sharpener,3,8,5,2,00123,India
947252,2023-04-20,710,geometry box,100,150,50,2,00213,India
156610,2023-04-20,709,notebook,30,60,30,2,00033,India
156610,2023-04-20,704,scale,5,10,5,2,00033,India
156610,2023-04-20,707,marker,20,40,20,1,00033,India
522731,2023-04-20,704,scale,5,10,5,2,00425,India
522731,2023-04-20,705,stencil,10,20,10,2,00425,India
522731,2023-04-20,715,folder,5,15,10,1,00425,India
802795,2023-04-20,704,scale,5,10,5,2,00314,India
150329,2023-04-20,715,folder,5,15,10,1,00359,India
150329,2023-04-20,704,scale,5,10,5,2,00359,India
150329,2023-04-20,702,pencil,2,5,3,2,00359,India
150329,2023-04-20,708,sketchpen,15,40,25,1,00359,India
473571,2023-04-20,704,scale,5,10,5,2,00341,India
612080,2023-04-20,705,stencil,10,20,10,2,00335,India
606214,2023-04-20,717,spiral bound book,50,100,50,1,00498,India
606214,2023-04-20,707,marker,20,40,20,1,00498,India
606214,2023-04-20,714,carbon paper,15,30,15,1,00498,India
606214,2023-04-20,705,stencil,10,20,10,2,00498,India
606214,2023-04-20,716,printing paper,200,400,200,1,00498,India
450963,2023-04-20,712,graph paper,20,40,20,1,00312,India
450963,2023-04-20,705,stencil,10,20,10,2,00312,India
450963,2023-04-20,703,eraser,1,3,2,2,00312,India
450963,2023-04-20,702,pencil,2,5,3,2,00312,India
450963,2023-04-20,714,carbon paper,15,30,15,1,00312,India
429984,2023-04-20,707,marker,20,40,20,1,00150,India
429984,2023-04-20,704,scale,5,10,5,2,00150,India
429984,2023-04-20,711,TD kit,150,300,150,1,00150,India
842695,2023-04-20,716,printing paper,200,400,200,1,00193,India
842695,2023-04-20,717,spiral bound book,50,100,50,1,00193,India
842695,2023-04-20,708,sketchpen,15,40,25,1,00193,India
842695,2023-04-20,702,pencil,2,5,3,2,00193,India
842695,2023-04-20,710,geometry box,100,150,50,2,00193,India
563226,2023-04-20,715,folder,5,15,10,1,00050,India
563226,2023-04-20,703,eraser,1,3,2,2,00050,India
563226,2023-04-20,707,marker,20,40,20,1,00050,India
563226,2023-04-20,709,notebook,30,60,30,2,00050,India
563226,2023-04-20,714,carbon paper,15,30,15,1,00050,India
475379,2023-04-20,701,gel pen,5,10,5,2,00211,India
475379,2023-04-20,715,folder,5,15,10,1,00211,India
531069,2023-04-20,702,pencil,2,5,3,2,00303,India
684686,2023-04-20,705,stencil,10,20,10,2,00096,India
502513,2023-04-20,717,spiral bound book,50,100,50,1,00363,India
165189,2023-04-20,710,geometry box,100,150,50,2,00358,India
165189,2023-04-20,702,pencil,2,5,3,2,00358,India
165189,2023-04-20,716,printing paper,200,400,200,1,00358,India
165189,2023-04-20,713,ball pen,5,10,5,2,00358,India
932359,2023-04-20,716,printing paper,200,400,200,1,00173,India
932359,2023-04-20,711,TD kit,150,300,150,1,00173,India
932359,2023-04-20,704,scale,5,10,5,2,00173,India
932359,2023-04-20,712,graph paper,20,40,20,1,00173,India
932359,2023-04-20,705,stencil,10,20,10,2,00173,India
843343,2023-04-20,713,ball pen,5,10,5,2,00033,India
843343,2023-04-20,712,graph paper,20,40,20,1,00033,India
843343,2023-04-20,710,geometry box,100,150,50,2,00033,India
118443,2023-04-20,714,carbon paper,15,30,15,1,00357,India
118443,2023-04-20,709,notebook,30,60,30,2,00357,India
100892,2023-04-20,709,notebook,30,60,30,2,00198,India
455948,2023-04-20,705,stencil,10,20,10,2,00490,India
547030,2023-04-20,706,sharpener,3,8,5,2,00109,India
547030,2023-04-20,713,ball pen,5,10,5,2,00109,India
714811,2023-04-20,708,sketchpen,15,40,25,1,00003,India
168098,2023-04-20,706,sharpener,3,8,5,2,00439,India
168098,2023-04-20,702,pencil,2,5,3,2,00439,India
168098,2023-04-20,709,notebook,30,60,30,2,00439,India
130367,2023-04-20,711,TD kit,150,300,150,1,00147,India
130367,2023-04-20,707,marker,20,40,20,1,00147,India
130367,2023-04-20,716,printing paper,200,400,200,1,00147,India
130367,2023-04-20,705,stencil,10,20,10,2,00147,India
260678,2023-04-20,701,gel pen,5,10,5,2,00457,India
260678,2023-04-20,707,marker,20,40,20,1,00457,India
268066,2023-04-20,717,spiral bound book,50,100,50,1,00442,India
268066,2023-04-20,705,stencil,10,20,10,2,00442,India
551008,2023-04-20,716,printing paper,200,400,200,1,00085,India
516195,2023-04-20,707,marker,20,40,20,1,00399,India
516195,2023-04-20,705,stencil,10,20,10,2,00399,India
516195,2023-04-20,713,ball pen,5,10,5,2,00399,India
546760,2023-04-20,712,graph paper,20,40,20,1,00436,India
812491,2023-04-20,705,stencil,10,20,10,2,00028,India
812491,2023-04-20,706,sharpener,3,8,5,2,00028,India
812491,2023-04-20,712,graph paper,20,40,20,1,00028,India
760622,2023-04-20,707,marker,20,40,20,1,00242,India
760622,2023-04-20,713,ball pen,5,10,5,2,00242,India
480331,2023-04-20,712,graph paper,20,40,20,1,00439,India
480331,2023-04-20,711,TD kit,150,300,150,1,00439,India
480331,2023-04-20,705,stencil,10,20,10,2,00439,India
480331,2023-04-20,713,ball pen,5,10,5,2,00439,India
558404,2023-04-20,702,pencil,2,5,3,2,00051,India
981237,2023-04-20,709,notebook,30,60,30,2,00019,India
403702,2023-04-20,714,carbon paper,15,30,15,1,00500,India
403702,2023-04-20,710,geometry box,100,150,50,2,00500,India
403702,2023-04-20,717,spiral bound book,50,100,50,1,00500,India
403702,2023-04-20,706,sharpener,3,8,5,2,00500,India
403702,2023-04-20,702,pencil,2,5,3,2,00500,India
627236,2023-04-20,709,notebook,30,60,30,2,00199,India
627236,2023-04-20,713,ball pen,5,10,5,2,00199,India
627236,2023-04-20,714,carbon paper,15,30,15,1,00199,India
627236,2023-04-20,706,sharpener,3,8,5,2,00199,India
568973,2023-04-20,712,graph paper,20,40,20,1,00287,India
568973,2023-04-20,708,sketchpen,15,40,25,1,00287,India
568973,2023-04-20,714,carbon paper,15,30,15,1,00287,India
210292,2023-04-20,715,folder,5,15,10,1,00247,India
210292,2023-04-20,708,sketchpen,15,40,25,1,00247,India
488911,2023-04-20,710,geometry box,100,150,50,2,00358,India
488911,2023-04-20,706,sharpener,3,8,5,2,00358,India
378034,2023-04-20,706,sharpener,3,8,5,2,00296,India
378034,2023-04-20,708,sketchpen,15,40,25,1,00296,India
378034,2023-04-20,712,graph paper,20,40,20,1,00296,India
378034,2023-04-20,702,pencil,2,5,3,2,00296,India
378034,2023-04-20,715,folder,5,15,10,1,00296,India
520171,2023-04-20,704,scale,5,10,5,2,00424,India
520171,2023-04-20,706,sharpener,3,8,5,2,00424,India
520171,2023-04-20,705,stencil,10,20,10,2,00424,India
108061,2023-04-21,701,gel pen,5,10,5,2,00093,India
108061,2023-04-21,703,eraser,1,3,2,2,00093,India
108061,2023-04-21,710,geometry box,100,150,50,2,00093,India
108061,2023-04-21,704,scale,5,10,5,2,00093,India
108061,2023-04-21,706,sharpener,3,8,5,2,00093,India
901262,2023-04-21,707,marker,20,40,20,1,00184,India
350204,2023-04-21,714,carbon paper,15,30,15,1,00400,India
350204,2023-04-21,701,gel pen,5,10,5,2,00400,India
350204,2023-04-21,717,spiral bound book,50,100,50,1,00400,India
350204,2023-04-21,709,notebook,30,60,30,2,00400,India
119109,2023-04-21,704,scale,5,10,5,2,00188,India
119109,2023-04-21,713,ball pen,5,10,5,2,00188,India
119109,2023-04-21,717,spiral bound book,50,100,50,1,00188,India
119109,2023-04-21,710,geometry box,100,150,50,2,00188,India
813843,2023-04-21,715,folder,5,15,10,1,00424,India
271239,2023-04-21,711,TD kit,150,300,150,1,00192,India
271239,2023-04-21,701,gel pen,5,10,5,2,00192,India
983264,2023-04-21,713,ball pen,5,10,5,2,00303,India
983264,2023-04-21,706,sharpener,3,8,5,2,00303,India
983264,2023-04-21,709,notebook,30,60,30,2,00303,India
983264,2023-04-21,704,scale,5,10,5,2,00303,India
983264,2023-04-21,701,gel pen,5,10,5,2,00303,India
215338,2023-04-21,711,TD kit,150,300,150,1,00423,India
215338,2023-04-21,716,printing paper,200,400,200,1,00423,India
831216,2023-04-21,706,sharpener,3,8,5,2,00257,India
831216,2023-04-21,707,marker,20,40,20,1,00257,India
831216,2023-04-21,713,ball pen,5,10,5,2,00257,India
831216,2023-04-21,711,TD kit,150,300,150,1,00257,India
411312,2023-04-21,702,pencil,2,5,3,2,00434,India
411312,2023-04-21,717,spiral bound book,50,100,50,1,00434,India
411312,2023-04-21,709,notebook,30,60,30,2,00434,India
616544,2023-04-21,713,ball pen,5,10,5,2,00178,India
616544,2023-04-21,704,scale,5,10,5,2,00178,India
616544,2023-04-21,705,stencil,10,20,10,2,00178,India
616544,2023-04-21,708,sketchpen,15,40,25,1,00178,India
344165,2023-04-21,713,ball pen,5,10,5,2,00138,India
344165,2023-04-21,710,geometry box,100,150,50,2,00138,India
982252,2023-04-21,704,scale,5,10,5,2,00077,India
982252,2023-04-21,707,marker,20,40,20,1,00077,India
255044,2023-04-21,711,TD kit,150,300,150,1,00110,India
255044,2023-04-21,709,notebook,30,60,30,2,00110,India
255044,2023-04-21,706,sharpener,3,8,5,2,00110,India
255044,2023-04-21,710,geometry box,100,150,50,2,00110,India
582658,2023-04-21,701,gel pen,5,10,5,2,00368,India
582658,2023-04-21,708,sketchpen,15,40,25,1,00368,India
582658,2023-04-21,716,printing paper,200,400,200,1,00368,India
597495,2023-04-21,716,printing paper,200,400,200,1,00120,India
597495,2023-04-21,711,TD kit,150,300,150,1,00120,India
597495,2023-04-21,710,geometry box,100,150,50,2,00120,India
597495,2023-04-21,706,sharpener,3,8,5,2,00120,India
468671,2023-04-21,717,spiral bound book,50,100,50,1,00036,India
468671,2023-04-21,714,carbon paper,15,30,15,1,00036,India
770045,2023-04-21,702,pencil,2,5,3,2,00222,India
770045,2023-04-21,712,graph paper,20,40,20,1,00222,India
770045,2023-04-21,706,sharpener,3,8,5,2,00222,India
770045,2023-04-21,709,notebook,30,60,30,2,00222,India
226059,2023-04-21,702,pencil,2,5,3,2,00399,India
226059,2023-04-21,704,scale,5,10,5,2,00399,India
226059,2023-04-21,713,ball pen,5,10,5,2,00399,India
605720,2023-04-21,708,sketchpen,15,40,25,1,00387,India
950116,2023-04-21,707,marker,20,40,20,1,00426,India
950116,2023-04-21,701,gel pen,5,10,5,2,00426,India
248398,2023-04-21,703,eraser,1,3,2,2,00054,India
248398,2023-04-21,717,spiral bound book,50,100,50,1,00054,India
248398,2023-04-21,706,sharpener,3,8,5,2,00054,India
248398,2023-04-21,701,gel pen,5,10,5,2,00054,India
248398,2023-04-21,704,scale,5,10,5,2,00054,India
653678,2023-04-21,701,gel pen,5,10,5,2,00451,India
734090,2023-04-21,708,sketchpen,15,40,25,1,00159,India
100059,2023-04-21,708,sketchpen,15,40,25,1,00452,India
221554,2023-04-21,701,gel pen,5,10,5,2,00209,India
221554,2023-04-21,712,graph paper,20,40,20,1,00209,India
713741,2023-04-21,711,TD kit,150,300,150,1,00234,India
713741,2023-04-21,702,pencil,2,5,3,2,00234,India
713741,2023-04-21,714,carbon paper,15,30,15,1,00234,India
369488,2023-04-21,705,stencil,10,20,10,2,00351,India
369488,2023-04-21,703,eraser,1,3,2,2,00351,India
369488,2023-04-21,706,sharpener,3,8,5,2,00351,India
369488,2023-04-21,711,TD kit,150,300,150,1,00351,India
674558,2023-04-21,707,marker,20,40,20,1,00444,India
142133,2023-04-21,702,pencil,2,5,3,2,00419,India
142133,2023-04-21,703,eraser,1,3,2,2,00419,India
142133,2023-04-21,711,TD kit,150,300,150,1,00419,India
142133,2023-04-21,713,ball pen,5,10,5,2,00419,India
142133,2023-04-21,708,sketchpen,15,40,25,1,00419,India
235914,2023-04-21,705,stencil,10,20,10,2,00264,India
235914,2023-04-21,707,marker,20,40,20,1,00264,India
235914,2023-04-21,711,TD kit,150,300,150,1,00264,India
235914,2023-04-21,703,eraser,1,3,2,2,00264,India
170378,2023-04-21,711,TD kit,150,300,150,1,00092,India
268821,2023-04-21,701,gel pen,5,10,5,2,00298,India
268821,2023-04-21,702,pencil,2,5,3,2,00298,India
268821,2023-04-21,715,folder,5,15,10,1,00298,India
160247,2023-04-21,716,printing paper,200,400,200,1,00229,India
374826,2023-04-21,708,sketchpen,15,40,25,1,00335,India
374826,2023-04-21,704,scale,5,10,5,2,00335,India
700332,2023-04-21,710,geometry box,100,150,50,2,00426,India
700332,2023-04-21,707,marker,20,40,20,1,00426,India
220276,2023-04-22,704,scale,5,10,5,2,00294,India
220276,2023-04-22,714,carbon paper,15,30,15,1,00294,India
805424,2023-04-22,701,gel pen,5,10,5,2,00490,India
423786,2023-04-22,704,scale,5,10,5,2,00210,India
423786,2023-04-22,709,notebook,30,60,30,2,00210,India
423786,2023-04-22,705,stencil,10,20,10,2,00210,India
423786,2023-04-22,716,printing paper,200,400,200,1,00210,India
940646,2023-04-22,707,marker,20,40,20,1,00387,India
940646,2023-04-22,702,pencil,2,5,3,2,00387,India
940646,2023-04-22,714,carbon paper,15,30,15,1,00387,India
940646,2023-04-22,712,graph paper,20,40,20,1,00387,India
940646,2023-04-22,716,printing paper,200,400,200,1,00387,India
468016,2023-04-22,711,TD kit,150,300,150,1,00072,India
468016,2023-04-22,702,pencil,2,5,3,2,00072,India
250894,2023-04-22,704,scale,5,10,5,2,00067,India
250894,2023-04-22,709,notebook,30,60,30,2,00067,India
872443,2023-04-22,706,sharpener,3,8,5,2,00323,India
872443,2023-04-22,715,folder,5,15,10,1,00323,India
872443,2023-04-22,712,graph paper,20,40,20,1,00323,India
750350,2023-04-22,713,ball pen,5,10,5,2,00358,India
750350,2023-04-22,712,graph paper,20,40,20,1,00358,India
750350,2023-04-22,701,gel pen,5,10,5,2,00358,India
951412,2023-04-22,712,graph paper,20,40,20,1,00037,India
951412,2023-04-22,705,stencil,10,20,10,2,00037,India
951412,2023-04-22,708,sketchpen,15,40,25,1,00037,India
951412,2023-04-22,709,notebook,30,60,30,2,00037,India
306141,2023-04-22,711,TD kit,150,300,150,1,00254,India
306141,2023-04-22,710,geometry box,100,150,50,2,00254,India
294890,2023-04-22,715,folder,5,15,10,1,00022,India
294890,2023-04-22,706,sharpener,3,8,5,2,00022,India
294890,2023-04-22,710,geometry box,100,150,50,2,00022,India
763114,2023-04-22,701,gel pen,5,10,5,2,00307,India
763114,2023-04-22,710,geometry box,100,150,50,2,00307,India
763114,2023-04-22,705,stencil,10,20,10,2,00307,India
763114,2023-04-22,704,scale,5,10,5,2,00307,India
924760,2023-04-22,708,sketchpen,15,40,25,1,00353,India
924760,2023-04-22,713,ball pen,5,10,5,2,00353,India
924760,2023-04-22,709,notebook,30,60,30,2,00353,India
924760,2023-04-22,701,gel pen,5,10,5,2,00353,India
901124,2023-04-22,714,carbon paper,15,30,15,1,00299,India
901124,2023-04-22,709,notebook,30,60,30,2,00299,India
901124,2023-04-22,716,printing paper,200,400,200,1,00299,India
901124,2023-04-22,717,spiral bound book,50,100,50,1,00299,India
901124,2023-04-22,707,marker,20,40,20,1,00299,India
772744,2023-04-22,701,gel pen,5,10,5,2,00200,India
772744,2023-04-22,715,folder,5,15,10,1,00200,India
772744,2023-04-22,706,sharpener,3,8,5,2,00200,India
850578,2023-04-22,712,graph paper,20,40,20,1,00307,India
850578,2023-04-22,709,notebook,30,60,30,2,00307,India
543388,2023-04-22,705,stencil,10,20,10,2,00071,India
543388,2023-04-22,703,eraser,1,3,2,2,00071,India
543388,2023-04-22,716,printing paper,200,400,200,1,00071,India
452461,2023-04-22,703,eraser,1,3,2,2,00090,India
452461,2023-04-22,705,stencil,10,20,10,2,00090,India
836237,2023-04-22,714,carbon paper,15,30,15,1,00139,India
836237,2023-04-22,707,marker,20,40,20,1,00139,India
401094,2023-04-22,710,geometry box,100,150,50,2,00071,India
401094,2023-04-22,713,ball pen,5,10,5,2,00071,India
460146,2023-04-22,713,ball pen,5,10,5,2,00258,India
460146,2023-04-22,715,folder,5,15,10,1,00258,India
460146,2023-04-22,711,TD kit,150,300,150,1,00258,India
460146,2023-04-22,714,carbon paper,15,30,15,1,00258,India
509841,2023-04-22,709,notebook,30,60,30,2,00437,India
966832,2023-04-22,716,printing paper,200,400,200,1,00136,India
966832,2023-04-22,707,marker,20,40,20,1,00136,India
966832,2023-04-22,710,geometry box,100,150,50,2,00136,India
966832,2023-04-22,701,gel pen,5,10,5,2,00136,India
966832,2023-04-22,713,ball pen,5,10,5,2,00136,India
664773,2023-04-22,701,gel pen,5,10,5,2,00458,India
664773,2023-04-22,708,sketchpen,15,40,25,1,00458,India
699486,2023-04-22,713,ball pen,5,10,5,2,00295,India
699486,2023-04-22,709,notebook,30,60,30,2,00295,India
647606,2023-04-22,708,sketchpen,15,40,25,1,00229,India
181311,2023-04-22,709,notebook,30,60,30,2,00028,India
694674,2023-04-22,715,folder,5,15,10,1,00287,India
694674,2023-04-22,703,eraser,1,3,2,2,00287,India
694674,2023-04-22,717,spiral bound book,50,100,50,1,00287,India
694674,2023-04-22,709,notebook,30,60,30,2,00287,India
694674,2023-04-22,701,gel pen,5,10,5,2,00287,India
406081,2023-04-22,703,eraser,1,3,2,2,00087,India
406081,2023-04-22,708,sketchpen,15,40,25,1,00087,India
432067,2023-04-22,710,geometry box,100,150,50,2,00169,India
432067,2023-04-22,708,sketchpen,15,40,25,1,00169,India
241772,2023-04-22,701,gel pen,5,10,5,2,00448,India
241772,2023-04-22,710,geometry box,100,150,50,2,00448,India
241772,2023-04-22,707,marker,20,40,20,1,00448,India
492907,2023-04-22,712,graph paper,20,40,20,1,00310,India
492907,2023-04-22,703,eraser,1,3,2,2,00310,India
492907,2023-04-22,704,scale,5,10,5,2,00310,India
492907,2023-04-22,710,geometry box,100,150,50,2,00310,India
901625,2023-04-22,717,spiral bound book,50,100,50,1,00467,India
901625,2023-04-22,716,printing paper,200,400,200,1,00467,India
756180,2023-04-22,716,printing paper,200,400,200,1,00040,India
579025,2023-04-22,710,geometry box,100,150,50,2,00087,India
579025,2023-04-22,712,graph paper,20,40,20,1,00087,India
579025,2023-04-22,713,ball pen,5,10,5,2,00087,India
579025,2023-04-22,711,TD kit,150,300,150,1,00087,India
579025,2023-04-22,716,printing paper,200,400,200,1,00087,India
492743,2023-04-22,705,stencil,10,20,10,2,00198,India
492743,2023-04-22,717,spiral bound book,50,100,50,1,00198,India
492743,2023-04-22,701,gel pen,5,10,5,2,00198,India
186992,2023-04-22,701,gel pen,5,10,5,2,00275,India
191455,2023-04-22,713,ball pen,5,10,5,2,00347,India
191455,2023-04-22,717,spiral bound book,50,100,50,1,00347,India
191455,2023-04-22,716,printing paper,200,400,200,1,00347,India
221921,2023-04-22,717,spiral bound book,50,100,50,1,00346,India
221921,2023-04-22,710,geometry box,100,150,50,2,00346,India
221921,2023-04-22,712,graph paper,20,40,20,1,00346,India
987866,2023-04-22,712,graph paper,20,40,20,1,00159,India
987866,2023-04-22,701,gel pen,5,10,5,2,00159,India
987866,2023-04-22,716,printing paper,200,400,200,1,00159,India
100388,2023-04-22,715,folder,5,15,10,1,00436,India
100388,2023-04-22,701,gel pen,5,10,5,2,00436,India
285229,2023-04-22,712,graph paper,20,40,20,1,00079,India
285229,2023-04-22,713,ball pen,5,10,5,2,00079,India
285229,2023-04-22,704,scale,5,10,5,2,00079,India
285229,2023-04-22,716,printing paper,200,400,200,1,00079,India
396034,2023-04-22,711,TD kit,150,300,150,1,00334,India
396034,2023-04-22,701,gel pen,5,10,5,2,00334,India
396034,2023-04-22,715,folder,5,15,10,1,00334,India
396034,2023-04-22,717,spiral bound book,50,100,50,1,00334,India
882612,2023-04-23,705,stencil,10,20,10,2,00387,India
882612,2023-04-23,714,carbon paper,15,30,15,1,00387,India
882612,2023-04-23,704,scale,5,10,5,2,00387,India
348713,2023-04-23,709,notebook,30,60,30,2,00270,India
348713,2023-04-23,716,printing paper,200,400,200,1,00270,India
348713,2023-04-23,708,sketchpen,15,40,25,1,00270,India
348713,2023-04-23,706,sharpener,3,8,5,2,00270,India
866492,2023-04-23,713,ball pen,5,10,5,2,00464,India
866492,2023-04-23,708,sketchpen,15,40,25,1,00464,India
866492,2023-04-23,701,gel pen,5,10,5,2,00464,India
866492,2023-04-23,717,spiral bound book,50,100,50,1,00464,India
866492,2023-04-23,703,eraser,1,3,2,2,00464,India
978275,2023-04-23,708,sketchpen,15,40,25,1,00299,India
978275,2023-04-23,715,folder,5,15,10,1,00299,India
329655,2023-04-23,701,gel pen,5,10,5,2,00238,India
329655,2023-04-23,714,carbon paper,15,30,15,1,00238,India
329655,2023-04-23,702,pencil,2,5,3,2,00238,India
329655,2023-04-23,711,TD kit,150,300,150,1,00238,India
540992,2023-04-23,706,sharpener,3,8,5,2,00253,India
540992,2023-04-23,710,geometry box,100,150,50,2,00253,India
540992,2023-04-23,709,notebook,30,60,30,2,00253,India
540992,2023-04-23,707,marker,20,40,20,1,00253,India
662132,2023-04-23,702,pencil,2,5,3,2,00004,India
662132,2023-04-23,715,folder,5,15,10,1,00004,India
662132,2023-04-23,714,carbon paper,15,30,15,1,00004,India
167932,2023-04-23,707,marker,20,40,20,1,00058,India
338523,2023-04-23,713,ball pen,5,10,5,2,00396,India
338523,2023-04-23,703,eraser,1,3,2,2,00396,India
338523,2023-04-23,716,printing paper,200,400,200,1,00396,India
338523,2023-04-23,708,sketchpen,15,40,25,1,00396,India
250956,2023-04-23,701,gel pen,5,10,5,2,00394,India
250956,2023-04-23,713,ball pen,5,10,5,2,00394,India
250956,2023-04-23,712,graph paper,20,40,20,1,00394,India
336141,2023-04-23,712,graph paper,20,40,20,1,00176,India
336141,2023-04-23,713,ball pen,5,10,5,2,00176,India
336141,2023-04-23,707,marker,20,40,20,1,00176,India
336141,2023-04-23,717,spiral bound book,50,100,50,1,00176,India
222161,2023-04-23,706,sharpener,3,8,5,2,00007,India
222161,2023-04-23,704,scale,5,10,5,2,00007,India
222161,2023-04-23,714,carbon paper,15,30,15,1,00007,India
944245,2023-04-23,716,printing paper,200,400,200,1,00127,India
944245,2023-04-23,713,ball pen,5,10,5,2,00127,India
680994,2023-04-23,712,graph paper,20,40,20,1,00095,India
369109,2023-04-23,702,pencil,2,5,3,2,00125,India
735264,2023-04-23,715,folder,5,15,10,1,00254,India
735264,2023-04-23,708,sketchpen,15,40,25,1,00254,India
735264,2023-04-23,703,eraser,1,3,2,2,00254,India
735264,2023-04-23,705,stencil,10,20,10,2,00254,India
735264,2023-04-23,707,marker,20,40,20,1,00254,India
307179,2023-04-23,701,gel pen,5,10,5,2,00319,India
298392,2023-04-23,717,spiral bound book,50,100,50,1,00425,India
943119,2023-04-23,715,folder,5,15,10,1,00082,India
943119,2023-04-23,709,notebook,30,60,30,2,00082,India
718724,2023-04-23,711,TD kit,150,300,150,1,00449,India
839173,2023-04-23,713,ball pen,5,10,5,2,00129,India
839173,2023-04-23,714,carbon paper,15,30,15,1,00129,India
839173,2023-04-23,703,eraser,1,3,2,2,00129,India
839173,2023-04-23,701,gel pen,5,10,5,2,00129,India
839173,2023-04-23,706,sharpener,3,8,5,2,00129,India
754430,2023-04-23,702,pencil,2,5,3,2,00104,India
754430,2023-04-23,710,geometry box,100,150,50,2,00104,India
754430,2023-04-23,712,graph paper,20,40,20,1,00104,India
754430,2023-04-23,711,TD kit,150,300,150,1,00104,India
754430,2023-04-23,706,sharpener,3,8,5,2,00104,India
331516,2023-04-23,712,graph paper,20,40,20,1,00196,India
183702,2023-04-23,716,printing paper,200,400,200,1,00446,India
183702,2023-04-23,715,folder,5,15,10,1,00446,India
183702,2023-04-23,706,sharpener,3,8,5,2,00446,India
330228,2023-04-23,703,eraser,1,3,2,2,00254,India
330228,2023-04-23,711,TD kit,150,300,150,1,00254,India
426772,2023-04-23,705,stencil,10,20,10,2,00082,India
396280,2023-04-23,715,folder,5,15,10,1,00229,India
396280,2023-04-23,707,marker,20,40,20,1,00229,India
396280,2023-04-23,701,gel pen,5,10,5,2,00229,India
396280,2023-04-23,708,sketchpen,15,40,25,1,00229,India
857430,2023-04-23,708,sketchpen,15,40,25,1,00167,India
857430,2023-04-23,702,pencil,2,5,3,2,00167,India
495484,2023-04-23,707,marker,20,40,20,1,00060,India
495484,2023-04-23,708,sketchpen,15,40,25,1,00060,India
495484,2023-04-23,714,carbon paper,15,30,15,1,00060,India
495484,2023-04-23,710,geometry box,100,150,50,2,00060,India
748920,2023-04-23,706,sharpener,3,8,5,2,00402,India
307673,2023-04-23,713,ball pen,5,10,5,2,00093,India
307673,2023-04-23,711,TD kit,150,300,150,1,00093,India
281797,2023-04-23,716,printing paper,200,400,200,1,00210,India
281797,2023-04-23,711,TD kit,150,300,150,1,00210,India
281797,2023-04-23,717,spiral bound book,50,100,50,1,00210,India
281797,2023-04-23,707,marker,20,40,20,1,00210,India
100506,2023-04-23,701,gel pen,5,10,5,2,00235,India
991643,2023-04-24,704,scale,5,10,5,2,00323,India
991643,2023-04-24,702,pencil,2,5,3,2,00323,India
132220,2023-04-24,701,gel pen,5,10,5,2,00221,India
132220,2023-04-24,717,spiral bound book,50,100,50,1,00221,India
132220,2023-04-24,710,geometry box,100,150,50,2,00221,India
132220,2023-04-24,711,TD kit,150,300,150,1,00221,India
532400,2023-04-24,707,marker,20,40,20,1,00376,India
532400,2023-04-24,708,sketchpen,15,40,25,1,00376,India
532400,2023-04-24,717,spiral bound book,50,100,50,1,00376,India
774877,2023-04-24,708,sketchpen,15,40,25,1,00183,India
774877,2023-04-24,716,printing paper,200,400,200,1,00183,India
386075,2023-04-24,703,eraser,1,3,2,2,00435,India
687180,2023-04-24,713,ball pen,5,10,5,2,00244,India
845923,2023-04-24,713,ball pen,5,10,5,2,00500,India
845923,2023-04-24,716,printing paper,200,400,200,1,00500,India
845923,2023-04-24,710,geometry box,100,150,50,2,00500,India
845923,2023-04-24,703,eraser,1,3,2,2,00500,India
383961,2023-04-24,705,stencil,10,20,10,2,00291,India
383961,2023-04-24,709,notebook,30,60,30,2,00291,India
383961,2023-04-24,710,geometry box,100,150,50,2,00291,India
383961,2023-04-24,708,sketchpen,15,40,25,1,00291,India
984419,2023-04-24,708,sketchpen,15,40,25,1,00043,India
984419,2023-04-24,703,eraser,1,3,2,2,00043,India
984419,2023-04-24,705,stencil,10,20,10,2,00043,India
984419,2023-04-24,715,folder,5,15,10,1,00043,India
724787,2023-04-24,712,graph paper,20,40,20,1,00485,India
724787,2023-04-24,713,ball pen,5,10,5,2,00485,India
967512,2023-04-24,712,graph paper,20,40,20,1,00107,India
311573,2023-04-24,712,graph paper,20,40,20,1,00212,India
585951,2023-04-24,711,TD kit,150,300,150,1,00416,India
585951,2023-04-24,701,gel pen,5,10,5,2,00416,India
585951,2023-04-24,716,printing paper,200,400,200,1,00416,India
134502,2023-04-24,714,carbon paper,15,30,15,1,00353,India
134502,2023-04-24,710,geometry box,100,150,50,2,00353,India
134502,2023-04-24,701,gel pen,5,10,5,2,00353,India
721861,2023-04-24,711,TD kit,150,300,150,1,00270,India
721861,2023-04-24,707,marker,20,40,20,1,00270,India
721861,2023-04-24,714,carbon paper,15,30,15,1,00270,India
721861,2023-04-24,703,eraser,1,3,2,2,00270,India
721861,2023-04-24,708,sketchpen,15,40,25,1,00270,India
630795,2023-04-24,717,spiral bound book,50,100,50,1,00336,India
630795,2023-04-24,710,geometry box,100,150,50,2,00336,India
630795,2023-04-24,708,sketchpen,15,40,25,1,00336,India
936304,2023-04-24,704,scale,5,10,5,2,00179,India
936304,2023-04-24,713,ball pen,5,10,5,2,00179,India
936304,2023-04-24,711,TD kit,150,300,150,1,00179,India
936304,2023-04-24,710,geometry box,100,150,50,2,00179,India
936304,2023-04-24,701,gel pen,5,10,5,2,00179,India
979578,2023-04-24,714,carbon paper,15,30,15,1,00244,India
979578,2023-04-24,702,pencil,2,5,3,2,00244,India
979578,2023-04-24,715,folder,5,15,10,1,00244,India
265160,2023-04-24,709,notebook,30,60,30,2,00247,India
265160,2023-04-24,704,scale,5,10,5,2,00247,India
265160,2023-04-24,713,ball pen,5,10,5,2,00247,India
265160,2023-04-24,701,gel pen,5,10,5,2,00247,India
161279,2023-04-24,707,marker,20,40,20,1,00095,India
161279,2023-04-24,715,folder,5,15,10,1,00095,India
161279,2023-04-24,703,eraser,1,3,2,2,00095,India
504285,2023-04-24,701,gel pen,5,10,5,2,00256,India
320598,2023-04-24,702,pencil,2,5,3,2,00268,India
320598,2023-04-24,709,notebook,30,60,30,2,00268,India
649243,2023-04-24,709,notebook,30,60,30,2,00389,India
649243,2023-04-24,708,sketchpen,15,40,25,1,00389,India
649243,2023-04-24,707,marker,20,40,20,1,00389,India
649243,2023-04-24,703,eraser,1,3,2,2,00389,India
649243,2023-04-24,701,gel pen,5,10,5,2,00389,India
218327,2023-04-24,705,stencil,10,20,10,2,00472,India
218327,2023-04-24,716,printing paper,200,400,200,1,00472,India
468376,2023-04-24,715,folder,5,15,10,1,00092,India
420103,2023-04-24,703,eraser,1,3,2,2,00335,India
420103,2023-04-24,717,spiral bound book,50,100,50,1,00335,India
420103,2023-04-24,707,marker,20,40,20,1,00335,India
420103,2023-04-24,702,pencil,2,5,3,2,00335,India
420103,2023-04-24,706,sharpener,3,8,5,2,00335,India
723145,2023-04-24,708,sketchpen,15,40,25,1,00041,India
723145,2023-04-24,709,notebook,30,60,30,2,00041,India
723145,2023-04-24,716,printing paper,200,400,200,1,00041,India
475788,2023-04-24,711,TD kit,150,300,150,1,00142,India
475788,2023-04-24,701,gel pen,5,10,5,2,00142,India
600396,2023-04-24,707,marker,20,40,20,1,00058,India
600396,2023-04-24,715,folder,5,15,10,1,00058,India
600396,2023-04-24,717,spiral bound book,50,100,50,1,00058,India
600396,2023-04-24,708,sketchpen,15,40,25,1,00058,India
600396,2023-04-24,713,ball pen,5,10,5,2,00058,India
669876,2023-04-24,704,scale,5,10,5,2,00287,India
669876,2023-04-24,706,sharpener,3,8,5,2,00287,India
859885,2023-04-24,715,folder,5,15,10,1,00129,India
859885,2023-04-24,701,gel pen,5,10,5,2,00129,India
797570,2023-04-24,713,ball pen,5,10,5,2,00116,India
797570,2023-04-24,710,geometry box,100,150,50,2,00116,India
797570,2023-04-24,711,TD kit,150,300,150,1,00116,India
797570,2023-04-24,704,scale,5,10,5,2,00116,India
987796,2023-04-24,713,ball pen,5,10,5,2,00331,India
987796,2023-04-24,715,folder,5,15,10,1,00331,India
987796,2023-04-24,706,sharpener,3,8,5,2,00331,India
987796,2023-04-24,704,scale,5,10,5,2,00331,India
987796,2023-04-24,705,stencil,10,20,10,2,00331,India
203508,2023-04-24,714,carbon paper,15,30,15,1,00002,India
531965,2023-04-24,710,geometry box,100,150,50,2,00093,India
531965,2023-04-24,709,notebook,30,60,30,2,00093,India
531965,2023-04-24,706,sharpener,3,8,5,2,00093,India
531965,2023-04-24,707,marker,20,40,20,1,00093,India
935004,2023-04-24,716,printing paper,200,400,200,1,00354,India
803525,2023-04-24,711,TD kit,150,300,150,1,00375,India
803525,2023-04-24,716,printing paper,200,400,200,1,00375,India
803525,2023-04-24,707,marker,20,40,20,1,00375,India
241027,2023-04-24,706,sharpener,3,8,5,2,00471,India
425243,2023-04-24,703,eraser,1,3,2,2,00151,India
425243,2023-04-24,702,pencil,2,5,3,2,00151,India
425243,2023-04-24,709,notebook,30,60,30,2,00151,India
959347,2023-04-24,717,spiral bound book,50,100,50,1,00031,India
874752,2023-04-24,710,geometry box,100,150,50,2,00317,India
874752,2023-04-24,701,gel pen,5,10,5,2,00317,India
874752,2023-04-24,702,pencil,2,5,3,2,00317,India
874752,2023-04-24,711,TD kit,150,300,150,1,00317,India
846720,2023-04-24,707,marker,20,40,20,1,00429,India
846720,2023-04-24,708,sketchpen,15,40,25,1,00429,India
846720,2023-04-24,704,scale,5,10,5,2,00429,India
846720,2023-04-24,713,ball pen,5,10,5,2,00429,India
944269,2023-04-24,702,pencil,2,5,3,2,00363,India
944269,2023-04-24,706,sharpener,3,8,5,2,00363,India
944269,2023-04-24,712,graph paper,20,40,20,1,00363,India
916047,2023-04-24,712,graph paper,20,40,20,1,00154,India
557003,2023-04-24,709,notebook,30,60,30,2,00280,India
557003,2023-04-24,713,ball pen,5,10,5,2,00280,India
557003,2023-04-24,702,pencil,2,5,3,2,00280,India
989535,2023-04-24,709,notebook,30,60,30,2,00242,India
989535,2023-04-24,716,printing paper,200,400,200,1,00242,India
989535,2023-04-24,708,sketchpen,15,40,25,1,00242,India
989535,2023-04-24,717,spiral bound book,50,100,50,1,00242,India
989535,2023-04-24,713,ball pen,5,10,5,2,00242,India
965462,2023-04-24,713,ball pen,5,10,5,2,00280,India
965462,2023-04-24,707,marker,20,40,20,1,00280,India
965462,2023-04-24,706,sharpener,3,8,5,2,00280,India
965462,2023-04-24,717,spiral bound book,50,100,50,1,00280,India
965462,2023-04-24,702,pencil,2,5,3,2,00280,India
190430,2023-04-25,714,carbon paper,15,30,15,1,00328,India
190430,2023-04-25,709,notebook,30,60,30,2,00328,India
190430,2023-04-25,704,scale,5,10,5,2,00328,India
190430,2023-04-25,701,gel pen,5,10,5,2,00328,India
249135,2023-04-25,704,scale,5,10,5,2,00149,India
249135,2023-04-25,701,gel pen,5,10,5,2,00149,India
249135,2023-04-25,714,carbon paper,15,30,15,1,00149,India
249135,2023-04-25,710,geometry box,100,150,50,2,00149,India
249135,2023-04-25,703,eraser,1,3,2,2,00149,India
553836,2023-04-25,706,sharpener,3,8,5,2,00176,India
553836,2023-04-25,710,geometry box,100,150,50,2,00176,India
553836,2023-04-25,702,pencil,2,5,3,2,00176,India
667579,2023-04-25,704,scale,5,10,5,2,00340,India
989526,2023-04-25,703,eraser,1,3,2,2,00408,India
989526,2023-04-25,709,notebook,30,60,30,2,00408,India
963010,2023-04-25,705,stencil,10,20,10,2,00141,India
963010,2023-04-25,704,scale,5,10,5,2,00141,India
313461,2023-04-25,705,stencil,10,20,10,2,00445,India
313461,2023-04-25,704,scale,5,10,5,2,00445,India
313461,2023-04-25,714,carbon paper,15,30,15,1,00445,India
318087,2023-04-25,706,sharpener,3,8,5,2,00361,India
248761,2023-04-25,703,eraser,1,3,2,2,00387,India
248761,2023-04-25,717,spiral bound book,50,100,50,1,00387,India
740172,2023-04-25,715,folder,5,15,10,1,00344,India
740172,2023-04-25,714,carbon paper,15,30,15,1,00344,India
740172,2023-04-25,716,printing paper,200,400,200,1,00344,India
740172,2023-04-25,708,sketchpen,15,40,25,1,00344,India
740172,2023-04-25,709,notebook,30,60,30,2,00344,India
879082,2023-04-25,709,notebook,30,60,30,2,00305,India
879082,2023-04-25,706,sharpener,3,8,5,2,00305,India
879082,2023-04-25,711,TD kit,150,300,150,1,00305,India
879082,2023-04-25,710,geometry box,100,150,50,2,00305,India
769643,2023-04-25,701,gel pen,5,10,5,2,00181,India
769643,2023-04-25,711,TD kit,150,300,150,1,00181,India
769643,2023-04-25,713,ball pen,5,10,5,2,00181,India
769643,2023-04-25,714,carbon paper,15,30,15,1,00181,India
207405,2023-04-25,716,printing paper,200,400,200,1,00393,India
207405,2023-04-25,710,geometry box,100,150,50,2,00393,India
207405,2023-04-25,715,folder,5,15,10,1,00393,India
207405,2023-04-25,714,carbon paper,15,30,15,1,00393,India
207405,2023-04-25,701,gel pen,5,10,5,2,00393,India
698784,2023-04-25,709,notebook,30,60,30,2,00121,India
698784,2023-04-25,716,printing paper,200,400,200,1,00121,India
698784,2023-04-25,713,ball pen,5,10,5,2,00121,India
843837,2023-04-25,706,sharpener,3,8,5,2,00377,India
843837,2023-04-25,716,printing paper,200,400,200,1,00377,India
843837,2023-04-25,707,marker,20,40,20,1,00377,India
355875,2023-04-25,706,sharpener,3,8,5,2,00084,India
355875,2023-04-25,711,TD kit,150,300,150,1,00084,India
669941,2023-04-25,711,TD kit,150,300,150,1,00392,India
239477,2023-04-25,705,stencil,10,20,10,2,00459,India
239477,2023-04-25,712,graph paper,20,40,20,1,00459,India
239477,2023-04-25,701,gel pen,5,10,5,2,00459,India
239477,2023-04-25,710,geometry box,100,150,50,2,00459,India
773206,2023-04-25,716,printing paper,200,400,200,1,00184,India
773206,2023-04-25,712,graph paper,20,40,20,1,00184,India
773206,2023-04-25,709,notebook,30,60,30,2,00184,India
773206,2023-04-25,707,marker,20,40,20,1,00184,India
889813,2023-04-25,702,pencil,2,5,3,2,00077,India
889813,2023-04-25,701,gel pen,5,10,5,2,00077,India
889813,2023-04-25,714,carbon paper,15,30,15,1,00077,India
889813,2023-04-25,705,stencil,10,20,10,2,00077,India
410460,2023-04-25,714,carbon paper,15,30,15,1,00349,India
410460,2023-04-25,712,graph paper,20,40,20,1,00349,India
655486,2023-04-25,713,ball pen,5,10,5,2,00472,India
655486,2023-04-25,706,sharpener,3,8,5,2,00472,India
655486,2023-04-25,717,spiral bound book,50,100,50,1,00472,India
655486,2023-04-25,715,folder,5,15,10,1,00472,India
701436,2023-04-25,713,ball pen,5,10,5,2,00319,India
701436,2023-04-25,705,stencil,10,20,10,2,00319,India
701436,2023-04-25,710,geometry box,100,150,50,2,00319,India
701436,2023-04-25,703,eraser,1,3,2,2,00319,India
701436,2023-04-25,714,carbon paper,15,30,15,1,00319,India
265392,2023-04-25,706,sharpener,3,8,5,2,00484,India
560093,2023-04-25,714,carbon paper,15,30,15,1,00169,India
560093,2023-04-25,713,ball pen,5,10,5,2,00169,India
817034,2023-04-25,705,stencil,10,20,10,2,00387,India
817034,2023-04-25,706,sharpener,3,8,5,2,00387,India
145555,2023-04-25,712,graph paper,20,40,20,1,00166,India
145555,2023-04-25,711,TD kit,150,300,150,1,00166,India
867342,2023-04-25,706,sharpener,3,8,5,2,00222,India
867342,2023-04-25,712,graph paper,20,40,20,1,00222,India
856967,2023-04-25,702,pencil,2,5,3,2,00330,India
856967,2023-04-25,701,gel pen,5,10,5,2,00330,India
856967,2023-04-25,712,graph paper,20,40,20,1,00330,India
856967,2023-04-25,717,spiral bound book,50,100,50,1,00330,India
856967,2023-04-25,708,sketchpen,15,40,25,1,00330,India
890839,2023-04-25,708,sketchpen,15,40,25,1,00159,India
890839,2023-04-25,713,ball pen,5,10,5,2,00159,India
890839,2023-04-25,711,TD kit,150,300,150,1,00159,India
890839,2023-04-25,717,spiral bound book,50,100,50,1,00159,India
890839,2023-04-25,710,geometry box,100,150,50,2,00159,India
296727,2023-04-25,709,notebook,30,60,30,2,00206,India
121500,2023-04-25,706,sharpener,3,8,5,2,00155,India
121500,2023-04-25,707,marker,20,40,20,1,00155,India
121500,2023-04-25,705,stencil,10,20,10,2,00155,India
232480,2023-04-25,712,graph paper,20,40,20,1,00038,India
232480,2023-04-25,714,carbon paper,15,30,15,1,00038,India
232480,2023-04-25,705,stencil,10,20,10,2,00038,India
842194,2023-04-25,712,graph paper,20,40,20,1,00372,India
842194,2023-04-25,717,spiral bound book,50,100,50,1,00372,India
959641,2023-04-25,717,spiral bound book,50,100,50,1,00373,India
951313,2023-04-25,712,graph paper,20,40,20,1,00054,India
965142,2023-04-25,715,folder,5,15,10,1,00204,India
965142,2023-04-25,710,geometry box,100,150,50,2,00204,India
965142,2023-04-25,703,eraser,1,3,2,2,00204,India
965142,2023-04-25,716,printing paper,200,400,200,1,00204,India
881065,2023-04-25,705,stencil,10,20,10,2,00168,India
340156,2023-04-25,709,notebook,30,60,30,2,00362,India
340156,2023-04-25,706,sharpener,3,8,5,2,00362,India
142563,2023-04-25,711,TD kit,150,300,150,1,00463,India
142563,2023-04-25,701,gel pen,5,10,5,2,00463,India
142563,2023-04-25,715,folder,5,15,10,1,00463,India
142563,2023-04-25,706,sharpener,3,8,5,2,00463,India
445119,2023-04-25,709,notebook,30,60,30,2,00277,India
445119,2023-04-25,711,TD kit,150,300,150,1,00277,India
445119,2023-04-25,702,pencil,2,5,3,2,00277,India
777425,2023-04-25,706,sharpener,3,8,5,2,00304,India
777425,2023-04-25,703,eraser,1,3,2,2,00304,India
777425,2023-04-25,717,spiral bound book,50,100,50,1,00304,India
777425,2023-04-25,708,sketchpen,15,40,25,1,00304,India
777425,2023-04-25,713,ball pen,5,10,5,2,00304,India
129380,2023-04-25,715,folder,5,15,10,1,00333,India
129380,2023-04-25,708,sketchpen,15,40,25,1,00333,India
129380,2023-04-25,710,geometry box,100,150,50,2,00333,India
750194,2023-04-25,703,eraser,1,3,2,2,00196,India
750194,2023-04-25,705,stencil,10,20,10,2,00196,India
809766,2023-04-25,716,printing paper,200,400,200,1,00127,India
809766,2023-04-25,703,eraser,1,3,2,2,00127,India
809766,2023-04-25,709,notebook,30,60,30,2,00127,India
809766,2023-04-25,713,ball pen,5,10,5,2,00127,India
809766,2023-04-25,710,geometry box,100,150,50,2,00127,India
268415,2023-04-25,716,printing paper,200,400,200,1,00158,India
268415,2023-04-25,712,graph paper,20,40,20,1,00158,India
248143,2023-04-25,715,folder,5,15,10,1,00448,India
248143,2023-04-25,702,pencil,2,5,3,2,00448,India
715344,2023-04-25,709,notebook,30,60,30,2,00408,India
715344,2023-04-25,702,pencil,2,5,3,2,00408,India
715344,2023-04-25,706,sharpener,3,8,5,2,00408,India
911885,2023-04-25,715,folder,5,15,10,1,00193,India
911885,2023-04-25,702,pencil,2,5,3,2,00193,India
241961,2023-04-26,713,ball pen,5,10,5,2,00262,India
241961,2023-04-26,714,carbon paper,15,30,15,1,00262,India
241961,2023-04-26,712,graph paper,20,40,20,1,00262,India
880376,2023-04-26,706,sharpener,3,8,5,2,00021,India
880376,2023-04-26,703,eraser,1,3,2,2,00021,India
880376,2023-04-26,701,gel pen,5,10,5,2,00021,India
880376,2023-04-26,702,pencil,2,5,3,2,00021,India
176893,2023-04-26,714,carbon paper,15,30,15,1,00110,India
176893,2023-04-26,706,sharpener,3,8,5,2,00110,India
176893,2023-04-26,703,eraser,1,3,2,2,00110,India
103549,2023-04-26,706,sharpener,3,8,5,2,00388,India
103549,2023-04-26,710,geometry box,100,150,50,2,00388,India
103549,2023-04-26,705,stencil,10,20,10,2,00388,India
103549,2023-04-26,707,marker,20,40,20,1,00388,India
103549,2023-04-26,709,notebook,30,60,30,2,00388,India
997743,2023-04-26,705,stencil,10,20,10,2,00023,India
997743,2023-04-26,714,carbon paper,15,30,15,1,00023,India
997743,2023-04-26,708,sketchpen,15,40,25,1,00023,India
997743,2023-04-26,712,graph paper,20,40,20,1,00023,India
454988,2023-04-26,704,scale,5,10,5,2,00139,India
454988,2023-04-26,715,folder,5,15,10,1,00139,India
454988,2023-04-26,710,geometry box,100,150,50,2,00139,India
454988,2023-04-26,702,pencil,2,5,3,2,00139,India
424427,2023-04-26,709,notebook,30,60,30,2,00054,India
424427,2023-04-26,707,marker,20,40,20,1,00054,India
424427,2023-04-26,710,geometry box,100,150,50,2,00054,India
976659,2023-04-26,701,gel pen,5,10,5,2,00378,India
976659,2023-04-26,711,TD kit,150,300,150,1,00378,India
631625,2023-04-26,709,notebook,30,60,30,2,00378,India
631625,2023-04-26,703,eraser,1,3,2,2,00378,India
631625,2023-04-26,714,carbon paper,15,30,15,1,00378,India
631625,2023-04-26,710,geometry box,100,150,50,2,00378,India
975301,2023-04-26,709,notebook,30,60,30,2,00123,India
975301,2023-04-26,706,sharpener,3,8,5,2,00123,India
194800,2023-04-26,701,gel pen,5,10,5,2,00247,India
908174,2023-04-26,703,eraser,1,3,2,2,00230,India
908174,2023-04-26,717,spiral bound book,50,100,50,1,00230,India
908174,2023-04-26,713,ball pen,5,10,5,2,00230,India
908174,2023-04-26,710,geometry box,100,150,50,2,00230,India
908174,2023-04-26,705,stencil,10,20,10,2,00230,India
935248,2023-04-26,707,marker,20,40,20,1,00345,India
162363,2023-04-26,710,geometry box,100,150,50,2,00360,India
162363,2023-04-26,715,folder,5,15,10,1,00360,India
926745,2023-04-26,702,pencil,2,5,3,2,00496,India
926745,2023-04-26,701,gel pen,5,10,5,2,00496,India
419034,2023-04-26,714,carbon paper,15,30,15,1,00093,India
731989,2023-04-26,707,marker,20,40,20,1,00440,India
731989,2023-04-26,711,TD kit,150,300,150,1,00440,India
731989,2023-04-26,715,folder,5,15,10,1,00440,India
731989,2023-04-26,716,printing paper,200,400,200,1,00440,India
469645,2023-04-26,715,folder,5,15,10,1,00085,India
469645,2023-04-26,704,scale,5,10,5,2,00085,India
469645,2023-04-26,706,sharpener,3,8,5,2,00085,India
469645,2023-04-26,717,spiral bound book,50,100,50,1,00085,India
469645,2023-04-26,714,carbon paper,15,30,15,1,00085,India
505177,2023-04-26,707,marker,20,40,20,1,00409,India
615949,2023-04-26,713,ball pen,5,10,5,2,00477,India
615949,2023-04-26,704,scale,5,10,5,2,00477,India
615949,2023-04-26,717,spiral bound book,50,100,50,1,00477,India
161352,2023-04-26,716,printing paper,200,400,200,1,00302,India
161352,2023-04-26,704,scale,5,10,5,2,00302,India
161352,2023-04-26,705,stencil,10,20,10,2,00302,India
813693,2023-04-26,714,carbon paper,15,30,15,1,00033,India
813693,2023-04-26,702,pencil,2,5,3,2,00033,India
813693,2023-04-26,705,stencil,10,20,10,2,00033,India
813693,2023-04-26,709,notebook,30,60,30,2,00033,India
813693,2023-04-26,710,geometry box,100,150,50,2,00033,India
481773,2023-04-26,717,spiral bound book,50,100,50,1,00333,India
905016,2023-04-26,713,ball pen,5,10,5,2,00284,India
905016,2023-04-26,711,TD kit,150,300,150,1,00284,India
905016,2023-04-26,715,folder,5,15,10,1,00284,India
414728,2023-04-26,713,ball pen,5,10,5,2,00410,India
193373,2023-04-26,712,graph paper,20,40,20,1,00500,India
193373,2023-04-26,715,folder,5,15,10,1,00500,India
193373,2023-04-26,703,eraser,1,3,2,2,00500,India
185725,2023-04-26,711,TD kit,150,300,150,1,00094,India
185725,2023-04-26,706,sharpener,3,8,5,2,00094,India
123414,2023-04-26,712,graph paper,20,40,20,1,00101,India
123414,2023-04-26,705,stencil,10,20,10,2,00101,India
123414,2023-04-26,708,sketchpen,15,40,25,1,00101,India
213860,2023-04-26,706,sharpener,3,8,5,2,00315,India
213860,2023-04-26,712,graph paper,20,40,20,1,00315,India
213860,2023-04-26,714,carbon paper,15,30,15,1,00315,India
942413,2023-04-26,701,gel pen,5,10,5,2,00354,India
942413,2023-04-26,713,ball pen,5,10,5,2,00354,India
942413,2023-04-26,702,pencil,2,5,3,2,00354,India
942413,2023-04-26,712,graph paper,20,40,20,1,00354,India
942413,2023-04-26,715,folder,5,15,10,1,00354,India
673103,2023-04-26,713,ball pen,5,10,5,2,00458,India
673103,2023-04-26,707,marker,20,40,20,1,00458,India
673103,2023-04-26,716,printing paper,200,400,200,1,00458,India
169810,2023-04-26,704,scale,5,10,5,2,00422,India
169810,2023-04-26,703,eraser,1,3,2,2,00422,India
169810,2023-04-26,707,marker,20,40,20,1,00422,India
605313,2023-04-27,709,notebook,30,60,30,2,00069,India
605313,2023-04-27,701,gel pen,5,10,5,2,00069,India
854858,2023-04-27,713,ball pen,5,10,5,2,00136,India
854858,2023-04-27,705,stencil,10,20,10,2,00136,India
257561,2023-04-27,710,geometry box,100,150,50,2,00144,India
263120,2023-04-27,703,eraser,1,3,2,2,00137,India
263120,2023-04-27,707,marker,20,40,20,1,00137,India
263120,2023-04-27,706,sharpener,3,8,5,2,00137,India
734480,2023-04-27,710,geometry box,100,150,50,2,00478,India
734480,2023-04-27,705,stencil,10,20,10,2,00478,India
734480,2023-04-27,716,printing paper,200,400,200,1,00478,India
952442,2023-04-27,710,geometry box,100,150,50,2,00343,India
952442,2023-04-27,714,carbon paper,15,30,15,1,00343,India
465682,2023-04-27,703,eraser,1,3,2,2,00286,India
465682,2023-04-27,702,pencil,2,5,3,2,00286,India
465682,2023-04-27,711,TD kit,150,300,150,1,00286,India
465682,2023-04-27,707,marker,20,40,20,1,00286,India
465682,2023-04-27,701,gel pen,5,10,5,2,00286,India
652435,2023-04-27,711,TD kit,150,300,150,1,00467,India
652435,2023-04-27,707,marker,20,40,20,1,00467,India
652435,2023-04-27,704,scale,5,10,5,2,00467,India
652435,2023-04-27,702,pencil,2,5,3,2,00467,India
198320,2023-04-27,716,printing paper,200,400,200,1,00264,India
198320,2023-04-27,712,graph paper,20,40,20,1,00264,India
198320,2023-04-27,710,geometry box,100,150,50,2,00264,India
666608,2023-04-27,711,TD kit,150,300,150,1,00250,India
666608,2023-04-27,705,stencil,10,20,10,2,00250,India
666608,2023-04-27,710,geometry box,100,150,50,2,00250,India
167129,2023-04-27,711,TD kit,150,300,150,1,00316,India
167129,2023-04-27,709,notebook,30,60,30,2,00316,India
167129,2023-04-27,712,graph paper,20,40,20,1,00316,India
167129,2023-04-27,710,geometry box,100,150,50,2,00316,India
167129,2023-04-27,706,sharpener,3,8,5,2,00316,India
133098,2023-04-27,716,printing paper,200,400,200,1,00345,India
133098,2023-04-27,717,spiral bound book,50,100,50,1,00345,India
133098,2023-04-27,706,sharpener,3,8,5,2,00345,India
133098,2023-04-27,705,stencil,10,20,10,2,00345,India
701082,2023-04-27,709,notebook,30,60,30,2,00041,India
701082,2023-04-27,705,stencil,10,20,10,2,00041,India
452182,2023-04-27,716,printing paper,200,400,200,1,00409,India
452182,2023-04-27,715,folder,5,15,10,1,00409,India
452182,2023-04-27,710,geometry box,100,150,50,2,00409,India
326944,2023-04-27,709,notebook,30,60,30,2,00260,India
326944,2023-04-27,706,sharpener,3,8,5,2,00260,India
326944,2023-04-27,705,stencil,10,20,10,2,00260,India
443545,2023-04-27,707,marker,20,40,20,1,00137,India
443545,2023-04-27,709,notebook,30,60,30,2,00137,India
443545,2023-04-27,704,scale,5,10,5,2,00137,India
605243,2023-04-27,705,stencil,10,20,10,2,00205,India
605243,2023-04-27,710,geometry box,100,150,50,2,00205,India
605243,2023-04-27,704,scale,5,10,5,2,00205,India
866314,2023-04-27,711,TD kit,150,300,150,1,00140,India
788450,2023-04-27,703,eraser,1,3,2,2,00213,India
788450,2023-04-27,708,sketchpen,15,40,25,1,00213,India
788450,2023-04-27,714,carbon paper,15,30,15,1,00213,India
788450,2023-04-27,716,printing paper,200,400,200,1,00213,India
788450,2023-04-27,704,scale,5,10,5,2,00213,India
369698,2023-04-27,717,spiral bound book,50,100,50,1,00484,India
369698,2023-04-27,702,pencil,2,5,3,2,00484,India
959948,2023-04-27,706,sharpener,3,8,5,2,00367,India
959948,2023-04-27,712,graph paper,20,40,20,1,00367,India
959948,2023-04-27,709,notebook,30,60,30,2,00367,India
520322,2023-04-27,714,carbon paper,15,30,15,1,00128,India
520322,2023-04-27,701,gel pen,5,10,5,2,00128,India
542012,2023-04-27,716,printing paper,200,400,200,1,00251,India
542012,2023-04-27,712,graph paper,20,40,20,1,00251,India
542012,2023-04-27,703,eraser,1,3,2,2,00251,India
542012,2023-04-27,714,carbon paper,15,30,15,1,00251,India
525588,2023-04-27,701,gel pen,5,10,5,2,00187,India
525588,2023-04-27,716,printing paper,200,400,200,1,00187,India
197895,2023-04-27,711,TD kit,150,300,150,1,00376,India
197895,2023-04-27,702,pencil,2,5,3,2,00376,India
197895,2023-04-27,713,ball pen,5,10,5,2,00376,India
562205,2023-04-27,703,eraser,1,3,2,2,00458,India
562205,2023-04-27,714,carbon paper,15,30,15,1,00458,India
562205,2023-04-27,707,marker,20,40,20,1,00458,India
474481,2023-04-27,711,TD kit,150,300,150,1,00244,India
474481,2023-04-27,703,eraser,1,3,2,2,00244,India
474481,2023-04-27,710,geometry box,100,150,50,2,00244,India
346777,2023-04-27,717,spiral bound book,50,100,50,1,00407,India
346777,2023-04-27,707,marker,20,40,20,1,00407,India
514570,2023-04-27,713,ball pen,5,10,5,2,00310,India
514570,2023-04-27,707,marker,20,40,20,1,00310,India
514570,2023-04-27,705,stencil,10,20,10,2,00310,India
514570,2023-04-27,706,sharpener,3,8,5,2,00310,India
772486,2023-04-27,707,marker,20,40,20,1,00150,India
971969,2023-04-27,702,pencil,2,5,3,2,00046,India
309236,2023-04-27,717,spiral bound book,50,100,50,1,00048,India
309236,2023-04-27,702,pencil,2,5,3,2,00048,India
391660,2023-04-28,711,TD kit,150,300,150,1,00071,India
391660,2023-04-28,714,carbon paper,15,30,15,1,00071,India
391660,2023-04-28,717,spiral bound book,50,100,50,1,00071,India
469116,2023-04-28,705,stencil,10,20,10,2,00381,India
469116,2023-04-28,707,marker,20,40,20,1,00381,India
469116,2023-04-28,712,graph paper,20,40,20,1,00381,India
768253,2023-04-28,704,scale,5,10,5,2,00325,India
768253,2023-04-28,701,gel pen,5,10,5,2,00325,India
515980,2023-04-28,702,pencil,2,5,3,2,00235,India
515980,2023-04-28,705,stencil,10,20,10,2,00235,India
515980,2023-04-28,701,gel pen,5,10,5,2,00235,India
165801,2023-04-28,703,eraser,1,3,2,2,00239,India
165801,2023-04-28,708,sketchpen,15,40,25,1,00239,India
165801,2023-04-28,714,carbon paper,15,30,15,1,00239,India
165801,2023-04-28,707,marker,20,40,20,1,00239,India
324428,2023-04-28,711,TD kit,150,300,150,1,00246,India
736752,2023-04-28,716,printing paper,200,400,200,1,00013,India
736752,2023-04-28,711,TD kit,150,300,150,1,00013,India
736752,2023-04-28,714,carbon paper,15,30,15,1,00013,India
736752,2023-04-28,715,folder,5,15,10,1,00013,India
736752,2023-04-28,706,sharpener,3,8,5,2,00013,India
767210,2023-04-28,710,geometry box,100,150,50,2,00140,India
843683,2023-04-28,704,scale,5,10,5,2,00348,India
843683,2023-04-28,712,graph paper,20,40,20,1,00348,India
366828,2023-04-28,702,pencil,2,5,3,2,00075,India
366828,2023-04-28,709,notebook,30,60,30,2,00075,India
366828,2023-04-28,706,sharpener,3,8,5,2,00075,India
366828,2023-04-28,704,scale,5,10,5,2,00075,India
819965,2023-04-28,707,marker,20,40,20,1,00205,India
819965,2023-04-28,714,carbon paper,15,30,15,1,00205,India
819965,2023-04-28,705,stencil,10,20,10,2,00205,India
226695,2023-04-28,712,graph paper,20,40,20,1,00256,India
811944,2023-04-28,717,spiral bound book,50,100,50,1,00249,India
811944,2023-04-28,701,gel pen,5,10,5,2,00249,India
811944,2023-04-28,706,sharpener,3,8,5,2,00249,India
811944,2023-04-28,716,printing paper,200,400,200,1,00249,India
810371,2023-04-28,702,pencil,2,5,3,2,00273,India
810371,2023-04-28,716,printing paper,200,400,200,1,00273,India
810371,2023-04-28,703,eraser,1,3,2,2,00273,India
810371,2023-04-28,710,geometry box,100,150,50,2,00273,India
441988,2023-04-28,711,TD kit,150,300,150,1,00170,India
230467,2023-04-28,713,ball pen,5,10,5,2,00018,India
230467,2023-04-28,712,graph paper,20,40,20,1,00018,India
230467,2023-04-28,714,carbon paper,15,30,15,1,00018,India
369984,2023-04-28,705,stencil,10,20,10,2,00178,India
555603,2023-04-28,706,sharpener,3,8,5,2,00043,India
555603,2023-04-28,709,notebook,30,60,30,2,00043,India
555603,2023-04-28,710,geometry box,100,150,50,2,00043,India
180533,2023-04-28,713,ball pen,5,10,5,2,00043,India
766095,2023-04-28,713,ball pen,5,10,5,2,00241,India
766095,2023-04-28,707,marker,20,40,20,1,00241,India
766095,2023-04-28,714,carbon paper,15,30,15,1,00241,India
766095,2023-04-28,708,sketchpen,15,40,25,1,00241,India
766095,2023-04-28,702,pencil,2,5,3,2,00241,India
463417,2023-04-28,703,eraser,1,3,2,2,00293,India
162404,2023-04-28,712,graph paper,20,40,20,1,00136,India
162404,2023-04-28,715,folder,5,15,10,1,00136,India
162404,2023-04-28,709,notebook,30,60,30,2,00136,India
286749,2023-04-28,711,TD kit,150,300,150,1,00262,India
286749,2023-04-28,713,ball pen,5,10,5,2,00262,India
286749,2023-04-28,702,pencil,2,5,3,2,00262,India
828665,2023-04-28,701,gel pen,5,10,5,2,00035,India
828665,2023-04-28,705,stencil,10,20,10,2,00035,India
828665,2023-04-28,713,ball pen,5,10,5,2,00035,India
994454,2023-04-28,715,folder,5,15,10,1,00296,India
162488,2023-04-28,704,scale,5,10,5,2,00456,India
746303,2023-04-28,706,sharpener,3,8,5,2,00085,India
828229,2023-04-28,713,ball pen,5,10,5,2,00442,India
717151,2023-04-28,711,TD kit,150,300,150,1,00466,India
717151,2023-04-28,703,eraser,1,3,2,2,00466,India
717151,2023-04-28,709,notebook,30,60,30,2,00466,India
697588,2023-04-28,707,marker,20,40,20,1,00191,India
697588,2023-04-28,716,printing paper,200,400,200,1,00191,India
390689,2023-04-28,716,printing paper,200,400,200,1,00178,India
390689,2023-04-28,701,gel pen,5,10,5,2,00178,India
335529,2023-04-28,714,carbon paper,15,30,15,1,00427,India
335529,2023-04-28,716,printing paper,200,400,200,1,00427,India
335529,2023-04-28,704,scale,5,10,5,2,00427,India
335529,2023-04-28,703,eraser,1,3,2,2,00427,India
335529,2023-04-28,713,ball pen,5,10,5,2,00427,India
361319,2023-04-28,712,graph paper,20,40,20,1,00187,India
361319,2023-04-28,704,scale,5,10,5,2,00187,India
361319,2023-04-28,713,ball pen,5,10,5,2,00187,India
957669,2023-04-29,715,folder,5,15,10,1,00472,India
957669,2023-04-29,701,gel pen,5,10,5,2,00472,India
957669,2023-04-29,703,eraser,1,3,2,2,00472,India
957669,2023-04-29,709,notebook,30,60,30,2,00472,India
907087,2023-04-29,715,folder,5,15,10,1,00402,India
907087,2023-04-29,708,sketchpen,15,40,25,1,00402,India
907087,2023-04-29,710,geometry box,100,150,50,2,00402,India
907087,2023-04-29,701,gel pen,5,10,5,2,00402,India
427110,2023-04-29,702,pencil,2,5,3,2,00311,India
427110,2023-04-29,705,stencil,10,20,10,2,00311,India
427110,2023-04-29,707,marker,20,40,20,1,00311,India
427110,2023-04-29,712,graph paper,20,40,20,1,00311,India
427110,2023-04-29,706,sharpener,3,8,5,2,00311,India
595298,2023-04-29,717,spiral bound book,50,100,50,1,00305,India
620974,2023-04-29,716,printing paper,200,400,200,1,00202,India
620974,2023-04-29,711,TD kit,150,300,150,1,00202,India
675043,2023-04-29,717,spiral bound book,50,100,50,1,00128,India
675043,2023-04-29,705,stencil,10,20,10,2,00128,India
675043,2023-04-29,715,folder,5,15,10,1,00128,India
117442,2023-04-29,710,geometry box,100,150,50,2,00414,India
117442,2023-04-29,711,TD kit,150,300,150,1,00414,India
117442,2023-04-29,709,notebook,30,60,30,2,00414,India
117442,2023-04-29,716,printing paper,200,400,200,1,00414,India
117442,2023-04-29,705,stencil,10,20,10,2,00414,India
854218,2023-04-29,703,eraser,1,3,2,2,00329,India
854218,2023-04-29,712,graph paper,20,40,20,1,00329,India
854218,2023-04-29,702,pencil,2,5,3,2,00329,India
740851,2023-04-29,710,geometry box,100,150,50,2,00331,India
740851,2023-04-29,705,stencil,10,20,10,2,00331,India
740851,2023-04-29,707,marker,20,40,20,1,00331,India
822569,2023-04-29,708,sketchpen,15,40,25,1,00299,India
160810,2023-04-29,713,ball pen,5,10,5,2,00493,India
160810,2023-04-29,712,graph paper,20,40,20,1,00493,India
160810,2023-04-29,710,geometry box,100,150,50,2,00493,India
522099,2023-04-29,708,sketchpen,15,40,25,1,00141,India
918122,2023-04-29,714,carbon paper,15,30,15,1,00372,India
918122,2023-04-29,710,geometry box,100,150,50,2,00372,India
918122,2023-04-29,704,scale,5,10,5,2,00372,India
918122,2023-04-29,712,graph paper,20,40,20,1,00372,India
908718,2023-04-29,710,geometry box,100,150,50,2,00022,India
908718,2023-04-29,701,gel pen,5,10,5,2,00022,India
840587,2023-04-29,711,TD kit,150,300,150,1,00241,India
840587,2023-04-29,708,sketchpen,15,40,25,1,00241,India
840587,2023-04-29,705,stencil,10,20,10,2,00241,India
145865,2023-04-29,703,eraser,1,3,2,2,00043,India
145865,2023-04-29,714,carbon paper,15,30,15,1,00043,India
145865,2023-04-29,706,sharpener,3,8,5,2,00043,India
849535,2023-04-29,711,TD kit,150,300,150,1,00421,India
849535,2023-04-29,702,pencil,2,5,3,2,00421,India
466625,2023-04-29,715,folder,5,15,10,1,00150,India
671948,2023-04-29,714,carbon paper,15,30,15,1,00106,India
671948,2023-04-29,713,ball pen,5,10,5,2,00106,India
902437,2023-04-29,714,carbon paper,15,30,15,1,00075,India
902437,2023-04-29,712,graph paper,20,40,20,1,00075,India
902437,2023-04-29,709,notebook,30,60,30,2,00075,India
920776,2023-04-29,707,marker,20,40,20,1,00160,India
920776,2023-04-29,701,gel pen,5,10,5,2,00160,India
870841,2023-04-29,716,printing paper,200,400,200,1,00471,India
870841,2023-04-29,704,scale,5,10,5,2,00471,India
870841,2023-04-29,713,ball pen,5,10,5,2,00471,India
870841,2023-04-29,710,geometry box,100,150,50,2,00471,India
680944,2023-04-29,711,TD kit,150,300,150,1,00293,India
680944,2023-04-29,710,geometry box,100,150,50,2,00293,India
827773,2023-04-29,707,marker,20,40,20,1,00278,India
827773,2023-04-29,713,ball pen,5,10,5,2,00278,India
827773,2023-04-29,703,eraser,1,3,2,2,00278,India
870114,2023-04-29,714,carbon paper,15,30,15,1,00353,India
870114,2023-04-29,704,scale,5,10,5,2,00353,India
972869,2023-04-29,702,pencil,2,5,3,2,00353,India
972869,2023-04-29,704,scale,5,10,5,2,00353,India
972869,2023-04-29,705,stencil,10,20,10,2,00353,India
972869,2023-04-29,709,notebook,30,60,30,2,00353,India
972869,2023-04-29,717,spiral bound book,50,100,50,1,00353,India
343310,2023-04-29,703,eraser,1,3,2,2,00461,India
343310,2023-04-29,714,carbon paper,15,30,15,1,00461,India
343310,2023-04-29,713,ball pen,5,10,5,2,00461,India
157499,2023-04-29,704,scale,5,10,5,2,00209,India
157499,2023-04-29,711,TD kit,150,300,150,1,00209,India
157499,2023-04-29,706,sharpener,3,8,5,2,00209,India
708093,2023-04-29,715,folder,5,15,10,1,00273,India
708093,2023-04-29,705,stencil,10,20,10,2,00273,India
494090,2023-04-29,701,gel pen,5,10,5,2,00500,India
494090,2023-04-29,702,pencil,2,5,3,2,00500,India
494090,2023-04-29,717,spiral bound book,50,100,50,1,00500,India
494090,2023-04-29,708,sketchpen,15,40,25,1,00500,India
607199,2023-04-29,714,carbon paper,15,30,15,1,00338,India
607199,2023-04-29,711,TD kit,150,300,150,1,00338,India
607199,2023-04-29,701,gel pen,5,10,5,2,00338,India
555199,2023-04-29,715,folder,5,15,10,1,00340,India
555199,2023-04-29,708,sketchpen,15,40,25,1,00340,India
948429,2023-04-29,710,geometry box,100,150,50,2,00093,India
515975,2023-04-29,711,TD kit,150,300,150,1,00064,India
664158,2023-04-29,716,printing paper,200,400,200,1,00151,India
664158,2023-04-29,705,stencil,10,20,10,2,00151,India
664158,2023-04-29,713,ball pen,5,10,5,2,00151,India
664158,2023-04-29,702,pencil,2,5,3,2,00151,India
478931,2023-04-29,706,sharpener,3,8,5,2,00067,India
401539,2023-04-29,710,geometry box,100,150,50,2,00131,India
401539,2023-04-29,716,printing paper,200,400,200,1,00131,India
401539,2023-04-29,712,graph paper,20,40,20,1,00131,India
401539,2023-04-29,707,marker,20,40,20,1,00131,India
510258,2023-04-29,717,spiral bound book,50,100,50,1,00428,India
263305,2023-04-29,715,folder,5,15,10,1,00283,India
578862,2023-04-29,715,folder,5,15,10,1,00292,India
578862,2023-04-29,705,stencil,10,20,10,2,00292,India
578862,2023-04-29,706,sharpener,3,8,5,2,00292,India
578862,2023-04-29,703,eraser,1,3,2,2,00292,India
759419,2023-04-29,713,ball pen,5,10,5,2,00102,India
759419,2023-04-29,716,printing paper,200,400,200,1,00102,India
943209,2023-04-29,704,scale,5,10,5,2,00086,India
943209,2023-04-29,717,spiral bound book,50,100,50,1,00086,India
638720,2023-04-29,715,folder,5,15,10,1,00361,India
827392,2023-04-29,704,scale,5,10,5,2,00223,India
827392,2023-04-29,710,geometry box,100,150,50,2,00223,India
211725,2023-04-29,704,scale,5,10,5,2,00318,India
211725,2023-04-29,707,marker,20,40,20,1,00318,India
211725,2023-04-29,702,pencil,2,5,3,2,00318,India
275279,2023-04-29,704,scale,5,10,5,2,00273,India
320517,2023-04-29,701,gel pen,5,10,5,2,00188,India
320517,2023-04-29,704,scale,5,10,5,2,00188,India
320517,2023-04-29,709,notebook,30,60,30,2,00188,India
526654,2023-04-29,713,ball pen,5,10,5,2,00290,India
608232,2023-04-29,715,folder,5,15,10,1,00128,India
608232,2023-04-29,702,pencil,2,5,3,2,00128,India
176741,2023-04-30,707,marker,20,40,20,1,00425,India
176741,2023-04-30,704,scale,5,10,5,2,00425,India
262985,2023-04-30,713,ball pen,5,10,5,2,00256,India
262985,2023-04-30,708,sketchpen,15,40,25,1,00256,India
262985,2023-04-30,712,graph paper,20,40,20,1,00256,India
707701,2023-04-30,710,geometry box,100,150,50,2,00357,India
552685,2023-04-30,702,pencil,2,5,3,2,00102,India
552685,2023-04-30,711,TD kit,150,300,150,1,00102,India
552685,2023-04-30,716,printing paper,200,400,200,1,00102,India
552685,2023-04-30,713,ball pen,5,10,5,2,00102,India
396924,2023-04-30,706,sharpener,3,8,5,2,00070,India
396924,2023-04-30,709,notebook,30,60,30,2,00070,India
396924,2023-04-30,713,ball pen,5,10,5,2,00070,India
396924,2023-04-30,715,folder,5,15,10,1,00070,India
192014,2023-04-30,705,stencil,10,20,10,2,00307,India
192014,2023-04-30,701,gel pen,5,10,5,2,00307,India
192014,2023-04-30,703,eraser,1,3,2,2,00307,India
192014,2023-04-30,714,carbon paper,15,30,15,1,00307,India
578230,2023-04-30,706,sharpener,3,8,5,2,00097,India
578230,2023-04-30,707,marker,20,40,20,1,00097,India
578230,2023-04-30,708,sketchpen,15,40,25,1,00097,India
890547,2023-04-30,713,ball pen,5,10,5,2,00314,India
890547,2023-04-30,703,eraser,1,3,2,2,00314,India
890547,2023-04-30,701,gel pen,5,10,5,2,00314,India
671348,2023-04-30,713,ball pen,5,10,5,2,00211,India
671348,2023-04-30,702,pencil,2,5,3,2,00211,India
227793,2023-04-30,716,printing paper,200,400,200,1,00006,India
227793,2023-04-30,703,eraser,1,3,2,2,00006,India
227793,2023-04-30,709,notebook,30,60,30,2,00006,India
227793,2023-04-30,717,spiral bound book,50,100,50,1,00006,India
227793,2023-04-30,705,stencil,10,20,10,2,00006,India
373955,2023-04-30,717,spiral bound book,50,100,50,1,00387,India
373955,2023-04-30,704,scale,5,10,5,2,00387,India
373955,2023-04-30,716,printing paper,200,400,200,1,00387,India
373955,2023-04-30,703,eraser,1,3,2,2,00387,India
745000,2023-04-30,716,printing paper,200,400,200,1,00466,India
745000,2023-04-30,702,pencil,2,5,3,2,00466,India
688810,2023-04-30,704,scale,5,10,5,2,00121,India
688810,2023-04-30,708,sketchpen,15,40,25,1,00121,India
812754,2023-04-30,710,geometry box,100,150,50,2,00314,India
812754,2023-04-30,714,carbon paper,15,30,15,1,00314,India
812754,2023-04-30,707,marker,20,40,20,1,00314,India
812754,2023-04-30,705,stencil,10,20,10,2,00314,India
794859,2023-04-30,705,stencil,10,20,10,2,00444,India
210688,2023-04-30,715,folder,5,15,10,1,00432,India
582634,2023-04-30,714,carbon paper,15,30,15,1,00376,India
582634,2023-04-30,713,ball pen,5,10,5,2,00376,India
582634,2023-04-30,707,marker,20,40,20,1,00376,India
341180,2023-04-30,711,TD kit,150,300,150,1,00013,India
341180,2023-04-30,701,gel pen,5,10,5,2,00013,India
341180,2023-04-30,703,eraser,1,3,2,2,00013,India
341180,2023-04-30,714,carbon paper,15,30,15,1,00013,India
276786,2023-04-30,715,folder,5,15,10,1,00457,India
276786,2023-04-30,709,notebook,30,60,30,2,00457,India
276786,2023-04-30,711,TD kit,150,300,150,1,00457,India
340143,2023-04-30,706,sharpener,3,8,5,2,00038,India
340143,2023-04-30,716,printing paper,200,400,200,1,00038,India
562235,2023-04-30,701,gel pen,5,10,5,2,00334,India
562235,2023-04-30,714,carbon paper,15,30,15,1,00334,India
764630,2023-04-30,709,notebook,30,60,30,2,00128,India
153577,2023-04-30,706,sharpener,3,8,5,2,00432,India
646937,2023-04-30,711,TD kit,150,300,150,1,00347,India
182514,2023-04-30,705,stencil,10,20,10,2,00301,India
182514,2023-04-30,709,notebook,30,60,30,2,00301,India
182514,2023-04-30,715,folder,5,15,10,1,00301,India
919828,2023-04-30,711,TD kit,150,300,150,1,00176,India
919828,2023-04-30,716,printing paper,200,400,200,1,00176,India
919828,2023-04-30,705,stencil,10,20,10,2,00176,India
919828,2023-04-30,710,geometry box,100,150,50,2,00176,India
919828,2023-04-30,712,graph paper,20,40,20,1,00176,India
906048,2023-04-30,709,notebook,30,60,30,2,00112,India
906048,2023-04-30,708,sketchpen,15,40,25,1,00112,India
906048,2023-04-30,711,TD kit,150,300,150,1,00112,India
467605,2023-04-30,714,carbon paper,15,30,15,1,00215,India
832551,2023-04-30,716,printing paper,200,400,200,1,00335,India
699205,2023-04-30,707,marker,20,40,20,1,00241,India
699205,2023-04-30,705,stencil,10,20,10,2,00241,India
699205,2023-04-30,711,TD kit,150,300,150,1,00241,India
973182,2023-04-30,709,notebook,30,60,30,2,00143,India
973182,2023-04-30,701,gel pen,5,10,5,2,00143,India
973182,2023-04-30,712,graph paper,20,40,20,1,00143,India
865116,2023-04-30,717,spiral bound book,50,100,50,1,00276,India
397835,2023-04-30,705,stencil,10,20,10,2,00215,India
397835,2023-04-30,713,ball pen,5,10,5,2,00215,India
700120,2023-04-30,702,pencil,2,5,3,2,00237,India
700120,2023-04-30,714,carbon paper,15,30,15,1,00237,India
700120,2023-04-30,716,printing paper,200,400,200,1,00237,India
221775,2023-04-30,707,marker,20,40,20,1,00319,India
221775,2023-04-30,704,scale,5,10,5,2,00319,India
221775,2023-04-30,708,sketchpen,15,40,25,1,00319,India
966294,2023-04-30,712,graph paper,20,40,20,1,00380,India
966294,2023-04-30,709,notebook,30,60,30,2,00380,India
966294,2023-04-30,708,sketchpen,15,40,25,1,00380,India
966294,2023-04-30,707,marker,20,40,20,1,00380,India
966294,2023-04-30,715,folder,5,15,10,1,00380,India
415370,2023-04-30,702,pencil,2,5,3,2,00153,India
415370,2023-04-30,705,stencil,10,20,10,2,00153,India
415370,2023-04-30,709,notebook,30,60,30,2,00153,India
306037,2023-04-30,714,carbon paper,15,30,15,1,00466,India
306037,2023-04-30,704,scale,5,10,5,2,00466,India
539255,2023-04-30,703,eraser,1,3,2,2,00444,India
555175,2023-04-30,710,geometry box,100,150,50,2,00302,India
555175,2023-04-30,702,pencil,2,5,3,2,00302,India
555175,2023-04-30,717,spiral bound book,50,100,50,1,00302,India
555175,2023-04-30,704,scale,5,10,5,2,00302,India
905681,2023-04-30,708,sketchpen,15,40,25,1,00145,India
905681,2023-04-30,711,TD kit,150,300,150,1,00145,India
491397,2023-04-30,708,sketchpen,15,40,25,1,00219,India
491397,2023-04-30,714,carbon paper,15,30,15,1,00219,India
491397,2023-04-30,704,scale,5,10,5,2,00219,India
491397,2023-04-30,717,spiral bound book,50,100,50,1,00219,India
356148,2023-04-30,711,TD kit,150,300,150,1,00243,India
356148,2023-04-30,714,carbon paper,15,30,15,1,00243,India
356148,2023-04-30,706,sharpener,3,8,5,2,00243,India
334854,2023-04-30,715,folder,5,15,10,1,00019,India
334854,2023-04-30,712,graph paper,20,40,20,1,00019,India
334854,2023-04-30,701,gel pen,5,10,5,2,00019,India
773340,2023-04-30,715,folder,5,15,10,1,00332,India
773340,2023-04-30,705,stencil,10,20,10,2,00332,India
773340,2023-04-30,701,gel pen,5,10,5,2,00332,India
773340,2023-04-30,703,eraser,1,3,2,2,00332,India
736581,2023-04-30,702,pencil,2,5,3,2,00382,India
668900,2023-04-30,716,printing paper,200,400,200,1,00240,India
668900,2023-04-30,701,gel pen,5,10,5,2,00240,India
668900,2023-04-30,711,TD kit,150,300,150,1,00240,India
668900,2023-04-30,713,ball pen,5,10,5,2,00240,India
442436,2023-04-30,714,carbon paper,15,30,15,1,00219,India
743422,2023-05-01,710,geometry box,100,150,50,2,00225,India
743422,2023-05-01,714,carbon paper,15,30,15,1,00225,India
743422,2023-05-01,711,TD kit,150,300,150,1,00225,India
743422,2023-05-01,715,folder,5,15,10,1,00225,India
965472,2023-05-01,713,ball pen,5,10,5,2,00151,India
965472,2023-05-01,709,notebook,30,60,30,2,00151,India
965472,2023-05-01,705,stencil,10,20,10,2,00151,India
965472,2023-05-01,702,pencil,2,5,3,2,00151,India
608821,2023-05-01,709,notebook,30,60,30,2,00301,India
608821,2023-05-01,704,scale,5,10,5,2,00301,India
608821,2023-05-01,716,printing paper,200,400,200,1,00301,India
608821,2023-05-01,711,TD kit,150,300,150,1,00301,India
621582,2023-05-01,707,marker,20,40,20,1,00050,India
621582,2023-05-01,706,sharpener,3,8,5,2,00050,India
621582,2023-05-01,711,TD kit,150,300,150,1,00050,India
621582,2023-05-01,714,carbon paper,15,30,15,1,00050,India
879635,2023-05-01,714,carbon paper,15,30,15,1,00327,India
685508,2023-05-01,717,spiral bound book,50,100,50,1,00245,India
685508,2023-05-01,704,scale,5,10,5,2,00245,India
685508,2023-05-01,711,TD kit,150,300,150,1,00245,India
685508,2023-05-01,715,folder,5,15,10,1,00245,India
563149,2023-05-01,701,gel pen,5,10,5,2,00304,India
563149,2023-05-01,715,folder,5,15,10,1,00304,India
563149,2023-05-01,706,sharpener,3,8,5,2,00304,India
563149,2023-05-01,711,TD kit,150,300,150,1,00304,India
456662,2023-05-01,706,sharpener,3,8,5,2,00050,India
456662,2023-05-01,716,printing paper,200,400,200,1,00050,India
456662,2023-05-01,704,scale,5,10,5,2,00050,India
504918,2023-05-01,702,pencil,2,5,3,2,00078,India
504918,2023-05-01,701,gel pen,5,10,5,2,00078,India
504286,2023-05-01,707,marker,20,40,20,1,00381,India
484032,2023-05-01,708,sketchpen,15,40,25,1,00491,India
484032,2023-05-01,710,geometry box,100,150,50,2,00491,India
484032,2023-05-01,704,scale,5,10,5,2,00491,India
484032,2023-05-01,709,notebook,30,60,30,2,00491,India
351418,2023-05-01,712,graph paper,20,40,20,1,00195,India
351418,2023-05-01,715,folder,5,15,10,1,00195,India
898514,2023-05-01,702,pencil,2,5,3,2,00200,India
328004,2023-05-01,702,pencil,2,5,3,2,00215,India
422090,2023-05-01,709,notebook,30,60,30,2,00291,India
422090,2023-05-01,702,pencil,2,5,3,2,00291,India
422090,2023-05-01,704,scale,5,10,5,2,00291,India
788040,2023-05-01,709,notebook,30,60,30,2,00371,India
788040,2023-05-01,708,sketchpen,15,40,25,1,00371,India
796476,2023-05-01,711,TD kit,150,300,150,1,00185,India
796476,2023-05-01,705,stencil,10,20,10,2,00185,India
796476,2023-05-01,704,scale,5,10,5,2,00185,India
227678,2023-05-01,708,sketchpen,15,40,25,1,00417,India
227678,2023-05-01,717,spiral bound book,50,100,50,1,00417,India
227678,2023-05-01,716,printing paper,200,400,200,1,00417,India
922601,2023-05-01,710,geometry box,100,150,50,2,00141,India
922601,2023-05-01,701,gel pen,5,10,5,2,00141,India
643570,2023-05-01,707,marker,20,40,20,1,00045,India
643570,2023-05-01,706,sharpener,3,8,5,2,00045,India
643570,2023-05-01,703,eraser,1,3,2,2,00045,India
643570,2023-05-01,702,pencil,2,5,3,2,00045,India
452020,2023-05-01,714,carbon paper,15,30,15,1,00284,India
468421,2023-05-01,701,gel pen,5,10,5,2,00316,India
468421,2023-05-01,707,marker,20,40,20,1,00316,India
468421,2023-05-01,708,sketchpen,15,40,25,1,00316,India
468421,2023-05-01,704,scale,5,10,5,2,00316,India
604528,2023-05-01,707,marker,20,40,20,1,00479,India
604528,2023-05-01,702,pencil,2,5,3,2,00479,India
926604,2023-05-01,702,pencil,2,5,3,2,00402,India
495622,2023-05-01,707,marker,20,40,20,1,00271,India
495622,2023-05-01,711,TD kit,150,300,150,1,00271,India
800995,2023-05-01,709,notebook,30,60,30,2,00281,India
800995,2023-05-01,702,pencil,2,5,3,2,00281,India
529197,2023-05-01,717,spiral bound book,50,100,50,1,00064,India
914239,2023-05-01,701,gel pen,5,10,5,2,00383,India
843570,2023-05-01,707,marker,20,40,20,1,00251,India
164664,2023-05-01,706,sharpener,3,8,5,2,00167,India
164664,2023-05-01,717,spiral bound book,50,100,50,1,00167,India
164664,2023-05-01,704,scale,5,10,5,2,00167,India
164664,2023-05-01,701,gel pen,5,10,5,2,00167,India
115383,2023-05-01,704,scale,5,10,5,2,00111,India
115383,2023-05-01,701,gel pen,5,10,5,2,00111,India
115383,2023-05-01,708,sketchpen,15,40,25,1,00111,India
115383,2023-05-01,706,sharpener,3,8,5,2,00111,India
345939,2023-05-01,707,marker,20,40,20,1,00278,India
393528,2023-05-01,708,sketchpen,15,40,25,1,00357,India
191513,2023-05-01,709,notebook,30,60,30,2,00100,India
191513,2023-05-01,711,TD kit,150,300,150,1,00100,India
191513,2023-05-01,717,spiral bound book,50,100,50,1,00100,India
933109,2023-05-01,707,marker,20,40,20,1,00104,India
933109,2023-05-01,711,TD kit,150,300,150,1,00104,India
933109,2023-05-01,712,graph paper,20,40,20,1,00104,India
933109,2023-05-01,702,pencil,2,5,3,2,00104,India
373844,2023-05-01,705,stencil,10,20,10,2,00320,India
373844,2023-05-01,703,eraser,1,3,2,2,00320,India
373844,2023-05-01,702,pencil,2,5,3,2,00320,India
594134,2023-05-01,711,TD kit,150,300,150,1,00252,India
594134,2023-05-01,715,folder,5,15,10,1,00252,India
594134,2023-05-01,705,stencil,10,20,10,2,00252,India
594134,2023-05-01,714,carbon paper,15,30,15,1,00252,India
863461,2023-05-01,705,stencil,10,20,10,2,00401,India
347792,2023-05-01,717,spiral bound book,50,100,50,1,00417,India
347792,2023-05-01,707,marker,20,40,20,1,00417,India
391410,2023-05-01,715,folder,5,15,10,1,00220,India
391410,2023-05-01,701,gel pen,5,10,5,2,00220,India
391410,2023-05-01,705,stencil,10,20,10,2,00220,India
391410,2023-05-01,714,carbon paper,15,30,15,1,00220,India
408214,2023-05-01,706,sharpener,3,8,5,2,00053,India
408214,2023-05-01,703,eraser,1,3,2,2,00053,India
310581,2023-05-01,716,printing paper,200,400,200,1,00338,India
310581,2023-05-01,715,folder,5,15,10,1,00338,India
310581,2023-05-01,707,marker,20,40,20,1,00338,India
336630,2023-05-01,715,folder,5,15,10,1,00430,India
336630,2023-05-01,712,graph paper,20,40,20,1,00430,India
336630,2023-05-01,711,TD kit,150,300,150,1,00430,India
336630,2023-05-01,714,carbon paper,15,30,15,1,00430,India
336630,2023-05-01,703,eraser,1,3,2,2,00430,India
471978,2023-05-01,717,spiral bound book,50,100,50,1,00417,India
454808,2023-05-02,706,sharpener,3,8,5,2,00091,India
454808,2023-05-02,710,geometry box,100,150,50,2,00091,India
454808,2023-05-02,708,sketchpen,15,40,25,1,00091,India
596993,2023-05-02,716,printing paper,200,400,200,1,00413,India
596993,2023-05-02,713,ball pen,5,10,5,2,00413,India
596993,2023-05-02,702,pencil,2,5,3,2,00413,India
596993,2023-05-02,709,notebook,30,60,30,2,00413,India
968139,2023-05-02,716,printing paper,200,400,200,1,00362,India
968139,2023-05-02,704,scale,5,10,5,2,00362,India
716082,2023-05-02,701,gel pen,5,10,5,2,00095,India
716082,2023-05-02,706,sharpener,3,8,5,2,00095,India
716082,2023-05-02,711,TD kit,150,300,150,1,00095,India
273865,2023-05-02,709,notebook,30,60,30,2,00475,India
273865,2023-05-02,715,folder,5,15,10,1,00475,India
273865,2023-05-02,716,printing paper,200,400,200,1,00475,India
366763,2023-05-02,709,notebook,30,60,30,2,00211,India
366763,2023-05-02,708,sketchpen,15,40,25,1,00211,India
366763,2023-05-02,711,TD kit,150,300,150,1,00211,India
366763,2023-05-02,714,carbon paper,15,30,15,1,00211,India
239575,2023-05-02,717,spiral bound book,50,100,50,1,00477,India
239575,2023-05-02,702,pencil,2,5,3,2,00477,India
420758,2023-05-02,707,marker,20,40,20,1,00105,India
420758,2023-05-02,711,TD kit,150,300,150,1,00105,India
420758,2023-05-02,706,sharpener,3,8,5,2,00105,India
420758,2023-05-02,710,geometry box,100,150,50,2,00105,India
436719,2023-05-02,704,scale,5,10,5,2,00395,India
436719,2023-05-02,712,graph paper,20,40,20,1,00395,India
436719,2023-05-02,716,printing paper,200,400,200,1,00395,India
436719,2023-05-02,702,pencil,2,5,3,2,00395,India
436719,2023-05-02,703,eraser,1,3,2,2,00395,India
908204,2023-05-02,716,printing paper,200,400,200,1,00306,India
908204,2023-05-02,709,notebook,30,60,30,2,00306,India
221124,2023-05-02,704,scale,5,10,5,2,00428,India
221124,2023-05-02,710,geometry box,100,150,50,2,00428,India
731244,2023-05-02,708,sketchpen,15,40,25,1,00103,India
731244,2023-05-02,702,pencil,2,5,3,2,00103,India
841652,2023-05-02,714,carbon paper,15,30,15,1,00455,India
841652,2023-05-02,702,pencil,2,5,3,2,00455,India
841652,2023-05-02,701,gel pen,5,10,5,2,00455,India
536078,2023-05-02,714,carbon paper,15,30,15,1,00349,India
100799,2023-05-02,708,sketchpen,15,40,25,1,00063,India
100799,2023-05-02,703,eraser,1,3,2,2,00063,India
100799,2023-05-02,706,sharpener,3,8,5,2,00063,India
100799,2023-05-02,715,folder,5,15,10,1,00063,India
940024,2023-05-02,716,printing paper,200,400,200,1,00384,India
940024,2023-05-02,701,gel pen,5,10,5,2,00384,India
101542,2023-05-02,706,sharpener,3,8,5,2,00241,India
363688,2023-05-02,708,sketchpen,15,40,25,1,00031,India
247743,2023-05-02,714,carbon paper,15,30,15,1,00188,India
247743,2023-05-02,708,sketchpen,15,40,25,1,00188,India
745883,2023-05-02,703,eraser,1,3,2,2,00315,India
745883,2023-05-02,709,notebook,30,60,30,2,00315,India
230330,2023-05-02,713,ball pen,5,10,5,2,00250,India
230330,2023-05-02,701,gel pen,5,10,5,2,00250,India
230330,2023-05-02,703,eraser,1,3,2,2,00250,India
230330,2023-05-02,705,stencil,10,20,10,2,00250,India
748664,2023-05-02,711,TD kit,150,300,150,1,00039,India
748664,2023-05-02,707,marker,20,40,20,1,00039,India
748664,2023-05-02,710,geometry box,100,150,50,2,00039,India
322956,2023-05-02,716,printing paper,200,400,200,1,00125,India
322956,2023-05-02,703,eraser,1,3,2,2,00125,India
322956,2023-05-02,715,folder,5,15,10,1,00125,India
322956,2023-05-02,711,TD kit,150,300,150,1,00125,India
457319,2023-05-02,715,folder,5,15,10,1,00085,India
457319,2023-05-02,701,gel pen,5,10,5,2,00085,India
457319,2023-05-02,712,graph paper,20,40,20,1,00085,India
457319,2023-05-02,705,stencil,10,20,10,2,00085,India
457319,2023-05-02,702,pencil,2,5,3,2,00085,India
828033,2023-05-02,705,stencil,10,20,10,2,00417,India
828033,2023-05-02,706,sharpener,3,8,5,2,00417,India
828033,2023-05-02,713,ball pen,5,10,5,2,00417,India
439842,2023-05-02,715,folder,5,15,10,1,00043,India
439842,2023-05-02,717,spiral bound book,50,100,50,1,00043,India
755845,2023-05-02,715,folder,5,15,10,1,00102,India
755845,2023-05-02,705,stencil,10,20,10,2,00102,India
755845,2023-05-02,712,graph paper,20,40,20,1,00102,India
755845,2023-05-02,716,printing paper,200,400,200,1,00102,India
755845,2023-05-02,717,spiral bound book,50,100,50,1,00102,India
590583,2023-05-02,715,folder,5,15,10,1,00250,India
590583,2023-05-02,709,notebook,30,60,30,2,00250,India
107302,2023-05-02,715,folder,5,15,10,1,00238,India
107302,2023-05-02,714,carbon paper,15,30,15,1,00238,India
965601,2023-05-02,701,gel pen,5,10,5,2,00094,India
937031,2023-05-02,702,pencil,2,5,3,2,00050,India
937031,2023-05-02,713,ball pen,5,10,5,2,00050,India
937031,2023-05-02,706,sharpener,3,8,5,2,00050,India
937031,2023-05-02,710,geometry box,100,150,50,2,00050,India
937031,2023-05-02,705,stencil,10,20,10,2,00050,India
447318,2023-05-02,707,marker,20,40,20,1,00327,India
338209,2023-05-02,701,gel pen,5,10,5,2,00005,India
138956,2023-05-02,710,geometry box,100,150,50,2,00410,India
562687,2023-05-02,705,stencil,10,20,10,2,00234,India
812102,2023-05-02,704,scale,5,10,5,2,00063,India
752128,2023-05-02,713,ball pen,5,10,5,2,00386,India
752128,2023-05-02,708,sketchpen,15,40,25,1,00386,India
752128,2023-05-02,702,pencil,2,5,3,2,00386,India
752128,2023-05-02,715,folder,5,15,10,1,00386,India
426111,2023-05-02,716,printing paper,200,400,200,1,00310,India
426111,2023-05-02,708,sketchpen,15,40,25,1,00310,India
768019,2023-05-02,703,eraser,1,3,2,2,00290,India
768019,2023-05-02,716,printing paper,200,400,200,1,00290,India
825835,2023-05-02,704,scale,5,10,5,2,00249,India
825835,2023-05-02,706,sharpener,3,8,5,2,00249,India
825835,2023-05-02,712,graph paper,20,40,20,1,00249,India
423448,2023-05-02,707,marker,20,40,20,1,00207,India
621955,2023-05-02,714,carbon paper,15,30,15,1,00459,India
621955,2023-05-02,705,stencil,10,20,10,2,00459,India
853324,2023-05-02,703,eraser,1,3,2,2,00319,India
774992,2023-05-02,713,ball pen,5,10,5,2,00332,India
916767,2023-05-02,717,spiral bound book,50,100,50,1,00229,India
916767,2023-05-02,703,eraser,1,3,2,2,00229,India
916767,2023-05-02,709,notebook,30,60,30,2,00229,India
916767,2023-05-02,712,graph paper,20,40,20,1,00229,India
642448,2023-05-02,706,sharpener,3,8,5,2,00331,India
642448,2023-05-02,713,ball pen,5,10,5,2,00331,India
642448,2023-05-02,714,carbon paper,15,30,15,1,00331,India
642448,2023-05-02,715,folder,5,15,10,1,00331,India
272990,2023-05-02,708,sketchpen,15,40,25,1,00065,India
272990,2023-05-02,701,gel pen,5,10,5,2,00065,India
272990,2023-05-02,706,sharpener,3,8,5,2,00065,India
272990,2023-05-02,715,folder,5,15,10,1,00065,India
241730,2023-05-02,712,graph paper,20,40,20,1,00043,India
241730,2023-05-02,703,eraser,1,3,2,2,00043,India
241730,2023-05-02,709,notebook,30,60,30,2,00043,India
241730,2023-05-02,717,spiral bound book,50,100,50,1,00043,India
818782,2023-05-03,703,eraser,1,3,2,2,00349,India
848465,2023-05-03,709,notebook,30,60,30,2,00465,India
679609,2023-05-03,711,TD kit,150,300,150,1,00379,India
679609,2023-05-03,717,spiral bound book,50,100,50,1,00379,India
303189,2023-05-03,708,sketchpen,15,40,25,1,00072,India
133670,2023-05-03,716,printing paper,200,400,200,1,00385,India
896055,2023-05-03,712,graph paper,20,40,20,1,00253,India
896055,2023-05-03,716,printing paper,200,400,200,1,00253,India
896055,2023-05-03,705,stencil,10,20,10,2,00253,India
398748,2023-05-03,708,sketchpen,15,40,25,1,00145,India
398748,2023-05-03,705,stencil,10,20,10,2,00145,India
398748,2023-05-03,709,notebook,30,60,30,2,00145,India
116667,2023-05-03,710,geometry box,100,150,50,2,00224,India
116667,2023-05-03,702,pencil,2,5,3,2,00224,India
116667,2023-05-03,703,eraser,1,3,2,2,00224,India
404701,2023-05-03,705,stencil,10,20,10,2,00400,India
404701,2023-05-03,702,pencil,2,5,3,2,00400,India
404701,2023-05-03,706,sharpener,3,8,5,2,00400,India
404701,2023-05-03,717,spiral bound book,50,100,50,1,00400,India
370558,2023-05-03,703,eraser,1,3,2,2,00478,India
302190,2023-05-03,712,graph paper,20,40,20,1,00102,India
291114,2023-05-03,714,carbon paper,15,30,15,1,00452,India
291114,2023-05-03,706,sharpener,3,8,5,2,00452,India
291114,2023-05-03,711,TD kit,150,300,150,1,00452,India
291114,2023-05-03,713,ball pen,5,10,5,2,00452,India
291114,2023-05-03,709,notebook,30,60,30,2,00452,India
935546,2023-05-03,716,printing paper,200,400,200,1,00017,India
935546,2023-05-03,713,ball pen,5,10,5,2,00017,India
726204,2023-05-03,717,spiral bound book,50,100,50,1,00317,India
726204,2023-05-03,710,geometry box,100,150,50,2,00317,India
726204,2023-05-03,712,graph paper,20,40,20,1,00317,India
726204,2023-05-03,704,scale,5,10,5,2,00317,India
726204,2023-05-03,706,sharpener,3,8,5,2,00317,India
955072,2023-05-03,717,spiral bound book,50,100,50,1,00436,India
263501,2023-05-03,715,folder,5,15,10,1,00151,India
263501,2023-05-03,704,scale,5,10,5,2,00151,India
263501,2023-05-03,714,carbon paper,15,30,15,1,00151,India
263501,2023-05-03,712,graph paper,20,40,20,1,00151,India
507347,2023-05-03,710,geometry box,100,150,50,2,00031,India
602220,2023-05-03,707,marker,20,40,20,1,00151,India
602220,2023-05-03,708,sketchpen,15,40,25,1,00151,India
818355,2023-05-03,716,printing paper,200,400,200,1,00306,India
818355,2023-05-03,705,stencil,10,20,10,2,00306,India
818355,2023-05-03,703,eraser,1,3,2,2,00306,India
818355,2023-05-03,715,folder,5,15,10,1,00306,India
775981,2023-05-03,702,pencil,2,5,3,2,00115,India
775981,2023-05-03,701,gel pen,5,10,5,2,00115,India
775981,2023-05-03,715,folder,5,15,10,1,00115,India
775981,2023-05-03,705,stencil,10,20,10,2,00115,India
775981,2023-05-03,706,sharpener,3,8,5,2,00115,India
241211,2023-05-03,703,eraser,1,3,2,2,00403,India
241211,2023-05-03,706,sharpener,3,8,5,2,00403,India
241211,2023-05-03,709,notebook,30,60,30,2,00403,India
323239,2023-05-03,712,graph paper,20,40,20,1,00211,India
323239,2023-05-03,715,folder,5,15,10,1,00211,India
323239,2023-05-03,711,TD kit,150,300,150,1,00211,India
208031,2023-05-03,713,ball pen,5,10,5,2,00282,India
208031,2023-05-03,715,folder,5,15,10,1,00282,India
208031,2023-05-03,714,carbon paper,15,30,15,1,00282,India
208031,2023-05-03,702,pencil,2,5,3,2,00282,India
208031,2023-05-03,711,TD kit,150,300,150,1,00282,India
530444,2023-05-03,702,pencil,2,5,3,2,00249,India
530444,2023-05-03,705,stencil,10,20,10,2,00249,India
737658,2023-05-03,712,graph paper,20,40,20,1,00004,India
737658,2023-05-03,713,ball pen,5,10,5,2,00004,India
737658,2023-05-03,704,scale,5,10,5,2,00004,India
737658,2023-05-03,702,pencil,2,5,3,2,00004,India
737658,2023-05-03,701,gel pen,5,10,5,2,00004,India
961650,2023-05-03,716,printing paper,200,400,200,1,00300,India
961650,2023-05-03,710,geometry box,100,150,50,2,00300,India
961650,2023-05-03,703,eraser,1,3,2,2,00300,India
961650,2023-05-03,715,folder,5,15,10,1,00300,India
853322,2023-05-03,714,carbon paper,15,30,15,1,00269,India
853322,2023-05-03,701,gel pen,5,10,5,2,00269,India
853322,2023-05-03,715,folder,5,15,10,1,00269,India
853322,2023-05-03,705,stencil,10,20,10,2,00269,India
146348,2023-05-03,716,printing paper,200,400,200,1,00298,India
750357,2023-05-03,712,graph paper,20,40,20,1,00346,India
957004,2023-05-03,712,graph paper,20,40,20,1,00187,India
499887,2023-05-03,701,gel pen,5,10,5,2,00489,India
499887,2023-05-03,707,marker,20,40,20,1,00489,India
499887,2023-05-03,708,sketchpen,15,40,25,1,00489,India
817088,2023-05-03,704,scale,5,10,5,2,00007,India
817088,2023-05-03,712,graph paper,20,40,20,1,00007,India
817088,2023-05-03,706,sharpener,3,8,5,2,00007,India
817088,2023-05-03,716,printing paper,200,400,200,1,00007,India
171639,2023-05-03,716,printing paper,200,400,200,1,00083,India
549373,2023-05-03,709,notebook,30,60,30,2,00263,India
549373,2023-05-03,714,carbon paper,15,30,15,1,00263,India
979910,2023-05-04,713,ball pen,5,10,5,2,00011,India
979910,2023-05-04,712,graph paper,20,40,20,1,00011,India
979910,2023-05-04,705,stencil,10,20,10,2,00011,India
273519,2023-05-04,706,sharpener,3,8,5,2,00032,India
273519,2023-05-04,702,pencil,2,5,3,2,00032,India
273519,2023-05-04,712,graph paper,20,40,20,1,00032,India
273519,2023-05-04,711,TD kit,150,300,150,1,00032,India
273519,2023-05-04,710,geometry box,100,150,50,2,00032,India
917618,2023-05-04,710,geometry box,100,150,50,2,00228,India
751545,2023-05-04,706,sharpener,3,8,5,2,00040,India
196293,2023-05-04,703,eraser,1,3,2,2,00313,India
196293,2023-05-04,709,notebook,30,60,30,2,00313,India
196293,2023-05-04,716,printing paper,200,400,200,1,00313,India
196293,2023-05-04,710,geometry box,100,150,50,2,00313,India
196293,2023-05-04,702,pencil,2,5,3,2,00313,India
956162,2023-05-04,713,ball pen,5,10,5,2,00350,India
956162,2023-05-04,703,eraser,1,3,2,2,00350,India
956162,2023-05-04,716,printing paper,200,400,200,1,00350,India
746893,2023-05-04,708,sketchpen,15,40,25,1,00427,India
746893,2023-05-04,703,eraser,1,3,2,2,00427,India
746893,2023-05-04,704,scale,5,10,5,2,00427,India
746893,2023-05-04,717,spiral bound book,50,100,50,1,00427,India
913701,2023-05-04,713,ball pen,5,10,5,2,00402,India
416871,2023-05-04,712,graph paper,20,40,20,1,00381,India
334286,2023-05-04,710,geometry box,100,150,50,2,00014,India
334286,2023-05-04,715,folder,5,15,10,1,00014,India
250786,2023-05-04,716,printing paper,200,400,200,1,00112,India
322607,2023-05-04,709,notebook,30,60,30,2,00106,India
322607,2023-05-04,703,eraser,1,3,2,2,00106,India
322607,2023-05-04,707,marker,20,40,20,1,00106,India
289706,2023-05-04,702,pencil,2,5,3,2,00395,India
289706,2023-05-04,713,ball pen,5,10,5,2,00395,India
289706,2023-05-04,716,printing paper,200,400,200,1,00395,India
289706,2023-05-04,711,TD kit,150,300,150,1,00395,India
289706,2023-05-04,708,sketchpen,15,40,25,1,00395,India
576025,2023-05-04,716,printing paper,200,400,200,1,00211,India
353586,2023-05-04,712,graph paper,20,40,20,1,00476,India
353586,2023-05-04,711,TD kit,150,300,150,1,00476,India
353586,2023-05-04,710,geometry box,100,150,50,2,00476,India
353586,2023-05-04,707,marker,20,40,20,1,00476,India
486461,2023-05-04,715,folder,5,15,10,1,00097,India
486461,2023-05-04,712,graph paper,20,40,20,1,00097,India
486461,2023-05-04,704,scale,5,10,5,2,00097,India
486461,2023-05-04,716,printing paper,200,400,200,1,00097,India
776800,2023-05-04,701,gel pen,5,10,5,2,00168,India
776800,2023-05-04,707,marker,20,40,20,1,00168,India
497290,2023-05-04,708,sketchpen,15,40,25,1,00142,India
497290,2023-05-04,710,geometry box,100,150,50,2,00142,India
497290,2023-05-04,712,graph paper,20,40,20,1,00142,India
497290,2023-05-04,715,folder,5,15,10,1,00142,India
497290,2023-05-04,707,marker,20,40,20,1,00142,India
913076,2023-05-04,712,graph paper,20,40,20,1,00451,India
913076,2023-05-04,701,gel pen,5,10,5,2,00451,India
913076,2023-05-04,710,geometry box,100,150,50,2,00451,India
691130,2023-05-04,706,sharpener,3,8,5,2,00147,India
691130,2023-05-04,701,gel pen,5,10,5,2,00147,India
691130,2023-05-04,707,marker,20,40,20,1,00147,India
691130,2023-05-04,708,sketchpen,15,40,25,1,00147,India
730620,2023-05-04,714,carbon paper,15,30,15,1,00460,India
592469,2023-05-04,703,eraser,1,3,2,2,00002,India
592469,2023-05-04,710,geometry box,100,150,50,2,00002,India
592469,2023-05-04,709,notebook,30,60,30,2,00002,India
592469,2023-05-04,707,marker,20,40,20,1,00002,India
203466,2023-05-04,707,marker,20,40,20,1,00369,India
203466,2023-05-04,705,stencil,10,20,10,2,00369,India
203466,2023-05-04,714,carbon paper,15,30,15,1,00369,India
985367,2023-05-04,706,sharpener,3,8,5,2,00061,India
985367,2023-05-04,702,pencil,2,5,3,2,00061,India
985367,2023-05-04,704,scale,5,10,5,2,00061,India
985367,2023-05-04,703,eraser,1,3,2,2,00061,India
808418,2023-05-04,704,scale,5,10,5,2,00192,India
808418,2023-05-04,711,TD kit,150,300,150,1,00192,India
808418,2023-05-04,708,sketchpen,15,40,25,1,00192,India
808418,2023-05-04,707,marker,20,40,20,1,00192,India
540962,2023-05-04,715,folder,5,15,10,1,00100,India
540962,2023-05-04,716,printing paper,200,400,200,1,00100,India
635021,2023-05-04,705,stencil,10,20,10,2,00189,India
635021,2023-05-04,717,spiral bound book,50,100,50,1,00189,India
635021,2023-05-04,707,marker,20,40,20,1,00189,India
778038,2023-05-04,714,carbon paper,15,30,15,1,00026,India
778038,2023-05-04,717,spiral bound book,50,100,50,1,00026,India
778038,2023-05-04,713,ball pen,5,10,5,2,00026,India
778038,2023-05-04,712,graph paper,20,40,20,1,00026,India
778038,2023-05-04,708,sketchpen,15,40,25,1,00026,India
594333,2023-05-04,717,spiral bound book,50,100,50,1,00036,India
594333,2023-05-04,707,marker,20,40,20,1,00036,India
594333,2023-05-04,701,gel pen,5,10,5,2,00036,India
594333,2023-05-04,712,graph paper,20,40,20,1,00036,India
238950,2023-05-04,701,gel pen,5,10,5,2,00144,India
238950,2023-05-04,715,folder,5,15,10,1,00144,India
196732,2023-05-04,701,gel pen,5,10,5,2,00269,India
427000,2023-05-04,712,graph paper,20,40,20,1,00176,India
427000,2023-05-04,710,geometry box,100,150,50,2,00176,India
374405,2023-05-05,714,carbon paper,15,30,15,1,00208,India
374405,2023-05-05,710,geometry box,100,150,50,2,00208,India
374405,2023-05-05,701,gel pen,5,10,5,2,00208,India
374405,2023-05-05,715,folder,5,15,10,1,00208,India
897775,2023-05-05,710,geometry box,100,150,50,2,00301,India
897775,2023-05-05,703,eraser,1,3,2,2,00301,India
897775,2023-05-05,709,notebook,30,60,30,2,00301,India
589752,2023-05-05,710,geometry box,100,150,50,2,00012,India
589752,2023-05-05,711,TD kit,150,300,150,1,00012,India
589752,2023-05-05,702,pencil,2,5,3,2,00012,India
589752,2023-05-05,708,sketchpen,15,40,25,1,00012,India
589752,2023-05-05,715,folder,5,15,10,1,00012,India
735342,2023-05-05,708,sketchpen,15,40,25,1,00023,India
735342,2023-05-05,703,eraser,1,3,2,2,00023,India
735342,2023-05-05,706,sharpener,3,8,5,2,00023,India
735342,2023-05-05,710,geometry box,100,150,50,2,00023,India
735342,2023-05-05,711,TD kit,150,300,150,1,00023,India
893375,2023-05-05,703,eraser,1,3,2,2,00347,India
893375,2023-05-05,702,pencil,2,5,3,2,00347,India
893375,2023-05-05,701,gel pen,5,10,5,2,00347,India
893375,2023-05-05,714,carbon paper,15,30,15,1,00347,India
893375,2023-05-05,716,printing paper,200,400,200,1,00347,India
335748,2023-05-05,712,graph paper,20,40,20,1,00223,India
335748,2023-05-05,714,carbon paper,15,30,15,1,00223,India
745189,2023-05-05,714,carbon paper,15,30,15,1,00048,India
745189,2023-05-05,702,pencil,2,5,3,2,00048,India
745189,2023-05-05,703,eraser,1,3,2,2,00048,India
604486,2023-05-05,706,sharpener,3,8,5,2,00141,India
604486,2023-05-05,711,TD kit,150,300,150,1,00141,India
604486,2023-05-05,702,pencil,2,5,3,2,00141,India
364616,2023-05-05,703,eraser,1,3,2,2,00036,India
364616,2023-05-05,701,gel pen,5,10,5,2,00036,India
364616,2023-05-05,711,TD kit,150,300,150,1,00036,India
364616,2023-05-05,714,carbon paper,15,30,15,1,00036,India
969657,2023-05-05,714,carbon paper,15,30,15,1,00149,India
264382,2023-05-05,712,graph paper,20,40,20,1,00485,India
264382,2023-05-05,711,TD kit,150,300,150,1,00485,India
965940,2023-05-05,704,scale,5,10,5,2,00346,India
965940,2023-05-05,717,spiral bound book,50,100,50,1,00346,India
965940,2023-05-05,715,folder,5,15,10,1,00346,India
243732,2023-05-05,711,TD kit,150,300,150,1,00199,India
243732,2023-05-05,710,geometry box,100,150,50,2,00199,India
243732,2023-05-05,715,folder,5,15,10,1,00199,India
785068,2023-05-05,716,printing paper,200,400,200,1,00069,India
785068,2023-05-05,714,carbon paper,15,30,15,1,00069,India
785068,2023-05-05,709,notebook,30,60,30,2,00069,India
785068,2023-05-05,710,geometry box,100,150,50,2,00069,India
785068,2023-05-05,707,marker,20,40,20,1,00069,India
844778,2023-05-05,707,marker,20,40,20,1,00402,India
844778,2023-05-05,712,graph paper,20,40,20,1,00402,India
736812,2023-05-05,707,marker,20,40,20,1,00276,India
736812,2023-05-05,712,graph paper,20,40,20,1,00276,India
875951,2023-05-05,712,graph paper,20,40,20,1,00413,India
723262,2023-05-05,709,notebook,30,60,30,2,00270,India
723262,2023-05-05,706,sharpener,3,8,5,2,00270,India
799292,2023-05-05,715,folder,5,15,10,1,00354,India
799292,2023-05-05,702,pencil,2,5,3,2,00354,India
799292,2023-05-05,706,sharpener,3,8,5,2,00354,India
799292,2023-05-05,714,carbon paper,15,30,15,1,00354,India
799292,2023-05-05,705,stencil,10,20,10,2,00354,India
923054,2023-05-05,717,spiral bound book,50,100,50,1,00039,India
923054,2023-05-05,715,folder,5,15,10,1,00039,India
815320,2023-05-05,716,printing paper,200,400,200,1,00088,India
815320,2023-05-05,708,sketchpen,15,40,25,1,00088,India
815320,2023-05-05,703,eraser,1,3,2,2,00088,India
815320,2023-05-05,711,TD kit,150,300,150,1,00088,India
241360,2023-05-05,710,geometry box,100,150,50,2,00058,India
461076,2023-05-05,715,folder,5,15,10,1,00336,India
461076,2023-05-05,716,printing paper,200,400,200,1,00336,India
461076,2023-05-05,707,marker,20,40,20,1,00336,India
233697,2023-05-05,705,stencil,10,20,10,2,00311,India
233697,2023-05-05,715,folder,5,15,10,1,00311,India
611396,2023-05-05,704,scale,5,10,5,2,00214,India
185686,2023-05-05,701,gel pen,5,10,5,2,00144,India
185686,2023-05-05,704,scale,5,10,5,2,00144,India
185686,2023-05-05,717,spiral bound book,50,100,50,1,00144,India
217192,2023-05-05,709,notebook,30,60,30,2,00100,India
217192,2023-05-05,704,scale,5,10,5,2,00100,India
446768,2023-05-05,704,scale,5,10,5,2,00334,India
446768,2023-05-05,701,gel pen,5,10,5,2,00334,India
446768,2023-05-05,705,stencil,10,20,10,2,00334,India
446768,2023-05-05,715,folder,5,15,10,1,00334,India
354304,2023-05-05,717,spiral bound book,50,100,50,1,00213,India
354304,2023-05-05,703,eraser,1,3,2,2,00213,India
354304,2023-05-05,712,graph paper,20,40,20,1,00213,India
354304,2023-05-05,709,notebook,30,60,30,2,00213,India
354304,2023-05-05,716,printing paper,200,400,200,1,00213,India
503528,2023-05-05,716,printing paper,200,400,200,1,00332,India
503528,2023-05-05,709,notebook,30,60,30,2,00332,India
503528,2023-05-05,706,sharpener,3,8,5,2,00332,India
883078,2023-05-05,714,carbon paper,15,30,15,1,00390,India
883078,2023-05-05,713,ball pen,5,10,5,2,00390,India
883078,2023-05-05,711,TD kit,150,300,150,1,00390,India
883078,2023-05-05,710,geometry box,100,150,50,2,00390,India
883078,2023-05-05,707,marker,20,40,20,1,00390,India
464364,2023-05-05,701,gel pen,5,10,5,2,00330,India
544992,2023-05-05,707,marker,20,40,20,1,00368,India
808560,2023-05-05,710,geometry box,100,150,50,2,00475,India
523626,2023-05-05,703,eraser,1,3,2,2,00249,India
978897,2023-05-05,711,TD kit,150,300,150,1,00080,India
978897,2023-05-05,715,folder,5,15,10,1,00080,India
978897,2023-05-05,714,carbon paper,15,30,15,1,00080,India
140857,2023-05-05,710,geometry box,100,150,50,2,00209,India
140857,2023-05-05,702,pencil,2,5,3,2,00209,India
572194,2023-05-05,715,folder,5,15,10,1,00278,India
188849,2023-05-06,703,eraser,1,3,2,2,00457,India
130569,2023-05-06,715,folder,5,15,10,1,00130,India
948556,2023-05-06,702,pencil,2,5,3,2,00376,India
180494,2023-05-06,702,pencil,2,5,3,2,00024,India
976591,2023-05-06,701,gel pen,5,10,5,2,00390,India
976591,2023-05-06,717,spiral bound book,50,100,50,1,00390,India
976591,2023-05-06,711,TD kit,150,300,150,1,00390,India
976591,2023-05-06,709,notebook,30,60,30,2,00390,India
976591,2023-05-06,710,geometry box,100,150,50,2,00390,India
714487,2023-05-06,703,eraser,1,3,2,2,00041,India
714487,2023-05-06,706,sharpener,3,8,5,2,00041,India
827984,2023-05-06,712,graph paper,20,40,20,1,00294,India
202407,2023-05-06,703,eraser,1,3,2,2,00067,India
202407,2023-05-06,713,ball pen,5,10,5,2,00067,India
202407,2023-05-06,707,marker,20,40,20,1,00067,India
897749,2023-05-06,701,gel pen,5,10,5,2,00163,India
897749,2023-05-06,707,marker,20,40,20,1,00163,India
897749,2023-05-06,704,scale,5,10,5,2,00163,India
287340,2023-05-06,716,printing paper,200,400,200,1,00112,India
287340,2023-05-06,702,pencil,2,5,3,2,00112,India
287340,2023-05-06,708,sketchpen,15,40,25,1,00112,India
678429,2023-05-06,711,TD kit,150,300,150,1,00296,India
678429,2023-05-06,716,printing paper,200,400,200,1,00296,India
678429,2023-05-06,715,folder,5,15,10,1,00296,India
678429,2023-05-06,717,spiral bound book,50,100,50,1,00296,India
678429,2023-05-06,706,sharpener,3,8,5,2,00296,India
800542,2023-05-06,709,notebook,30,60,30,2,00354,India
800542,2023-05-06,702,pencil,2,5,3,2,00354,India
800542,2023-05-06,705,stencil,10,20,10,2,00354,India
800542,2023-05-06,711,TD kit,150,300,150,1,00354,India
800542,2023-05-06,714,carbon paper,15,30,15,1,00354,India
395722,2023-05-06,705,stencil,10,20,10,2,00065,India
395722,2023-05-06,709,notebook,30,60,30,2,00065,India
395722,2023-05-06,714,carbon paper,15,30,15,1,00065,India
395722,2023-05-06,703,eraser,1,3,2,2,00065,India
395722,2023-05-06,708,sketchpen,15,40,25,1,00065,India
816972,2023-05-06,706,sharpener,3,8,5,2,00023,India
816972,2023-05-06,709,notebook,30,60,30,2,00023,India
816972,2023-05-06,713,ball pen,5,10,5,2,00023,India
816972,2023-05-06,714,carbon paper,15,30,15,1,00023,India
245315,2023-05-06,703,eraser,1,3,2,2,00455,India
245315,2023-05-06,716,printing paper,200,400,200,1,00455,India
113422,2023-05-06,701,gel pen,5,10,5,2,00052,India
113422,2023-05-06,710,geometry box,100,150,50,2,00052,India
113422,2023-05-06,706,sharpener,3,8,5,2,00052,India
113422,2023-05-06,713,ball pen,5,10,5,2,00052,India
113422,2023-05-06,705,stencil,10,20,10,2,00052,India
798786,2023-05-06,704,scale,5,10,5,2,00004,India
798786,2023-05-06,712,graph paper,20,40,20,1,00004,India
798786,2023-05-06,710,geometry box,100,150,50,2,00004,India
798786,2023-05-06,707,marker,20,40,20,1,00004,India
798786,2023-05-06,709,notebook,30,60,30,2,00004,India
902664,2023-05-06,704,scale,5,10,5,2,00457,India
902664,2023-05-06,715,folder,5,15,10,1,00457,India
902664,2023-05-06,717,spiral bound book,50,100,50,1,00457,India
609302,2023-05-06,702,pencil,2,5,3,2,00202,India
609302,2023-05-06,712,graph paper,20,40,20,1,00202,India
609302,2023-05-06,717,spiral bound book,50,100,50,1,00202,India
898612,2023-05-06,717,spiral bound book,50,100,50,1,00205,India
898612,2023-05-06,707,marker,20,40,20,1,00205,India
790830,2023-05-06,717,spiral bound book,50,100,50,1,00101,India
790830,2023-05-06,713,ball pen,5,10,5,2,00101,India
790830,2023-05-06,703,eraser,1,3,2,2,00101,India
213228,2023-05-06,707,marker,20,40,20,1,00303,India
268361,2023-05-06,711,TD kit,150,300,150,1,00080,India
268361,2023-05-06,712,graph paper,20,40,20,1,00080,India
268361,2023-05-06,715,folder,5,15,10,1,00080,India
252897,2023-05-06,717,spiral bound book,50,100,50,1,00309,India
252897,2023-05-06,711,TD kit,150,300,150,1,00309,India
252897,2023-05-06,704,scale,5,10,5,2,00309,India
764798,2023-05-06,710,geometry box,100,150,50,2,00490,India
764798,2023-05-06,701,gel pen,5,10,5,2,00490,India
121456,2023-05-06,703,eraser,1,3,2,2,00370,India
121456,2023-05-06,708,sketchpen,15,40,25,1,00370,India
121456,2023-05-06,702,pencil,2,5,3,2,00370,India
904534,2023-05-06,711,TD kit,150,300,150,1,00091,India
904534,2023-05-06,709,notebook,30,60,30,2,00091,India
904534,2023-05-06,705,stencil,10,20,10,2,00091,India
904534,2023-05-06,702,pencil,2,5,3,2,00091,India
602952,2023-05-06,716,printing paper,200,400,200,1,00017,India
602952,2023-05-06,711,TD kit,150,300,150,1,00017,India
706609,2023-05-06,713,ball pen,5,10,5,2,00144,India
706609,2023-05-06,711,TD kit,150,300,150,1,00144,India
706609,2023-05-06,710,geometry box,100,150,50,2,00144,India
706609,2023-05-06,705,stencil,10,20,10,2,00144,India
719230,2023-05-06,710,geometry box,100,150,50,2,00394,India
719230,2023-05-06,714,carbon paper,15,30,15,1,00394,India
719230,2023-05-06,707,marker,20,40,20,1,00394,India
719230,2023-05-06,713,ball pen,5,10,5,2,00394,India
529469,2023-05-06,707,marker,20,40,20,1,00393,India
529469,2023-05-06,705,stencil,10,20,10,2,00393,India
762075,2023-05-06,714,carbon paper,15,30,15,1,00048,India
526051,2023-05-06,714,carbon paper,15,30,15,1,00457,India
731559,2023-05-06,710,geometry box,100,150,50,2,00204,India
731559,2023-05-06,712,graph paper,20,40,20,1,00204,India
390305,2023-05-06,701,gel pen,5,10,5,2,00167,India
390305,2023-05-06,714,carbon paper,15,30,15,1,00167,India
722503,2023-05-06,712,graph paper,20,40,20,1,00036,India
722503,2023-05-06,711,TD kit,150,300,150,1,00036,India
722503,2023-05-06,709,notebook,30,60,30,2,00036,India
149291,2023-05-06,712,graph paper,20,40,20,1,00061,India
149291,2023-05-06,710,geometry box,100,150,50,2,00061,India
149291,2023-05-06,706,sharpener,3,8,5,2,00061,India
595528,2023-05-06,714,carbon paper,15,30,15,1,00013,India
595528,2023-05-06,704,scale,5,10,5,2,00013,India
595528,2023-05-06,707,marker,20,40,20,1,00013,India
798661,2023-05-06,710,geometry box,100,150,50,2,00133,India
649887,2023-05-06,701,gel pen,5,10,5,2,00245,India
136997,2023-05-06,706,sharpener,3,8,5,2,00374,India
136997,2023-05-06,715,folder,5,15,10,1,00374,India
901760,2023-05-06,704,scale,5,10,5,2,00495,India
713061,2023-05-06,705,stencil,10,20,10,2,00317,India
713061,2023-05-06,707,marker,20,40,20,1,00317,India
713061,2023-05-06,701,gel pen,5,10,5,2,00317,India
454959,2023-05-06,703,eraser,1,3,2,2,00397,India
110295,2023-05-06,714,carbon paper,15,30,15,1,00070,India
798674,2023-05-06,711,TD kit,150,300,150,1,00076,India
798674,2023-05-06,710,geometry box,100,150,50,2,00076,India
798674,2023-05-06,713,ball pen,5,10,5,2,00076,India
798674,2023-05-06,703,eraser,1,3,2,2,00076,India
351489,2023-05-06,702,pencil,2,5,3,2,00216,India
351489,2023-05-06,705,stencil,10,20,10,2,00216,India
351489,2023-05-06,703,eraser,1,3,2,2,00216,India
351489,2023-05-06,712,graph paper,20,40,20,1,00216,India
550100,2023-05-06,714,carbon paper,15,30,15,1,00154,India
550100,2023-05-06,708,sketchpen,15,40,25,1,00154,India
648765,2023-05-07,710,geometry box,100,150,50,2,00085,India
648765,2023-05-07,705,stencil,10,20,10,2,00085,India
648765,2023-05-07,711,TD kit,150,300,150,1,00085,India
439755,2023-05-07,705,stencil,10,20,10,2,00037,India
439755,2023-05-07,704,scale,5,10,5,2,00037,India
439755,2023-05-07,702,pencil,2,5,3,2,00037,India
439755,2023-05-07,711,TD kit,150,300,150,1,00037,India
439755,2023-05-07,713,ball pen,5,10,5,2,00037,India
825552,2023-05-07,702,pencil,2,5,3,2,00433,India
825552,2023-05-07,707,marker,20,40,20,1,00433,India
825552,2023-05-07,715,folder,5,15,10,1,00433,India
825552,2023-05-07,706,sharpener,3,8,5,2,00433,India
825552,2023-05-07,717,spiral bound book,50,100,50,1,00433,India
342670,2023-05-07,709,notebook,30,60,30,2,00175,India
342670,2023-05-07,701,gel pen,5,10,5,2,00175,India
342670,2023-05-07,707,marker,20,40,20,1,00175,India
342670,2023-05-07,715,folder,5,15,10,1,00175,India
163637,2023-05-07,704,scale,5,10,5,2,00280,India
625086,2023-05-07,711,TD kit,150,300,150,1,00493,India
625086,2023-05-07,713,ball pen,5,10,5,2,00493,India
115561,2023-05-07,705,stencil,10,20,10,2,00050,India
115561,2023-05-07,714,carbon paper,15,30,15,1,00050,India
115561,2023-05-07,710,geometry box,100,150,50,2,00050,India
897091,2023-05-07,712,graph paper,20,40,20,1,00419,India
897091,2023-05-07,704,scale,5,10,5,2,00419,India
897091,2023-05-07,707,marker,20,40,20,1,00419,India
897091,2023-05-07,710,geometry box,100,150,50,2,00419,India
108824,2023-05-07,715,folder,5,15,10,1,00487,India
108824,2023-05-07,704,scale,5,10,5,2,00487,India
392511,2023-05-07,714,carbon paper,15,30,15,1,00498,India
392511,2023-05-07,711,TD kit,150,300,150,1,00498,India
392511,2023-05-07,712,graph paper,20,40,20,1,00498,India
560105,2023-05-07,712,graph paper,20,40,20,1,00107,India
560105,2023-05-07,716,printing paper,200,400,200,1,00107,India
560105,2023-05-07,707,marker,20,40,20,1,00107,India
792529,2023-05-07,704,scale,5,10,5,2,00180,India
934636,2023-05-07,711,TD kit,150,300,150,1,00102,India
934636,2023-05-07,713,ball pen,5,10,5,2,00102,India
934636,2023-05-07,706,sharpener,3,8,5,2,00102,India
934636,2023-05-07,703,eraser,1,3,2,2,00102,India
934636,2023-05-07,704,scale,5,10,5,2,00102,India
798698,2023-05-07,708,sketchpen,15,40,25,1,00459,India
798698,2023-05-07,705,stencil,10,20,10,2,00459,India
363012,2023-05-07,713,ball pen,5,10,5,2,00462,India
343230,2023-05-07,702,pencil,2,5,3,2,00205,India
620129,2023-05-07,717,spiral bound book,50,100,50,1,00070,India
620129,2023-05-07,705,stencil,10,20,10,2,00070,India
620129,2023-05-07,711,TD kit,150,300,150,1,00070,India
620129,2023-05-07,703,eraser,1,3,2,2,00070,India
940121,2023-05-07,702,pencil,2,5,3,2,00300,India
799645,2023-05-07,715,folder,5,15,10,1,00464,India
799645,2023-05-07,703,eraser,1,3,2,2,00464,India
734034,2023-05-07,701,gel pen,5,10,5,2,00144,India
734034,2023-05-07,706,sharpener,3,8,5,2,00144,India
270738,2023-05-07,716,printing paper,200,400,200,1,00162,India
270738,2023-05-07,706,sharpener,3,8,5,2,00162,India
313306,2023-05-07,717,spiral bound book,50,100,50,1,00392,India
846818,2023-05-07,702,pencil,2,5,3,2,00261,India
235777,2023-05-07,717,spiral bound book,50,100,50,1,00283,India
235777,2023-05-07,716,printing paper,200,400,200,1,00283,India
779745,2023-05-07,716,printing paper,200,400,200,1,00254,India
779745,2023-05-07,710,geometry box,100,150,50,2,00254,India
795179,2023-05-07,713,ball pen,5,10,5,2,00296,India
795179,2023-05-07,707,marker,20,40,20,1,00296,India
795179,2023-05-07,711,TD kit,150,300,150,1,00296,India
795179,2023-05-07,705,stencil,10,20,10,2,00296,India
160059,2023-05-07,707,marker,20,40,20,1,00341,India
160059,2023-05-07,708,sketchpen,15,40,25,1,00341,India
656658,2023-05-07,707,marker,20,40,20,1,00216,India
756550,2023-05-07,709,notebook,30,60,30,2,00286,India
498296,2023-05-07,707,marker,20,40,20,1,00184,India
498296,2023-05-07,706,sharpener,3,8,5,2,00184,India
498296,2023-05-07,717,spiral bound book,50,100,50,1,00184,India
576317,2023-05-07,708,sketchpen,15,40,25,1,00165,India
616207,2023-05-07,711,TD kit,150,300,150,1,00095,India
616207,2023-05-07,701,gel pen,5,10,5,2,00095,India
616207,2023-05-07,716,printing paper,200,400,200,1,00095,India
616207,2023-05-07,717,spiral bound book,50,100,50,1,00095,India
743317,2023-05-07,711,TD kit,150,300,150,1,00289,India
743317,2023-05-07,716,printing paper,200,400,200,1,00289,India
743317,2023-05-07,709,notebook,30,60,30,2,00289,India
743317,2023-05-07,706,sharpener,3,8,5,2,00289,India
384096,2023-05-07,703,eraser,1,3,2,2,00024,India
384096,2023-05-07,709,notebook,30,60,30,2,00024,India
101927,2023-05-07,711,TD kit,150,300,150,1,00133,India
101927,2023-05-07,702,pencil,2,5,3,2,00133,India
101927,2023-05-07,709,notebook,30,60,30,2,00133,India
885983,2023-05-08,707,marker,20,40,20,1,00352,India
885983,2023-05-08,712,graph paper,20,40,20,1,00352,India
885983,2023-05-08,706,sharpener,3,8,5,2,00352,India
885983,2023-05-08,716,printing paper,200,400,200,1,00352,India
885983,2023-05-08,710,geometry box,100,150,50,2,00352,India
625010,2023-05-08,717,spiral bound book,50,100,50,1,00110,India
625010,2023-05-08,716,printing paper,200,400,200,1,00110,India
625010,2023-05-08,704,scale,5,10,5,2,00110,India
119278,2023-05-08,709,notebook,30,60,30,2,00485,India
119278,2023-05-08,716,printing paper,200,400,200,1,00485,India
119278,2023-05-08,706,sharpener,3,8,5,2,00485,India
119278,2023-05-08,717,spiral bound book,50,100,50,1,00485,India
119278,2023-05-08,714,carbon paper,15,30,15,1,00485,India
866483,2023-05-08,711,TD kit,150,300,150,1,00051,India
775894,2023-05-08,701,gel pen,5,10,5,2,00426,India
507119,2023-05-08,715,folder,5,15,10,1,00199,India
507119,2023-05-08,711,TD kit,150,300,150,1,00199,India
507119,2023-05-08,714,carbon paper,15,30,15,1,00199,India
507119,2023-05-08,707,marker,20,40,20,1,00199,India
507119,2023-05-08,702,pencil,2,5,3,2,00199,India
379338,2023-05-08,703,eraser,1,3,2,2,00402,India
379338,2023-05-08,716,printing paper,200,400,200,1,00402,India
379338,2023-05-08,710,geometry box,100,150,50,2,00402,India
379338,2023-05-08,712,graph paper,20,40,20,1,00402,India
379338,2023-05-08,705,stencil,10,20,10,2,00402,India
379783,2023-05-08,713,ball pen,5,10,5,2,00063,India
379783,2023-05-08,717,spiral bound book,50,100,50,1,00063,India
379783,2023-05-08,714,carbon paper,15,30,15,1,00063,India
379783,2023-05-08,710,geometry box,100,150,50,2,00063,India
892533,2023-05-08,703,eraser,1,3,2,2,00421,India
892533,2023-05-08,706,sharpener,3,8,5,2,00421,India
892533,2023-05-08,713,ball pen,5,10,5,2,00421,India
447255,2023-05-08,705,stencil,10,20,10,2,00244,India
297095,2023-05-08,703,eraser,1,3,2,2,00028,India
944131,2023-05-08,714,carbon paper,15,30,15,1,00267,India
944131,2023-05-08,715,folder,5,15,10,1,00267,India
944131,2023-05-08,706,sharpener,3,8,5,2,00267,India
596282,2023-05-08,715,folder,5,15,10,1,00279,India
596282,2023-05-08,702,pencil,2,5,3,2,00279,India
596282,2023-05-08,708,sketchpen,15,40,25,1,00279,India
787410,2023-05-08,715,folder,5,15,10,1,00119,India
787410,2023-05-08,708,sketchpen,15,40,25,1,00119,India
603508,2023-05-08,716,printing paper,200,400,200,1,00413,India
345014,2023-05-08,716,printing paper,200,400,200,1,00177,India
345014,2023-05-08,703,eraser,1,3,2,2,00177,India
345014,2023-05-08,702,pencil,2,5,3,2,00177,India
494770,2023-05-08,715,folder,5,15,10,1,00030,India
494770,2023-05-08,712,graph paper,20,40,20,1,00030,India
119531,2023-05-08,715,folder,5,15,10,1,00072,India
119531,2023-05-08,707,marker,20,40,20,1,00072,India
119531,2023-05-08,706,sharpener,3,8,5,2,00072,India
750024,2023-05-08,704,scale,5,10,5,2,00165,India
750024,2023-05-08,717,spiral bound book,50,100,50,1,00165,India
750024,2023-05-08,716,printing paper,200,400,200,1,00165,India
957741,2023-05-08,702,pencil,2,5,3,2,00304,India
188678,2023-05-08,706,sharpener,3,8,5,2,00191,India
188678,2023-05-08,708,sketchpen,15,40,25,1,00191,India
188678,2023-05-08,702,pencil,2,5,3,2,00191,India
269019,2023-05-08,715,folder,5,15,10,1,00389,India
269019,2023-05-08,702,pencil,2,5,3,2,00389,India
269019,2023-05-08,711,TD kit,150,300,150,1,00389,India
106938,2023-05-08,702,pencil,2,5,3,2,00444,India
106938,2023-05-08,705,stencil,10,20,10,2,00444,India
777808,2023-05-08,716,printing paper,200,400,200,1,00400,India
777808,2023-05-08,701,gel pen,5,10,5,2,00400,India
295555,2023-05-08,704,scale,5,10,5,2,00250,India
295555,2023-05-08,706,sharpener,3,8,5,2,00250,India
295555,2023-05-08,713,ball pen,5,10,5,2,00250,India
374117,2023-05-08,715,folder,5,15,10,1,00382,India
198781,2023-05-08,702,pencil,2,5,3,2,00109,India
303651,2023-05-08,711,TD kit,150,300,150,1,00455,India
303651,2023-05-08,702,pencil,2,5,3,2,00455,India
303651,2023-05-08,709,notebook,30,60,30,2,00455,India
303651,2023-05-08,716,printing paper,200,400,200,1,00455,India
691964,2023-05-08,709,notebook,30,60,30,2,00178,India
691964,2023-05-08,713,ball pen,5,10,5,2,00178,India
879308,2023-05-08,702,pencil,2,5,3,2,00275,India
879308,2023-05-08,708,sketchpen,15,40,25,1,00275,India
544012,2023-05-08,701,gel pen,5,10,5,2,00406,India
544012,2023-05-08,708,sketchpen,15,40,25,1,00406,India
360354,2023-05-08,703,eraser,1,3,2,2,00080,India
969032,2023-05-08,707,marker,20,40,20,1,00320,India
969032,2023-05-08,713,ball pen,5,10,5,2,00320,India
969032,2023-05-08,715,folder,5,15,10,1,00320,India
538176,2023-05-08,707,marker,20,40,20,1,00211,India
538176,2023-05-08,717,spiral bound book,50,100,50,1,00211,India
538176,2023-05-08,711,TD kit,150,300,150,1,00211,India
538176,2023-05-08,703,eraser,1,3,2,2,00211,India
459621,2023-05-09,706,sharpener,3,8,5,2,00080,India
459621,2023-05-09,709,notebook,30,60,30,2,00080,India
459621,2023-05-09,713,ball pen,5,10,5,2,00080,India
788406,2023-05-09,707,marker,20,40,20,1,00175,India
788406,2023-05-09,716,printing paper,200,400,200,1,00175,India
293835,2023-05-09,701,gel pen,5,10,5,2,00056,India
293835,2023-05-09,713,ball pen,5,10,5,2,00056,India
293835,2023-05-09,712,graph paper,20,40,20,1,00056,India
293835,2023-05-09,715,folder,5,15,10,1,00056,India
551356,2023-05-09,715,folder,5,15,10,1,00479,India
551356,2023-05-09,702,pencil,2,5,3,2,00479,India
551356,2023-05-09,709,notebook,30,60,30,2,00479,India
551356,2023-05-09,712,graph paper,20,40,20,1,00479,India
551356,2023-05-09,701,gel pen,5,10,5,2,00479,India
590908,2023-05-09,704,scale,5,10,5,2,00252,India
590908,2023-05-09,703,eraser,1,3,2,2,00252,India
590908,2023-05-09,702,pencil,2,5,3,2,00252,India
590908,2023-05-09,715,folder,5,15,10,1,00252,India
960885,2023-05-09,704,scale,5,10,5,2,00026,India
960885,2023-05-09,706,sharpener,3,8,5,2,00026,India
615801,2023-05-09,701,gel pen,5,10,5,2,00323,India
117367,2023-05-09,701,gel pen,5,10,5,2,00447,India
117367,2023-05-09,707,marker,20,40,20,1,00447,India
906527,2023-05-09,708,sketchpen,15,40,25,1,00055,India
136679,2023-05-09,715,folder,5,15,10,1,00486,India
136679,2023-05-09,705,stencil,10,20,10,2,00486,India
695056,2023-05-09,704,scale,5,10,5,2,00182,India
695056,2023-05-09,701,gel pen,5,10,5,2,00182,India
446761,2023-05-09,708,sketchpen,15,40,25,1,00371,India
826676,2023-05-09,707,marker,20,40,20,1,00337,India
826676,2023-05-09,708,sketchpen,15,40,25,1,00337,India
779297,2023-05-09,713,ball pen,5,10,5,2,00077,India
779297,2023-05-09,717,spiral bound book,50,100,50,1,00077,India
779297,2023-05-09,705,stencil,10,20,10,2,00077,India
779297,2023-05-09,709,notebook,30,60,30,2,00077,India
628176,2023-05-09,715,folder,5,15,10,1,00120,India
628176,2023-05-09,713,ball pen,5,10,5,2,00120,India
628176,2023-05-09,716,printing paper,200,400,200,1,00120,India
830736,2023-05-09,701,gel pen,5,10,5,2,00188,India
532234,2023-05-09,713,ball pen,5,10,5,2,00313,India
532234,2023-05-09,712,graph paper,20,40,20,1,00313,India
858472,2023-05-09,704,scale,5,10,5,2,00332,India
858472,2023-05-09,708,sketchpen,15,40,25,1,00332,India
810158,2023-05-09,707,marker,20,40,20,1,00418,India
446773,2023-05-09,716,printing paper,200,400,200,1,00064,India
446773,2023-05-09,711,TD kit,150,300,150,1,00064,India
446773,2023-05-09,715,folder,5,15,10,1,00064,India
356719,2023-05-09,712,graph paper,20,40,20,1,00119,India
227925,2023-05-09,712,graph paper,20,40,20,1,00055,India
227925,2023-05-09,706,sharpener,3,8,5,2,00055,India
227925,2023-05-09,715,folder,5,15,10,1,00055,India
227925,2023-05-09,713,ball pen,5,10,5,2,00055,India
204046,2023-05-09,712,graph paper,20,40,20,1,00328,India
204046,2023-05-09,702,pencil,2,5,3,2,00328,India
204046,2023-05-09,715,folder,5,15,10,1,00328,India
204046,2023-05-09,709,notebook,30,60,30,2,00328,India
204046,2023-05-09,707,marker,20,40,20,1,00328,India
865577,2023-05-09,710,geometry box,100,150,50,2,00488,India
865577,2023-05-09,713,ball pen,5,10,5,2,00488,India
865577,2023-05-09,711,TD kit,150,300,150,1,00488,India
363650,2023-05-09,704,scale,5,10,5,2,00096,India
363650,2023-05-09,708,sketchpen,15,40,25,1,00096,India
966323,2023-05-09,701,gel pen,5,10,5,2,00444,India
966323,2023-05-09,704,scale,5,10,5,2,00444,India
966323,2023-05-09,712,graph paper,20,40,20,1,00444,India
966323,2023-05-09,711,TD kit,150,300,150,1,00444,India
528619,2023-05-09,717,spiral bound book,50,100,50,1,00342,India
528619,2023-05-09,712,graph paper,20,40,20,1,00342,India
148269,2023-05-09,709,notebook,30,60,30,2,00369,India
148269,2023-05-09,710,geometry box,100,150,50,2,00369,India
148269,2023-05-09,712,graph paper,20,40,20,1,00369,India
148269,2023-05-09,717,spiral bound book,50,100,50,1,00369,India
133456,2023-05-09,704,scale,5,10,5,2,00202,India
133456,2023-05-09,702,pencil,2,5,3,2,00202,India
133456,2023-05-09,717,spiral bound book,50,100,50,1,00202,India
133456,2023-05-09,709,notebook,30,60,30,2,00202,India
864711,2023-05-09,714,carbon paper,15,30,15,1,00077,India
864711,2023-05-09,713,ball pen,5,10,5,2,00077,India
864711,2023-05-09,705,stencil,10,20,10,2,00077,India
972234,2023-05-09,708,sketchpen,15,40,25,1,00272,India
972234,2023-05-09,705,stencil,10,20,10,2,00272,India
972234,2023-05-09,717,spiral bound book,50,100,50,1,00272,India
972234,2023-05-09,709,notebook,30,60,30,2,00272,India
841159,2023-05-09,709,notebook,30,60,30,2,00392,India
841159,2023-05-09,713,ball pen,5,10,5,2,00392,India
841159,2023-05-09,717,spiral bound book,50,100,50,1,00392,India
990806,2023-05-09,716,printing paper,200,400,200,1,00292,India
990806,2023-05-09,703,eraser,1,3,2,2,00292,India
990806,2023-05-09,712,graph paper,20,40,20,1,00292,India
583033,2023-05-09,711,TD kit,150,300,150,1,00431,India
583033,2023-05-09,704,scale,5,10,5,2,00431,India
501737,2023-05-09,710,geometry box,100,150,50,2,00350,India
601465,2023-05-09,702,pencil,2,5,3,2,00152,India
601465,2023-05-09,712,graph paper,20,40,20,1,00152,India
573263,2023-05-09,715,folder,5,15,10,1,00059,India
573263,2023-05-09,708,sketchpen,15,40,25,1,00059,India
573263,2023-05-09,714,carbon paper,15,30,15,1,00059,India
321240,2023-05-09,704,scale,5,10,5,2,00151,India
321240,2023-05-09,707,marker,20,40,20,1,00151,India
321240,2023-05-09,706,sharpener,3,8,5,2,00151,India
422138,2023-05-09,704,scale,5,10,5,2,00301,India
422138,2023-05-09,706,sharpener,3,8,5,2,00301,India
707871,2023-05-09,713,ball pen,5,10,5,2,00118,India
707871,2023-05-09,712,graph paper,20,40,20,1,00118,India
707871,2023-05-09,704,scale,5,10,5,2,00118,India
317026,2023-05-09,715,folder,5,15,10,1,00045,India
317026,2023-05-09,707,marker,20,40,20,1,00045,India
317026,2023-05-09,717,spiral bound book,50,100,50,1,00045,India
444173,2023-05-09,709,notebook,30,60,30,2,00044,India
444173,2023-05-09,713,ball pen,5,10,5,2,00044,India
444173,2023-05-09,704,scale,5,10,5,2,00044,India
444173,2023-05-09,716,printing paper,200,400,200,1,00044,India
667523,2023-05-09,706,sharpener,3,8,5,2,00319,India
667523,2023-05-09,703,eraser,1,3,2,2,00319,India
541680,2023-05-09,702,pencil,2,5,3,2,00101,India
541680,2023-05-09,716,printing paper,200,400,200,1,00101,India
658799,2023-05-09,707,marker,20,40,20,1,00096,India
658799,2023-05-09,709,notebook,30,60,30,2,00096,India
658799,2023-05-09,713,ball pen,5,10,5,2,00096,India
658799,2023-05-09,714,carbon paper,15,30,15,1,00096,India
927107,2023-05-09,702,pencil,2,5,3,2,00119,India
927107,2023-05-09,705,stencil,10,20,10,2,00119,India
927107,2023-05-09,709,notebook,30,60,30,2,00119,India
383829,2023-05-09,716,printing paper,200,400,200,1,00283,India
383829,2023-05-09,702,pencil,2,5,3,2,00283,India
383829,2023-05-09,703,eraser,1,3,2,2,00283,India
383829,2023-05-09,715,folder,5,15,10,1,00283,India
383829,2023-05-09,714,carbon paper,15,30,15,1,00283,India
299919,2023-05-09,714,carbon paper,15,30,15,1,00422,India
299919,2023-05-09,709,notebook,30,60,30,2,00422,India
299919,2023-05-09,717,spiral bound book,50,100,50,1,00422,India
173507,2023-05-09,703,eraser,1,3,2,2,00041,India
173507,2023-05-09,708,sketchpen,15,40,25,1,00041,India
173507,2023-05-09,713,ball pen,5,10,5,2,00041,India
173507,2023-05-09,714,carbon paper,15,30,15,1,00041,India
695911,2023-05-09,705,stencil,10,20,10,2,00463,India
757442,2023-05-10,716,printing paper,200,400,200,1,00352,India
757442,2023-05-10,704,scale,5,10,5,2,00352,India
757442,2023-05-10,713,ball pen,5,10,5,2,00352,India
757442,2023-05-10,707,marker,20,40,20,1,00352,India
713227,2023-05-10,701,gel pen,5,10,5,2,00059,India
713227,2023-05-10,713,ball pen,5,10,5,2,00059,India
713227,2023-05-10,702,pencil,2,5,3,2,00059,India
645638,2023-05-10,715,folder,5,15,10,1,00297,India
348039,2023-05-10,717,spiral bound book,50,100,50,1,00115,India
348039,2023-05-10,709,notebook,30,60,30,2,00115,India
348039,2023-05-10,715,folder,5,15,10,1,00115,India
486190,2023-05-10,715,folder,5,15,10,1,00177,India
497372,2023-05-10,704,scale,5,10,5,2,00321,India
497372,2023-05-10,706,sharpener,3,8,5,2,00321,India
497372,2023-05-10,711,TD kit,150,300,150,1,00321,India
154851,2023-05-10,714,carbon paper,15,30,15,1,00393,India
154851,2023-05-10,713,ball pen,5,10,5,2,00393,India
154851,2023-05-10,710,geometry box,100,150,50,2,00393,India
154851,2023-05-10,709,notebook,30,60,30,2,00393,India
148718,2023-05-10,708,sketchpen,15,40,25,1,00022,India
148718,2023-05-10,705,stencil,10,20,10,2,00022,India
148718,2023-05-10,713,ball pen,5,10,5,2,00022,India
148718,2023-05-10,704,scale,5,10,5,2,00022,India
359030,2023-05-10,714,carbon paper,15,30,15,1,00300,India
359030,2023-05-10,715,folder,5,15,10,1,00300,India
359030,2023-05-10,712,graph paper,20,40,20,1,00300,India
359030,2023-05-10,706,sharpener,3,8,5,2,00300,India
359030,2023-05-10,708,sketchpen,15,40,25,1,00300,India
820621,2023-05-10,702,pencil,2,5,3,2,00187,India
820621,2023-05-10,705,stencil,10,20,10,2,00187,India
458932,2023-05-10,715,folder,5,15,10,1,00342,India
458932,2023-05-10,716,printing paper,200,400,200,1,00342,India
779297,2023-05-10,708,sketchpen,15,40,25,1,00077,India
779297,2023-05-10,709,notebook,30,60,30,2,00077,India
779297,2023-05-10,710,geometry box,100,150,50,2,00077,India
422612,2023-05-10,714,carbon paper,15,30,15,1,00494,India
422612,2023-05-10,703,eraser,1,3,2,2,00494,India
422612,2023-05-10,710,geometry box,100,150,50,2,00494,India
422612,2023-05-10,701,gel pen,5,10,5,2,00494,India
507233,2023-05-10,703,eraser,1,3,2,2,00321,India
507233,2023-05-10,716,printing paper,200,400,200,1,00321,India
507233,2023-05-10,712,graph paper,20,40,20,1,00321,India
830289,2023-05-10,717,spiral bound book,50,100,50,1,00033,India
830289,2023-05-10,716,printing paper,200,400,200,1,00033,India
830289,2023-05-10,701,gel pen,5,10,5,2,00033,India
830289,2023-05-10,709,notebook,30,60,30,2,00033,India
621652,2023-05-10,716,printing paper,200,400,200,1,00417,India
621652,2023-05-10,705,stencil,10,20,10,2,00417,India
621652,2023-05-10,715,folder,5,15,10,1,00417,India
621652,2023-05-10,710,geometry box,100,150,50,2,00417,India
727911,2023-05-10,706,sharpener,3,8,5,2,00204,India
727911,2023-05-10,703,eraser,1,3,2,2,00204,India
747713,2023-05-10,708,sketchpen,15,40,25,1,00454,India
747713,2023-05-10,704,scale,5,10,5,2,00454,India
747713,2023-05-10,707,marker,20,40,20,1,00454,India
747713,2023-05-10,716,printing paper,200,400,200,1,00454,India
144196,2023-05-10,701,gel pen,5,10,5,2,00259,India
190522,2023-05-10,703,eraser,1,3,2,2,00483,India
190522,2023-05-10,711,TD kit,150,300,150,1,00483,India
961864,2023-05-10,708,sketchpen,15,40,25,1,00221,India
961864,2023-05-10,715,folder,5,15,10,1,00221,India
810404,2023-05-10,702,pencil,2,5,3,2,00329,India
810404,2023-05-10,715,folder,5,15,10,1,00329,India
810404,2023-05-10,705,stencil,10,20,10,2,00329,India
983711,2023-05-10,714,carbon paper,15,30,15,1,00008,India
983711,2023-05-10,706,sharpener,3,8,5,2,00008,India
275358,2023-05-10,712,graph paper,20,40,20,1,00264,India
798635,2023-05-10,714,carbon paper,15,30,15,1,00240,India
798635,2023-05-10,702,pencil,2,5,3,2,00240,India
798635,2023-05-10,706,sharpener,3,8,5,2,00240,India
798635,2023-05-10,713,ball pen,5,10,5,2,00240,India
486987,2023-05-10,703,eraser,1,3,2,2,00049,India
486987,2023-05-10,713,ball pen,5,10,5,2,00049,India
486987,2023-05-10,714,carbon paper,15,30,15,1,00049,India
486987,2023-05-10,716,printing paper,200,400,200,1,00049,India
290759,2023-05-10,716,printing paper,200,400,200,1,00417,India
290759,2023-05-10,715,folder,5,15,10,1,00417,India
290759,2023-05-10,712,graph paper,20,40,20,1,00417,India
290759,2023-05-10,713,ball pen,5,10,5,2,00417,India
740335,2023-05-10,704,scale,5,10,5,2,00153,India
566798,2023-05-10,712,graph paper,20,40,20,1,00451,India
566798,2023-05-10,708,sketchpen,15,40,25,1,00451,India
566798,2023-05-10,703,eraser,1,3,2,2,00451,India
970543,2023-05-10,706,sharpener,3,8,5,2,00241,India
970543,2023-05-10,715,folder,5,15,10,1,00241,India
970543,2023-05-10,707,marker,20,40,20,1,00241,India
282434,2023-05-10,709,notebook,30,60,30,2,00108,India
282434,2023-05-10,716,printing paper,200,400,200,1,00108,India
827665,2023-05-10,704,scale,5,10,5,2,00480,India
154047,2023-05-10,717,spiral bound book,50,100,50,1,00234,India
154047,2023-05-10,711,TD kit,150,300,150,1,00234,India
154047,2023-05-10,715,folder,5,15,10,1,00234,India
480208,2023-05-10,702,pencil,2,5,3,2,00394,India
984542,2023-05-10,701,gel pen,5,10,5,2,00066,India
984542,2023-05-10,711,TD kit,150,300,150,1,00066,India
925923,2023-05-10,708,sketchpen,15,40,25,1,00039,India
925923,2023-05-10,712,graph paper,20,40,20,1,00039,India
925923,2023-05-10,701,gel pen,5,10,5,2,00039,India
925923,2023-05-10,706,sharpener,3,8,5,2,00039,India
925923,2023-05-10,714,carbon paper,15,30,15,1,00039,India
645751,2023-05-10,714,carbon paper,15,30,15,1,00092,India
645751,2023-05-10,706,sharpener,3,8,5,2,00092,India
651100,2023-05-10,704,scale,5,10,5,2,00113,India
651100,2023-05-10,713,ball pen,5,10,5,2,00113,India
459831,2023-05-11,703,eraser,1,3,2,2,00037,India
995025,2023-05-11,705,stencil,10,20,10,2,00351,India
995025,2023-05-11,712,graph paper,20,40,20,1,00351,India
995025,2023-05-11,703,eraser,1,3,2,2,00351,India
995025,2023-05-11,706,sharpener,3,8,5,2,00351,India
995025,2023-05-11,704,scale,5,10,5,2,00351,India
392504,2023-05-11,709,notebook,30,60,30,2,00371,India
392504,2023-05-11,716,printing paper,200,400,200,1,00371,India
643918,2023-05-11,702,pencil,2,5,3,2,00151,India
643918,2023-05-11,706,sharpener,3,8,5,2,00151,India
643918,2023-05-11,709,notebook,30,60,30,2,00151,India
643918,2023-05-11,716,printing paper,200,400,200,1,00151,India
643918,2023-05-11,704,scale,5,10,5,2,00151,India
661474,2023-05-11,712,graph paper,20,40,20,1,00162,India
661474,2023-05-11,709,notebook,30,60,30,2,00162,India
661474,2023-05-11,707,marker,20,40,20,1,00162,India
661474,2023-05-11,717,spiral bound book,50,100,50,1,00162,India
661474,2023-05-11,701,gel pen,5,10,5,2,00162,India
986769,2023-05-11,710,geometry box,100,150,50,2,00354,India
736997,2023-05-11,709,notebook,30,60,30,2,00269,India
736997,2023-05-11,711,TD kit,150,300,150,1,00269,India
736997,2023-05-11,710,geometry box,100,150,50,2,00269,India
174817,2023-05-11,712,graph paper,20,40,20,1,00243,India
174817,2023-05-11,713,ball pen,5,10,5,2,00243,India
174817,2023-05-11,708,sketchpen,15,40,25,1,00243,India
266913,2023-05-11,710,geometry box,100,150,50,2,00094,India
266913,2023-05-11,705,stencil,10,20,10,2,00094,India
266913,2023-05-11,706,sharpener,3,8,5,2,00094,India
266913,2023-05-11,704,scale,5,10,5,2,00094,India
266913,2023-05-11,711,TD kit,150,300,150,1,00094,India
351017,2023-05-11,701,gel pen,5,10,5,2,00175,India
351017,2023-05-11,703,eraser,1,3,2,2,00175,India
342953,2023-05-11,709,notebook,30,60,30,2,00357,India
342953,2023-05-11,701,gel pen,5,10,5,2,00357,India
454821,2023-05-11,713,ball pen,5,10,5,2,00409,India
454821,2023-05-11,703,eraser,1,3,2,2,00409,India
628042,2023-05-11,703,eraser,1,3,2,2,00359,India
628042,2023-05-11,711,TD kit,150,300,150,1,00359,India
628042,2023-05-11,717,spiral bound book,50,100,50,1,00359,India
628042,2023-05-11,706,sharpener,3,8,5,2,00359,India
499516,2023-05-11,717,spiral bound book,50,100,50,1,00036,India
796499,2023-05-11,714,carbon paper,15,30,15,1,00389,India
796499,2023-05-11,702,pencil,2,5,3,2,00389,India
796499,2023-05-11,713,ball pen,5,10,5,2,00389,India
796499,2023-05-11,707,marker,20,40,20,1,00389,India
210346,2023-05-11,703,eraser,1,3,2,2,00342,India
210346,2023-05-11,716,printing paper,200,400,200,1,00342,India
210346,2023-05-11,701,gel pen,5,10,5,2,00342,India
210346,2023-05-11,704,scale,5,10,5,2,00342,India
210346,2023-05-11,706,sharpener,3,8,5,2,00342,India
371617,2023-05-11,701,gel pen,5,10,5,2,00020,India
371617,2023-05-11,712,graph paper,20,40,20,1,00020,India
371617,2023-05-11,706,sharpener,3,8,5,2,00020,India
371617,2023-05-11,705,stencil,10,20,10,2,00020,India
141074,2023-05-11,707,marker,20,40,20,1,00372,India
141074,2023-05-11,716,printing paper,200,400,200,1,00372,India
141074,2023-05-11,715,folder,5,15,10,1,00372,India
481305,2023-05-11,712,graph paper,20,40,20,1,00232,India
481305,2023-05-11,710,geometry box,100,150,50,2,00232,India
481305,2023-05-11,717,spiral bound book,50,100,50,1,00232,India
165950,2023-05-11,703,eraser,1,3,2,2,00082,India
165950,2023-05-11,702,pencil,2,5,3,2,00082,India
666100,2023-05-11,714,carbon paper,15,30,15,1,00226,India
666100,2023-05-11,716,printing paper,200,400,200,1,00226,India
666100,2023-05-11,703,eraser,1,3,2,2,00226,India
554949,2023-05-11,703,eraser,1,3,2,2,00178,India
554949,2023-05-11,710,geometry box,100,150,50,2,00178,India
554949,2023-05-11,716,printing paper,200,400,200,1,00178,India
563401,2023-05-11,709,notebook,30,60,30,2,00490,India
563401,2023-05-11,712,graph paper,20,40,20,1,00490,India
563401,2023-05-11,711,TD kit,150,300,150,1,00490,India
563401,2023-05-11,701,gel pen,5,10,5,2,00490,India
346189,2023-05-11,714,carbon paper,15,30,15,1,00029,India
346189,2023-05-11,716,printing paper,200,400,200,1,00029,India
346189,2023-05-11,710,geometry box,100,150,50,2,00029,India
346189,2023-05-11,703,eraser,1,3,2,2,00029,India
264384,2023-05-11,714,carbon paper,15,30,15,1,00066,India
264384,2023-05-11,701,gel pen,5,10,5,2,00066,India
963242,2023-05-11,701,gel pen,5,10,5,2,00377,India
963242,2023-05-11,705,stencil,10,20,10,2,00377,India
963242,2023-05-11,717,spiral bound book,50,100,50,1,00377,India
963242,2023-05-11,713,ball pen,5,10,5,2,00377,India
978993,2023-05-11,704,scale,5,10,5,2,00371,India
978993,2023-05-11,716,printing paper,200,400,200,1,00371,India
978993,2023-05-11,717,spiral bound book,50,100,50,1,00371,India
978993,2023-05-11,711,TD kit,150,300,150,1,00371,India
850324,2023-05-11,710,geometry box,100,150,50,2,00263,India
850324,2023-05-11,717,spiral bound book,50,100,50,1,00263,India
850324,2023-05-11,702,pencil,2,5,3,2,00263,India
213676,2023-05-11,701,gel pen,5,10,5,2,00166,India
472397,2023-05-11,706,sharpener,3,8,5,2,00148,India
472397,2023-05-11,709,notebook,30,60,30,2,00148,India
472397,2023-05-11,714,carbon paper,15,30,15,1,00148,India
915496,2023-05-11,716,printing paper,200,400,200,1,00250,India
915496,2023-05-11,703,eraser,1,3,2,2,00250,India
607488,2023-05-11,714,carbon paper,15,30,15,1,00209,India
607488,2023-05-11,702,pencil,2,5,3,2,00209,India
607488,2023-05-11,712,graph paper,20,40,20,1,00209,India
607488,2023-05-11,707,marker,20,40,20,1,00209,India
607488,2023-05-11,717,spiral bound book,50,100,50,1,00209,India
697589,2023-05-11,713,ball pen,5,10,5,2,00052,India
697589,2023-05-11,707,marker,20,40,20,1,00052,India
697589,2023-05-11,717,spiral bound book,50,100,50,1,00052,India
690030,2023-05-11,711,TD kit,150,300,150,1,00291,India
690030,2023-05-11,712,graph paper,20,40,20,1,00291,India
690030,2023-05-11,706,sharpener,3,8,5,2,00291,India
649683,2023-05-11,712,graph paper,20,40,20,1,00014,India
649683,2023-05-11,708,sketchpen,15,40,25,1,00014,India
649683,2023-05-11,713,ball pen,5,10,5,2,00014,India
649683,2023-05-11,716,printing paper,200,400,200,1,00014,India
719863,2023-05-11,715,folder,5,15,10,1,00488,India
834708,2023-05-11,717,spiral bound book,50,100,50,1,00154,India
834708,2023-05-11,702,pencil,2,5,3,2,00154,India
834708,2023-05-11,716,printing paper,200,400,200,1,00154,India
101928,2023-05-12,710,geometry box,100,150,50,2,00369,India
101928,2023-05-12,715,folder,5,15,10,1,00369,India
101928,2023-05-12,703,eraser,1,3,2,2,00369,India
289098,2023-05-12,714,carbon paper,15,30,15,1,00275,India
289098,2023-05-12,715,folder,5,15,10,1,00275,India
289098,2023-05-12,704,scale,5,10,5,2,00275,India
518588,2023-05-12,703,eraser,1,3,2,2,00283,India
518588,2023-05-12,711,TD kit,150,300,150,1,00283,India
314810,2023-05-12,701,gel pen,5,10,5,2,00233,India
314810,2023-05-12,703,eraser,1,3,2,2,00233,India
314810,2023-05-12,708,sketchpen,15,40,25,1,00233,India
314810,2023-05-12,709,notebook,30,60,30,2,00233,India
314810,2023-05-12,707,marker,20,40,20,1,00233,India
325353,2023-05-12,705,stencil,10,20,10,2,00067,India
325353,2023-05-12,703,eraser,1,3,2,2,00067,India
325353,2023-05-12,709,notebook,30,60,30,2,00067,India
325353,2023-05-12,701,gel pen,5,10,5,2,00067,India
764953,2023-05-12,704,scale,5,10,5,2,00093,India
632580,2023-05-12,714,carbon paper,15,30,15,1,00059,India
382961,2023-05-12,702,pencil,2,5,3,2,00110,India
382961,2023-05-12,710,geometry box,100,150,50,2,00110,India
382961,2023-05-12,713,ball pen,5,10,5,2,00110,India
382961,2023-05-12,701,gel pen,5,10,5,2,00110,India
366225,2023-05-12,711,TD kit,150,300,150,1,00404,India
366225,2023-05-12,712,graph paper,20,40,20,1,00404,India
572554,2023-05-12,706,sharpener,3,8,5,2,00180,India
998270,2023-05-12,706,sharpener,3,8,5,2,00489,India
998270,2023-05-12,717,spiral bound book,50,100,50,1,00489,India
998270,2023-05-12,708,sketchpen,15,40,25,1,00489,India
998270,2023-05-12,712,graph paper,20,40,20,1,00489,India
998270,2023-05-12,703,eraser,1,3,2,2,00489,India
792113,2023-05-12,716,printing paper,200,400,200,1,00257,India
302855,2023-05-12,710,geometry box,100,150,50,2,00037,India
791129,2023-05-12,711,TD kit,150,300,150,1,00131,India
791129,2023-05-12,708,sketchpen,15,40,25,1,00131,India
791129,2023-05-12,709,notebook,30,60,30,2,00131,India
791129,2023-05-12,712,graph paper,20,40,20,1,00131,India
791129,2023-05-12,706,sharpener,3,8,5,2,00131,India
683247,2023-05-12,706,sharpener,3,8,5,2,00018,India
857152,2023-05-12,707,marker,20,40,20,1,00074,India
318632,2023-05-12,709,notebook,30,60,30,2,00083,India
318632,2023-05-12,705,stencil,10,20,10,2,00083,India
530523,2023-05-12,717,spiral bound book,50,100,50,1,00239,India
684712,2023-05-12,711,TD kit,150,300,150,1,00176,India
701767,2023-05-12,707,marker,20,40,20,1,00492,India
701767,2023-05-12,711,TD kit,150,300,150,1,00492,India
172285,2023-05-12,701,gel pen,5,10,5,2,00462,India
700168,2023-05-12,703,eraser,1,3,2,2,00385,India
861058,2023-05-12,709,notebook,30,60,30,2,00200,India
861058,2023-05-12,705,stencil,10,20,10,2,00200,India
861058,2023-05-12,702,pencil,2,5,3,2,00200,India
861058,2023-05-12,701,gel pen,5,10,5,2,00200,India
301981,2023-05-12,712,graph paper,20,40,20,1,00487,India
724046,2023-05-12,710,geometry box,100,150,50,2,00252,India
724046,2023-05-12,717,spiral bound book,50,100,50,1,00252,India
599129,2023-05-12,717,spiral bound book,50,100,50,1,00158,India
599129,2023-05-12,708,sketchpen,15,40,25,1,00158,India
599129,2023-05-12,704,scale,5,10,5,2,00158,India
599129,2023-05-12,707,marker,20,40,20,1,00158,India
313249,2023-05-12,706,sharpener,3,8,5,2,00258,India
313249,2023-05-12,717,spiral bound book,50,100,50,1,00258,India
313249,2023-05-12,704,scale,5,10,5,2,00258,India
670043,2023-05-12,709,notebook,30,60,30,2,00183,India
670043,2023-05-12,706,sharpener,3,8,5,2,00183,India
670043,2023-05-12,707,marker,20,40,20,1,00183,India
702215,2023-05-12,707,marker,20,40,20,1,00019,India
702215,2023-05-12,702,pencil,2,5,3,2,00019,India
982344,2023-05-12,714,carbon paper,15,30,15,1,00457,India
982344,2023-05-12,711,TD kit,150,300,150,1,00457,India
982344,2023-05-12,701,gel pen,5,10,5,2,00457,India
982344,2023-05-12,704,scale,5,10,5,2,00457,India
225737,2023-05-12,712,graph paper,20,40,20,1,00282,India
109500,2023-05-12,717,spiral bound book,50,100,50,1,00057,India
109500,2023-05-12,715,folder,5,15,10,1,00057,India
109500,2023-05-12,710,geometry box,100,150,50,2,00057,India
584044,2023-05-12,703,eraser,1,3,2,2,00223,India
616896,2023-05-12,717,spiral bound book,50,100,50,1,00334,India
616896,2023-05-12,709,notebook,30,60,30,2,00334,India
616896,2023-05-12,703,eraser,1,3,2,2,00334,India
616896,2023-05-12,712,graph paper,20,40,20,1,00334,India
616896,2023-05-12,701,gel pen,5,10,5,2,00334,India
110638,2023-05-12,702,pencil,2,5,3,2,00264,India
110638,2023-05-12,712,graph paper,20,40,20,1,00264,India
110638,2023-05-12,717,spiral bound book,50,100,50,1,00264,India
110638,2023-05-12,715,folder,5,15,10,1,00264,India
110638,2023-05-12,710,geometry box,100,150,50,2,00264,India
489920,2023-05-12,717,spiral bound book,50,100,50,1,00395,India
489920,2023-05-12,706,sharpener,3,8,5,2,00395,India
502652,2023-05-12,712,graph paper,20,40,20,1,00149,India
502652,2023-05-12,711,TD kit,150,300,150,1,00149,India
555508,2023-05-12,704,scale,5,10,5,2,00323,India
555508,2023-05-12,717,spiral bound book,50,100,50,1,00323,India
555508,2023-05-12,708,sketchpen,15,40,25,1,00323,India
555508,2023-05-12,710,geometry box,100,150,50,2,00323,India
523629,2023-05-12,706,sharpener,3,8,5,2,00386,India
523629,2023-05-12,711,TD kit,150,300,150,1,00386,India
282406,2023-05-12,715,folder,5,15,10,1,00193,India
783123,2023-05-12,701,gel pen,5,10,5,2,00259,India
783123,2023-05-12,712,graph paper,20,40,20,1,00259,India
783123,2023-05-12,709,notebook,30,60,30,2,00259,India
783123,2023-05-12,708,sketchpen,15,40,25,1,00259,India
783123,2023-05-12,705,stencil,10,20,10,2,00259,India
504233,2023-05-12,703,eraser,1,3,2,2,00088,India
504233,2023-05-12,708,sketchpen,15,40,25,1,00088,India
504233,2023-05-12,711,TD kit,150,300,150,1,00088,India
850252,2023-05-12,709,notebook,30,60,30,2,00098,India
259840,2023-05-12,708,sketchpen,15,40,25,1,00203,India
259840,2023-05-12,717,spiral bound book,50,100,50,1,00203,India
259840,2023-05-12,703,eraser,1,3,2,2,00203,India
259840,2023-05-12,706,sharpener,3,8,5,2,00203,India
104548,2023-05-12,703,eraser,1,3,2,2,00193,India
104548,2023-05-12,714,carbon paper,15,30,15,1,00193,India
104548,2023-05-12,705,stencil,10,20,10,2,00193,India
964257,2023-05-12,712,graph paper,20,40,20,1,00167,India
557916,2023-05-12,713,ball pen,5,10,5,2,00167,India
557916,2023-05-12,712,graph paper,20,40,20,1,00167,India
557916,2023-05-12,714,carbon paper,15,30,15,1,00167,India
558133,2023-05-13,707,marker,20,40,20,1,00292,India
558133,2023-05-13,701,gel pen,5,10,5,2,00292,India
558133,2023-05-13,717,spiral bound book,50,100,50,1,00292,India
558133,2023-05-13,708,sketchpen,15,40,25,1,00292,India
482655,2023-05-13,702,pencil,2,5,3,2,00335,India
993484,2023-05-13,715,folder,5,15,10,1,00123,India
993484,2023-05-13,702,pencil,2,5,3,2,00123,India
892757,2023-05-13,703,eraser,1,3,2,2,00426,India
892757,2023-05-13,708,sketchpen,15,40,25,1,00426,India
892757,2023-05-13,704,scale,5,10,5,2,00426,India
394569,2023-05-13,710,geometry box,100,150,50,2,00394,India
394569,2023-05-13,709,notebook,30,60,30,2,00394,India
402553,2023-05-13,701,gel pen,5,10,5,2,00394,India
402553,2023-05-13,703,eraser,1,3,2,2,00394,India
402553,2023-05-13,712,graph paper,20,40,20,1,00394,India
402553,2023-05-13,717,spiral bound book,50,100,50,1,00394,India
664226,2023-05-13,715,folder,5,15,10,1,00008,India
664226,2023-05-13,717,spiral bound book,50,100,50,1,00008,India
664226,2023-05-13,716,printing paper,200,400,200,1,00008,India
330788,2023-05-13,713,ball pen,5,10,5,2,00071,India
330788,2023-05-13,707,marker,20,40,20,1,00071,India
330788,2023-05-13,708,sketchpen,15,40,25,1,00071,India
607183,2023-05-13,713,ball pen,5,10,5,2,00387,India
476191,2023-05-13,708,sketchpen,15,40,25,1,00310,India
569501,2023-05-13,702,pencil,2,5,3,2,00251,India
569501,2023-05-13,707,marker,20,40,20,1,00251,India
360455,2023-05-13,714,carbon paper,15,30,15,1,00094,India
360455,2023-05-13,711,TD kit,150,300,150,1,00094,India
360455,2023-05-13,703,eraser,1,3,2,2,00094,India
360455,2023-05-13,704,scale,5,10,5,2,00094,India
549172,2023-05-13,707,marker,20,40,20,1,00361,India
312203,2023-05-13,705,stencil,10,20,10,2,00013,India
312203,2023-05-13,706,sharpener,3,8,5,2,00013,India
312203,2023-05-13,701,gel pen,5,10,5,2,00013,India
312203,2023-05-13,704,scale,5,10,5,2,00013,India
350251,2023-05-13,715,folder,5,15,10,1,00064,India
350251,2023-05-13,704,scale,5,10,5,2,00064,India
350251,2023-05-13,702,pencil,2,5,3,2,00064,India
945931,2023-05-13,701,gel pen,5,10,5,2,00086,India
945931,2023-05-13,710,geometry box,100,150,50,2,00086,India
945931,2023-05-13,717,spiral bound book,50,100,50,1,00086,India
945931,2023-05-13,714,carbon paper,15,30,15,1,00086,India
945931,2023-05-13,715,folder,5,15,10,1,00086,India
102916,2023-05-13,713,ball pen,5,10,5,2,00311,India
102916,2023-05-13,712,graph paper,20,40,20,1,00311,India
102916,2023-05-13,714,carbon paper,15,30,15,1,00311,India
102916,2023-05-13,715,folder,5,15,10,1,00311,India
270575,2023-05-13,710,geometry box,100,150,50,2,00426,India
270575,2023-05-13,703,eraser,1,3,2,2,00426,India
270575,2023-05-13,704,scale,5,10,5,2,00426,India
270575,2023-05-13,711,TD kit,150,300,150,1,00426,India
333032,2023-05-13,710,geometry box,100,150,50,2,00309,India
333032,2023-05-13,716,printing paper,200,400,200,1,00309,India
333032,2023-05-13,707,marker,20,40,20,1,00309,India
333032,2023-05-13,704,scale,5,10,5,2,00309,India
605406,2023-05-13,716,printing paper,200,400,200,1,00048,India
605406,2023-05-13,708,sketchpen,15,40,25,1,00048,India
605406,2023-05-13,713,ball pen,5,10,5,2,00048,India
605406,2023-05-13,710,geometry box,100,150,50,2,00048,India
827253,2023-05-13,709,notebook,30,60,30,2,00282,India
827253,2023-05-13,717,spiral bound book,50,100,50,1,00282,India
827253,2023-05-13,716,printing paper,200,400,200,1,00282,India
827253,2023-05-13,704,scale,5,10,5,2,00282,India
156048,2023-05-13,716,printing paper,200,400,200,1,00189,India
156048,2023-05-13,717,spiral bound book,50,100,50,1,00189,India
156048,2023-05-13,702,pencil,2,5,3,2,00189,India
156048,2023-05-13,701,gel pen,5,10,5,2,00189,India
156048,2023-05-13,713,ball pen,5,10,5,2,00189,India
224060,2023-05-13,707,marker,20,40,20,1,00385,India
224060,2023-05-13,715,folder,5,15,10,1,00385,India
224060,2023-05-13,703,eraser,1,3,2,2,00385,India
224060,2023-05-13,710,geometry box,100,150,50,2,00385,India
589758,2023-05-13,701,gel pen,5,10,5,2,00266,India
589758,2023-05-13,708,sketchpen,15,40,25,1,00266,India
589758,2023-05-13,714,carbon paper,15,30,15,1,00266,India
589758,2023-05-13,711,TD kit,150,300,150,1,00266,India
790337,2023-05-13,705,stencil,10,20,10,2,00482,India
664471,2023-05-13,711,TD kit,150,300,150,1,00267,India
664471,2023-05-13,707,marker,20,40,20,1,00267,India
736998,2023-05-13,708,sketchpen,15,40,25,1,00374,India
736998,2023-05-13,702,pencil,2,5,3,2,00374,India
736998,2023-05-13,711,TD kit,150,300,150,1,00374,India
736998,2023-05-13,704,scale,5,10,5,2,00374,India
736998,2023-05-13,709,notebook,30,60,30,2,00374,India
611799,2023-05-13,705,stencil,10,20,10,2,00483,India
611799,2023-05-13,702,pencil,2,5,3,2,00483,India
611799,2023-05-13,711,TD kit,150,300,150,1,00483,India
611799,2023-05-13,706,sharpener,3,8,5,2,00483,India
964082,2023-05-13,707,marker,20,40,20,1,00437,India
215999,2023-05-13,713,ball pen,5,10,5,2,00226,India
215999,2023-05-13,710,geometry box,100,150,50,2,00226,India
215999,2023-05-13,702,pencil,2,5,3,2,00226,India
209465,2023-05-13,712,graph paper,20,40,20,1,00033,India
328367,2023-05-13,706,sharpener,3,8,5,2,00247,India
328367,2023-05-13,711,TD kit,150,300,150,1,00247,India
236716,2023-05-13,717,spiral bound book,50,100,50,1,00070,India
236716,2023-05-13,715,folder,5,15,10,1,00070,India
236716,2023-05-13,707,marker,20,40,20,1,00070,India
236716,2023-05-13,714,carbon paper,15,30,15,1,00070,India
236716,2023-05-13,712,graph paper,20,40,20,1,00070,India
920558,2023-05-13,712,graph paper,20,40,20,1,00274,India
920558,2023-05-13,707,marker,20,40,20,1,00274,India
630540,2023-05-13,709,notebook,30,60,30,2,00480,India
630540,2023-05-13,701,gel pen,5,10,5,2,00480,India
100935,2023-05-13,704,scale,5,10,5,2,00481,India
100935,2023-05-13,713,ball pen,5,10,5,2,00481,India
100935,2023-05-13,710,geometry box,100,150,50,2,00481,India
110128,2023-05-13,708,sketchpen,15,40,25,1,00473,India
110128,2023-05-13,715,folder,5,15,10,1,00473,India
110128,2023-05-13,712,graph paper,20,40,20,1,00473,India
466687,2023-05-13,708,sketchpen,15,40,25,1,00192,India
723856,2023-05-14,717,spiral bound book,50,100,50,1,00218,India
693470,2023-05-14,717,spiral bound book,50,100,50,1,00448,India
693470,2023-05-14,708,sketchpen,15,40,25,1,00448,India
693470,2023-05-14,701,gel pen,5,10,5,2,00448,India
693470,2023-05-14,715,folder,5,15,10,1,00448,India
693470,2023-05-14,702,pencil,2,5,3,2,00448,India
103050,2023-05-14,702,pencil,2,5,3,2,00137,India
103050,2023-05-14,704,scale,5,10,5,2,00137,India
103050,2023-05-14,707,marker,20,40,20,1,00137,India
103050,2023-05-14,706,sharpener,3,8,5,2,00137,India
103050,2023-05-14,713,ball pen,5,10,5,2,00137,India
408340,2023-05-14,704,scale,5,10,5,2,00404,India
408340,2023-05-14,712,graph paper,20,40,20,1,00404,India
408340,2023-05-14,715,folder,5,15,10,1,00404,India
807106,2023-05-14,712,graph paper,20,40,20,1,00106,India
219842,2023-05-14,712,graph paper,20,40,20,1,00114,India
219842,2023-05-14,702,pencil,2,5,3,2,00114,India
383816,2023-05-14,717,spiral bound book,50,100,50,1,00406,India
571335,2023-05-14,717,spiral bound book,50,100,50,1,00361,India
571335,2023-05-14,703,eraser,1,3,2,2,00361,India
571335,2023-05-14,716,printing paper,200,400,200,1,00361,India
571335,2023-05-14,710,geometry box,100,150,50,2,00361,India
472711,2023-05-14,709,notebook,30,60,30,2,00375,India
472711,2023-05-14,708,sketchpen,15,40,25,1,00375,India
472711,2023-05-14,714,carbon paper,15,30,15,1,00375,India
472711,2023-05-14,717,spiral bound book,50,100,50,1,00375,India
472711,2023-05-14,702,pencil,2,5,3,2,00375,India
296265,2023-05-14,703,eraser,1,3,2,2,00099,India
296265,2023-05-14,705,stencil,10,20,10,2,00099,India
296265,2023-05-14,701,gel pen,5,10,5,2,00099,India
296265,2023-05-14,713,ball pen,5,10,5,2,00099,India
567907,2023-05-14,709,notebook,30,60,30,2,00473,India
312213,2023-05-14,713,ball pen,5,10,5,2,00350,India
568496,2023-05-14,701,gel pen,5,10,5,2,00298,India
568496,2023-05-14,713,ball pen,5,10,5,2,00298,India
568496,2023-05-14,710,geometry box,100,150,50,2,00298,India
568496,2023-05-14,703,eraser,1,3,2,2,00298,India
860235,2023-05-14,714,carbon paper,15,30,15,1,00463,India
860235,2023-05-14,712,graph paper,20,40,20,1,00463,India
994153,2023-05-14,701,gel pen,5,10,5,2,00023,India
994153,2023-05-14,717,spiral bound book,50,100,50,1,00023,India
994153,2023-05-14,704,scale,5,10,5,2,00023,India
293362,2023-05-14,716,printing paper,200,400,200,1,00454,India
293362,2023-05-14,711,TD kit,150,300,150,1,00454,India
244818,2023-05-14,705,stencil,10,20,10,2,00213,India
175867,2023-05-14,713,ball pen,5,10,5,2,00449,India
175867,2023-05-14,708,sketchpen,15,40,25,1,00449,India
175867,2023-05-14,709,notebook,30,60,30,2,00449,India
693009,2023-05-14,714,carbon paper,15,30,15,1,00152,India
693009,2023-05-14,707,marker,20,40,20,1,00152,India
693009,2023-05-14,710,geometry box,100,150,50,2,00152,India
693009,2023-05-14,716,printing paper,200,400,200,1,00152,India
101464,2023-05-14,705,stencil,10,20,10,2,00016,India
101464,2023-05-14,713,ball pen,5,10,5,2,00016,India
101464,2023-05-14,709,notebook,30,60,30,2,00016,India
484155,2023-05-14,709,notebook,30,60,30,2,00213,India
484155,2023-05-14,711,TD kit,150,300,150,1,00213,India
484155,2023-05-14,713,ball pen,5,10,5,2,00213,India
484155,2023-05-14,706,sharpener,3,8,5,2,00213,India
484155,2023-05-14,705,stencil,10,20,10,2,00213,India
943282,2023-05-14,708,sketchpen,15,40,25,1,00278,India
943282,2023-05-14,712,graph paper,20,40,20,1,00278,India
943282,2023-05-14,706,sharpener,3,8,5,2,00278,India
178269,2023-05-14,704,scale,5,10,5,2,00483,India
178269,2023-05-14,705,stencil,10,20,10,2,00483,India
178269,2023-05-14,717,spiral bound book,50,100,50,1,00483,India
343990,2023-05-14,717,spiral bound book,50,100,50,1,00178,India
343990,2023-05-14,716,printing paper,200,400,200,1,00178,India
343990,2023-05-14,715,folder,5,15,10,1,00178,India
343990,2023-05-14,710,geometry box,100,150,50,2,00178,India
483651,2023-05-14,705,stencil,10,20,10,2,00093,India
988160,2023-05-14,701,gel pen,5,10,5,2,00433,India
988160,2023-05-14,702,pencil,2,5,3,2,00433,India
988160,2023-05-14,706,sharpener,3,8,5,2,00433,India
988160,2023-05-14,712,graph paper,20,40,20,1,00433,India
893905,2023-05-14,704,scale,5,10,5,2,00053,India
832125,2023-05-14,705,stencil,10,20,10,2,00245,India
832125,2023-05-14,713,ball pen,5,10,5,2,00245,India
832125,2023-05-14,717,spiral bound book,50,100,50,1,00245,India
832125,2023-05-14,707,marker,20,40,20,1,00245,India
832125,2023-05-14,715,folder,5,15,10,1,00245,India
826413,2023-05-14,702,pencil,2,5,3,2,00069,India
826413,2023-05-14,708,sketchpen,15,40,25,1,00069,India
412622,2023-05-14,703,eraser,1,3,2,2,00345,India
207367,2023-05-14,706,sharpener,3,8,5,2,00166,India
207367,2023-05-14,716,printing paper,200,400,200,1,00166,India
207367,2023-05-14,708,sketchpen,15,40,25,1,00166,India
207367,2023-05-14,713,ball pen,5,10,5,2,00166,India
207367,2023-05-14,715,folder,5,15,10,1,00166,India
701715,2023-05-14,710,geometry box,100,150,50,2,00186,India
701715,2023-05-14,711,TD kit,150,300,150,1,00186,India
701715,2023-05-14,717,spiral bound book,50,100,50,1,00186,India
701715,2023-05-14,702,pencil,2,5,3,2,00186,India
377040,2023-05-14,711,TD kit,150,300,150,1,00419,India
377040,2023-05-14,712,graph paper,20,40,20,1,00419,India
377040,2023-05-14,705,stencil,10,20,10,2,00419,India
377040,2023-05-14,702,pencil,2,5,3,2,00419,India
965784,2023-05-14,715,folder,5,15,10,1,00448,India
965784,2023-05-14,705,stencil,10,20,10,2,00448,India
849670,2023-05-14,711,TD kit,150,300,150,1,00057,India
849670,2023-05-14,706,sharpener,3,8,5,2,00057,India
929735,2023-05-14,704,scale,5,10,5,2,00447,India
929735,2023-05-14,713,ball pen,5,10,5,2,00447,India
929735,2023-05-14,705,stencil,10,20,10,2,00447,India
929735,2023-05-14,702,pencil,2,5,3,2,00447,India
548023,2023-05-14,708,sketchpen,15,40,25,1,00270,India
548023,2023-05-14,702,pencil,2,5,3,2,00270,India
548023,2023-05-14,707,marker,20,40,20,1,00270,India
548023,2023-05-14,704,scale,5,10,5,2,00270,India
895719,2023-05-14,706,sharpener,3,8,5,2,00128,India
691145,2023-05-14,717,spiral bound book,50,100,50,1,00071,India
691145,2023-05-14,711,TD kit,150,300,150,1,00071,India
691145,2023-05-14,703,eraser,1,3,2,2,00071,India
458991,2023-05-14,711,TD kit,150,300,150,1,00168,India
306605,2023-05-14,705,stencil,10,20,10,2,00102,India
468409,2023-05-14,714,carbon paper,15,30,15,1,00269,India
468409,2023-05-14,710,geometry box,100,150,50,2,00269,India
468409,2023-05-14,709,notebook,30,60,30,2,00269,India
668976,2023-05-14,716,printing paper,200,400,200,1,00050,India
668976,2023-05-14,704,scale,5,10,5,2,00050,India
668976,2023-05-14,707,marker,20,40,20,1,00050,India
668976,2023-05-14,717,spiral bound book,50,100,50,1,00050,India
761763,2023-05-14,716,printing paper,200,400,200,1,00072,India
761763,2023-05-14,703,eraser,1,3,2,2,00072,India
761763,2023-05-14,714,carbon paper,15,30,15,1,00072,India
761763,2023-05-14,711,TD kit,150,300,150,1,00072,India
106000,2023-05-14,715,folder,5,15,10,1,00150,India
106000,2023-05-14,714,carbon paper,15,30,15,1,00150,India
852526,2023-05-14,715,folder,5,15,10,1,00072,India
852526,2023-05-14,711,TD kit,150,300,150,1,00072,India
326225,2023-05-14,708,sketchpen,15,40,25,1,00324,India
326225,2023-05-14,706,sharpener,3,8,5,2,00324,India
326225,2023-05-14,707,marker,20,40,20,1,00324,India
326225,2023-05-14,716,printing paper,200,400,200,1,00324,India
326225,2023-05-14,714,carbon paper,15,30,15,1,00324,India
146997,2023-05-14,703,eraser,1,3,2,2,00211,India
146997,2023-05-14,705,stencil,10,20,10,2,00211,India
244843,2023-05-14,716,printing paper,200,400,200,1,00043,India
344903,2023-05-15,701,gel pen,5,10,5,2,00018,India
344903,2023-05-15,712,graph paper,20,40,20,1,00018,India
278760,2023-05-15,713,ball pen,5,10,5,2,00310,India
278760,2023-05-15,714,carbon paper,15,30,15,1,00310,India
548314,2023-05-15,708,sketchpen,15,40,25,1,00466,India
548314,2023-05-15,713,ball pen,5,10,5,2,00466,India
548314,2023-05-15,715,folder,5,15,10,1,00466,India
548314,2023-05-15,716,printing paper,200,400,200,1,00466,India
999486,2023-05-15,715,folder,5,15,10,1,00065,India
999486,2023-05-15,713,ball pen,5,10,5,2,00065,India
999486,2023-05-15,703,eraser,1,3,2,2,00065,India
999486,2023-05-15,712,graph paper,20,40,20,1,00065,India
729990,2023-05-15,711,TD kit,150,300,150,1,00014,India
956487,2023-05-15,716,printing paper,200,400,200,1,00177,India
956487,2023-05-15,704,scale,5,10,5,2,00177,India
406697,2023-05-15,701,gel pen,5,10,5,2,00383,India
406697,2023-05-15,702,pencil,2,5,3,2,00383,India
406697,2023-05-15,704,scale,5,10,5,2,00383,India
406697,2023-05-15,708,sketchpen,15,40,25,1,00383,India
369134,2023-05-15,716,printing paper,200,400,200,1,00117,India
369134,2023-05-15,708,sketchpen,15,40,25,1,00117,India
369134,2023-05-15,701,gel pen,5,10,5,2,00117,India
369134,2023-05-15,715,folder,5,15,10,1,00117,India
761780,2023-05-15,704,scale,5,10,5,2,00400,India
761780,2023-05-15,710,geometry box,100,150,50,2,00400,India
761780,2023-05-15,711,TD kit,150,300,150,1,00400,India
867819,2023-05-15,707,marker,20,40,20,1,00497,India
867819,2023-05-15,717,spiral bound book,50,100,50,1,00497,India
344128,2023-05-15,708,sketchpen,15,40,25,1,00135,India
344128,2023-05-15,711,TD kit,150,300,150,1,00135,India
344128,2023-05-15,701,gel pen,5,10,5,2,00135,India
344128,2023-05-15,717,spiral bound book,50,100,50,1,00135,India
691889,2023-05-15,713,ball pen,5,10,5,2,00023,India
691889,2023-05-15,702,pencil,2,5,3,2,00023,India
691889,2023-05-15,704,scale,5,10,5,2,00023,India
862215,2023-05-15,703,eraser,1,3,2,2,00355,India
435891,2023-05-15,703,eraser,1,3,2,2,00344,India
435891,2023-05-15,710,geometry box,100,150,50,2,00344,India
141807,2023-05-15,710,geometry box,100,150,50,2,00034,India
141807,2023-05-15,705,stencil,10,20,10,2,00034,India
141807,2023-05-15,717,spiral bound book,50,100,50,1,00034,India
141807,2023-05-15,704,scale,5,10,5,2,00034,India
716440,2023-05-15,712,graph paper,20,40,20,1,00132,India
716440,2023-05-15,711,TD kit,150,300,150,1,00132,India
764739,2023-05-15,716,printing paper,200,400,200,1,00438,India
764739,2023-05-15,704,scale,5,10,5,2,00438,India
228967,2023-05-15,712,graph paper,20,40,20,1,00398,India
228967,2023-05-15,709,notebook,30,60,30,2,00398,India
228967,2023-05-15,714,carbon paper,15,30,15,1,00398,India
358939,2023-05-15,701,gel pen,5,10,5,2,00107,India
358939,2023-05-15,711,TD kit,150,300,150,1,00107,India
339594,2023-05-15,715,folder,5,15,10,1,00493,India
339594,2023-05-15,709,notebook,30,60,30,2,00493,India
339594,2023-05-15,713,ball pen,5,10,5,2,00493,India
339594,2023-05-15,704,scale,5,10,5,2,00493,India
585134,2023-05-15,716,printing paper,200,400,200,1,00172,India
585134,2023-05-15,705,stencil,10,20,10,2,00172,India
585134,2023-05-15,710,geometry box,100,150,50,2,00172,India
585134,2023-05-15,709,notebook,30,60,30,2,00172,India
585134,2023-05-15,702,pencil,2,5,3,2,00172,India
959100,2023-05-15,712,graph paper,20,40,20,1,00341,India
959100,2023-05-15,706,sharpener,3,8,5,2,00341,India
959100,2023-05-15,705,stencil,10,20,10,2,00341,India
959100,2023-05-15,704,scale,5,10,5,2,00341,India
277164,2023-05-15,714,carbon paper,15,30,15,1,00313,India
277164,2023-05-15,706,sharpener,3,8,5,2,00313,India
849025,2023-05-15,706,sharpener,3,8,5,2,00355,India
849025,2023-05-15,711,TD kit,150,300,150,1,00355,India
849025,2023-05-15,715,folder,5,15,10,1,00355,India
849025,2023-05-15,714,carbon paper,15,30,15,1,00355,India
134914,2023-05-15,715,folder,5,15,10,1,00405,India
134914,2023-05-15,708,sketchpen,15,40,25,1,00405,India
134914,2023-05-15,706,sharpener,3,8,5,2,00405,India
481558,2023-05-15,715,folder,5,15,10,1,00217,India
481558,2023-05-15,705,stencil,10,20,10,2,00217,India
481558,2023-05-15,711,TD kit,150,300,150,1,00217,India
481558,2023-05-15,707,marker,20,40,20,1,00217,India
805709,2023-05-15,712,graph paper,20,40,20,1,00133,India
805709,2023-05-15,707,marker,20,40,20,1,00133,India
174834,2023-05-15,703,eraser,1,3,2,2,00347,India
174834,2023-05-15,711,TD kit,150,300,150,1,00347,India
174834,2023-05-15,704,scale,5,10,5,2,00347,India
553079,2023-05-15,715,folder,5,15,10,1,00347,India
553079,2023-05-15,705,stencil,10,20,10,2,00347,India
553079,2023-05-15,707,marker,20,40,20,1,00347,India
553079,2023-05-15,702,pencil,2,5,3,2,00347,India
362354,2023-05-15,707,marker,20,40,20,1,00236,India
362354,2023-05-15,711,TD kit,150,300,150,1,00236,India
971852,2023-05-15,715,folder,5,15,10,1,00377,India
650611,2023-05-15,714,carbon paper,15,30,15,1,00419,India
650611,2023-05-15,704,scale,5,10,5,2,00419,India
650611,2023-05-15,711,TD kit,150,300,150,1,00419,India
721952,2023-05-15,707,marker,20,40,20,1,00155,India
721952,2023-05-15,712,graph paper,20,40,20,1,00155,India
721952,2023-05-15,703,eraser,1,3,2,2,00155,India
261691,2023-05-15,702,pencil,2,5,3,2,00466,India
261691,2023-05-15,717,spiral bound book,50,100,50,1,00466,India
811136,2023-05-15,717,spiral bound book,50,100,50,1,00208,India
811136,2023-05-15,709,notebook,30,60,30,2,00208,India
811136,2023-05-15,707,marker,20,40,20,1,00208,India
811136,2023-05-15,710,geometry box,100,150,50,2,00208,India
811136,2023-05-15,713,ball pen,5,10,5,2,00208,India
837771,2023-05-15,701,gel pen,5,10,5,2,00212,India
837771,2023-05-15,710,geometry box,100,150,50,2,00212,India
965453,2023-05-15,708,sketchpen,15,40,25,1,00479,India
965453,2023-05-15,714,carbon paper,15,30,15,1,00479,India
965453,2023-05-15,707,marker,20,40,20,1,00479,India
524352,2023-05-15,717,spiral bound book,50,100,50,1,00328,India
524352,2023-05-15,702,pencil,2,5,3,2,00328,India
127353,2023-05-15,705,stencil,10,20,10,2,00219,India
127353,2023-05-15,715,folder,5,15,10,1,00219,India
127353,2023-05-15,717,spiral bound book,50,100,50,1,00219,India
127353,2023-05-15,712,graph paper,20,40,20,1,00219,India
458679,2023-05-15,714,carbon paper,15,30,15,1,00085,India
458679,2023-05-15,713,ball pen,5,10,5,2,00085,India
458679,2023-05-15,705,stencil,10,20,10,2,00085,India
410198,2023-05-15,716,printing paper,200,400,200,1,00133,India
410198,2023-05-15,715,folder,5,15,10,1,00133,India
410198,2023-05-15,713,ball pen,5,10,5,2,00133,India
159891,2023-05-15,714,carbon paper,15,30,15,1,00395,India
159891,2023-05-15,711,TD kit,150,300,150,1,00395,India
159891,2023-05-15,709,notebook,30,60,30,2,00395,India
159891,2023-05-15,705,stencil,10,20,10,2,00395,India
159891,2023-05-15,713,ball pen,5,10,5,2,00395,India
468490,2023-05-15,703,eraser,1,3,2,2,00135,India
468490,2023-05-15,711,TD kit,150,300,150,1,00135,India
468490,2023-05-15,714,carbon paper,15,30,15,1,00135,India
588244,2023-05-15,702,pencil,2,5,3,2,00241,India
588244,2023-05-15,716,printing paper,200,400,200,1,00241,India
205911,2023-05-16,711,TD kit,150,300,150,1,00098,India
123921,2023-05-16,702,pencil,2,5,3,2,00412,India
123921,2023-05-16,711,TD kit,150,300,150,1,00412,India
489796,2023-05-16,706,sharpener,3,8,5,2,00434,India
489796,2023-05-16,702,pencil,2,5,3,2,00434,India
489796,2023-05-16,703,eraser,1,3,2,2,00434,India
489796,2023-05-16,715,folder,5,15,10,1,00434,India
489796,2023-05-16,705,stencil,10,20,10,2,00434,India
251228,2023-05-16,707,marker,20,40,20,1,00090,India
876890,2023-05-16,701,gel pen,5,10,5,2,00265,India
876890,2023-05-16,706,sharpener,3,8,5,2,00265,India
876890,2023-05-16,710,geometry box,100,150,50,2,00265,India
692694,2023-05-16,702,pencil,2,5,3,2,00493,India
692694,2023-05-16,708,sketchpen,15,40,25,1,00493,India
692694,2023-05-16,703,eraser,1,3,2,2,00493,India
692694,2023-05-16,712,graph paper,20,40,20,1,00493,India
886713,2023-05-16,711,TD kit,150,300,150,1,00250,India
886713,2023-05-16,712,graph paper,20,40,20,1,00250,India
744016,2023-05-16,712,graph paper,20,40,20,1,00489,India
307848,2023-05-16,714,carbon paper,15,30,15,1,00454,India
307848,2023-05-16,713,ball pen,5,10,5,2,00454,India
307848,2023-05-16,703,eraser,1,3,2,2,00454,India
307848,2023-05-16,716,printing paper,200,400,200,1,00454,India
297736,2023-05-16,704,scale,5,10,5,2,00251,India
297736,2023-05-16,717,spiral bound book,50,100,50,1,00251,India
297736,2023-05-16,702,pencil,2,5,3,2,00251,India
297736,2023-05-16,709,notebook,30,60,30,2,00251,India
297736,2023-05-16,716,printing paper,200,400,200,1,00251,India
766472,2023-05-16,713,ball pen,5,10,5,2,00289,India
766472,2023-05-16,701,gel pen,5,10,5,2,00289,India
766472,2023-05-16,705,stencil,10,20,10,2,00289,India
766472,2023-05-16,707,marker,20,40,20,1,00289,India
766472,2023-05-16,710,geometry box,100,150,50,2,00289,India
450191,2023-05-16,711,TD kit,150,300,150,1,00130,India
450191,2023-05-16,705,stencil,10,20,10,2,00130,India
568454,2023-05-16,715,folder,5,15,10,1,00097,India
568454,2023-05-16,717,spiral bound book,50,100,50,1,00097,India
985669,2023-05-16,701,gel pen,5,10,5,2,00122,India
985669,2023-05-16,711,TD kit,150,300,150,1,00122,India
502514,2023-05-16,703,eraser,1,3,2,2,00441,India
502514,2023-05-16,714,carbon paper,15,30,15,1,00441,India
502514,2023-05-16,708,sketchpen,15,40,25,1,00441,India
502514,2023-05-16,701,gel pen,5,10,5,2,00441,India
134931,2023-05-16,703,eraser,1,3,2,2,00423,India
271026,2023-05-16,707,marker,20,40,20,1,00039,India
271026,2023-05-16,709,notebook,30,60,30,2,00039,India
564637,2023-05-16,703,eraser,1,3,2,2,00200,India
564637,2023-05-16,710,geometry box,100,150,50,2,00200,India
564637,2023-05-16,709,notebook,30,60,30,2,00200,India
167230,2023-05-16,715,folder,5,15,10,1,00028,India
167230,2023-05-16,716,printing paper,200,400,200,1,00028,India
167230,2023-05-16,711,TD kit,150,300,150,1,00028,India
167230,2023-05-16,713,ball pen,5,10,5,2,00028,India
849502,2023-05-16,704,scale,5,10,5,2,00496,India
849502,2023-05-16,712,graph paper,20,40,20,1,00496,India
849502,2023-05-16,707,marker,20,40,20,1,00496,India
849502,2023-05-16,713,ball pen,5,10,5,2,00496,India
849502,2023-05-16,701,gel pen,5,10,5,2,00496,India
134574,2023-05-16,711,TD kit,150,300,150,1,00416,India
134574,2023-05-16,710,geometry box,100,150,50,2,00416,India
134574,2023-05-16,717,spiral bound book,50,100,50,1,00416,India
134574,2023-05-16,714,carbon paper,15,30,15,1,00416,India
111310,2023-05-16,701,gel pen,5,10,5,2,00386,India
111310,2023-05-16,717,spiral bound book,50,100,50,1,00386,India
411103,2023-05-16,707,marker,20,40,20,1,00253,India
929409,2023-05-16,701,gel pen,5,10,5,2,00490,India
929409,2023-05-16,712,graph paper,20,40,20,1,00490,India
929409,2023-05-16,704,scale,5,10,5,2,00490,India
929409,2023-05-16,702,pencil,2,5,3,2,00490,India
481117,2023-05-16,702,pencil,2,5,3,2,00358,India
481117,2023-05-16,712,graph paper,20,40,20,1,00358,India
481117,2023-05-16,707,marker,20,40,20,1,00358,India
481117,2023-05-16,716,printing paper,200,400,200,1,00358,India
567671,2023-05-16,704,scale,5,10,5,2,00009,India
567671,2023-05-16,711,TD kit,150,300,150,1,00009,India
815643,2023-05-16,704,scale,5,10,5,2,00170,India
696006,2023-05-16,702,pencil,2,5,3,2,00038,India
696006,2023-05-16,704,scale,5,10,5,2,00038,India
696006,2023-05-16,709,notebook,30,60,30,2,00038,India
429398,2023-05-16,715,folder,5,15,10,1,00139,India
429398,2023-05-16,705,stencil,10,20,10,2,00139,India
429398,2023-05-16,713,ball pen,5,10,5,2,00139,India
429398,2023-05-16,709,notebook,30,60,30,2,00139,India
429398,2023-05-16,710,geometry box,100,150,50,2,00139,India
329387,2023-05-16,709,notebook,30,60,30,2,00099,India
329387,2023-05-16,703,eraser,1,3,2,2,00099,India
159267,2023-05-16,713,ball pen,5,10,5,2,00316,India
159267,2023-05-16,716,printing paper,200,400,200,1,00316,India
188130,2023-05-17,712,graph paper,20,40,20,1,00453,India
188130,2023-05-17,701,gel pen,5,10,5,2,00453,India
188130,2023-05-17,705,stencil,10,20,10,2,00453,India
188130,2023-05-17,702,pencil,2,5,3,2,00453,India
701211,2023-05-17,713,ball pen,5,10,5,2,00222,India
701211,2023-05-17,701,gel pen,5,10,5,2,00222,India
701211,2023-05-17,705,stencil,10,20,10,2,00222,India
701211,2023-05-17,715,folder,5,15,10,1,00222,India
920193,2023-05-17,714,carbon paper,15,30,15,1,00060,India
920193,2023-05-17,713,ball pen,5,10,5,2,00060,India
463221,2023-05-17,701,gel pen,5,10,5,2,00117,India
463221,2023-05-17,702,pencil,2,5,3,2,00117,India
463221,2023-05-17,709,notebook,30,60,30,2,00117,India
829696,2023-05-17,702,pencil,2,5,3,2,00165,India
829696,2023-05-17,714,carbon paper,15,30,15,1,00165,India
191427,2023-05-17,714,carbon paper,15,30,15,1,00155,India
191427,2023-05-17,710,geometry box,100,150,50,2,00155,India
191427,2023-05-17,713,ball pen,5,10,5,2,00155,India
566723,2023-05-17,707,marker,20,40,20,1,00184,India
566723,2023-05-17,710,geometry box,100,150,50,2,00184,India
566723,2023-05-17,712,graph paper,20,40,20,1,00184,India
566723,2023-05-17,702,pencil,2,5,3,2,00184,India
401644,2023-05-17,712,graph paper,20,40,20,1,00358,India
401644,2023-05-17,708,sketchpen,15,40,25,1,00358,India
401644,2023-05-17,711,TD kit,150,300,150,1,00358,India
847690,2023-05-17,715,folder,5,15,10,1,00070,India
847690,2023-05-17,714,carbon paper,15,30,15,1,00070,India
847690,2023-05-17,705,stencil,10,20,10,2,00070,India
847690,2023-05-17,703,eraser,1,3,2,2,00070,India
471505,2023-05-17,701,gel pen,5,10,5,2,00092,India
471505,2023-05-17,713,ball pen,5,10,5,2,00092,India
471505,2023-05-17,703,eraser,1,3,2,2,00092,India
471505,2023-05-17,704,scale,5,10,5,2,00092,India
452927,2023-05-17,701,gel pen,5,10,5,2,00010,India
452927,2023-05-17,708,sketchpen,15,40,25,1,00010,India
452927,2023-05-17,717,spiral bound book,50,100,50,1,00010,India
452927,2023-05-17,712,graph paper,20,40,20,1,00010,India
706878,2023-05-17,706,sharpener,3,8,5,2,00446,India
706878,2023-05-17,705,stencil,10,20,10,2,00446,India
706878,2023-05-17,707,marker,20,40,20,1,00446,India
698800,2023-05-17,706,sharpener,3,8,5,2,00101,India
698800,2023-05-17,710,geometry box,100,150,50,2,00101,India
698800,2023-05-17,711,TD kit,150,300,150,1,00101,India
698800,2023-05-17,708,sketchpen,15,40,25,1,00101,India
285343,2023-05-17,705,stencil,10,20,10,2,00107,India
688809,2023-05-17,715,folder,5,15,10,1,00084,India
688809,2023-05-17,702,pencil,2,5,3,2,00084,India
688809,2023-05-17,705,stencil,10,20,10,2,00084,India
446907,2023-05-17,711,TD kit,150,300,150,1,00495,India
446907,2023-05-17,715,folder,5,15,10,1,00495,India
446907,2023-05-17,714,carbon paper,15,30,15,1,00495,India
139810,2023-05-17,707,marker,20,40,20,1,00395,India
139810,2023-05-17,702,pencil,2,5,3,2,00395,India
139810,2023-05-17,712,graph paper,20,40,20,1,00395,India
139810,2023-05-17,709,notebook,30,60,30,2,00395,India
762400,2023-05-17,706,sharpener,3,8,5,2,00444,India
762400,2023-05-17,716,printing paper,200,400,200,1,00444,India
762400,2023-05-17,712,graph paper,20,40,20,1,00444,India
762400,2023-05-17,710,geometry box,100,150,50,2,00444,India
762400,2023-05-17,711,TD kit,150,300,150,1,00444,India
389337,2023-05-17,714,carbon paper,15,30,15,1,00114,India
389337,2023-05-17,707,marker,20,40,20,1,00114,India
389337,2023-05-17,717,spiral bound book,50,100,50,1,00114,India
162210,2023-05-17,701,gel pen,5,10,5,2,00370,India
162210,2023-05-17,716,printing paper,200,400,200,1,00370,India
749781,2023-05-17,705,stencil,10,20,10,2,00032,India
749781,2023-05-17,713,ball pen,5,10,5,2,00032,India
517573,2023-05-17,707,marker,20,40,20,1,00442,India
517573,2023-05-17,713,ball pen,5,10,5,2,00442,India
517573,2023-05-17,708,sketchpen,15,40,25,1,00442,India
629561,2023-05-17,713,ball pen,5,10,5,2,00060,India
766267,2023-05-17,713,ball pen,5,10,5,2,00215,India
766267,2023-05-17,706,sharpener,3,8,5,2,00215,India
766267,2023-05-17,709,notebook,30,60,30,2,00215,India
772654,2023-05-17,714,carbon paper,15,30,15,1,00284,India
381968,2023-05-17,707,marker,20,40,20,1,00309,India
381968,2023-05-17,711,TD kit,150,300,150,1,00309,India
381968,2023-05-17,706,sharpener,3,8,5,2,00309,India
268997,2023-05-17,714,carbon paper,15,30,15,1,00484,India
756429,2023-05-17,714,carbon paper,15,30,15,1,00471,India
144276,2023-05-17,709,notebook,30,60,30,2,00450,India
144276,2023-05-17,713,ball pen,5,10,5,2,00450,India
144276,2023-05-17,717,spiral bound book,50,100,50,1,00450,India
144276,2023-05-17,715,folder,5,15,10,1,00450,India
383410,2023-05-17,705,stencil,10,20,10,2,00214,India
383410,2023-05-17,717,spiral bound book,50,100,50,1,00214,India
383410,2023-05-17,702,pencil,2,5,3,2,00214,India
383410,2023-05-17,714,carbon paper,15,30,15,1,00214,India
466935,2023-05-17,701,gel pen,5,10,5,2,00412,India
466935,2023-05-17,707,marker,20,40,20,1,00412,India
466935,2023-05-17,702,pencil,2,5,3,2,00412,India
466935,2023-05-17,703,eraser,1,3,2,2,00412,India
302024,2023-05-17,709,notebook,30,60,30,2,00437,India
302024,2023-05-17,711,TD kit,150,300,150,1,00437,India
566966,2023-05-17,713,ball pen,5,10,5,2,00177,India
566966,2023-05-17,708,sketchpen,15,40,25,1,00177,India
566966,2023-05-17,714,carbon paper,15,30,15,1,00177,India
566966,2023-05-17,712,graph paper,20,40,20,1,00177,India
566966,2023-05-17,709,notebook,30,60,30,2,00177,India
402738,2023-05-17,711,TD kit,150,300,150,1,00078,India
402738,2023-05-17,714,carbon paper,15,30,15,1,00078,India
402738,2023-05-17,708,sketchpen,15,40,25,1,00078,India
132873,2023-05-17,705,stencil,10,20,10,2,00321,India
132873,2023-05-17,709,notebook,30,60,30,2,00321,India
132873,2023-05-17,701,gel pen,5,10,5,2,00321,India
494482,2023-05-17,715,folder,5,15,10,1,00126,India
494482,2023-05-17,704,scale,5,10,5,2,00126,India
494482,2023-05-17,708,sketchpen,15,40,25,1,00126,India
988685,2023-05-17,703,eraser,1,3,2,2,00122,India
330399,2023-05-17,714,carbon paper,15,30,15,1,00259,India
316051,2023-05-17,714,carbon paper,15,30,15,1,00304,India
316051,2023-05-17,710,geometry box,100,150,50,2,00304,India
316051,2023-05-17,705,stencil,10,20,10,2,00304,India
316051,2023-05-17,704,scale,5,10,5,2,00304,India
316051,2023-05-17,717,spiral bound book,50,100,50,1,00304,India
909793,2023-05-17,709,notebook,30,60,30,2,00275,India
211899,2023-05-17,714,carbon paper,15,30,15,1,00142,India
211899,2023-05-17,716,printing paper,200,400,200,1,00142,India
211899,2023-05-17,703,eraser,1,3,2,2,00142,India
824870,2023-05-17,709,notebook,30,60,30,2,00222,India
824870,2023-05-17,705,stencil,10,20,10,2,00222,India
307726,2023-05-17,707,marker,20,40,20,1,00379,India
307726,2023-05-17,716,printing paper,200,400,200,1,00379,India
647290,2023-05-17,706,sharpener,3,8,5,2,00081,India
647290,2023-05-17,702,pencil,2,5,3,2,00081,India
723722,2023-05-17,705,stencil,10,20,10,2,00031,India
723722,2023-05-17,708,sketchpen,15,40,25,1,00031,India
304280,2023-05-17,702,pencil,2,5,3,2,00409,India
171150,2023-05-17,717,spiral bound book,50,100,50,1,00395,India
171150,2023-05-17,704,scale,5,10,5,2,00395,India
171150,2023-05-17,702,pencil,2,5,3,2,00395,India
376148,2023-05-18,704,scale,5,10,5,2,00492,India
376148,2023-05-18,705,stencil,10,20,10,2,00492,India
176931,2023-05-18,710,geometry box,100,150,50,2,00220,India
176931,2023-05-18,706,sharpener,3,8,5,2,00220,India
176931,2023-05-18,711,TD kit,150,300,150,1,00220,India
176931,2023-05-18,712,graph paper,20,40,20,1,00220,India
697235,2023-05-18,710,geometry box,100,150,50,2,00332,India
143701,2023-05-18,717,spiral bound book,50,100,50,1,00235,India
143701,2023-05-18,709,notebook,30,60,30,2,00235,India
143701,2023-05-18,702,pencil,2,5,3,2,00235,India
143701,2023-05-18,703,eraser,1,3,2,2,00235,India
143701,2023-05-18,716,printing paper,200,400,200,1,00235,India
263282,2023-05-18,715,folder,5,15,10,1,00431,India
263282,2023-05-18,702,pencil,2,5,3,2,00431,India
954200,2023-05-18,704,scale,5,10,5,2,00214,India
954200,2023-05-18,706,sharpener,3,8,5,2,00214,India
954200,2023-05-18,709,notebook,30,60,30,2,00214,India
954200,2023-05-18,703,eraser,1,3,2,2,00214,India
954200,2023-05-18,714,carbon paper,15,30,15,1,00214,India
122212,2023-05-18,717,spiral bound book,50,100,50,1,00322,India
122212,2023-05-18,703,eraser,1,3,2,2,00322,India
698078,2023-05-18,714,carbon paper,15,30,15,1,00134,India
698078,2023-05-18,703,eraser,1,3,2,2,00134,India
698078,2023-05-18,716,printing paper,200,400,200,1,00134,India
698078,2023-05-18,708,sketchpen,15,40,25,1,00134,India
432614,2023-05-18,704,scale,5,10,5,2,00158,India
432614,2023-05-18,701,gel pen,5,10,5,2,00158,India
711246,2023-05-18,711,TD kit,150,300,150,1,00069,India
711246,2023-05-18,710,geometry box,100,150,50,2,00069,India
271479,2023-05-18,707,marker,20,40,20,1,00184,India
839245,2023-05-18,716,printing paper,200,400,200,1,00065,India
839245,2023-05-18,711,TD kit,150,300,150,1,00065,India
839245,2023-05-18,707,marker,20,40,20,1,00065,India
839245,2023-05-18,710,geometry box,100,150,50,2,00065,India
839245,2023-05-18,704,scale,5,10,5,2,00065,India
813838,2023-05-18,705,stencil,10,20,10,2,00486,India
845557,2023-05-18,705,stencil,10,20,10,2,00249,India
845557,2023-05-18,713,ball pen,5,10,5,2,00249,India
966753,2023-05-18,717,spiral bound book,50,100,50,1,00143,India
128143,2023-05-18,711,TD kit,150,300,150,1,00103,India
128143,2023-05-18,712,graph paper,20,40,20,1,00103,India
828706,2023-05-18,705,stencil,10,20,10,2,00028,India
929125,2023-05-18,715,folder,5,15,10,1,00363,India
385166,2023-05-18,709,notebook,30,60,30,2,00387,India
385166,2023-05-18,714,carbon paper,15,30,15,1,00387,India
385166,2023-05-18,713,ball pen,5,10,5,2,00387,India
385166,2023-05-18,701,gel pen,5,10,5,2,00387,India
575344,2023-05-18,717,spiral bound book,50,100,50,1,00264,India
575344,2023-05-18,714,carbon paper,15,30,15,1,00264,India
590583,2023-05-18,717,spiral bound book,50,100,50,1,00250,India
590583,2023-05-18,707,marker,20,40,20,1,00250,India
683862,2023-05-18,702,pencil,2,5,3,2,00038,India
683862,2023-05-18,716,printing paper,200,400,200,1,00038,India
763204,2023-05-18,711,TD kit,150,300,150,1,00234,India
763204,2023-05-18,701,gel pen,5,10,5,2,00234,India
763204,2023-05-18,703,eraser,1,3,2,2,00234,India
257855,2023-05-18,712,graph paper,20,40,20,1,00119,India
257855,2023-05-18,705,stencil,10,20,10,2,00119,India
257855,2023-05-18,710,geometry box,100,150,50,2,00119,India
257855,2023-05-18,716,printing paper,200,400,200,1,00119,India
561222,2023-05-18,702,pencil,2,5,3,2,00219,India
561222,2023-05-18,713,ball pen,5,10,5,2,00219,India
561222,2023-05-18,712,graph paper,20,40,20,1,00219,India
548763,2023-05-18,714,carbon paper,15,30,15,1,00442,India
921570,2023-05-18,703,eraser,1,3,2,2,00079,India
921570,2023-05-18,705,stencil,10,20,10,2,00079,India
921570,2023-05-18,707,marker,20,40,20,1,00079,India
921570,2023-05-18,709,notebook,30,60,30,2,00079,India
921570,2023-05-18,716,printing paper,200,400,200,1,00079,India
818014,2023-05-18,716,printing paper,200,400,200,1,00018,India
300957,2023-05-18,708,sketchpen,15,40,25,1,00389,India
300957,2023-05-18,704,scale,5,10,5,2,00389,India
300957,2023-05-18,710,geometry box,100,150,50,2,00389,India
300957,2023-05-18,715,folder,5,15,10,1,00389,India
269836,2023-05-18,714,carbon paper,15,30,15,1,00341,India
269836,2023-05-18,706,sharpener,3,8,5,2,00341,India
269836,2023-05-18,710,geometry box,100,150,50,2,00341,India
720667,2023-05-18,711,TD kit,150,300,150,1,00218,India
720667,2023-05-18,704,scale,5,10,5,2,00218,India
720667,2023-05-18,716,printing paper,200,400,200,1,00218,India
720667,2023-05-18,714,carbon paper,15,30,15,1,00218,India
985498,2023-05-18,710,geometry box,100,150,50,2,00419,India
985498,2023-05-18,702,pencil,2,5,3,2,00419,India
985498,2023-05-18,714,carbon paper,15,30,15,1,00419,India
985498,2023-05-18,706,sharpener,3,8,5,2,00419,India
248950,2023-05-18,712,graph paper,20,40,20,1,00205,India
248950,2023-05-18,713,ball pen,5,10,5,2,00205,India
270908,2023-05-18,706,sharpener,3,8,5,2,00005,India
270908,2023-05-18,707,marker,20,40,20,1,00005,India
270908,2023-05-18,703,eraser,1,3,2,2,00005,India
270908,2023-05-18,702,pencil,2,5,3,2,00005,India
733392,2023-05-18,710,geometry box,100,150,50,2,00486,India
733392,2023-05-18,711,TD kit,150,300,150,1,00486,India
733392,2023-05-18,713,ball pen,5,10,5,2,00486,India
733392,2023-05-18,707,marker,20,40,20,1,00486,India
182722,2023-05-18,716,printing paper,200,400,200,1,00363,India
182722,2023-05-18,708,sketchpen,15,40,25,1,00363,India
337715,2023-05-18,712,graph paper,20,40,20,1,00242,India
337715,2023-05-18,709,notebook,30,60,30,2,00242,India
337715,2023-05-18,711,TD kit,150,300,150,1,00242,India
337715,2023-05-18,714,carbon paper,15,30,15,1,00242,India
245250,2023-05-18,712,graph paper,20,40,20,1,00164,India
245250,2023-05-18,708,sketchpen,15,40,25,1,00164,India
245250,2023-05-18,709,notebook,30,60,30,2,00164,India
245250,2023-05-18,703,eraser,1,3,2,2,00164,India
554025,2023-05-18,716,printing paper,200,400,200,1,00151,India
554025,2023-05-18,709,notebook,30,60,30,2,00151,India
554025,2023-05-18,707,marker,20,40,20,1,00151,India
521628,2023-05-18,704,scale,5,10,5,2,00128,India
521628,2023-05-18,714,carbon paper,15,30,15,1,00128,India
233391,2023-05-18,702,pencil,2,5,3,2,00412,India
121719,2023-05-18,713,ball pen,5,10,5,2,00392,India
121719,2023-05-18,701,gel pen,5,10,5,2,00392,India
121719,2023-05-18,705,stencil,10,20,10,2,00392,India
121719,2023-05-18,714,carbon paper,15,30,15,1,00392,India
338530,2023-05-18,702,pencil,2,5,3,2,00426,India
338530,2023-05-18,716,printing paper,200,400,200,1,00426,India
338530,2023-05-18,701,gel pen,5,10,5,2,00426,India
338530,2023-05-18,708,sketchpen,15,40,25,1,00426,India
338530,2023-05-18,703,eraser,1,3,2,2,00426,India
731919,2023-05-18,704,scale,5,10,5,2,00086,India
731919,2023-05-18,710,geometry box,100,150,50,2,00086,India
731919,2023-05-18,714,carbon paper,15,30,15,1,00086,India
731919,2023-05-18,703,eraser,1,3,2,2,00086,India
385053,2023-05-18,711,TD kit,150,300,150,1,00194,India
385053,2023-05-18,714,carbon paper,15,30,15,1,00194,India
935489,2023-05-18,714,carbon paper,15,30,15,1,00292,India
935489,2023-05-18,704,scale,5,10,5,2,00292,India
935489,2023-05-18,709,notebook,30,60,30,2,00292,India
616368,2023-05-18,702,pencil,2,5,3,2,00020,India
616368,2023-05-18,707,marker,20,40,20,1,00020,India
523130,2023-05-18,716,printing paper,200,400,200,1,00273,India
523130,2023-05-18,705,stencil,10,20,10,2,00273,India
523130,2023-05-18,713,ball pen,5,10,5,2,00273,India
523130,2023-05-18,717,spiral bound book,50,100,50,1,00273,India
523130,2023-05-18,714,carbon paper,15,30,15,1,00273,India
218604,2023-05-19,713,ball pen,5,10,5,2,00238,India
218604,2023-05-19,711,TD kit,150,300,150,1,00238,India
381636,2023-05-19,708,sketchpen,15,40,25,1,00256,India
381636,2023-05-19,711,TD kit,150,300,150,1,00256,India
381636,2023-05-19,710,geometry box,100,150,50,2,00256,India
381636,2023-05-19,713,ball pen,5,10,5,2,00256,India
822073,2023-05-19,707,marker,20,40,20,1,00409,India
822073,2023-05-19,709,notebook,30,60,30,2,00409,India
474564,2023-05-19,707,marker,20,40,20,1,00260,India
474564,2023-05-19,704,scale,5,10,5,2,00260,India
474564,2023-05-19,711,TD kit,150,300,150,1,00260,India
474564,2023-05-19,703,eraser,1,3,2,2,00260,India
474564,2023-05-19,709,notebook,30,60,30,2,00260,India
701589,2023-05-19,704,scale,5,10,5,2,00373,India
701589,2023-05-19,701,gel pen,5,10,5,2,00373,India
701589,2023-05-19,703,eraser,1,3,2,2,00373,India
588848,2023-05-19,710,geometry box,100,150,50,2,00074,India
588848,2023-05-19,712,graph paper,20,40,20,1,00074,India
588848,2023-05-19,717,spiral bound book,50,100,50,1,00074,India
588848,2023-05-19,702,pencil,2,5,3,2,00074,India
168220,2023-05-19,709,notebook,30,60,30,2,00002,India
168220,2023-05-19,706,sharpener,3,8,5,2,00002,India
168220,2023-05-19,702,pencil,2,5,3,2,00002,India
168220,2023-05-19,701,gel pen,5,10,5,2,00002,India
976174,2023-05-19,708,sketchpen,15,40,25,1,00108,India
976174,2023-05-19,712,graph paper,20,40,20,1,00108,India
976174,2023-05-19,701,gel pen,5,10,5,2,00108,India
976174,2023-05-19,703,eraser,1,3,2,2,00108,India
273026,2023-05-19,708,sketchpen,15,40,25,1,00354,India
273026,2023-05-19,709,notebook,30,60,30,2,00354,India
273026,2023-05-19,701,gel pen,5,10,5,2,00354,India
273026,2023-05-19,702,pencil,2,5,3,2,00354,India
273026,2023-05-19,710,geometry box,100,150,50,2,00354,India
748025,2023-05-19,717,spiral bound book,50,100,50,1,00360,India
748025,2023-05-19,716,printing paper,200,400,200,1,00360,India
748025,2023-05-19,711,TD kit,150,300,150,1,00360,India
748025,2023-05-19,709,notebook,30,60,30,2,00360,India
748025,2023-05-19,702,pencil,2,5,3,2,00360,India
434769,2023-05-19,711,TD kit,150,300,150,1,00303,India
108615,2023-05-19,709,notebook,30,60,30,2,00252,India
108615,2023-05-19,711,TD kit,150,300,150,1,00252,India
498251,2023-05-19,702,pencil,2,5,3,2,00124,India
498251,2023-05-19,703,eraser,1,3,2,2,00124,India
498251,2023-05-19,709,notebook,30,60,30,2,00124,India
882582,2023-05-19,704,scale,5,10,5,2,00136,India
882582,2023-05-19,713,ball pen,5,10,5,2,00136,India
930521,2023-05-19,709,notebook,30,60,30,2,00413,India
930521,2023-05-19,706,sharpener,3,8,5,2,00413,India
350522,2023-05-19,712,graph paper,20,40,20,1,00273,India
350522,2023-05-19,702,pencil,2,5,3,2,00273,India
350522,2023-05-19,717,spiral bound book,50,100,50,1,00273,India
343129,2023-05-19,703,eraser,1,3,2,2,00142,India
343129,2023-05-19,717,spiral bound book,50,100,50,1,00142,India
903426,2023-05-19,713,ball pen,5,10,5,2,00389,India
903426,2023-05-19,717,spiral bound book,50,100,50,1,00389,India
978388,2023-05-19,702,pencil,2,5,3,2,00488,India
378095,2023-05-19,715,folder,5,15,10,1,00429,India
378095,2023-05-19,704,scale,5,10,5,2,00429,India
378095,2023-05-19,708,sketchpen,15,40,25,1,00429,India
378095,2023-05-19,711,TD kit,150,300,150,1,00429,India
324759,2023-05-19,717,spiral bound book,50,100,50,1,00025,India
324759,2023-05-19,705,stencil,10,20,10,2,00025,India
324759,2023-05-19,713,ball pen,5,10,5,2,00025,India
940288,2023-05-19,704,scale,5,10,5,2,00097,India
940288,2023-05-19,705,stencil,10,20,10,2,00097,India
940288,2023-05-19,709,notebook,30,60,30,2,00097,India
940288,2023-05-19,706,sharpener,3,8,5,2,00097,India
926049,2023-05-19,704,scale,5,10,5,2,00152,India
926049,2023-05-19,710,geometry box,100,150,50,2,00152,India
926049,2023-05-19,714,carbon paper,15,30,15,1,00152,India
926049,2023-05-19,715,folder,5,15,10,1,00152,India
852721,2023-05-19,713,ball pen,5,10,5,2,00009,India
715610,2023-05-19,715,folder,5,15,10,1,00361,India
216151,2023-05-19,706,sharpener,3,8,5,2,00150,India
216151,2023-05-19,712,graph paper,20,40,20,1,00150,India
655564,2023-05-19,716,printing paper,200,400,200,1,00390,India
655564,2023-05-19,701,gel pen,5,10,5,2,00390,India
793091,2023-05-19,703,eraser,1,3,2,2,00221,India
794775,2023-05-19,713,ball pen,5,10,5,2,00491,India
794775,2023-05-19,706,sharpener,3,8,5,2,00491,India
794775,2023-05-19,708,sketchpen,15,40,25,1,00491,India
794775,2023-05-19,710,geometry box,100,150,50,2,00491,India
783485,2023-05-19,711,TD kit,150,300,150,1,00019,India
783485,2023-05-19,713,ball pen,5,10,5,2,00019,India
610059,2023-05-19,709,notebook,30,60,30,2,00124,India
610059,2023-05-19,711,TD kit,150,300,150,1,00124,India
234963,2023-05-19,711,TD kit,150,300,150,1,00174,India
234963,2023-05-19,710,geometry box,100,150,50,2,00174,India
234963,2023-05-19,704,scale,5,10,5,2,00174,India
234963,2023-05-19,717,spiral bound book,50,100,50,1,00174,India
258585,2023-05-19,701,gel pen,5,10,5,2,00155,India
258585,2023-05-19,704,scale,5,10,5,2,00155,India
258585,2023-05-19,703,eraser,1,3,2,2,00155,India
751352,2023-05-19,713,ball pen,5,10,5,2,00435,India
262711,2023-05-19,707,marker,20,40,20,1,00323,India
262711,2023-05-19,716,printing paper,200,400,200,1,00323,India
262711,2023-05-19,710,geometry box,100,150,50,2,00323,India
262711,2023-05-19,717,spiral bound book,50,100,50,1,00323,India
515995,2023-05-19,715,folder,5,15,10,1,00250,India
515995,2023-05-19,706,sharpener,3,8,5,2,00250,India
515995,2023-05-19,710,geometry box,100,150,50,2,00250,India
515995,2023-05-19,714,carbon paper,15,30,15,1,00250,India
194345,2023-05-19,706,sharpener,3,8,5,2,00227,India
194345,2023-05-19,715,folder,5,15,10,1,00227,India
194345,2023-05-19,710,geometry box,100,150,50,2,00227,India
810046,2023-05-19,701,gel pen,5,10,5,2,00002,India
810046,2023-05-19,703,eraser,1,3,2,2,00002,India
810046,2023-05-19,707,marker,20,40,20,1,00002,India
568602,2023-05-19,708,sketchpen,15,40,25,1,00372,India
241679,2023-05-19,711,TD kit,150,300,150,1,00493,India
241679,2023-05-19,702,pencil,2,5,3,2,00493,India
241679,2023-05-19,710,geometry box,100,150,50,2,00493,India
241679,2023-05-19,709,notebook,30,60,30,2,00493,India
241679,2023-05-19,712,graph paper,20,40,20,1,00493,India
736690,2023-05-19,704,scale,5,10,5,2,00090,India
736690,2023-05-19,707,marker,20,40,20,1,00090,India
736690,2023-05-19,706,sharpener,3,8,5,2,00090,India
736690,2023-05-19,709,notebook,30,60,30,2,00090,India
736690,2023-05-19,701,gel pen,5,10,5,2,00090,India
228464,2023-05-19,707,marker,20,40,20,1,00458,India
228464,2023-05-19,709,notebook,30,60,30,2,00458,India
228464,2023-05-19,710,geometry box,100,150,50,2,00458,India
228464,2023-05-19,704,scale,5,10,5,2,00458,India
186599,2023-05-19,708,sketchpen,15,40,25,1,00373,India
744549,2023-05-19,702,pencil,2,5,3,2,00272,India
744549,2023-05-19,716,printing paper,200,400,200,1,00272,India
653641,2023-05-19,703,eraser,1,3,2,2,00287,India
653641,2023-05-19,709,notebook,30,60,30,2,00287,India
653641,2023-05-19,701,gel pen,5,10,5,2,00287,India
251899,2023-05-19,706,sharpener,3,8,5,2,00057,India
251899,2023-05-19,713,ball pen,5,10,5,2,00057,India
812054,2023-05-19,716,printing paper,200,400,200,1,00038,India
812054,2023-05-19,704,scale,5,10,5,2,00038,India
812054,2023-05-19,702,pencil,2,5,3,2,00038,India
672439,2023-05-19,708,sketchpen,15,40,25,1,00328,India
672439,2023-05-19,702,pencil,2,5,3,2,00328,India
122587,2023-05-20,714,carbon paper,15,30,15,1,00410,India
122587,2023-05-20,706,sharpener,3,8,5,2,00410,India
414384,2023-05-20,705,stencil,10,20,10,2,00232,India
414384,2023-05-20,712,graph paper,20,40,20,1,00232,India
414384,2023-05-20,717,spiral bound book,50,100,50,1,00232,India
118060,2023-05-20,704,scale,5,10,5,2,00348,India
118060,2023-05-20,709,notebook,30,60,30,2,00348,India
118060,2023-05-20,703,eraser,1,3,2,2,00348,India
118060,2023-05-20,710,geometry box,100,150,50,2,00348,India
214388,2023-05-20,702,pencil,2,5,3,2,00360,India
214388,2023-05-20,716,printing paper,200,400,200,1,00360,India
214388,2023-05-20,707,marker,20,40,20,1,00360,India
842708,2023-05-20,707,marker,20,40,20,1,00046,India
842708,2023-05-20,711,TD kit,150,300,150,1,00046,India
533544,2023-05-20,714,carbon paper,15,30,15,1,00009,India
533544,2023-05-20,717,spiral bound book,50,100,50,1,00009,India
533544,2023-05-20,716,printing paper,200,400,200,1,00009,India
533544,2023-05-20,703,eraser,1,3,2,2,00009,India
533544,2023-05-20,701,gel pen,5,10,5,2,00009,India
311044,2023-05-20,717,spiral bound book,50,100,50,1,00239,India
311044,2023-05-20,711,TD kit,150,300,150,1,00239,India
311044,2023-05-20,710,geometry box,100,150,50,2,00239,India
311044,2023-05-20,715,folder,5,15,10,1,00239,India
311044,2023-05-20,702,pencil,2,5,3,2,00239,India
405968,2023-05-20,709,notebook,30,60,30,2,00171,India
308710,2023-05-20,702,pencil,2,5,3,2,00230,India
308710,2023-05-20,715,folder,5,15,10,1,00230,India
597867,2023-05-20,715,folder,5,15,10,1,00072,India
597867,2023-05-20,711,TD kit,150,300,150,1,00072,India
597867,2023-05-20,708,sketchpen,15,40,25,1,00072,India
597867,2023-05-20,704,scale,5,10,5,2,00072,India
433985,2023-05-20,706,sharpener,3,8,5,2,00278,India
433985,2023-05-20,705,stencil,10,20,10,2,00278,India
515112,2023-05-20,713,ball pen,5,10,5,2,00350,India
515112,2023-05-20,715,folder,5,15,10,1,00350,India
515112,2023-05-20,708,sketchpen,15,40,25,1,00350,India
154333,2023-05-20,712,graph paper,20,40,20,1,00238,India
154333,2023-05-20,716,printing paper,200,400,200,1,00238,India
766031,2023-05-20,705,stencil,10,20,10,2,00239,India
962922,2023-05-20,713,ball pen,5,10,5,2,00258,India
962922,2023-05-20,714,carbon paper,15,30,15,1,00258,India
962922,2023-05-20,716,printing paper,200,400,200,1,00258,India
499625,2023-05-20,704,scale,5,10,5,2,00485,India
499625,2023-05-20,701,gel pen,5,10,5,2,00485,India
499625,2023-05-20,717,spiral bound book,50,100,50,1,00485,India
499625,2023-05-20,710,geometry box,100,150,50,2,00485,India
517778,2023-05-20,701,gel pen,5,10,5,2,00338,India
517778,2023-05-20,710,geometry box,100,150,50,2,00338,India
517778,2023-05-20,715,folder,5,15,10,1,00338,India
517778,2023-05-20,716,printing paper,200,400,200,1,00338,India
604004,2023-05-20,705,stencil,10,20,10,2,00153,India
989990,2023-05-20,710,geometry box,100,150,50,2,00050,India
989990,2023-05-20,707,marker,20,40,20,1,00050,India
989990,2023-05-20,704,scale,5,10,5,2,00050,India
565888,2023-05-20,710,geometry box,100,150,50,2,00049,India
565888,2023-05-20,702,pencil,2,5,3,2,00049,India
565888,2023-05-20,703,eraser,1,3,2,2,00049,India
565888,2023-05-20,716,printing paper,200,400,200,1,00049,India
585455,2023-05-20,710,geometry box,100,150,50,2,00424,India
713137,2023-05-20,701,gel pen,5,10,5,2,00257,India
713137,2023-05-20,716,printing paper,200,400,200,1,00257,India
713137,2023-05-20,709,notebook,30,60,30,2,00257,India
713137,2023-05-20,714,carbon paper,15,30,15,1,00257,India
713137,2023-05-20,706,sharpener,3,8,5,2,00257,India
729878,2023-05-20,701,gel pen,5,10,5,2,00132,India
935638,2023-05-20,711,TD kit,150,300,150,1,00449,India
935638,2023-05-20,704,scale,5,10,5,2,00449,India
729770,2023-05-20,711,TD kit,150,300,150,1,00369,India
449540,2023-05-20,713,ball pen,5,10,5,2,00280,India
449540,2023-05-20,702,pencil,2,5,3,2,00280,India
449540,2023-05-20,712,graph paper,20,40,20,1,00280,India
449540,2023-05-20,704,scale,5,10,5,2,00280,India
885499,2023-05-20,714,carbon paper,15,30,15,1,00498,India
885499,2023-05-20,708,sketchpen,15,40,25,1,00498,India
885499,2023-05-20,701,gel pen,5,10,5,2,00498,India
318014,2023-05-20,709,notebook,30,60,30,2,00164,India
318014,2023-05-20,705,stencil,10,20,10,2,00164,India
318014,2023-05-20,707,marker,20,40,20,1,00164,India
318014,2023-05-20,714,carbon paper,15,30,15,1,00164,India
619470,2023-05-20,712,graph paper,20,40,20,1,00021,India
619470,2023-05-20,707,marker,20,40,20,1,00021,India
619470,2023-05-20,701,gel pen,5,10,5,2,00021,India
619470,2023-05-20,702,pencil,2,5,3,2,00021,India
352955,2023-05-20,704,scale,5,10,5,2,00490,India
456943,2023-05-20,707,marker,20,40,20,1,00090,India
456943,2023-05-20,704,scale,5,10,5,2,00090,India
287746,2023-05-20,710,geometry box,100,150,50,2,00303,India
287746,2023-05-20,709,notebook,30,60,30,2,00303,India
232661,2023-05-20,712,graph paper,20,40,20,1,00054,India
232661,2023-05-20,713,ball pen,5,10,5,2,00054,India
232661,2023-05-20,714,carbon paper,15,30,15,1,00054,India
232661,2023-05-20,706,sharpener,3,8,5,2,00054,India
232661,2023-05-20,708,sketchpen,15,40,25,1,00054,India
479140,2023-05-20,703,eraser,1,3,2,2,00053,India
479140,2023-05-20,709,notebook,30,60,30,2,00053,India
479140,2023-05-20,707,marker,20,40,20,1,00053,India
479140,2023-05-20,701,gel pen,5,10,5,2,00053,India
325877,2023-05-20,706,sharpener,3,8,5,2,00406,India
453950,2023-05-20,706,sharpener,3,8,5,2,00072,India
453950,2023-05-20,710,geometry box,100,150,50,2,00072,India
453950,2023-05-20,704,scale,5,10,5,2,00072,India
255002,2023-05-20,711,TD kit,150,300,150,1,00405,India
255002,2023-05-20,704,scale,5,10,5,2,00405,India
255002,2023-05-20,714,carbon paper,15,30,15,1,00405,India
255002,2023-05-20,717,spiral bound book,50,100,50,1,00405,India
969099,2023-05-20,711,TD kit,150,300,150,1,00271,India
969099,2023-05-20,708,sketchpen,15,40,25,1,00271,India
969099,2023-05-20,712,graph paper,20,40,20,1,00271,India
969099,2023-05-20,709,notebook,30,60,30,2,00271,India
969099,2023-05-20,705,stencil,10,20,10,2,00271,India
715502,2023-05-20,706,sharpener,3,8,5,2,00152,India
715502,2023-05-20,712,graph paper,20,40,20,1,00152,India
715502,2023-05-20,715,folder,5,15,10,1,00152,India
885870,2023-05-20,715,folder,5,15,10,1,00458,India
483943,2023-05-21,715,folder,5,15,10,1,00266,India
483943,2023-05-21,706,sharpener,3,8,5,2,00266,India
623450,2023-05-21,717,spiral bound book,50,100,50,1,00243,India
623450,2023-05-21,714,carbon paper,15,30,15,1,00243,India
886601,2023-05-21,711,TD kit,150,300,150,1,00169,India
886601,2023-05-21,710,geometry box,100,150,50,2,00169,India
982793,2023-05-21,703,eraser,1,3,2,2,00154,India
982793,2023-05-21,717,spiral bound book,50,100,50,1,00154,India
483700,2023-05-21,707,marker,20,40,20,1,00130,India
483700,2023-05-21,704,scale,5,10,5,2,00130,India
483700,2023-05-21,716,printing paper,200,400,200,1,00130,India
483700,2023-05-21,701,gel pen,5,10,5,2,00130,India
134514,2023-05-21,707,marker,20,40,20,1,00490,India
971145,2023-05-21,701,gel pen,5,10,5,2,00045,India
971145,2023-05-21,705,stencil,10,20,10,2,00045,India
971145,2023-05-21,716,printing paper,200,400,200,1,00045,India
971145,2023-05-21,713,ball pen,5,10,5,2,00045,India
422315,2023-05-21,711,TD kit,150,300,150,1,00461,India
422315,2023-05-21,708,sketchpen,15,40,25,1,00461,India
338772,2023-05-21,713,ball pen,5,10,5,2,00153,India
338772,2023-05-21,707,marker,20,40,20,1,00153,India
338772,2023-05-21,717,spiral bound book,50,100,50,1,00153,India
846166,2023-05-21,715,folder,5,15,10,1,00166,India
846166,2023-05-21,701,gel pen,5,10,5,2,00166,India
846166,2023-05-21,711,TD kit,150,300,150,1,00166,India
846166,2023-05-21,704,scale,5,10,5,2,00166,India
427127,2023-05-21,701,gel pen,5,10,5,2,00480,India
324573,2023-05-21,714,carbon paper,15,30,15,1,00324,India
324573,2023-05-21,707,marker,20,40,20,1,00324,India
324573,2023-05-21,711,TD kit,150,300,150,1,00324,India
485419,2023-05-21,713,ball pen,5,10,5,2,00341,India
485419,2023-05-21,702,pencil,2,5,3,2,00341,India
485419,2023-05-21,705,stencil,10,20,10,2,00341,India
485419,2023-05-21,711,TD kit,150,300,150,1,00341,India
797593,2023-05-21,707,marker,20,40,20,1,00049,India
114179,2023-05-21,714,carbon paper,15,30,15,1,00419,India
114179,2023-05-21,716,printing paper,200,400,200,1,00419,India
887387,2023-05-21,709,notebook,30,60,30,2,00350,India
887387,2023-05-21,712,graph paper,20,40,20,1,00350,India
887387,2023-05-21,704,scale,5,10,5,2,00350,India
887387,2023-05-21,708,sketchpen,15,40,25,1,00350,India
828713,2023-05-21,712,graph paper,20,40,20,1,00167,India
966430,2023-05-21,714,carbon paper,15,30,15,1,00138,India
966430,2023-05-21,717,spiral bound book,50,100,50,1,00138,India
865567,2023-05-21,702,pencil,2,5,3,2,00351,India
865567,2023-05-21,705,stencil,10,20,10,2,00351,India
865567,2023-05-21,717,spiral bound book,50,100,50,1,00351,India
999158,2023-05-21,705,stencil,10,20,10,2,00450,India
480390,2023-05-21,708,sketchpen,15,40,25,1,00028,India
480390,2023-05-21,704,scale,5,10,5,2,00028,India
480390,2023-05-21,717,spiral bound book,50,100,50,1,00028,India
480390,2023-05-21,705,stencil,10,20,10,2,00028,India
827236,2023-05-21,708,sketchpen,15,40,25,1,00154,India
827236,2023-05-21,706,sharpener,3,8,5,2,00154,India
827236,2023-05-21,710,geometry box,100,150,50,2,00154,India
827236,2023-05-21,705,stencil,10,20,10,2,00154,India
166796,2023-05-21,702,pencil,2,5,3,2,00308,India
468043,2023-05-21,704,scale,5,10,5,2,00040,India
468043,2023-05-21,714,carbon paper,15,30,15,1,00040,India
468043,2023-05-21,715,folder,5,15,10,1,00040,India
468043,2023-05-21,706,sharpener,3,8,5,2,00040,India
468043,2023-05-21,703,eraser,1,3,2,2,00040,India
895939,2023-05-21,708,sketchpen,15,40,25,1,00154,India
898723,2023-05-21,701,gel pen,5,10,5,2,00374,India
898723,2023-05-21,706,sharpener,3,8,5,2,00374,India
714980,2023-05-21,707,marker,20,40,20,1,00127,India
714980,2023-05-21,712,graph paper,20,40,20,1,00127,India
714980,2023-05-21,715,folder,5,15,10,1,00127,India
714980,2023-05-21,716,printing paper,200,400,200,1,00127,India
702126,2023-05-21,705,stencil,10,20,10,2,00366,India
702126,2023-05-21,710,geometry box,100,150,50,2,00366,India
702126,2023-05-21,716,printing paper,200,400,200,1,00366,India
702126,2023-05-21,708,sketchpen,15,40,25,1,00366,India
453312,2023-05-21,711,TD kit,150,300,150,1,00448,India
453312,2023-05-21,705,stencil,10,20,10,2,00448,India
453312,2023-05-21,702,pencil,2,5,3,2,00448,India
453312,2023-05-21,703,eraser,1,3,2,2,00448,India
101814,2023-05-21,708,sketchpen,15,40,25,1,00224,India
101814,2023-05-21,715,folder,5,15,10,1,00224,India
823984,2023-05-21,703,eraser,1,3,2,2,00207,India
823984,2023-05-21,702,pencil,2,5,3,2,00207,India
198995,2023-05-21,703,eraser,1,3,2,2,00246,India
198995,2023-05-21,709,notebook,30,60,30,2,00246,India
198995,2023-05-21,706,sharpener,3,8,5,2,00246,India
198995,2023-05-21,716,printing paper,200,400,200,1,00246,India
114209,2023-05-21,715,folder,5,15,10,1,00012,India
493950,2023-05-21,703,eraser,1,3,2,2,00410,India
624420,2023-05-21,710,geometry box,100,150,50,2,00034,India
624420,2023-05-21,704,scale,5,10,5,2,00034,India
624420,2023-05-21,702,pencil,2,5,3,2,00034,India
658683,2023-05-21,716,printing paper,200,400,200,1,00364,India
658683,2023-05-21,706,sharpener,3,8,5,2,00364,India
658683,2023-05-21,702,pencil,2,5,3,2,00364,India
658683,2023-05-21,708,sketchpen,15,40,25,1,00364,India
288858,2023-05-21,717,spiral bound book,50,100,50,1,00209,India
347166,2023-05-21,710,geometry box,100,150,50,2,00256,India
759680,2023-05-21,716,printing paper,200,400,200,1,00446,India
759680,2023-05-21,702,pencil,2,5,3,2,00446,India
759680,2023-05-21,703,eraser,1,3,2,2,00446,India
759680,2023-05-21,712,graph paper,20,40,20,1,00446,India
759680,2023-05-21,715,folder,5,15,10,1,00446,India
986183,2023-05-22,707,marker,20,40,20,1,00284,India
986183,2023-05-22,702,pencil,2,5,3,2,00284,India
444713,2023-05-22,701,gel pen,5,10,5,2,00188,India
487353,2023-05-22,711,TD kit,150,300,150,1,00231,India
487353,2023-05-22,704,scale,5,10,5,2,00231,India
487353,2023-05-22,702,pencil,2,5,3,2,00231,India
602626,2023-05-22,711,TD kit,150,300,150,1,00453,India
602626,2023-05-22,709,notebook,30,60,30,2,00453,India
748209,2023-05-22,707,marker,20,40,20,1,00417,India
748209,2023-05-22,710,geometry box,100,150,50,2,00417,India
748209,2023-05-22,703,eraser,1,3,2,2,00417,India
167310,2023-05-22,702,pencil,2,5,3,2,00464,India
902719,2023-05-22,706,sharpener,3,8,5,2,00397,India
902719,2023-05-22,705,stencil,10,20,10,2,00397,India
902719,2023-05-22,717,spiral bound book,50,100,50,1,00397,India
849161,2023-05-22,704,scale,5,10,5,2,00414,India
277964,2023-05-22,710,geometry box,100,150,50,2,00102,India
366439,2023-05-22,701,gel pen,5,10,5,2,00112,India
366439,2023-05-22,702,pencil,2,5,3,2,00112,India
366439,2023-05-22,705,stencil,10,20,10,2,00112,India
366439,2023-05-22,714,carbon paper,15,30,15,1,00112,India
366439,2023-05-22,711,TD kit,150,300,150,1,00112,India
359749,2023-05-22,704,scale,5,10,5,2,00390,India
359749,2023-05-22,703,eraser,1,3,2,2,00390,India
359749,2023-05-22,709,notebook,30,60,30,2,00390,India
359749,2023-05-22,710,geometry box,100,150,50,2,00390,India
455353,2023-05-22,711,TD kit,150,300,150,1,00320,India
455353,2023-05-22,705,stencil,10,20,10,2,00320,India
455353,2023-05-22,712,graph paper,20,40,20,1,00320,India
407819,2023-05-22,713,ball pen,5,10,5,2,00155,India
407819,2023-05-22,716,printing paper,200,400,200,1,00155,India
407819,2023-05-22,701,gel pen,5,10,5,2,00155,India
407819,2023-05-22,707,marker,20,40,20,1,00155,India
407819,2023-05-22,708,sketchpen,15,40,25,1,00155,India
904525,2023-05-22,702,pencil,2,5,3,2,00090,India
904525,2023-05-22,712,graph paper,20,40,20,1,00090,India
904525,2023-05-22,708,sketchpen,15,40,25,1,00090,India
904525,2023-05-22,709,notebook,30,60,30,2,00090,India
676960,2023-05-22,713,ball pen,5,10,5,2,00354,India
676960,2023-05-22,704,scale,5,10,5,2,00354,India
462448,2023-05-22,701,gel pen,5,10,5,2,00300,India
462448,2023-05-22,702,pencil,2,5,3,2,00300,India
462448,2023-05-22,716,printing paper,200,400,200,1,00300,India
197404,2023-05-22,705,stencil,10,20,10,2,00197,India
197404,2023-05-22,715,folder,5,15,10,1,00197,India
197404,2023-05-22,712,graph paper,20,40,20,1,00197,India
585118,2023-05-22,716,printing paper,200,400,200,1,00317,India
585118,2023-05-22,715,folder,5,15,10,1,00317,India
776504,2023-05-22,713,ball pen,5,10,5,2,00189,India
776504,2023-05-22,704,scale,5,10,5,2,00189,India
952345,2023-05-22,717,spiral bound book,50,100,50,1,00435,India
952345,2023-05-22,711,TD kit,150,300,150,1,00435,India
140940,2023-05-22,706,sharpener,3,8,5,2,00435,India
140940,2023-05-22,701,gel pen,5,10,5,2,00435,India
336606,2023-05-22,708,sketchpen,15,40,25,1,00442,India
336606,2023-05-22,703,eraser,1,3,2,2,00442,India
336606,2023-05-22,709,notebook,30,60,30,2,00442,India
336606,2023-05-22,713,ball pen,5,10,5,2,00442,India
307474,2023-05-22,708,sketchpen,15,40,25,1,00458,India
234980,2023-05-22,707,marker,20,40,20,1,00284,India
502799,2023-05-22,710,geometry box,100,150,50,2,00227,India
502799,2023-05-22,709,notebook,30,60,30,2,00227,India
569335,2023-05-22,703,eraser,1,3,2,2,00337,India
569335,2023-05-22,702,pencil,2,5,3,2,00337,India
569335,2023-05-22,711,TD kit,150,300,150,1,00337,India
569335,2023-05-22,705,stencil,10,20,10,2,00337,India
524741,2023-05-22,709,notebook,30,60,30,2,00031,India
524741,2023-05-22,707,marker,20,40,20,1,00031,India
132775,2023-05-22,707,marker,20,40,20,1,00156,India
132775,2023-05-22,704,scale,5,10,5,2,00156,India
132775,2023-05-22,717,spiral bound book,50,100,50,1,00156,India
132775,2023-05-22,711,TD kit,150,300,150,1,00156,India
593031,2023-05-22,706,sharpener,3,8,5,2,00156,India
593031,2023-05-22,705,stencil,10,20,10,2,00156,India
593031,2023-05-22,701,gel pen,5,10,5,2,00156,India
593031,2023-05-22,712,graph paper,20,40,20,1,00156,India
135920,2023-05-22,714,carbon paper,15,30,15,1,00065,India
135920,2023-05-22,709,notebook,30,60,30,2,00065,India
195757,2023-05-22,717,spiral bound book,50,100,50,1,00039,India
195757,2023-05-22,708,sketchpen,15,40,25,1,00039,India
371483,2023-05-22,717,spiral bound book,50,100,50,1,00157,India
154479,2023-05-22,705,stencil,10,20,10,2,00203,India
154479,2023-05-22,715,folder,5,15,10,1,00203,India
154479,2023-05-22,713,ball pen,5,10,5,2,00203,India
154479,2023-05-22,712,graph paper,20,40,20,1,00203,India
154479,2023-05-22,706,sharpener,3,8,5,2,00203,India
142835,2023-05-22,702,pencil,2,5,3,2,00038,India
675977,2023-05-22,716,printing paper,200,400,200,1,00216,India
159738,2023-05-22,712,graph paper,20,40,20,1,00362,India
815170,2023-05-22,702,pencil,2,5,3,2,00367,India
815170,2023-05-22,706,sharpener,3,8,5,2,00367,India
815170,2023-05-22,717,spiral bound book,50,100,50,1,00367,India
958614,2023-05-22,708,sketchpen,15,40,25,1,00474,India
958614,2023-05-22,713,ball pen,5,10,5,2,00474,India
958614,2023-05-22,716,printing paper,200,400,200,1,00474,India
701314,2023-05-22,705,stencil,10,20,10,2,00161,India
701314,2023-05-22,707,marker,20,40,20,1,00161,India
701314,2023-05-22,713,ball pen,5,10,5,2,00161,India
328193,2023-05-22,707,marker,20,40,20,1,00233,India
328193,2023-05-22,706,sharpener,3,8,5,2,00233,India
328193,2023-05-22,717,spiral bound book,50,100,50,1,00233,India
603642,2023-05-22,705,stencil,10,20,10,2,00331,India
209741,2023-05-22,705,stencil,10,20,10,2,00301,India
406589,2023-05-23,714,carbon paper,15,30,15,1,00380,India
406589,2023-05-23,707,marker,20,40,20,1,00380,India
406589,2023-05-23,705,stencil,10,20,10,2,00380,India
298060,2023-05-23,716,printing paper,200,400,200,1,00193,India
298060,2023-05-23,717,spiral bound book,50,100,50,1,00193,India
298060,2023-05-23,704,scale,5,10,5,2,00193,India
298060,2023-05-23,715,folder,5,15,10,1,00193,India
298060,2023-05-23,707,marker,20,40,20,1,00193,India
135904,2023-05-23,711,TD kit,150,300,150,1,00037,India
135904,2023-05-23,712,graph paper,20,40,20,1,00037,India
135904,2023-05-23,709,notebook,30,60,30,2,00037,India
131347,2023-05-23,717,spiral bound book,50,100,50,1,00097,India
516002,2023-05-23,716,printing paper,200,400,200,1,00283,India
546052,2023-05-23,704,scale,5,10,5,2,00357,India
546052,2023-05-23,706,sharpener,3,8,5,2,00357,India
607561,2023-05-23,709,notebook,30,60,30,2,00159,India
607561,2023-05-23,705,stencil,10,20,10,2,00159,India
607561,2023-05-23,714,carbon paper,15,30,15,1,00159,India
607561,2023-05-23,716,printing paper,200,400,200,1,00159,India
113020,2023-05-23,708,sketchpen,15,40,25,1,00482,India
113020,2023-05-23,711,TD kit,150,300,150,1,00482,India
113020,2023-05-23,705,stencil,10,20,10,2,00482,India
113020,2023-05-23,712,graph paper,20,40,20,1,00482,India
954839,2023-05-23,714,carbon paper,15,30,15,1,00025,India
415228,2023-05-23,714,carbon paper,15,30,15,1,00130,India
415228,2023-05-23,716,printing paper,200,400,200,1,00130,India
415228,2023-05-23,712,graph paper,20,40,20,1,00130,India
415228,2023-05-23,702,pencil,2,5,3,2,00130,India
291591,2023-05-23,713,ball pen,5,10,5,2,00072,India
291591,2023-05-23,711,TD kit,150,300,150,1,00072,India
291591,2023-05-23,702,pencil,2,5,3,2,00072,India
291591,2023-05-23,715,folder,5,15,10,1,00072,India
291591,2023-05-23,710,geometry box,100,150,50,2,00072,India
939688,2023-05-23,713,ball pen,5,10,5,2,00151,India
939688,2023-05-23,701,gel pen,5,10,5,2,00151,India
304002,2023-05-23,708,sketchpen,15,40,25,1,00217,India
304002,2023-05-23,716,printing paper,200,400,200,1,00217,India
560891,2023-05-23,708,sketchpen,15,40,25,1,00083,India
560891,2023-05-23,716,printing paper,200,400,200,1,00083,India
560891,2023-05-23,712,graph paper,20,40,20,1,00083,India
560891,2023-05-23,714,carbon paper,15,30,15,1,00083,India
520606,2023-05-23,703,eraser,1,3,2,2,00358,India
373442,2023-05-23,709,notebook,30,60,30,2,00239,India
373442,2023-05-23,716,printing paper,200,400,200,1,00239,India
373442,2023-05-23,713,ball pen,5,10,5,2,00239,India
611823,2023-05-23,701,gel pen,5,10,5,2,00192,India
611823,2023-05-23,710,geometry box,100,150,50,2,00192,India
208394,2023-05-23,704,scale,5,10,5,2,00478,India
454740,2023-05-23,713,ball pen,5,10,5,2,00345,India
454740,2023-05-23,708,sketchpen,15,40,25,1,00345,India
454740,2023-05-23,705,stencil,10,20,10,2,00345,India
454740,2023-05-23,714,carbon paper,15,30,15,1,00345,India
726906,2023-05-23,709,notebook,30,60,30,2,00159,India
726906,2023-05-23,701,gel pen,5,10,5,2,00159,India
726906,2023-05-23,714,carbon paper,15,30,15,1,00159,India
726906,2023-05-23,703,eraser,1,3,2,2,00159,India
726906,2023-05-23,711,TD kit,150,300,150,1,00159,India
323309,2023-05-23,705,stencil,10,20,10,2,00340,India
323309,2023-05-23,710,geometry box,100,150,50,2,00340,India
323309,2023-05-23,707,marker,20,40,20,1,00340,India
323309,2023-05-23,714,carbon paper,15,30,15,1,00340,India
167924,2023-05-23,715,folder,5,15,10,1,00491,India
167924,2023-05-23,704,scale,5,10,5,2,00491,India
786399,2023-05-23,717,spiral bound book,50,100,50,1,00024,India
786399,2023-05-23,702,pencil,2,5,3,2,00024,India
786399,2023-05-23,714,carbon paper,15,30,15,1,00024,India
786399,2023-05-23,706,sharpener,3,8,5,2,00024,India
727907,2023-05-23,704,scale,5,10,5,2,00320,India
432117,2023-05-23,703,eraser,1,3,2,2,00029,India
432117,2023-05-23,707,marker,20,40,20,1,00029,India
432117,2023-05-23,701,gel pen,5,10,5,2,00029,India
435456,2023-05-23,710,geometry box,100,150,50,2,00483,India
435456,2023-05-23,713,ball pen,5,10,5,2,00483,India
435456,2023-05-23,701,gel pen,5,10,5,2,00483,India
791826,2023-05-23,704,scale,5,10,5,2,00403,India
301793,2023-05-23,710,geometry box,100,150,50,2,00206,India
301793,2023-05-23,716,printing paper,200,400,200,1,00206,India
301793,2023-05-23,709,notebook,30,60,30,2,00206,India
884916,2023-05-23,706,sharpener,3,8,5,2,00059,India
878028,2023-05-23,706,sharpener,3,8,5,2,00181,India
878028,2023-05-23,714,carbon paper,15,30,15,1,00181,India
725087,2023-05-23,717,spiral bound book,50,100,50,1,00344,India
725087,2023-05-23,712,graph paper,20,40,20,1,00344,India
445017,2023-05-23,706,sharpener,3,8,5,2,00138,India
445017,2023-05-23,717,spiral bound book,50,100,50,1,00138,India
445017,2023-05-23,701,gel pen,5,10,5,2,00138,India
445017,2023-05-23,711,TD kit,150,300,150,1,00138,India
313129,2023-05-23,710,geometry box,100,150,50,2,00390,India
313129,2023-05-23,707,marker,20,40,20,1,00390,India
313129,2023-05-23,714,carbon paper,15,30,15,1,00390,India
313129,2023-05-23,705,stencil,10,20,10,2,00390,India
356378,2023-05-23,715,folder,5,15,10,1,00423,India
356378,2023-05-23,712,graph paper,20,40,20,1,00423,India
510216,2023-05-23,708,sketchpen,15,40,25,1,00278,India
510216,2023-05-23,701,gel pen,5,10,5,2,00278,India
510216,2023-05-23,709,notebook,30,60,30,2,00278,India
510216,2023-05-23,712,graph paper,20,40,20,1,00278,India
795377,2023-05-23,708,sketchpen,15,40,25,1,00019,India
795377,2023-05-23,716,printing paper,200,400,200,1,00019,India
795377,2023-05-23,706,sharpener,3,8,5,2,00019,India
448099,2023-05-23,705,stencil,10,20,10,2,00325,India
448099,2023-05-23,715,folder,5,15,10,1,00325,India
448099,2023-05-23,702,pencil,2,5,3,2,00325,India
448099,2023-05-23,717,spiral bound book,50,100,50,1,00325,India
448099,2023-05-23,701,gel pen,5,10,5,2,00325,India
307570,2023-05-23,704,scale,5,10,5,2,00417,India
307570,2023-05-23,713,ball pen,5,10,5,2,00417,India
307570,2023-05-23,706,sharpener,3,8,5,2,00417,India
307570,2023-05-23,716,printing paper,200,400,200,1,00417,India
307570,2023-05-23,712,graph paper,20,40,20,1,00417,India
481855,2023-05-24,716,printing paper,200,400,200,1,00260,India
481855,2023-05-24,703,eraser,1,3,2,2,00260,India
762515,2023-05-24,715,folder,5,15,10,1,00397,India
762515,2023-05-24,702,pencil,2,5,3,2,00397,India
762515,2023-05-24,711,TD kit,150,300,150,1,00397,India
762515,2023-05-24,714,carbon paper,15,30,15,1,00397,India
762515,2023-05-24,713,ball pen,5,10,5,2,00397,India
540170,2023-05-24,713,ball pen,5,10,5,2,00462,India
135325,2023-05-24,715,folder,5,15,10,1,00027,India
135325,2023-05-24,709,notebook,30,60,30,2,00027,India
135325,2023-05-24,702,pencil,2,5,3,2,00027,India
362448,2023-05-24,713,ball pen,5,10,5,2,00305,India
362448,2023-05-24,704,scale,5,10,5,2,00305,India
362448,2023-05-24,714,carbon paper,15,30,15,1,00305,India
574892,2023-05-24,707,marker,20,40,20,1,00036,India
574892,2023-05-24,712,graph paper,20,40,20,1,00036,India
574892,2023-05-24,704,scale,5,10,5,2,00036,India
574892,2023-05-24,708,sketchpen,15,40,25,1,00036,India
635649,2023-05-24,712,graph paper,20,40,20,1,00067,India
635649,2023-05-24,713,ball pen,5,10,5,2,00067,India
495999,2023-05-24,702,pencil,2,5,3,2,00378,India
495999,2023-05-24,711,TD kit,150,300,150,1,00378,India
495999,2023-05-24,710,geometry box,100,150,50,2,00378,India
154475,2023-05-24,705,stencil,10,20,10,2,00170,India
760803,2023-05-24,715,folder,5,15,10,1,00431,India
760803,2023-05-24,712,graph paper,20,40,20,1,00431,India
760803,2023-05-24,711,TD kit,150,300,150,1,00431,India
760803,2023-05-24,713,ball pen,5,10,5,2,00431,India
145722,2023-05-24,702,pencil,2,5,3,2,00275,India
145722,2023-05-24,701,gel pen,5,10,5,2,00275,India
426707,2023-05-24,715,folder,5,15,10,1,00053,India
426707,2023-05-24,704,scale,5,10,5,2,00053,India
426707,2023-05-24,713,ball pen,5,10,5,2,00053,India
426707,2023-05-24,706,sharpener,3,8,5,2,00053,India
416911,2023-05-24,713,ball pen,5,10,5,2,00282,India
416911,2023-05-24,715,folder,5,15,10,1,00282,India
372129,2023-05-24,708,sketchpen,15,40,25,1,00401,India
372129,2023-05-24,712,graph paper,20,40,20,1,00401,India
372129,2023-05-24,703,eraser,1,3,2,2,00401,India
949428,2023-05-24,708,sketchpen,15,40,25,1,00491,India
949428,2023-05-24,703,eraser,1,3,2,2,00491,India
949428,2023-05-24,702,pencil,2,5,3,2,00491,India
767053,2023-05-24,712,graph paper,20,40,20,1,00142,India
767053,2023-05-24,702,pencil,2,5,3,2,00142,India
767053,2023-05-24,710,geometry box,100,150,50,2,00142,India
767053,2023-05-24,714,carbon paper,15,30,15,1,00142,India
385799,2023-05-24,714,carbon paper,15,30,15,1,00278,India
385799,2023-05-24,704,scale,5,10,5,2,00278,India
385799,2023-05-24,713,ball pen,5,10,5,2,00278,India
385799,2023-05-24,716,printing paper,200,400,200,1,00278,India
247154,2023-05-24,707,marker,20,40,20,1,00493,India
247154,2023-05-24,703,eraser,1,3,2,2,00493,India
247154,2023-05-24,702,pencil,2,5,3,2,00493,India
247154,2023-05-24,713,ball pen,5,10,5,2,00493,India
375150,2023-05-24,714,carbon paper,15,30,15,1,00385,India
375150,2023-05-24,717,spiral bound book,50,100,50,1,00385,India
375150,2023-05-24,707,marker,20,40,20,1,00385,India
375150,2023-05-24,705,stencil,10,20,10,2,00385,India
417508,2023-05-24,714,carbon paper,15,30,15,1,00394,India
417508,2023-05-24,705,stencil,10,20,10,2,00394,India
417508,2023-05-24,710,geometry box,100,150,50,2,00394,India
729444,2023-05-24,710,geometry box,100,150,50,2,00300,India
729444,2023-05-24,715,folder,5,15,10,1,00300,India
729444,2023-05-24,712,graph paper,20,40,20,1,00300,India
729444,2023-05-24,701,gel pen,5,10,5,2,00300,India
256224,2023-05-24,716,printing paper,200,400,200,1,00481,India
408968,2023-05-24,708,sketchpen,15,40,25,1,00493,India
408968,2023-05-24,704,scale,5,10,5,2,00493,India
229864,2023-05-24,704,scale,5,10,5,2,00077,India
229864,2023-05-24,716,printing paper,200,400,200,1,00077,India
229864,2023-05-24,709,notebook,30,60,30,2,00077,India
409195,2023-05-24,715,folder,5,15,10,1,00265,India
409195,2023-05-24,703,eraser,1,3,2,2,00265,India
409195,2023-05-24,714,carbon paper,15,30,15,1,00265,India
409195,2023-05-24,705,stencil,10,20,10,2,00265,India
409195,2023-05-24,701,gel pen,5,10,5,2,00265,India
448790,2023-05-24,705,stencil,10,20,10,2,00272,India
448790,2023-05-24,710,geometry box,100,150,50,2,00272,India
290631,2023-05-24,704,scale,5,10,5,2,00230,India
290631,2023-05-24,702,pencil,2,5,3,2,00230,India
290631,2023-05-24,717,spiral bound book,50,100,50,1,00230,India
290631,2023-05-24,708,sketchpen,15,40,25,1,00230,India
290631,2023-05-24,701,gel pen,5,10,5,2,00230,India
264949,2023-05-24,707,marker,20,40,20,1,00472,India
264949,2023-05-24,703,eraser,1,3,2,2,00472,India
264949,2023-05-24,715,folder,5,15,10,1,00472,India
264949,2023-05-24,716,printing paper,200,400,200,1,00472,India
334273,2023-05-24,708,sketchpen,15,40,25,1,00292,India
334273,2023-05-24,701,gel pen,5,10,5,2,00292,India
334273,2023-05-24,712,graph paper,20,40,20,1,00292,India
624132,2023-05-24,716,printing paper,200,400,200,1,00494,India
491917,2023-05-24,704,scale,5,10,5,2,00266,India
674130,2023-05-24,713,ball pen,5,10,5,2,00113,India
674130,2023-05-24,709,notebook,30,60,30,2,00113,India
674130,2023-05-24,715,folder,5,15,10,1,00113,India
674130,2023-05-24,717,spiral bound book,50,100,50,1,00113,India
900392,2023-05-24,713,ball pen,5,10,5,2,00182,India
816197,2023-05-24,714,carbon paper,15,30,15,1,00133,India
816197,2023-05-24,713,ball pen,5,10,5,2,00133,India
958979,2023-05-24,707,marker,20,40,20,1,00432,India
487970,2023-05-24,711,TD kit,150,300,150,1,00036,India
854058,2023-05-24,711,TD kit,150,300,150,1,00312,India
854058,2023-05-24,714,carbon paper,15,30,15,1,00312,India
854058,2023-05-24,707,marker,20,40,20,1,00312,India
854058,2023-05-24,704,scale,5,10,5,2,00312,India
621029,2023-05-24,716,printing paper,200,400,200,1,00123,India
621029,2023-05-24,713,ball pen,5,10,5,2,00123,India
780397,2023-05-24,703,eraser,1,3,2,2,00340,India
780397,2023-05-24,712,graph paper,20,40,20,1,00340,India
780397,2023-05-24,714,carbon paper,15,30,15,1,00340,India
780397,2023-05-24,715,folder,5,15,10,1,00340,India
780397,2023-05-24,710,geometry box,100,150,50,2,00340,India
378041,2023-05-25,712,graph paper,20,40,20,1,00417,India
275355,2023-05-25,713,ball pen,5,10,5,2,00213,India
275355,2023-05-25,701,gel pen,5,10,5,2,00213,India
275355,2023-05-25,703,eraser,1,3,2,2,00213,India
734960,2023-05-25,701,gel pen,5,10,5,2,00385,India
734960,2023-05-25,709,notebook,30,60,30,2,00385,India
734960,2023-05-25,705,stencil,10,20,10,2,00385,India
734960,2023-05-25,704,scale,5,10,5,2,00385,India
113592,2023-05-25,716,printing paper,200,400,200,1,00306,India
113592,2023-05-25,701,gel pen,5,10,5,2,00306,India
113592,2023-05-25,702,pencil,2,5,3,2,00306,India
113592,2023-05-25,715,folder,5,15,10,1,00306,India
839302,2023-05-25,702,pencil,2,5,3,2,00007,India
839302,2023-05-25,703,eraser,1,3,2,2,00007,India
947084,2023-05-25,713,ball pen,5,10,5,2,00042,India
947084,2023-05-25,701,gel pen,5,10,5,2,00042,India
947084,2023-05-25,705,stencil,10,20,10,2,00042,India
600121,2023-05-25,701,gel pen,5,10,5,2,00183,India
600121,2023-05-25,705,stencil,10,20,10,2,00183,India
995756,2023-05-25,712,graph paper,20,40,20,1,00210,India
995756,2023-05-25,703,eraser,1,3,2,2,00210,India
995756,2023-05-25,716,printing paper,200,400,200,1,00210,India
995756,2023-05-25,710,geometry box,100,150,50,2,00210,India
174759,2023-05-25,713,ball pen,5,10,5,2,00194,India
828867,2023-05-25,717,spiral bound book,50,100,50,1,00230,India
828867,2023-05-25,710,geometry box,100,150,50,2,00230,India
719470,2023-05-25,712,graph paper,20,40,20,1,00449,India
719470,2023-05-25,710,geometry box,100,150,50,2,00449,India
719470,2023-05-25,701,gel pen,5,10,5,2,00449,India
816812,2023-05-25,715,folder,5,15,10,1,00270,India
816812,2023-05-25,703,eraser,1,3,2,2,00270,India
816812,2023-05-25,704,scale,5,10,5,2,00270,India
588513,2023-05-25,715,folder,5,15,10,1,00442,India
588513,2023-05-25,716,printing paper,200,400,200,1,00442,India
588513,2023-05-25,705,stencil,10,20,10,2,00442,India
618991,2023-05-25,705,stencil,10,20,10,2,00118,India
822421,2023-05-25,706,sharpener,3,8,5,2,00180,India
822421,2023-05-25,711,TD kit,150,300,150,1,00180,India
822421,2023-05-25,709,notebook,30,60,30,2,00180,India
822421,2023-05-25,712,graph paper,20,40,20,1,00180,India
368214,2023-05-25,703,eraser,1,3,2,2,00401,India
368214,2023-05-25,714,carbon paper,15,30,15,1,00401,India
412729,2023-05-25,708,sketchpen,15,40,25,1,00205,India
412729,2023-05-25,702,pencil,2,5,3,2,00205,India
412729,2023-05-25,704,scale,5,10,5,2,00205,India
412729,2023-05-25,701,gel pen,5,10,5,2,00205,India
879753,2023-05-25,701,gel pen,5,10,5,2,00464,India
879753,2023-05-25,711,TD kit,150,300,150,1,00464,India
224093,2023-05-25,703,eraser,1,3,2,2,00438,India
224093,2023-05-25,701,gel pen,5,10,5,2,00438,India
224093,2023-05-25,715,folder,5,15,10,1,00438,India
301348,2023-05-25,706,sharpener,3,8,5,2,00421,India
301348,2023-05-25,705,stencil,10,20,10,2,00421,India
301348,2023-05-25,710,geometry box,100,150,50,2,00421,India
301348,2023-05-25,716,printing paper,200,400,200,1,00421,India
301348,2023-05-25,715,folder,5,15,10,1,00421,India
264944,2023-05-25,714,carbon paper,15,30,15,1,00163,India
264944,2023-05-25,711,TD kit,150,300,150,1,00163,India
264944,2023-05-25,712,graph paper,20,40,20,1,00163,India
622926,2023-05-25,702,pencil,2,5,3,2,00476,India
622926,2023-05-25,709,notebook,30,60,30,2,00476,India
313276,2023-05-25,717,spiral bound book,50,100,50,1,00090,India
313276,2023-05-25,716,printing paper,200,400,200,1,00090,India
313276,2023-05-25,713,ball pen,5,10,5,2,00090,India
313276,2023-05-25,714,carbon paper,15,30,15,1,00090,India
708816,2023-05-25,716,printing paper,200,400,200,1,00059,India
708816,2023-05-25,710,geometry box,100,150,50,2,00059,India
991649,2023-05-25,716,printing paper,200,400,200,1,00094,India
603115,2023-05-25,701,gel pen,5,10,5,2,00311,India
603115,2023-05-25,702,pencil,2,5,3,2,00311,India
404459,2023-05-25,715,folder,5,15,10,1,00451,India
404459,2023-05-25,717,spiral bound book,50,100,50,1,00451,India
989933,2023-05-25,716,printing paper,200,400,200,1,00313,India
989933,2023-05-25,702,pencil,2,5,3,2,00313,India
989933,2023-05-25,701,gel pen,5,10,5,2,00313,India
640921,2023-05-25,704,scale,5,10,5,2,00108,India
640921,2023-05-25,703,eraser,1,3,2,2,00108,India
640921,2023-05-25,712,graph paper,20,40,20,1,00108,India
741102,2023-05-25,705,stencil,10,20,10,2,00461,India
741102,2023-05-25,714,carbon paper,15,30,15,1,00461,India
741102,2023-05-25,704,scale,5,10,5,2,00461,India
741102,2023-05-25,701,gel pen,5,10,5,2,00461,India
907456,2023-05-25,716,printing paper,200,400,200,1,00305,India
907456,2023-05-25,711,TD kit,150,300,150,1,00305,India
907456,2023-05-25,710,geometry box,100,150,50,2,00305,India
907456,2023-05-25,715,folder,5,15,10,1,00305,India
907456,2023-05-25,703,eraser,1,3,2,2,00305,India
990270,2023-05-25,704,scale,5,10,5,2,00459,India
990270,2023-05-25,709,notebook,30,60,30,2,00459,India
990270,2023-05-25,710,geometry box,100,150,50,2,00459,India
451395,2023-05-25,705,stencil,10,20,10,2,00488,India
451395,2023-05-25,711,TD kit,150,300,150,1,00488,India
451395,2023-05-25,702,pencil,2,5,3,2,00488,India
683211,2023-05-25,709,notebook,30,60,30,2,00225,India
683211,2023-05-25,708,sketchpen,15,40,25,1,00225,India
683211,2023-05-25,712,graph paper,20,40,20,1,00225,India
683211,2023-05-25,715,folder,5,15,10,1,00225,India
942381,2023-05-25,703,eraser,1,3,2,2,00472,India
942381,2023-05-25,707,marker,20,40,20,1,00472,India
942381,2023-05-25,705,stencil,10,20,10,2,00472,India
942381,2023-05-25,706,sharpener,3,8,5,2,00472,India
897924,2023-05-25,717,spiral bound book,50,100,50,1,00397,India
897924,2023-05-25,709,notebook,30,60,30,2,00397,India
897924,2023-05-25,715,folder,5,15,10,1,00397,India
897924,2023-05-25,704,scale,5,10,5,2,00397,India
897924,2023-05-25,708,sketchpen,15,40,25,1,00397,India
267281,2023-05-26,715,folder,5,15,10,1,00236,India
267281,2023-05-26,716,printing paper,200,400,200,1,00236,India
267281,2023-05-26,702,pencil,2,5,3,2,00236,India
267281,2023-05-26,706,sharpener,3,8,5,2,00236,India
267281,2023-05-26,701,gel pen,5,10,5,2,00236,India
931664,2023-05-26,708,sketchpen,15,40,25,1,00201,India
931664,2023-05-26,713,ball pen,5,10,5,2,00201,India
931664,2023-05-26,716,printing paper,200,400,200,1,00201,India
934387,2023-05-26,715,folder,5,15,10,1,00223,India
934387,2023-05-26,702,pencil,2,5,3,2,00223,India
934387,2023-05-26,708,sketchpen,15,40,25,1,00223,India
934387,2023-05-26,716,printing paper,200,400,200,1,00223,India
595093,2023-05-26,701,gel pen,5,10,5,2,00124,India
595093,2023-05-26,703,eraser,1,3,2,2,00124,India
595093,2023-05-26,710,geometry box,100,150,50,2,00124,India
903089,2023-05-26,709,notebook,30,60,30,2,00147,India
903089,2023-05-26,708,sketchpen,15,40,25,1,00147,India
903089,2023-05-26,707,marker,20,40,20,1,00147,India
903089,2023-05-26,701,gel pen,5,10,5,2,00147,India
815250,2023-05-26,702,pencil,2,5,3,2,00271,India
994039,2023-05-26,701,gel pen,5,10,5,2,00313,India
994039,2023-05-26,716,printing paper,200,400,200,1,00313,India
288983,2023-05-26,710,geometry box,100,150,50,2,00186,India
288983,2023-05-26,705,stencil,10,20,10,2,00186,India
997415,2023-05-26,709,notebook,30,60,30,2,00357,India
997415,2023-05-26,714,carbon paper,15,30,15,1,00357,India
997415,2023-05-26,701,gel pen,5,10,5,2,00357,India
997415,2023-05-26,712,graph paper,20,40,20,1,00357,India
309850,2023-05-26,704,scale,5,10,5,2,00097,India
309850,2023-05-26,712,graph paper,20,40,20,1,00097,India
309850,2023-05-26,702,pencil,2,5,3,2,00097,India
309850,2023-05-26,716,printing paper,200,400,200,1,00097,India
266017,2023-05-26,702,pencil,2,5,3,2,00268,India
831652,2023-05-26,703,eraser,1,3,2,2,00220,India
831652,2023-05-26,713,ball pen,5,10,5,2,00220,India
831652,2023-05-26,707,marker,20,40,20,1,00220,India
831652,2023-05-26,710,geometry box,100,150,50,2,00220,India
809801,2023-05-26,708,sketchpen,15,40,25,1,00486,India
809801,2023-05-26,714,carbon paper,15,30,15,1,00486,India
803980,2023-05-26,717,spiral bound book,50,100,50,1,00425,India
803980,2023-05-26,712,graph paper,20,40,20,1,00425,India
803980,2023-05-26,703,eraser,1,3,2,2,00425,India
803980,2023-05-26,710,geometry box,100,150,50,2,00425,India
681836,2023-05-26,717,spiral bound book,50,100,50,1,00468,India
681836,2023-05-26,716,printing paper,200,400,200,1,00468,India
681836,2023-05-26,715,folder,5,15,10,1,00468,India
685337,2023-05-26,715,folder,5,15,10,1,00448,India
685337,2023-05-26,708,sketchpen,15,40,25,1,00448,India
685337,2023-05-26,710,geometry box,100,150,50,2,00448,India
180689,2023-05-26,706,sharpener,3,8,5,2,00103,India
180689,2023-05-26,715,folder,5,15,10,1,00103,India
180689,2023-05-26,707,marker,20,40,20,1,00103,India
562488,2023-05-26,711,TD kit,150,300,150,1,00384,India
408725,2023-05-26,704,scale,5,10,5,2,00500,India
408725,2023-05-26,716,printing paper,200,400,200,1,00500,India
408725,2023-05-26,708,sketchpen,15,40,25,1,00500,India
230107,2023-05-26,703,eraser,1,3,2,2,00346,India
230107,2023-05-26,702,pencil,2,5,3,2,00346,India
230107,2023-05-26,716,printing paper,200,400,200,1,00346,India
262167,2023-05-26,717,spiral bound book,50,100,50,1,00125,India
262167,2023-05-26,708,sketchpen,15,40,25,1,00125,India
710142,2023-05-26,713,ball pen,5,10,5,2,00455,India
710142,2023-05-26,704,scale,5,10,5,2,00455,India
710142,2023-05-26,715,folder,5,15,10,1,00455,India
515130,2023-05-26,713,ball pen,5,10,5,2,00213,India
515130,2023-05-26,717,spiral bound book,50,100,50,1,00213,India
688533,2023-05-26,706,sharpener,3,8,5,2,00368,India
688533,2023-05-26,712,graph paper,20,40,20,1,00368,India
458140,2023-05-26,710,geometry box,100,150,50,2,00234,India
458140,2023-05-26,716,printing paper,200,400,200,1,00234,India
421091,2023-05-26,714,carbon paper,15,30,15,1,00466,India
659769,2023-05-26,711,TD kit,150,300,150,1,00271,India
659769,2023-05-26,713,ball pen,5,10,5,2,00271,India
659769,2023-05-26,710,geometry box,100,150,50,2,00271,India
815543,2023-05-26,706,sharpener,3,8,5,2,00353,India
815543,2023-05-26,707,marker,20,40,20,1,00353,India
531512,2023-05-26,708,sketchpen,15,40,25,1,00046,India
788427,2023-05-26,702,pencil,2,5,3,2,00013,India
788427,2023-05-26,717,spiral bound book,50,100,50,1,00013,India
788427,2023-05-26,713,ball pen,5,10,5,2,00013,India
788427,2023-05-26,704,scale,5,10,5,2,00013,India
790444,2023-05-26,706,sharpener,3,8,5,2,00001,India
798919,2023-05-26,706,sharpener,3,8,5,2,00134,India
798919,2023-05-26,709,notebook,30,60,30,2,00134,India
798919,2023-05-26,710,geometry box,100,150,50,2,00134,India
428118,2023-05-26,702,pencil,2,5,3,2,00379,India
499230,2023-05-26,702,pencil,2,5,3,2,00233,India
782797,2023-05-26,711,TD kit,150,300,150,1,00227,India
782797,2023-05-26,701,gel pen,5,10,5,2,00227,India
782797,2023-05-26,709,notebook,30,60,30,2,00227,India
797791,2023-05-26,712,graph paper,20,40,20,1,00323,India
797791,2023-05-26,705,stencil,10,20,10,2,00323,India
818399,2023-05-26,709,notebook,30,60,30,2,00491,India
670980,2023-05-26,717,spiral bound book,50,100,50,1,00016,India
670980,2023-05-26,703,eraser,1,3,2,2,00016,India
670980,2023-05-26,701,gel pen,5,10,5,2,00016,India
670980,2023-05-26,705,stencil,10,20,10,2,00016,India
263255,2023-05-27,708,sketchpen,15,40,25,1,00358,India
557257,2023-05-27,704,scale,5,10,5,2,00290,India
557257,2023-05-27,710,geometry box,100,150,50,2,00290,India
557257,2023-05-27,714,carbon paper,15,30,15,1,00290,India
303683,2023-05-27,710,geometry box,100,150,50,2,00307,India
303683,2023-05-27,708,sketchpen,15,40,25,1,00307,India
385334,2023-05-27,710,geometry box,100,150,50,2,00306,India
385334,2023-05-27,706,sharpener,3,8,5,2,00306,India
643594,2023-05-27,716,printing paper,200,400,200,1,00125,India
643594,2023-05-27,701,gel pen,5,10,5,2,00125,India
643594,2023-05-27,715,folder,5,15,10,1,00125,India
643594,2023-05-27,702,pencil,2,5,3,2,00125,India
643594,2023-05-27,706,sharpener,3,8,5,2,00125,India
308579,2023-05-27,701,gel pen,5,10,5,2,00448,India
308579,2023-05-27,714,carbon paper,15,30,15,1,00448,India
924744,2023-05-27,708,sketchpen,15,40,25,1,00176,India
924744,2023-05-27,715,folder,5,15,10,1,00176,India
917878,2023-05-27,710,geometry box,100,150,50,2,00460,India
917878,2023-05-27,714,carbon paper,15,30,15,1,00460,India
914860,2023-05-27,715,folder,5,15,10,1,00428,India
914860,2023-05-27,710,geometry box,100,150,50,2,00428,India
914860,2023-05-27,714,carbon paper,15,30,15,1,00428,India
914860,2023-05-27,711,TD kit,150,300,150,1,00428,India
181730,2023-05-27,715,folder,5,15,10,1,00305,India
181730,2023-05-27,710,geometry box,100,150,50,2,00305,India
205690,2023-05-27,712,graph paper,20,40,20,1,00240,India
205690,2023-05-27,714,carbon paper,15,30,15,1,00240,India
205690,2023-05-27,704,scale,5,10,5,2,00240,India
205690,2023-05-27,708,sketchpen,15,40,25,1,00240,India
673398,2023-05-27,711,TD kit,150,300,150,1,00249,India
673398,2023-05-27,709,notebook,30,60,30,2,00249,India
673398,2023-05-27,705,stencil,10,20,10,2,00249,India
673398,2023-05-27,717,spiral bound book,50,100,50,1,00249,India
466686,2023-05-27,702,pencil,2,5,3,2,00039,India
466686,2023-05-27,713,ball pen,5,10,5,2,00039,India
466686,2023-05-27,714,carbon paper,15,30,15,1,00039,India
437534,2023-05-27,709,notebook,30,60,30,2,00092,India
437534,2023-05-27,712,graph paper,20,40,20,1,00092,India
437534,2023-05-27,707,marker,20,40,20,1,00092,India
437534,2023-05-27,710,geometry box,100,150,50,2,00092,India
958452,2023-05-27,712,graph paper,20,40,20,1,00470,India
958452,2023-05-27,701,gel pen,5,10,5,2,00470,India
958452,2023-05-27,704,scale,5,10,5,2,00470,India
573133,2023-05-27,713,ball pen,5,10,5,2,00306,India
452461,2023-05-27,715,folder,5,15,10,1,00090,India
452461,2023-05-27,710,geometry box,100,150,50,2,00090,India
452461,2023-05-27,703,eraser,1,3,2,2,00090,India
452461,2023-05-27,701,gel pen,5,10,5,2,00090,India
111036,2023-05-27,714,carbon paper,15,30,15,1,00046,India
111036,2023-05-27,713,ball pen,5,10,5,2,00046,India
690409,2023-05-27,707,marker,20,40,20,1,00400,India
851550,2023-05-27,708,sketchpen,15,40,25,1,00117,India
851550,2023-05-27,702,pencil,2,5,3,2,00117,India
936935,2023-05-27,715,folder,5,15,10,1,00343,India
936935,2023-05-27,712,graph paper,20,40,20,1,00343,India
936935,2023-05-27,714,carbon paper,15,30,15,1,00343,India
936935,2023-05-27,701,gel pen,5,10,5,2,00343,India
877777,2023-05-27,710,geometry box,100,150,50,2,00151,India
877777,2023-05-27,708,sketchpen,15,40,25,1,00151,India
877777,2023-05-27,716,printing paper,200,400,200,1,00151,India
877777,2023-05-27,714,carbon paper,15,30,15,1,00151,India
176770,2023-05-27,707,marker,20,40,20,1,00028,India
176770,2023-05-27,701,gel pen,5,10,5,2,00028,India
176770,2023-05-27,710,geometry box,100,150,50,2,00028,India
176770,2023-05-27,703,eraser,1,3,2,2,00028,India
244392,2023-05-27,717,spiral bound book,50,100,50,1,00262,India
244392,2023-05-27,716,printing paper,200,400,200,1,00262,India
244392,2023-05-27,707,marker,20,40,20,1,00262,India
540934,2023-05-27,713,ball pen,5,10,5,2,00235,India
437739,2023-05-27,703,eraser,1,3,2,2,00040,India
437739,2023-05-27,710,geometry box,100,150,50,2,00040,India
437739,2023-05-27,701,gel pen,5,10,5,2,00040,India
437739,2023-05-27,712,graph paper,20,40,20,1,00040,India
304530,2023-05-27,704,scale,5,10,5,2,00152,India
903196,2023-05-27,705,stencil,10,20,10,2,00121,India
903196,2023-05-27,708,sketchpen,15,40,25,1,00121,India
903196,2023-05-27,703,eraser,1,3,2,2,00121,India
600123,2023-05-27,708,sketchpen,15,40,25,1,00093,India
920847,2023-05-27,712,graph paper,20,40,20,1,00196,India
920847,2023-05-27,714,carbon paper,15,30,15,1,00196,India
682794,2023-05-27,703,eraser,1,3,2,2,00443,India
682794,2023-05-27,710,geometry box,100,150,50,2,00443,India
682794,2023-05-27,711,TD kit,150,300,150,1,00443,India
682794,2023-05-27,707,marker,20,40,20,1,00443,India
383930,2023-05-27,711,TD kit,150,300,150,1,00336,India
305991,2023-05-27,707,marker,20,40,20,1,00292,India
305991,2023-05-27,704,scale,5,10,5,2,00292,India
305991,2023-05-27,702,pencil,2,5,3,2,00292,India
535599,2023-05-27,706,sharpener,3,8,5,2,00417,India
250589,2023-05-27,701,gel pen,5,10,5,2,00103,India
250589,2023-05-27,704,scale,5,10,5,2,00103,India
250589,2023-05-27,708,sketchpen,15,40,25,1,00103,India
558902,2023-05-27,708,sketchpen,15,40,25,1,00113,India
558902,2023-05-27,710,geometry box,100,150,50,2,00113,India
558902,2023-05-27,713,ball pen,5,10,5,2,00113,India
558902,2023-05-27,705,stencil,10,20,10,2,00113,India
429831,2023-05-27,704,scale,5,10,5,2,00235,India
639606,2023-05-27,709,notebook,30,60,30,2,00116,India
606054,2023-05-27,707,marker,20,40,20,1,00438,India
606054,2023-05-27,704,scale,5,10,5,2,00438,India
606054,2023-05-27,711,TD kit,150,300,150,1,00438,India
606054,2023-05-27,703,eraser,1,3,2,2,00438,India
606054,2023-05-27,710,geometry box,100,150,50,2,00438,India
242198,2023-05-27,710,geometry box,100,150,50,2,00050,India
242198,2023-05-27,709,notebook,30,60,30,2,00050,India
242198,2023-05-27,701,gel pen,5,10,5,2,00050,India
246315,2023-05-27,709,notebook,30,60,30,2,00256,India
246315,2023-05-27,705,stencil,10,20,10,2,00256,India
246315,2023-05-27,703,eraser,1,3,2,2,00256,India
246315,2023-05-27,712,graph paper,20,40,20,1,00256,India
246315,2023-05-27,707,marker,20,40,20,1,00256,India
508633,2023-05-27,713,ball pen,5,10,5,2,00289,India
508633,2023-05-27,706,sharpener,3,8,5,2,00289,India
508633,2023-05-27,715,folder,5,15,10,1,00289,India
588800,2023-05-27,701,gel pen,5,10,5,2,00454,India
588800,2023-05-27,708,sketchpen,15,40,25,1,00454,India
588800,2023-05-27,709,notebook,30,60,30,2,00454,India
588800,2023-05-27,716,printing paper,200,400,200,1,00454,India
126745,2023-05-27,707,marker,20,40,20,1,00092,India
126745,2023-05-27,709,notebook,30,60,30,2,00092,India
126745,2023-05-27,705,stencil,10,20,10,2,00092,India
126745,2023-05-27,716,printing paper,200,400,200,1,00092,India
585782,2023-05-27,713,ball pen,5,10,5,2,00489,India
585782,2023-05-27,707,marker,20,40,20,1,00489,India
585782,2023-05-27,711,TD kit,150,300,150,1,00489,India
585782,2023-05-27,705,stencil,10,20,10,2,00489,India
706912,2023-05-27,714,carbon paper,15,30,15,1,00205,India
706912,2023-05-27,710,geometry box,100,150,50,2,00205,India
706912,2023-05-27,704,scale,5,10,5,2,00205,India
848316,2023-05-27,707,marker,20,40,20,1,00462,India
848316,2023-05-27,702,pencil,2,5,3,2,00462,India
130674,2023-05-27,701,gel pen,5,10,5,2,00458,India
130674,2023-05-27,716,printing paper,200,400,200,1,00458,India
130674,2023-05-27,705,stencil,10,20,10,2,00458,India
623704,2023-05-27,711,TD kit,150,300,150,1,00017,India
355272,2023-05-27,706,sharpener,3,8,5,2,00034,India
927183,2023-05-28,708,sketchpen,15,40,25,1,00162,India
927183,2023-05-28,714,carbon paper,15,30,15,1,00162,India
927183,2023-05-28,711,TD kit,150,300,150,1,00162,India
927183,2023-05-28,716,printing paper,200,400,200,1,00162,India
669875,2023-05-28,710,geometry box,100,150,50,2,00200,India
669875,2023-05-28,701,gel pen,5,10,5,2,00200,India
795202,2023-05-28,702,pencil,2,5,3,2,00440,India
795202,2023-05-28,707,marker,20,40,20,1,00440,India
795202,2023-05-28,701,gel pen,5,10,5,2,00440,India
534513,2023-05-28,708,sketchpen,15,40,25,1,00024,India
534513,2023-05-28,713,ball pen,5,10,5,2,00024,India
534513,2023-05-28,702,pencil,2,5,3,2,00024,India
534513,2023-05-28,705,stencil,10,20,10,2,00024,India
352579,2023-05-28,703,eraser,1,3,2,2,00267,India
107540,2023-05-28,703,eraser,1,3,2,2,00075,India
185120,2023-05-28,710,geometry box,100,150,50,2,00291,India
185120,2023-05-28,708,sketchpen,15,40,25,1,00291,India
185120,2023-05-28,714,carbon paper,15,30,15,1,00291,India
506626,2023-05-28,702,pencil,2,5,3,2,00159,India
506626,2023-05-28,703,eraser,1,3,2,2,00159,India
565106,2023-05-28,706,sharpener,3,8,5,2,00277,India
565106,2023-05-28,702,pencil,2,5,3,2,00277,India
709196,2023-05-28,706,sharpener,3,8,5,2,00308,India
709196,2023-05-28,701,gel pen,5,10,5,2,00308,India
709196,2023-05-28,711,TD kit,150,300,150,1,00308,India
458106,2023-05-28,704,scale,5,10,5,2,00350,India
596234,2023-05-28,710,geometry box,100,150,50,2,00107,India
188882,2023-05-28,706,sharpener,3,8,5,2,00005,India
188882,2023-05-28,712,graph paper,20,40,20,1,00005,India
188882,2023-05-28,715,folder,5,15,10,1,00005,India
188882,2023-05-28,711,TD kit,150,300,150,1,00005,India
958619,2023-05-28,709,notebook,30,60,30,2,00457,India
958619,2023-05-28,711,TD kit,150,300,150,1,00457,India
958619,2023-05-28,716,printing paper,200,400,200,1,00457,India
978273,2023-05-28,710,geometry box,100,150,50,2,00130,India
817011,2023-05-28,710,geometry box,100,150,50,2,00287,India
817011,2023-05-28,709,notebook,30,60,30,2,00287,India
439968,2023-05-28,705,stencil,10,20,10,2,00410,India
257901,2023-05-28,710,geometry box,100,150,50,2,00055,India
257901,2023-05-28,706,sharpener,3,8,5,2,00055,India
257901,2023-05-28,713,ball pen,5,10,5,2,00055,India
257901,2023-05-28,715,folder,5,15,10,1,00055,India
182901,2023-05-28,709,notebook,30,60,30,2,00353,India
182901,2023-05-28,705,stencil,10,20,10,2,00353,India
182901,2023-05-28,712,graph paper,20,40,20,1,00353,India
182901,2023-05-28,716,printing paper,200,400,200,1,00353,India
182901,2023-05-28,710,geometry box,100,150,50,2,00353,India
777620,2023-05-28,712,graph paper,20,40,20,1,00195,India
777620,2023-05-28,707,marker,20,40,20,1,00195,India
601742,2023-05-28,708,sketchpen,15,40,25,1,00280,India
601742,2023-05-28,716,printing paper,200,400,200,1,00280,India
601742,2023-05-28,702,pencil,2,5,3,2,00280,India
601742,2023-05-28,714,carbon paper,15,30,15,1,00280,India
371351,2023-05-28,705,stencil,10,20,10,2,00220,India
371351,2023-05-28,712,graph paper,20,40,20,1,00220,India
371351,2023-05-28,703,eraser,1,3,2,2,00220,India
481466,2023-05-28,712,graph paper,20,40,20,1,00467,India
481466,2023-05-28,702,pencil,2,5,3,2,00467,India
973643,2023-05-28,709,notebook,30,60,30,2,00471,India
234238,2023-05-28,711,TD kit,150,300,150,1,00385,India
234238,2023-05-28,710,geometry box,100,150,50,2,00385,India
665625,2023-05-28,702,pencil,2,5,3,2,00055,India
665625,2023-05-28,710,geometry box,100,150,50,2,00055,India
665625,2023-05-28,704,scale,5,10,5,2,00055,India
665625,2023-05-28,709,notebook,30,60,30,2,00055,India
665625,2023-05-28,703,eraser,1,3,2,2,00055,India
105759,2023-05-28,712,graph paper,20,40,20,1,00393,India
154672,2023-05-28,714,carbon paper,15,30,15,1,00272,India
154672,2023-05-28,705,stencil,10,20,10,2,00272,India
154672,2023-05-28,709,notebook,30,60,30,2,00272,India
548567,2023-05-28,701,gel pen,5,10,5,2,00477,India
548567,2023-05-28,703,eraser,1,3,2,2,00477,India
474894,2023-05-28,708,sketchpen,15,40,25,1,00391,India
474894,2023-05-28,709,notebook,30,60,30,2,00391,India
474894,2023-05-28,713,ball pen,5,10,5,2,00391,India
474894,2023-05-28,712,graph paper,20,40,20,1,00391,India
653160,2023-05-28,716,printing paper,200,400,200,1,00093,India
468948,2023-05-28,708,sketchpen,15,40,25,1,00362,India
468948,2023-05-28,702,pencil,2,5,3,2,00362,India
468948,2023-05-28,710,geometry box,100,150,50,2,00362,India
468948,2023-05-28,704,scale,5,10,5,2,00362,India
468948,2023-05-28,714,carbon paper,15,30,15,1,00362,India
250803,2023-05-28,715,folder,5,15,10,1,00428,India
250803,2023-05-28,707,marker,20,40,20,1,00428,India
937613,2023-05-28,705,stencil,10,20,10,2,00283,India
584654,2023-05-28,716,printing paper,200,400,200,1,00463,India
584654,2023-05-28,705,stencil,10,20,10,2,00463,India
584654,2023-05-28,704,scale,5,10,5,2,00463,India
658389,2023-05-28,706,sharpener,3,8,5,2,00267,India
778710,2023-05-28,710,geometry box,100,150,50,2,00162,India
599435,2023-05-28,714,carbon paper,15,30,15,1,00277,India
195346,2023-05-28,712,graph paper,20,40,20,1,00109,India
195346,2023-05-28,708,sketchpen,15,40,25,1,00109,India
195346,2023-05-28,703,eraser,1,3,2,2,00109,India
914055,2023-05-29,714,carbon paper,15,30,15,1,00227,India
914055,2023-05-29,710,geometry box,100,150,50,2,00227,India
728237,2023-05-29,715,folder,5,15,10,1,00069,India
728237,2023-05-29,705,stencil,10,20,10,2,00069,India
728237,2023-05-29,716,printing paper,200,400,200,1,00069,India
249698,2023-05-29,703,eraser,1,3,2,2,00452,India
491017,2023-05-29,712,graph paper,20,40,20,1,00017,India
491017,2023-05-29,714,carbon paper,15,30,15,1,00017,India
319108,2023-05-29,711,TD kit,150,300,150,1,00368,India
319108,2023-05-29,714,carbon paper,15,30,15,1,00368,India
319108,2023-05-29,715,folder,5,15,10,1,00368,India
829825,2023-05-29,714,carbon paper,15,30,15,1,00139,India
829825,2023-05-29,716,printing paper,200,400,200,1,00139,India
829825,2023-05-29,707,marker,20,40,20,1,00139,India
957365,2023-05-29,705,stencil,10,20,10,2,00091,India
957365,2023-05-29,707,marker,20,40,20,1,00091,India
957365,2023-05-29,708,sketchpen,15,40,25,1,00091,India
202320,2023-05-29,702,pencil,2,5,3,2,00168,India
202320,2023-05-29,709,notebook,30,60,30,2,00168,India
913279,2023-05-29,701,gel pen,5,10,5,2,00116,India
913279,2023-05-29,716,printing paper,200,400,200,1,00116,India
913279,2023-05-29,717,spiral bound book,50,100,50,1,00116,India
553011,2023-05-29,703,eraser,1,3,2,2,00171,India
553011,2023-05-29,702,pencil,2,5,3,2,00171,India
873313,2023-05-29,708,sketchpen,15,40,25,1,00024,India
873313,2023-05-29,710,geometry box,100,150,50,2,00024,India
873313,2023-05-29,715,folder,5,15,10,1,00024,India
981180,2023-05-29,712,graph paper,20,40,20,1,00036,India
981180,2023-05-29,715,folder,5,15,10,1,00036,India
981180,2023-05-29,704,scale,5,10,5,2,00036,India
981180,2023-05-29,713,ball pen,5,10,5,2,00036,India
385417,2023-05-29,715,folder,5,15,10,1,00170,India
730543,2023-05-29,709,notebook,30,60,30,2,00207,India
730543,2023-05-29,713,ball pen,5,10,5,2,00207,India
730543,2023-05-29,703,eraser,1,3,2,2,00207,India
387391,2023-05-29,708,sketchpen,15,40,25,1,00180,India
387391,2023-05-29,712,graph paper,20,40,20,1,00180,India
387391,2023-05-29,705,stencil,10,20,10,2,00180,India
387391,2023-05-29,704,scale,5,10,5,2,00180,India
387391,2023-05-29,707,marker,20,40,20,1,00180,India
754149,2023-05-29,715,folder,5,15,10,1,00371,India
465516,2023-05-29,716,printing paper,200,400,200,1,00338,India
465516,2023-05-29,715,folder,5,15,10,1,00338,India
465516,2023-05-29,717,spiral bound book,50,100,50,1,00338,India
465516,2023-05-29,707,marker,20,40,20,1,00338,India
465516,2023-05-29,706,sharpener,3,8,5,2,00338,India
486061,2023-05-29,702,pencil,2,5,3,2,00275,India
486061,2023-05-29,717,spiral bound book,50,100,50,1,00275,India
486061,2023-05-29,710,geometry box,100,150,50,2,00275,India
486061,2023-05-29,705,stencil,10,20,10,2,00275,India
486061,2023-05-29,716,printing paper,200,400,200,1,00275,India
771600,2023-05-29,715,folder,5,15,10,1,00459,India
771600,2023-05-29,701,gel pen,5,10,5,2,00459,India
771600,2023-05-29,705,stencil,10,20,10,2,00459,India
771600,2023-05-29,717,spiral bound book,50,100,50,1,00459,India
824992,2023-05-29,702,pencil,2,5,3,2,00316,India
824992,2023-05-29,704,scale,5,10,5,2,00316,India
835653,2023-05-29,710,geometry box,100,150,50,2,00296,India
152719,2023-05-29,713,ball pen,5,10,5,2,00380,India
152719,2023-05-29,716,printing paper,200,400,200,1,00380,India
152719,2023-05-29,702,pencil,2,5,3,2,00380,India
747181,2023-05-29,703,eraser,1,3,2,2,00043,India
747181,2023-05-29,714,carbon paper,15,30,15,1,00043,India
747181,2023-05-29,717,spiral bound book,50,100,50,1,00043,India
747181,2023-05-29,709,notebook,30,60,30,2,00043,India
164587,2023-05-29,713,ball pen,5,10,5,2,00123,India
164587,2023-05-29,716,printing paper,200,400,200,1,00123,India
164587,2023-05-29,717,spiral bound book,50,100,50,1,00123,India
164587,2023-05-29,701,gel pen,5,10,5,2,00123,India
347024,2023-05-29,715,folder,5,15,10,1,00083,India
527380,2023-05-29,714,carbon paper,15,30,15,1,00178,India
527380,2023-05-29,702,pencil,2,5,3,2,00178,India
131559,2023-05-29,716,printing paper,200,400,200,1,00087,India
131559,2023-05-29,714,carbon paper,15,30,15,1,00087,India
777021,2023-05-29,702,pencil,2,5,3,2,00131,India
777021,2023-05-29,712,graph paper,20,40,20,1,00131,India
437649,2023-05-29,713,ball pen,5,10,5,2,00265,India
437649,2023-05-29,711,TD kit,150,300,150,1,00265,India
437649,2023-05-29,702,pencil,2,5,3,2,00265,India
679736,2023-05-29,712,graph paper,20,40,20,1,00178,India
679736,2023-05-29,703,eraser,1,3,2,2,00178,India
679736,2023-05-29,715,folder,5,15,10,1,00178,India
206862,2023-05-29,712,graph paper,20,40,20,1,00288,India
206862,2023-05-29,710,geometry box,100,150,50,2,00288,India
206862,2023-05-29,702,pencil,2,5,3,2,00288,India
206862,2023-05-29,713,ball pen,5,10,5,2,00288,India
775671,2023-05-29,708,sketchpen,15,40,25,1,00411,India
775671,2023-05-29,709,notebook,30,60,30,2,00411,India
397912,2023-05-29,701,gel pen,5,10,5,2,00367,India
589922,2023-05-29,709,notebook,30,60,30,2,00214,India
589922,2023-05-29,707,marker,20,40,20,1,00214,India
589922,2023-05-29,705,stencil,10,20,10,2,00214,India
751361,2023-05-30,712,graph paper,20,40,20,1,00418,India
751361,2023-05-30,706,sharpener,3,8,5,2,00418,India
751361,2023-05-30,707,marker,20,40,20,1,00418,India
790539,2023-05-30,703,eraser,1,3,2,2,00432,India
790539,2023-05-30,717,spiral bound book,50,100,50,1,00432,India
790539,2023-05-30,709,notebook,30,60,30,2,00432,India
790539,2023-05-30,712,graph paper,20,40,20,1,00432,India
144738,2023-05-30,702,pencil,2,5,3,2,00187,India
278718,2023-05-30,701,gel pen,5,10,5,2,00257,India
278718,2023-05-30,704,scale,5,10,5,2,00257,India
278718,2023-05-30,713,ball pen,5,10,5,2,00257,India
278718,2023-05-30,711,TD kit,150,300,150,1,00257,India
723300,2023-05-30,714,carbon paper,15,30,15,1,00375,India
723300,2023-05-30,709,notebook,30,60,30,2,00375,India
723300,2023-05-30,713,ball pen,5,10,5,2,00375,India
723300,2023-05-30,715,folder,5,15,10,1,00375,India
982828,2023-05-30,716,printing paper,200,400,200,1,00012,India
486238,2023-05-30,701,gel pen,5,10,5,2,00357,India
486238,2023-05-30,706,sharpener,3,8,5,2,00357,India
486238,2023-05-30,712,graph paper,20,40,20,1,00357,India
486238,2023-05-30,704,scale,5,10,5,2,00357,India
659219,2023-05-30,701,gel pen,5,10,5,2,00423,India
659219,2023-05-30,713,ball pen,5,10,5,2,00423,India
659219,2023-05-30,715,folder,5,15,10,1,00423,India
659219,2023-05-30,716,printing paper,200,400,200,1,00423,India
557468,2023-05-30,702,pencil,2,5,3,2,00236,India
557468,2023-05-30,705,stencil,10,20,10,2,00236,India
557468,2023-05-30,709,notebook,30,60,30,2,00236,India
557468,2023-05-30,714,carbon paper,15,30,15,1,00236,India
557468,2023-05-30,717,spiral bound book,50,100,50,1,00236,India
710053,2023-05-30,706,sharpener,3,8,5,2,00326,India
710053,2023-05-30,701,gel pen,5,10,5,2,00326,India
775034,2023-05-30,713,ball pen,5,10,5,2,00071,India
648371,2023-05-30,706,sharpener,3,8,5,2,00321,India
648371,2023-05-30,711,TD kit,150,300,150,1,00321,India
648371,2023-05-30,709,notebook,30,60,30,2,00321,India
196097,2023-05-30,703,eraser,1,3,2,2,00035,India
196097,2023-05-30,711,TD kit,150,300,150,1,00035,India
591469,2023-05-30,707,marker,20,40,20,1,00176,India
591469,2023-05-30,710,geometry box,100,150,50,2,00176,India
582081,2023-05-30,713,ball pen,5,10,5,2,00452,India
538755,2023-05-30,711,TD kit,150,300,150,1,00437,India
345210,2023-05-30,701,gel pen,5,10,5,2,00166,India
345210,2023-05-30,704,scale,5,10,5,2,00166,India
345210,2023-05-30,708,sketchpen,15,40,25,1,00166,India
345210,2023-05-30,716,printing paper,200,400,200,1,00166,India
345210,2023-05-30,713,ball pen,5,10,5,2,00166,India
905365,2023-05-30,713,ball pen,5,10,5,2,00412,India
905365,2023-05-30,702,pencil,2,5,3,2,00412,India
905365,2023-05-30,703,eraser,1,3,2,2,00412,India
554043,2023-05-30,716,printing paper,200,400,200,1,00162,India
554043,2023-05-30,707,marker,20,40,20,1,00162,India
554043,2023-05-30,704,scale,5,10,5,2,00162,India
409380,2023-05-30,712,graph paper,20,40,20,1,00299,India
409380,2023-05-30,706,sharpener,3,8,5,2,00299,India
882934,2023-05-30,707,marker,20,40,20,1,00288,India
882934,2023-05-30,706,sharpener,3,8,5,2,00288,India
882934,2023-05-30,703,eraser,1,3,2,2,00288,India
400346,2023-05-30,713,ball pen,5,10,5,2,00063,India
400346,2023-05-30,705,stencil,10,20,10,2,00063,India
400346,2023-05-30,703,eraser,1,3,2,2,00063,India
400346,2023-05-30,716,printing paper,200,400,200,1,00063,India
400346,2023-05-30,704,scale,5,10,5,2,00063,India
225762,2023-05-30,710,geometry box,100,150,50,2,00101,India
225762,2023-05-30,702,pencil,2,5,3,2,00101,India
225762,2023-05-30,709,notebook,30,60,30,2,00101,India
225762,2023-05-30,711,TD kit,150,300,150,1,00101,India
225762,2023-05-30,708,sketchpen,15,40,25,1,00101,India
174852,2023-05-30,712,graph paper,20,40,20,1,00384,India
813400,2023-05-30,702,pencil,2,5,3,2,00484,India
752728,2023-05-30,711,TD kit,150,300,150,1,00266,India
752728,2023-05-30,710,geometry box,100,150,50,2,00266,India
100906,2023-05-30,701,gel pen,5,10,5,2,00427,India
100906,2023-05-30,709,notebook,30,60,30,2,00427,India
100906,2023-05-30,710,geometry box,100,150,50,2,00427,India
643866,2023-05-30,712,graph paper,20,40,20,1,00195,India
643866,2023-05-30,710,geometry box,100,150,50,2,00195,India
643866,2023-05-30,703,eraser,1,3,2,2,00195,India
645927,2023-05-30,717,spiral bound book,50,100,50,1,00310,India
645927,2023-05-30,709,notebook,30,60,30,2,00310,India
645927,2023-05-30,714,carbon paper,15,30,15,1,00310,India
441905,2023-05-30,711,TD kit,150,300,150,1,00251,India
321895,2023-05-30,717,spiral bound book,50,100,50,1,00406,India
321895,2023-05-30,708,sketchpen,15,40,25,1,00406,India
321895,2023-05-30,712,graph paper,20,40,20,1,00406,India
483979,2023-05-30,706,sharpener,3,8,5,2,00302,India
483979,2023-05-30,702,pencil,2,5,3,2,00302,India
483979,2023-05-30,716,printing paper,200,400,200,1,00302,India
483979,2023-05-30,701,gel pen,5,10,5,2,00302,India
483979,2023-05-30,713,ball pen,5,10,5,2,00302,India
443290,2023-05-30,706,sharpener,3,8,5,2,00405,India
443290,2023-05-30,703,eraser,1,3,2,2,00405,India
443290,2023-05-30,702,pencil,2,5,3,2,00405,India
443290,2023-05-30,716,printing paper,200,400,200,1,00405,India
443290,2023-05-30,705,stencil,10,20,10,2,00405,India
165474,2023-05-30,717,spiral bound book,50,100,50,1,00420,India
165474,2023-05-30,710,geometry box,100,150,50,2,00420,India
165474,2023-05-30,716,printing paper,200,400,200,1,00420,India
158641,2023-05-30,707,marker,20,40,20,1,00218,India
158641,2023-05-30,708,sketchpen,15,40,25,1,00218,India
921268,2023-05-30,703,eraser,1,3,2,2,00309,India
921268,2023-05-30,706,sharpener,3,8,5,2,00309,India
773904,2023-05-31,708,sketchpen,15,40,25,1,00291,India
773904,2023-05-31,714,carbon paper,15,30,15,1,00291,India
773904,2023-05-31,712,graph paper,20,40,20,1,00291,India
773904,2023-05-31,709,notebook,30,60,30,2,00291,India
499409,2023-05-31,707,marker,20,40,20,1,00393,India
143771,2023-05-31,716,printing paper,200,400,200,1,00349,India
143771,2023-05-31,714,carbon paper,15,30,15,1,00349,India
143771,2023-05-31,708,sketchpen,15,40,25,1,00349,India
545800,2023-05-31,701,gel pen,5,10,5,2,00473,India
545800,2023-05-31,705,stencil,10,20,10,2,00473,India
545800,2023-05-31,711,TD kit,150,300,150,1,00473,India
520540,2023-05-31,713,ball pen,5,10,5,2,00280,India
520540,2023-05-31,705,stencil,10,20,10,2,00280,India
941836,2023-05-31,709,notebook,30,60,30,2,00340,India
941836,2023-05-31,711,TD kit,150,300,150,1,00340,India
185218,2023-05-31,707,marker,20,40,20,1,00134,India
185218,2023-05-31,712,graph paper,20,40,20,1,00134,India
839491,2023-05-31,708,sketchpen,15,40,25,1,00500,India
114604,2023-05-31,715,folder,5,15,10,1,00288,India
114604,2023-05-31,714,carbon paper,15,30,15,1,00288,India
214936,2023-05-31,713,ball pen,5,10,5,2,00329,India
214936,2023-05-31,706,sharpener,3,8,5,2,00329,India
214936,2023-05-31,716,printing paper,200,400,200,1,00329,India
728016,2023-05-31,706,sharpener,3,8,5,2,00398,India
728016,2023-05-31,707,marker,20,40,20,1,00398,India
728016,2023-05-31,709,notebook,30,60,30,2,00398,India
792751,2023-05-31,715,folder,5,15,10,1,00064,India
349935,2023-05-31,714,carbon paper,15,30,15,1,00087,India
349935,2023-05-31,716,printing paper,200,400,200,1,00087,India
349935,2023-05-31,701,gel pen,5,10,5,2,00087,India
349935,2023-05-31,710,geometry box,100,150,50,2,00087,India
349935,2023-05-31,717,spiral bound book,50,100,50,1,00087,India
899350,2023-05-31,701,gel pen,5,10,5,2,00038,India
899350,2023-05-31,711,TD kit,150,300,150,1,00038,India
526006,2023-05-31,708,sketchpen,15,40,25,1,00427,India
526006,2023-05-31,713,ball pen,5,10,5,2,00427,India
526006,2023-05-31,710,geometry box,100,150,50,2,00427,India
526006,2023-05-31,702,pencil,2,5,3,2,00427,India
973411,2023-05-31,705,stencil,10,20,10,2,00372,India
973411,2023-05-31,711,TD kit,150,300,150,1,00372,India
973411,2023-05-31,712,graph paper,20,40,20,1,00372,India
973411,2023-05-31,703,eraser,1,3,2,2,00372,India
329584,2023-05-31,708,sketchpen,15,40,25,1,00416,India
329584,2023-05-31,713,ball pen,5,10,5,2,00416,India
329584,2023-05-31,709,notebook,30,60,30,2,00416,India
329584,2023-05-31,710,geometry box,100,150,50,2,00416,India
329584,2023-05-31,707,marker,20,40,20,1,00416,India
857052,2023-05-31,716,printing paper,200,400,200,1,00334,India
857052,2023-05-31,710,geometry box,100,150,50,2,00334,India
826901,2023-05-31,702,pencil,2,5,3,2,00408,India
826901,2023-05-31,704,scale,5,10,5,2,00408,India
826901,2023-05-31,706,sharpener,3,8,5,2,00408,India
628209,2023-05-31,704,scale,5,10,5,2,00032,India
628209,2023-05-31,710,geometry box,100,150,50,2,00032,India
628209,2023-05-31,711,TD kit,150,300,150,1,00032,India
628209,2023-05-31,706,sharpener,3,8,5,2,00032,India
287801,2023-05-31,708,sketchpen,15,40,25,1,00187,India
287801,2023-05-31,709,notebook,30,60,30,2,00187,India
287801,2023-05-31,701,gel pen,5,10,5,2,00187,India
544498,2023-05-31,709,notebook,30,60,30,2,00025,India
544498,2023-05-31,710,geometry box,100,150,50,2,00025,India
544498,2023-05-31,703,eraser,1,3,2,2,00025,India
765121,2023-05-31,713,ball pen,5,10,5,2,00388,India
788126,2023-05-31,708,sketchpen,15,40,25,1,00301,India
788126,2023-05-31,710,geometry box,100,150,50,2,00301,India
788126,2023-05-31,715,folder,5,15,10,1,00301,India
788126,2023-05-31,705,stencil,10,20,10,2,00301,India
446076,2023-05-31,716,printing paper,200,400,200,1,00018,India
446076,2023-05-31,717,spiral bound book,50,100,50,1,00018,India
143321,2023-05-31,707,marker,20,40,20,1,00026,India
143321,2023-05-31,712,graph paper,20,40,20,1,00026,India
143321,2023-05-31,709,notebook,30,60,30,2,00026,India
347148,2023-05-31,703,eraser,1,3,2,2,00227,India
347148,2023-05-31,713,ball pen,5,10,5,2,00227,India
104306,2023-05-31,717,spiral bound book,50,100,50,1,00213,India
104306,2023-05-31,707,marker,20,40,20,1,00213,India
104306,2023-05-31,705,stencil,10,20,10,2,00213,India
104306,2023-05-31,709,notebook,30,60,30,2,00213,India
104306,2023-05-31,702,pencil,2,5,3,2,00213,India
781576,2023-05-31,702,pencil,2,5,3,2,00309,India
781576,2023-05-31,709,notebook,30,60,30,2,00309,India
781576,2023-05-31,715,folder,5,15,10,1,00309,India
685279,2023-05-31,708,sketchpen,15,40,25,1,00130,India
685279,2023-05-31,717,spiral bound book,50,100,50,1,00130,India
685279,2023-05-31,710,geometry box,100,150,50,2,00130,India
685279,2023-05-31,715,folder,5,15,10,1,00130,India
815605,2023-05-31,713,ball pen,5,10,5,2,00276,India
549636,2023-05-31,705,stencil,10,20,10,2,00190,India
549636,2023-05-31,709,notebook,30,60,30,2,00190,India
612975,2023-05-31,702,pencil,2,5,3,2,00323,India
612975,2023-05-31,703,eraser,1,3,2,2,00323,India
612975,2023-05-31,706,sharpener,3,8,5,2,00323,India
621730,2023-05-31,709,notebook,30,60,30,2,00264,India
621730,2023-05-31,715,folder,5,15,10,1,00264,India
621730,2023-05-31,701,gel pen,5,10,5,2,00264,India
621730,2023-05-31,707,marker,20,40,20,1,00264,India
267699,2023-05-31,709,notebook,30,60,30,2,00145,India
982064,2023-05-31,713,ball pen,5,10,5,2,00326,India
814855,2023-05-31,710,geometry box,100,150,50,2,00367,India
814855,2023-05-31,716,printing paper,200,400,200,1,00367,India
814855,2023-05-31,712,graph paper,20,40,20,1,00367,India
814855,2023-05-31,711,TD kit,150,300,150,1,00367,India
986769,2023-06-01,709,notebook,30,60,30,1,00354,India
986769,2023-06-01,702,pencil,2,5,3,1,00354,India
986769,2023-06-01,701,gel pen,5,10,5,1,00354,India
986769,2023-06-01,703,eraser,1,3,2,1,00354,India
793117,2023-06-01,706,sharpener,3,8,5,1,00189,India
793117,2023-06-01,704,scale,5,10,5,1,00189,India
793117,2023-06-01,709,notebook,30,60,30,1,00189,India
793117,2023-06-01,714,carbon paper,15,30,15,1,00189,India
277105,2023-06-01,714,carbon paper,15,30,15,1,00089,India
277105,2023-06-01,701,gel pen,5,10,5,1,00089,India
277105,2023-06-01,713,ball pen,5,10,5,1,00089,India
277105,2023-06-01,706,sharpener,3,8,5,1,00089,India
466110,2023-06-01,711,TD kit,150,300,150,1,00368,India
466110,2023-06-01,704,scale,5,10,5,1,00368,India
466110,2023-06-01,709,notebook,30,60,30,1,00368,India
466110,2023-06-01,706,sharpener,3,8,5,1,00368,India
884074,2023-06-01,708,sketchpen,15,40,25,1,00464,India
714468,2023-06-01,709,notebook,30,60,30,1,00170,India
983546,2023-06-01,709,notebook,30,60,30,1,00142,India
983546,2023-06-01,702,pencil,2,5,3,1,00142,India
999442,2023-06-01,711,TD kit,150,300,150,1,00028,India
864701,2023-06-01,715,folder,5,15,10,1,00188,India
864701,2023-06-01,703,eraser,1,3,2,1,00188,India
172129,2023-06-01,717,spiral bound book,50,100,50,1,00477,India
172129,2023-06-01,716,printing paper,200,400,200,1,00477,India
172129,2023-06-01,703,eraser,1,3,2,1,00477,India
516296,2023-06-01,710,geometry box,100,150,50,1,00383,India
516296,2023-06-01,707,marker,20,40,20,1,00383,India
562651,2023-06-01,707,marker,20,40,20,1,00034,India
379547,2023-06-01,703,eraser,1,3,2,1,00082,India
379547,2023-06-01,710,geometry box,100,150,50,1,00082,India
508076,2023-06-01,704,scale,5,10,5,1,00414,India
508076,2023-06-01,712,graph paper,20,40,20,1,00414,India
508076,2023-06-01,715,folder,5,15,10,1,00414,India
508076,2023-06-01,705,stencil,10,20,10,1,00414,India
508076,2023-06-01,706,sharpener,3,8,5,1,00414,India
401796,2023-06-01,711,TD kit,150,300,150,1,00385,India
401796,2023-06-01,716,printing paper,200,400,200,1,00385,India
401796,2023-06-01,701,gel pen,5,10,5,1,00385,India
401796,2023-06-01,708,sketchpen,15,40,25,1,00385,India
580116,2023-06-01,708,sketchpen,15,40,25,1,00252,India
580116,2023-06-01,715,folder,5,15,10,1,00252,India
580116,2023-06-01,709,notebook,30,60,30,1,00252,India
580116,2023-06-01,704,scale,5,10,5,1,00252,India
580116,2023-06-01,713,ball pen,5,10,5,1,00252,India
517559,2023-06-01,708,sketchpen,15,40,25,1,00046,India
517559,2023-06-01,716,printing paper,200,400,200,1,00046,India
132217,2023-06-01,710,geometry box,100,150,50,1,00191,India
132217,2023-06-01,717,spiral bound book,50,100,50,1,00191,India
132217,2023-06-01,715,folder,5,15,10,1,00191,India
608377,2023-06-01,709,notebook,30,60,30,1,00219,India
608377,2023-06-01,715,folder,5,15,10,1,00219,India
608377,2023-06-01,707,marker,20,40,20,1,00219,India
608377,2023-06-01,710,geometry box,100,150,50,1,00219,India
608377,2023-06-01,706,sharpener,3,8,5,1,00219,India
286306,2023-06-01,713,ball pen,5,10,5,1,00099,India
286306,2023-06-01,715,folder,5,15,10,1,00099,India
119932,2023-06-01,705,stencil,10,20,10,1,00066,India
119932,2023-06-01,704,scale,5,10,5,1,00066,India
698555,2023-06-01,706,sharpener,3,8,5,1,00131,India
698555,2023-06-01,713,ball pen,5,10,5,1,00131,India
698555,2023-06-01,702,pencil,2,5,3,1,00131,India
698555,2023-06-01,714,carbon paper,15,30,15,1,00131,India
555253,2023-06-01,703,eraser,1,3,2,1,00119,India
555253,2023-06-01,708,sketchpen,15,40,25,1,00119,India
555253,2023-06-01,710,geometry box,100,150,50,1,00119,India
555253,2023-06-01,714,carbon paper,15,30,15,1,00119,India
271898,2023-06-01,712,graph paper,20,40,20,1,00408,India
271898,2023-06-01,717,spiral bound book,50,100,50,1,00408,India
271898,2023-06-01,714,carbon paper,15,30,15,1,00408,India
271898,2023-06-01,703,eraser,1,3,2,1,00408,India
483199,2023-06-01,710,geometry box,100,150,50,1,00005,India
483199,2023-06-01,709,notebook,30,60,30,1,00005,India
483199,2023-06-01,704,scale,5,10,5,1,00005,India
365128,2023-06-01,711,TD kit,150,300,150,1,00005,India
365128,2023-06-01,715,folder,5,15,10,1,00005,India
365128,2023-06-01,706,sharpener,3,8,5,1,00005,India
365128,2023-06-01,717,spiral bound book,50,100,50,1,00005,India
831301,2023-06-01,709,notebook,30,60,30,1,00311,India
831301,2023-06-01,710,geometry box,100,150,50,1,00311,India
831301,2023-06-01,701,gel pen,5,10,5,1,00311,India
535672,2023-06-01,705,stencil,10,20,10,1,00238,India
535672,2023-06-01,708,sketchpen,15,40,25,1,00238,India
296415,2023-06-01,708,sketchpen,15,40,25,1,00124,India
296415,2023-06-01,702,pencil,2,5,3,1,00124,India
296415,2023-06-01,713,ball pen,5,10,5,1,00124,India
187316,2023-06-01,705,stencil,10,20,10,1,00117,India
187316,2023-06-01,714,carbon paper,15,30,15,1,00117,India
187316,2023-06-01,703,eraser,1,3,2,1,00117,India
327694,2023-06-02,711,TD kit,150,300,150,1,00107,India
327694,2023-06-02,707,marker,20,40,20,1,00107,India
711626,2023-06-02,716,printing paper,200,400,200,1,00393,India
711626,2023-06-02,712,graph paper,20,40,20,1,00393,India
965407,2023-06-02,715,folder,5,15,10,1,00135,India
965407,2023-06-02,708,sketchpen,15,40,25,1,00135,India
965407,2023-06-02,716,printing paper,200,400,200,1,00135,India
308492,2023-06-02,703,eraser,1,3,2,1,00464,India
308492,2023-06-02,715,folder,5,15,10,1,00464,India
992279,2023-06-02,711,TD kit,150,300,150,1,00450,India
992279,2023-06-02,707,marker,20,40,20,1,00450,India
992279,2023-06-02,705,stencil,10,20,10,1,00450,India
992279,2023-06-02,712,graph paper,20,40,20,1,00450,India
519382,2023-06-02,706,sharpener,3,8,5,1,00075,India
519382,2023-06-02,713,ball pen,5,10,5,1,00075,India
686800,2023-06-02,707,marker,20,40,20,1,00221,India
686800,2023-06-02,710,geometry box,100,150,50,1,00221,India
155574,2023-06-02,709,notebook,30,60,30,1,00446,India
155574,2023-06-02,701,gel pen,5,10,5,1,00446,India
340879,2023-06-02,701,gel pen,5,10,5,1,00413,India
340879,2023-06-02,710,geometry box,100,150,50,1,00413,India
340879,2023-06-02,706,sharpener,3,8,5,1,00413,India
496264,2023-06-02,707,marker,20,40,20,1,00479,India
496264,2023-06-02,711,TD kit,150,300,150,1,00479,India
496264,2023-06-02,713,ball pen,5,10,5,1,00479,India
410839,2023-06-02,704,scale,5,10,5,1,00488,India
859290,2023-06-02,701,gel pen,5,10,5,1,00095,India
859290,2023-06-02,704,scale,5,10,5,1,00095,India
859290,2023-06-02,705,stencil,10,20,10,1,00095,India
940331,2023-06-02,703,eraser,1,3,2,1,00150,India
940331,2023-06-02,705,stencil,10,20,10,1,00150,India
940331,2023-06-02,716,printing paper,200,400,200,1,00150,India
940331,2023-06-02,714,carbon paper,15,30,15,1,00150,India
940331,2023-06-02,712,graph paper,20,40,20,1,00150,India
226107,2023-06-02,717,spiral bound book,50,100,50,1,00381,India
226107,2023-06-02,705,stencil,10,20,10,1,00381,India
242747,2023-06-02,715,folder,5,15,10,1,00381,India
242747,2023-06-02,713,ball pen,5,10,5,1,00381,India
242747,2023-06-02,708,sketchpen,15,40,25,1,00381,India
575956,2023-06-02,703,eraser,1,3,2,1,00334,India
575956,2023-06-02,710,geometry box,100,150,50,1,00334,India
575956,2023-06-02,705,stencil,10,20,10,1,00334,India
240700,2023-06-02,713,ball pen,5,10,5,1,00150,India
240700,2023-06-02,701,gel pen,5,10,5,1,00150,India
240700,2023-06-02,708,sketchpen,15,40,25,1,00150,India
502907,2023-06-02,709,notebook,30,60,30,1,00174,India
502907,2023-06-02,711,TD kit,150,300,150,1,00174,India
344517,2023-06-02,708,sketchpen,15,40,25,1,00228,India
344517,2023-06-02,715,folder,5,15,10,1,00228,India
344517,2023-06-02,717,spiral bound book,50,100,50,1,00228,India
344517,2023-06-02,707,marker,20,40,20,1,00228,India
344517,2023-06-02,710,geometry box,100,150,50,1,00228,India
339256,2023-06-02,709,notebook,30,60,30,1,00482,India
339256,2023-06-02,710,geometry box,100,150,50,1,00482,India
339256,2023-06-02,704,scale,5,10,5,1,00482,India
339256,2023-06-02,703,eraser,1,3,2,1,00482,India
339256,2023-06-02,714,carbon paper,15,30,15,1,00482,India
550563,2023-06-02,705,stencil,10,20,10,1,00124,India
550563,2023-06-02,701,gel pen,5,10,5,1,00124,India
550563,2023-06-02,702,pencil,2,5,3,1,00124,India
453786,2023-06-02,713,ball pen,5,10,5,1,00495,India
374630,2023-06-02,705,stencil,10,20,10,1,00289,India
374630,2023-06-02,701,gel pen,5,10,5,1,00289,India
314418,2023-06-02,705,stencil,10,20,10,1,00314,India
314418,2023-06-02,712,graph paper,20,40,20,1,00314,India
171905,2023-06-02,702,pencil,2,5,3,1,00259,India
171905,2023-06-02,711,TD kit,150,300,150,1,00259,India
171905,2023-06-02,708,sketchpen,15,40,25,1,00259,India
834131,2023-06-02,708,sketchpen,15,40,25,1,00240,India
834131,2023-06-02,703,eraser,1,3,2,1,00240,India
834131,2023-06-02,702,pencil,2,5,3,1,00240,India
834131,2023-06-02,711,TD kit,150,300,150,1,00240,India
834131,2023-06-02,712,graph paper,20,40,20,1,00240,India
571007,2023-06-02,714,carbon paper,15,30,15,1,00417,India
734643,2023-06-02,702,pencil,2,5,3,1,00353,India
734643,2023-06-02,712,graph paper,20,40,20,1,00353,India
391792,2023-06-02,705,stencil,10,20,10,1,00149,India
391792,2023-06-02,711,TD kit,150,300,150,1,00149,India
391792,2023-06-02,703,eraser,1,3,2,1,00149,India
391792,2023-06-02,701,gel pen,5,10,5,1,00149,India
391792,2023-06-02,707,marker,20,40,20,1,00149,India
847090,2023-06-02,713,ball pen,5,10,5,1,00293,India
847090,2023-06-02,715,folder,5,15,10,1,00293,India
847090,2023-06-02,704,scale,5,10,5,1,00293,India
847090,2023-06-02,714,carbon paper,15,30,15,1,00293,India
515517,2023-06-02,716,printing paper,200,400,200,1,00021,India
515517,2023-06-02,714,carbon paper,15,30,15,1,00021,India
515517,2023-06-02,702,pencil,2,5,3,1,00021,India
515517,2023-06-02,701,gel pen,5,10,5,1,00021,India
212506,2023-06-03,706,sharpener,3,8,5,1,00493,India
212506,2023-06-03,707,marker,20,40,20,1,00493,India
212506,2023-06-03,715,folder,5,15,10,1,00493,India
212506,2023-06-03,703,eraser,1,3,2,1,00493,India
103584,2023-06-03,704,scale,5,10,5,1,00420,India
103584,2023-06-03,709,notebook,30,60,30,1,00420,India
103584,2023-06-03,711,TD kit,150,300,150,1,00420,India
103584,2023-06-03,706,sharpener,3,8,5,1,00420,India
581314,2023-06-03,709,notebook,30,60,30,1,00353,India
581314,2023-06-03,714,carbon paper,15,30,15,1,00353,India
581314,2023-06-03,702,pencil,2,5,3,1,00353,India
581314,2023-06-03,707,marker,20,40,20,1,00353,India
987303,2023-06-03,704,scale,5,10,5,1,00022,India
987303,2023-06-03,711,TD kit,150,300,150,1,00022,India
987303,2023-06-03,715,folder,5,15,10,1,00022,India
987303,2023-06-03,707,marker,20,40,20,1,00022,India
987303,2023-06-03,713,ball pen,5,10,5,1,00022,India
102874,2023-06-03,712,graph paper,20,40,20,1,00335,India
148682,2023-06-03,706,sharpener,3,8,5,1,00244,India
148682,2023-06-03,715,folder,5,15,10,1,00244,India
120540,2023-06-03,713,ball pen,5,10,5,1,00075,India
120540,2023-06-03,706,sharpener,3,8,5,1,00075,India
120540,2023-06-03,710,geometry box,100,150,50,1,00075,India
120540,2023-06-03,715,folder,5,15,10,1,00075,India
437407,2023-06-03,711,TD kit,150,300,150,1,00391,India
437407,2023-06-03,702,pencil,2,5,3,1,00391,India
238459,2023-06-03,713,ball pen,5,10,5,1,00381,India
401199,2023-06-03,717,spiral bound book,50,100,50,1,00045,India
401199,2023-06-03,708,sketchpen,15,40,25,1,00045,India
449724,2023-06-03,710,geometry box,100,150,50,1,00224,India
449724,2023-06-03,716,printing paper,200,400,200,1,00224,India
566593,2023-06-03,712,graph paper,20,40,20,1,00436,India
566593,2023-06-03,701,gel pen,5,10,5,1,00436,India
228036,2023-06-03,710,geometry box,100,150,50,1,00234,India
228036,2023-06-03,708,sketchpen,15,40,25,1,00234,India
228036,2023-06-03,712,graph paper,20,40,20,1,00234,India
228036,2023-06-03,704,scale,5,10,5,1,00234,India
743467,2023-06-03,714,carbon paper,15,30,15,1,00411,India
743467,2023-06-03,716,printing paper,200,400,200,1,00411,India
743467,2023-06-03,712,graph paper,20,40,20,1,00411,India
743467,2023-06-03,708,sketchpen,15,40,25,1,00411,India
709317,2023-06-03,706,sharpener,3,8,5,1,00403,India
391109,2023-06-03,706,sharpener,3,8,5,1,00150,India
391109,2023-06-03,707,marker,20,40,20,1,00150,India
447928,2023-06-03,707,marker,20,40,20,1,00296,India
447928,2023-06-03,703,eraser,1,3,2,1,00296,India
447928,2023-06-03,706,sharpener,3,8,5,1,00296,India
742606,2023-06-03,717,spiral bound book,50,100,50,1,00485,India
742606,2023-06-03,705,stencil,10,20,10,1,00485,India
409311,2023-06-03,710,geometry box,100,150,50,1,00027,India
409311,2023-06-03,703,eraser,1,3,2,1,00027,India
409311,2023-06-03,714,carbon paper,15,30,15,1,00027,India
409311,2023-06-03,705,stencil,10,20,10,1,00027,India
363019,2023-06-03,705,stencil,10,20,10,1,00074,India
363019,2023-06-03,711,TD kit,150,300,150,1,00074,India
363019,2023-06-03,702,pencil,2,5,3,1,00074,India
363019,2023-06-03,712,graph paper,20,40,20,1,00074,India
306258,2023-06-03,714,carbon paper,15,30,15,1,00179,India
347505,2023-06-03,705,stencil,10,20,10,1,00238,India
347505,2023-06-03,706,sharpener,3,8,5,1,00238,India
347505,2023-06-03,716,printing paper,200,400,200,1,00238,India
146874,2023-06-03,705,stencil,10,20,10,1,00009,India
146874,2023-06-03,712,graph paper,20,40,20,1,00009,India
146874,2023-06-03,713,ball pen,5,10,5,1,00009,India
146874,2023-06-03,709,notebook,30,60,30,1,00009,India
761089,2023-06-03,706,sharpener,3,8,5,1,00378,India
997373,2023-06-03,714,carbon paper,15,30,15,1,00474,India
997373,2023-06-03,711,TD kit,150,300,150,1,00474,India
997373,2023-06-03,702,pencil,2,5,3,1,00474,India
997373,2023-06-03,706,sharpener,3,8,5,1,00474,India
997373,2023-06-03,704,scale,5,10,5,1,00474,India
585840,2023-06-03,706,sharpener,3,8,5,1,00188,India
445618,2023-06-03,709,notebook,30,60,30,1,00367,India
445618,2023-06-03,701,gel pen,5,10,5,1,00367,India
180141,2023-06-03,713,ball pen,5,10,5,1,00357,India
180141,2023-06-03,703,eraser,1,3,2,1,00357,India
180141,2023-06-03,712,graph paper,20,40,20,1,00357,India
180141,2023-06-03,704,scale,5,10,5,1,00357,India
180141,2023-06-03,707,marker,20,40,20,1,00357,India
760718,2023-06-03,704,scale,5,10,5,1,00499,India
760718,2023-06-03,710,geometry box,100,150,50,1,00499,India
760718,2023-06-03,708,sketchpen,15,40,25,1,00499,India
760718,2023-06-03,707,marker,20,40,20,1,00499,India
262500,2023-06-03,708,sketchpen,15,40,25,1,00181,India
262500,2023-06-03,705,stencil,10,20,10,1,00181,India
262500,2023-06-03,703,eraser,1,3,2,1,00181,India
662785,2023-06-03,716,printing paper,200,400,200,1,00187,India
662785,2023-06-03,710,geometry box,100,150,50,1,00187,India
662785,2023-06-03,715,folder,5,15,10,1,00187,India
662785,2023-06-03,713,ball pen,5,10,5,1,00187,India
727702,2023-06-03,711,TD kit,150,300,150,1,00120,India
727702,2023-06-03,707,marker,20,40,20,1,00120,India
127971,2023-06-04,708,sketchpen,15,40,25,1,00265,India
127971,2023-06-04,714,carbon paper,15,30,15,1,00265,India
386734,2023-06-04,715,folder,5,15,10,1,00292,India
386734,2023-06-04,701,gel pen,5,10,5,1,00292,India
386734,2023-06-04,708,sketchpen,15,40,25,1,00292,India
828439,2023-06-04,715,folder,5,15,10,1,00021,India
828439,2023-06-04,716,printing paper,200,400,200,1,00021,India
721100,2023-06-04,709,notebook,30,60,30,1,00414,India
721100,2023-06-04,703,eraser,1,3,2,1,00414,India
282557,2023-06-04,705,stencil,10,20,10,1,00460,India
282557,2023-06-04,716,printing paper,200,400,200,1,00460,India
461421,2023-06-04,707,marker,20,40,20,1,00283,India
177175,2023-06-04,712,graph paper,20,40,20,1,00048,India
177175,2023-06-04,710,geometry box,100,150,50,1,00048,India
177175,2023-06-04,717,spiral bound book,50,100,50,1,00048,India
177175,2023-06-04,706,sharpener,3,8,5,1,00048,India
964317,2023-06-04,710,geometry box,100,150,50,1,00156,India
964317,2023-06-04,706,sharpener,3,8,5,1,00156,India
964317,2023-06-04,703,eraser,1,3,2,1,00156,India
865623,2023-06-04,714,carbon paper,15,30,15,1,00491,India
865623,2023-06-04,710,geometry box,100,150,50,1,00491,India
865623,2023-06-04,712,graph paper,20,40,20,1,00491,India
493372,2023-06-04,702,pencil,2,5,3,1,00260,India
493372,2023-06-04,708,sketchpen,15,40,25,1,00260,India
606061,2023-06-04,716,printing paper,200,400,200,1,00204,India
193426,2023-06-04,704,scale,5,10,5,1,00217,India
193426,2023-06-04,709,notebook,30,60,30,1,00217,India
193426,2023-06-04,714,carbon paper,15,30,15,1,00217,India
193426,2023-06-04,710,geometry box,100,150,50,1,00217,India
224927,2023-06-04,706,sharpener,3,8,5,1,00440,India
224927,2023-06-04,713,ball pen,5,10,5,1,00440,India
739328,2023-06-04,705,stencil,10,20,10,1,00133,India
739328,2023-06-04,710,geometry box,100,150,50,1,00133,India
739328,2023-06-04,706,sharpener,3,8,5,1,00133,India
739328,2023-06-04,701,gel pen,5,10,5,1,00133,India
183817,2023-06-04,701,gel pen,5,10,5,1,00464,India
183817,2023-06-04,711,TD kit,150,300,150,1,00464,India
183817,2023-06-04,702,pencil,2,5,3,1,00464,India
635490,2023-06-04,707,marker,20,40,20,1,00400,India
635490,2023-06-04,714,carbon paper,15,30,15,1,00400,India
635490,2023-06-04,706,sharpener,3,8,5,1,00400,India
635490,2023-06-04,703,eraser,1,3,2,1,00400,India
276763,2023-06-04,702,pencil,2,5,3,1,00473,India
276763,2023-06-04,716,printing paper,200,400,200,1,00473,India
276763,2023-06-04,701,gel pen,5,10,5,1,00473,India
276763,2023-06-04,703,eraser,1,3,2,1,00473,India
544487,2023-06-04,717,spiral bound book,50,100,50,1,00305,India
544487,2023-06-04,710,geometry box,100,150,50,1,00305,India
544487,2023-06-04,708,sketchpen,15,40,25,1,00305,India
567328,2023-06-04,705,stencil,10,20,10,1,00081,India
567328,2023-06-04,709,notebook,30,60,30,1,00081,India
569814,2023-06-04,706,sharpener,3,8,5,1,00410,India
512992,2023-06-04,707,marker,20,40,20,1,00011,India
939375,2023-06-04,708,sketchpen,15,40,25,1,00313,India
939375,2023-06-04,702,pencil,2,5,3,1,00313,India
939375,2023-06-04,717,spiral bound book,50,100,50,1,00313,India
939375,2023-06-04,714,carbon paper,15,30,15,1,00313,India
802992,2023-06-04,717,spiral bound book,50,100,50,1,00349,India
802992,2023-06-04,708,sketchpen,15,40,25,1,00349,India
802992,2023-06-04,709,notebook,30,60,30,1,00349,India
242476,2023-06-04,705,stencil,10,20,10,1,00098,India
242476,2023-06-04,708,sketchpen,15,40,25,1,00098,India
242476,2023-06-04,703,eraser,1,3,2,1,00098,India
784827,2023-06-04,714,carbon paper,15,30,15,1,00076,India
784827,2023-06-04,703,eraser,1,3,2,1,00076,India
784827,2023-06-04,717,spiral bound book,50,100,50,1,00076,India
674877,2023-06-04,702,pencil,2,5,3,1,00421,India
674877,2023-06-04,712,graph paper,20,40,20,1,00421,India
674877,2023-06-04,708,sketchpen,15,40,25,1,00421,India
358460,2023-06-04,710,geometry box,100,150,50,1,00032,India
963770,2023-06-04,708,sketchpen,15,40,25,1,00088,India
963770,2023-06-04,710,geometry box,100,150,50,1,00088,India
963770,2023-06-04,706,sharpener,3,8,5,1,00088,India
963770,2023-06-04,701,gel pen,5,10,5,1,00088,India
892874,2023-06-04,707,marker,20,40,20,1,00039,India
225135,2023-06-04,717,spiral bound book,50,100,50,1,00090,India
225135,2023-06-04,710,geometry box,100,150,50,1,00090,India
225135,2023-06-04,704,scale,5,10,5,1,00090,India
764153,2023-06-05,709,notebook,30,60,30,1,00463,India
764153,2023-06-05,716,printing paper,200,400,200,1,00463,India
764153,2023-06-05,701,gel pen,5,10,5,1,00463,India
764153,2023-06-05,710,geometry box,100,150,50,1,00463,India
550207,2023-06-05,716,printing paper,200,400,200,1,00426,India
945864,2023-06-05,704,scale,5,10,5,1,00450,India
347655,2023-06-05,712,graph paper,20,40,20,1,00183,India
347655,2023-06-05,709,notebook,30,60,30,1,00183,India
347655,2023-06-05,704,scale,5,10,5,1,00183,India
789028,2023-06-05,707,marker,20,40,20,1,00269,India
789028,2023-06-05,704,scale,5,10,5,1,00269,India
827593,2023-06-05,715,folder,5,15,10,1,00442,India
827593,2023-06-05,714,carbon paper,15,30,15,1,00442,India
349214,2023-06-05,716,printing paper,200,400,200,1,00455,India
349214,2023-06-05,712,graph paper,20,40,20,1,00455,India
349214,2023-06-05,715,folder,5,15,10,1,00455,India
915995,2023-06-05,710,geometry box,100,150,50,1,00064,India
915995,2023-06-05,711,TD kit,150,300,150,1,00064,India
915995,2023-06-05,707,marker,20,40,20,1,00064,India
893003,2023-06-05,703,eraser,1,3,2,1,00173,India
241691,2023-06-05,703,eraser,1,3,2,1,00267,India
241691,2023-06-05,706,sharpener,3,8,5,1,00267,India
241691,2023-06-05,710,geometry box,100,150,50,1,00267,India
213876,2023-06-05,702,pencil,2,5,3,1,00232,India
213876,2023-06-05,714,carbon paper,15,30,15,1,00232,India
160309,2023-06-05,712,graph paper,20,40,20,1,00492,India
160309,2023-06-05,704,scale,5,10,5,1,00492,India
160309,2023-06-05,706,sharpener,3,8,5,1,00492,India
160309,2023-06-05,709,notebook,30,60,30,1,00492,India
825702,2023-06-05,713,ball pen,5,10,5,1,00356,India
825702,2023-06-05,701,gel pen,5,10,5,1,00356,India
825702,2023-06-05,707,marker,20,40,20,1,00356,India
825702,2023-06-05,702,pencil,2,5,3,1,00356,India
912431,2023-06-05,716,printing paper,200,400,200,1,00372,India
912431,2023-06-05,703,eraser,1,3,2,1,00372,India
465756,2023-06-05,708,sketchpen,15,40,25,1,00388,India
465756,2023-06-05,707,marker,20,40,20,1,00388,India
465756,2023-06-05,716,printing paper,200,400,200,1,00388,India
465756,2023-06-05,715,folder,5,15,10,1,00388,India
748796,2023-06-05,715,folder,5,15,10,1,00010,India
862387,2023-06-05,710,geometry box,100,150,50,1,00009,India
862387,2023-06-05,712,graph paper,20,40,20,1,00009,India
862387,2023-06-05,714,carbon paper,15,30,15,1,00009,India
862387,2023-06-05,704,scale,5,10,5,1,00009,India
862387,2023-06-05,703,eraser,1,3,2,1,00009,India
280454,2023-06-05,701,gel pen,5,10,5,1,00137,India
280454,2023-06-05,709,notebook,30,60,30,1,00137,India
311961,2023-06-05,710,geometry box,100,150,50,1,00022,India
755251,2023-06-05,707,marker,20,40,20,1,00193,India
755251,2023-06-05,701,gel pen,5,10,5,1,00193,India
755251,2023-06-05,709,notebook,30,60,30,1,00193,India
755251,2023-06-05,715,folder,5,15,10,1,00193,India
474683,2023-06-05,716,printing paper,200,400,200,1,00402,India
474683,2023-06-05,706,sharpener,3,8,5,1,00402,India
474683,2023-06-05,713,ball pen,5,10,5,1,00402,India
759788,2023-06-05,715,folder,5,15,10,1,00180,India
759788,2023-06-05,706,sharpener,3,8,5,1,00180,India
823949,2023-06-05,708,sketchpen,15,40,25,1,00467,India
823949,2023-06-05,702,pencil,2,5,3,1,00467,India
269822,2023-06-05,705,stencil,10,20,10,1,00379,India
596346,2023-06-05,702,pencil,2,5,3,1,00259,India
596346,2023-06-05,711,TD kit,150,300,150,1,00259,India
596346,2023-06-05,707,marker,20,40,20,1,00259,India
587433,2023-06-05,709,notebook,30,60,30,1,00336,India
587433,2023-06-05,712,graph paper,20,40,20,1,00336,India
587433,2023-06-05,705,stencil,10,20,10,1,00336,India
587433,2023-06-05,706,sharpener,3,8,5,1,00336,India
587433,2023-06-05,710,geometry box,100,150,50,1,00336,India
533901,2023-06-05,706,sharpener,3,8,5,1,00311,India
533901,2023-06-05,710,geometry box,100,150,50,1,00311,India
533901,2023-06-05,709,notebook,30,60,30,1,00311,India
533901,2023-06-05,702,pencil,2,5,3,1,00311,India
508911,2023-06-05,704,scale,5,10,5,1,00008,India
506906,2023-06-05,704,scale,5,10,5,1,00116,India
506906,2023-06-05,708,sketchpen,15,40,25,1,00116,India
506906,2023-06-05,705,stencil,10,20,10,1,00116,India
730680,2023-06-05,711,TD kit,150,300,150,1,00312,India
730680,2023-06-05,705,stencil,10,20,10,1,00312,India
730680,2023-06-05,715,folder,5,15,10,1,00312,India
730680,2023-06-05,701,gel pen,5,10,5,1,00312,India
704048,2023-06-05,707,marker,20,40,20,1,00247,India
808420,2023-06-05,706,sharpener,3,8,5,1,00472,India
121549,2023-06-05,703,eraser,1,3,2,1,00044,India
121549,2023-06-05,713,ball pen,5,10,5,1,00044,India
121549,2023-06-05,707,marker,20,40,20,1,00044,India
785338,2023-06-05,716,printing paper,200,400,200,1,00187,India
484204,2023-06-05,711,TD kit,150,300,150,1,00416,India
484204,2023-06-05,702,pencil,2,5,3,1,00416,India
484204,2023-06-05,707,marker,20,40,20,1,00416,India
484204,2023-06-05,703,eraser,1,3,2,1,00416,India
484204,2023-06-05,714,carbon paper,15,30,15,1,00416,India
756493,2023-06-05,717,spiral bound book,50,100,50,1,00158,India
756493,2023-06-05,716,printing paper,200,400,200,1,00158,India
756493,2023-06-05,702,pencil,2,5,3,1,00158,India
756493,2023-06-05,715,folder,5,15,10,1,00158,India
628554,2023-06-05,711,TD kit,150,300,150,1,00456,India
628554,2023-06-05,701,gel pen,5,10,5,1,00456,India
628554,2023-06-05,717,spiral bound book,50,100,50,1,00456,India
684575,2023-06-05,707,marker,20,40,20,1,00283,India
684575,2023-06-05,703,eraser,1,3,2,1,00283,India
684575,2023-06-05,705,stencil,10,20,10,1,00283,India
684575,2023-06-05,710,geometry box,100,150,50,1,00283,India
684575,2023-06-05,716,printing paper,200,400,200,1,00283,India
642941,2023-06-05,711,TD kit,150,300,150,1,00261,India
725434,2023-06-05,709,notebook,30,60,30,1,00237,India
725434,2023-06-05,703,eraser,1,3,2,1,00237,India
716999,2023-06-05,703,eraser,1,3,2,1,00043,India
716999,2023-06-05,714,carbon paper,15,30,15,1,00043,India
716999,2023-06-05,709,notebook,30,60,30,1,00043,India
558813,2023-06-05,701,gel pen,5,10,5,1,00351,India
558813,2023-06-05,705,stencil,10,20,10,1,00351,India
558813,2023-06-05,714,carbon paper,15,30,15,1,00351,India
558813,2023-06-05,709,notebook,30,60,30,1,00351,India
344680,2023-06-06,712,graph paper,20,40,20,1,00083,India
344680,2023-06-06,710,geometry box,100,150,50,1,00083,India
344680,2023-06-06,704,scale,5,10,5,1,00083,India
297159,2023-06-06,704,scale,5,10,5,1,00446,India
297159,2023-06-06,702,pencil,2,5,3,1,00446,India
297159,2023-06-06,710,geometry box,100,150,50,1,00446,India
662700,2023-06-06,715,folder,5,15,10,1,00364,India
662700,2023-06-06,702,pencil,2,5,3,1,00364,India
662700,2023-06-06,707,marker,20,40,20,1,00364,India
836951,2023-06-06,712,graph paper,20,40,20,1,00498,India
274813,2023-06-06,708,sketchpen,15,40,25,1,00060,India
351291,2023-06-06,706,sharpener,3,8,5,1,00323,India
351291,2023-06-06,702,pencil,2,5,3,1,00323,India
351291,2023-06-06,714,carbon paper,15,30,15,1,00323,India
367716,2023-06-06,713,ball pen,5,10,5,1,00309,India
367716,2023-06-06,703,eraser,1,3,2,1,00309,India
367716,2023-06-06,712,graph paper,20,40,20,1,00309,India
154568,2023-06-06,703,eraser,1,3,2,1,00482,India
154568,2023-06-06,716,printing paper,200,400,200,1,00482,India
178544,2023-06-06,710,geometry box,100,150,50,1,00350,India
178544,2023-06-06,701,gel pen,5,10,5,1,00350,India
178544,2023-06-06,702,pencil,2,5,3,1,00350,India
178544,2023-06-06,708,sketchpen,15,40,25,1,00350,India
178544,2023-06-06,713,ball pen,5,10,5,1,00350,India
302402,2023-06-06,701,gel pen,5,10,5,1,00466,India
998893,2023-06-06,716,printing paper,200,400,200,1,00217,India
998893,2023-06-06,707,marker,20,40,20,1,00217,India
998893,2023-06-06,717,spiral bound book,50,100,50,1,00217,India
657621,2023-06-06,703,eraser,1,3,2,1,00411,India
657621,2023-06-06,706,sharpener,3,8,5,1,00411,India
657621,2023-06-06,701,gel pen,5,10,5,1,00411,India
657621,2023-06-06,713,ball pen,5,10,5,1,00411,India
453389,2023-06-06,706,sharpener,3,8,5,1,00303,India
618038,2023-06-06,711,TD kit,150,300,150,1,00406,India
183833,2023-06-06,716,printing paper,200,400,200,1,00453,India
952036,2023-06-06,713,ball pen,5,10,5,1,00338,India
952036,2023-06-06,709,notebook,30,60,30,1,00338,India
952036,2023-06-06,705,stencil,10,20,10,1,00338,India
982439,2023-06-06,701,gel pen,5,10,5,1,00421,India
982439,2023-06-06,706,sharpener,3,8,5,1,00421,India
388037,2023-06-06,713,ball pen,5,10,5,1,00392,India
388037,2023-06-06,711,TD kit,150,300,150,1,00392,India
554384,2023-06-06,713,ball pen,5,10,5,1,00333,India
554384,2023-06-06,716,printing paper,200,400,200,1,00333,India
554384,2023-06-06,701,gel pen,5,10,5,1,00333,India
296555,2023-06-06,705,stencil,10,20,10,1,00123,India
296555,2023-06-06,713,ball pen,5,10,5,1,00123,India
296555,2023-06-06,708,sketchpen,15,40,25,1,00123,India
580494,2023-06-06,710,geometry box,100,150,50,1,00261,India
580494,2023-06-06,706,sharpener,3,8,5,1,00261,India
580494,2023-06-06,701,gel pen,5,10,5,1,00261,India
580494,2023-06-06,711,TD kit,150,300,150,1,00261,India
649098,2023-06-06,705,stencil,10,20,10,1,00490,India
649098,2023-06-06,717,spiral bound book,50,100,50,1,00490,India
649098,2023-06-06,707,marker,20,40,20,1,00490,India
649098,2023-06-06,701,gel pen,5,10,5,1,00490,India
649098,2023-06-06,712,graph paper,20,40,20,1,00490,India
720617,2023-06-06,715,folder,5,15,10,1,00181,India
720617,2023-06-06,712,graph paper,20,40,20,1,00181,India
720617,2023-06-06,717,spiral bound book,50,100,50,1,00181,India
366376,2023-06-06,716,printing paper,200,400,200,1,00271,India
366376,2023-06-06,711,TD kit,150,300,150,1,00271,India
698174,2023-06-06,714,carbon paper,15,30,15,1,00414,India
698174,2023-06-06,705,stencil,10,20,10,1,00414,India
161358,2023-06-06,702,pencil,2,5,3,1,00135,India
161358,2023-06-06,708,sketchpen,15,40,25,1,00135,India
161358,2023-06-06,716,printing paper,200,400,200,1,00135,India
161358,2023-06-06,704,scale,5,10,5,1,00135,India
629294,2023-06-06,703,eraser,1,3,2,1,00424,India
264494,2023-06-06,712,graph paper,20,40,20,1,00190,India
264494,2023-06-06,714,carbon paper,15,30,15,1,00190,India
264494,2023-06-06,715,folder,5,15,10,1,00190,India
175594,2023-06-06,704,scale,5,10,5,1,00392,India
175594,2023-06-06,703,eraser,1,3,2,1,00392,India
175594,2023-06-06,701,gel pen,5,10,5,1,00392,India
270554,2023-06-06,716,printing paper,200,400,200,1,00411,India
270554,2023-06-06,713,ball pen,5,10,5,1,00411,India
270554,2023-06-06,702,pencil,2,5,3,1,00411,India
727121,2023-06-06,714,carbon paper,15,30,15,1,00237,India
466736,2023-06-06,707,marker,20,40,20,1,00467,India
466736,2023-06-06,701,gel pen,5,10,5,1,00467,India
466736,2023-06-06,705,stencil,10,20,10,1,00467,India
466736,2023-06-06,703,eraser,1,3,2,1,00467,India
466736,2023-06-06,702,pencil,2,5,3,1,00467,India
226148,2023-06-06,707,marker,20,40,20,1,00270,India
226148,2023-06-06,715,folder,5,15,10,1,00270,India
270550,2023-06-06,714,carbon paper,15,30,15,1,00069,India
270550,2023-06-06,707,marker,20,40,20,1,00069,India
270550,2023-06-06,701,gel pen,5,10,5,1,00069,India
270550,2023-06-06,713,ball pen,5,10,5,1,00069,India
682527,2023-06-06,712,graph paper,20,40,20,1,00137,India
682527,2023-06-06,715,folder,5,15,10,1,00137,India
920162,2023-06-06,711,TD kit,150,300,150,1,00440,India
920162,2023-06-06,710,geometry box,100,150,50,1,00440,India
949036,2023-06-06,708,sketchpen,15,40,25,1,00099,India
949036,2023-06-06,704,scale,5,10,5,1,00099,India
257690,2023-06-06,707,marker,20,40,20,1,00206,India
257690,2023-06-06,716,printing paper,200,400,200,1,00206,India
257690,2023-06-06,712,graph paper,20,40,20,1,00206,India
302116,2023-06-06,710,geometry box,100,150,50,1,00246,India
302116,2023-06-06,705,stencil,10,20,10,1,00246,India
302116,2023-06-06,709,notebook,30,60,30,1,00246,India
302116,2023-06-06,706,sharpener,3,8,5,1,00246,India
302116,2023-06-06,702,pencil,2,5,3,1,00246,India
318353,2023-06-06,713,ball pen,5,10,5,1,00325,India
318353,2023-06-06,712,graph paper,20,40,20,1,00325,India
318353,2023-06-06,710,geometry box,100,150,50,1,00325,India
318353,2023-06-06,705,stencil,10,20,10,1,00325,India
325941,2023-06-06,710,geometry box,100,150,50,1,00363,India
437122,2023-06-06,715,folder,5,15,10,1,00392,India
193933,2023-06-06,712,graph paper,20,40,20,1,00427,India
193933,2023-06-06,716,printing paper,200,400,200,1,00427,India
193933,2023-06-06,705,stencil,10,20,10,1,00427,India
193933,2023-06-06,713,ball pen,5,10,5,1,00427,India
923181,2023-06-06,708,sketchpen,15,40,25,1,00016,India
923181,2023-06-06,702,pencil,2,5,3,1,00016,India
923181,2023-06-06,707,marker,20,40,20,1,00016,India
923181,2023-06-06,712,graph paper,20,40,20,1,00016,India
923181,2023-06-06,709,notebook,30,60,30,1,00016,India
875536,2023-06-07,708,sketchpen,15,40,25,1,00424,India
537381,2023-06-07,710,geometry box,100,150,50,1,00060,India
537381,2023-06-07,707,marker,20,40,20,1,00060,India
537381,2023-06-07,716,printing paper,200,400,200,1,00060,India
593898,2023-06-07,701,gel pen,5,10,5,1,00123,India
593898,2023-06-07,704,scale,5,10,5,1,00123,India
593898,2023-06-07,713,ball pen,5,10,5,1,00123,India
890881,2023-06-07,710,geometry box,100,150,50,1,00273,India
890881,2023-06-07,701,gel pen,5,10,5,1,00273,India
890881,2023-06-07,704,scale,5,10,5,1,00273,India
890881,2023-06-07,702,pencil,2,5,3,1,00273,India
188948,2023-06-07,714,carbon paper,15,30,15,1,00080,India
188948,2023-06-07,715,folder,5,15,10,1,00080,India
188948,2023-06-07,713,ball pen,5,10,5,1,00080,India
188948,2023-06-07,704,scale,5,10,5,1,00080,India
667803,2023-06-07,715,folder,5,15,10,1,00181,India
667803,2023-06-07,701,gel pen,5,10,5,1,00181,India
667803,2023-06-07,703,eraser,1,3,2,1,00181,India
667803,2023-06-07,711,TD kit,150,300,150,1,00181,India
972622,2023-06-07,717,spiral bound book,50,100,50,1,00302,India
972622,2023-06-07,712,graph paper,20,40,20,1,00302,India
745158,2023-06-07,707,marker,20,40,20,1,00170,India
745158,2023-06-07,709,notebook,30,60,30,1,00170,India
745158,2023-06-07,705,stencil,10,20,10,1,00170,India
745158,2023-06-07,706,sharpener,3,8,5,1,00170,India
745158,2023-06-07,703,eraser,1,3,2,1,00170,India
759228,2023-06-07,711,TD kit,150,300,150,1,00330,India
759228,2023-06-07,706,sharpener,3,8,5,1,00330,India
463630,2023-06-07,704,scale,5,10,5,1,00001,India
822429,2023-06-07,712,graph paper,20,40,20,1,00368,India
822429,2023-06-07,710,geometry box,100,150,50,1,00368,India
822429,2023-06-07,705,stencil,10,20,10,1,00368,India
822429,2023-06-07,707,marker,20,40,20,1,00368,India
822429,2023-06-07,717,spiral bound book,50,100,50,1,00368,India
137937,2023-06-07,707,marker,20,40,20,1,00392,India
137937,2023-06-07,709,notebook,30,60,30,1,00392,India
137937,2023-06-07,715,folder,5,15,10,1,00392,India
137937,2023-06-07,714,carbon paper,15,30,15,1,00392,India
137937,2023-06-07,706,sharpener,3,8,5,1,00392,India
917553,2023-06-07,703,eraser,1,3,2,1,00488,India
917553,2023-06-07,708,sketchpen,15,40,25,1,00488,India
917553,2023-06-07,716,printing paper,200,400,200,1,00488,India
105678,2023-06-07,715,folder,5,15,10,1,00234,India
105678,2023-06-07,711,TD kit,150,300,150,1,00234,India
663940,2023-06-07,711,TD kit,150,300,150,1,00068,India
195839,2023-06-07,712,graph paper,20,40,20,1,00411,India
452209,2023-06-07,716,printing paper,200,400,200,1,00430,India
458665,2023-06-07,706,sharpener,3,8,5,1,00228,India
594115,2023-06-07,712,graph paper,20,40,20,1,00276,India
594115,2023-06-07,713,ball pen,5,10,5,1,00276,India
594115,2023-06-07,711,TD kit,150,300,150,1,00276,India
577923,2023-06-07,714,carbon paper,15,30,15,1,00065,India
577923,2023-06-07,705,stencil,10,20,10,1,00065,India
577923,2023-06-07,703,eraser,1,3,2,1,00065,India
577923,2023-06-07,717,spiral bound book,50,100,50,1,00065,India
347730,2023-06-07,702,pencil,2,5,3,1,00277,India
347730,2023-06-07,712,graph paper,20,40,20,1,00277,India
347730,2023-06-07,717,spiral bound book,50,100,50,1,00277,India
352860,2023-06-07,704,scale,5,10,5,1,00085,India
352860,2023-06-07,707,marker,20,40,20,1,00085,India
352860,2023-06-07,701,gel pen,5,10,5,1,00085,India
513390,2023-06-07,709,notebook,30,60,30,1,00081,India
513390,2023-06-07,701,gel pen,5,10,5,1,00081,India
513390,2023-06-07,703,eraser,1,3,2,1,00081,India
513390,2023-06-07,706,sharpener,3,8,5,1,00081,India
852734,2023-06-07,717,spiral bound book,50,100,50,1,00135,India
852734,2023-06-07,706,sharpener,3,8,5,1,00135,India
310145,2023-06-07,703,eraser,1,3,2,1,00214,India
310145,2023-06-07,709,notebook,30,60,30,1,00214,India
310145,2023-06-07,705,stencil,10,20,10,1,00214,India
269712,2023-06-07,704,scale,5,10,5,1,00099,India
269712,2023-06-07,702,pencil,2,5,3,1,00099,India
269712,2023-06-07,706,sharpener,3,8,5,1,00099,India
269712,2023-06-07,711,TD kit,150,300,150,1,00099,India
562855,2023-06-07,703,eraser,1,3,2,1,00379,India
562855,2023-06-07,716,printing paper,200,400,200,1,00379,India
562855,2023-06-07,707,marker,20,40,20,1,00379,India
322641,2023-06-07,706,sharpener,3,8,5,1,00267,India
322641,2023-06-07,715,folder,5,15,10,1,00267,India
322641,2023-06-07,713,ball pen,5,10,5,1,00267,India
322641,2023-06-07,710,geometry box,100,150,50,1,00267,India
322641,2023-06-07,716,printing paper,200,400,200,1,00267,India
318995,2023-06-07,716,printing paper,200,400,200,1,00385,India
318995,2023-06-07,709,notebook,30,60,30,1,00385,India
318995,2023-06-07,708,sketchpen,15,40,25,1,00385,India
424593,2023-06-07,715,folder,5,15,10,1,00448,India
424593,2023-06-07,716,printing paper,200,400,200,1,00448,India
424593,2023-06-07,714,carbon paper,15,30,15,1,00448,India
424593,2023-06-07,708,sketchpen,15,40,25,1,00448,India
790602,2023-06-07,711,TD kit,150,300,150,1,00469,India
790602,2023-06-07,715,folder,5,15,10,1,00469,India
790602,2023-06-07,705,stencil,10,20,10,1,00469,India
421070,2023-06-07,711,TD kit,150,300,150,1,00003,India
421070,2023-06-07,707,marker,20,40,20,1,00003,India
421070,2023-06-07,702,pencil,2,5,3,1,00003,India
421070,2023-06-07,704,scale,5,10,5,1,00003,India
548496,2023-06-07,707,marker,20,40,20,1,00153,India
548496,2023-06-07,717,spiral bound book,50,100,50,1,00153,India
548496,2023-06-07,702,pencil,2,5,3,1,00153,India
926794,2023-06-07,702,pencil,2,5,3,1,00035,India
926794,2023-06-07,705,stencil,10,20,10,1,00035,India
976545,2023-06-07,701,gel pen,5,10,5,1,00233,India
976545,2023-06-07,712,graph paper,20,40,20,1,00233,India
976545,2023-06-07,716,printing paper,200,400,200,1,00233,India
569668,2023-06-07,706,sharpener,3,8,5,1,00137,India
515486,2023-06-07,716,printing paper,200,400,200,1,00056,India
515486,2023-06-07,706,sharpener,3,8,5,1,00056,India
515486,2023-06-07,708,sketchpen,15,40,25,1,00056,India
515486,2023-06-07,711,TD kit,150,300,150,1,00056,India
644634,2023-06-07,706,sharpener,3,8,5,1,00052,India
644634,2023-06-07,708,sketchpen,15,40,25,1,00052,India
644634,2023-06-07,711,TD kit,150,300,150,1,00052,India
121291,2023-06-07,714,carbon paper,15,30,15,1,00068,India
121291,2023-06-07,704,scale,5,10,5,1,00068,India
121291,2023-06-07,703,eraser,1,3,2,1,00068,India
121291,2023-06-07,717,spiral bound book,50,100,50,1,00068,India
121291,2023-06-07,711,TD kit,150,300,150,1,00068,India
395413,2023-06-07,707,marker,20,40,20,1,00243,India
395413,2023-06-07,710,geometry box,100,150,50,1,00243,India
384861,2023-06-07,714,carbon paper,15,30,15,1,00059,India
384861,2023-06-07,705,stencil,10,20,10,1,00059,India
384861,2023-06-07,701,gel pen,5,10,5,1,00059,India
384861,2023-06-07,712,graph paper,20,40,20,1,00059,India
777688,2023-06-07,703,eraser,1,3,2,1,00266,India
642371,2023-06-07,707,marker,20,40,20,1,00228,India
642371,2023-06-07,715,folder,5,15,10,1,00228,India
834299,2023-06-07,714,carbon paper,15,30,15,1,00447,India
834299,2023-06-07,712,graph paper,20,40,20,1,00447,India
834299,2023-06-07,702,pencil,2,5,3,1,00447,India
164212,2023-06-07,707,marker,20,40,20,1,00352,India
164212,2023-06-07,717,spiral bound book,50,100,50,1,00352,India
164212,2023-06-07,710,geometry box,100,150,50,1,00352,India
164212,2023-06-07,712,graph paper,20,40,20,1,00352,India
755816,2023-06-08,713,ball pen,5,10,5,1,00236,India
755816,2023-06-08,712,graph paper,20,40,20,1,00236,India
540648,2023-06-08,706,sharpener,3,8,5,1,00426,India
332973,2023-06-08,704,scale,5,10,5,1,00047,India
332973,2023-06-08,713,ball pen,5,10,5,1,00047,India
332973,2023-06-08,715,folder,5,15,10,1,00047,India
632580,2023-06-08,703,eraser,1,3,2,1,00059,India
632580,2023-06-08,709,notebook,30,60,30,1,00059,India
632580,2023-06-08,716,printing paper,200,400,200,1,00059,India
632580,2023-06-08,714,carbon paper,15,30,15,1,00059,India
632580,2023-06-08,704,scale,5,10,5,1,00059,India
652940,2023-06-08,705,stencil,10,20,10,1,00444,India
652940,2023-06-08,704,scale,5,10,5,1,00444,India
652940,2023-06-08,710,geometry box,100,150,50,1,00444,India
652940,2023-06-08,703,eraser,1,3,2,1,00444,India
878107,2023-06-08,707,marker,20,40,20,1,00347,India
271665,2023-06-08,717,spiral bound book,50,100,50,1,00279,India
271665,2023-06-08,706,sharpener,3,8,5,1,00279,India
775280,2023-06-08,704,scale,5,10,5,1,00118,India
775280,2023-06-08,714,carbon paper,15,30,15,1,00118,India
678926,2023-06-08,714,carbon paper,15,30,15,1,00343,India
678926,2023-06-08,717,spiral bound book,50,100,50,1,00343,India
678926,2023-06-08,716,printing paper,200,400,200,1,00343,India
678926,2023-06-08,713,ball pen,5,10,5,1,00343,India
192008,2023-06-08,713,ball pen,5,10,5,1,00331,India
698872,2023-06-08,714,carbon paper,15,30,15,1,00119,India
698872,2023-06-08,705,stencil,10,20,10,1,00119,India
698872,2023-06-08,710,geometry box,100,150,50,1,00119,India
698872,2023-06-08,702,pencil,2,5,3,1,00119,India
540017,2023-06-08,703,eraser,1,3,2,1,00499,India
833010,2023-06-08,710,geometry box,100,150,50,1,00321,India
833010,2023-06-08,716,printing paper,200,400,200,1,00321,India
833010,2023-06-08,708,sketchpen,15,40,25,1,00321,India
833010,2023-06-08,713,ball pen,5,10,5,1,00321,India
833010,2023-06-08,703,eraser,1,3,2,1,00321,India
923596,2023-06-08,710,geometry box,100,150,50,1,00154,India
923596,2023-06-08,703,eraser,1,3,2,1,00154,India
923596,2023-06-08,713,ball pen,5,10,5,1,00154,India
336658,2023-06-08,702,pencil,2,5,3,1,00261,India
336658,2023-06-08,704,scale,5,10,5,1,00261,India
336658,2023-06-08,701,gel pen,5,10,5,1,00261,India
847774,2023-06-08,703,eraser,1,3,2,1,00257,India
847774,2023-06-08,709,notebook,30,60,30,1,00257,India
847774,2023-06-08,710,geometry box,100,150,50,1,00257,India
786591,2023-06-08,702,pencil,2,5,3,1,00106,India
786591,2023-06-08,713,ball pen,5,10,5,1,00106,India
786591,2023-06-08,709,notebook,30,60,30,1,00106,India
786591,2023-06-08,714,carbon paper,15,30,15,1,00106,India
612158,2023-06-08,716,printing paper,200,400,200,1,00244,India
612158,2023-06-08,714,carbon paper,15,30,15,1,00244,India
612158,2023-06-08,707,marker,20,40,20,1,00244,India
612158,2023-06-08,713,ball pen,5,10,5,1,00244,India
612158,2023-06-08,717,spiral bound book,50,100,50,1,00244,India
331842,2023-06-08,714,carbon paper,15,30,15,1,00195,India
998542,2023-06-08,701,gel pen,5,10,5,1,00411,India
998542,2023-06-08,704,scale,5,10,5,1,00411,India
794724,2023-06-08,705,stencil,10,20,10,1,00188,India
794724,2023-06-08,702,pencil,2,5,3,1,00188,India
671655,2023-06-08,710,geometry box,100,150,50,1,00259,India
671655,2023-06-08,711,TD kit,150,300,150,1,00259,India
785068,2023-06-08,701,gel pen,5,10,5,1,00069,India
810346,2023-06-08,701,gel pen,5,10,5,1,00416,India
810346,2023-06-08,712,graph paper,20,40,20,1,00416,India
810346,2023-06-08,710,geometry box,100,150,50,1,00416,India
186784,2023-06-08,705,stencil,10,20,10,1,00056,India
858004,2023-06-08,712,graph paper,20,40,20,1,00280,India
858004,2023-06-08,713,ball pen,5,10,5,1,00280,India
318841,2023-06-08,703,eraser,1,3,2,1,00261,India
318841,2023-06-08,713,ball pen,5,10,5,1,00261,India
582780,2023-06-08,714,carbon paper,15,30,15,1,00129,India
582780,2023-06-08,716,printing paper,200,400,200,1,00129,India
582780,2023-06-08,709,notebook,30,60,30,1,00129,India
582780,2023-06-08,707,marker,20,40,20,1,00129,India
582780,2023-06-08,708,sketchpen,15,40,25,1,00129,India
530364,2023-06-08,710,geometry box,100,150,50,1,00184,India
530364,2023-06-08,705,stencil,10,20,10,1,00184,India
530364,2023-06-08,714,carbon paper,15,30,15,1,00184,India
133511,2023-06-08,703,eraser,1,3,2,1,00092,India
133511,2023-06-08,716,printing paper,200,400,200,1,00092,India
923632,2023-06-08,707,marker,20,40,20,1,00048,India
923632,2023-06-08,702,pencil,2,5,3,1,00048,India
923632,2023-06-08,710,geometry box,100,150,50,1,00048,India
169993,2023-06-08,704,scale,5,10,5,1,00463,India
169993,2023-06-08,711,TD kit,150,300,150,1,00463,India
697890,2023-06-08,708,sketchpen,15,40,25,1,00414,India
697890,2023-06-08,716,printing paper,200,400,200,1,00414,India
697890,2023-06-08,704,scale,5,10,5,1,00414,India
697890,2023-06-08,713,ball pen,5,10,5,1,00414,India
643744,2023-06-08,701,gel pen,5,10,5,1,00203,India
643744,2023-06-08,707,marker,20,40,20,1,00203,India
644135,2023-06-08,703,eraser,1,3,2,1,00210,India
644135,2023-06-08,711,TD kit,150,300,150,1,00210,India
155260,2023-06-08,706,sharpener,3,8,5,1,00050,India
155260,2023-06-08,717,spiral bound book,50,100,50,1,00050,India
747455,2023-06-08,710,geometry box,100,150,50,1,00371,India
747455,2023-06-08,715,folder,5,15,10,1,00371,India
747455,2023-06-08,701,gel pen,5,10,5,1,00371,India
962916,2023-06-09,715,folder,5,15,10,1,00461,India
962916,2023-06-09,707,marker,20,40,20,1,00461,India
499604,2023-06-09,708,sketchpen,15,40,25,1,00033,India
499604,2023-06-09,714,carbon paper,15,30,15,1,00033,India
499604,2023-06-09,717,spiral bound book,50,100,50,1,00033,India
499604,2023-06-09,715,folder,5,15,10,1,00033,India
616726,2023-06-09,704,scale,5,10,5,1,00493,India
616726,2023-06-09,703,eraser,1,3,2,1,00493,India
616726,2023-06-09,711,TD kit,150,300,150,1,00493,India
886340,2023-06-09,703,eraser,1,3,2,1,00003,India
886340,2023-06-09,709,notebook,30,60,30,1,00003,India
886340,2023-06-09,706,sharpener,3,8,5,1,00003,India
886340,2023-06-09,714,carbon paper,15,30,15,1,00003,India
133783,2023-06-09,715,folder,5,15,10,1,00243,India
177099,2023-06-09,709,notebook,30,60,30,1,00487,India
177099,2023-06-09,714,carbon paper,15,30,15,1,00487,India
852591,2023-06-09,717,spiral bound book,50,100,50,1,00230,India
852591,2023-06-09,701,gel pen,5,10,5,1,00230,India
852591,2023-06-09,702,pencil,2,5,3,1,00230,India
852591,2023-06-09,705,stencil,10,20,10,1,00230,India
392598,2023-06-09,707,marker,20,40,20,1,00390,India
713284,2023-06-09,701,gel pen,5,10,5,1,00082,India
713284,2023-06-09,710,geometry box,100,150,50,1,00082,India
713284,2023-06-09,708,sketchpen,15,40,25,1,00082,India
816869,2023-06-09,702,pencil,2,5,3,1,00171,India
816869,2023-06-09,701,gel pen,5,10,5,1,00171,India
816869,2023-06-09,707,marker,20,40,20,1,00171,India
702040,2023-06-09,704,scale,5,10,5,1,00449,India
702040,2023-06-09,707,marker,20,40,20,1,00449,India
702040,2023-06-09,711,TD kit,150,300,150,1,00449,India
702040,2023-06-09,716,printing paper,200,400,200,1,00449,India
902730,2023-06-09,715,folder,5,15,10,1,00301,India
393608,2023-06-09,702,pencil,2,5,3,1,00006,India
393608,2023-06-09,706,sharpener,3,8,5,1,00006,India
393608,2023-06-09,715,folder,5,15,10,1,00006,India
884743,2023-06-09,706,sharpener,3,8,5,1,00461,India
884743,2023-06-09,713,ball pen,5,10,5,1,00461,India
884743,2023-06-09,714,carbon paper,15,30,15,1,00461,India
884743,2023-06-09,704,scale,5,10,5,1,00461,India
356803,2023-06-09,701,gel pen,5,10,5,1,00311,India
356803,2023-06-09,712,graph paper,20,40,20,1,00311,India
356803,2023-06-09,708,sketchpen,15,40,25,1,00311,India
356803,2023-06-09,706,sharpener,3,8,5,1,00311,India
356803,2023-06-09,713,ball pen,5,10,5,1,00311,India
910041,2023-06-09,705,stencil,10,20,10,1,00067,India
910041,2023-06-09,717,spiral bound book,50,100,50,1,00067,India
910041,2023-06-09,703,eraser,1,3,2,1,00067,India
234410,2023-06-09,707,marker,20,40,20,1,00230,India
234410,2023-06-09,709,notebook,30,60,30,1,00230,India
234410,2023-06-09,711,TD kit,150,300,150,1,00230,India
515881,2023-06-09,709,notebook,30,60,30,1,00080,India
515881,2023-06-09,708,sketchpen,15,40,25,1,00080,India
146370,2023-06-09,708,sketchpen,15,40,25,1,00262,India
146370,2023-06-09,717,spiral bound book,50,100,50,1,00262,India
146370,2023-06-09,716,printing paper,200,400,200,1,00262,India
146370,2023-06-09,712,graph paper,20,40,20,1,00262,India
281635,2023-06-09,709,notebook,30,60,30,1,00223,India
281635,2023-06-09,710,geometry box,100,150,50,1,00223,India
281635,2023-06-09,713,ball pen,5,10,5,1,00223,India
281635,2023-06-09,716,printing paper,200,400,200,1,00223,India
281635,2023-06-09,712,graph paper,20,40,20,1,00223,India
933430,2023-06-09,708,sketchpen,15,40,25,1,00081,India
933430,2023-06-09,705,stencil,10,20,10,1,00081,India
933430,2023-06-09,701,gel pen,5,10,5,1,00081,India
933430,2023-06-09,706,sharpener,3,8,5,1,00081,India
658026,2023-06-09,713,ball pen,5,10,5,1,00233,India
658026,2023-06-09,705,stencil,10,20,10,1,00233,India
658026,2023-06-09,707,marker,20,40,20,1,00233,India
658026,2023-06-09,716,printing paper,200,400,200,1,00233,India
824198,2023-06-09,704,scale,5,10,5,1,00147,India
824198,2023-06-09,711,TD kit,150,300,150,1,00147,India
824198,2023-06-09,715,folder,5,15,10,1,00147,India
824198,2023-06-09,716,printing paper,200,400,200,1,00147,India
824198,2023-06-09,701,gel pen,5,10,5,1,00147,India
550363,2023-06-09,715,folder,5,15,10,1,00325,India
550363,2023-06-09,706,sharpener,3,8,5,1,00325,India
621294,2023-06-09,712,graph paper,20,40,20,1,00298,India
621294,2023-06-09,714,carbon paper,15,30,15,1,00298,India
621294,2023-06-09,711,TD kit,150,300,150,1,00298,India
621294,2023-06-09,702,pencil,2,5,3,1,00298,India
118049,2023-06-09,710,geometry box,100,150,50,1,00358,India
118049,2023-06-09,714,carbon paper,15,30,15,1,00358,India
290237,2023-06-09,716,printing paper,200,400,200,1,00090,India
290237,2023-06-09,709,notebook,30,60,30,1,00090,India
290237,2023-06-09,711,TD kit,150,300,150,1,00090,India
442774,2023-06-09,711,TD kit,150,300,150,1,00254,India
442774,2023-06-09,703,eraser,1,3,2,1,00254,India
442774,2023-06-09,708,sketchpen,15,40,25,1,00254,India
970268,2023-06-09,715,folder,5,15,10,1,00029,India
970268,2023-06-09,711,TD kit,150,300,150,1,00029,India
793004,2023-06-09,702,pencil,2,5,3,1,00039,India
793004,2023-06-09,703,eraser,1,3,2,1,00039,India
793004,2023-06-09,705,stencil,10,20,10,1,00039,India
793004,2023-06-09,716,printing paper,200,400,200,1,00039,India
217578,2023-06-09,717,spiral bound book,50,100,50,1,00220,India
217578,2023-06-09,714,carbon paper,15,30,15,1,00220,India
217578,2023-06-09,704,scale,5,10,5,1,00220,India
217578,2023-06-09,703,eraser,1,3,2,1,00220,India
217578,2023-06-09,711,TD kit,150,300,150,1,00220,India
191640,2023-06-10,713,ball pen,5,10,5,1,00115,India
191640,2023-06-10,711,TD kit,150,300,150,1,00115,India
191640,2023-06-10,716,printing paper,200,400,200,1,00115,India
191640,2023-06-10,709,notebook,30,60,30,1,00115,India
191640,2023-06-10,703,eraser,1,3,2,1,00115,India
667359,2023-06-10,701,gel pen,5,10,5,1,00011,India
667359,2023-06-10,704,scale,5,10,5,1,00011,India
667359,2023-06-10,709,notebook,30,60,30,1,00011,India
422100,2023-06-10,705,stencil,10,20,10,1,00484,India
131695,2023-06-10,712,graph paper,20,40,20,1,00282,India
131695,2023-06-10,704,scale,5,10,5,1,00282,India
131695,2023-06-10,714,carbon paper,15,30,15,1,00282,India
131695,2023-06-10,710,geometry box,100,150,50,1,00282,India
131695,2023-06-10,701,gel pen,5,10,5,1,00282,India
236550,2023-06-10,712,graph paper,20,40,20,1,00380,India
236550,2023-06-10,703,eraser,1,3,2,1,00380,India
236550,2023-06-10,713,ball pen,5,10,5,1,00380,India
990671,2023-06-10,705,stencil,10,20,10,1,00469,India
990671,2023-06-10,703,eraser,1,3,2,1,00469,India
990671,2023-06-10,706,sharpener,3,8,5,1,00469,India
990671,2023-06-10,707,marker,20,40,20,1,00469,India
990671,2023-06-10,715,folder,5,15,10,1,00469,India
898680,2023-06-10,716,printing paper,200,400,200,1,00117,India
898680,2023-06-10,701,gel pen,5,10,5,1,00117,India
898680,2023-06-10,703,eraser,1,3,2,1,00117,India
898680,2023-06-10,709,notebook,30,60,30,1,00117,India
525759,2023-06-10,701,gel pen,5,10,5,1,00164,India
525759,2023-06-10,709,notebook,30,60,30,1,00164,India
525759,2023-06-10,706,sharpener,3,8,5,1,00164,India
365514,2023-06-10,701,gel pen,5,10,5,1,00056,India
735156,2023-06-10,702,pencil,2,5,3,1,00352,India
735156,2023-06-10,714,carbon paper,15,30,15,1,00352,India
735156,2023-06-10,705,stencil,10,20,10,1,00352,India
735156,2023-06-10,704,scale,5,10,5,1,00352,India
143943,2023-06-10,710,geometry box,100,150,50,1,00350,India
113182,2023-06-10,711,TD kit,150,300,150,1,00032,India
113182,2023-06-10,712,graph paper,20,40,20,1,00032,India
113182,2023-06-10,707,marker,20,40,20,1,00032,India
252958,2023-06-10,705,stencil,10,20,10,1,00450,India
252958,2023-06-10,709,notebook,30,60,30,1,00450,India
252958,2023-06-10,717,spiral bound book,50,100,50,1,00450,India
852799,2023-06-10,707,marker,20,40,20,1,00289,India
852799,2023-06-10,713,ball pen,5,10,5,1,00289,India
852799,2023-06-10,704,scale,5,10,5,1,00289,India
852799,2023-06-10,714,carbon paper,15,30,15,1,00289,India
732306,2023-06-10,712,graph paper,20,40,20,1,00479,India
732306,2023-06-10,704,scale,5,10,5,1,00479,India
732306,2023-06-10,714,carbon paper,15,30,15,1,00479,India
689742,2023-06-10,710,geometry box,100,150,50,1,00200,India
689742,2023-06-10,709,notebook,30,60,30,1,00200,India
689742,2023-06-10,705,stencil,10,20,10,1,00200,India
188526,2023-06-10,708,sketchpen,15,40,25,1,00286,India
188526,2023-06-10,701,gel pen,5,10,5,1,00286,India
188526,2023-06-10,714,carbon paper,15,30,15,1,00286,India
119502,2023-06-10,703,eraser,1,3,2,1,00314,India
119502,2023-06-10,704,scale,5,10,5,1,00314,India
891156,2023-06-10,715,folder,5,15,10,1,00037,India
891156,2023-06-10,714,carbon paper,15,30,15,1,00037,India
891156,2023-06-10,713,ball pen,5,10,5,1,00037,India
891156,2023-06-10,717,spiral bound book,50,100,50,1,00037,India
891156,2023-06-10,703,eraser,1,3,2,1,00037,India
144989,2023-06-10,703,eraser,1,3,2,1,00298,India
144989,2023-06-10,709,notebook,30,60,30,1,00298,India
185038,2023-06-10,703,eraser,1,3,2,1,00241,India
185038,2023-06-10,711,TD kit,150,300,150,1,00241,India
185038,2023-06-10,717,spiral bound book,50,100,50,1,00241,India
185038,2023-06-10,716,printing paper,200,400,200,1,00241,India
297777,2023-06-10,716,printing paper,200,400,200,1,00496,India
297777,2023-06-10,717,spiral bound book,50,100,50,1,00496,India
297777,2023-06-10,702,pencil,2,5,3,1,00496,India
761545,2023-06-10,711,TD kit,150,300,150,1,00255,India
761545,2023-06-10,702,pencil,2,5,3,1,00255,India
740026,2023-06-10,702,pencil,2,5,3,1,00466,India
740026,2023-06-10,708,sketchpen,15,40,25,1,00466,India
740026,2023-06-10,710,geometry box,100,150,50,1,00466,India
510733,2023-06-10,713,ball pen,5,10,5,1,00385,India
510733,2023-06-10,704,scale,5,10,5,1,00385,India
510733,2023-06-10,709,notebook,30,60,30,1,00385,India
510733,2023-06-10,708,sketchpen,15,40,25,1,00385,India
157422,2023-06-10,717,spiral bound book,50,100,50,1,00247,India
989912,2023-06-10,703,eraser,1,3,2,1,00356,India
989912,2023-06-10,709,notebook,30,60,30,1,00356,India
989912,2023-06-10,714,carbon paper,15,30,15,1,00356,India
511650,2023-06-10,713,ball pen,5,10,5,1,00413,India
511650,2023-06-10,702,pencil,2,5,3,1,00413,India
102010,2023-06-10,708,sketchpen,15,40,25,1,00188,India
102010,2023-06-10,704,scale,5,10,5,1,00188,India
520143,2023-06-10,706,sharpener,3,8,5,1,00461,India
520143,2023-06-10,715,folder,5,15,10,1,00461,India
520143,2023-06-10,702,pencil,2,5,3,1,00461,India
520143,2023-06-10,704,scale,5,10,5,1,00461,India
520143,2023-06-10,701,gel pen,5,10,5,1,00461,India
584303,2023-06-10,702,pencil,2,5,3,1,00302,India
584303,2023-06-10,707,marker,20,40,20,1,00302,India
584303,2023-06-10,717,spiral bound book,50,100,50,1,00302,India
368357,2023-06-10,707,marker,20,40,20,1,00253,India
368357,2023-06-10,701,gel pen,5,10,5,1,00253,India
368357,2023-06-10,715,folder,5,15,10,1,00253,India
368357,2023-06-10,709,notebook,30,60,30,1,00253,India
274557,2023-06-10,716,printing paper,200,400,200,1,00493,India
274557,2023-06-10,708,sketchpen,15,40,25,1,00493,India
410003,2023-06-11,707,marker,20,40,20,1,00005,India
410003,2023-06-11,706,sharpener,3,8,5,1,00005,India
154237,2023-06-11,712,graph paper,20,40,20,1,00004,India
289496,2023-06-11,710,geometry box,100,150,50,1,00414,India
289496,2023-06-11,706,sharpener,3,8,5,1,00414,India
289496,2023-06-11,716,printing paper,200,400,200,1,00414,India
658299,2023-06-11,706,sharpener,3,8,5,1,00381,India
658299,2023-06-11,709,notebook,30,60,30,1,00381,India
658299,2023-06-11,717,spiral bound book,50,100,50,1,00381,India
658299,2023-06-11,716,printing paper,200,400,200,1,00381,India
853648,2023-06-11,711,TD kit,150,300,150,1,00250,India
598770,2023-06-11,708,sketchpen,15,40,25,1,00149,India
598770,2023-06-11,710,geometry box,100,150,50,1,00149,India
598770,2023-06-11,712,graph paper,20,40,20,1,00149,India
598770,2023-06-11,703,eraser,1,3,2,1,00149,India
595458,2023-06-11,704,scale,5,10,5,1,00307,India
595458,2023-06-11,703,eraser,1,3,2,1,00307,India
595458,2023-06-11,714,carbon paper,15,30,15,1,00307,India
595458,2023-06-11,715,folder,5,15,10,1,00307,India
475441,2023-06-11,707,marker,20,40,20,1,00029,India
475441,2023-06-11,709,notebook,30,60,30,1,00029,India
475441,2023-06-11,711,TD kit,150,300,150,1,00029,India
554954,2023-06-11,703,eraser,1,3,2,1,00065,India
554954,2023-06-11,709,notebook,30,60,30,1,00065,India
554954,2023-06-11,711,TD kit,150,300,150,1,00065,India
554954,2023-06-11,716,printing paper,200,400,200,1,00065,India
554954,2023-06-11,710,geometry box,100,150,50,1,00065,India
531578,2023-06-11,717,spiral bound book,50,100,50,1,00401,India
953094,2023-06-11,716,printing paper,200,400,200,1,00121,India
510889,2023-06-11,715,folder,5,15,10,1,00314,India
510889,2023-06-11,714,carbon paper,15,30,15,1,00314,India
510889,2023-06-11,706,sharpener,3,8,5,1,00314,India
510889,2023-06-11,710,geometry box,100,150,50,1,00314,India
316781,2023-06-11,709,notebook,30,60,30,1,00477,India
316781,2023-06-11,710,geometry box,100,150,50,1,00477,India
316781,2023-06-11,716,printing paper,200,400,200,1,00477,India
545473,2023-06-11,715,folder,5,15,10,1,00049,India
545473,2023-06-11,713,ball pen,5,10,5,1,00049,India
545473,2023-06-11,711,TD kit,150,300,150,1,00049,India
545473,2023-06-11,717,spiral bound book,50,100,50,1,00049,India
545473,2023-06-11,709,notebook,30,60,30,1,00049,India
786456,2023-06-11,715,folder,5,15,10,1,00245,India
183933,2023-06-11,708,sketchpen,15,40,25,1,00364,India
183933,2023-06-11,707,marker,20,40,20,1,00364,India
760018,2023-06-11,705,stencil,10,20,10,1,00363,India
370555,2023-06-11,705,stencil,10,20,10,1,00286,India
370555,2023-06-11,711,TD kit,150,300,150,1,00286,India
370555,2023-06-11,701,gel pen,5,10,5,1,00286,India
902665,2023-06-11,704,scale,5,10,5,1,00033,India
902665,2023-06-11,706,sharpener,3,8,5,1,00033,India
979033,2023-06-11,714,carbon paper,15,30,15,1,00172,India
979033,2023-06-11,717,spiral bound book,50,100,50,1,00172,India
848838,2023-06-11,714,carbon paper,15,30,15,1,00002,India
848838,2023-06-11,703,eraser,1,3,2,1,00002,India
567740,2023-06-11,708,sketchpen,15,40,25,1,00236,India
567740,2023-06-11,714,carbon paper,15,30,15,1,00236,India
231039,2023-06-11,713,ball pen,5,10,5,1,00074,India
194941,2023-06-11,716,printing paper,200,400,200,1,00163,India
194941,2023-06-11,714,carbon paper,15,30,15,1,00163,India
194941,2023-06-11,701,gel pen,5,10,5,1,00163,India
194941,2023-06-11,702,pencil,2,5,3,1,00163,India
518216,2023-06-11,701,gel pen,5,10,5,1,00059,India
518216,2023-06-11,704,scale,5,10,5,1,00059,India
518216,2023-06-11,712,graph paper,20,40,20,1,00059,India
303136,2023-06-11,704,scale,5,10,5,1,00101,India
577751,2023-06-11,714,carbon paper,15,30,15,1,00438,India
577751,2023-06-11,711,TD kit,150,300,150,1,00438,India
577751,2023-06-11,709,notebook,30,60,30,1,00438,India
577751,2023-06-11,710,geometry box,100,150,50,1,00438,India
743471,2023-06-11,704,scale,5,10,5,1,00218,India
743471,2023-06-11,715,folder,5,15,10,1,00218,India
743471,2023-06-11,713,ball pen,5,10,5,1,00218,India
743471,2023-06-11,716,printing paper,200,400,200,1,00218,India
743471,2023-06-11,701,gel pen,5,10,5,1,00218,India
529096,2023-06-11,713,ball pen,5,10,5,1,00343,India
529096,2023-06-11,707,marker,20,40,20,1,00343,India
529096,2023-06-11,704,scale,5,10,5,1,00343,India
746817,2023-06-11,706,sharpener,3,8,5,1,00298,India
421070,2023-06-11,701,gel pen,5,10,5,1,00003,India
421070,2023-06-11,704,scale,5,10,5,1,00003,India
421070,2023-06-11,715,folder,5,15,10,1,00003,India
421070,2023-06-11,710,geometry box,100,150,50,1,00003,India
132273,2023-06-11,704,scale,5,10,5,1,00461,India
132273,2023-06-11,713,ball pen,5,10,5,1,00461,India
132273,2023-06-11,702,pencil,2,5,3,1,00461,India
789716,2023-06-11,705,stencil,10,20,10,1,00338,India
789716,2023-06-11,707,marker,20,40,20,1,00338,India
985506,2023-06-11,701,gel pen,5,10,5,1,00450,India
985506,2023-06-11,715,folder,5,15,10,1,00450,India
985506,2023-06-11,708,sketchpen,15,40,25,1,00450,India
985506,2023-06-11,703,eraser,1,3,2,1,00450,India
985506,2023-06-11,710,geometry box,100,150,50,1,00450,India
297587,2023-06-11,709,notebook,30,60,30,1,00366,India
297587,2023-06-11,712,graph paper,20,40,20,1,00366,India
297587,2023-06-11,704,scale,5,10,5,1,00366,India
297587,2023-06-11,716,printing paper,200,400,200,1,00366,India
297587,2023-06-11,713,ball pen,5,10,5,1,00366,India
276991,2023-06-12,714,carbon paper,15,30,15,1,00007,India
276991,2023-06-12,709,notebook,30,60,30,1,00007,India
276991,2023-06-12,710,geometry box,100,150,50,1,00007,India
276991,2023-06-12,704,scale,5,10,5,1,00007,India
638611,2023-06-12,716,printing paper,200,400,200,1,00029,India
714360,2023-06-12,703,eraser,1,3,2,1,00460,India
714360,2023-06-12,706,sharpener,3,8,5,1,00460,India
714360,2023-06-12,705,stencil,10,20,10,1,00460,India
807902,2023-06-12,708,sketchpen,15,40,25,1,00356,India
807902,2023-06-12,713,ball pen,5,10,5,1,00356,India
807902,2023-06-12,705,stencil,10,20,10,1,00356,India
807902,2023-06-12,711,TD kit,150,300,150,1,00356,India
807902,2023-06-12,717,spiral bound book,50,100,50,1,00356,India
119093,2023-06-12,701,gel pen,5,10,5,1,00084,India
119093,2023-06-12,709,notebook,30,60,30,1,00084,India
119093,2023-06-12,713,ball pen,5,10,5,1,00084,India
119093,2023-06-12,717,spiral bound book,50,100,50,1,00084,India
119093,2023-06-12,711,TD kit,150,300,150,1,00084,India
308327,2023-06-12,703,eraser,1,3,2,1,00025,India
308327,2023-06-12,709,notebook,30,60,30,1,00025,India
813044,2023-06-12,706,sharpener,3,8,5,1,00197,India
813044,2023-06-12,711,TD kit,150,300,150,1,00197,India
642577,2023-06-12,711,TD kit,150,300,150,1,00019,India
161604,2023-06-12,713,ball pen,5,10,5,1,00342,India
452409,2023-06-12,704,scale,5,10,5,1,00396,India
452409,2023-06-12,709,notebook,30,60,30,1,00396,India
769564,2023-06-12,711,TD kit,150,300,150,1,00088,India
769564,2023-06-12,707,marker,20,40,20,1,00088,India
767008,2023-06-12,712,graph paper,20,40,20,1,00178,India
984035,2023-06-12,702,pencil,2,5,3,1,00318,India
984035,2023-06-12,709,notebook,30,60,30,1,00318,India
984035,2023-06-12,703,eraser,1,3,2,1,00318,India
984035,2023-06-12,713,ball pen,5,10,5,1,00318,India
266277,2023-06-12,717,spiral bound book,50,100,50,1,00076,India
266277,2023-06-12,701,gel pen,5,10,5,1,00076,India
266277,2023-06-12,711,TD kit,150,300,150,1,00076,India
816828,2023-06-12,704,scale,5,10,5,1,00288,India
816828,2023-06-12,713,ball pen,5,10,5,1,00288,India
816828,2023-06-12,706,sharpener,3,8,5,1,00288,India
816828,2023-06-12,716,printing paper,200,400,200,1,00288,India
285783,2023-06-12,706,sharpener,3,8,5,1,00177,India
285783,2023-06-12,715,folder,5,15,10,1,00177,India
285783,2023-06-12,702,pencil,2,5,3,1,00177,India
285783,2023-06-12,712,graph paper,20,40,20,1,00177,India
867251,2023-06-12,703,eraser,1,3,2,1,00405,India
867251,2023-06-12,711,TD kit,150,300,150,1,00405,India
867251,2023-06-12,717,spiral bound book,50,100,50,1,00405,India
867251,2023-06-12,709,notebook,30,60,30,1,00405,India
867251,2023-06-12,705,stencil,10,20,10,1,00405,India
783020,2023-06-12,716,printing paper,200,400,200,1,00019,India
783020,2023-06-12,710,geometry box,100,150,50,1,00019,India
888188,2023-06-12,714,carbon paper,15,30,15,1,00118,India
888188,2023-06-12,709,notebook,30,60,30,1,00118,India
888188,2023-06-12,703,eraser,1,3,2,1,00118,India
888188,2023-06-12,715,folder,5,15,10,1,00118,India
888188,2023-06-12,702,pencil,2,5,3,1,00118,India
129260,2023-06-12,717,spiral bound book,50,100,50,1,00445,India
129260,2023-06-12,710,geometry box,100,150,50,1,00445,India
129260,2023-06-12,706,sharpener,3,8,5,1,00445,India
119838,2023-06-12,709,notebook,30,60,30,1,00093,India
299785,2023-06-12,701,gel pen,5,10,5,1,00347,India
299785,2023-06-12,703,eraser,1,3,2,1,00347,India
299785,2023-06-12,704,scale,5,10,5,1,00347,India
299785,2023-06-12,711,TD kit,150,300,150,1,00347,India
899209,2023-06-12,714,carbon paper,15,30,15,1,00039,India
899209,2023-06-12,703,eraser,1,3,2,1,00039,India
899209,2023-06-12,711,TD kit,150,300,150,1,00039,India
899209,2023-06-12,717,spiral bound book,50,100,50,1,00039,India
899209,2023-06-12,708,sketchpen,15,40,25,1,00039,India
271474,2023-06-12,716,printing paper,200,400,200,1,00329,India
271474,2023-06-12,701,gel pen,5,10,5,1,00329,India
271474,2023-06-12,708,sketchpen,15,40,25,1,00329,India
656587,2023-06-12,712,graph paper,20,40,20,1,00336,India
656587,2023-06-12,716,printing paper,200,400,200,1,00336,India
656587,2023-06-12,709,notebook,30,60,30,1,00336,India
656587,2023-06-12,713,ball pen,5,10,5,1,00336,India
573408,2023-06-12,709,notebook,30,60,30,1,00223,India
762399,2023-06-12,702,pencil,2,5,3,1,00267,India
762399,2023-06-12,713,ball pen,5,10,5,1,00267,India
762399,2023-06-12,703,eraser,1,3,2,1,00267,India
762399,2023-06-12,716,printing paper,200,400,200,1,00267,India
762399,2023-06-12,710,geometry box,100,150,50,1,00267,India
925781,2023-06-12,713,ball pen,5,10,5,1,00031,India
925781,2023-06-12,704,scale,5,10,5,1,00031,India
198279,2023-06-12,708,sketchpen,15,40,25,1,00381,India
198279,2023-06-12,714,carbon paper,15,30,15,1,00381,India
827427,2023-06-12,714,carbon paper,15,30,15,1,00500,India
827427,2023-06-12,710,geometry box,100,150,50,1,00500,India
382543,2023-06-12,713,ball pen,5,10,5,1,00442,India
382543,2023-06-12,701,gel pen,5,10,5,1,00442,India
680882,2023-06-12,708,sketchpen,15,40,25,1,00341,India
680882,2023-06-12,706,sharpener,3,8,5,1,00341,India
680882,2023-06-12,703,eraser,1,3,2,1,00341,India
680882,2023-06-12,702,pencil,2,5,3,1,00341,India
239963,2023-06-12,706,sharpener,3,8,5,1,00186,India
862385,2023-06-12,709,notebook,30,60,30,1,00049,India
862385,2023-06-12,704,scale,5,10,5,1,00049,India
862385,2023-06-12,706,sharpener,3,8,5,1,00049,India
296977,2023-06-12,716,printing paper,200,400,200,1,00038,India
296977,2023-06-12,705,stencil,10,20,10,1,00038,India
296977,2023-06-12,715,folder,5,15,10,1,00038,India
630731,2023-06-12,707,marker,20,40,20,1,00134,India
630731,2023-06-12,715,folder,5,15,10,1,00134,India
804274,2023-06-12,710,geometry box,100,150,50,1,00150,India
804274,2023-06-12,715,folder,5,15,10,1,00150,India
804274,2023-06-12,717,spiral bound book,50,100,50,1,00150,India
804274,2023-06-12,705,stencil,10,20,10,1,00150,India
730860,2023-06-12,717,spiral bound book,50,100,50,1,00383,India
730860,2023-06-12,716,printing paper,200,400,200,1,00383,India
730860,2023-06-12,714,carbon paper,15,30,15,1,00383,India
730860,2023-06-12,705,stencil,10,20,10,1,00383,India
206972,2023-06-12,701,gel pen,5,10,5,1,00161,India
206972,2023-06-12,708,sketchpen,15,40,25,1,00161,India
441608,2023-06-13,709,notebook,30,60,30,1,00311,India
103769,2023-06-13,712,graph paper,20,40,20,1,00119,India
103769,2023-06-13,701,gel pen,5,10,5,1,00119,India
103769,2023-06-13,717,spiral bound book,50,100,50,1,00119,India
825333,2023-06-13,704,scale,5,10,5,1,00365,India
825333,2023-06-13,714,carbon paper,15,30,15,1,00365,India
952787,2023-06-13,707,marker,20,40,20,1,00206,India
952787,2023-06-13,709,notebook,30,60,30,1,00206,India
952787,2023-06-13,703,eraser,1,3,2,1,00206,India
108737,2023-06-13,707,marker,20,40,20,1,00182,India
108737,2023-06-13,717,spiral bound book,50,100,50,1,00182,India
108737,2023-06-13,716,printing paper,200,400,200,1,00182,India
529147,2023-06-13,704,scale,5,10,5,1,00127,India
529147,2023-06-13,709,notebook,30,60,30,1,00127,India
529147,2023-06-13,717,spiral bound book,50,100,50,1,00127,India
529147,2023-06-13,713,ball pen,5,10,5,1,00127,India
495171,2023-06-13,701,gel pen,5,10,5,1,00450,India
495171,2023-06-13,713,ball pen,5,10,5,1,00450,India
495171,2023-06-13,705,stencil,10,20,10,1,00450,India
495171,2023-06-13,706,sharpener,3,8,5,1,00450,India
866453,2023-06-13,709,notebook,30,60,30,1,00427,India
866453,2023-06-13,704,scale,5,10,5,1,00427,India
866453,2023-06-13,707,marker,20,40,20,1,00427,India
866453,2023-06-13,714,carbon paper,15,30,15,1,00427,India
866453,2023-06-13,711,TD kit,150,300,150,1,00427,India
199971,2023-06-13,706,sharpener,3,8,5,1,00419,India
199971,2023-06-13,707,marker,20,40,20,1,00419,India
199971,2023-06-13,712,graph paper,20,40,20,1,00419,India
199971,2023-06-13,704,scale,5,10,5,1,00419,India
278550,2023-06-13,706,sharpener,3,8,5,1,00264,India
278550,2023-06-13,714,carbon paper,15,30,15,1,00264,India
278550,2023-06-13,709,notebook,30,60,30,1,00264,India
278550,2023-06-13,705,stencil,10,20,10,1,00264,India
278550,2023-06-13,711,TD kit,150,300,150,1,00264,India
150225,2023-06-13,713,ball pen,5,10,5,1,00036,India
150225,2023-06-13,711,TD kit,150,300,150,1,00036,India
826840,2023-06-13,709,notebook,30,60,30,1,00465,India
826840,2023-06-13,708,sketchpen,15,40,25,1,00465,India
826840,2023-06-13,713,ball pen,5,10,5,1,00465,India
826840,2023-06-13,712,graph paper,20,40,20,1,00465,India
826840,2023-06-13,715,folder,5,15,10,1,00465,India
660399,2023-06-13,717,spiral bound book,50,100,50,1,00050,India
660399,2023-06-13,702,pencil,2,5,3,1,00050,India
150996,2023-06-13,708,sketchpen,15,40,25,1,00428,India
150996,2023-06-13,704,scale,5,10,5,1,00428,India
150996,2023-06-13,713,ball pen,5,10,5,1,00428,India
150996,2023-06-13,711,TD kit,150,300,150,1,00428,India
152035,2023-06-13,717,spiral bound book,50,100,50,1,00224,India
355284,2023-06-13,717,spiral bound book,50,100,50,1,00413,India
355284,2023-06-13,710,geometry box,100,150,50,1,00413,India
355284,2023-06-13,716,printing paper,200,400,200,1,00413,India
166893,2023-06-13,705,stencil,10,20,10,1,00416,India
166893,2023-06-13,703,eraser,1,3,2,1,00416,India
166893,2023-06-13,713,ball pen,5,10,5,1,00416,India
297043,2023-06-13,705,stencil,10,20,10,1,00186,India
297043,2023-06-13,712,graph paper,20,40,20,1,00186,India
297043,2023-06-13,710,geometry box,100,150,50,1,00186,India
647769,2023-06-13,702,pencil,2,5,3,1,00244,India
647769,2023-06-13,705,stencil,10,20,10,1,00244,India
647769,2023-06-13,701,gel pen,5,10,5,1,00244,India
647769,2023-06-13,716,printing paper,200,400,200,1,00244,India
647769,2023-06-13,708,sketchpen,15,40,25,1,00244,India
443870,2023-06-13,708,sketchpen,15,40,25,1,00422,India
443870,2023-06-13,716,printing paper,200,400,200,1,00422,India
443870,2023-06-13,705,stencil,10,20,10,1,00422,India
110473,2023-06-13,714,carbon paper,15,30,15,1,00078,India
260761,2023-06-13,704,scale,5,10,5,1,00258,India
260761,2023-06-13,710,geometry box,100,150,50,1,00258,India
492248,2023-06-13,713,ball pen,5,10,5,1,00031,India
492248,2023-06-13,709,notebook,30,60,30,1,00031,India
492248,2023-06-13,715,folder,5,15,10,1,00031,India
492248,2023-06-13,711,TD kit,150,300,150,1,00031,India
492248,2023-06-13,712,graph paper,20,40,20,1,00031,India
317163,2023-06-13,706,sharpener,3,8,5,1,00127,India
275961,2023-06-13,714,carbon paper,15,30,15,1,00367,India
993316,2023-06-13,705,stencil,10,20,10,1,00407,India
993316,2023-06-13,714,carbon paper,15,30,15,1,00407,India
993316,2023-06-13,710,geometry box,100,150,50,1,00407,India
993316,2023-06-13,717,spiral bound book,50,100,50,1,00407,India
112230,2023-06-13,717,spiral bound book,50,100,50,1,00066,India
112230,2023-06-13,714,carbon paper,15,30,15,1,00066,India
112230,2023-06-13,709,notebook,30,60,30,1,00066,India
112230,2023-06-13,703,eraser,1,3,2,1,00066,India
112230,2023-06-13,711,TD kit,150,300,150,1,00066,India
874507,2023-06-13,701,gel pen,5,10,5,1,00420,India
874507,2023-06-13,706,sharpener,3,8,5,1,00420,India
874507,2023-06-13,708,sketchpen,15,40,25,1,00420,India
287532,2023-06-13,714,carbon paper,15,30,15,1,00340,India
287532,2023-06-13,712,graph paper,20,40,20,1,00340,India
287532,2023-06-13,713,ball pen,5,10,5,1,00340,India
975751,2023-06-13,704,scale,5,10,5,1,00019,India
975751,2023-06-13,711,TD kit,150,300,150,1,00019,India
975751,2023-06-13,707,marker,20,40,20,1,00019,India
975751,2023-06-13,710,geometry box,100,150,50,1,00019,India
975751,2023-06-13,701,gel pen,5,10,5,1,00019,India
689500,2023-06-13,706,sharpener,3,8,5,1,00219,India
689500,2023-06-13,708,sketchpen,15,40,25,1,00219,India
689500,2023-06-13,707,marker,20,40,20,1,00219,India
689500,2023-06-13,714,carbon paper,15,30,15,1,00219,India
299165,2023-06-13,712,graph paper,20,40,20,1,00196,India
299165,2023-06-13,703,eraser,1,3,2,1,00196,India
328577,2023-06-13,711,TD kit,150,300,150,1,00177,India
328577,2023-06-13,709,notebook,30,60,30,1,00177,India
328577,2023-06-13,713,ball pen,5,10,5,1,00177,India
328577,2023-06-13,707,marker,20,40,20,1,00177,India
414700,2023-06-13,715,folder,5,15,10,1,00101,India
414700,2023-06-13,717,spiral bound book,50,100,50,1,00101,India
414700,2023-06-13,703,eraser,1,3,2,1,00101,India
414700,2023-06-13,708,sketchpen,15,40,25,1,00101,India
421373,2023-06-13,716,printing paper,200,400,200,1,00413,India
421373,2023-06-13,714,carbon paper,15,30,15,1,00413,India
421373,2023-06-13,708,sketchpen,15,40,25,1,00413,India
423383,2023-06-13,716,printing paper,200,400,200,1,00373,India
423383,2023-06-13,707,marker,20,40,20,1,00373,India
423383,2023-06-13,712,graph paper,20,40,20,1,00373,India
423383,2023-06-13,711,TD kit,150,300,150,1,00373,India
272322,2023-06-13,703,eraser,1,3,2,1,00391,India
272322,2023-06-13,705,stencil,10,20,10,1,00391,India
176021,2023-06-13,703,eraser,1,3,2,1,00180,India
176021,2023-06-13,704,scale,5,10,5,1,00180,India
176021,2023-06-13,706,sharpener,3,8,5,1,00180,India
176021,2023-06-13,710,geometry box,100,150,50,1,00180,India
470323,2023-06-13,701,gel pen,5,10,5,1,00137,India
470323,2023-06-13,703,eraser,1,3,2,1,00137,India
470323,2023-06-13,713,ball pen,5,10,5,1,00137,India
470323,2023-06-13,715,folder,5,15,10,1,00137,India
123381,2023-06-13,707,marker,20,40,20,1,00181,India
540700,2023-06-14,711,TD kit,150,300,150,1,00128,India
540700,2023-06-14,702,pencil,2,5,3,1,00128,India
540700,2023-06-14,703,eraser,1,3,2,1,00128,India
507496,2023-06-14,705,stencil,10,20,10,1,00219,India
507496,2023-06-14,715,folder,5,15,10,1,00219,India
507496,2023-06-14,712,graph paper,20,40,20,1,00219,India
507496,2023-06-14,707,marker,20,40,20,1,00219,India
485790,2023-06-14,711,TD kit,150,300,150,1,00433,India
485790,2023-06-14,701,gel pen,5,10,5,1,00433,India
485790,2023-06-14,706,sharpener,3,8,5,1,00433,India
485790,2023-06-14,704,scale,5,10,5,1,00433,India
558766,2023-06-14,714,carbon paper,15,30,15,1,00241,India
558766,2023-06-14,705,stencil,10,20,10,1,00241,India
443236,2023-06-14,716,printing paper,200,400,200,1,00056,India
443236,2023-06-14,707,marker,20,40,20,1,00056,India
552303,2023-06-14,705,stencil,10,20,10,1,00315,India
552303,2023-06-14,708,sketchpen,15,40,25,1,00315,India
552303,2023-06-14,711,TD kit,150,300,150,1,00315,India
552303,2023-06-14,712,graph paper,20,40,20,1,00315,India
915740,2023-06-14,717,spiral bound book,50,100,50,1,00090,India
915740,2023-06-14,715,folder,5,15,10,1,00090,India
915740,2023-06-14,701,gel pen,5,10,5,1,00090,India
915740,2023-06-14,704,scale,5,10,5,1,00090,India
802271,2023-06-14,701,gel pen,5,10,5,1,00359,India
170327,2023-06-14,710,geometry box,100,150,50,1,00265,India
170327,2023-06-14,713,ball pen,5,10,5,1,00265,India
170327,2023-06-14,717,spiral bound book,50,100,50,1,00265,India
170327,2023-06-14,701,gel pen,5,10,5,1,00265,India
398572,2023-06-14,701,gel pen,5,10,5,1,00295,India
511445,2023-06-14,707,marker,20,40,20,1,00259,India
511445,2023-06-14,703,eraser,1,3,2,1,00259,India
191719,2023-06-14,707,marker,20,40,20,1,00187,India
719268,2023-06-14,709,notebook,30,60,30,1,00153,India
518372,2023-06-14,705,stencil,10,20,10,1,00434,India
983808,2023-06-14,710,geometry box,100,150,50,1,00108,India
983808,2023-06-14,714,carbon paper,15,30,15,1,00108,India
983808,2023-06-14,701,gel pen,5,10,5,1,00108,India
983808,2023-06-14,715,folder,5,15,10,1,00108,India
703337,2023-06-14,710,geometry box,100,150,50,1,00140,India
703337,2023-06-14,717,spiral bound book,50,100,50,1,00140,India
703337,2023-06-14,714,carbon paper,15,30,15,1,00140,India
703337,2023-06-14,705,stencil,10,20,10,1,00140,India
703337,2023-06-14,712,graph paper,20,40,20,1,00140,India
769772,2023-06-14,702,pencil,2,5,3,1,00140,India
823918,2023-06-14,706,sharpener,3,8,5,1,00154,India
823918,2023-06-14,710,geometry box,100,150,50,1,00154,India
823918,2023-06-14,713,ball pen,5,10,5,1,00154,India
918158,2023-06-14,712,graph paper,20,40,20,1,00488,India
918158,2023-06-14,703,eraser,1,3,2,1,00488,India
239464,2023-06-14,703,eraser,1,3,2,1,00257,India
868361,2023-06-14,704,scale,5,10,5,1,00228,India
868361,2023-06-14,707,marker,20,40,20,1,00228,India
868361,2023-06-14,710,geometry box,100,150,50,1,00228,India
957650,2023-06-14,713,ball pen,5,10,5,1,00151,India
957650,2023-06-14,705,stencil,10,20,10,1,00151,India
957650,2023-06-14,710,geometry box,100,150,50,1,00151,India
113262,2023-06-14,701,gel pen,5,10,5,1,00332,India
113262,2023-06-14,704,scale,5,10,5,1,00332,India
113262,2023-06-14,715,folder,5,15,10,1,00332,India
465853,2023-06-14,701,gel pen,5,10,5,1,00308,India
465853,2023-06-14,708,sketchpen,15,40,25,1,00308,India
465853,2023-06-14,707,marker,20,40,20,1,00308,India
465853,2023-06-14,714,carbon paper,15,30,15,1,00308,India
706171,2023-06-14,703,eraser,1,3,2,1,00472,India
706171,2023-06-14,717,spiral bound book,50,100,50,1,00472,India
511582,2023-06-14,701,gel pen,5,10,5,1,00324,India
511582,2023-06-14,716,printing paper,200,400,200,1,00324,India
511582,2023-06-14,715,folder,5,15,10,1,00324,India
226116,2023-06-14,713,ball pen,5,10,5,1,00184,India
202670,2023-06-14,707,marker,20,40,20,1,00080,India
202670,2023-06-14,710,geometry box,100,150,50,1,00080,India
882059,2023-06-14,713,ball pen,5,10,5,1,00458,India
882059,2023-06-14,706,sharpener,3,8,5,1,00458,India
882059,2023-06-14,711,TD kit,150,300,150,1,00458,India
882059,2023-06-14,710,geometry box,100,150,50,1,00458,India
669550,2023-06-14,708,sketchpen,15,40,25,1,00389,India
669550,2023-06-14,709,notebook,30,60,30,1,00389,India
276958,2023-06-14,714,carbon paper,15,30,15,1,00248,India
276958,2023-06-14,717,spiral bound book,50,100,50,1,00248,India
276958,2023-06-14,703,eraser,1,3,2,1,00248,India
276958,2023-06-14,709,notebook,30,60,30,1,00248,India
168769,2023-06-14,709,notebook,30,60,30,1,00456,India
168769,2023-06-14,710,geometry box,100,150,50,1,00456,India
168769,2023-06-14,715,folder,5,15,10,1,00456,India
168769,2023-06-14,707,marker,20,40,20,1,00456,India
134570,2023-06-14,717,spiral bound book,50,100,50,1,00492,India
158994,2023-06-14,706,sharpener,3,8,5,1,00317,India
158994,2023-06-14,707,marker,20,40,20,1,00317,India
158994,2023-06-14,708,sketchpen,15,40,25,1,00317,India
158994,2023-06-14,705,stencil,10,20,10,1,00317,India
415906,2023-06-14,712,graph paper,20,40,20,1,00051,India
415906,2023-06-14,709,notebook,30,60,30,1,00051,India
415906,2023-06-14,705,stencil,10,20,10,1,00051,India
415906,2023-06-14,701,gel pen,5,10,5,1,00051,India
608545,2023-06-14,714,carbon paper,15,30,15,1,00033,India
608545,2023-06-14,712,graph paper,20,40,20,1,00033,India
608545,2023-06-14,706,sharpener,3,8,5,1,00033,India
213032,2023-06-14,703,eraser,1,3,2,1,00333,India
556735,2023-06-14,708,sketchpen,15,40,25,1,00030,India
556735,2023-06-14,710,geometry box,100,150,50,1,00030,India
556735,2023-06-14,705,stencil,10,20,10,1,00030,India
440830,2023-06-14,717,spiral bound book,50,100,50,1,00473,India
440830,2023-06-14,716,printing paper,200,400,200,1,00473,India
604652,2023-06-14,711,TD kit,150,300,150,1,00220,India
604652,2023-06-14,703,eraser,1,3,2,1,00220,India
604652,2023-06-14,702,pencil,2,5,3,1,00220,India
604652,2023-06-14,717,spiral bound book,50,100,50,1,00220,India
833386,2023-06-14,716,printing paper,200,400,200,1,00015,India
833386,2023-06-14,708,sketchpen,15,40,25,1,00015,India
272800,2023-06-15,716,printing paper,200,400,200,1,00359,India
272800,2023-06-15,711,TD kit,150,300,150,1,00359,India
272800,2023-06-15,715,folder,5,15,10,1,00359,India
272800,2023-06-15,710,geometry box,100,150,50,1,00359,India
853975,2023-06-15,710,geometry box,100,150,50,1,00117,India
927278,2023-06-15,706,sharpener,3,8,5,1,00196,India
927278,2023-06-15,712,graph paper,20,40,20,1,00196,India
927278,2023-06-15,708,sketchpen,15,40,25,1,00196,India
927278,2023-06-15,710,geometry box,100,150,50,1,00196,India
215736,2023-06-15,708,sketchpen,15,40,25,1,00100,India
215736,2023-06-15,711,TD kit,150,300,150,1,00100,India
215736,2023-06-15,702,pencil,2,5,3,1,00100,India
909699,2023-06-15,715,folder,5,15,10,1,00199,India
657592,2023-06-15,705,stencil,10,20,10,1,00431,India
657592,2023-06-15,714,carbon paper,15,30,15,1,00431,India
657592,2023-06-15,706,sharpener,3,8,5,1,00431,India
657592,2023-06-15,701,gel pen,5,10,5,1,00431,India
873691,2023-06-15,715,folder,5,15,10,1,00064,India
873691,2023-06-15,716,printing paper,200,400,200,1,00064,India
873691,2023-06-15,708,sketchpen,15,40,25,1,00064,India
873691,2023-06-15,705,stencil,10,20,10,1,00064,India
581203,2023-06-15,707,marker,20,40,20,1,00204,India
581203,2023-06-15,716,printing paper,200,400,200,1,00204,India
581203,2023-06-15,702,pencil,2,5,3,1,00204,India
581203,2023-06-15,706,sharpener,3,8,5,1,00204,India
231582,2023-06-15,712,graph paper,20,40,20,1,00100,India
915855,2023-06-15,704,scale,5,10,5,1,00283,India
915855,2023-06-15,715,folder,5,15,10,1,00283,India
915855,2023-06-15,710,geometry box,100,150,50,1,00283,India
834944,2023-06-15,713,ball pen,5,10,5,1,00349,India
834944,2023-06-15,703,eraser,1,3,2,1,00349,India
834944,2023-06-15,717,spiral bound book,50,100,50,1,00349,India
834944,2023-06-15,708,sketchpen,15,40,25,1,00349,India
938261,2023-06-15,716,printing paper,200,400,200,1,00392,India
938261,2023-06-15,714,carbon paper,15,30,15,1,00392,India
538097,2023-06-15,712,graph paper,20,40,20,1,00087,India
538097,2023-06-15,716,printing paper,200,400,200,1,00087,India
538097,2023-06-15,701,gel pen,5,10,5,1,00087,India
538097,2023-06-15,714,carbon paper,15,30,15,1,00087,India
809633,2023-06-15,717,spiral bound book,50,100,50,1,00128,India
757410,2023-06-15,703,eraser,1,3,2,1,00422,India
757410,2023-06-15,707,marker,20,40,20,1,00422,India
757410,2023-06-15,702,pencil,2,5,3,1,00422,India
221512,2023-06-15,705,stencil,10,20,10,1,00013,India
221512,2023-06-15,712,graph paper,20,40,20,1,00013,India
221512,2023-06-15,702,pencil,2,5,3,1,00013,India
380225,2023-06-15,701,gel pen,5,10,5,1,00163,India
930016,2023-06-15,713,ball pen,5,10,5,1,00268,India
930016,2023-06-15,712,graph paper,20,40,20,1,00268,India
930016,2023-06-15,711,TD kit,150,300,150,1,00268,India
930016,2023-06-15,715,folder,5,15,10,1,00268,India
930016,2023-06-15,707,marker,20,40,20,1,00268,India
263343,2023-06-15,709,notebook,30,60,30,1,00078,India
125060,2023-06-15,708,sketchpen,15,40,25,1,00272,India
125060,2023-06-15,709,notebook,30,60,30,1,00272,India
125060,2023-06-15,713,ball pen,5,10,5,1,00272,India
552177,2023-06-15,712,graph paper,20,40,20,1,00489,India
552177,2023-06-15,716,printing paper,200,400,200,1,00489,India
552177,2023-06-15,714,carbon paper,15,30,15,1,00489,India
627336,2023-06-15,707,marker,20,40,20,1,00128,India
627336,2023-06-15,717,spiral bound book,50,100,50,1,00128,India
627336,2023-06-15,713,ball pen,5,10,5,1,00128,India
158841,2023-06-15,717,spiral bound book,50,100,50,1,00420,India
158841,2023-06-15,709,notebook,30,60,30,1,00420,India
158841,2023-06-15,705,stencil,10,20,10,1,00420,India
158841,2023-06-15,710,geometry box,100,150,50,1,00420,India
153728,2023-06-15,705,stencil,10,20,10,1,00252,India
514637,2023-06-15,708,sketchpen,15,40,25,1,00469,India
514637,2023-06-15,707,marker,20,40,20,1,00469,India
514637,2023-06-15,701,gel pen,5,10,5,1,00469,India
996124,2023-06-15,709,notebook,30,60,30,1,00206,India
996124,2023-06-15,715,folder,5,15,10,1,00206,India
996124,2023-06-15,707,marker,20,40,20,1,00206,India
996124,2023-06-15,711,TD kit,150,300,150,1,00206,India
424821,2023-06-15,710,geometry box,100,150,50,1,00194,India
424821,2023-06-15,715,folder,5,15,10,1,00194,India
424821,2023-06-15,713,ball pen,5,10,5,1,00194,India
424821,2023-06-15,711,TD kit,150,300,150,1,00194,India
170455,2023-06-15,706,sharpener,3,8,5,1,00059,India
170455,2023-06-15,712,graph paper,20,40,20,1,00059,India
304869,2023-06-15,710,geometry box,100,150,50,1,00037,India
304869,2023-06-15,707,marker,20,40,20,1,00037,India
304869,2023-06-15,711,TD kit,150,300,150,1,00037,India
481758,2023-06-15,707,marker,20,40,20,1,00271,India
481758,2023-06-15,706,sharpener,3,8,5,1,00271,India
577517,2023-06-15,702,pencil,2,5,3,1,00457,India
577517,2023-06-15,705,stencil,10,20,10,1,00457,India
577517,2023-06-15,704,scale,5,10,5,1,00457,India
577517,2023-06-15,711,TD kit,150,300,150,1,00457,India
326109,2023-06-15,715,folder,5,15,10,1,00137,India
326109,2023-06-15,716,printing paper,200,400,200,1,00137,India
307417,2023-06-15,716,printing paper,200,400,200,1,00473,India
307417,2023-06-15,710,geometry box,100,150,50,1,00473,India
754887,2023-06-15,705,stencil,10,20,10,1,00404,India
754887,2023-06-15,715,folder,5,15,10,1,00404,India
754887,2023-06-15,704,scale,5,10,5,1,00404,India
105860,2023-06-15,716,printing paper,200,400,200,1,00059,India
105860,2023-06-15,701,gel pen,5,10,5,1,00059,India
834753,2023-06-15,705,stencil,10,20,10,1,00466,India
834753,2023-06-15,715,folder,5,15,10,1,00466,India
834753,2023-06-15,701,gel pen,5,10,5,1,00466,India
241612,2023-06-15,706,sharpener,3,8,5,1,00490,India
241612,2023-06-15,717,spiral bound book,50,100,50,1,00490,India
377289,2023-06-15,713,ball pen,5,10,5,1,00393,India
377289,2023-06-15,711,TD kit,150,300,150,1,00393,India
377289,2023-06-15,702,pencil,2,5,3,1,00393,India
377289,2023-06-15,717,spiral bound book,50,100,50,1,00393,India
742695,2023-06-15,715,folder,5,15,10,1,00382,India
742695,2023-06-15,712,graph paper,20,40,20,1,00382,India
796884,2023-06-15,713,ball pen,5,10,5,1,00176,India
349679,2023-06-15,708,sketchpen,15,40,25,1,00353,India
349679,2023-06-15,701,gel pen,5,10,5,1,00353,India
567437,2023-06-15,713,ball pen,5,10,5,1,00307,India
911524,2023-06-15,714,carbon paper,15,30,15,1,00183,India
911524,2023-06-15,712,graph paper,20,40,20,1,00183,India
911524,2023-06-15,710,geometry box,100,150,50,1,00183,India
505553,2023-06-15,708,sketchpen,15,40,25,1,00001,India
505553,2023-06-15,716,printing paper,200,400,200,1,00001,India
797299,2023-06-15,705,stencil,10,20,10,1,00402,India
686770,2023-06-15,706,sharpener,3,8,5,1,00181,India
686770,2023-06-15,716,printing paper,200,400,200,1,00181,India
686770,2023-06-15,703,eraser,1,3,2,1,00181,India
952874,2023-06-16,703,eraser,1,3,2,1,00122,India
952874,2023-06-16,706,sharpener,3,8,5,1,00122,India
952874,2023-06-16,707,marker,20,40,20,1,00122,India
612272,2023-06-16,708,sketchpen,15,40,25,1,00132,India
612272,2023-06-16,710,geometry box,100,150,50,1,00132,India
612272,2023-06-16,701,gel pen,5,10,5,1,00132,India
612272,2023-06-16,704,scale,5,10,5,1,00132,India
612272,2023-06-16,716,printing paper,200,400,200,1,00132,India
517862,2023-06-16,705,stencil,10,20,10,1,00230,India
517862,2023-06-16,708,sketchpen,15,40,25,1,00230,India
906924,2023-06-16,706,sharpener,3,8,5,1,00150,India
906924,2023-06-16,712,graph paper,20,40,20,1,00150,India
415047,2023-06-16,715,folder,5,15,10,1,00295,India
177506,2023-06-16,709,notebook,30,60,30,1,00017,India
177506,2023-06-16,707,marker,20,40,20,1,00017,India
177506,2023-06-16,715,folder,5,15,10,1,00017,India
177506,2023-06-16,701,gel pen,5,10,5,1,00017,India
369719,2023-06-16,710,geometry box,100,150,50,1,00167,India
290902,2023-06-16,706,sharpener,3,8,5,1,00065,India
290902,2023-06-16,716,printing paper,200,400,200,1,00065,India
290902,2023-06-16,714,carbon paper,15,30,15,1,00065,India
290902,2023-06-16,713,ball pen,5,10,5,1,00065,India
610274,2023-06-16,706,sharpener,3,8,5,1,00464,India
610274,2023-06-16,708,sketchpen,15,40,25,1,00464,India
610274,2023-06-16,709,notebook,30,60,30,1,00464,India
629731,2023-06-16,717,spiral bound book,50,100,50,1,00469,India
629731,2023-06-16,705,stencil,10,20,10,1,00469,India
629731,2023-06-16,715,folder,5,15,10,1,00469,India
629731,2023-06-16,716,printing paper,200,400,200,1,00469,India
629731,2023-06-16,704,scale,5,10,5,1,00469,India
587499,2023-06-16,701,gel pen,5,10,5,1,00446,India
587499,2023-06-16,712,graph paper,20,40,20,1,00446,India
587499,2023-06-16,708,sketchpen,15,40,25,1,00446,India
587499,2023-06-16,716,printing paper,200,400,200,1,00446,India
442585,2023-06-16,716,printing paper,200,400,200,1,00010,India
442585,2023-06-16,706,sharpener,3,8,5,1,00010,India
442585,2023-06-16,701,gel pen,5,10,5,1,00010,India
442585,2023-06-16,714,carbon paper,15,30,15,1,00010,India
637172,2023-06-16,715,folder,5,15,10,1,00122,India
637172,2023-06-16,716,printing paper,200,400,200,1,00122,India
637172,2023-06-16,706,sharpener,3,8,5,1,00122,India
651026,2023-06-16,703,eraser,1,3,2,1,00253,India
651026,2023-06-16,707,marker,20,40,20,1,00253,India
350504,2023-06-16,708,sketchpen,15,40,25,1,00235,India
350504,2023-06-16,717,spiral bound book,50,100,50,1,00235,India
350504,2023-06-16,714,carbon paper,15,30,15,1,00235,India
278582,2023-06-16,707,marker,20,40,20,1,00021,India
278582,2023-06-16,715,folder,5,15,10,1,00021,India
278582,2023-06-16,709,notebook,30,60,30,1,00021,India
278582,2023-06-16,708,sketchpen,15,40,25,1,00021,India
703408,2023-06-16,710,geometry box,100,150,50,1,00392,India
703408,2023-06-16,701,gel pen,5,10,5,1,00392,India
703408,2023-06-16,704,scale,5,10,5,1,00392,India
416968,2023-06-16,717,spiral bound book,50,100,50,1,00436,India
416968,2023-06-16,715,folder,5,15,10,1,00436,India
416968,2023-06-16,709,notebook,30,60,30,1,00436,India
358861,2023-06-16,710,geometry box,100,150,50,1,00376,India
358861,2023-06-16,708,sketchpen,15,40,25,1,00376,India
358861,2023-06-16,712,graph paper,20,40,20,1,00376,India
829688,2023-06-16,705,stencil,10,20,10,1,00479,India
294138,2023-06-16,701,gel pen,5,10,5,1,00074,India
294138,2023-06-16,704,scale,5,10,5,1,00074,India
541506,2023-06-16,717,spiral bound book,50,100,50,1,00260,India
541506,2023-06-16,704,scale,5,10,5,1,00260,India
635557,2023-06-16,713,ball pen,5,10,5,1,00291,India
584057,2023-06-16,713,ball pen,5,10,5,1,00062,India
661912,2023-06-16,710,geometry box,100,150,50,1,00383,India
661912,2023-06-16,703,eraser,1,3,2,1,00383,India
830054,2023-06-16,711,TD kit,150,300,150,1,00322,India
501076,2023-06-16,717,spiral bound book,50,100,50,1,00428,India
501076,2023-06-16,703,eraser,1,3,2,1,00428,India
501076,2023-06-16,707,marker,20,40,20,1,00428,India
115365,2023-06-16,703,eraser,1,3,2,1,00098,India
115365,2023-06-16,715,folder,5,15,10,1,00098,India
582393,2023-06-16,713,ball pen,5,10,5,1,00442,India
582393,2023-06-16,710,geometry box,100,150,50,1,00442,India
515016,2023-06-16,704,scale,5,10,5,1,00277,India
515016,2023-06-16,708,sketchpen,15,40,25,1,00277,India
707621,2023-06-16,717,spiral bound book,50,100,50,1,00432,India
707621,2023-06-16,713,ball pen,5,10,5,1,00432,India
251381,2023-06-16,702,pencil,2,5,3,1,00394,India
251381,2023-06-16,714,carbon paper,15,30,15,1,00394,India
732869,2023-06-16,704,scale,5,10,5,1,00326,India
732869,2023-06-16,705,stencil,10,20,10,1,00326,India
732869,2023-06-16,716,printing paper,200,400,200,1,00326,India
732869,2023-06-16,715,folder,5,15,10,1,00326,India
855849,2023-06-16,703,eraser,1,3,2,1,00251,India
855849,2023-06-16,717,spiral bound book,50,100,50,1,00251,India
855849,2023-06-16,701,gel pen,5,10,5,1,00251,India
855849,2023-06-16,716,printing paper,200,400,200,1,00251,India
327175,2023-06-16,703,eraser,1,3,2,1,00423,India
327175,2023-06-16,710,geometry box,100,150,50,1,00423,India
327175,2023-06-16,706,sharpener,3,8,5,1,00423,India
327175,2023-06-16,714,carbon paper,15,30,15,1,00423,India
653526,2023-06-16,714,carbon paper,15,30,15,1,00315,India
844109,2023-06-16,702,pencil,2,5,3,1,00045,India
844109,2023-06-16,708,sketchpen,15,40,25,1,00045,India
606907,2023-06-16,716,printing paper,200,400,200,1,00291,India
606907,2023-06-16,706,sharpener,3,8,5,1,00291,India
271888,2023-06-16,717,spiral bound book,50,100,50,1,00037,India
271888,2023-06-16,711,TD kit,150,300,150,1,00037,India
965224,2023-06-17,705,stencil,10,20,10,1,00329,India
965224,2023-06-17,715,folder,5,15,10,1,00329,India
965224,2023-06-17,709,notebook,30,60,30,1,00329,India
965224,2023-06-17,704,scale,5,10,5,1,00329,India
965224,2023-06-17,716,printing paper,200,400,200,1,00329,India
442499,2023-06-17,702,pencil,2,5,3,1,00282,India
442499,2023-06-17,703,eraser,1,3,2,1,00282,India
442499,2023-06-17,701,gel pen,5,10,5,1,00282,India
874668,2023-06-17,707,marker,20,40,20,1,00459,India
874668,2023-06-17,705,stencil,10,20,10,1,00459,India
874668,2023-06-17,702,pencil,2,5,3,1,00459,India
874668,2023-06-17,709,notebook,30,60,30,1,00459,India
874668,2023-06-17,713,ball pen,5,10,5,1,00459,India
624450,2023-06-17,705,stencil,10,20,10,1,00009,India
624450,2023-06-17,712,graph paper,20,40,20,1,00009,India
624450,2023-06-17,708,sketchpen,15,40,25,1,00009,India
840636,2023-06-17,716,printing paper,200,400,200,1,00248,India
840636,2023-06-17,713,ball pen,5,10,5,1,00248,India
198233,2023-06-17,702,pencil,2,5,3,1,00066,India
198233,2023-06-17,715,folder,5,15,10,1,00066,India
198233,2023-06-17,705,stencil,10,20,10,1,00066,India
198233,2023-06-17,713,ball pen,5,10,5,1,00066,India
407089,2023-06-17,710,geometry box,100,150,50,1,00329,India
407089,2023-06-17,708,sketchpen,15,40,25,1,00329,India
407089,2023-06-17,712,graph paper,20,40,20,1,00329,India
268346,2023-06-17,709,notebook,30,60,30,1,00153,India
451019,2023-06-17,710,geometry box,100,150,50,1,00402,India
451019,2023-06-17,702,pencil,2,5,3,1,00402,India
451019,2023-06-17,703,eraser,1,3,2,1,00402,India
451019,2023-06-17,708,sketchpen,15,40,25,1,00402,India
368020,2023-06-17,714,carbon paper,15,30,15,1,00303,India
368020,2023-06-17,715,folder,5,15,10,1,00303,India
328000,2023-06-17,702,pencil,2,5,3,1,00156,India
328000,2023-06-17,711,TD kit,150,300,150,1,00156,India
328000,2023-06-17,704,scale,5,10,5,1,00156,India
990977,2023-06-17,708,sketchpen,15,40,25,1,00453,India
990977,2023-06-17,707,marker,20,40,20,1,00453,India
990977,2023-06-17,702,pencil,2,5,3,1,00453,India
891353,2023-06-17,709,notebook,30,60,30,1,00007,India
891353,2023-06-17,717,spiral bound book,50,100,50,1,00007,India
891353,2023-06-17,707,marker,20,40,20,1,00007,India
682099,2023-06-17,716,printing paper,200,400,200,1,00429,India
682099,2023-06-17,714,carbon paper,15,30,15,1,00429,India
682099,2023-06-17,707,marker,20,40,20,1,00429,India
682099,2023-06-17,702,pencil,2,5,3,1,00429,India
444598,2023-06-17,707,marker,20,40,20,1,00219,India
444598,2023-06-17,710,geometry box,100,150,50,1,00219,India
444598,2023-06-17,713,ball pen,5,10,5,1,00219,India
717840,2023-06-17,706,sharpener,3,8,5,1,00466,India
717840,2023-06-17,701,gel pen,5,10,5,1,00466,India
717840,2023-06-17,716,printing paper,200,400,200,1,00466,India
717840,2023-06-17,707,marker,20,40,20,1,00466,India
605962,2023-06-17,716,printing paper,200,400,200,1,00297,India
605962,2023-06-17,711,TD kit,150,300,150,1,00297,India
605962,2023-06-17,714,carbon paper,15,30,15,1,00297,India
775675,2023-06-17,714,carbon paper,15,30,15,1,00414,India
643865,2023-06-17,703,eraser,1,3,2,1,00250,India
643865,2023-06-17,705,stencil,10,20,10,1,00250,India
407903,2023-06-17,709,notebook,30,60,30,1,00304,India
407903,2023-06-17,702,pencil,2,5,3,1,00304,India
256356,2023-06-17,704,scale,5,10,5,1,00216,India
256356,2023-06-17,701,gel pen,5,10,5,1,00216,India
256356,2023-06-17,711,TD kit,150,300,150,1,00216,India
256356,2023-06-17,715,folder,5,15,10,1,00216,India
256356,2023-06-17,714,carbon paper,15,30,15,1,00216,India
562911,2023-06-17,702,pencil,2,5,3,1,00139,India
221504,2023-06-17,716,printing paper,200,400,200,1,00348,India
221504,2023-06-17,709,notebook,30,60,30,1,00348,India
221504,2023-06-17,715,folder,5,15,10,1,00348,India
221504,2023-06-17,706,sharpener,3,8,5,1,00348,India
994677,2023-06-17,711,TD kit,150,300,150,1,00021,India
994677,2023-06-17,707,marker,20,40,20,1,00021,India
603436,2023-06-17,707,marker,20,40,20,1,00372,India
603436,2023-06-17,710,geometry box,100,150,50,1,00372,India
603436,2023-06-17,705,stencil,10,20,10,1,00372,India
603436,2023-06-17,713,ball pen,5,10,5,1,00372,India
810983,2023-06-17,704,scale,5,10,5,1,00366,India
282586,2023-06-17,705,stencil,10,20,10,1,00409,India
282586,2023-06-17,712,graph paper,20,40,20,1,00409,India
282586,2023-06-17,716,printing paper,200,400,200,1,00409,India
371473,2023-06-17,708,sketchpen,15,40,25,1,00452,India
371473,2023-06-17,711,TD kit,150,300,150,1,00452,India
371473,2023-06-17,716,printing paper,200,400,200,1,00452,India
518931,2023-06-17,716,printing paper,200,400,200,1,00371,India
518931,2023-06-17,701,gel pen,5,10,5,1,00371,India
802874,2023-06-17,706,sharpener,3,8,5,1,00322,India
802874,2023-06-17,710,geometry box,100,150,50,1,00322,India
771850,2023-06-17,715,folder,5,15,10,1,00266,India
771850,2023-06-17,701,gel pen,5,10,5,1,00266,India
771850,2023-06-17,713,ball pen,5,10,5,1,00266,India
771850,2023-06-17,717,spiral bound book,50,100,50,1,00266,India
143938,2023-06-17,706,sharpener,3,8,5,1,00293,India
143938,2023-06-17,710,geometry box,100,150,50,1,00293,India
143938,2023-06-17,711,TD kit,150,300,150,1,00293,India
710417,2023-06-18,707,marker,20,40,20,1,00353,India
921672,2023-06-18,714,carbon paper,15,30,15,1,00095,India
921672,2023-06-18,701,gel pen,5,10,5,1,00095,India
921672,2023-06-18,708,sketchpen,15,40,25,1,00095,India
921672,2023-06-18,715,folder,5,15,10,1,00095,India
563347,2023-06-18,713,ball pen,5,10,5,1,00205,India
563347,2023-06-18,715,folder,5,15,10,1,00205,India
501318,2023-06-18,709,notebook,30,60,30,1,00199,India
501318,2023-06-18,704,scale,5,10,5,1,00199,India
501318,2023-06-18,715,folder,5,15,10,1,00199,India
665547,2023-06-18,709,notebook,30,60,30,1,00056,India
665547,2023-06-18,713,ball pen,5,10,5,1,00056,India
665547,2023-06-18,702,pencil,2,5,3,1,00056,India
787809,2023-06-18,711,TD kit,150,300,150,1,00223,India
889279,2023-06-18,716,printing paper,200,400,200,1,00104,India
889279,2023-06-18,712,graph paper,20,40,20,1,00104,India
322426,2023-06-18,705,stencil,10,20,10,1,00241,India
322426,2023-06-18,712,graph paper,20,40,20,1,00241,India
514550,2023-06-18,712,graph paper,20,40,20,1,00088,India
756273,2023-06-18,715,folder,5,15,10,1,00419,India
756273,2023-06-18,706,sharpener,3,8,5,1,00419,India
135681,2023-06-18,701,gel pen,5,10,5,1,00363,India
135681,2023-06-18,703,eraser,1,3,2,1,00363,India
998125,2023-06-18,717,spiral bound book,50,100,50,1,00338,India
792175,2023-06-18,705,stencil,10,20,10,1,00304,India
792175,2023-06-18,704,scale,5,10,5,1,00304,India
792175,2023-06-18,701,gel pen,5,10,5,1,00304,India
792175,2023-06-18,706,sharpener,3,8,5,1,00304,India
983930,2023-06-18,714,carbon paper,15,30,15,1,00223,India
665706,2023-06-18,711,TD kit,150,300,150,1,00276,India
665706,2023-06-18,716,printing paper,200,400,200,1,00276,India
661761,2023-06-18,717,spiral bound book,50,100,50,1,00006,India
661761,2023-06-18,709,notebook,30,60,30,1,00006,India
947031,2023-06-18,713,ball pen,5,10,5,1,00314,India
947031,2023-06-18,701,gel pen,5,10,5,1,00314,India
947031,2023-06-18,710,geometry box,100,150,50,1,00314,India
286177,2023-06-18,715,folder,5,15,10,1,00219,India
286177,2023-06-18,711,TD kit,150,300,150,1,00219,India
286177,2023-06-18,713,ball pen,5,10,5,1,00219,India
656932,2023-06-18,709,notebook,30,60,30,1,00231,India
656932,2023-06-18,713,ball pen,5,10,5,1,00231,India
885136,2023-06-18,703,eraser,1,3,2,1,00252,India
885136,2023-06-18,704,scale,5,10,5,1,00252,India
885136,2023-06-18,702,pencil,2,5,3,1,00252,India
885136,2023-06-18,705,stencil,10,20,10,1,00252,India
885136,2023-06-18,715,folder,5,15,10,1,00252,India
865166,2023-06-18,714,carbon paper,15,30,15,1,00105,India
865166,2023-06-18,706,sharpener,3,8,5,1,00105,India
865166,2023-06-18,716,printing paper,200,400,200,1,00105,India
865166,2023-06-18,713,ball pen,5,10,5,1,00105,India
658563,2023-06-18,715,folder,5,15,10,1,00099,India
658563,2023-06-18,714,carbon paper,15,30,15,1,00099,India
658563,2023-06-18,701,gel pen,5,10,5,1,00099,India
658563,2023-06-18,716,printing paper,200,400,200,1,00099,India
836946,2023-06-18,709,notebook,30,60,30,1,00461,India
836946,2023-06-18,702,pencil,2,5,3,1,00461,India
836946,2023-06-18,716,printing paper,200,400,200,1,00461,India
203870,2023-06-18,714,carbon paper,15,30,15,1,00028,India
203870,2023-06-18,708,sketchpen,15,40,25,1,00028,India
692916,2023-06-18,715,folder,5,15,10,1,00499,India
692916,2023-06-18,703,eraser,1,3,2,1,00499,India
692916,2023-06-18,712,graph paper,20,40,20,1,00499,India
670463,2023-06-18,702,pencil,2,5,3,1,00386,India
670463,2023-06-18,707,marker,20,40,20,1,00386,India
670463,2023-06-18,716,printing paper,200,400,200,1,00386,India
116280,2023-06-18,713,ball pen,5,10,5,1,00017,India
274148,2023-06-18,706,sharpener,3,8,5,1,00335,India
274148,2023-06-18,711,TD kit,150,300,150,1,00335,India
274148,2023-06-18,707,marker,20,40,20,1,00335,India
274148,2023-06-18,715,folder,5,15,10,1,00335,India
274148,2023-06-18,702,pencil,2,5,3,1,00335,India
337809,2023-06-18,710,geometry box,100,150,50,1,00494,India
337809,2023-06-18,715,folder,5,15,10,1,00494,India
403209,2023-06-18,703,eraser,1,3,2,1,00086,India
403209,2023-06-18,713,ball pen,5,10,5,1,00086,India
403209,2023-06-18,715,folder,5,15,10,1,00086,India
403209,2023-06-18,701,gel pen,5,10,5,1,00086,India
847224,2023-06-18,709,notebook,30,60,30,1,00337,India
847224,2023-06-18,712,graph paper,20,40,20,1,00337,India
406252,2023-06-18,713,ball pen,5,10,5,1,00180,India
406252,2023-06-18,705,stencil,10,20,10,1,00180,India
816886,2023-06-18,710,geometry box,100,150,50,1,00366,India
600369,2023-06-18,707,marker,20,40,20,1,00238,India
600369,2023-06-18,706,sharpener,3,8,5,1,00238,India
600369,2023-06-18,711,TD kit,150,300,150,1,00238,India
600369,2023-06-18,708,sketchpen,15,40,25,1,00238,India
725125,2023-06-18,711,TD kit,150,300,150,1,00303,India
353771,2023-06-18,706,sharpener,3,8,5,1,00023,India
353771,2023-06-18,705,stencil,10,20,10,1,00023,India
353771,2023-06-18,702,pencil,2,5,3,1,00023,India
353771,2023-06-18,710,geometry box,100,150,50,1,00023,India
390594,2023-06-18,704,scale,5,10,5,1,00472,India
390594,2023-06-18,707,marker,20,40,20,1,00472,India
390594,2023-06-18,716,printing paper,200,400,200,1,00472,India
390594,2023-06-18,714,carbon paper,15,30,15,1,00472,India
360016,2023-06-18,703,eraser,1,3,2,1,00441,India
360016,2023-06-18,706,sharpener,3,8,5,1,00441,India
360016,2023-06-18,716,printing paper,200,400,200,1,00441,India
360016,2023-06-18,707,marker,20,40,20,1,00441,India
150821,2023-06-18,710,geometry box,100,150,50,1,00081,India
150821,2023-06-18,712,graph paper,20,40,20,1,00081,India
150821,2023-06-18,702,pencil,2,5,3,1,00081,India
150821,2023-06-18,707,marker,20,40,20,1,00081,India
150821,2023-06-18,708,sketchpen,15,40,25,1,00081,India
729269,2023-06-19,712,graph paper,20,40,20,1,00280,India
729269,2023-06-19,713,ball pen,5,10,5,1,00280,India
729269,2023-06-19,708,sketchpen,15,40,25,1,00280,India
729269,2023-06-19,703,eraser,1,3,2,1,00280,India
642937,2023-06-19,705,stencil,10,20,10,1,00377,India
642937,2023-06-19,710,geometry box,100,150,50,1,00377,India
642937,2023-06-19,717,spiral bound book,50,100,50,1,00377,India
642937,2023-06-19,711,TD kit,150,300,150,1,00377,India
269339,2023-06-19,703,eraser,1,3,2,1,00246,India
269339,2023-06-19,717,spiral bound book,50,100,50,1,00246,India
269339,2023-06-19,716,printing paper,200,400,200,1,00246,India
817363,2023-06-19,714,carbon paper,15,30,15,1,00127,India
817363,2023-06-19,705,stencil,10,20,10,1,00127,India
817363,2023-06-19,713,ball pen,5,10,5,1,00127,India
918367,2023-06-19,705,stencil,10,20,10,1,00073,India
317980,2023-06-19,701,gel pen,5,10,5,1,00078,India
317980,2023-06-19,712,graph paper,20,40,20,1,00078,India
317980,2023-06-19,710,geometry box,100,150,50,1,00078,India
317980,2023-06-19,715,folder,5,15,10,1,00078,India
317980,2023-06-19,707,marker,20,40,20,1,00078,India
754250,2023-06-19,709,notebook,30,60,30,1,00005,India
313672,2023-06-19,709,notebook,30,60,30,1,00451,India
313672,2023-06-19,707,marker,20,40,20,1,00451,India
313672,2023-06-19,705,stencil,10,20,10,1,00451,India
313672,2023-06-19,704,scale,5,10,5,1,00451,India
875681,2023-06-19,708,sketchpen,15,40,25,1,00126,India
875681,2023-06-19,713,ball pen,5,10,5,1,00126,India
875681,2023-06-19,710,geometry box,100,150,50,1,00126,India
163699,2023-06-19,701,gel pen,5,10,5,1,00404,India
163699,2023-06-19,705,stencil,10,20,10,1,00404,India
163699,2023-06-19,704,scale,5,10,5,1,00404,India
163699,2023-06-19,714,carbon paper,15,30,15,1,00404,India
111205,2023-06-19,713,ball pen,5,10,5,1,00024,India
111205,2023-06-19,711,TD kit,150,300,150,1,00024,India
111205,2023-06-19,715,folder,5,15,10,1,00024,India
111205,2023-06-19,710,geometry box,100,150,50,1,00024,India
111205,2023-06-19,701,gel pen,5,10,5,1,00024,India
358504,2023-06-19,703,eraser,1,3,2,1,00482,India
358504,2023-06-19,713,ball pen,5,10,5,1,00482,India
358504,2023-06-19,709,notebook,30,60,30,1,00482,India
358504,2023-06-19,712,graph paper,20,40,20,1,00482,India
427789,2023-06-19,715,folder,5,15,10,1,00018,India
592467,2023-06-19,708,sketchpen,15,40,25,1,00048,India
222984,2023-06-19,705,stencil,10,20,10,1,00109,India
420333,2023-06-19,713,ball pen,5,10,5,1,00342,India
820625,2023-06-19,716,printing paper,200,400,200,1,00488,India
820625,2023-06-19,717,spiral bound book,50,100,50,1,00488,India
820625,2023-06-19,703,eraser,1,3,2,1,00488,India
820625,2023-06-19,702,pencil,2,5,3,1,00488,India
820625,2023-06-19,712,graph paper,20,40,20,1,00488,India
313538,2023-06-19,705,stencil,10,20,10,1,00183,India
313538,2023-06-19,713,ball pen,5,10,5,1,00183,India
313538,2023-06-19,716,printing paper,200,400,200,1,00183,India
279478,2023-06-19,715,folder,5,15,10,1,00414,India
279478,2023-06-19,705,stencil,10,20,10,1,00414,India
279478,2023-06-19,707,marker,20,40,20,1,00414,India
107474,2023-06-19,710,geometry box,100,150,50,1,00201,India
107474,2023-06-19,703,eraser,1,3,2,1,00201,India
923380,2023-06-19,709,notebook,30,60,30,1,00388,India
439896,2023-06-19,707,marker,20,40,20,1,00267,India
439896,2023-06-19,709,notebook,30,60,30,1,00267,India
439896,2023-06-19,702,pencil,2,5,3,1,00267,India
439896,2023-06-19,703,eraser,1,3,2,1,00267,India
439896,2023-06-19,713,ball pen,5,10,5,1,00267,India
371394,2023-06-19,712,graph paper,20,40,20,1,00235,India
371394,2023-06-19,703,eraser,1,3,2,1,00235,India
618515,2023-06-19,712,graph paper,20,40,20,1,00481,India
618515,2023-06-19,702,pencil,2,5,3,1,00481,India
618515,2023-06-19,703,eraser,1,3,2,1,00481,India
592021,2023-06-19,712,graph paper,20,40,20,1,00461,India
592021,2023-06-19,705,stencil,10,20,10,1,00461,India
592021,2023-06-19,704,scale,5,10,5,1,00461,India
326260,2023-06-19,712,graph paper,20,40,20,1,00328,India
326260,2023-06-19,711,TD kit,150,300,150,1,00328,India
326260,2023-06-19,713,ball pen,5,10,5,1,00328,India
450646,2023-06-19,712,graph paper,20,40,20,1,00358,India
450646,2023-06-19,715,folder,5,15,10,1,00358,India
450646,2023-06-19,717,spiral bound book,50,100,50,1,00358,India
456474,2023-06-19,704,scale,5,10,5,1,00478,India
456474,2023-06-19,712,graph paper,20,40,20,1,00478,India
456474,2023-06-19,713,ball pen,5,10,5,1,00478,India
456474,2023-06-19,714,carbon paper,15,30,15,1,00478,India
199360,2023-06-19,710,geometry box,100,150,50,1,00035,India
199360,2023-06-19,713,ball pen,5,10,5,1,00035,India
140645,2023-06-19,705,stencil,10,20,10,1,00289,India
313705,2023-06-19,706,sharpener,3,8,5,1,00247,India
495499,2023-06-19,701,gel pen,5,10,5,1,00363,India
495499,2023-06-19,710,geometry box,100,150,50,1,00363,India
495499,2023-06-19,705,stencil,10,20,10,1,00363,India
495499,2023-06-19,704,scale,5,10,5,1,00363,India
222004,2023-06-19,702,pencil,2,5,3,1,00002,India
721959,2023-06-19,706,sharpener,3,8,5,1,00290,India
721959,2023-06-19,708,sketchpen,15,40,25,1,00290,India
996211,2023-06-19,706,sharpener,3,8,5,1,00491,India
814477,2023-06-19,707,marker,20,40,20,1,00192,India
814477,2023-06-19,709,notebook,30,60,30,1,00192,India
814477,2023-06-19,717,spiral bound book,50,100,50,1,00192,India
814477,2023-06-19,705,stencil,10,20,10,1,00192,India
563118,2023-06-19,716,printing paper,200,400,200,1,00344,India
563118,2023-06-19,712,graph paper,20,40,20,1,00344,India
563118,2023-06-19,705,stencil,10,20,10,1,00344,India
800851,2023-06-19,712,graph paper,20,40,20,1,00400,India
800851,2023-06-19,716,printing paper,200,400,200,1,00400,India
800851,2023-06-19,714,carbon paper,15,30,15,1,00400,India
198067,2023-06-19,717,spiral bound book,50,100,50,1,00016,India
198067,2023-06-19,716,printing paper,200,400,200,1,00016,India
198067,2023-06-19,706,sharpener,3,8,5,1,00016,India
198067,2023-06-19,705,stencil,10,20,10,1,00016,India
921352,2023-06-19,702,pencil,2,5,3,1,00313,India
921352,2023-06-19,706,sharpener,3,8,5,1,00313,India
921352,2023-06-19,701,gel pen,5,10,5,1,00313,India
782059,2023-06-19,711,TD kit,150,300,150,1,00294,India
782059,2023-06-19,708,sketchpen,15,40,25,1,00294,India
498965,2023-06-19,716,printing paper,200,400,200,1,00310,India
498965,2023-06-19,703,eraser,1,3,2,1,00310,India
498965,2023-06-19,712,graph paper,20,40,20,1,00310,India
498965,2023-06-19,714,carbon paper,15,30,15,1,00310,India
866894,2023-06-19,715,folder,5,15,10,1,00495,India
866894,2023-06-19,705,stencil,10,20,10,1,00495,India
866894,2023-06-19,713,ball pen,5,10,5,1,00495,India
866894,2023-06-19,711,TD kit,150,300,150,1,00495,India
866894,2023-06-19,712,graph paper,20,40,20,1,00495,India
921235,2023-06-19,710,geometry box,100,150,50,1,00493,India
921235,2023-06-19,713,ball pen,5,10,5,1,00493,India
526701,2023-06-19,715,folder,5,15,10,1,00075,India
526701,2023-06-19,702,pencil,2,5,3,1,00075,India
579123,2023-06-19,701,gel pen,5,10,5,1,00149,India
579123,2023-06-19,706,sharpener,3,8,5,1,00149,India
139709,2023-06-19,703,eraser,1,3,2,1,00367,India
139709,2023-06-19,710,geometry box,100,150,50,1,00367,India
945013,2023-06-20,713,ball pen,5,10,5,1,00406,India
945013,2023-06-20,712,graph paper,20,40,20,1,00406,India
945013,2023-06-20,707,marker,20,40,20,1,00406,India
945013,2023-06-20,717,spiral bound book,50,100,50,1,00406,India
918439,2023-06-20,701,gel pen,5,10,5,1,00300,India
918439,2023-06-20,714,carbon paper,15,30,15,1,00300,India
434513,2023-06-20,715,folder,5,15,10,1,00167,India
434513,2023-06-20,709,notebook,30,60,30,1,00167,India
434513,2023-06-20,704,scale,5,10,5,1,00167,India
434513,2023-06-20,716,printing paper,200,400,200,1,00167,India
387748,2023-06-20,703,eraser,1,3,2,1,00107,India
387748,2023-06-20,708,sketchpen,15,40,25,1,00107,India
387748,2023-06-20,713,ball pen,5,10,5,1,00107,India
897541,2023-06-20,703,eraser,1,3,2,1,00252,India
897541,2023-06-20,702,pencil,2,5,3,1,00252,India
897541,2023-06-20,716,printing paper,200,400,200,1,00252,India
792753,2023-06-20,715,folder,5,15,10,1,00034,India
787946,2023-06-20,713,ball pen,5,10,5,1,00301,India
787946,2023-06-20,712,graph paper,20,40,20,1,00301,India
787946,2023-06-20,714,carbon paper,15,30,15,1,00301,India
289815,2023-06-20,708,sketchpen,15,40,25,1,00388,India
289815,2023-06-20,717,spiral bound book,50,100,50,1,00388,India
289815,2023-06-20,707,marker,20,40,20,1,00388,India
289815,2023-06-20,704,scale,5,10,5,1,00388,India
622365,2023-06-20,704,scale,5,10,5,1,00210,India
420578,2023-06-20,706,sharpener,3,8,5,1,00168,India
420578,2023-06-20,704,scale,5,10,5,1,00168,India
420578,2023-06-20,714,carbon paper,15,30,15,1,00168,India
560604,2023-06-20,712,graph paper,20,40,20,1,00043,India
560604,2023-06-20,705,stencil,10,20,10,1,00043,India
560604,2023-06-20,702,pencil,2,5,3,1,00043,India
560604,2023-06-20,701,gel pen,5,10,5,1,00043,India
819947,2023-06-20,703,eraser,1,3,2,1,00064,India
819947,2023-06-20,701,gel pen,5,10,5,1,00064,India
886458,2023-06-20,713,ball pen,5,10,5,1,00195,India
886458,2023-06-20,710,geometry box,100,150,50,1,00195,India
886458,2023-06-20,702,pencil,2,5,3,1,00195,India
886458,2023-06-20,704,scale,5,10,5,1,00195,India
286644,2023-06-20,713,ball pen,5,10,5,1,00044,India
757267,2023-06-20,708,sketchpen,15,40,25,1,00121,India
757267,2023-06-20,703,eraser,1,3,2,1,00121,India
757267,2023-06-20,716,printing paper,200,400,200,1,00121,India
757267,2023-06-20,701,gel pen,5,10,5,1,00121,India
678063,2023-06-20,701,gel pen,5,10,5,1,00201,India
555484,2023-06-20,707,marker,20,40,20,1,00464,India
555484,2023-06-20,715,folder,5,15,10,1,00464,India
403832,2023-06-20,706,sharpener,3,8,5,1,00324,India
403832,2023-06-20,704,scale,5,10,5,1,00324,India
403832,2023-06-20,710,geometry box,100,150,50,1,00324,India
981521,2023-06-20,714,carbon paper,15,30,15,1,00390,India
981521,2023-06-20,704,scale,5,10,5,1,00390,India
981521,2023-06-20,701,gel pen,5,10,5,1,00390,India
981521,2023-06-20,716,printing paper,200,400,200,1,00390,India
542986,2023-06-20,715,folder,5,15,10,1,00046,India
542986,2023-06-20,712,graph paper,20,40,20,1,00046,India
542986,2023-06-20,717,spiral bound book,50,100,50,1,00046,India
146876,2023-06-20,701,gel pen,5,10,5,1,00189,India
146876,2023-06-20,705,stencil,10,20,10,1,00189,India
146876,2023-06-20,708,sketchpen,15,40,25,1,00189,India
146876,2023-06-20,702,pencil,2,5,3,1,00189,India
871234,2023-06-20,709,notebook,30,60,30,1,00120,India
871234,2023-06-20,716,printing paper,200,400,200,1,00120,India
871234,2023-06-20,708,sketchpen,15,40,25,1,00120,India
417378,2023-06-20,706,sharpener,3,8,5,1,00134,India
417378,2023-06-20,715,folder,5,15,10,1,00134,India
417378,2023-06-20,707,marker,20,40,20,1,00134,India
654970,2023-06-20,701,gel pen,5,10,5,1,00022,India
654970,2023-06-20,703,eraser,1,3,2,1,00022,India
654970,2023-06-20,716,printing paper,200,400,200,1,00022,India
558277,2023-06-20,713,ball pen,5,10,5,1,00227,India
558277,2023-06-20,706,sharpener,3,8,5,1,00227,India
558277,2023-06-20,715,folder,5,15,10,1,00227,India
949188,2023-06-20,702,pencil,2,5,3,1,00095,India
949188,2023-06-20,706,sharpener,3,8,5,1,00095,India
949188,2023-06-20,708,sketchpen,15,40,25,1,00095,India
767973,2023-06-20,708,sketchpen,15,40,25,1,00385,India
767973,2023-06-20,704,scale,5,10,5,1,00385,India
330150,2023-06-20,706,sharpener,3,8,5,1,00321,India
330150,2023-06-20,712,graph paper,20,40,20,1,00321,India
330150,2023-06-20,701,gel pen,5,10,5,1,00321,India
330150,2023-06-20,710,geometry box,100,150,50,1,00321,India
394710,2023-06-20,714,carbon paper,15,30,15,1,00125,India
231797,2023-06-20,717,spiral bound book,50,100,50,1,00360,India
231797,2023-06-20,715,folder,5,15,10,1,00360,India
231797,2023-06-20,711,TD kit,150,300,150,1,00360,India
231797,2023-06-20,705,stencil,10,20,10,1,00360,India
937578,2023-06-20,709,notebook,30,60,30,1,00486,India
937578,2023-06-20,712,graph paper,20,40,20,1,00486,India
937578,2023-06-20,701,gel pen,5,10,5,1,00486,India
937578,2023-06-20,707,marker,20,40,20,1,00486,India
937578,2023-06-20,716,printing paper,200,400,200,1,00486,India
354946,2023-06-20,705,stencil,10,20,10,1,00174,India
354946,2023-06-20,717,spiral bound book,50,100,50,1,00174,India
924261,2023-06-20,712,graph paper,20,40,20,1,00451,India
176142,2023-06-20,702,pencil,2,5,3,1,00026,India
176142,2023-06-20,707,marker,20,40,20,1,00026,India
176142,2023-06-20,705,stencil,10,20,10,1,00026,India
624164,2023-06-20,707,marker,20,40,20,1,00282,India
624164,2023-06-20,712,graph paper,20,40,20,1,00282,India
624164,2023-06-20,708,sketchpen,15,40,25,1,00282,India
624164,2023-06-20,713,ball pen,5,10,5,1,00282,India
624164,2023-06-20,711,TD kit,150,300,150,1,00282,India
314288,2023-06-20,711,TD kit,150,300,150,1,00024,India
314288,2023-06-20,706,sharpener,3,8,5,1,00024,India
314288,2023-06-20,702,pencil,2,5,3,1,00024,India
246672,2023-06-20,708,sketchpen,15,40,25,1,00396,India
246672,2023-06-20,713,ball pen,5,10,5,1,00396,India
246672,2023-06-20,703,eraser,1,3,2,1,00396,India
999354,2023-06-20,701,gel pen,5,10,5,1,00248,India
999354,2023-06-20,702,pencil,2,5,3,1,00248,India
999354,2023-06-20,708,sketchpen,15,40,25,1,00248,India
999354,2023-06-20,716,printing paper,200,400,200,1,00248,India
999354,2023-06-20,703,eraser,1,3,2,1,00248,India
384687,2023-06-20,703,eraser,1,3,2,1,00055,India
384687,2023-06-20,707,marker,20,40,20,1,00055,India
384687,2023-06-20,714,carbon paper,15,30,15,1,00055,India
384687,2023-06-20,708,sketchpen,15,40,25,1,00055,India
106634,2023-06-21,705,stencil,10,20,10,1,00018,India
871130,2023-06-21,701,gel pen,5,10,5,1,00298,India
871130,2023-06-21,717,spiral bound book,50,100,50,1,00298,India
481217,2023-06-21,712,graph paper,20,40,20,1,00355,India
481217,2023-06-21,717,spiral bound book,50,100,50,1,00355,India
481217,2023-06-21,707,marker,20,40,20,1,00355,India
481217,2023-06-21,716,printing paper,200,400,200,1,00355,India
481217,2023-06-21,702,pencil,2,5,3,1,00355,India
290470,2023-06-21,713,ball pen,5,10,5,1,00282,India
162078,2023-06-21,713,ball pen,5,10,5,1,00322,India
289608,2023-06-21,703,eraser,1,3,2,1,00086,India
289608,2023-06-21,711,TD kit,150,300,150,1,00086,India
289608,2023-06-21,714,carbon paper,15,30,15,1,00086,India
289608,2023-06-21,713,ball pen,5,10,5,1,00086,India
289608,2023-06-21,710,geometry box,100,150,50,1,00086,India
685056,2023-06-21,706,sharpener,3,8,5,1,00162,India
685056,2023-06-21,717,spiral bound book,50,100,50,1,00162,India
685056,2023-06-21,707,marker,20,40,20,1,00162,India
314268,2023-06-21,702,pencil,2,5,3,1,00341,India
314268,2023-06-21,717,spiral bound book,50,100,50,1,00341,India
314268,2023-06-21,706,sharpener,3,8,5,1,00341,India
314268,2023-06-21,705,stencil,10,20,10,1,00341,India
581047,2023-06-21,712,graph paper,20,40,20,1,00236,India
682733,2023-06-21,714,carbon paper,15,30,15,1,00219,India
682733,2023-06-21,711,TD kit,150,300,150,1,00219,India
392384,2023-06-21,713,ball pen,5,10,5,1,00264,India
392384,2023-06-21,712,graph paper,20,40,20,1,00264,India
392384,2023-06-21,709,notebook,30,60,30,1,00264,India
392384,2023-06-21,714,carbon paper,15,30,15,1,00264,India
392384,2023-06-21,705,stencil,10,20,10,1,00264,India
730235,2023-06-21,710,geometry box,100,150,50,1,00069,India
730235,2023-06-21,702,pencil,2,5,3,1,00069,India
877635,2023-06-21,716,printing paper,200,400,200,1,00443,India
877635,2023-06-21,706,sharpener,3,8,5,1,00443,India
679219,2023-06-21,706,sharpener,3,8,5,1,00218,India
679219,2023-06-21,703,eraser,1,3,2,1,00218,India
679219,2023-06-21,704,scale,5,10,5,1,00218,India
679219,2023-06-21,702,pencil,2,5,3,1,00218,India
794873,2023-06-21,713,ball pen,5,10,5,1,00471,India
794873,2023-06-21,715,folder,5,15,10,1,00471,India
154119,2023-06-21,707,marker,20,40,20,1,00102,India
172199,2023-06-21,703,eraser,1,3,2,1,00132,India
466545,2023-06-21,702,pencil,2,5,3,1,00175,India
466545,2023-06-21,712,graph paper,20,40,20,1,00175,India
466545,2023-06-21,710,geometry box,100,150,50,1,00175,India
466545,2023-06-21,706,sharpener,3,8,5,1,00175,India
772382,2023-06-21,710,geometry box,100,150,50,1,00050,India
107057,2023-06-21,712,graph paper,20,40,20,1,00341,India
107057,2023-06-21,708,sketchpen,15,40,25,1,00341,India
107057,2023-06-21,701,gel pen,5,10,5,1,00341,India
107057,2023-06-21,703,eraser,1,3,2,1,00341,India
211448,2023-06-21,710,geometry box,100,150,50,1,00135,India
211448,2023-06-21,717,spiral bound book,50,100,50,1,00135,India
211448,2023-06-21,707,marker,20,40,20,1,00135,India
211448,2023-06-21,706,sharpener,3,8,5,1,00135,India
211448,2023-06-21,704,scale,5,10,5,1,00135,India
315964,2023-06-21,715,folder,5,15,10,1,00429,India
225952,2023-06-21,710,geometry box,100,150,50,1,00176,India
225952,2023-06-21,708,sketchpen,15,40,25,1,00176,India
847869,2023-06-21,705,stencil,10,20,10,1,00376,India
847869,2023-06-21,707,marker,20,40,20,1,00376,India
576068,2023-06-21,715,folder,5,15,10,1,00336,India
924669,2023-06-21,702,pencil,2,5,3,1,00209,India
924669,2023-06-21,710,geometry box,100,150,50,1,00209,India
461447,2023-06-21,705,stencil,10,20,10,1,00255,India
461447,2023-06-21,702,pencil,2,5,3,1,00255,India
461447,2023-06-21,711,TD kit,150,300,150,1,00255,India
461447,2023-06-21,714,carbon paper,15,30,15,1,00255,India
212006,2023-06-21,704,scale,5,10,5,1,00341,India
979927,2023-06-21,703,eraser,1,3,2,1,00291,India
979927,2023-06-21,708,sketchpen,15,40,25,1,00291,India
979927,2023-06-21,710,geometry box,100,150,50,1,00291,India
251879,2023-06-21,704,scale,5,10,5,1,00058,India
251879,2023-06-21,714,carbon paper,15,30,15,1,00058,India
258585,2023-06-21,714,carbon paper,15,30,15,1,00155,India
956695,2023-06-21,711,TD kit,150,300,150,1,00172,India
956695,2023-06-21,714,carbon paper,15,30,15,1,00172,India
956695,2023-06-21,705,stencil,10,20,10,1,00172,India
956695,2023-06-21,709,notebook,30,60,30,1,00172,India
618314,2023-06-21,717,spiral bound book,50,100,50,1,00060,India
618314,2023-06-21,711,TD kit,150,300,150,1,00060,India
618314,2023-06-21,716,printing paper,200,400,200,1,00060,India
618314,2023-06-21,709,notebook,30,60,30,1,00060,India
666103,2023-06-21,712,graph paper,20,40,20,1,00292,India
666103,2023-06-21,708,sketchpen,15,40,25,1,00292,India
666103,2023-06-21,709,notebook,30,60,30,1,00292,India
666103,2023-06-21,704,scale,5,10,5,1,00292,India
973153,2023-06-21,701,gel pen,5,10,5,1,00072,India
973153,2023-06-21,706,sharpener,3,8,5,1,00072,India
973153,2023-06-21,715,folder,5,15,10,1,00072,India
973153,2023-06-21,709,notebook,30,60,30,1,00072,India
767696,2023-06-21,712,graph paper,20,40,20,1,00048,India
158418,2023-06-21,712,graph paper,20,40,20,1,00246,India
158418,2023-06-21,710,geometry box,100,150,50,1,00246,India
858610,2023-06-21,715,folder,5,15,10,1,00188,India
858610,2023-06-21,708,sketchpen,15,40,25,1,00188,India
858610,2023-06-21,702,pencil,2,5,3,1,00188,India
858610,2023-06-21,704,scale,5,10,5,1,00188,India
491885,2023-06-21,712,graph paper,20,40,20,1,00110,India
491885,2023-06-21,701,gel pen,5,10,5,1,00110,India
491885,2023-06-21,710,geometry box,100,150,50,1,00110,India
491885,2023-06-21,705,stencil,10,20,10,1,00110,India
491885,2023-06-21,702,pencil,2,5,3,1,00110,India
279676,2023-06-21,714,carbon paper,15,30,15,1,00030,India
279676,2023-06-21,707,marker,20,40,20,1,00030,India
503685,2023-06-21,701,gel pen,5,10,5,1,00423,India
503685,2023-06-21,710,geometry box,100,150,50,1,00423,India
503685,2023-06-21,712,graph paper,20,40,20,1,00423,India
503685,2023-06-21,714,carbon paper,15,30,15,1,00423,India
503685,2023-06-21,709,notebook,30,60,30,1,00423,India
866624,2023-06-21,708,sketchpen,15,40,25,1,00231,India
866624,2023-06-21,706,sharpener,3,8,5,1,00231,India
866624,2023-06-21,714,carbon paper,15,30,15,1,00231,India
866624,2023-06-21,704,scale,5,10,5,1,00231,India
182329,2023-06-21,717,spiral bound book,50,100,50,1,00310,India
182329,2023-06-21,710,geometry box,100,150,50,1,00310,India
182329,2023-06-21,709,notebook,30,60,30,1,00310,India
608060,2023-06-21,702,pencil,2,5,3,1,00037,India
608060,2023-06-21,709,notebook,30,60,30,1,00037,India
608060,2023-06-21,717,spiral bound book,50,100,50,1,00037,India
608060,2023-06-21,716,printing paper,200,400,200,1,00037,India
691931,2023-06-21,706,sharpener,3,8,5,1,00201,India
691931,2023-06-21,710,geometry box,100,150,50,1,00201,India
206696,2023-06-21,702,pencil,2,5,3,1,00472,India
681206,2023-06-21,708,sketchpen,15,40,25,1,00132,India
681206,2023-06-21,706,sharpener,3,8,5,1,00132,India
681206,2023-06-21,712,graph paper,20,40,20,1,00132,India
143383,2023-06-21,713,ball pen,5,10,5,1,00402,India
565827,2023-06-21,703,eraser,1,3,2,1,00273,India
565827,2023-06-21,711,TD kit,150,300,150,1,00273,India
565827,2023-06-21,716,printing paper,200,400,200,1,00273,India
565827,2023-06-21,717,spiral bound book,50,100,50,1,00273,India
565827,2023-06-21,701,gel pen,5,10,5,1,00273,India
223502,2023-06-22,703,eraser,1,3,2,1,00208,India
223502,2023-06-22,714,carbon paper,15,30,15,1,00208,India
223502,2023-06-22,715,folder,5,15,10,1,00208,India
223502,2023-06-22,709,notebook,30,60,30,1,00208,India
638266,2023-06-22,711,TD kit,150,300,150,1,00099,India
638266,2023-06-22,716,printing paper,200,400,200,1,00099,India
638266,2023-06-22,707,marker,20,40,20,1,00099,India
940069,2023-06-22,705,stencil,10,20,10,1,00200,India
940069,2023-06-22,701,gel pen,5,10,5,1,00200,India
940069,2023-06-22,712,graph paper,20,40,20,1,00200,India
899605,2023-06-22,714,carbon paper,15,30,15,1,00286,India
487657,2023-06-22,716,printing paper,200,400,200,1,00105,India
487657,2023-06-22,707,marker,20,40,20,1,00105,India
487657,2023-06-22,705,stencil,10,20,10,1,00105,India
322248,2023-06-22,703,eraser,1,3,2,1,00379,India
322248,2023-06-22,714,carbon paper,15,30,15,1,00379,India
849848,2023-06-22,714,carbon paper,15,30,15,1,00440,India
849848,2023-06-22,707,marker,20,40,20,1,00440,India
849848,2023-06-22,716,printing paper,200,400,200,1,00440,India
849848,2023-06-22,702,pencil,2,5,3,1,00440,India
327339,2023-06-22,716,printing paper,200,400,200,1,00220,India
327339,2023-06-22,704,scale,5,10,5,1,00220,India
327339,2023-06-22,714,carbon paper,15,30,15,1,00220,India
537274,2023-06-22,701,gel pen,5,10,5,1,00052,India
537274,2023-06-22,713,ball pen,5,10,5,1,00052,India
537274,2023-06-22,709,notebook,30,60,30,1,00052,India
537274,2023-06-22,711,TD kit,150,300,150,1,00052,India
718470,2023-06-22,712,graph paper,20,40,20,1,00420,India
718470,2023-06-22,708,sketchpen,15,40,25,1,00420,India
718470,2023-06-22,705,stencil,10,20,10,1,00420,India
718470,2023-06-22,711,TD kit,150,300,150,1,00420,India
110218,2023-06-22,713,ball pen,5,10,5,1,00492,India
110218,2023-06-22,701,gel pen,5,10,5,1,00492,India
110218,2023-06-22,706,sharpener,3,8,5,1,00492,India
884195,2023-06-22,704,scale,5,10,5,1,00288,India
884195,2023-06-22,711,TD kit,150,300,150,1,00288,India
884195,2023-06-22,713,ball pen,5,10,5,1,00288,India
884195,2023-06-22,716,printing paper,200,400,200,1,00288,India
188654,2023-06-22,705,stencil,10,20,10,1,00385,India
459451,2023-06-22,705,stencil,10,20,10,1,00334,India
459451,2023-06-22,712,graph paper,20,40,20,1,00334,India
459451,2023-06-22,714,carbon paper,15,30,15,1,00334,India
548056,2023-06-22,705,stencil,10,20,10,1,00055,India
548056,2023-06-22,713,ball pen,5,10,5,1,00055,India
548056,2023-06-22,712,graph paper,20,40,20,1,00055,India
562351,2023-06-22,703,eraser,1,3,2,1,00019,India
559733,2023-06-22,713,ball pen,5,10,5,1,00260,India
559733,2023-06-22,717,spiral bound book,50,100,50,1,00260,India
401620,2023-06-22,714,carbon paper,15,30,15,1,00264,India
115013,2023-06-22,717,spiral bound book,50,100,50,1,00408,India
591691,2023-06-22,704,scale,5,10,5,1,00364,India
591691,2023-06-22,705,stencil,10,20,10,1,00364,India
591691,2023-06-22,717,spiral bound book,50,100,50,1,00364,India
591691,2023-06-22,706,sharpener,3,8,5,1,00364,India
516643,2023-06-22,705,stencil,10,20,10,1,00303,India
516643,2023-06-22,713,ball pen,5,10,5,1,00303,India
516643,2023-06-22,709,notebook,30,60,30,1,00303,India
164867,2023-06-22,715,folder,5,15,10,1,00180,India
164867,2023-06-22,708,sketchpen,15,40,25,1,00180,India
164867,2023-06-22,701,gel pen,5,10,5,1,00180,India
164867,2023-06-22,702,pencil,2,5,3,1,00180,India
164867,2023-06-22,716,printing paper,200,400,200,1,00180,India
173473,2023-06-22,707,marker,20,40,20,1,00486,India
173473,2023-06-22,710,geometry box,100,150,50,1,00486,India
173473,2023-06-22,701,gel pen,5,10,5,1,00486,India
173473,2023-06-22,703,eraser,1,3,2,1,00486,India
173473,2023-06-22,709,notebook,30,60,30,1,00486,India
901286,2023-06-22,701,gel pen,5,10,5,1,00251,India
901286,2023-06-22,709,notebook,30,60,30,1,00251,India
163544,2023-06-22,704,scale,5,10,5,1,00484,India
163544,2023-06-22,715,folder,5,15,10,1,00484,India
163544,2023-06-22,706,sharpener,3,8,5,1,00484,India
163544,2023-06-22,713,ball pen,5,10,5,1,00484,India
321767,2023-06-22,701,gel pen,5,10,5,1,00150,India
718138,2023-06-22,717,spiral bound book,50,100,50,1,00033,India
718138,2023-06-22,711,TD kit,150,300,150,1,00033,India
212862,2023-06-22,716,printing paper,200,400,200,1,00447,India
212862,2023-06-22,702,pencil,2,5,3,1,00447,India
481847,2023-06-22,714,carbon paper,15,30,15,1,00433,India
481847,2023-06-22,717,spiral bound book,50,100,50,1,00433,India
481847,2023-06-22,708,sketchpen,15,40,25,1,00433,India
676799,2023-06-22,715,folder,5,15,10,1,00249,India
676799,2023-06-22,703,eraser,1,3,2,1,00249,India
676799,2023-06-22,708,sketchpen,15,40,25,1,00249,India
939549,2023-06-22,710,geometry box,100,150,50,1,00216,India
939549,2023-06-22,701,gel pen,5,10,5,1,00216,India
939549,2023-06-22,713,ball pen,5,10,5,1,00216,India
591687,2023-06-22,702,pencil,2,5,3,1,00368,India
460057,2023-06-22,705,stencil,10,20,10,1,00175,India
460057,2023-06-22,703,eraser,1,3,2,1,00175,India
460057,2023-06-22,704,scale,5,10,5,1,00175,India
492937,2023-06-22,707,marker,20,40,20,1,00078,India
492937,2023-06-22,716,printing paper,200,400,200,1,00078,India
492937,2023-06-22,717,spiral bound book,50,100,50,1,00078,India
457167,2023-06-22,708,sketchpen,15,40,25,1,00466,India
457167,2023-06-22,709,notebook,30,60,30,1,00466,India
457167,2023-06-22,714,carbon paper,15,30,15,1,00466,India
490449,2023-06-22,709,notebook,30,60,30,1,00088,India
490449,2023-06-22,714,carbon paper,15,30,15,1,00088,India
490449,2023-06-22,701,gel pen,5,10,5,1,00088,India
490449,2023-06-22,717,spiral bound book,50,100,50,1,00088,India
674927,2023-06-22,712,graph paper,20,40,20,1,00464,India
674927,2023-06-22,706,sharpener,3,8,5,1,00464,India
674927,2023-06-22,715,folder,5,15,10,1,00464,India
477456,2023-06-23,713,ball pen,5,10,5,1,00448,India
477456,2023-06-23,702,pencil,2,5,3,1,00448,India
477456,2023-06-23,708,sketchpen,15,40,25,1,00448,India
192681,2023-06-23,717,spiral bound book,50,100,50,1,00476,India
192681,2023-06-23,716,printing paper,200,400,200,1,00476,India
192681,2023-06-23,715,folder,5,15,10,1,00476,India
192681,2023-06-23,709,notebook,30,60,30,1,00476,India
624454,2023-06-23,707,marker,20,40,20,1,00349,India
624454,2023-06-23,713,ball pen,5,10,5,1,00349,India
929988,2023-06-23,701,gel pen,5,10,5,1,00428,India
929988,2023-06-23,712,graph paper,20,40,20,1,00428,India
929988,2023-06-23,702,pencil,2,5,3,1,00428,India
325395,2023-06-23,713,ball pen,5,10,5,1,00084,India
404531,2023-06-23,715,folder,5,15,10,1,00170,India
125546,2023-06-23,708,sketchpen,15,40,25,1,00337,India
125546,2023-06-23,715,folder,5,15,10,1,00337,India
125546,2023-06-23,713,ball pen,5,10,5,1,00337,India
125546,2023-06-23,709,notebook,30,60,30,1,00337,India
729969,2023-06-23,706,sharpener,3,8,5,1,00005,India
729969,2023-06-23,714,carbon paper,15,30,15,1,00005,India
729969,2023-06-23,707,marker,20,40,20,1,00005,India
729969,2023-06-23,710,geometry box,100,150,50,1,00005,India
655168,2023-06-23,703,eraser,1,3,2,1,00319,India
655168,2023-06-23,717,spiral bound book,50,100,50,1,00319,India
655168,2023-06-23,711,TD kit,150,300,150,1,00319,India
655168,2023-06-23,712,graph paper,20,40,20,1,00319,India
220132,2023-06-23,716,printing paper,200,400,200,1,00393,India
688875,2023-06-23,707,marker,20,40,20,1,00132,India
688875,2023-06-23,709,notebook,30,60,30,1,00132,India
688875,2023-06-23,715,folder,5,15,10,1,00132,India
664935,2023-06-23,706,sharpener,3,8,5,1,00454,India
664935,2023-06-23,713,ball pen,5,10,5,1,00454,India
664935,2023-06-23,714,carbon paper,15,30,15,1,00454,India
664935,2023-06-23,717,spiral bound book,50,100,50,1,00454,India
664935,2023-06-23,703,eraser,1,3,2,1,00454,India
914720,2023-06-23,707,marker,20,40,20,1,00350,India
914720,2023-06-23,704,scale,5,10,5,1,00350,India
914720,2023-06-23,709,notebook,30,60,30,1,00350,India
914720,2023-06-23,717,spiral bound book,50,100,50,1,00350,India
199266,2023-06-23,716,printing paper,200,400,200,1,00464,India
199266,2023-06-23,701,gel pen,5,10,5,1,00464,India
199266,2023-06-23,704,scale,5,10,5,1,00464,India
199266,2023-06-23,715,folder,5,15,10,1,00464,India
292647,2023-06-23,706,sharpener,3,8,5,1,00439,India
292647,2023-06-23,716,printing paper,200,400,200,1,00439,India
816626,2023-06-23,708,sketchpen,15,40,25,1,00455,India
816626,2023-06-23,710,geometry box,100,150,50,1,00455,India
816626,2023-06-23,705,stencil,10,20,10,1,00455,India
816626,2023-06-23,704,scale,5,10,5,1,00455,India
858628,2023-06-23,706,sharpener,3,8,5,1,00455,India
858628,2023-06-23,701,gel pen,5,10,5,1,00455,India
858628,2023-06-23,716,printing paper,200,400,200,1,00455,India
858628,2023-06-23,703,eraser,1,3,2,1,00455,India
858628,2023-06-23,707,marker,20,40,20,1,00455,India
572709,2023-06-23,711,TD kit,150,300,150,1,00368,India
572709,2023-06-23,703,eraser,1,3,2,1,00368,India
572709,2023-06-23,713,ball pen,5,10,5,1,00368,India
572709,2023-06-23,715,folder,5,15,10,1,00368,India
572709,2023-06-23,716,printing paper,200,400,200,1,00368,India
142944,2023-06-23,717,spiral bound book,50,100,50,1,00482,India
142944,2023-06-23,704,scale,5,10,5,1,00482,India
142944,2023-06-23,715,folder,5,15,10,1,00482,India
535025,2023-06-23,703,eraser,1,3,2,1,00489,India
535025,2023-06-23,705,stencil,10,20,10,1,00489,India
535025,2023-06-23,715,folder,5,15,10,1,00489,India
904961,2023-06-23,710,geometry box,100,150,50,1,00352,India
904961,2023-06-23,707,marker,20,40,20,1,00352,India
962108,2023-06-23,715,folder,5,15,10,1,00063,India
962108,2023-06-23,716,printing paper,200,400,200,1,00063,India
962108,2023-06-23,708,sketchpen,15,40,25,1,00063,India
962108,2023-06-23,710,geometry box,100,150,50,1,00063,India
924624,2023-06-23,707,marker,20,40,20,1,00384,India
924624,2023-06-23,705,stencil,10,20,10,1,00384,India
924624,2023-06-23,714,carbon paper,15,30,15,1,00384,India
854071,2023-06-23,704,scale,5,10,5,1,00474,India
854071,2023-06-23,713,ball pen,5,10,5,1,00474,India
854071,2023-06-23,708,sketchpen,15,40,25,1,00474,India
261401,2023-06-23,713,ball pen,5,10,5,1,00169,India
261401,2023-06-23,710,geometry box,100,150,50,1,00169,India
261401,2023-06-23,716,printing paper,200,400,200,1,00169,India
717030,2023-06-23,703,eraser,1,3,2,1,00085,India
927823,2023-06-23,709,notebook,30,60,30,1,00183,India
927823,2023-06-23,706,sharpener,3,8,5,1,00183,India
927823,2023-06-23,714,carbon paper,15,30,15,1,00183,India
927823,2023-06-23,705,stencil,10,20,10,1,00183,India
572748,2023-06-23,704,scale,5,10,5,1,00272,India
572748,2023-06-23,706,sharpener,3,8,5,1,00272,India
572748,2023-06-23,702,pencil,2,5,3,1,00272,India
832261,2023-06-23,707,marker,20,40,20,1,00480,India
832261,2023-06-23,702,pencil,2,5,3,1,00480,India
832261,2023-06-23,703,eraser,1,3,2,1,00480,India
832261,2023-06-23,714,carbon paper,15,30,15,1,00480,India
351695,2023-06-23,702,pencil,2,5,3,1,00170,India
351695,2023-06-23,706,sharpener,3,8,5,1,00170,India
351695,2023-06-23,717,spiral bound book,50,100,50,1,00170,India
896074,2023-06-23,701,gel pen,5,10,5,1,00424,India
896074,2023-06-23,717,spiral bound book,50,100,50,1,00424,India
896074,2023-06-23,702,pencil,2,5,3,1,00424,India
896074,2023-06-23,711,TD kit,150,300,150,1,00424,India
869960,2023-06-23,707,marker,20,40,20,1,00432,India
869960,2023-06-23,716,printing paper,200,400,200,1,00432,India
869960,2023-06-23,708,sketchpen,15,40,25,1,00432,India
288041,2023-06-23,707,marker,20,40,20,1,00244,India
367643,2023-06-23,717,spiral bound book,50,100,50,1,00328,India
646476,2023-06-23,706,sharpener,3,8,5,1,00472,India
273520,2023-06-23,704,scale,5,10,5,1,00309,India
273520,2023-06-23,716,printing paper,200,400,200,1,00309,India
273520,2023-06-23,714,carbon paper,15,30,15,1,00309,India
719414,2023-06-24,713,ball pen,5,10,5,1,00003,India
719414,2023-06-24,716,printing paper,200,400,200,1,00003,India
719414,2023-06-24,704,scale,5,10,5,1,00003,India
770622,2023-06-24,707,marker,20,40,20,1,00439,India
770622,2023-06-24,716,printing paper,200,400,200,1,00439,India
770622,2023-06-24,703,eraser,1,3,2,1,00439,India
128810,2023-06-24,711,TD kit,150,300,150,1,00252,India
777871,2023-06-24,714,carbon paper,15,30,15,1,00258,India
777871,2023-06-24,716,printing paper,200,400,200,1,00258,India
107546,2023-06-24,713,ball pen,5,10,5,1,00081,India
107546,2023-06-24,707,marker,20,40,20,1,00081,India
550983,2023-06-24,707,marker,20,40,20,1,00444,India
832459,2023-06-24,713,ball pen,5,10,5,1,00268,India
832459,2023-06-24,711,TD kit,150,300,150,1,00268,India
852496,2023-06-24,708,sketchpen,15,40,25,1,00398,India
852496,2023-06-24,710,geometry box,100,150,50,1,00398,India
440796,2023-06-24,716,printing paper,200,400,200,1,00020,India
342179,2023-06-24,712,graph paper,20,40,20,1,00457,India
342179,2023-06-24,714,carbon paper,15,30,15,1,00457,India
342179,2023-06-24,717,spiral bound book,50,100,50,1,00457,India
596786,2023-06-24,709,notebook,30,60,30,1,00430,India
596786,2023-06-24,701,gel pen,5,10,5,1,00430,India
223134,2023-06-24,714,carbon paper,15,30,15,1,00420,India
223134,2023-06-24,703,eraser,1,3,2,1,00420,India
223134,2023-06-24,717,spiral bound book,50,100,50,1,00420,India
959308,2023-06-24,713,ball pen,5,10,5,1,00476,India
959308,2023-06-24,710,geometry box,100,150,50,1,00476,India
959308,2023-06-24,706,sharpener,3,8,5,1,00476,India
959308,2023-06-24,711,TD kit,150,300,150,1,00476,India
138623,2023-06-24,713,ball pen,5,10,5,1,00151,India
138623,2023-06-24,709,notebook,30,60,30,1,00151,India
138623,2023-06-24,707,marker,20,40,20,1,00151,India
584840,2023-06-24,708,sketchpen,15,40,25,1,00487,India
584840,2023-06-24,706,sharpener,3,8,5,1,00487,India
138974,2023-06-24,706,sharpener,3,8,5,1,00172,India
138974,2023-06-24,714,carbon paper,15,30,15,1,00172,India
611303,2023-06-24,716,printing paper,200,400,200,1,00053,India
611303,2023-06-24,701,gel pen,5,10,5,1,00053,India
611303,2023-06-24,711,TD kit,150,300,150,1,00053,India
844713,2023-06-24,704,scale,5,10,5,1,00448,India
844713,2023-06-24,713,ball pen,5,10,5,1,00448,India
304364,2023-06-24,716,printing paper,200,400,200,1,00183,India
304364,2023-06-24,706,sharpener,3,8,5,1,00183,India
948433,2023-06-24,707,marker,20,40,20,1,00249,India
948433,2023-06-24,705,stencil,10,20,10,1,00249,India
948433,2023-06-24,717,spiral bound book,50,100,50,1,00249,India
948433,2023-06-24,708,sketchpen,15,40,25,1,00249,India
948433,2023-06-24,702,pencil,2,5,3,1,00249,India
658722,2023-06-24,717,spiral bound book,50,100,50,1,00160,India
658722,2023-06-24,710,geometry box,100,150,50,1,00160,India
313129,2023-06-24,711,TD kit,150,300,150,1,00390,India
313129,2023-06-24,710,geometry box,100,150,50,1,00390,India
313129,2023-06-24,707,marker,20,40,20,1,00390,India
313129,2023-06-24,715,folder,5,15,10,1,00390,India
313129,2023-06-24,701,gel pen,5,10,5,1,00390,India
427555,2023-06-24,715,folder,5,15,10,1,00015,India
427555,2023-06-24,711,TD kit,150,300,150,1,00015,India
427555,2023-06-24,701,gel pen,5,10,5,1,00015,India
757838,2023-06-24,715,folder,5,15,10,1,00036,India
757838,2023-06-24,703,eraser,1,3,2,1,00036,India
757838,2023-06-24,716,printing paper,200,400,200,1,00036,India
757838,2023-06-24,709,notebook,30,60,30,1,00036,India
557320,2023-06-24,713,ball pen,5,10,5,1,00008,India
557320,2023-06-24,711,TD kit,150,300,150,1,00008,India
335383,2023-06-24,710,geometry box,100,150,50,1,00314,India
777574,2023-06-24,702,pencil,2,5,3,1,00415,India
777574,2023-06-24,712,graph paper,20,40,20,1,00415,India
641928,2023-06-24,708,sketchpen,15,40,25,1,00385,India
641928,2023-06-24,706,sharpener,3,8,5,1,00385,India
569936,2023-06-24,714,carbon paper,15,30,15,1,00370,India
569936,2023-06-24,706,sharpener,3,8,5,1,00370,India
454270,2023-06-24,713,ball pen,5,10,5,1,00037,India
454270,2023-06-24,711,TD kit,150,300,150,1,00037,India
719043,2023-06-24,711,TD kit,150,300,150,1,00178,India
719043,2023-06-24,705,stencil,10,20,10,1,00178,India
719043,2023-06-24,715,folder,5,15,10,1,00178,India
719043,2023-06-24,709,notebook,30,60,30,1,00178,India
357403,2023-06-24,710,geometry box,100,150,50,1,00032,India
357403,2023-06-24,703,eraser,1,3,2,1,00032,India
357403,2023-06-24,712,graph paper,20,40,20,1,00032,India
482393,2023-06-24,709,notebook,30,60,30,1,00362,India
482393,2023-06-24,703,eraser,1,3,2,1,00362,India
482393,2023-06-24,706,sharpener,3,8,5,1,00362,India
308411,2023-06-24,715,folder,5,15,10,1,00314,India
308411,2023-06-24,704,scale,5,10,5,1,00314,India
308411,2023-06-24,706,sharpener,3,8,5,1,00314,India
308411,2023-06-24,713,ball pen,5,10,5,1,00314,India
648637,2023-06-24,707,marker,20,40,20,1,00134,India
648637,2023-06-24,703,eraser,1,3,2,1,00134,India
954252,2023-06-24,704,scale,5,10,5,1,00064,India
954252,2023-06-24,708,sketchpen,15,40,25,1,00064,India
555464,2023-06-24,706,sharpener,3,8,5,1,00044,India
555464,2023-06-24,703,eraser,1,3,2,1,00044,India
555464,2023-06-24,710,geometry box,100,150,50,1,00044,India
555464,2023-06-24,708,sketchpen,15,40,25,1,00044,India
555464,2023-06-24,712,graph paper,20,40,20,1,00044,India
835775,2023-06-24,711,TD kit,150,300,150,1,00315,India
835775,2023-06-24,708,sketchpen,15,40,25,1,00315,India
268746,2023-06-24,717,spiral bound book,50,100,50,1,00286,India
268746,2023-06-24,707,marker,20,40,20,1,00286,India
266123,2023-06-25,717,spiral bound book,50,100,50,1,00181,India
266123,2023-06-25,702,pencil,2,5,3,1,00181,India
266123,2023-06-25,712,graph paper,20,40,20,1,00181,India
266123,2023-06-25,703,eraser,1,3,2,1,00181,India
321644,2023-06-25,709,notebook,30,60,30,1,00392,India
321644,2023-06-25,711,TD kit,150,300,150,1,00392,India
454858,2023-06-25,707,marker,20,40,20,1,00068,India
387657,2023-06-25,714,carbon paper,15,30,15,1,00359,India
387657,2023-06-25,716,printing paper,200,400,200,1,00359,India
385224,2023-06-25,711,TD kit,150,300,150,1,00330,India
385224,2023-06-25,713,ball pen,5,10,5,1,00330,India
385224,2023-06-25,702,pencil,2,5,3,1,00330,India
385224,2023-06-25,701,gel pen,5,10,5,1,00330,India
981204,2023-06-25,716,printing paper,200,400,200,1,00103,India
981204,2023-06-25,705,stencil,10,20,10,1,00103,India
457571,2023-06-25,703,eraser,1,3,2,1,00060,India
301806,2023-06-25,703,eraser,1,3,2,1,00394,India
301806,2023-06-25,717,spiral bound book,50,100,50,1,00394,India
301806,2023-06-25,714,carbon paper,15,30,15,1,00394,India
301806,2023-06-25,713,ball pen,5,10,5,1,00394,India
301806,2023-06-25,711,TD kit,150,300,150,1,00394,India
381318,2023-06-25,703,eraser,1,3,2,1,00436,India
690434,2023-06-25,710,geometry box,100,150,50,1,00115,India
690434,2023-06-25,711,TD kit,150,300,150,1,00115,India
690434,2023-06-25,702,pencil,2,5,3,1,00115,India
690434,2023-06-25,703,eraser,1,3,2,1,00115,India
411069,2023-06-25,716,printing paper,200,400,200,1,00129,India
411069,2023-06-25,705,stencil,10,20,10,1,00129,India
378963,2023-06-25,702,pencil,2,5,3,1,00334,India
378963,2023-06-25,704,scale,5,10,5,1,00334,India
114780,2023-06-25,712,graph paper,20,40,20,1,00123,India
114780,2023-06-25,705,stencil,10,20,10,1,00123,India
114780,2023-06-25,710,geometry box,100,150,50,1,00123,India
114780,2023-06-25,708,sketchpen,15,40,25,1,00123,India
724643,2023-06-25,714,carbon paper,15,30,15,1,00421,India
724643,2023-06-25,703,eraser,1,3,2,1,00421,India
724643,2023-06-25,708,sketchpen,15,40,25,1,00421,India
517183,2023-06-25,710,geometry box,100,150,50,1,00216,India
517183,2023-06-25,711,TD kit,150,300,150,1,00216,India
517183,2023-06-25,704,scale,5,10,5,1,00216,India
517183,2023-06-25,717,spiral bound book,50,100,50,1,00216,India
423947,2023-06-25,711,TD kit,150,300,150,1,00203,India
423947,2023-06-25,717,spiral bound book,50,100,50,1,00203,India
423947,2023-06-25,706,sharpener,3,8,5,1,00203,India
745316,2023-06-25,708,sketchpen,15,40,25,1,00119,India
745316,2023-06-25,704,scale,5,10,5,1,00119,India
745316,2023-06-25,706,sharpener,3,8,5,1,00119,India
745316,2023-06-25,710,geometry box,100,150,50,1,00119,India
931157,2023-06-25,703,eraser,1,3,2,1,00012,India
931157,2023-06-25,701,gel pen,5,10,5,1,00012,India
931157,2023-06-25,708,sketchpen,15,40,25,1,00012,India
980359,2023-06-25,715,folder,5,15,10,1,00440,India
980359,2023-06-25,714,carbon paper,15,30,15,1,00440,India
980359,2023-06-25,716,printing paper,200,400,200,1,00440,India
298761,2023-06-25,707,marker,20,40,20,1,00268,India
298761,2023-06-25,702,pencil,2,5,3,1,00268,India
807056,2023-06-25,701,gel pen,5,10,5,1,00386,India
807056,2023-06-25,711,TD kit,150,300,150,1,00386,India
807056,2023-06-25,709,notebook,30,60,30,1,00386,India
518857,2023-06-25,701,gel pen,5,10,5,1,00338,India
518857,2023-06-25,711,TD kit,150,300,150,1,00338,India
932435,2023-06-25,708,sketchpen,15,40,25,1,00492,India
932435,2023-06-25,711,TD kit,150,300,150,1,00492,India
400403,2023-06-25,713,ball pen,5,10,5,1,00240,India
400403,2023-06-25,709,notebook,30,60,30,1,00240,India
400403,2023-06-25,708,sketchpen,15,40,25,1,00240,India
400403,2023-06-25,716,printing paper,200,400,200,1,00240,India
400403,2023-06-25,702,pencil,2,5,3,1,00240,India
735848,2023-06-25,715,folder,5,15,10,1,00137,India
735848,2023-06-25,710,geometry box,100,150,50,1,00137,India
824381,2023-06-25,704,scale,5,10,5,1,00389,India
431520,2023-06-25,717,spiral bound book,50,100,50,1,00377,India
431520,2023-06-25,712,graph paper,20,40,20,1,00377,India
431520,2023-06-25,704,scale,5,10,5,1,00377,India
387510,2023-06-25,716,printing paper,200,400,200,1,00160,India
387510,2023-06-25,710,geometry box,100,150,50,1,00160,India
344318,2023-06-25,713,ball pen,5,10,5,1,00417,India
344318,2023-06-25,715,folder,5,15,10,1,00417,India
344318,2023-06-25,706,sharpener,3,8,5,1,00417,India
344318,2023-06-25,717,spiral bound book,50,100,50,1,00417,India
415870,2023-06-25,716,printing paper,200,400,200,1,00056,India
415870,2023-06-25,717,spiral bound book,50,100,50,1,00056,India
763614,2023-06-25,717,spiral bound book,50,100,50,1,00121,India
763614,2023-06-25,710,geometry box,100,150,50,1,00121,India
763614,2023-06-25,701,gel pen,5,10,5,1,00121,India
943479,2023-06-25,712,graph paper,20,40,20,1,00466,India
732813,2023-06-25,711,TD kit,150,300,150,1,00311,India
697393,2023-06-25,707,marker,20,40,20,1,00259,India
697393,2023-06-25,711,TD kit,150,300,150,1,00259,India
697393,2023-06-25,703,eraser,1,3,2,1,00259,India
697393,2023-06-25,702,pencil,2,5,3,1,00259,India
697393,2023-06-25,708,sketchpen,15,40,25,1,00259,India
701431,2023-06-25,708,sketchpen,15,40,25,1,00206,India
701431,2023-06-25,711,TD kit,150,300,150,1,00206,India
701431,2023-06-25,702,pencil,2,5,3,1,00206,India
701431,2023-06-25,707,marker,20,40,20,1,00206,India
274724,2023-06-25,706,sharpener,3,8,5,1,00181,India
274724,2023-06-25,705,stencil,10,20,10,1,00181,India
274724,2023-06-25,703,eraser,1,3,2,1,00181,India
274724,2023-06-25,717,spiral bound book,50,100,50,1,00181,India
137052,2023-06-25,707,marker,20,40,20,1,00464,India
137052,2023-06-25,701,gel pen,5,10,5,1,00464,India
137052,2023-06-25,709,notebook,30,60,30,1,00464,India
877154,2023-06-25,704,scale,5,10,5,1,00380,India
350158,2023-06-25,702,pencil,2,5,3,1,00473,India
350158,2023-06-25,708,sketchpen,15,40,25,1,00473,India
350158,2023-06-25,701,gel pen,5,10,5,1,00473,India
990340,2023-06-25,714,carbon paper,15,30,15,1,00309,India
990340,2023-06-25,710,geometry box,100,150,50,1,00309,India
990340,2023-06-25,708,sketchpen,15,40,25,1,00309,India
990340,2023-06-25,701,gel pen,5,10,5,1,00309,India
728035,2023-06-25,713,ball pen,5,10,5,1,00224,India
940814,2023-06-25,703,eraser,1,3,2,1,00051,India
940814,2023-06-25,711,TD kit,150,300,150,1,00051,India
940814,2023-06-25,709,notebook,30,60,30,1,00051,India
602548,2023-06-25,705,stencil,10,20,10,1,00306,India
602548,2023-06-25,709,notebook,30,60,30,1,00306,India
975061,2023-06-25,711,TD kit,150,300,150,1,00414,India
975061,2023-06-25,717,spiral bound book,50,100,50,1,00414,India
975061,2023-06-25,702,pencil,2,5,3,1,00414,India
975061,2023-06-25,701,gel pen,5,10,5,1,00414,India
975061,2023-06-25,707,marker,20,40,20,1,00414,India
204426,2023-06-25,711,TD kit,150,300,150,1,00187,India
204426,2023-06-25,701,gel pen,5,10,5,1,00187,India
575441,2023-06-25,711,TD kit,150,300,150,1,00448,India
575441,2023-06-25,704,scale,5,10,5,1,00448,India
939455,2023-06-25,713,ball pen,5,10,5,1,00246,India
939455,2023-06-25,711,TD kit,150,300,150,1,00246,India
939455,2023-06-25,707,marker,20,40,20,1,00246,India
939455,2023-06-25,705,stencil,10,20,10,1,00246,India
860147,2023-06-25,711,TD kit,150,300,150,1,00293,India
860147,2023-06-25,704,scale,5,10,5,1,00293,India
860147,2023-06-25,707,marker,20,40,20,1,00293,India
860147,2023-06-25,706,sharpener,3,8,5,1,00293,India
817480,2023-06-25,713,ball pen,5,10,5,1,00122,India
817480,2023-06-25,714,carbon paper,15,30,15,1,00122,India
817480,2023-06-25,712,graph paper,20,40,20,1,00122,India
817480,2023-06-25,717,spiral bound book,50,100,50,1,00122,India
817480,2023-06-25,716,printing paper,200,400,200,1,00122,India
186970,2023-06-26,717,spiral bound book,50,100,50,1,00131,India
265177,2023-06-26,704,scale,5,10,5,1,00444,India
836418,2023-06-26,702,pencil,2,5,3,1,00160,India
836418,2023-06-26,713,ball pen,5,10,5,1,00160,India
770823,2023-06-26,703,eraser,1,3,2,1,00312,India
770823,2023-06-26,707,marker,20,40,20,1,00312,India
829465,2023-06-26,715,folder,5,15,10,1,00235,India
600962,2023-06-26,707,marker,20,40,20,1,00032,India
600962,2023-06-26,712,graph paper,20,40,20,1,00032,India
600962,2023-06-26,708,sketchpen,15,40,25,1,00032,India
600962,2023-06-26,711,TD kit,150,300,150,1,00032,India
101105,2023-06-26,708,sketchpen,15,40,25,1,00315,India
101105,2023-06-26,701,gel pen,5,10,5,1,00315,India
101105,2023-06-26,705,stencil,10,20,10,1,00315,India
129736,2023-06-26,704,scale,5,10,5,1,00109,India
129736,2023-06-26,716,printing paper,200,400,200,1,00109,India
129736,2023-06-26,710,geometry box,100,150,50,1,00109,India
129736,2023-06-26,707,marker,20,40,20,1,00109,India
613897,2023-06-26,703,eraser,1,3,2,1,00024,India
613897,2023-06-26,710,geometry box,100,150,50,1,00024,India
613897,2023-06-26,705,stencil,10,20,10,1,00024,India
613897,2023-06-26,713,ball pen,5,10,5,1,00024,India
660321,2023-06-26,704,scale,5,10,5,1,00005,India
660321,2023-06-26,710,geometry box,100,150,50,1,00005,India
660321,2023-06-26,713,ball pen,5,10,5,1,00005,India
660321,2023-06-26,703,eraser,1,3,2,1,00005,India
480940,2023-06-26,710,geometry box,100,150,50,1,00139,India
480940,2023-06-26,703,eraser,1,3,2,1,00139,India
480940,2023-06-26,717,spiral bound book,50,100,50,1,00139,India
480940,2023-06-26,711,TD kit,150,300,150,1,00139,India
480940,2023-06-26,715,folder,5,15,10,1,00139,India
223483,2023-06-26,707,marker,20,40,20,1,00259,India
223483,2023-06-26,701,gel pen,5,10,5,1,00259,India
223483,2023-06-26,711,TD kit,150,300,150,1,00259,India
749700,2023-06-26,710,geometry box,100,150,50,1,00113,India
749700,2023-06-26,712,graph paper,20,40,20,1,00113,India
955876,2023-06-26,707,marker,20,40,20,1,00246,India
491082,2023-06-26,707,marker,20,40,20,1,00263,India
491082,2023-06-26,708,sketchpen,15,40,25,1,00263,India
323216,2023-06-26,714,carbon paper,15,30,15,1,00373,India
221850,2023-06-26,706,sharpener,3,8,5,1,00194,India
221850,2023-06-26,710,geometry box,100,150,50,1,00194,India
221850,2023-06-26,711,TD kit,150,300,150,1,00194,India
221850,2023-06-26,712,graph paper,20,40,20,1,00194,India
221850,2023-06-26,713,ball pen,5,10,5,1,00194,India
753922,2023-06-26,712,graph paper,20,40,20,1,00446,India
100065,2023-06-26,712,graph paper,20,40,20,1,00259,India
100065,2023-06-26,716,printing paper,200,400,200,1,00259,India
100065,2023-06-26,702,pencil,2,5,3,1,00259,India
100065,2023-06-26,701,gel pen,5,10,5,1,00259,India
441238,2023-06-26,707,marker,20,40,20,1,00189,India
441238,2023-06-26,703,eraser,1,3,2,1,00189,India
441238,2023-06-26,716,printing paper,200,400,200,1,00189,India
441238,2023-06-26,705,stencil,10,20,10,1,00189,India
441238,2023-06-26,712,graph paper,20,40,20,1,00189,India
414525,2023-06-26,716,printing paper,200,400,200,1,00054,India
414525,2023-06-26,717,spiral bound book,50,100,50,1,00054,India
414525,2023-06-26,703,eraser,1,3,2,1,00054,India
193893,2023-06-26,715,folder,5,15,10,1,00246,India
193893,2023-06-26,712,graph paper,20,40,20,1,00246,India
304669,2023-06-26,709,notebook,30,60,30,1,00257,India
304669,2023-06-26,716,printing paper,200,400,200,1,00257,India
304669,2023-06-26,706,sharpener,3,8,5,1,00257,India
304669,2023-06-26,701,gel pen,5,10,5,1,00257,India
304669,2023-06-26,711,TD kit,150,300,150,1,00257,India
140199,2023-06-26,715,folder,5,15,10,1,00121,India
140199,2023-06-26,713,ball pen,5,10,5,1,00121,India
140199,2023-06-26,706,sharpener,3,8,5,1,00121,India
648502,2023-06-26,708,sketchpen,15,40,25,1,00396,India
648502,2023-06-26,709,notebook,30,60,30,1,00396,India
648502,2023-06-26,702,pencil,2,5,3,1,00396,India
648502,2023-06-26,716,printing paper,200,400,200,1,00396,India
923500,2023-06-26,703,eraser,1,3,2,1,00168,India
923500,2023-06-26,713,ball pen,5,10,5,1,00168,India
923500,2023-06-26,710,geometry box,100,150,50,1,00168,India
261833,2023-06-26,716,printing paper,200,400,200,1,00035,India
852862,2023-06-26,715,folder,5,15,10,1,00084,India
852862,2023-06-26,717,spiral bound book,50,100,50,1,00084,India
187226,2023-06-26,705,stencil,10,20,10,1,00456,India
187226,2023-06-26,703,eraser,1,3,2,1,00456,India
665046,2023-06-26,715,folder,5,15,10,1,00139,India
276630,2023-06-26,711,TD kit,150,300,150,1,00454,India
276630,2023-06-26,705,stencil,10,20,10,1,00454,India
276630,2023-06-26,710,geometry box,100,150,50,1,00454,India
276630,2023-06-26,701,gel pen,5,10,5,1,00454,India
402776,2023-06-26,701,gel pen,5,10,5,1,00042,India
402776,2023-06-26,710,geometry box,100,150,50,1,00042,India
402776,2023-06-26,705,stencil,10,20,10,1,00042,India
402776,2023-06-26,709,notebook,30,60,30,1,00042,India
374852,2023-06-26,704,scale,5,10,5,1,00279,India
374852,2023-06-26,713,ball pen,5,10,5,1,00279,India
374852,2023-06-26,705,stencil,10,20,10,1,00279,India
374852,2023-06-26,716,printing paper,200,400,200,1,00279,India
805081,2023-06-26,701,gel pen,5,10,5,1,00407,India
805081,2023-06-26,713,ball pen,5,10,5,1,00407,India
805081,2023-06-26,709,notebook,30,60,30,1,00407,India
941056,2023-06-26,704,scale,5,10,5,1,00294,India
952843,2023-06-26,708,sketchpen,15,40,25,1,00471,India
952843,2023-06-26,715,folder,5,15,10,1,00471,India
952843,2023-06-26,707,marker,20,40,20,1,00471,India
952843,2023-06-26,709,notebook,30,60,30,1,00471,India
539834,2023-06-27,707,marker,20,40,20,1,00215,India
539834,2023-06-27,705,stencil,10,20,10,1,00215,India
539834,2023-06-27,715,folder,5,15,10,1,00215,India
539834,2023-06-27,709,notebook,30,60,30,1,00215,India
539834,2023-06-27,706,sharpener,3,8,5,1,00215,India
889226,2023-06-27,708,sketchpen,15,40,25,1,00124,India
280591,2023-06-27,709,notebook,30,60,30,1,00430,India
280591,2023-06-27,713,ball pen,5,10,5,1,00430,India
423393,2023-06-27,707,marker,20,40,20,1,00055,India
423393,2023-06-27,704,scale,5,10,5,1,00055,India
423393,2023-06-27,702,pencil,2,5,3,1,00055,India
619559,2023-06-27,715,folder,5,15,10,1,00260,India
619559,2023-06-27,713,ball pen,5,10,5,1,00260,India
800829,2023-06-27,713,ball pen,5,10,5,1,00353,India
800829,2023-06-27,709,notebook,30,60,30,1,00353,India
618481,2023-06-27,713,ball pen,5,10,5,1,00389,India
618481,2023-06-27,704,scale,5,10,5,1,00389,India
618481,2023-06-27,712,graph paper,20,40,20,1,00389,India
618481,2023-06-27,715,folder,5,15,10,1,00389,India
618481,2023-06-27,707,marker,20,40,20,1,00389,India
282584,2023-06-27,714,carbon paper,15,30,15,1,00015,India
282584,2023-06-27,701,gel pen,5,10,5,1,00015,India
282584,2023-06-27,704,scale,5,10,5,1,00015,India
282584,2023-06-27,713,ball pen,5,10,5,1,00015,India
732354,2023-06-27,715,folder,5,15,10,1,00299,India
732354,2023-06-27,713,ball pen,5,10,5,1,00299,India
732354,2023-06-27,711,TD kit,150,300,150,1,00299,India
255532,2023-06-27,701,gel pen,5,10,5,1,00152,India
255532,2023-06-27,707,marker,20,40,20,1,00152,India
255532,2023-06-27,713,ball pen,5,10,5,1,00152,India
436710,2023-06-27,705,stencil,10,20,10,1,00480,India
188698,2023-06-27,708,sketchpen,15,40,25,1,00116,India
188698,2023-06-27,714,carbon paper,15,30,15,1,00116,India
102273,2023-06-27,702,pencil,2,5,3,1,00078,India
102273,2023-06-27,709,notebook,30,60,30,1,00078,India
102273,2023-06-27,716,printing paper,200,400,200,1,00078,India
975673,2023-06-27,715,folder,5,15,10,1,00036,India
975673,2023-06-27,708,sketchpen,15,40,25,1,00036,India
250977,2023-06-27,706,sharpener,3,8,5,1,00425,India
250977,2023-06-27,708,sketchpen,15,40,25,1,00425,India
250977,2023-06-27,704,scale,5,10,5,1,00425,India
668541,2023-06-27,716,printing paper,200,400,200,1,00393,India
668541,2023-06-27,711,TD kit,150,300,150,1,00393,India
668541,2023-06-27,704,scale,5,10,5,1,00393,India
668541,2023-06-27,709,notebook,30,60,30,1,00393,India
668541,2023-06-27,713,ball pen,5,10,5,1,00393,India
490896,2023-06-27,706,sharpener,3,8,5,1,00177,India
502311,2023-06-27,705,stencil,10,20,10,1,00282,India
502311,2023-06-27,701,gel pen,5,10,5,1,00282,India
898055,2023-06-27,707,marker,20,40,20,1,00155,India
898055,2023-06-27,704,scale,5,10,5,1,00155,India
898055,2023-06-27,710,geometry box,100,150,50,1,00155,India
898055,2023-06-27,709,notebook,30,60,30,1,00155,India
898055,2023-06-27,715,folder,5,15,10,1,00155,India
686685,2023-06-27,704,scale,5,10,5,1,00016,India
686685,2023-06-27,710,geometry box,100,150,50,1,00016,India
701787,2023-06-27,704,scale,5,10,5,1,00343,India
552009,2023-06-27,704,scale,5,10,5,1,00315,India
552009,2023-06-27,703,eraser,1,3,2,1,00315,India
552009,2023-06-27,717,spiral bound book,50,100,50,1,00315,India
514261,2023-06-27,705,stencil,10,20,10,1,00371,India
514261,2023-06-27,717,spiral bound book,50,100,50,1,00371,India
514261,2023-06-27,706,sharpener,3,8,5,1,00371,India
514261,2023-06-27,714,carbon paper,15,30,15,1,00371,India
514261,2023-06-27,701,gel pen,5,10,5,1,00371,India
704615,2023-06-27,705,stencil,10,20,10,1,00018,India
704615,2023-06-27,702,pencil,2,5,3,1,00018,India
704615,2023-06-27,713,ball pen,5,10,5,1,00018,India
704615,2023-06-27,716,printing paper,200,400,200,1,00018,India
926449,2023-06-27,710,geometry box,100,150,50,1,00062,India
926449,2023-06-27,717,spiral bound book,50,100,50,1,00062,India
926449,2023-06-27,706,sharpener,3,8,5,1,00062,India
545647,2023-06-27,705,stencil,10,20,10,1,00222,India
545647,2023-06-27,715,folder,5,15,10,1,00222,India
545647,2023-06-27,717,spiral bound book,50,100,50,1,00222,India
917699,2023-06-27,713,ball pen,5,10,5,1,00095,India
917699,2023-06-27,707,marker,20,40,20,1,00095,India
917699,2023-06-27,702,pencil,2,5,3,1,00095,India
917699,2023-06-27,709,notebook,30,60,30,1,00095,India
917699,2023-06-27,705,stencil,10,20,10,1,00095,India
158028,2023-06-27,712,graph paper,20,40,20,1,00323,India
158028,2023-06-27,710,geometry box,100,150,50,1,00323,India
158028,2023-06-27,716,printing paper,200,400,200,1,00323,India
737866,2023-06-27,702,pencil,2,5,3,1,00482,India
775859,2023-06-27,708,sketchpen,15,40,25,1,00408,India
775859,2023-06-27,710,geometry box,100,150,50,1,00408,India
775859,2023-06-27,704,scale,5,10,5,1,00408,India
775859,2023-06-27,706,sharpener,3,8,5,1,00408,India
995431,2023-06-27,713,ball pen,5,10,5,1,00015,India
995431,2023-06-27,703,eraser,1,3,2,1,00015,India
510242,2023-06-27,715,folder,5,15,10,1,00262,India
510242,2023-06-27,703,eraser,1,3,2,1,00262,India
295149,2023-06-27,717,spiral bound book,50,100,50,1,00498,India
636204,2023-06-27,714,carbon paper,15,30,15,1,00412,India
636204,2023-06-27,709,notebook,30,60,30,1,00412,India
636204,2023-06-27,711,TD kit,150,300,150,1,00412,India
913485,2023-06-27,715,folder,5,15,10,1,00426,India
913485,2023-06-27,714,carbon paper,15,30,15,1,00426,India
913485,2023-06-27,711,TD kit,150,300,150,1,00426,India
274525,2023-06-27,715,folder,5,15,10,1,00127,India
274525,2023-06-27,713,ball pen,5,10,5,1,00127,India
274525,2023-06-27,709,notebook,30,60,30,1,00127,India
143644,2023-06-27,715,folder,5,15,10,1,00088,India
143644,2023-06-27,701,gel pen,5,10,5,1,00088,India
143644,2023-06-27,702,pencil,2,5,3,1,00088,India
143644,2023-06-27,711,TD kit,150,300,150,1,00088,India
718308,2023-06-27,710,geometry box,100,150,50,1,00143,India
718308,2023-06-27,708,sketchpen,15,40,25,1,00143,India
718308,2023-06-27,713,ball pen,5,10,5,1,00143,India
718308,2023-06-27,705,stencil,10,20,10,1,00143,India
777314,2023-06-27,714,carbon paper,15,30,15,1,00122,India
762409,2023-06-27,715,folder,5,15,10,1,00296,India
762409,2023-06-27,712,graph paper,20,40,20,1,00296,India
762409,2023-06-27,702,pencil,2,5,3,1,00296,India
528698,2023-06-27,704,scale,5,10,5,1,00141,India
528698,2023-06-27,707,marker,20,40,20,1,00141,India
528698,2023-06-27,714,carbon paper,15,30,15,1,00141,India
528698,2023-06-27,716,printing paper,200,400,200,1,00141,India
279330,2023-06-27,713,ball pen,5,10,5,1,00494,India
279330,2023-06-27,711,TD kit,150,300,150,1,00494,India
567939,2023-06-27,706,sharpener,3,8,5,1,00079,India
677424,2023-06-27,713,ball pen,5,10,5,1,00160,India
677424,2023-06-27,704,scale,5,10,5,1,00160,India
677424,2023-06-27,701,gel pen,5,10,5,1,00160,India
677424,2023-06-27,709,notebook,30,60,30,1,00160,India
477486,2023-06-27,713,ball pen,5,10,5,1,00198,India
477486,2023-06-27,702,pencil,2,5,3,1,00198,India
550839,2023-06-28,704,scale,5,10,5,1,00406,India
550839,2023-06-28,709,notebook,30,60,30,1,00406,India
550839,2023-06-28,711,TD kit,150,300,150,1,00406,India
348263,2023-06-28,701,gel pen,5,10,5,1,00407,India
348263,2023-06-28,704,scale,5,10,5,1,00407,India
348263,2023-06-28,715,folder,5,15,10,1,00407,India
541522,2023-06-28,701,gel pen,5,10,5,1,00250,India
541522,2023-06-28,714,carbon paper,15,30,15,1,00250,India
541522,2023-06-28,706,sharpener,3,8,5,1,00250,India
541522,2023-06-28,708,sketchpen,15,40,25,1,00250,India
541522,2023-06-28,711,TD kit,150,300,150,1,00250,India
122064,2023-06-28,713,ball pen,5,10,5,1,00074,India
122064,2023-06-28,701,gel pen,5,10,5,1,00074,India
122064,2023-06-28,717,spiral bound book,50,100,50,1,00074,India
116942,2023-06-28,706,sharpener,3,8,5,1,00102,India
116942,2023-06-28,717,spiral bound book,50,100,50,1,00102,India
684290,2023-06-28,708,sketchpen,15,40,25,1,00421,India
207002,2023-06-28,702,pencil,2,5,3,1,00354,India
769677,2023-06-28,708,sketchpen,15,40,25,1,00105,India
769677,2023-06-28,710,geometry box,100,150,50,1,00105,India
769677,2023-06-28,701,gel pen,5,10,5,1,00105,India
769677,2023-06-28,716,printing paper,200,400,200,1,00105,India
769677,2023-06-28,714,carbon paper,15,30,15,1,00105,India
789722,2023-06-28,705,stencil,10,20,10,1,00132,India
789722,2023-06-28,716,printing paper,200,400,200,1,00132,India
879527,2023-06-28,715,folder,5,15,10,1,00490,India
879527,2023-06-28,711,TD kit,150,300,150,1,00490,India
879527,2023-06-28,704,scale,5,10,5,1,00490,India
109768,2023-06-28,714,carbon paper,15,30,15,1,00202,India
109768,2023-06-28,717,spiral bound book,50,100,50,1,00202,India
109768,2023-06-28,704,scale,5,10,5,1,00202,India
109768,2023-06-28,715,folder,5,15,10,1,00202,India
879333,2023-06-28,706,sharpener,3,8,5,1,00006,India
879333,2023-06-28,702,pencil,2,5,3,1,00006,India
879333,2023-06-28,710,geometry box,100,150,50,1,00006,India
940651,2023-06-28,708,sketchpen,15,40,25,1,00483,India
246794,2023-06-28,707,marker,20,40,20,1,00027,India
246794,2023-06-28,714,carbon paper,15,30,15,1,00027,India
246794,2023-06-28,702,pencil,2,5,3,1,00027,India
854953,2023-06-28,704,scale,5,10,5,1,00423,India
854953,2023-06-28,710,geometry box,100,150,50,1,00423,India
854953,2023-06-28,714,carbon paper,15,30,15,1,00423,India
854953,2023-06-28,712,graph paper,20,40,20,1,00423,India
854953,2023-06-28,706,sharpener,3,8,5,1,00423,India
699840,2023-06-28,704,scale,5,10,5,1,00338,India
699840,2023-06-28,716,printing paper,200,400,200,1,00338,India
699840,2023-06-28,710,geometry box,100,150,50,1,00338,India
699840,2023-06-28,708,sketchpen,15,40,25,1,00338,India
989343,2023-06-28,702,pencil,2,5,3,1,00194,India
807112,2023-06-28,716,printing paper,200,400,200,1,00416,India
591505,2023-06-28,705,stencil,10,20,10,1,00265,India
491980,2023-06-28,706,sharpener,3,8,5,1,00267,India
166830,2023-06-28,715,folder,5,15,10,1,00067,India
166830,2023-06-28,713,ball pen,5,10,5,1,00067,India
166830,2023-06-28,704,scale,5,10,5,1,00067,India
315152,2023-06-28,706,sharpener,3,8,5,1,00267,India
315152,2023-06-28,712,graph paper,20,40,20,1,00267,India
315152,2023-06-28,717,spiral bound book,50,100,50,1,00267,India
315152,2023-06-28,713,ball pen,5,10,5,1,00267,India
919964,2023-06-28,702,pencil,2,5,3,1,00423,India
919964,2023-06-28,703,eraser,1,3,2,1,00423,India
919964,2023-06-28,710,geometry box,100,150,50,1,00423,India
474502,2023-06-28,716,printing paper,200,400,200,1,00133,India
969751,2023-06-28,701,gel pen,5,10,5,1,00170,India
969751,2023-06-28,706,sharpener,3,8,5,1,00170,India
969751,2023-06-28,717,spiral bound book,50,100,50,1,00170,India
917199,2023-06-28,709,notebook,30,60,30,1,00105,India
917199,2023-06-28,717,spiral bound book,50,100,50,1,00105,India
917199,2023-06-28,711,TD kit,150,300,150,1,00105,India
917199,2023-06-28,715,folder,5,15,10,1,00105,India
744751,2023-06-28,706,sharpener,3,8,5,1,00326,India
744751,2023-06-28,708,sketchpen,15,40,25,1,00326,India
744751,2023-06-28,705,stencil,10,20,10,1,00326,India
476997,2023-06-28,706,sharpener,3,8,5,1,00088,India
476997,2023-06-28,709,notebook,30,60,30,1,00088,India
476997,2023-06-28,708,sketchpen,15,40,25,1,00088,India
476997,2023-06-28,710,geometry box,100,150,50,1,00088,India
476997,2023-06-28,705,stencil,10,20,10,1,00088,India
701272,2023-06-28,706,sharpener,3,8,5,1,00030,India
249636,2023-06-28,711,TD kit,150,300,150,1,00189,India
249636,2023-06-28,703,eraser,1,3,2,1,00189,India
249636,2023-06-28,712,graph paper,20,40,20,1,00189,India
249636,2023-06-28,708,sketchpen,15,40,25,1,00189,India
249636,2023-06-28,705,stencil,10,20,10,1,00189,India
585076,2023-06-28,708,sketchpen,15,40,25,1,00053,India
585076,2023-06-28,702,pencil,2,5,3,1,00053,India
585076,2023-06-28,706,sharpener,3,8,5,1,00053,India
585076,2023-06-28,716,printing paper,200,400,200,1,00053,India
306809,2023-06-28,708,sketchpen,15,40,25,1,00286,India
306809,2023-06-28,716,printing paper,200,400,200,1,00286,India
306809,2023-06-28,709,notebook,30,60,30,1,00286,India
306809,2023-06-28,707,marker,20,40,20,1,00286,India
902255,2023-06-28,703,eraser,1,3,2,1,00468,India
902255,2023-06-28,708,sketchpen,15,40,25,1,00468,India
902255,2023-06-28,715,folder,5,15,10,1,00468,India
550620,2023-06-28,704,scale,5,10,5,1,00169,India
550620,2023-06-28,701,gel pen,5,10,5,1,00169,India
550620,2023-06-28,702,pencil,2,5,3,1,00169,India
550620,2023-06-28,707,marker,20,40,20,1,00169,India
200355,2023-06-28,712,graph paper,20,40,20,1,00290,India
894136,2023-06-28,706,sharpener,3,8,5,1,00174,India
879629,2023-06-28,711,TD kit,150,300,150,1,00136,India
879629,2023-06-28,707,marker,20,40,20,1,00136,India
879629,2023-06-28,716,printing paper,200,400,200,1,00136,India
879629,2023-06-28,712,graph paper,20,40,20,1,00136,India
998922,2023-06-28,715,folder,5,15,10,1,00383,India
998922,2023-06-28,703,eraser,1,3,2,1,00383,India
128656,2023-06-28,705,stencil,10,20,10,1,00336,India
128656,2023-06-28,712,graph paper,20,40,20,1,00336,India
128656,2023-06-28,707,marker,20,40,20,1,00336,India
128656,2023-06-28,702,pencil,2,5,3,1,00336,India
884842,2023-06-28,710,geometry box,100,150,50,1,00124,India
884842,2023-06-28,715,folder,5,15,10,1,00124,India
884842,2023-06-28,716,printing paper,200,400,200,1,00124,India
884842,2023-06-28,701,gel pen,5,10,5,1,00124,India
884842,2023-06-28,702,pencil,2,5,3,1,00124,India
620444,2023-06-28,708,sketchpen,15,40,25,1,00198,India
620444,2023-06-28,717,spiral bound book,50,100,50,1,00198,India
620444,2023-06-28,701,gel pen,5,10,5,1,00198,India
483300,2023-06-28,717,spiral bound book,50,100,50,1,00225,India
483300,2023-06-28,712,graph paper,20,40,20,1,00225,India
483300,2023-06-28,713,ball pen,5,10,5,1,00225,India
483300,2023-06-28,706,sharpener,3,8,5,1,00225,India
568440,2023-06-28,703,eraser,1,3,2,1,00063,India
568440,2023-06-28,702,pencil,2,5,3,1,00063,India
568440,2023-06-28,707,marker,20,40,20,1,00063,India
568440,2023-06-28,714,carbon paper,15,30,15,1,00063,India
124648,2023-06-28,702,pencil,2,5,3,1,00441,India
124648,2023-06-28,716,printing paper,200,400,200,1,00441,India
124648,2023-06-28,714,carbon paper,15,30,15,1,00441,India
124648,2023-06-28,715,folder,5,15,10,1,00441,India
529056,2023-06-29,716,printing paper,200,400,200,1,00353,India
529056,2023-06-29,709,notebook,30,60,30,1,00353,India
529056,2023-06-29,710,geometry box,100,150,50,1,00353,India
529056,2023-06-29,707,marker,20,40,20,1,00353,India
529056,2023-06-29,712,graph paper,20,40,20,1,00353,India
798577,2023-06-29,704,scale,5,10,5,1,00377,India
119862,2023-06-29,714,carbon paper,15,30,15,1,00326,India
119862,2023-06-29,710,geometry box,100,150,50,1,00326,India
119862,2023-06-29,704,scale,5,10,5,1,00326,India
119862,2023-06-29,707,marker,20,40,20,1,00326,India
947315,2023-06-29,714,carbon paper,15,30,15,1,00074,India
947315,2023-06-29,709,notebook,30,60,30,1,00074,India
947315,2023-06-29,705,stencil,10,20,10,1,00074,India
975453,2023-06-29,704,scale,5,10,5,1,00386,India
975453,2023-06-29,713,ball pen,5,10,5,1,00386,India
170079,2023-06-29,709,notebook,30,60,30,1,00441,India
701187,2023-06-29,710,geometry box,100,150,50,1,00286,India
701187,2023-06-29,705,stencil,10,20,10,1,00286,India
701187,2023-06-29,707,marker,20,40,20,1,00286,India
701187,2023-06-29,713,ball pen,5,10,5,1,00286,India
175407,2023-06-29,715,folder,5,15,10,1,00435,India
175407,2023-06-29,714,carbon paper,15,30,15,1,00435,India
175407,2023-06-29,711,TD kit,150,300,150,1,00435,India
371801,2023-06-29,707,marker,20,40,20,1,00434,India
371801,2023-06-29,716,printing paper,200,400,200,1,00434,India
371801,2023-06-29,715,folder,5,15,10,1,00434,India
371801,2023-06-29,708,sketchpen,15,40,25,1,00434,India
644866,2023-06-29,714,carbon paper,15,30,15,1,00196,India
934730,2023-06-29,701,gel pen,5,10,5,1,00192,India
934730,2023-06-29,717,spiral bound book,50,100,50,1,00192,India
282103,2023-06-29,710,geometry box,100,150,50,1,00497,India
282103,2023-06-29,705,stencil,10,20,10,1,00497,India
227204,2023-06-29,711,TD kit,150,300,150,1,00344,India
227204,2023-06-29,701,gel pen,5,10,5,1,00344,India
227204,2023-06-29,709,notebook,30,60,30,1,00344,India
678136,2023-06-29,710,geometry box,100,150,50,1,00099,India
678136,2023-06-29,712,graph paper,20,40,20,1,00099,India
678136,2023-06-29,714,carbon paper,15,30,15,1,00099,India
442470,2023-06-29,701,gel pen,5,10,5,1,00157,India
532292,2023-06-29,705,stencil,10,20,10,1,00100,India
532292,2023-06-29,702,pencil,2,5,3,1,00100,India
427579,2023-06-29,716,printing paper,200,400,200,1,00284,India
206994,2023-06-29,703,eraser,1,3,2,1,00023,India
160550,2023-06-29,712,graph paper,20,40,20,1,00497,India
160550,2023-06-29,708,sketchpen,15,40,25,1,00497,India
160550,2023-06-29,703,eraser,1,3,2,1,00497,India
160550,2023-06-29,713,ball pen,5,10,5,1,00497,India
160550,2023-06-29,714,carbon paper,15,30,15,1,00497,India
512995,2023-06-29,704,scale,5,10,5,1,00043,India
251355,2023-06-29,715,folder,5,15,10,1,00125,India
683824,2023-06-29,715,folder,5,15,10,1,00080,India
683824,2023-06-29,702,pencil,2,5,3,1,00080,India
683824,2023-06-29,710,geometry box,100,150,50,1,00080,India
683824,2023-06-29,714,carbon paper,15,30,15,1,00080,India
683824,2023-06-29,707,marker,20,40,20,1,00080,India
191381,2023-06-29,705,stencil,10,20,10,1,00197,India
191381,2023-06-29,706,sharpener,3,8,5,1,00197,India
191381,2023-06-29,701,gel pen,5,10,5,1,00197,India
191381,2023-06-29,704,scale,5,10,5,1,00197,India
191381,2023-06-29,714,carbon paper,15,30,15,1,00197,India
690409,2023-06-29,717,spiral bound book,50,100,50,1,00400,India
690409,2023-06-29,707,marker,20,40,20,1,00400,India
690409,2023-06-29,703,eraser,1,3,2,1,00400,India
690409,2023-06-29,715,folder,5,15,10,1,00400,India
514434,2023-06-29,704,scale,5,10,5,1,00357,India
514434,2023-06-29,708,sketchpen,15,40,25,1,00357,India
514434,2023-06-29,712,graph paper,20,40,20,1,00357,India
514434,2023-06-29,706,sharpener,3,8,5,1,00357,India
433127,2023-06-29,715,folder,5,15,10,1,00333,India
529136,2023-06-29,707,marker,20,40,20,1,00345,India
141467,2023-06-29,708,sketchpen,15,40,25,1,00036,India
141467,2023-06-29,703,eraser,1,3,2,1,00036,India
141467,2023-06-29,705,stencil,10,20,10,1,00036,India
141467,2023-06-29,715,folder,5,15,10,1,00036,India
293105,2023-06-29,716,printing paper,200,400,200,1,00101,India
293105,2023-06-29,711,TD kit,150,300,150,1,00101,India
293105,2023-06-29,703,eraser,1,3,2,1,00101,India
293105,2023-06-29,701,gel pen,5,10,5,1,00101,India
130687,2023-06-29,707,marker,20,40,20,1,00085,India
130687,2023-06-29,701,gel pen,5,10,5,1,00085,India
130687,2023-06-29,715,folder,5,15,10,1,00085,India
130687,2023-06-29,717,spiral bound book,50,100,50,1,00085,India
130687,2023-06-29,709,notebook,30,60,30,1,00085,India
760911,2023-06-29,703,eraser,1,3,2,1,00088,India
760911,2023-06-29,710,geometry box,100,150,50,1,00088,India
150868,2023-06-29,715,folder,5,15,10,1,00478,India
150868,2023-06-29,711,TD kit,150,300,150,1,00478,India
150868,2023-06-29,706,sharpener,3,8,5,1,00478,India
150868,2023-06-29,710,geometry box,100,150,50,1,00478,India
819182,2023-06-29,716,printing paper,200,400,200,1,00137,India
160377,2023-06-29,703,eraser,1,3,2,1,00174,India
160377,2023-06-29,712,graph paper,20,40,20,1,00174,India
739834,2023-06-29,712,graph paper,20,40,20,1,00130,India
739834,2023-06-29,715,folder,5,15,10,1,00130,India
739834,2023-06-29,714,carbon paper,15,30,15,1,00130,India
739834,2023-06-29,708,sketchpen,15,40,25,1,00130,India
102869,2023-06-29,707,marker,20,40,20,1,00310,India
102869,2023-06-29,716,printing paper,200,400,200,1,00310,India
102869,2023-06-29,714,carbon paper,15,30,15,1,00310,India
856717,2023-06-29,714,carbon paper,15,30,15,1,00007,India
856717,2023-06-29,701,gel pen,5,10,5,1,00007,India
856717,2023-06-29,717,spiral bound book,50,100,50,1,00007,India
344508,2023-06-29,705,stencil,10,20,10,1,00076,India
344508,2023-06-29,712,graph paper,20,40,20,1,00076,India
344508,2023-06-29,701,gel pen,5,10,5,1,00076,India
636651,2023-06-29,705,stencil,10,20,10,1,00164,India
274313,2023-06-29,711,TD kit,150,300,150,1,00136,India
976792,2023-06-29,712,graph paper,20,40,20,1,00013,India
976792,2023-06-29,707,marker,20,40,20,1,00013,India
976792,2023-06-29,705,stencil,10,20,10,1,00013,India
947613,2023-06-29,717,spiral bound book,50,100,50,1,00229,India
947613,2023-06-29,702,pencil,2,5,3,1,00229,India
947613,2023-06-29,706,sharpener,3,8,5,1,00229,India
947613,2023-06-29,712,graph paper,20,40,20,1,00229,India
947613,2023-06-29,714,carbon paper,15,30,15,1,00229,India
717377,2023-06-29,708,sketchpen,15,40,25,1,00154,India
826133,2023-06-30,709,notebook,30,60,30,1,00191,India
826133,2023-06-30,704,scale,5,10,5,1,00191,India
232363,2023-06-30,711,TD kit,150,300,150,1,00374,India
232363,2023-06-30,717,spiral bound book,50,100,50,1,00374,India
232363,2023-06-30,702,pencil,2,5,3,1,00374,India
232363,2023-06-30,716,printing paper,200,400,200,1,00374,India
851290,2023-06-30,705,stencil,10,20,10,1,00299,India
851290,2023-06-30,713,ball pen,5,10,5,1,00299,India
851290,2023-06-30,703,eraser,1,3,2,1,00299,India
539758,2023-06-30,709,notebook,30,60,30,1,00335,India
539758,2023-06-30,704,scale,5,10,5,1,00335,India
539758,2023-06-30,703,eraser,1,3,2,1,00335,India
539758,2023-06-30,716,printing paper,200,400,200,1,00335,India
878176,2023-06-30,710,geometry box,100,150,50,1,00383,India
213153,2023-06-30,713,ball pen,5,10,5,1,00224,India
213153,2023-06-30,716,printing paper,200,400,200,1,00224,India
213153,2023-06-30,708,sketchpen,15,40,25,1,00224,India
444727,2023-06-30,710,geometry box,100,150,50,1,00239,India
444727,2023-06-30,703,eraser,1,3,2,1,00239,India
444727,2023-06-30,702,pencil,2,5,3,1,00239,India
663728,2023-06-30,707,marker,20,40,20,1,00421,India
616927,2023-06-30,709,notebook,30,60,30,1,00383,India
616927,2023-06-30,706,sharpener,3,8,5,1,00383,India
616927,2023-06-30,704,scale,5,10,5,1,00383,India
947413,2023-06-30,702,pencil,2,5,3,1,00441,India
947413,2023-06-30,709,notebook,30,60,30,1,00441,India
947413,2023-06-30,704,scale,5,10,5,1,00441,India
947413,2023-06-30,714,carbon paper,15,30,15,1,00441,India
947413,2023-06-30,705,stencil,10,20,10,1,00441,India
805444,2023-06-30,717,spiral bound book,50,100,50,1,00068,India
805444,2023-06-30,707,marker,20,40,20,1,00068,India
805444,2023-06-30,714,carbon paper,15,30,15,1,00068,India
805444,2023-06-30,716,printing paper,200,400,200,1,00068,India
708718,2023-06-30,705,stencil,10,20,10,1,00345,India
708718,2023-06-30,713,ball pen,5,10,5,1,00345,India
708718,2023-06-30,716,printing paper,200,400,200,1,00345,India
690959,2023-06-30,710,geometry box,100,150,50,1,00198,India
690959,2023-06-30,705,stencil,10,20,10,1,00198,India
690959,2023-06-30,711,TD kit,150,300,150,1,00198,India
690959,2023-06-30,716,printing paper,200,400,200,1,00198,India
690959,2023-06-30,712,graph paper,20,40,20,1,00198,India
905245,2023-06-30,712,graph paper,20,40,20,1,00408,India
905245,2023-06-30,715,folder,5,15,10,1,00408,India
905245,2023-06-30,701,gel pen,5,10,5,1,00408,India
905245,2023-06-30,702,pencil,2,5,3,1,00408,India
905245,2023-06-30,707,marker,20,40,20,1,00408,India
553649,2023-06-30,715,folder,5,15,10,1,00083,India
553649,2023-06-30,703,eraser,1,3,2,1,00083,India
553649,2023-06-30,716,printing paper,200,400,200,1,00083,India
553649,2023-06-30,712,graph paper,20,40,20,1,00083,India
553649,2023-06-30,701,gel pen,5,10,5,1,00083,India
676152,2023-06-30,702,pencil,2,5,3,1,00197,India
676152,2023-06-30,712,graph paper,20,40,20,1,00197,India
676152,2023-06-30,714,carbon paper,15,30,15,1,00197,India
676152,2023-06-30,717,spiral bound book,50,100,50,1,00197,India
676152,2023-06-30,705,stencil,10,20,10,1,00197,India
775427,2023-06-30,703,eraser,1,3,2,1,00464,India
775427,2023-06-30,707,marker,20,40,20,1,00464,India
775427,2023-06-30,713,ball pen,5,10,5,1,00464,India
775427,2023-06-30,704,scale,5,10,5,1,00464,India
775427,2023-06-30,711,TD kit,150,300,150,1,00464,India
175306,2023-06-30,712,graph paper,20,40,20,1,00292,India
673101,2023-06-30,704,scale,5,10,5,1,00133,India
673101,2023-06-30,713,ball pen,5,10,5,1,00133,India
673101,2023-06-30,717,spiral bound book,50,100,50,1,00133,India
673101,2023-06-30,709,notebook,30,60,30,1,00133,India
743467,2023-06-30,707,marker,20,40,20,1,00411,India
743467,2023-06-30,704,scale,5,10,5,1,00411,India
743467,2023-06-30,706,sharpener,3,8,5,1,00411,India
447573,2023-06-30,711,TD kit,150,300,150,1,00300,India
447573,2023-06-30,712,graph paper,20,40,20,1,00300,India
862709,2023-06-30,704,scale,5,10,5,1,00116,India
464992,2023-06-30,706,sharpener,3,8,5,1,00446,India
464992,2023-06-30,705,stencil,10,20,10,1,00446,India
553459,2023-06-30,702,pencil,2,5,3,1,00363,India
190234,2023-06-30,702,pencil,2,5,3,1,00148,India
190234,2023-06-30,707,marker,20,40,20,1,00148,India
794085,2023-06-30,711,TD kit,150,300,150,1,00173,India
794085,2023-06-30,709,notebook,30,60,30,1,00173,India
794085,2023-06-30,704,scale,5,10,5,1,00173,India
794085,2023-06-30,703,eraser,1,3,2,1,00173,India
794085,2023-06-30,712,graph paper,20,40,20,1,00173,India
527339,2023-06-30,706,sharpener,3,8,5,1,00333,India
527339,2023-06-30,705,stencil,10,20,10,1,00333,India
250198,2023-06-30,708,sketchpen,15,40,25,1,00371,India
629973,2023-06-30,712,graph paper,20,40,20,1,00225,India
629973,2023-06-30,709,notebook,30,60,30,1,00225,India
629973,2023-06-30,707,marker,20,40,20,1,00225,India
629973,2023-06-30,704,scale,5,10,5,1,00225,India
629973,2023-06-30,705,stencil,10,20,10,1,00225,India
707583,2023-06-30,708,sketchpen,15,40,25,1,00396,India
707583,2023-06-30,701,gel pen,5,10,5,1,00396,India
108702,2023-06-30,707,marker,20,40,20,1,00318,India
108702,2023-06-30,710,geometry box,100,150,50,1,00318,India
108702,2023-06-30,714,carbon paper,15,30,15,1,00318,India
108702,2023-06-30,704,scale,5,10,5,1,00318,India
893768,2023-06-30,709,notebook,30,60,30,1,00349,India
893768,2023-06-30,703,eraser,1,3,2,1,00349,India
893768,2023-06-30,705,stencil,10,20,10,1,00349,India
157984,2023-06-30,712,graph paper,20,40,20,1,00361,India
157984,2023-06-30,705,stencil,10,20,10,1,00361,India
157984,2023-06-30,708,sketchpen,15,40,25,1,00361,India
157984,2023-06-30,714,carbon paper,15,30,15,1,00361,India
272230,2023-06-30,708,sketchpen,15,40,25,1,00342,India
644024,2023-06-30,708,sketchpen,15,40,25,1,00145,India
644024,2023-06-30,711,TD kit,150,300,150,1,00145,India
911086,2023-07-01,717,spiral bound book,50,100,50,1,00199,India
911086,2023-07-01,702,pencil,2,5,3,1,00199,India
911086,2023-07-01,713,ball pen,5,10,5,1,00199,India
911086,2023-07-01,709,notebook,30,60,30,1,00199,India
309985,2023-07-01,714,carbon paper,15,30,15,1,00436,India
309985,2023-07-01,717,spiral bound book,50,100,50,1,00436,India
309985,2023-07-01,712,graph paper,20,40,20,1,00436,India
341953,2023-07-01,716,printing paper,200,400,200,1,00062,India
341953,2023-07-01,708,sketchpen,15,40,25,1,00062,India
341953,2023-07-01,717,spiral bound book,50,100,50,1,00062,India
341953,2023-07-01,713,ball pen,5,10,5,1,00062,India
895357,2023-07-01,702,pencil,2,5,3,1,00299,India
895357,2023-07-01,708,sketchpen,15,40,25,1,00299,India
895357,2023-07-01,713,ball pen,5,10,5,1,00299,India
895357,2023-07-01,710,geometry box,100,150,50,1,00299,India
758372,2023-07-01,704,scale,5,10,5,1,00282,India
758372,2023-07-01,708,sketchpen,15,40,25,1,00282,India
758372,2023-07-01,710,geometry box,100,150,50,1,00282,India
594766,2023-07-01,708,sketchpen,15,40,25,1,00394,India
594766,2023-07-01,709,notebook,30,60,30,1,00394,India
594766,2023-07-01,714,carbon paper,15,30,15,1,00394,India
594766,2023-07-01,707,marker,20,40,20,1,00394,India
594766,2023-07-01,713,ball pen,5,10,5,1,00394,India
643257,2023-07-01,708,sketchpen,15,40,25,1,00278,India
643257,2023-07-01,704,scale,5,10,5,1,00278,India
643257,2023-07-01,713,ball pen,5,10,5,1,00278,India
487212,2023-07-01,710,geometry box,100,150,50,1,00095,India
487212,2023-07-01,715,folder,5,15,10,1,00095,India
695383,2023-07-01,703,eraser,1,3,2,1,00188,India
968414,2023-07-01,712,graph paper,20,40,20,1,00316,India
968414,2023-07-01,706,sharpener,3,8,5,1,00316,India
481677,2023-07-01,717,spiral bound book,50,100,50,1,00428,India
343743,2023-07-01,711,TD kit,150,300,150,1,00066,India
343743,2023-07-01,716,printing paper,200,400,200,1,00066,India
343743,2023-07-01,714,carbon paper,15,30,15,1,00066,India
133599,2023-07-01,706,sharpener,3,8,5,1,00466,India
133599,2023-07-01,711,TD kit,150,300,150,1,00466,India
133599,2023-07-01,714,carbon paper,15,30,15,1,00466,India
133599,2023-07-01,705,stencil,10,20,10,1,00466,India
863816,2023-07-01,710,geometry box,100,150,50,1,00216,India
863816,2023-07-01,701,gel pen,5,10,5,1,00216,India
285002,2023-07-01,710,geometry box,100,150,50,1,00130,India
285002,2023-07-01,711,TD kit,150,300,150,1,00130,India
819579,2023-07-01,712,graph paper,20,40,20,1,00383,India
819579,2023-07-01,717,spiral bound book,50,100,50,1,00383,India
219281,2023-07-01,710,geometry box,100,150,50,1,00048,India
702741,2023-07-01,701,gel pen,5,10,5,1,00275,India
702741,2023-07-01,706,sharpener,3,8,5,1,00275,India
702741,2023-07-01,716,printing paper,200,400,200,1,00275,India
702741,2023-07-01,703,eraser,1,3,2,1,00275,India
221440,2023-07-01,704,scale,5,10,5,1,00032,India
221440,2023-07-01,706,sharpener,3,8,5,1,00032,India
221440,2023-07-01,717,spiral bound book,50,100,50,1,00032,India
221440,2023-07-01,714,carbon paper,15,30,15,1,00032,India
496647,2023-07-01,704,scale,5,10,5,1,00239,India
496647,2023-07-01,716,printing paper,200,400,200,1,00239,India
496647,2023-07-01,701,gel pen,5,10,5,1,00239,India
496647,2023-07-01,715,folder,5,15,10,1,00239,India
526490,2023-07-01,708,sketchpen,15,40,25,1,00351,India
843213,2023-07-01,713,ball pen,5,10,5,1,00470,India
883082,2023-07-01,702,pencil,2,5,3,1,00134,India
883082,2023-07-01,712,graph paper,20,40,20,1,00134,India
883082,2023-07-01,717,spiral bound book,50,100,50,1,00134,India
883082,2023-07-01,703,eraser,1,3,2,1,00134,India
548501,2023-07-01,703,eraser,1,3,2,1,00105,India
241052,2023-07-01,717,spiral bound book,50,100,50,1,00340,India
514928,2023-07-01,716,printing paper,200,400,200,1,00153,India
514928,2023-07-01,712,graph paper,20,40,20,1,00153,India
514928,2023-07-01,705,stencil,10,20,10,1,00153,India
738592,2023-07-01,711,TD kit,150,300,150,1,00190,India
738592,2023-07-01,701,gel pen,5,10,5,1,00190,India
140291,2023-07-01,716,printing paper,200,400,200,1,00041,India
140291,2023-07-01,705,stencil,10,20,10,1,00041,India
929050,2023-07-01,713,ball pen,5,10,5,1,00168,India
778976,2023-07-01,710,geometry box,100,150,50,1,00413,India
778976,2023-07-01,702,pencil,2,5,3,1,00413,India
778976,2023-07-01,713,ball pen,5,10,5,1,00413,India
778976,2023-07-01,706,sharpener,3,8,5,1,00413,India
778976,2023-07-01,712,graph paper,20,40,20,1,00413,India
457572,2023-07-01,714,carbon paper,15,30,15,1,00495,India
457572,2023-07-01,706,sharpener,3,8,5,1,00495,India
501627,2023-07-01,701,gel pen,5,10,5,1,00213,India
791403,2023-07-01,717,spiral bound book,50,100,50,1,00306,India
791403,2023-07-01,704,scale,5,10,5,1,00306,India
982582,2023-07-01,705,stencil,10,20,10,1,00470,India
982582,2023-07-01,704,scale,5,10,5,1,00470,India
982582,2023-07-01,702,pencil,2,5,3,1,00470,India
982582,2023-07-01,706,sharpener,3,8,5,1,00470,India
429328,2023-07-01,709,notebook,30,60,30,1,00139,India
429328,2023-07-01,717,spiral bound book,50,100,50,1,00139,India
429328,2023-07-01,714,carbon paper,15,30,15,1,00139,India
429328,2023-07-01,712,graph paper,20,40,20,1,00139,India
458613,2023-07-02,714,carbon paper,15,30,15,1,00151,India
458613,2023-07-02,709,notebook,30,60,30,1,00151,India
458613,2023-07-02,716,printing paper,200,400,200,1,00151,India
458613,2023-07-02,703,eraser,1,3,2,1,00151,India
458613,2023-07-02,717,spiral bound book,50,100,50,1,00151,India
247801,2023-07-02,711,TD kit,150,300,150,1,00034,India
247801,2023-07-02,703,eraser,1,3,2,1,00034,India
754303,2023-07-02,714,carbon paper,15,30,15,1,00039,India
362662,2023-07-02,711,TD kit,150,300,150,1,00288,India
362662,2023-07-02,702,pencil,2,5,3,1,00288,India
874906,2023-07-02,705,stencil,10,20,10,1,00457,India
874906,2023-07-02,701,gel pen,5,10,5,1,00457,India
874906,2023-07-02,707,marker,20,40,20,1,00457,India
678187,2023-07-02,708,sketchpen,15,40,25,1,00214,India
678187,2023-07-02,703,eraser,1,3,2,1,00214,India
678187,2023-07-02,712,graph paper,20,40,20,1,00214,India
564871,2023-07-02,712,graph paper,20,40,20,1,00215,India
564871,2023-07-02,710,geometry box,100,150,50,1,00215,India
842904,2023-07-02,711,TD kit,150,300,150,1,00280,India
842904,2023-07-02,702,pencil,2,5,3,1,00280,India
139371,2023-07-02,705,stencil,10,20,10,1,00013,India
139371,2023-07-02,707,marker,20,40,20,1,00013,India
139371,2023-07-02,713,ball pen,5,10,5,1,00013,India
139371,2023-07-02,706,sharpener,3,8,5,1,00013,India
756150,2023-07-02,709,notebook,30,60,30,1,00017,India
756150,2023-07-02,716,printing paper,200,400,200,1,00017,India
756150,2023-07-02,703,eraser,1,3,2,1,00017,India
756150,2023-07-02,713,ball pen,5,10,5,1,00017,India
175723,2023-07-02,715,folder,5,15,10,1,00413,India
175723,2023-07-02,704,scale,5,10,5,1,00413,India
175723,2023-07-02,717,spiral bound book,50,100,50,1,00413,India
175723,2023-07-02,709,notebook,30,60,30,1,00413,India
755282,2023-07-02,712,graph paper,20,40,20,1,00393,India
755282,2023-07-02,709,notebook,30,60,30,1,00393,India
152376,2023-07-02,712,graph paper,20,40,20,1,00090,India
152376,2023-07-02,713,ball pen,5,10,5,1,00090,India
152376,2023-07-02,706,sharpener,3,8,5,1,00090,India
152376,2023-07-02,705,stencil,10,20,10,1,00090,India
152376,2023-07-02,714,carbon paper,15,30,15,1,00090,India
772724,2023-07-02,703,eraser,1,3,2,1,00408,India
772724,2023-07-02,716,printing paper,200,400,200,1,00408,India
772724,2023-07-02,713,ball pen,5,10,5,1,00408,India
925695,2023-07-02,704,scale,5,10,5,1,00232,India
925695,2023-07-02,716,printing paper,200,400,200,1,00232,India
925695,2023-07-02,708,sketchpen,15,40,25,1,00232,India
430166,2023-07-02,713,ball pen,5,10,5,1,00207,India
421218,2023-07-02,711,TD kit,150,300,150,1,00159,India
421218,2023-07-02,702,pencil,2,5,3,1,00159,India
982780,2023-07-02,704,scale,5,10,5,1,00120,India
824699,2023-07-02,716,printing paper,200,400,200,1,00268,India
824699,2023-07-02,715,folder,5,15,10,1,00268,India
824699,2023-07-02,702,pencil,2,5,3,1,00268,India
783279,2023-07-02,709,notebook,30,60,30,1,00051,India
214968,2023-07-02,716,printing paper,200,400,200,1,00493,India
753408,2023-07-02,708,sketchpen,15,40,25,1,00141,India
435681,2023-07-02,708,sketchpen,15,40,25,1,00214,India
435681,2023-07-02,712,graph paper,20,40,20,1,00214,India
794880,2023-07-02,702,pencil,2,5,3,1,00015,India
138098,2023-07-02,712,graph paper,20,40,20,1,00194,India
138098,2023-07-02,711,TD kit,150,300,150,1,00194,India
138098,2023-07-02,706,sharpener,3,8,5,1,00194,India
114232,2023-07-02,712,graph paper,20,40,20,1,00236,India
846820,2023-07-02,705,stencil,10,20,10,1,00244,India
846820,2023-07-02,714,carbon paper,15,30,15,1,00244,India
846820,2023-07-02,715,folder,5,15,10,1,00244,India
464933,2023-07-02,712,graph paper,20,40,20,1,00019,India
246530,2023-07-02,716,printing paper,200,400,200,1,00050,India
246530,2023-07-02,706,sharpener,3,8,5,1,00050,India
246530,2023-07-02,711,TD kit,150,300,150,1,00050,India
246530,2023-07-02,704,scale,5,10,5,1,00050,India
755047,2023-07-02,713,ball pen,5,10,5,1,00203,India
755047,2023-07-02,704,scale,5,10,5,1,00203,India
755047,2023-07-02,711,TD kit,150,300,150,1,00203,India
755047,2023-07-02,707,marker,20,40,20,1,00203,India
755047,2023-07-02,702,pencil,2,5,3,1,00203,India
135626,2023-07-02,714,carbon paper,15,30,15,1,00435,India
135626,2023-07-02,701,gel pen,5,10,5,1,00435,India
414959,2023-07-02,709,notebook,30,60,30,1,00333,India
201064,2023-07-02,701,gel pen,5,10,5,1,00490,India
219023,2023-07-02,701,gel pen,5,10,5,1,00394,India
219023,2023-07-02,711,TD kit,150,300,150,1,00394,India
219023,2023-07-02,705,stencil,10,20,10,1,00394,India
219023,2023-07-02,707,marker,20,40,20,1,00394,India
909687,2023-07-02,707,marker,20,40,20,1,00432,India
909687,2023-07-02,710,geometry box,100,150,50,1,00432,India
909687,2023-07-02,706,sharpener,3,8,5,1,00432,India
909687,2023-07-02,712,graph paper,20,40,20,1,00432,India
909687,2023-07-02,716,printing paper,200,400,200,1,00432,India
861400,2023-07-02,701,gel pen,5,10,5,1,00453,India
861400,2023-07-02,714,carbon paper,15,30,15,1,00453,India
861400,2023-07-02,715,folder,5,15,10,1,00453,India
861400,2023-07-02,716,printing paper,200,400,200,1,00453,India
639502,2023-07-02,703,eraser,1,3,2,1,00471,India
639502,2023-07-02,702,pencil,2,5,3,1,00471,India
639502,2023-07-02,713,ball pen,5,10,5,1,00471,India
639502,2023-07-02,714,carbon paper,15,30,15,1,00471,India
364811,2023-07-02,705,stencil,10,20,10,1,00280,India
603626,2023-07-02,702,pencil,2,5,3,1,00487,India
603626,2023-07-02,714,carbon paper,15,30,15,1,00487,India
163901,2023-07-02,711,TD kit,150,300,150,1,00360,India
163901,2023-07-02,714,carbon paper,15,30,15,1,00360,India
986355,2023-07-02,709,notebook,30,60,30,1,00356,India
986355,2023-07-02,703,eraser,1,3,2,1,00356,India
986355,2023-07-02,713,ball pen,5,10,5,1,00356,India
986355,2023-07-02,707,marker,20,40,20,1,00356,India
866347,2023-07-02,710,geometry box,100,150,50,1,00439,India
866347,2023-07-02,702,pencil,2,5,3,1,00439,India
866347,2023-07-02,706,sharpener,3,8,5,1,00439,India
698955,2023-07-03,708,sketchpen,15,40,25,1,00352,India
698955,2023-07-03,716,printing paper,200,400,200,1,00352,India
467550,2023-07-03,712,graph paper,20,40,20,1,00082,India
467550,2023-07-03,713,ball pen,5,10,5,1,00082,India
900752,2023-07-03,708,sketchpen,15,40,25,1,00121,India
900752,2023-07-03,713,ball pen,5,10,5,1,00121,India
900752,2023-07-03,716,printing paper,200,400,200,1,00121,India
558957,2023-07-03,706,sharpener,3,8,5,1,00037,India
513280,2023-07-03,710,geometry box,100,150,50,1,00129,India
513280,2023-07-03,713,ball pen,5,10,5,1,00129,India
513280,2023-07-03,703,eraser,1,3,2,1,00129,India
853994,2023-07-03,705,stencil,10,20,10,1,00389,India
853994,2023-07-03,708,sketchpen,15,40,25,1,00389,India
773732,2023-07-03,717,spiral bound book,50,100,50,1,00118,India
773732,2023-07-03,704,scale,5,10,5,1,00118,India
773732,2023-07-03,714,carbon paper,15,30,15,1,00118,India
773732,2023-07-03,710,geometry box,100,150,50,1,00118,India
773732,2023-07-03,707,marker,20,40,20,1,00118,India
315617,2023-07-03,717,spiral bound book,50,100,50,1,00234,India
315617,2023-07-03,707,marker,20,40,20,1,00234,India
315617,2023-07-03,706,sharpener,3,8,5,1,00234,India
315617,2023-07-03,702,pencil,2,5,3,1,00234,India
315617,2023-07-03,701,gel pen,5,10,5,1,00234,India
254188,2023-07-03,717,spiral bound book,50,100,50,1,00487,India
254188,2023-07-03,715,folder,5,15,10,1,00487,India
248605,2023-07-03,715,folder,5,15,10,1,00243,India
248605,2023-07-03,703,eraser,1,3,2,1,00243,India
248605,2023-07-03,714,carbon paper,15,30,15,1,00243,India
237259,2023-07-03,715,folder,5,15,10,1,00460,India
237259,2023-07-03,707,marker,20,40,20,1,00460,India
237259,2023-07-03,717,spiral bound book,50,100,50,1,00460,India
574074,2023-07-03,717,spiral bound book,50,100,50,1,00415,India
574074,2023-07-03,704,scale,5,10,5,1,00415,India
574074,2023-07-03,716,printing paper,200,400,200,1,00415,India
574074,2023-07-03,702,pencil,2,5,3,1,00415,India
724839,2023-07-03,707,marker,20,40,20,1,00120,India
724839,2023-07-03,714,carbon paper,15,30,15,1,00120,India
724839,2023-07-03,704,scale,5,10,5,1,00120,India
644457,2023-07-03,705,stencil,10,20,10,1,00137,India
644457,2023-07-03,702,pencil,2,5,3,1,00137,India
381192,2023-07-03,701,gel pen,5,10,5,1,00397,India
381192,2023-07-03,715,folder,5,15,10,1,00397,India
362452,2023-07-03,714,carbon paper,15,30,15,1,00270,India
576009,2023-07-03,702,pencil,2,5,3,1,00028,India
576009,2023-07-03,711,TD kit,150,300,150,1,00028,India
576009,2023-07-03,710,geometry box,100,150,50,1,00028,India
576009,2023-07-03,716,printing paper,200,400,200,1,00028,India
708571,2023-07-03,713,ball pen,5,10,5,1,00233,India
762895,2023-07-03,701,gel pen,5,10,5,1,00424,India
762895,2023-07-03,709,notebook,30,60,30,1,00424,India
980449,2023-07-03,714,carbon paper,15,30,15,1,00386,India
980449,2023-07-03,710,geometry box,100,150,50,1,00386,India
836586,2023-07-03,702,pencil,2,5,3,1,00164,India
836586,2023-07-03,705,stencil,10,20,10,1,00164,India
836586,2023-07-03,716,printing paper,200,400,200,1,00164,India
836586,2023-07-03,717,spiral bound book,50,100,50,1,00164,India
593946,2023-07-03,709,notebook,30,60,30,1,00322,India
137507,2023-07-03,717,spiral bound book,50,100,50,1,00228,India
137507,2023-07-03,703,eraser,1,3,2,1,00228,India
137507,2023-07-03,712,graph paper,20,40,20,1,00228,India
735060,2023-07-03,708,sketchpen,15,40,25,1,00054,India
735060,2023-07-03,710,geometry box,100,150,50,1,00054,India
735060,2023-07-03,709,notebook,30,60,30,1,00054,India
934967,2023-07-03,716,printing paper,200,400,200,1,00117,India
934967,2023-07-03,703,eraser,1,3,2,1,00117,India
104804,2023-07-03,713,ball pen,5,10,5,1,00471,India
104804,2023-07-03,708,sketchpen,15,40,25,1,00471,India
104804,2023-07-03,706,sharpener,3,8,5,1,00471,India
235491,2023-07-03,708,sketchpen,15,40,25,1,00032,India
235491,2023-07-03,702,pencil,2,5,3,1,00032,India
235491,2023-07-03,710,geometry box,100,150,50,1,00032,India
237891,2023-07-03,707,marker,20,40,20,1,00017,India
237891,2023-07-03,705,stencil,10,20,10,1,00017,India
821748,2023-07-03,715,folder,5,15,10,1,00284,India
821748,2023-07-03,707,marker,20,40,20,1,00284,India
215662,2023-07-03,709,notebook,30,60,30,1,00017,India
170993,2023-07-03,708,sketchpen,15,40,25,1,00113,India
170993,2023-07-03,706,sharpener,3,8,5,1,00113,India
170993,2023-07-03,716,printing paper,200,400,200,1,00113,India
151243,2023-07-03,704,scale,5,10,5,1,00474,India
151243,2023-07-03,702,pencil,2,5,3,1,00474,India
151243,2023-07-03,708,sketchpen,15,40,25,1,00474,India
151243,2023-07-03,701,gel pen,5,10,5,1,00474,India
151243,2023-07-03,717,spiral bound book,50,100,50,1,00474,India
869214,2023-07-03,715,folder,5,15,10,1,00056,India
869214,2023-07-03,717,spiral bound book,50,100,50,1,00056,India
256069,2023-07-03,709,notebook,30,60,30,1,00381,India
256069,2023-07-03,708,sketchpen,15,40,25,1,00381,India
256069,2023-07-03,710,geometry box,100,150,50,1,00381,India
256069,2023-07-03,717,spiral bound book,50,100,50,1,00381,India
882568,2023-07-03,702,pencil,2,5,3,1,00453,India
882568,2023-07-03,717,spiral bound book,50,100,50,1,00453,India
882568,2023-07-03,704,scale,5,10,5,1,00453,India
882568,2023-07-03,711,TD kit,150,300,150,1,00453,India
882568,2023-07-03,706,sharpener,3,8,5,1,00453,India
619823,2023-07-03,706,sharpener,3,8,5,1,00103,India
619823,2023-07-03,710,geometry box,100,150,50,1,00103,India
239823,2023-07-03,707,marker,20,40,20,1,00232,India
239823,2023-07-03,710,geometry box,100,150,50,1,00232,India
239823,2023-07-03,701,gel pen,5,10,5,1,00232,India
239823,2023-07-03,712,graph paper,20,40,20,1,00232,India
239823,2023-07-03,704,scale,5,10,5,1,00232,India
186669,2023-07-03,705,stencil,10,20,10,1,00053,India
186669,2023-07-03,707,marker,20,40,20,1,00053,India
186669,2023-07-03,710,geometry box,100,150,50,1,00053,India
186669,2023-07-03,714,carbon paper,15,30,15,1,00053,India
186669,2023-07-03,717,spiral bound book,50,100,50,1,00053,India
889490,2023-07-03,701,gel pen,5,10,5,1,00206,India
889490,2023-07-03,714,carbon paper,15,30,15,1,00206,India
889490,2023-07-03,709,notebook,30,60,30,1,00206,India
889490,2023-07-03,708,sketchpen,15,40,25,1,00206,India
381698,2023-07-03,708,sketchpen,15,40,25,1,00163,India
381698,2023-07-03,703,eraser,1,3,2,1,00163,India
308866,2023-07-03,713,ball pen,5,10,5,1,00350,India
417002,2023-07-03,710,geometry box,100,150,50,1,00295,India
417002,2023-07-03,702,pencil,2,5,3,1,00295,India
417002,2023-07-03,703,eraser,1,3,2,1,00295,India
417002,2023-07-03,709,notebook,30,60,30,1,00295,India
664217,2023-07-03,713,ball pen,5,10,5,1,00028,India
664217,2023-07-03,714,carbon paper,15,30,15,1,00028,India
664217,2023-07-03,712,graph paper,20,40,20,1,00028,India
866289,2023-07-03,717,spiral bound book,50,100,50,1,00393,India
866289,2023-07-03,705,stencil,10,20,10,1,00393,India
938327,2023-07-03,701,gel pen,5,10,5,1,00219,India
938327,2023-07-03,708,sketchpen,15,40,25,1,00219,India
938327,2023-07-03,705,stencil,10,20,10,1,00219,India
938327,2023-07-03,711,TD kit,150,300,150,1,00219,India
443532,2023-07-03,703,eraser,1,3,2,1,00196,India
443532,2023-07-03,711,TD kit,150,300,150,1,00196,India
648328,2023-07-04,711,TD kit,150,300,150,1,00494,India
307274,2023-07-04,709,notebook,30,60,30,1,00420,India
947554,2023-07-04,712,graph paper,20,40,20,1,00367,India
947554,2023-07-04,704,scale,5,10,5,1,00367,India
947554,2023-07-04,714,carbon paper,15,30,15,1,00367,India
947554,2023-07-04,709,notebook,30,60,30,1,00367,India
947554,2023-07-04,701,gel pen,5,10,5,1,00367,India
133667,2023-07-04,704,scale,5,10,5,1,00033,India
547696,2023-07-04,708,sketchpen,15,40,25,1,00327,India
547696,2023-07-04,717,spiral bound book,50,100,50,1,00327,India
547696,2023-07-04,703,eraser,1,3,2,1,00327,India
547696,2023-07-04,714,carbon paper,15,30,15,1,00327,India
547696,2023-07-04,709,notebook,30,60,30,1,00327,India
798211,2023-07-04,710,geometry box,100,150,50,1,00143,India
798211,2023-07-04,709,notebook,30,60,30,1,00143,India
125379,2023-07-04,709,notebook,30,60,30,1,00442,India
242877,2023-07-04,707,marker,20,40,20,1,00278,India
242877,2023-07-04,704,scale,5,10,5,1,00278,India
242877,2023-07-04,701,gel pen,5,10,5,1,00278,India
808210,2023-07-04,708,sketchpen,15,40,25,1,00304,India
808210,2023-07-04,701,gel pen,5,10,5,1,00304,India
808210,2023-07-04,712,graph paper,20,40,20,1,00304,India
401946,2023-07-04,709,notebook,30,60,30,1,00399,India
756461,2023-07-04,712,graph paper,20,40,20,1,00239,India
757473,2023-07-04,707,marker,20,40,20,1,00014,India
678524,2023-07-04,709,notebook,30,60,30,1,00384,India
678524,2023-07-04,704,scale,5,10,5,1,00384,India
678524,2023-07-04,708,sketchpen,15,40,25,1,00384,India
678524,2023-07-04,711,TD kit,150,300,150,1,00384,India
112999,2023-07-04,706,sharpener,3,8,5,1,00395,India
886140,2023-07-04,705,stencil,10,20,10,1,00334,India
886140,2023-07-04,711,TD kit,150,300,150,1,00334,India
886140,2023-07-04,708,sketchpen,15,40,25,1,00334,India
886140,2023-07-04,713,ball pen,5,10,5,1,00334,India
706904,2023-07-04,705,stencil,10,20,10,1,00130,India
706904,2023-07-04,711,TD kit,150,300,150,1,00130,India
706904,2023-07-04,713,ball pen,5,10,5,1,00130,India
706904,2023-07-04,707,marker,20,40,20,1,00130,India
188869,2023-07-04,703,eraser,1,3,2,1,00272,India
188869,2023-07-04,708,sketchpen,15,40,25,1,00272,India
188869,2023-07-04,712,graph paper,20,40,20,1,00272,India
188869,2023-07-04,715,folder,5,15,10,1,00272,India
951454,2023-07-04,701,gel pen,5,10,5,1,00287,India
951454,2023-07-04,707,marker,20,40,20,1,00287,India
951454,2023-07-04,708,sketchpen,15,40,25,1,00287,India
803608,2023-07-04,710,geometry box,100,150,50,1,00293,India
803608,2023-07-04,714,carbon paper,15,30,15,1,00293,India
803608,2023-07-04,701,gel pen,5,10,5,1,00293,India
247275,2023-07-04,715,folder,5,15,10,1,00235,India
247275,2023-07-04,704,scale,5,10,5,1,00235,India
247275,2023-07-04,708,sketchpen,15,40,25,1,00235,India
247275,2023-07-04,717,spiral bound book,50,100,50,1,00235,India
363505,2023-07-04,713,ball pen,5,10,5,1,00333,India
475734,2023-07-04,709,notebook,30,60,30,1,00058,India
475734,2023-07-04,706,sharpener,3,8,5,1,00058,India
914162,2023-07-04,707,marker,20,40,20,1,00444,India
985054,2023-07-04,702,pencil,2,5,3,1,00118,India
190592,2023-07-04,703,eraser,1,3,2,1,00232,India
190592,2023-07-04,715,folder,5,15,10,1,00232,India
190592,2023-07-04,716,printing paper,200,400,200,1,00232,India
190592,2023-07-04,714,carbon paper,15,30,15,1,00232,India
956523,2023-07-04,708,sketchpen,15,40,25,1,00029,India
956523,2023-07-04,704,scale,5,10,5,1,00029,India
956523,2023-07-04,709,notebook,30,60,30,1,00029,India
956523,2023-07-04,701,gel pen,5,10,5,1,00029,India
243613,2023-07-04,708,sketchpen,15,40,25,1,00009,India
243613,2023-07-04,704,scale,5,10,5,1,00009,India
243613,2023-07-04,712,graph paper,20,40,20,1,00009,India
235534,2023-07-04,715,folder,5,15,10,1,00060,India
235534,2023-07-04,712,graph paper,20,40,20,1,00060,India
729104,2023-07-04,717,spiral bound book,50,100,50,1,00379,India
729104,2023-07-04,704,scale,5,10,5,1,00379,India
729104,2023-07-04,709,notebook,30,60,30,1,00379,India
729104,2023-07-04,708,sketchpen,15,40,25,1,00379,India
540361,2023-07-04,707,marker,20,40,20,1,00043,India
979540,2023-07-04,706,sharpener,3,8,5,1,00220,India
979540,2023-07-04,717,spiral bound book,50,100,50,1,00220,India
793617,2023-07-04,714,carbon paper,15,30,15,1,00104,India
793617,2023-07-04,715,folder,5,15,10,1,00104,India
793617,2023-07-04,706,sharpener,3,8,5,1,00104,India
793617,2023-07-04,717,spiral bound book,50,100,50,1,00104,India
754466,2023-07-04,701,gel pen,5,10,5,1,00180,India
587054,2023-07-04,716,printing paper,200,400,200,1,00387,India
587054,2023-07-04,712,graph paper,20,40,20,1,00387,India
587054,2023-07-04,717,spiral bound book,50,100,50,1,00387,India
587054,2023-07-04,711,TD kit,150,300,150,1,00387,India
329408,2023-07-04,707,marker,20,40,20,1,00207,India
329408,2023-07-04,713,ball pen,5,10,5,1,00207,India
138051,2023-07-04,702,pencil,2,5,3,1,00093,India
138051,2023-07-04,712,graph paper,20,40,20,1,00093,India
138051,2023-07-04,709,notebook,30,60,30,1,00093,India
197276,2023-07-04,708,sketchpen,15,40,25,1,00128,India
197276,2023-07-04,717,spiral bound book,50,100,50,1,00128,India
197276,2023-07-04,714,carbon paper,15,30,15,1,00128,India
197276,2023-07-04,711,TD kit,150,300,150,1,00128,India
629543,2023-07-04,716,printing paper,200,400,200,1,00139,India
629543,2023-07-04,702,pencil,2,5,3,1,00139,India
716077,2023-07-04,716,printing paper,200,400,200,1,00023,India
716077,2023-07-04,711,TD kit,150,300,150,1,00023,India
716077,2023-07-04,703,eraser,1,3,2,1,00023,India
509815,2023-07-04,708,sketchpen,15,40,25,1,00446,India
509815,2023-07-04,702,pencil,2,5,3,1,00446,India
902038,2023-07-04,705,stencil,10,20,10,1,00102,India
248125,2023-07-04,717,spiral bound book,50,100,50,1,00173,India
248125,2023-07-04,710,geometry box,100,150,50,1,00173,India
248125,2023-07-04,715,folder,5,15,10,1,00173,India
931680,2023-07-04,706,sharpener,3,8,5,1,00220,India
931680,2023-07-04,705,stencil,10,20,10,1,00220,India
931680,2023-07-04,702,pencil,2,5,3,1,00220,India
931680,2023-07-04,714,carbon paper,15,30,15,1,00220,India
908869,2023-07-04,715,folder,5,15,10,1,00426,India
908869,2023-07-04,712,graph paper,20,40,20,1,00426,India
908869,2023-07-04,711,TD kit,150,300,150,1,00426,India
968839,2023-07-04,708,sketchpen,15,40,25,1,00451,India
968839,2023-07-04,706,sharpener,3,8,5,1,00451,India
632001,2023-07-04,715,folder,5,15,10,1,00318,India
440242,2023-07-04,710,geometry box,100,150,50,1,00159,India
440242,2023-07-04,712,graph paper,20,40,20,1,00159,India
440242,2023-07-04,713,ball pen,5,10,5,1,00159,India
185510,2023-07-04,707,marker,20,40,20,1,00132,India
185510,2023-07-04,716,printing paper,200,400,200,1,00132,India
185510,2023-07-04,712,graph paper,20,40,20,1,00132,India
185510,2023-07-04,714,carbon paper,15,30,15,1,00132,India
341541,2023-07-04,711,TD kit,150,300,150,1,00468,India
341541,2023-07-04,714,carbon paper,15,30,15,1,00468,India
319302,2023-07-04,713,ball pen,5,10,5,1,00047,India
726478,2023-07-05,717,spiral bound book,50,100,50,1,00389,India
726478,2023-07-05,709,notebook,30,60,30,1,00389,India
264909,2023-07-05,715,folder,5,15,10,1,00052,India
264909,2023-07-05,711,TD kit,150,300,150,1,00052,India
123091,2023-07-05,709,notebook,30,60,30,1,00143,India
123091,2023-07-05,715,folder,5,15,10,1,00143,India
123091,2023-07-05,702,pencil,2,5,3,1,00143,India
987799,2023-07-05,702,pencil,2,5,3,1,00464,India
987799,2023-07-05,707,marker,20,40,20,1,00464,India
987799,2023-07-05,713,ball pen,5,10,5,1,00464,India
987799,2023-07-05,716,printing paper,200,400,200,1,00464,India
677957,2023-07-05,704,scale,5,10,5,1,00391,India
263038,2023-07-05,701,gel pen,5,10,5,1,00387,India
263038,2023-07-05,711,TD kit,150,300,150,1,00387,India
263038,2023-07-05,704,scale,5,10,5,1,00387,India
263038,2023-07-05,707,marker,20,40,20,1,00387,India
263038,2023-07-05,712,graph paper,20,40,20,1,00387,India
195768,2023-07-05,702,pencil,2,5,3,1,00491,India
195768,2023-07-05,714,carbon paper,15,30,15,1,00491,India
389220,2023-07-05,713,ball pen,5,10,5,1,00022,India
389220,2023-07-05,706,sharpener,3,8,5,1,00022,India
389220,2023-07-05,701,gel pen,5,10,5,1,00022,India
506974,2023-07-05,714,carbon paper,15,30,15,1,00314,India
506974,2023-07-05,713,ball pen,5,10,5,1,00314,India
908739,2023-07-05,707,marker,20,40,20,1,00320,India
320163,2023-07-05,711,TD kit,150,300,150,1,00422,India
320163,2023-07-05,716,printing paper,200,400,200,1,00422,India
320163,2023-07-05,706,sharpener,3,8,5,1,00422,India
327730,2023-07-05,709,notebook,30,60,30,1,00288,India
327730,2023-07-05,703,eraser,1,3,2,1,00288,India
327730,2023-07-05,706,sharpener,3,8,5,1,00288,India
173880,2023-07-05,708,sketchpen,15,40,25,1,00309,India
173880,2023-07-05,717,spiral bound book,50,100,50,1,00309,India
173880,2023-07-05,710,geometry box,100,150,50,1,00309,India
513119,2023-07-05,716,printing paper,200,400,200,1,00175,India
513119,2023-07-05,717,spiral bound book,50,100,50,1,00175,India
513119,2023-07-05,704,scale,5,10,5,1,00175,India
816187,2023-07-05,713,ball pen,5,10,5,1,00410,India
816187,2023-07-05,704,scale,5,10,5,1,00410,India
921411,2023-07-05,706,sharpener,3,8,5,1,00033,India
921411,2023-07-05,705,stencil,10,20,10,1,00033,India
921411,2023-07-05,714,carbon paper,15,30,15,1,00033,India
921411,2023-07-05,715,folder,5,15,10,1,00033,India
465671,2023-07-05,705,stencil,10,20,10,1,00230,India
465671,2023-07-05,710,geometry box,100,150,50,1,00230,India
465671,2023-07-05,703,eraser,1,3,2,1,00230,India
266569,2023-07-05,702,pencil,2,5,3,1,00408,India
266569,2023-07-05,708,sketchpen,15,40,25,1,00408,India
266569,2023-07-05,701,gel pen,5,10,5,1,00408,India
266569,2023-07-05,704,scale,5,10,5,1,00408,India
844041,2023-07-05,709,notebook,30,60,30,1,00253,India
844041,2023-07-05,703,eraser,1,3,2,1,00253,India
844041,2023-07-05,711,TD kit,150,300,150,1,00253,India
539186,2023-07-05,703,eraser,1,3,2,1,00171,India
539186,2023-07-05,714,carbon paper,15,30,15,1,00171,India
539186,2023-07-05,709,notebook,30,60,30,1,00171,India
519974,2023-07-05,702,pencil,2,5,3,1,00246,India
519974,2023-07-05,715,folder,5,15,10,1,00246,India
519974,2023-07-05,708,sketchpen,15,40,25,1,00246,India
519974,2023-07-05,704,scale,5,10,5,1,00246,India
247105,2023-07-05,707,marker,20,40,20,1,00198,India
247105,2023-07-05,715,folder,5,15,10,1,00198,India
247105,2023-07-05,701,gel pen,5,10,5,1,00198,India
247105,2023-07-05,709,notebook,30,60,30,1,00198,India
247105,2023-07-05,710,geometry box,100,150,50,1,00198,India
537057,2023-07-05,708,sketchpen,15,40,25,1,00158,India
537057,2023-07-05,717,spiral bound book,50,100,50,1,00158,India
232980,2023-07-05,712,graph paper,20,40,20,1,00083,India
232980,2023-07-05,710,geometry box,100,150,50,1,00083,India
232980,2023-07-05,714,carbon paper,15,30,15,1,00083,India
232980,2023-07-05,703,eraser,1,3,2,1,00083,India
806496,2023-07-05,716,printing paper,200,400,200,1,00166,India
806496,2023-07-05,711,TD kit,150,300,150,1,00166,India
806496,2023-07-05,714,carbon paper,15,30,15,1,00166,India
806496,2023-07-05,708,sketchpen,15,40,25,1,00166,India
806496,2023-07-05,707,marker,20,40,20,1,00166,India
583674,2023-07-05,707,marker,20,40,20,1,00452,India
583674,2023-07-05,714,carbon paper,15,30,15,1,00452,India
583674,2023-07-05,709,notebook,30,60,30,1,00452,India
422803,2023-07-05,709,notebook,30,60,30,1,00060,India
372641,2023-07-05,716,printing paper,200,400,200,1,00133,India
751677,2023-07-05,714,carbon paper,15,30,15,1,00354,India
751677,2023-07-05,709,notebook,30,60,30,1,00354,India
751677,2023-07-05,710,geometry box,100,150,50,1,00354,India
751677,2023-07-05,704,scale,5,10,5,1,00354,India
751677,2023-07-05,715,folder,5,15,10,1,00354,India
979186,2023-07-05,714,carbon paper,15,30,15,1,00425,India
979186,2023-07-05,707,marker,20,40,20,1,00425,India
979186,2023-07-05,701,gel pen,5,10,5,1,00425,India
979186,2023-07-05,703,eraser,1,3,2,1,00425,India
734794,2023-07-05,704,scale,5,10,5,1,00494,India
734794,2023-07-05,707,marker,20,40,20,1,00494,India
353618,2023-07-05,717,spiral bound book,50,100,50,1,00113,India
353618,2023-07-05,709,notebook,30,60,30,1,00113,India
353618,2023-07-05,711,TD kit,150,300,150,1,00113,India
208694,2023-07-05,716,printing paper,200,400,200,1,00130,India
208694,2023-07-05,714,carbon paper,15,30,15,1,00130,India
208694,2023-07-05,708,sketchpen,15,40,25,1,00130,India
431568,2023-07-05,711,TD kit,150,300,150,1,00204,India
431568,2023-07-05,717,spiral bound book,50,100,50,1,00204,India
355400,2023-07-05,701,gel pen,5,10,5,1,00384,India
355400,2023-07-05,704,scale,5,10,5,1,00384,India
355400,2023-07-05,705,stencil,10,20,10,1,00384,India
355400,2023-07-05,706,sharpener,3,8,5,1,00384,India
273315,2023-07-05,702,pencil,2,5,3,1,00334,India
273315,2023-07-05,711,TD kit,150,300,150,1,00334,India
736983,2023-07-05,710,geometry box,100,150,50,1,00032,India
736983,2023-07-05,713,ball pen,5,10,5,1,00032,India
736983,2023-07-05,706,sharpener,3,8,5,1,00032,India
736983,2023-07-05,707,marker,20,40,20,1,00032,India
803628,2023-07-05,708,sketchpen,15,40,25,1,00009,India
803628,2023-07-05,706,sharpener,3,8,5,1,00009,India
803628,2023-07-05,716,printing paper,200,400,200,1,00009,India
803628,2023-07-05,713,ball pen,5,10,5,1,00009,India
342971,2023-07-05,703,eraser,1,3,2,1,00068,India
342971,2023-07-05,715,folder,5,15,10,1,00068,India
342971,2023-07-05,714,carbon paper,15,30,15,1,00068,India
205873,2023-07-06,703,eraser,1,3,2,1,00114,India
501319,2023-07-06,706,sharpener,3,8,5,1,00137,India
501319,2023-07-06,704,scale,5,10,5,1,00137,India
501319,2023-07-06,709,notebook,30,60,30,1,00137,India
773368,2023-07-06,710,geometry box,100,150,50,1,00125,India
773368,2023-07-06,717,spiral bound book,50,100,50,1,00125,India
773368,2023-07-06,706,sharpener,3,8,5,1,00125,India
429017,2023-07-06,703,eraser,1,3,2,1,00140,India
695499,2023-07-06,701,gel pen,5,10,5,1,00242,India
695499,2023-07-06,710,geometry box,100,150,50,1,00242,India
695499,2023-07-06,715,folder,5,15,10,1,00242,India
677528,2023-07-06,706,sharpener,3,8,5,1,00472,India
677528,2023-07-06,716,printing paper,200,400,200,1,00472,India
677528,2023-07-06,717,spiral bound book,50,100,50,1,00472,India
750863,2023-07-06,702,pencil,2,5,3,1,00080,India
630737,2023-07-06,715,folder,5,15,10,1,00199,India
630737,2023-07-06,705,stencil,10,20,10,1,00199,India
630737,2023-07-06,709,notebook,30,60,30,1,00199,India
188914,2023-07-06,717,spiral bound book,50,100,50,1,00349,India
188914,2023-07-06,715,folder,5,15,10,1,00349,India
327615,2023-07-06,717,spiral bound book,50,100,50,1,00092,India
327615,2023-07-06,702,pencil,2,5,3,1,00092,India
327615,2023-07-06,712,graph paper,20,40,20,1,00092,India
327615,2023-07-06,707,marker,20,40,20,1,00092,India
840110,2023-07-06,711,TD kit,150,300,150,1,00487,India
840110,2023-07-06,714,carbon paper,15,30,15,1,00487,India
840110,2023-07-06,705,stencil,10,20,10,1,00487,India
997761,2023-07-06,712,graph paper,20,40,20,1,00488,India
843917,2023-07-06,702,pencil,2,5,3,1,00388,India
843917,2023-07-06,715,folder,5,15,10,1,00388,India
843917,2023-07-06,716,printing paper,200,400,200,1,00388,India
910374,2023-07-06,716,printing paper,200,400,200,1,00480,India
910374,2023-07-06,711,TD kit,150,300,150,1,00480,India
910374,2023-07-06,712,graph paper,20,40,20,1,00480,India
910374,2023-07-06,704,scale,5,10,5,1,00480,India
746162,2023-07-06,706,sharpener,3,8,5,1,00122,India
877904,2023-07-06,706,sharpener,3,8,5,1,00391,India
877904,2023-07-06,707,marker,20,40,20,1,00391,India
303719,2023-07-06,711,TD kit,150,300,150,1,00114,India
147359,2023-07-06,712,graph paper,20,40,20,1,00492,India
147359,2023-07-06,715,folder,5,15,10,1,00492,India
147359,2023-07-06,709,notebook,30,60,30,1,00492,India
267977,2023-07-06,716,printing paper,200,400,200,1,00180,India
267977,2023-07-06,705,stencil,10,20,10,1,00180,India
267977,2023-07-06,712,graph paper,20,40,20,1,00180,India
267977,2023-07-06,702,pencil,2,5,3,1,00180,India
770751,2023-07-06,705,stencil,10,20,10,1,00124,India
770751,2023-07-06,708,sketchpen,15,40,25,1,00124,India
110018,2023-07-06,704,scale,5,10,5,1,00447,India
110018,2023-07-06,711,TD kit,150,300,150,1,00447,India
110018,2023-07-06,703,eraser,1,3,2,1,00447,India
251040,2023-07-06,709,notebook,30,60,30,1,00388,India
792138,2023-07-06,706,sharpener,3,8,5,1,00086,India
792138,2023-07-06,711,TD kit,150,300,150,1,00086,India
792138,2023-07-06,701,gel pen,5,10,5,1,00086,India
792138,2023-07-06,708,sketchpen,15,40,25,1,00086,India
792138,2023-07-06,713,ball pen,5,10,5,1,00086,India
766492,2023-07-06,701,gel pen,5,10,5,1,00143,India
766492,2023-07-06,716,printing paper,200,400,200,1,00143,India
766492,2023-07-06,706,sharpener,3,8,5,1,00143,India
766492,2023-07-06,714,carbon paper,15,30,15,1,00143,India
439966,2023-07-06,704,scale,5,10,5,1,00437,India
439966,2023-07-06,705,stencil,10,20,10,1,00437,India
439966,2023-07-06,702,pencil,2,5,3,1,00437,India
876480,2023-07-06,703,eraser,1,3,2,1,00252,India
876480,2023-07-06,708,sketchpen,15,40,25,1,00252,India
876480,2023-07-06,717,spiral bound book,50,100,50,1,00252,India
876480,2023-07-06,710,geometry box,100,150,50,1,00252,India
404797,2023-07-06,705,stencil,10,20,10,1,00292,India
404797,2023-07-06,717,spiral bound book,50,100,50,1,00292,India
404797,2023-07-06,704,scale,5,10,5,1,00292,India
404797,2023-07-06,710,geometry box,100,150,50,1,00292,India
404797,2023-07-06,713,ball pen,5,10,5,1,00292,India
606691,2023-07-06,706,sharpener,3,8,5,1,00331,India
606691,2023-07-06,712,graph paper,20,40,20,1,00331,India
606691,2023-07-06,705,stencil,10,20,10,1,00331,India
283696,2023-07-06,701,gel pen,5,10,5,1,00195,India
237571,2023-07-06,701,gel pen,5,10,5,1,00146,India
237571,2023-07-06,709,notebook,30,60,30,1,00146,India
237571,2023-07-06,703,eraser,1,3,2,1,00146,India
237571,2023-07-06,708,sketchpen,15,40,25,1,00146,India
646846,2023-07-06,701,gel pen,5,10,5,1,00189,India
646846,2023-07-06,709,notebook,30,60,30,1,00189,India
744540,2023-07-06,707,marker,20,40,20,1,00067,India
744540,2023-07-06,713,ball pen,5,10,5,1,00067,India
744540,2023-07-06,706,sharpener,3,8,5,1,00067,India
744540,2023-07-06,709,notebook,30,60,30,1,00067,India
879221,2023-07-06,709,notebook,30,60,30,1,00432,India
459893,2023-07-06,714,carbon paper,15,30,15,1,00231,India
459893,2023-07-06,702,pencil,2,5,3,1,00231,India
459893,2023-07-06,704,scale,5,10,5,1,00231,India
459893,2023-07-06,709,notebook,30,60,30,1,00231,India
288342,2023-07-06,709,notebook,30,60,30,1,00205,India
288342,2023-07-06,702,pencil,2,5,3,1,00205,India
755330,2023-07-06,708,sketchpen,15,40,25,1,00126,India
755330,2023-07-06,710,geometry box,100,150,50,1,00126,India
755330,2023-07-06,702,pencil,2,5,3,1,00126,India
755330,2023-07-06,711,TD kit,150,300,150,1,00126,India
755330,2023-07-06,714,carbon paper,15,30,15,1,00126,India
653003,2023-07-06,705,stencil,10,20,10,1,00243,India
653003,2023-07-06,715,folder,5,15,10,1,00243,India
653003,2023-07-06,716,printing paper,200,400,200,1,00243,India
798674,2023-07-07,702,pencil,2,5,3,1,00076,India
311936,2023-07-07,710,geometry box,100,150,50,1,00023,India
311936,2023-07-07,703,eraser,1,3,2,1,00023,India
311936,2023-07-07,716,printing paper,200,400,200,1,00023,India
561013,2023-07-07,702,pencil,2,5,3,1,00303,India
561013,2023-07-07,713,ball pen,5,10,5,1,00303,India
561013,2023-07-07,704,scale,5,10,5,1,00303,India
561013,2023-07-07,710,geometry box,100,150,50,1,00303,India
937361,2023-07-07,709,notebook,30,60,30,1,00106,India
937361,2023-07-07,715,folder,5,15,10,1,00106,India
937361,2023-07-07,710,geometry box,100,150,50,1,00106,India
813279,2023-07-07,703,eraser,1,3,2,1,00026,India
813279,2023-07-07,702,pencil,2,5,3,1,00026,India
813279,2023-07-07,717,spiral bound book,50,100,50,1,00026,India
522945,2023-07-07,710,geometry box,100,150,50,1,00076,India
522945,2023-07-07,709,notebook,30,60,30,1,00076,India
522945,2023-07-07,712,graph paper,20,40,20,1,00076,India
522945,2023-07-07,717,spiral bound book,50,100,50,1,00076,India
165697,2023-07-07,711,TD kit,150,300,150,1,00296,India
165697,2023-07-07,708,sketchpen,15,40,25,1,00296,India
165697,2023-07-07,702,pencil,2,5,3,1,00296,India
165697,2023-07-07,712,graph paper,20,40,20,1,00296,India
157164,2023-07-07,713,ball pen,5,10,5,1,00464,India
157164,2023-07-07,704,scale,5,10,5,1,00464,India
157164,2023-07-07,715,folder,5,15,10,1,00464,India
157164,2023-07-07,716,printing paper,200,400,200,1,00464,India
112974,2023-07-07,716,printing paper,200,400,200,1,00362,India
112974,2023-07-07,701,gel pen,5,10,5,1,00362,India
112974,2023-07-07,706,sharpener,3,8,5,1,00362,India
112974,2023-07-07,703,eraser,1,3,2,1,00362,India
382513,2023-07-07,706,sharpener,3,8,5,1,00422,India
796768,2023-07-07,712,graph paper,20,40,20,1,00373,India
796768,2023-07-07,703,eraser,1,3,2,1,00373,India
796768,2023-07-07,709,notebook,30,60,30,1,00373,India
796768,2023-07-07,710,geometry box,100,150,50,1,00373,India
291377,2023-07-07,713,ball pen,5,10,5,1,00074,India
291377,2023-07-07,706,sharpener,3,8,5,1,00074,India
291377,2023-07-07,708,sketchpen,15,40,25,1,00074,India
291377,2023-07-07,717,spiral bound book,50,100,50,1,00074,India
291377,2023-07-07,702,pencil,2,5,3,1,00074,India
741827,2023-07-07,712,graph paper,20,40,20,1,00434,India
741827,2023-07-07,715,folder,5,15,10,1,00434,India
741827,2023-07-07,703,eraser,1,3,2,1,00434,India
741827,2023-07-07,702,pencil,2,5,3,1,00434,India
813623,2023-07-07,706,sharpener,3,8,5,1,00293,India
813623,2023-07-07,703,eraser,1,3,2,1,00293,India
813623,2023-07-07,705,stencil,10,20,10,1,00293,India
654587,2023-07-07,709,notebook,30,60,30,1,00067,India
916982,2023-07-07,712,graph paper,20,40,20,1,00036,India
872350,2023-07-07,711,TD kit,150,300,150,1,00131,India
872350,2023-07-07,715,folder,5,15,10,1,00131,India
748563,2023-07-07,707,marker,20,40,20,1,00358,India
748563,2023-07-07,702,pencil,2,5,3,1,00358,India
260023,2023-07-07,704,scale,5,10,5,1,00421,India
573381,2023-07-07,705,stencil,10,20,10,1,00332,India
573381,2023-07-07,714,carbon paper,15,30,15,1,00332,India
573381,2023-07-07,704,scale,5,10,5,1,00332,India
657223,2023-07-07,708,sketchpen,15,40,25,1,00222,India
657223,2023-07-07,701,gel pen,5,10,5,1,00222,India
657223,2023-07-07,705,stencil,10,20,10,1,00222,India
657223,2023-07-07,712,graph paper,20,40,20,1,00222,India
800189,2023-07-07,709,notebook,30,60,30,1,00319,India
800189,2023-07-07,703,eraser,1,3,2,1,00319,India
270615,2023-07-07,708,sketchpen,15,40,25,1,00066,India
270615,2023-07-07,705,stencil,10,20,10,1,00066,India
270615,2023-07-07,706,sharpener,3,8,5,1,00066,India
270615,2023-07-07,709,notebook,30,60,30,1,00066,India
275354,2023-07-07,706,sharpener,3,8,5,1,00155,India
356134,2023-07-07,709,notebook,30,60,30,1,00242,India
356134,2023-07-07,710,geometry box,100,150,50,1,00242,India
896215,2023-07-07,709,notebook,30,60,30,1,00149,India
896215,2023-07-07,715,folder,5,15,10,1,00149,India
621827,2023-07-07,707,marker,20,40,20,1,00361,India
621827,2023-07-07,703,eraser,1,3,2,1,00361,India
173975,2023-07-07,714,carbon paper,15,30,15,1,00318,India
173975,2023-07-07,703,eraser,1,3,2,1,00318,India
173975,2023-07-07,715,folder,5,15,10,1,00318,India
677578,2023-07-07,714,carbon paper,15,30,15,1,00354,India
677578,2023-07-07,710,geometry box,100,150,50,1,00354,India
677578,2023-07-07,706,sharpener,3,8,5,1,00354,India
845739,2023-07-07,707,marker,20,40,20,1,00302,India
500358,2023-07-07,715,folder,5,15,10,1,00078,India
500358,2023-07-07,703,eraser,1,3,2,1,00078,India
500358,2023-07-07,717,spiral bound book,50,100,50,1,00078,India
500358,2023-07-07,702,pencil,2,5,3,1,00078,India
257977,2023-07-07,709,notebook,30,60,30,1,00492,India
257977,2023-07-07,716,printing paper,200,400,200,1,00492,India
211149,2023-07-07,717,spiral bound book,50,100,50,1,00017,India
211149,2023-07-07,711,TD kit,150,300,150,1,00017,India
211149,2023-07-07,706,sharpener,3,8,5,1,00017,India
211149,2023-07-07,713,ball pen,5,10,5,1,00017,India
779977,2023-07-07,705,stencil,10,20,10,1,00056,India
779977,2023-07-07,716,printing paper,200,400,200,1,00056,India
901335,2023-07-07,715,folder,5,15,10,1,00018,India
901335,2023-07-07,717,spiral bound book,50,100,50,1,00018,India
901335,2023-07-07,701,gel pen,5,10,5,1,00018,India
901335,2023-07-07,716,printing paper,200,400,200,1,00018,India
901335,2023-07-07,707,marker,20,40,20,1,00018,India
392000,2023-07-07,714,carbon paper,15,30,15,1,00228,India
392000,2023-07-07,715,folder,5,15,10,1,00228,India
392000,2023-07-07,708,sketchpen,15,40,25,1,00228,India
603671,2023-07-07,716,printing paper,200,400,200,1,00385,India
603671,2023-07-07,710,geometry box,100,150,50,1,00385,India
603671,2023-07-07,711,TD kit,150,300,150,1,00385,India
603671,2023-07-07,713,ball pen,5,10,5,1,00385,India
211474,2023-07-07,717,spiral bound book,50,100,50,1,00020,India
683164,2023-07-07,703,eraser,1,3,2,1,00054,India
683164,2023-07-07,712,graph paper,20,40,20,1,00054,India
683164,2023-07-07,710,geometry box,100,150,50,1,00054,India
969164,2023-07-07,703,eraser,1,3,2,1,00076,India
969164,2023-07-07,716,printing paper,200,400,200,1,00076,India
481237,2023-07-07,704,scale,5,10,5,1,00307,India
481237,2023-07-07,716,printing paper,200,400,200,1,00307,India
995159,2023-07-07,713,ball pen,5,10,5,1,00475,India
995159,2023-07-07,716,printing paper,200,400,200,1,00475,India
995159,2023-07-07,703,eraser,1,3,2,1,00475,India
995159,2023-07-07,705,stencil,10,20,10,1,00475,India
801706,2023-07-08,708,sketchpen,15,40,25,1,00045,India
801706,2023-07-08,713,ball pen,5,10,5,1,00045,India
801706,2023-07-08,702,pencil,2,5,3,1,00045,India
801706,2023-07-08,709,notebook,30,60,30,1,00045,India
801706,2023-07-08,707,marker,20,40,20,1,00045,India
634963,2023-07-08,705,stencil,10,20,10,1,00322,India
884271,2023-07-08,707,marker,20,40,20,1,00292,India
332731,2023-07-08,708,sketchpen,15,40,25,1,00183,India
142784,2023-07-08,708,sketchpen,15,40,25,1,00476,India
142784,2023-07-08,716,printing paper,200,400,200,1,00476,India
142784,2023-07-08,707,marker,20,40,20,1,00476,India
142784,2023-07-08,706,sharpener,3,8,5,1,00476,India
698000,2023-07-08,713,ball pen,5,10,5,1,00075,India
698000,2023-07-08,716,printing paper,200,400,200,1,00075,India
698000,2023-07-08,715,folder,5,15,10,1,00075,India
698000,2023-07-08,706,sharpener,3,8,5,1,00075,India
698000,2023-07-08,702,pencil,2,5,3,1,00075,India
270231,2023-07-08,706,sharpener,3,8,5,1,00034,India
270231,2023-07-08,716,printing paper,200,400,200,1,00034,India
270231,2023-07-08,708,sketchpen,15,40,25,1,00034,India
747396,2023-07-08,710,geometry box,100,150,50,1,00385,India
747396,2023-07-08,711,TD kit,150,300,150,1,00385,India
747396,2023-07-08,715,folder,5,15,10,1,00385,India
747396,2023-07-08,701,gel pen,5,10,5,1,00385,India
747396,2023-07-08,713,ball pen,5,10,5,1,00385,India
950405,2023-07-08,715,folder,5,15,10,1,00417,India
950405,2023-07-08,701,gel pen,5,10,5,1,00417,India
950405,2023-07-08,702,pencil,2,5,3,1,00417,India
950405,2023-07-08,716,printing paper,200,400,200,1,00417,India
686670,2023-07-08,710,geometry box,100,150,50,1,00240,India
686670,2023-07-08,715,folder,5,15,10,1,00240,India
686670,2023-07-08,711,TD kit,150,300,150,1,00240,India
517157,2023-07-08,710,geometry box,100,150,50,1,00350,India
517157,2023-07-08,716,printing paper,200,400,200,1,00350,India
901062,2023-07-08,707,marker,20,40,20,1,00140,India
901062,2023-07-08,702,pencil,2,5,3,1,00140,India
333086,2023-07-08,717,spiral bound book,50,100,50,1,00224,India
333086,2023-07-08,711,TD kit,150,300,150,1,00224,India
815987,2023-07-08,706,sharpener,3,8,5,1,00414,India
815987,2023-07-08,716,printing paper,200,400,200,1,00414,India
815987,2023-07-08,703,eraser,1,3,2,1,00414,India
815987,2023-07-08,713,ball pen,5,10,5,1,00414,India
815987,2023-07-08,717,spiral bound book,50,100,50,1,00414,India
185964,2023-07-08,713,ball pen,5,10,5,1,00487,India
185964,2023-07-08,701,gel pen,5,10,5,1,00487,India
185964,2023-07-08,709,notebook,30,60,30,1,00487,India
909107,2023-07-08,714,carbon paper,15,30,15,1,00405,India
909107,2023-07-08,708,sketchpen,15,40,25,1,00405,India
584331,2023-07-08,713,ball pen,5,10,5,1,00236,India
584331,2023-07-08,714,carbon paper,15,30,15,1,00236,India
584331,2023-07-08,706,sharpener,3,8,5,1,00236,India
584331,2023-07-08,717,spiral bound book,50,100,50,1,00236,India
584331,2023-07-08,703,eraser,1,3,2,1,00236,India
193692,2023-07-08,709,notebook,30,60,30,1,00011,India
193692,2023-07-08,702,pencil,2,5,3,1,00011,India
193692,2023-07-08,705,stencil,10,20,10,1,00011,India
901130,2023-07-08,704,scale,5,10,5,1,00081,India
901130,2023-07-08,717,spiral bound book,50,100,50,1,00081,India
901130,2023-07-08,709,notebook,30,60,30,1,00081,India
226676,2023-07-08,709,notebook,30,60,30,1,00151,India
365646,2023-07-08,707,marker,20,40,20,1,00068,India
365646,2023-07-08,708,sketchpen,15,40,25,1,00068,India
365646,2023-07-08,717,spiral bound book,50,100,50,1,00068,India
365646,2023-07-08,711,TD kit,150,300,150,1,00068,India
365646,2023-07-08,714,carbon paper,15,30,15,1,00068,India
443686,2023-07-08,710,geometry box,100,150,50,1,00125,India
443686,2023-07-08,712,graph paper,20,40,20,1,00125,India
443686,2023-07-08,714,carbon paper,15,30,15,1,00125,India
443686,2023-07-08,709,notebook,30,60,30,1,00125,India
125452,2023-07-08,703,eraser,1,3,2,1,00402,India
125452,2023-07-08,707,marker,20,40,20,1,00402,India
125452,2023-07-08,704,scale,5,10,5,1,00402,India
125452,2023-07-08,705,stencil,10,20,10,1,00402,India
125452,2023-07-08,711,TD kit,150,300,150,1,00402,India
716065,2023-07-08,709,notebook,30,60,30,1,00274,India
716065,2023-07-08,708,sketchpen,15,40,25,1,00274,India
716065,2023-07-08,715,folder,5,15,10,1,00274,India
716065,2023-07-08,702,pencil,2,5,3,1,00274,India
139989,2023-07-08,702,pencil,2,5,3,1,00270,India
139989,2023-07-08,712,graph paper,20,40,20,1,00270,India
144119,2023-07-08,712,graph paper,20,40,20,1,00369,India
140672,2023-07-08,703,eraser,1,3,2,1,00076,India
140672,2023-07-08,708,sketchpen,15,40,25,1,00076,India
140672,2023-07-08,715,folder,5,15,10,1,00076,India
654539,2023-07-08,715,folder,5,15,10,1,00103,India
654539,2023-07-08,712,graph paper,20,40,20,1,00103,India
654539,2023-07-08,704,scale,5,10,5,1,00103,India
654539,2023-07-08,705,stencil,10,20,10,1,00103,India
659007,2023-07-08,706,sharpener,3,8,5,1,00408,India
659007,2023-07-08,708,sketchpen,15,40,25,1,00408,India
659007,2023-07-08,713,ball pen,5,10,5,1,00408,India
503991,2023-07-08,701,gel pen,5,10,5,1,00300,India
503991,2023-07-08,713,ball pen,5,10,5,1,00300,India
503991,2023-07-08,711,TD kit,150,300,150,1,00300,India
541913,2023-07-08,704,scale,5,10,5,1,00152,India
541913,2023-07-08,716,printing paper,200,400,200,1,00152,India
541913,2023-07-08,715,folder,5,15,10,1,00152,India
644260,2023-07-08,706,sharpener,3,8,5,1,00482,India
644260,2023-07-08,716,printing paper,200,400,200,1,00482,India
831936,2023-07-08,705,stencil,10,20,10,1,00428,India
425009,2023-07-08,702,pencil,2,5,3,1,00376,India
425009,2023-07-08,713,ball pen,5,10,5,1,00376,India
425009,2023-07-08,709,notebook,30,60,30,1,00376,India
183164,2023-07-08,702,pencil,2,5,3,1,00057,India
183164,2023-07-08,703,eraser,1,3,2,1,00057,India
183164,2023-07-08,707,marker,20,40,20,1,00057,India
260309,2023-07-08,716,printing paper,200,400,200,1,00042,India
260309,2023-07-08,705,stencil,10,20,10,1,00042,India
260309,2023-07-08,714,carbon paper,15,30,15,1,00042,India
260309,2023-07-08,715,folder,5,15,10,1,00042,India
704191,2023-07-08,707,marker,20,40,20,1,00440,India
704191,2023-07-08,710,geometry box,100,150,50,1,00440,India
704191,2023-07-08,716,printing paper,200,400,200,1,00440,India
212609,2023-07-08,716,printing paper,200,400,200,1,00377,India
212609,2023-07-08,703,eraser,1,3,2,1,00377,India
419238,2023-07-08,717,spiral bound book,50,100,50,1,00024,India
419238,2023-07-08,712,graph paper,20,40,20,1,00024,India
419238,2023-07-08,704,scale,5,10,5,1,00024,India
419238,2023-07-08,709,notebook,30,60,30,1,00024,India
419238,2023-07-08,707,marker,20,40,20,1,00024,India
541451,2023-07-08,717,spiral bound book,50,100,50,1,00350,India
541451,2023-07-08,703,eraser,1,3,2,1,00350,India
541451,2023-07-08,711,TD kit,150,300,150,1,00350,India
541451,2023-07-08,708,sketchpen,15,40,25,1,00350,India
451072,2023-07-08,715,folder,5,15,10,1,00438,India
451072,2023-07-08,702,pencil,2,5,3,1,00438,India
313591,2023-07-08,705,stencil,10,20,10,1,00172,India
313591,2023-07-08,716,printing paper,200,400,200,1,00172,India
313591,2023-07-08,706,sharpener,3,8,5,1,00172,India
313591,2023-07-08,703,eraser,1,3,2,1,00172,India
313591,2023-07-08,717,spiral bound book,50,100,50,1,00172,India
809403,2023-07-08,705,stencil,10,20,10,1,00386,India
809403,2023-07-08,715,folder,5,15,10,1,00386,India
809403,2023-07-08,713,ball pen,5,10,5,1,00386,India
809403,2023-07-08,703,eraser,1,3,2,1,00386,India
313462,2023-07-08,712,graph paper,20,40,20,1,00108,India
313462,2023-07-08,704,scale,5,10,5,1,00108,India
313462,2023-07-08,717,spiral bound book,50,100,50,1,00108,India
890539,2023-07-09,710,geometry box,100,150,50,1,00426,India
731567,2023-07-09,703,eraser,1,3,2,1,00496,India
731567,2023-07-09,701,gel pen,5,10,5,1,00496,India
731567,2023-07-09,713,ball pen,5,10,5,1,00496,India
731567,2023-07-09,702,pencil,2,5,3,1,00496,India
731567,2023-07-09,712,graph paper,20,40,20,1,00496,India
312726,2023-07-09,702,pencil,2,5,3,1,00409,India
845814,2023-07-09,701,gel pen,5,10,5,1,00104,India
845814,2023-07-09,710,geometry box,100,150,50,1,00104,India
845814,2023-07-09,716,printing paper,200,400,200,1,00104,India
207788,2023-07-09,707,marker,20,40,20,1,00219,India
207788,2023-07-09,714,carbon paper,15,30,15,1,00219,India
207788,2023-07-09,713,ball pen,5,10,5,1,00219,India
207788,2023-07-09,704,scale,5,10,5,1,00219,India
166913,2023-07-09,706,sharpener,3,8,5,1,00452,India
166913,2023-07-09,716,printing paper,200,400,200,1,00452,India
805944,2023-07-09,712,graph paper,20,40,20,1,00395,India
805944,2023-07-09,707,marker,20,40,20,1,00395,India
805944,2023-07-09,706,sharpener,3,8,5,1,00395,India
309663,2023-07-09,712,graph paper,20,40,20,1,00235,India
309663,2023-07-09,714,carbon paper,15,30,15,1,00235,India
309663,2023-07-09,704,scale,5,10,5,1,00235,India
439513,2023-07-09,713,ball pen,5,10,5,1,00449,India
439513,2023-07-09,703,eraser,1,3,2,1,00449,India
439513,2023-07-09,707,marker,20,40,20,1,00449,India
893149,2023-07-09,706,sharpener,3,8,5,1,00067,India
893149,2023-07-09,712,graph paper,20,40,20,1,00067,India
893149,2023-07-09,703,eraser,1,3,2,1,00067,India
530301,2023-07-09,706,sharpener,3,8,5,1,00466,India
530301,2023-07-09,703,eraser,1,3,2,1,00466,India
530301,2023-07-09,705,stencil,10,20,10,1,00466,India
530301,2023-07-09,715,folder,5,15,10,1,00466,India
773550,2023-07-09,711,TD kit,150,300,150,1,00147,India
773550,2023-07-09,709,notebook,30,60,30,1,00147,India
773550,2023-07-09,710,geometry box,100,150,50,1,00147,India
876676,2023-07-09,711,TD kit,150,300,150,1,00345,India
876676,2023-07-09,708,sketchpen,15,40,25,1,00345,India
876676,2023-07-09,704,scale,5,10,5,1,00345,India
876676,2023-07-09,702,pencil,2,5,3,1,00345,India
876676,2023-07-09,701,gel pen,5,10,5,1,00345,India
368578,2023-07-09,716,printing paper,200,400,200,1,00297,India
368578,2023-07-09,712,graph paper,20,40,20,1,00297,India
674308,2023-07-09,716,printing paper,200,400,200,1,00385,India
674308,2023-07-09,707,marker,20,40,20,1,00385,India
674308,2023-07-09,706,sharpener,3,8,5,1,00385,India
674308,2023-07-09,712,graph paper,20,40,20,1,00385,India
802876,2023-07-09,710,geometry box,100,150,50,1,00276,India
802876,2023-07-09,709,notebook,30,60,30,1,00276,India
802876,2023-07-09,717,spiral bound book,50,100,50,1,00276,India
554426,2023-07-09,705,stencil,10,20,10,1,00226,India
554426,2023-07-09,712,graph paper,20,40,20,1,00226,India
554426,2023-07-09,702,pencil,2,5,3,1,00226,India
614877,2023-07-09,707,marker,20,40,20,1,00457,India
614877,2023-07-09,701,gel pen,5,10,5,1,00457,India
614877,2023-07-09,716,printing paper,200,400,200,1,00457,India
750082,2023-07-09,708,sketchpen,15,40,25,1,00195,India
827732,2023-07-09,710,geometry box,100,150,50,1,00117,India
827732,2023-07-09,707,marker,20,40,20,1,00117,India
827732,2023-07-09,717,spiral bound book,50,100,50,1,00117,India
686904,2023-07-09,701,gel pen,5,10,5,1,00269,India
686904,2023-07-09,714,carbon paper,15,30,15,1,00269,India
686904,2023-07-09,716,printing paper,200,400,200,1,00269,India
686904,2023-07-09,717,spiral bound book,50,100,50,1,00269,India
158974,2023-07-09,701,gel pen,5,10,5,1,00499,India
487063,2023-07-09,703,eraser,1,3,2,1,00266,India
116211,2023-07-09,701,gel pen,5,10,5,1,00371,India
116211,2023-07-09,711,TD kit,150,300,150,1,00371,India
116211,2023-07-09,705,stencil,10,20,10,1,00371,India
103950,2023-07-09,708,sketchpen,15,40,25,1,00168,India
177268,2023-07-09,716,printing paper,200,400,200,1,00396,India
177268,2023-07-09,714,carbon paper,15,30,15,1,00396,India
874331,2023-07-09,708,sketchpen,15,40,25,1,00131,India
874331,2023-07-09,707,marker,20,40,20,1,00131,India
885562,2023-07-09,710,geometry box,100,150,50,1,00351,India
555598,2023-07-09,713,ball pen,5,10,5,1,00353,India
418666,2023-07-09,703,eraser,1,3,2,1,00394,India
418666,2023-07-09,705,stencil,10,20,10,1,00394,India
418666,2023-07-09,708,sketchpen,15,40,25,1,00394,India
450012,2023-07-09,713,ball pen,5,10,5,1,00065,India
450012,2023-07-09,704,scale,5,10,5,1,00065,India
450012,2023-07-09,702,pencil,2,5,3,1,00065,India
450012,2023-07-09,716,printing paper,200,400,200,1,00065,India
191086,2023-07-09,708,sketchpen,15,40,25,1,00070,India
191086,2023-07-09,717,spiral bound book,50,100,50,1,00070,India
191086,2023-07-09,714,carbon paper,15,30,15,1,00070,India
814665,2023-07-09,708,sketchpen,15,40,25,1,00031,India
814665,2023-07-09,713,ball pen,5,10,5,1,00031,India
510208,2023-07-09,708,sketchpen,15,40,25,1,00381,India
510208,2023-07-09,706,sharpener,3,8,5,1,00381,India
510208,2023-07-09,710,geometry box,100,150,50,1,00381,India
920581,2023-07-09,715,folder,5,15,10,1,00220,India
920581,2023-07-09,705,stencil,10,20,10,1,00220,India
878671,2023-07-10,714,carbon paper,15,30,15,1,00104,India
878671,2023-07-10,710,geometry box,100,150,50,1,00104,India
878671,2023-07-10,716,printing paper,200,400,200,1,00104,India
835021,2023-07-10,705,stencil,10,20,10,1,00379,India
835021,2023-07-10,710,geometry box,100,150,50,1,00379,India
842963,2023-07-10,703,eraser,1,3,2,1,00221,India
842963,2023-07-10,701,gel pen,5,10,5,1,00221,India
842963,2023-07-10,712,graph paper,20,40,20,1,00221,India
842963,2023-07-10,705,stencil,10,20,10,1,00221,India
891013,2023-07-10,712,graph paper,20,40,20,1,00141,India
903052,2023-07-10,712,graph paper,20,40,20,1,00190,India
903052,2023-07-10,703,eraser,1,3,2,1,00190,India
903052,2023-07-10,706,sharpener,3,8,5,1,00190,India
903052,2023-07-10,711,TD kit,150,300,150,1,00190,India
322747,2023-07-10,705,stencil,10,20,10,1,00008,India
322747,2023-07-10,711,TD kit,150,300,150,1,00008,India
444780,2023-07-10,706,sharpener,3,8,5,1,00210,India
444780,2023-07-10,704,scale,5,10,5,1,00210,India
319830,2023-07-10,711,TD kit,150,300,150,1,00432,India
107569,2023-07-10,710,geometry box,100,150,50,1,00398,India
107569,2023-07-10,708,sketchpen,15,40,25,1,00398,India
593785,2023-07-10,716,printing paper,200,400,200,1,00312,India
591853,2023-07-10,712,graph paper,20,40,20,1,00024,India
591853,2023-07-10,704,scale,5,10,5,1,00024,India
591853,2023-07-10,705,stencil,10,20,10,1,00024,India
591853,2023-07-10,701,gel pen,5,10,5,1,00024,India
191724,2023-07-10,703,eraser,1,3,2,1,00040,India
191724,2023-07-10,702,pencil,2,5,3,1,00040,India
191724,2023-07-10,705,stencil,10,20,10,1,00040,India
191724,2023-07-10,717,spiral bound book,50,100,50,1,00040,India
367463,2023-07-10,703,eraser,1,3,2,1,00184,India
473051,2023-07-10,701,gel pen,5,10,5,1,00367,India
473051,2023-07-10,707,marker,20,40,20,1,00367,India
473051,2023-07-10,706,sharpener,3,8,5,1,00367,India
473051,2023-07-10,708,sketchpen,15,40,25,1,00367,India
477783,2023-07-10,707,marker,20,40,20,1,00354,India
477783,2023-07-10,710,geometry box,100,150,50,1,00354,India
477783,2023-07-10,711,TD kit,150,300,150,1,00354,India
595889,2023-07-10,711,TD kit,150,300,150,1,00157,India
595889,2023-07-10,701,gel pen,5,10,5,1,00157,India
595889,2023-07-10,712,graph paper,20,40,20,1,00157,India
595889,2023-07-10,706,sharpener,3,8,5,1,00157,India
594423,2023-07-10,711,TD kit,150,300,150,1,00302,India
594423,2023-07-10,708,sketchpen,15,40,25,1,00302,India
390013,2023-07-10,701,gel pen,5,10,5,1,00233,India
390013,2023-07-10,716,printing paper,200,400,200,1,00233,India
896700,2023-07-10,709,notebook,30,60,30,1,00148,India
896700,2023-07-10,713,ball pen,5,10,5,1,00148,India
896700,2023-07-10,710,geometry box,100,150,50,1,00148,India
988952,2023-07-10,701,gel pen,5,10,5,1,00052,India
584528,2023-07-10,709,notebook,30,60,30,1,00476,India
584528,2023-07-10,713,ball pen,5,10,5,1,00476,India
649722,2023-07-10,710,geometry box,100,150,50,1,00256,India
767232,2023-07-10,704,scale,5,10,5,1,00172,India
767232,2023-07-10,717,spiral bound book,50,100,50,1,00172,India
767232,2023-07-10,708,sketchpen,15,40,25,1,00172,India
163080,2023-07-10,702,pencil,2,5,3,1,00427,India
163080,2023-07-10,708,sketchpen,15,40,25,1,00427,India
163080,2023-07-10,711,TD kit,150,300,150,1,00427,India
163080,2023-07-10,705,stencil,10,20,10,1,00427,India
163080,2023-07-10,703,eraser,1,3,2,1,00427,India
439974,2023-07-10,716,printing paper,200,400,200,1,00367,India
439974,2023-07-10,714,carbon paper,15,30,15,1,00367,India
439974,2023-07-10,711,TD kit,150,300,150,1,00367,India
439974,2023-07-10,708,sketchpen,15,40,25,1,00367,India
475723,2023-07-10,706,sharpener,3,8,5,1,00131,India
475723,2023-07-10,707,marker,20,40,20,1,00131,India
475723,2023-07-10,715,folder,5,15,10,1,00131,India
475723,2023-07-10,710,geometry box,100,150,50,1,00131,India
475723,2023-07-10,714,carbon paper,15,30,15,1,00131,India
506659,2023-07-10,713,ball pen,5,10,5,1,00209,India
849405,2023-07-10,702,pencil,2,5,3,1,00424,India
233892,2023-07-10,708,sketchpen,15,40,25,1,00060,India
233892,2023-07-10,715,folder,5,15,10,1,00060,India
233892,2023-07-10,705,stencil,10,20,10,1,00060,India
752455,2023-07-10,701,gel pen,5,10,5,1,00424,India
752455,2023-07-10,708,sketchpen,15,40,25,1,00424,India
601629,2023-07-10,713,ball pen,5,10,5,1,00220,India
601629,2023-07-10,715,folder,5,15,10,1,00220,India
601629,2023-07-10,705,stencil,10,20,10,1,00220,India
601629,2023-07-10,707,marker,20,40,20,1,00220,India
885990,2023-07-10,715,folder,5,15,10,1,00293,India
864672,2023-07-10,717,spiral bound book,50,100,50,1,00132,India
864672,2023-07-10,710,geometry box,100,150,50,1,00132,India
934613,2023-07-11,710,geometry box,100,150,50,1,00498,India
934613,2023-07-11,705,stencil,10,20,10,1,00498,India
934613,2023-07-11,715,folder,5,15,10,1,00498,India
934613,2023-07-11,701,gel pen,5,10,5,1,00498,India
870327,2023-07-11,703,eraser,1,3,2,1,00082,India
870327,2023-07-11,708,sketchpen,15,40,25,1,00082,India
870327,2023-07-11,707,marker,20,40,20,1,00082,India
793304,2023-07-11,713,ball pen,5,10,5,1,00493,India
430262,2023-07-11,709,notebook,30,60,30,1,00063,India
430262,2023-07-11,713,ball pen,5,10,5,1,00063,India
641985,2023-07-11,701,gel pen,5,10,5,1,00036,India
641985,2023-07-11,717,spiral bound book,50,100,50,1,00036,India
641985,2023-07-11,703,eraser,1,3,2,1,00036,India
641985,2023-07-11,709,notebook,30,60,30,1,00036,India
515751,2023-07-11,712,graph paper,20,40,20,1,00093,India
515751,2023-07-11,704,scale,5,10,5,1,00093,India
515751,2023-07-11,708,sketchpen,15,40,25,1,00093,India
515751,2023-07-11,701,gel pen,5,10,5,1,00093,India
515751,2023-07-11,716,printing paper,200,400,200,1,00093,India
583314,2023-07-11,709,notebook,30,60,30,1,00002,India
583314,2023-07-11,702,pencil,2,5,3,1,00002,India
301534,2023-07-11,708,sketchpen,15,40,25,1,00368,India
399018,2023-07-11,701,gel pen,5,10,5,1,00373,India
399018,2023-07-11,716,printing paper,200,400,200,1,00373,India
842393,2023-07-11,703,eraser,1,3,2,1,00128,India
445260,2023-07-11,716,printing paper,200,400,200,1,00195,India
445260,2023-07-11,709,notebook,30,60,30,1,00195,India
445260,2023-07-11,705,stencil,10,20,10,1,00195,India
511003,2023-07-11,711,TD kit,150,300,150,1,00229,India
130204,2023-07-11,705,stencil,10,20,10,1,00237,India
541332,2023-07-11,716,printing paper,200,400,200,1,00046,India
541332,2023-07-11,707,marker,20,40,20,1,00046,India
797411,2023-07-11,706,sharpener,3,8,5,1,00161,India
797411,2023-07-11,709,notebook,30,60,30,1,00161,India
797411,2023-07-11,717,spiral bound book,50,100,50,1,00161,India
797411,2023-07-11,708,sketchpen,15,40,25,1,00161,India
814094,2023-07-11,710,geometry box,100,150,50,1,00291,India
814094,2023-07-11,704,scale,5,10,5,1,00291,India
619486,2023-07-11,716,printing paper,200,400,200,1,00005,India
619486,2023-07-11,712,graph paper,20,40,20,1,00005,India
619486,2023-07-11,707,marker,20,40,20,1,00005,India
619486,2023-07-11,714,carbon paper,15,30,15,1,00005,India
265863,2023-07-11,710,geometry box,100,150,50,1,00157,India
832913,2023-07-11,702,pencil,2,5,3,1,00097,India
832913,2023-07-11,714,carbon paper,15,30,15,1,00097,India
832913,2023-07-11,701,gel pen,5,10,5,1,00097,India
832913,2023-07-11,708,sketchpen,15,40,25,1,00097,India
915486,2023-07-11,714,carbon paper,15,30,15,1,00305,India
915486,2023-07-11,715,folder,5,15,10,1,00305,India
915486,2023-07-11,710,geometry box,100,150,50,1,00305,India
915486,2023-07-11,713,ball pen,5,10,5,1,00305,India
915486,2023-07-11,701,gel pen,5,10,5,1,00305,India
624227,2023-07-11,715,folder,5,15,10,1,00143,India
624227,2023-07-11,701,gel pen,5,10,5,1,00143,India
624227,2023-07-11,708,sketchpen,15,40,25,1,00143,India
624227,2023-07-11,707,marker,20,40,20,1,00143,India
624227,2023-07-11,712,graph paper,20,40,20,1,00143,India
253367,2023-07-11,710,geometry box,100,150,50,1,00334,India
253367,2023-07-11,707,marker,20,40,20,1,00334,India
253367,2023-07-11,706,sharpener,3,8,5,1,00334,India
253367,2023-07-11,716,printing paper,200,400,200,1,00334,India
253367,2023-07-11,711,TD kit,150,300,150,1,00334,India
565286,2023-07-11,706,sharpener,3,8,5,1,00192,India
565286,2023-07-11,710,geometry box,100,150,50,1,00192,India
565286,2023-07-11,707,marker,20,40,20,1,00192,India
565286,2023-07-11,715,folder,5,15,10,1,00192,India
565286,2023-07-11,711,TD kit,150,300,150,1,00192,India
264325,2023-07-11,707,marker,20,40,20,1,00170,India
264325,2023-07-11,702,pencil,2,5,3,1,00170,India
827656,2023-07-11,707,marker,20,40,20,1,00075,India
827656,2023-07-11,716,printing paper,200,400,200,1,00075,India
282692,2023-07-11,706,sharpener,3,8,5,1,00340,India
282692,2023-07-11,715,folder,5,15,10,1,00340,India
191201,2023-07-11,715,folder,5,15,10,1,00227,India
191201,2023-07-11,702,pencil,2,5,3,1,00227,India
271024,2023-07-11,707,marker,20,40,20,1,00479,India
271024,2023-07-11,716,printing paper,200,400,200,1,00479,India
271024,2023-07-11,702,pencil,2,5,3,1,00479,India
271024,2023-07-11,703,eraser,1,3,2,1,00479,India
553505,2023-07-11,716,printing paper,200,400,200,1,00465,India
553505,2023-07-11,713,ball pen,5,10,5,1,00465,India
553505,2023-07-11,705,stencil,10,20,10,1,00465,India
801880,2023-07-11,707,marker,20,40,20,1,00439,India
801880,2023-07-11,712,graph paper,20,40,20,1,00439,India
801880,2023-07-11,709,notebook,30,60,30,1,00439,India
801880,2023-07-11,713,ball pen,5,10,5,1,00439,India
801880,2023-07-11,702,pencil,2,5,3,1,00439,India
246394,2023-07-11,714,carbon paper,15,30,15,1,00089,India
246394,2023-07-11,706,sharpener,3,8,5,1,00089,India
246394,2023-07-11,703,eraser,1,3,2,1,00089,India
246394,2023-07-11,707,marker,20,40,20,1,00089,India
516258,2023-07-11,714,carbon paper,15,30,15,1,00347,India
516258,2023-07-11,701,gel pen,5,10,5,1,00347,India
516258,2023-07-11,708,sketchpen,15,40,25,1,00347,India
516258,2023-07-11,717,spiral bound book,50,100,50,1,00347,India
798489,2023-07-11,708,sketchpen,15,40,25,1,00094,India
798489,2023-07-11,702,pencil,2,5,3,1,00094,India
116967,2023-07-11,709,notebook,30,60,30,1,00499,India
116967,2023-07-11,717,spiral bound book,50,100,50,1,00499,India
116967,2023-07-11,715,folder,5,15,10,1,00499,India
116967,2023-07-11,713,ball pen,5,10,5,1,00499,India
397856,2023-07-11,710,geometry box,100,150,50,1,00262,India
397856,2023-07-11,701,gel pen,5,10,5,1,00262,India
247147,2023-07-12,701,gel pen,5,10,5,1,00265,India
247147,2023-07-12,712,graph paper,20,40,20,1,00265,India
247147,2023-07-12,706,sharpener,3,8,5,1,00265,India
247147,2023-07-12,710,geometry box,100,150,50,1,00265,India
803341,2023-07-12,703,eraser,1,3,2,1,00247,India
803341,2023-07-12,707,marker,20,40,20,1,00247,India
803341,2023-07-12,701,gel pen,5,10,5,1,00247,India
906717,2023-07-12,701,gel pen,5,10,5,1,00135,India
311728,2023-07-12,717,spiral bound book,50,100,50,1,00332,India
311728,2023-07-12,713,ball pen,5,10,5,1,00332,India
311728,2023-07-12,712,graph paper,20,40,20,1,00332,India
642437,2023-07-12,703,eraser,1,3,2,1,00283,India
642437,2023-07-12,707,marker,20,40,20,1,00283,India
642437,2023-07-12,710,geometry box,100,150,50,1,00283,India
642437,2023-07-12,712,graph paper,20,40,20,1,00283,India
671204,2023-07-12,710,geometry box,100,150,50,1,00383,India
671204,2023-07-12,713,ball pen,5,10,5,1,00383,India
671204,2023-07-12,715,folder,5,15,10,1,00383,India
668801,2023-07-12,703,eraser,1,3,2,1,00447,India
668801,2023-07-12,712,graph paper,20,40,20,1,00447,India
668801,2023-07-12,708,sketchpen,15,40,25,1,00447,India
668801,2023-07-12,709,notebook,30,60,30,1,00447,India
586115,2023-07-12,701,gel pen,5,10,5,1,00098,India
586115,2023-07-12,713,ball pen,5,10,5,1,00098,India
586115,2023-07-12,704,scale,5,10,5,1,00098,India
586115,2023-07-12,707,marker,20,40,20,1,00098,India
307217,2023-07-12,709,notebook,30,60,30,1,00392,India
607583,2023-07-12,705,stencil,10,20,10,1,00081,India
298417,2023-07-12,711,TD kit,150,300,150,1,00362,India
298417,2023-07-12,713,ball pen,5,10,5,1,00362,India
298417,2023-07-12,709,notebook,30,60,30,1,00362,India
298417,2023-07-12,712,graph paper,20,40,20,1,00362,India
447098,2023-07-12,710,geometry box,100,150,50,1,00415,India
447098,2023-07-12,711,TD kit,150,300,150,1,00415,India
447098,2023-07-12,709,notebook,30,60,30,1,00415,India
447098,2023-07-12,716,printing paper,200,400,200,1,00415,India
913325,2023-07-12,711,TD kit,150,300,150,1,00115,India
913325,2023-07-12,714,carbon paper,15,30,15,1,00115,India
913325,2023-07-12,712,graph paper,20,40,20,1,00115,India
913325,2023-07-12,710,geometry box,100,150,50,1,00115,India
913325,2023-07-12,704,scale,5,10,5,1,00115,India
452349,2023-07-12,711,TD kit,150,300,150,1,00246,India
301915,2023-07-12,702,pencil,2,5,3,1,00423,India
301915,2023-07-12,715,folder,5,15,10,1,00423,India
778331,2023-07-12,701,gel pen,5,10,5,1,00170,India
778331,2023-07-12,716,printing paper,200,400,200,1,00170,India
778331,2023-07-12,710,geometry box,100,150,50,1,00170,India
333567,2023-07-12,711,TD kit,150,300,150,1,00480,India
333567,2023-07-12,703,eraser,1,3,2,1,00480,India
333567,2023-07-12,716,printing paper,200,400,200,1,00480,India
231876,2023-07-12,711,TD kit,150,300,150,1,00280,India
451954,2023-07-12,705,stencil,10,20,10,1,00125,India
196976,2023-07-12,701,gel pen,5,10,5,1,00214,India
196976,2023-07-12,708,sketchpen,15,40,25,1,00214,India
196976,2023-07-12,711,TD kit,150,300,150,1,00214,India
532141,2023-07-12,716,printing paper,200,400,200,1,00250,India
532141,2023-07-12,706,sharpener,3,8,5,1,00250,India
532141,2023-07-12,707,marker,20,40,20,1,00250,India
532141,2023-07-12,713,ball pen,5,10,5,1,00250,India
606264,2023-07-12,706,sharpener,3,8,5,1,00159,India
606264,2023-07-12,703,eraser,1,3,2,1,00159,India
286918,2023-07-12,710,geometry box,100,150,50,1,00380,India
286918,2023-07-12,716,printing paper,200,400,200,1,00380,India
286918,2023-07-12,702,pencil,2,5,3,1,00380,India
286918,2023-07-12,711,TD kit,150,300,150,1,00380,India
899861,2023-07-12,709,notebook,30,60,30,1,00495,India
899861,2023-07-12,714,carbon paper,15,30,15,1,00495,India
899861,2023-07-12,707,marker,20,40,20,1,00495,India
899861,2023-07-12,701,gel pen,5,10,5,1,00495,India
899861,2023-07-12,710,geometry box,100,150,50,1,00495,India
144144,2023-07-12,706,sharpener,3,8,5,1,00297,India
144144,2023-07-12,713,ball pen,5,10,5,1,00297,India
669927,2023-07-12,710,geometry box,100,150,50,1,00133,India
669927,2023-07-12,706,sharpener,3,8,5,1,00133,India
669927,2023-07-12,707,marker,20,40,20,1,00133,India
805275,2023-07-12,714,carbon paper,15,30,15,1,00162,India
460199,2023-07-12,712,graph paper,20,40,20,1,00192,India
460199,2023-07-12,706,sharpener,3,8,5,1,00192,India
460199,2023-07-12,713,ball pen,5,10,5,1,00192,India
460199,2023-07-12,705,stencil,10,20,10,1,00192,India
721663,2023-07-12,710,geometry box,100,150,50,1,00098,India
721663,2023-07-12,708,sketchpen,15,40,25,1,00098,India
721663,2023-07-12,709,notebook,30,60,30,1,00098,India
721663,2023-07-12,703,eraser,1,3,2,1,00098,India
225368,2023-07-12,711,TD kit,150,300,150,1,00028,India
225368,2023-07-12,703,eraser,1,3,2,1,00028,India
225368,2023-07-12,716,printing paper,200,400,200,1,00028,India
225368,2023-07-12,705,stencil,10,20,10,1,00028,India
589166,2023-07-12,702,pencil,2,5,3,1,00211,India
589166,2023-07-12,715,folder,5,15,10,1,00211,India
589166,2023-07-12,708,sketchpen,15,40,25,1,00211,India
589166,2023-07-12,704,scale,5,10,5,1,00211,India
752536,2023-07-12,712,graph paper,20,40,20,1,00013,India
752536,2023-07-12,713,ball pen,5,10,5,1,00013,India
752536,2023-07-12,715,folder,5,15,10,1,00013,India
752536,2023-07-12,716,printing paper,200,400,200,1,00013,India
900848,2023-07-12,714,carbon paper,15,30,15,1,00462,India
900848,2023-07-12,701,gel pen,5,10,5,1,00462,India
900848,2023-07-12,716,printing paper,200,400,200,1,00462,India
900848,2023-07-12,703,eraser,1,3,2,1,00462,India
263749,2023-07-12,704,scale,5,10,5,1,00402,India
263749,2023-07-12,712,graph paper,20,40,20,1,00402,India
437989,2023-07-12,706,sharpener,3,8,5,1,00119,India
949277,2023-07-12,702,pencil,2,5,3,1,00034,India
949277,2023-07-12,708,sketchpen,15,40,25,1,00034,India
731194,2023-07-12,716,printing paper,200,400,200,1,00380,India
683775,2023-07-12,717,spiral bound book,50,100,50,1,00137,India
683775,2023-07-12,713,ball pen,5,10,5,1,00137,India
683775,2023-07-12,711,TD kit,150,300,150,1,00137,India
683775,2023-07-12,710,geometry box,100,150,50,1,00137,India
683775,2023-07-12,703,eraser,1,3,2,1,00137,India
509090,2023-07-12,714,carbon paper,15,30,15,1,00252,India
509090,2023-07-12,706,sharpener,3,8,5,1,00252,India
509090,2023-07-12,704,scale,5,10,5,1,00252,India
509090,2023-07-12,705,stencil,10,20,10,1,00252,India
916197,2023-07-12,715,folder,5,15,10,1,00019,India
916197,2023-07-12,707,marker,20,40,20,1,00019,India
916197,2023-07-12,705,stencil,10,20,10,1,00019,India
675912,2023-07-12,706,sharpener,3,8,5,1,00101,India
675912,2023-07-12,703,eraser,1,3,2,1,00101,India
675912,2023-07-12,711,TD kit,150,300,150,1,00101,India
675912,2023-07-12,701,gel pen,5,10,5,1,00101,India
417627,2023-07-12,706,sharpener,3,8,5,1,00234,India
417627,2023-07-12,715,folder,5,15,10,1,00234,India
417627,2023-07-12,704,scale,5,10,5,1,00234,India
417627,2023-07-12,713,ball pen,5,10,5,1,00234,India
825041,2023-07-12,711,TD kit,150,300,150,1,00169,India
825041,2023-07-12,702,pencil,2,5,3,1,00169,India
825041,2023-07-12,717,spiral bound book,50,100,50,1,00169,India
825041,2023-07-12,713,ball pen,5,10,5,1,00169,India
825041,2023-07-12,703,eraser,1,3,2,1,00169,India
738793,2023-07-13,702,pencil,2,5,3,1,00148,India
145189,2023-07-13,713,ball pen,5,10,5,1,00247,India
145189,2023-07-13,717,spiral bound book,50,100,50,1,00247,India
145189,2023-07-13,716,printing paper,200,400,200,1,00247,India
145189,2023-07-13,703,eraser,1,3,2,1,00247,India
819379,2023-07-13,714,carbon paper,15,30,15,1,00428,India
254585,2023-07-13,707,marker,20,40,20,1,00153,India
254585,2023-07-13,704,scale,5,10,5,1,00153,India
254585,2023-07-13,716,printing paper,200,400,200,1,00153,India
254585,2023-07-13,702,pencil,2,5,3,1,00153,India
798884,2023-07-13,711,TD kit,150,300,150,1,00252,India
798884,2023-07-13,714,carbon paper,15,30,15,1,00252,India
530830,2023-07-13,713,ball pen,5,10,5,1,00155,India
530830,2023-07-13,705,stencil,10,20,10,1,00155,India
869731,2023-07-13,701,gel pen,5,10,5,1,00468,India
869731,2023-07-13,706,sharpener,3,8,5,1,00468,India
939989,2023-07-13,713,ball pen,5,10,5,1,00009,India
939989,2023-07-13,704,scale,5,10,5,1,00009,India
939989,2023-07-13,707,marker,20,40,20,1,00009,India
214656,2023-07-13,715,folder,5,15,10,1,00290,India
214656,2023-07-13,702,pencil,2,5,3,1,00290,India
267057,2023-07-13,704,scale,5,10,5,1,00206,India
267057,2023-07-13,714,carbon paper,15,30,15,1,00206,India
397248,2023-07-13,713,ball pen,5,10,5,1,00078,India
397248,2023-07-13,715,folder,5,15,10,1,00078,India
292038,2023-07-13,717,spiral bound book,50,100,50,1,00468,India
292038,2023-07-13,707,marker,20,40,20,1,00468,India
292038,2023-07-13,708,sketchpen,15,40,25,1,00468,India
292038,2023-07-13,702,pencil,2,5,3,1,00468,India
404804,2023-07-13,714,carbon paper,15,30,15,1,00060,India
643678,2023-07-13,709,notebook,30,60,30,1,00003,India
643678,2023-07-13,708,sketchpen,15,40,25,1,00003,India
643678,2023-07-13,705,stencil,10,20,10,1,00003,India
643678,2023-07-13,717,spiral bound book,50,100,50,1,00003,India
255374,2023-07-13,708,sketchpen,15,40,25,1,00351,India
207319,2023-07-13,702,pencil,2,5,3,1,00403,India
207319,2023-07-13,710,geometry box,100,150,50,1,00403,India
207319,2023-07-13,706,sharpener,3,8,5,1,00403,India
941520,2023-07-13,714,carbon paper,15,30,15,1,00283,India
941520,2023-07-13,711,TD kit,150,300,150,1,00283,India
710636,2023-07-13,702,pencil,2,5,3,1,00285,India
710636,2023-07-13,703,eraser,1,3,2,1,00285,India
710636,2023-07-13,716,printing paper,200,400,200,1,00285,India
710636,2023-07-13,706,sharpener,3,8,5,1,00285,India
399178,2023-07-13,712,graph paper,20,40,20,1,00072,India
399178,2023-07-13,717,spiral bound book,50,100,50,1,00072,India
399178,2023-07-13,708,sketchpen,15,40,25,1,00072,India
354501,2023-07-13,713,ball pen,5,10,5,1,00096,India
393463,2023-07-13,708,sketchpen,15,40,25,1,00175,India
393463,2023-07-13,714,carbon paper,15,30,15,1,00175,India
393463,2023-07-13,712,graph paper,20,40,20,1,00175,India
393463,2023-07-13,716,printing paper,200,400,200,1,00175,India
115003,2023-07-13,713,ball pen,5,10,5,1,00324,India
254330,2023-07-13,711,TD kit,150,300,150,1,00006,India
254330,2023-07-13,703,eraser,1,3,2,1,00006,India
254330,2023-07-13,708,sketchpen,15,40,25,1,00006,India
670104,2023-07-13,710,geometry box,100,150,50,1,00120,India
670104,2023-07-13,713,ball pen,5,10,5,1,00120,India
627382,2023-07-13,708,sketchpen,15,40,25,1,00326,India
627382,2023-07-13,707,marker,20,40,20,1,00326,India
793435,2023-07-13,714,carbon paper,15,30,15,1,00006,India
793435,2023-07-13,710,geometry box,100,150,50,1,00006,India
793435,2023-07-13,712,graph paper,20,40,20,1,00006,India
565630,2023-07-13,711,TD kit,150,300,150,1,00051,India
565630,2023-07-13,704,scale,5,10,5,1,00051,India
565630,2023-07-13,716,printing paper,200,400,200,1,00051,India
749283,2023-07-13,717,spiral bound book,50,100,50,1,00496,India
749283,2023-07-13,712,graph paper,20,40,20,1,00496,India
749283,2023-07-13,711,TD kit,150,300,150,1,00496,India
749283,2023-07-13,701,gel pen,5,10,5,1,00496,India
950483,2023-07-13,712,graph paper,20,40,20,1,00164,India
950483,2023-07-13,716,printing paper,200,400,200,1,00164,India
950483,2023-07-13,710,geometry box,100,150,50,1,00164,India
950483,2023-07-13,703,eraser,1,3,2,1,00164,India
999401,2023-07-13,714,carbon paper,15,30,15,1,00179,India
789866,2023-07-13,710,geometry box,100,150,50,1,00126,India
789866,2023-07-13,713,ball pen,5,10,5,1,00126,India
789866,2023-07-13,709,notebook,30,60,30,1,00126,India
789866,2023-07-13,716,printing paper,200,400,200,1,00126,India
789866,2023-07-13,715,folder,5,15,10,1,00126,India
105230,2023-07-13,717,spiral bound book,50,100,50,1,00292,India
105230,2023-07-13,714,carbon paper,15,30,15,1,00292,India
105230,2023-07-13,716,printing paper,200,400,200,1,00292,India
105230,2023-07-13,706,sharpener,3,8,5,1,00292,India
471099,2023-07-14,712,graph paper,20,40,20,1,00360,India
732975,2023-07-14,715,folder,5,15,10,1,00335,India
732975,2023-07-14,711,TD kit,150,300,150,1,00335,India
732975,2023-07-14,707,marker,20,40,20,1,00335,India
399270,2023-07-14,711,TD kit,150,300,150,1,00356,India
399270,2023-07-14,703,eraser,1,3,2,1,00356,India
399270,2023-07-14,714,carbon paper,15,30,15,1,00356,India
399270,2023-07-14,704,scale,5,10,5,1,00356,India
224004,2023-07-14,709,notebook,30,60,30,1,00218,India
176529,2023-07-14,702,pencil,2,5,3,1,00325,India
176529,2023-07-14,704,scale,5,10,5,1,00325,India
176529,2023-07-14,706,sharpener,3,8,5,1,00325,India
176529,2023-07-14,711,TD kit,150,300,150,1,00325,India
445746,2023-07-14,713,ball pen,5,10,5,1,00299,India
265389,2023-07-14,709,notebook,30,60,30,1,00398,India
265389,2023-07-14,702,pencil,2,5,3,1,00398,India
265389,2023-07-14,705,stencil,10,20,10,1,00398,India
212283,2023-07-14,710,geometry box,100,150,50,1,00281,India
442301,2023-07-14,712,graph paper,20,40,20,1,00052,India
353508,2023-07-14,707,marker,20,40,20,1,00446,India
561102,2023-07-14,705,stencil,10,20,10,1,00458,India
561102,2023-07-14,712,graph paper,20,40,20,1,00458,India
561102,2023-07-14,717,spiral bound book,50,100,50,1,00458,India
955206,2023-07-14,705,stencil,10,20,10,1,00082,India
955206,2023-07-14,716,printing paper,200,400,200,1,00082,India
334998,2023-07-14,711,TD kit,150,300,150,1,00193,India
354402,2023-07-14,704,scale,5,10,5,1,00474,India
354402,2023-07-14,703,eraser,1,3,2,1,00474,India
354402,2023-07-14,702,pencil,2,5,3,1,00474,India
354402,2023-07-14,709,notebook,30,60,30,1,00474,India
774613,2023-07-14,706,sharpener,3,8,5,1,00446,India
774613,2023-07-14,714,carbon paper,15,30,15,1,00446,India
774613,2023-07-14,712,graph paper,20,40,20,1,00446,India
468768,2023-07-14,710,geometry box,100,150,50,1,00045,India
468768,2023-07-14,705,stencil,10,20,10,1,00045,India
468768,2023-07-14,701,gel pen,5,10,5,1,00045,India
774418,2023-07-14,712,graph paper,20,40,20,1,00253,India
774418,2023-07-14,708,sketchpen,15,40,25,1,00253,India
774418,2023-07-14,711,TD kit,150,300,150,1,00253,India
199297,2023-07-14,716,printing paper,200,400,200,1,00344,India
199297,2023-07-14,712,graph paper,20,40,20,1,00344,India
199297,2023-07-14,713,ball pen,5,10,5,1,00344,India
199297,2023-07-14,715,folder,5,15,10,1,00344,India
199297,2023-07-14,706,sharpener,3,8,5,1,00344,India
723599,2023-07-14,708,sketchpen,15,40,25,1,00257,India
723599,2023-07-14,703,eraser,1,3,2,1,00257,India
497121,2023-07-14,705,stencil,10,20,10,1,00211,India
497121,2023-07-14,714,carbon paper,15,30,15,1,00211,India
497121,2023-07-14,711,TD kit,150,300,150,1,00211,India
815556,2023-07-14,706,sharpener,3,8,5,1,00351,India
815556,2023-07-14,710,geometry box,100,150,50,1,00351,India
815556,2023-07-14,701,gel pen,5,10,5,1,00351,India
815556,2023-07-14,703,eraser,1,3,2,1,00351,India
658296,2023-07-14,717,spiral bound book,50,100,50,1,00321,India
658296,2023-07-14,709,notebook,30,60,30,1,00321,India
658296,2023-07-14,702,pencil,2,5,3,1,00321,India
300382,2023-07-14,710,geometry box,100,150,50,1,00252,India
300382,2023-07-14,706,sharpener,3,8,5,1,00252,India
300382,2023-07-14,702,pencil,2,5,3,1,00252,India
300382,2023-07-14,711,TD kit,150,300,150,1,00252,India
683880,2023-07-14,714,carbon paper,15,30,15,1,00324,India
176951,2023-07-14,708,sketchpen,15,40,25,1,00259,India
176951,2023-07-14,712,graph paper,20,40,20,1,00259,India
196139,2023-07-14,716,printing paper,200,400,200,1,00396,India
196139,2023-07-14,701,gel pen,5,10,5,1,00396,India
196139,2023-07-14,708,sketchpen,15,40,25,1,00396,India
196139,2023-07-14,715,folder,5,15,10,1,00396,India
948831,2023-07-14,714,carbon paper,15,30,15,1,00124,India
948831,2023-07-14,709,notebook,30,60,30,1,00124,India
948831,2023-07-14,717,spiral bound book,50,100,50,1,00124,India
948831,2023-07-14,705,stencil,10,20,10,1,00124,India
653612,2023-07-14,714,carbon paper,15,30,15,1,00113,India
653612,2023-07-14,701,gel pen,5,10,5,1,00113,India
653612,2023-07-14,709,notebook,30,60,30,1,00113,India
117693,2023-07-14,716,printing paper,200,400,200,1,00344,India
117693,2023-07-14,707,marker,20,40,20,1,00344,India
469918,2023-07-14,704,scale,5,10,5,1,00487,India
469918,2023-07-14,716,printing paper,200,400,200,1,00487,India
907356,2023-07-14,714,carbon paper,15,30,15,1,00290,India
907356,2023-07-14,710,geometry box,100,150,50,1,00290,India
907356,2023-07-14,705,stencil,10,20,10,1,00290,India
773723,2023-07-14,706,sharpener,3,8,5,1,00210,India
773723,2023-07-14,713,ball pen,5,10,5,1,00210,India
747106,2023-07-14,709,notebook,30,60,30,1,00408,India
651193,2023-07-14,716,printing paper,200,400,200,1,00399,India
651193,2023-07-14,714,carbon paper,15,30,15,1,00399,India
651193,2023-07-14,707,marker,20,40,20,1,00399,India
651193,2023-07-14,709,notebook,30,60,30,1,00399,India
651193,2023-07-14,704,scale,5,10,5,1,00399,India
561495,2023-07-14,712,graph paper,20,40,20,1,00373,India
561495,2023-07-14,704,scale,5,10,5,1,00373,India
561495,2023-07-14,701,gel pen,5,10,5,1,00373,India
561495,2023-07-14,714,carbon paper,15,30,15,1,00373,India
223269,2023-07-14,712,graph paper,20,40,20,1,00388,India
223269,2023-07-14,711,TD kit,150,300,150,1,00388,India
223269,2023-07-14,702,pencil,2,5,3,1,00388,India
223269,2023-07-14,715,folder,5,15,10,1,00388,India
819891,2023-07-15,702,pencil,2,5,3,1,00266,India
819891,2023-07-15,701,gel pen,5,10,5,1,00266,India
819891,2023-07-15,715,folder,5,15,10,1,00266,India
819891,2023-07-15,704,scale,5,10,5,1,00266,India
221503,2023-07-15,712,graph paper,20,40,20,1,00123,India
221503,2023-07-15,715,folder,5,15,10,1,00123,India
221503,2023-07-15,707,marker,20,40,20,1,00123,India
221503,2023-07-15,708,sketchpen,15,40,25,1,00123,India
238539,2023-07-15,701,gel pen,5,10,5,1,00013,India
238539,2023-07-15,711,TD kit,150,300,150,1,00013,India
238539,2023-07-15,715,folder,5,15,10,1,00013,India
238539,2023-07-15,717,spiral bound book,50,100,50,1,00013,India
785221,2023-07-15,702,pencil,2,5,3,1,00254,India
785221,2023-07-15,709,notebook,30,60,30,1,00254,India
785221,2023-07-15,713,ball pen,5,10,5,1,00254,India
158341,2023-07-15,714,carbon paper,15,30,15,1,00012,India
256786,2023-07-15,708,sketchpen,15,40,25,1,00261,India
256786,2023-07-15,710,geometry box,100,150,50,1,00261,India
256786,2023-07-15,707,marker,20,40,20,1,00261,India
256786,2023-07-15,709,notebook,30,60,30,1,00261,India
256786,2023-07-15,716,printing paper,200,400,200,1,00261,India
865258,2023-07-15,705,stencil,10,20,10,1,00356,India
865258,2023-07-15,712,graph paper,20,40,20,1,00356,India
865258,2023-07-15,715,folder,5,15,10,1,00356,India
935718,2023-07-15,709,notebook,30,60,30,1,00319,India
935718,2023-07-15,714,carbon paper,15,30,15,1,00319,India
134476,2023-07-15,705,stencil,10,20,10,1,00430,India
134476,2023-07-15,702,pencil,2,5,3,1,00430,India
134476,2023-07-15,709,notebook,30,60,30,1,00430,India
134476,2023-07-15,706,sharpener,3,8,5,1,00430,India
627589,2023-07-15,713,ball pen,5,10,5,1,00257,India
627589,2023-07-15,710,geometry box,100,150,50,1,00257,India
627589,2023-07-15,706,sharpener,3,8,5,1,00257,India
627589,2023-07-15,707,marker,20,40,20,1,00257,India
148558,2023-07-15,706,sharpener,3,8,5,1,00391,India
148558,2023-07-15,708,sketchpen,15,40,25,1,00391,India
148558,2023-07-15,705,stencil,10,20,10,1,00391,India
148558,2023-07-15,707,marker,20,40,20,1,00391,India
148558,2023-07-15,714,carbon paper,15,30,15,1,00391,India
477652,2023-07-15,701,gel pen,5,10,5,1,00453,India
691303,2023-07-15,702,pencil,2,5,3,1,00109,India
691303,2023-07-15,716,printing paper,200,400,200,1,00109,India
286467,2023-07-15,704,scale,5,10,5,1,00366,India
286467,2023-07-15,703,eraser,1,3,2,1,00366,India
286467,2023-07-15,715,folder,5,15,10,1,00366,India
286467,2023-07-15,713,ball pen,5,10,5,1,00366,India
333136,2023-07-15,706,sharpener,3,8,5,1,00110,India
419922,2023-07-15,710,geometry box,100,150,50,1,00143,India
419922,2023-07-15,712,graph paper,20,40,20,1,00143,India
358632,2023-07-15,710,geometry box,100,150,50,1,00328,India
358632,2023-07-15,707,marker,20,40,20,1,00328,India
220966,2023-07-15,709,notebook,30,60,30,1,00281,India
220966,2023-07-15,701,gel pen,5,10,5,1,00281,India
220966,2023-07-15,703,eraser,1,3,2,1,00281,India
220966,2023-07-15,717,spiral bound book,50,100,50,1,00281,India
220966,2023-07-15,715,folder,5,15,10,1,00281,India
261528,2023-07-15,707,marker,20,40,20,1,00309,India
261528,2023-07-15,713,ball pen,5,10,5,1,00309,India
740929,2023-07-15,715,folder,5,15,10,1,00402,India
740929,2023-07-15,713,ball pen,5,10,5,1,00402,India
740929,2023-07-15,711,TD kit,150,300,150,1,00402,India
740929,2023-07-15,708,sketchpen,15,40,25,1,00402,India
161529,2023-07-15,711,TD kit,150,300,150,1,00455,India
161529,2023-07-15,716,printing paper,200,400,200,1,00455,India
682826,2023-07-15,709,notebook,30,60,30,1,00090,India
682826,2023-07-15,711,TD kit,150,300,150,1,00090,India
682826,2023-07-15,715,folder,5,15,10,1,00090,India
682826,2023-07-15,704,scale,5,10,5,1,00090,India
816148,2023-07-15,705,stencil,10,20,10,1,00035,India
816148,2023-07-15,709,notebook,30,60,30,1,00035,India
816148,2023-07-15,703,eraser,1,3,2,1,00035,India
816148,2023-07-15,715,folder,5,15,10,1,00035,India
625364,2023-07-15,712,graph paper,20,40,20,1,00291,India
625364,2023-07-15,717,spiral bound book,50,100,50,1,00291,India
625364,2023-07-15,710,geometry box,100,150,50,1,00291,India
625364,2023-07-15,705,stencil,10,20,10,1,00291,India
625364,2023-07-15,701,gel pen,5,10,5,1,00291,India
951987,2023-07-15,712,graph paper,20,40,20,1,00025,India
951987,2023-07-15,702,pencil,2,5,3,1,00025,India
951987,2023-07-15,714,carbon paper,15,30,15,1,00025,India
439261,2023-07-15,702,pencil,2,5,3,1,00320,India
439261,2023-07-15,712,graph paper,20,40,20,1,00320,India
439261,2023-07-15,705,stencil,10,20,10,1,00320,India
439261,2023-07-15,714,carbon paper,15,30,15,1,00320,India
439261,2023-07-15,711,TD kit,150,300,150,1,00320,India
343170,2023-07-15,716,printing paper,200,400,200,1,00168,India
343170,2023-07-15,703,eraser,1,3,2,1,00168,India
575100,2023-07-15,701,gel pen,5,10,5,1,00359,India
575100,2023-07-15,709,notebook,30,60,30,1,00359,India
575100,2023-07-15,717,spiral bound book,50,100,50,1,00359,India
524823,2023-07-15,708,sketchpen,15,40,25,1,00138,India
860927,2023-07-15,702,pencil,2,5,3,1,00077,India
860927,2023-07-15,715,folder,5,15,10,1,00077,India
125793,2023-07-15,714,carbon paper,15,30,15,1,00116,India
125793,2023-07-15,712,graph paper,20,40,20,1,00116,India
125793,2023-07-15,716,printing paper,200,400,200,1,00116,India
432159,2023-07-15,717,spiral bound book,50,100,50,1,00181,India
934503,2023-07-15,714,carbon paper,15,30,15,1,00362,India
934503,2023-07-15,706,sharpener,3,8,5,1,00362,India
356057,2023-07-15,714,carbon paper,15,30,15,1,00461,India
923589,2023-07-15,706,sharpener,3,8,5,1,00277,India
923589,2023-07-15,707,marker,20,40,20,1,00277,India
923589,2023-07-15,713,ball pen,5,10,5,1,00277,India
509312,2023-07-15,717,spiral bound book,50,100,50,1,00145,India
509312,2023-07-15,716,printing paper,200,400,200,1,00145,India
509312,2023-07-15,701,gel pen,5,10,5,1,00145,India
509312,2023-07-15,705,stencil,10,20,10,1,00145,India
509312,2023-07-15,711,TD kit,150,300,150,1,00145,India
148634,2023-07-15,701,gel pen,5,10,5,1,00016,India
148634,2023-07-15,704,scale,5,10,5,1,00016,India
148634,2023-07-15,716,printing paper,200,400,200,1,00016,India
517724,2023-07-15,704,scale,5,10,5,1,00255,India
275985,2023-07-15,702,pencil,2,5,3,1,00138,India
275985,2023-07-15,706,sharpener,3,8,5,1,00138,India
254212,2023-07-15,701,gel pen,5,10,5,1,00342,India
254212,2023-07-15,706,sharpener,3,8,5,1,00342,India
254212,2023-07-15,707,marker,20,40,20,1,00342,India
254212,2023-07-15,717,spiral bound book,50,100,50,1,00342,India
254212,2023-07-15,704,scale,5,10,5,1,00342,India
823966,2023-07-15,716,printing paper,200,400,200,1,00328,India
823966,2023-07-15,717,spiral bound book,50,100,50,1,00328,India
823966,2023-07-15,708,sketchpen,15,40,25,1,00328,India
779778,2023-07-15,704,scale,5,10,5,1,00233,India
577717,2023-07-15,703,eraser,1,3,2,1,00247,India
577717,2023-07-15,712,graph paper,20,40,20,1,00247,India
577717,2023-07-15,714,carbon paper,15,30,15,1,00247,India
577717,2023-07-15,706,sharpener,3,8,5,1,00247,India
336308,2023-07-15,710,geometry box,100,150,50,1,00081,India
336308,2023-07-15,705,stencil,10,20,10,1,00081,India
377462,2023-07-15,713,ball pen,5,10,5,1,00175,India
377462,2023-07-15,701,gel pen,5,10,5,1,00175,India
710571,2023-07-15,712,graph paper,20,40,20,1,00190,India
710571,2023-07-15,709,notebook,30,60,30,1,00190,India
710571,2023-07-15,717,spiral bound book,50,100,50,1,00190,India
710571,2023-07-15,715,folder,5,15,10,1,00190,India
741637,2023-07-16,709,notebook,30,60,30,1,00184,India
382953,2023-07-16,708,sketchpen,15,40,25,1,00095,India
382953,2023-07-16,704,scale,5,10,5,1,00095,India
382953,2023-07-16,707,marker,20,40,20,1,00095,India
382953,2023-07-16,715,folder,5,15,10,1,00095,India
741889,2023-07-16,703,eraser,1,3,2,1,00453,India
741889,2023-07-16,706,sharpener,3,8,5,1,00453,India
608096,2023-07-16,716,printing paper,200,400,200,1,00337,India
608096,2023-07-16,709,notebook,30,60,30,1,00337,India
608096,2023-07-16,711,TD kit,150,300,150,1,00337,India
608096,2023-07-16,712,graph paper,20,40,20,1,00337,India
156062,2023-07-16,701,gel pen,5,10,5,1,00289,India
156062,2023-07-16,708,sketchpen,15,40,25,1,00289,India
156062,2023-07-16,709,notebook,30,60,30,1,00289,India
156062,2023-07-16,711,TD kit,150,300,150,1,00289,India
156062,2023-07-16,706,sharpener,3,8,5,1,00289,India
706685,2023-07-16,715,folder,5,15,10,1,00029,India
706685,2023-07-16,707,marker,20,40,20,1,00029,India
706685,2023-07-16,711,TD kit,150,300,150,1,00029,India
130085,2023-07-16,703,eraser,1,3,2,1,00328,India
130085,2023-07-16,709,notebook,30,60,30,1,00328,India
130085,2023-07-16,701,gel pen,5,10,5,1,00328,India
130085,2023-07-16,711,TD kit,150,300,150,1,00328,India
437919,2023-07-16,701,gel pen,5,10,5,1,00359,India
684062,2023-07-16,715,folder,5,15,10,1,00098,India
617726,2023-07-16,708,sketchpen,15,40,25,1,00317,India
617726,2023-07-16,701,gel pen,5,10,5,1,00317,India
617726,2023-07-16,715,folder,5,15,10,1,00317,India
617726,2023-07-16,712,graph paper,20,40,20,1,00317,India
832821,2023-07-16,701,gel pen,5,10,5,1,00148,India
832821,2023-07-16,713,ball pen,5,10,5,1,00148,India
832821,2023-07-16,709,notebook,30,60,30,1,00148,India
832821,2023-07-16,702,pencil,2,5,3,1,00148,India
389956,2023-07-16,708,sketchpen,15,40,25,1,00097,India
389956,2023-07-16,705,stencil,10,20,10,1,00097,India
113573,2023-07-16,710,geometry box,100,150,50,1,00446,India
113573,2023-07-16,705,stencil,10,20,10,1,00446,India
558296,2023-07-16,701,gel pen,5,10,5,1,00327,India
364268,2023-07-16,713,ball pen,5,10,5,1,00036,India
871892,2023-07-16,715,folder,5,15,10,1,00264,India
871892,2023-07-16,717,spiral bound book,50,100,50,1,00264,India
291361,2023-07-16,701,gel pen,5,10,5,1,00021,India
291361,2023-07-16,704,scale,5,10,5,1,00021,India
270469,2023-07-16,711,TD kit,150,300,150,1,00350,India
270469,2023-07-16,704,scale,5,10,5,1,00350,India
270469,2023-07-16,712,graph paper,20,40,20,1,00350,India
270469,2023-07-16,717,spiral bound book,50,100,50,1,00350,India
265661,2023-07-16,705,stencil,10,20,10,1,00318,India
265661,2023-07-16,703,eraser,1,3,2,1,00318,India
601087,2023-07-16,717,spiral bound book,50,100,50,1,00309,India
601087,2023-07-16,713,ball pen,5,10,5,1,00309,India
601087,2023-07-16,711,TD kit,150,300,150,1,00309,India
601087,2023-07-16,715,folder,5,15,10,1,00309,India
617967,2023-07-16,707,marker,20,40,20,1,00009,India
617967,2023-07-16,714,carbon paper,15,30,15,1,00009,India
617967,2023-07-16,717,spiral bound book,50,100,50,1,00009,India
887443,2023-07-16,709,notebook,30,60,30,1,00037,India
887443,2023-07-16,714,carbon paper,15,30,15,1,00037,India
887443,2023-07-16,711,TD kit,150,300,150,1,00037,India
120629,2023-07-16,702,pencil,2,5,3,1,00462,India
120629,2023-07-16,716,printing paper,200,400,200,1,00462,India
120629,2023-07-16,713,ball pen,5,10,5,1,00462,India
978255,2023-07-16,706,sharpener,3,8,5,1,00162,India
978255,2023-07-16,708,sketchpen,15,40,25,1,00162,India
124590,2023-07-16,713,ball pen,5,10,5,1,00092,India
124590,2023-07-16,715,folder,5,15,10,1,00092,India
124590,2023-07-16,702,pencil,2,5,3,1,00092,India
951819,2023-07-16,711,TD kit,150,300,150,1,00293,India
863233,2023-07-16,712,graph paper,20,40,20,1,00222,India
863233,2023-07-16,701,gel pen,5,10,5,1,00222,India
863233,2023-07-16,716,printing paper,200,400,200,1,00222,India
306749,2023-07-16,710,geometry box,100,150,50,1,00366,India
306749,2023-07-16,707,marker,20,40,20,1,00366,India
635014,2023-07-16,706,sharpener,3,8,5,1,00396,India
635014,2023-07-16,704,scale,5,10,5,1,00396,India
635014,2023-07-16,702,pencil,2,5,3,1,00396,India
920207,2023-07-16,710,geometry box,100,150,50,1,00076,India
920207,2023-07-16,715,folder,5,15,10,1,00076,India
920207,2023-07-16,717,spiral bound book,50,100,50,1,00076,India
500509,2023-07-16,712,graph paper,20,40,20,1,00099,India
500509,2023-07-16,715,folder,5,15,10,1,00099,India
500509,2023-07-16,702,pencil,2,5,3,1,00099,India
500509,2023-07-16,704,scale,5,10,5,1,00099,India
491470,2023-07-16,702,pencil,2,5,3,1,00187,India
491470,2023-07-16,717,spiral bound book,50,100,50,1,00187,India
390103,2023-07-16,714,carbon paper,15,30,15,1,00172,India
390103,2023-07-16,702,pencil,2,5,3,1,00172,India
390103,2023-07-16,715,folder,5,15,10,1,00172,India
390103,2023-07-16,710,geometry box,100,150,50,1,00172,India
390103,2023-07-16,709,notebook,30,60,30,1,00172,India
916069,2023-07-16,702,pencil,2,5,3,1,00170,India
916069,2023-07-16,703,eraser,1,3,2,1,00170,India
916069,2023-07-16,715,folder,5,15,10,1,00170,India
916069,2023-07-16,706,sharpener,3,8,5,1,00170,India
265767,2023-07-16,710,geometry box,100,150,50,1,00148,India
363595,2023-07-16,712,graph paper,20,40,20,1,00397,India
363595,2023-07-16,713,ball pen,5,10,5,1,00397,India
316357,2023-07-16,712,graph paper,20,40,20,1,00098,India
345340,2023-07-16,711,TD kit,150,300,150,1,00306,India
345340,2023-07-16,703,eraser,1,3,2,1,00306,India
345340,2023-07-16,710,geometry box,100,150,50,1,00306,India
345340,2023-07-16,706,sharpener,3,8,5,1,00306,India
345340,2023-07-16,715,folder,5,15,10,1,00306,India
679889,2023-07-16,702,pencil,2,5,3,1,00461,India
679889,2023-07-16,710,geometry box,100,150,50,1,00461,India
679889,2023-07-16,715,folder,5,15,10,1,00461,India
679889,2023-07-16,707,marker,20,40,20,1,00461,India
513633,2023-07-16,715,folder,5,15,10,1,00114,India
775179,2023-07-16,701,gel pen,5,10,5,1,00263,India
775179,2023-07-16,717,spiral bound book,50,100,50,1,00263,India
775179,2023-07-16,714,carbon paper,15,30,15,1,00263,India
775179,2023-07-16,707,marker,20,40,20,1,00263,India
775179,2023-07-16,709,notebook,30,60,30,1,00263,India
794870,2023-07-16,715,folder,5,15,10,1,00381,India
794870,2023-07-16,716,printing paper,200,400,200,1,00381,India
127051,2023-07-16,714,carbon paper,15,30,15,1,00177,India
127051,2023-07-16,710,geometry box,100,150,50,1,00177,India
127051,2023-07-16,708,sketchpen,15,40,25,1,00177,India
127051,2023-07-16,715,folder,5,15,10,1,00177,India
826255,2023-07-16,711,TD kit,150,300,150,1,00189,India
826255,2023-07-16,717,spiral bound book,50,100,50,1,00189,India
826255,2023-07-16,712,graph paper,20,40,20,1,00189,India
963794,2023-07-16,716,printing paper,200,400,200,1,00117,India
963794,2023-07-16,715,folder,5,15,10,1,00117,India
963794,2023-07-16,704,scale,5,10,5,1,00117,India
357470,2023-07-16,703,eraser,1,3,2,1,00237,India
357470,2023-07-16,711,TD kit,150,300,150,1,00237,India
357470,2023-07-16,714,carbon paper,15,30,15,1,00237,India
357470,2023-07-16,712,graph paper,20,40,20,1,00237,India
357470,2023-07-16,709,notebook,30,60,30,1,00237,India
297884,2023-07-16,708,sketchpen,15,40,25,1,00461,India
297884,2023-07-16,707,marker,20,40,20,1,00461,India
509279,2023-07-16,710,geometry box,100,150,50,1,00158,India
509279,2023-07-16,711,TD kit,150,300,150,1,00158,India
509279,2023-07-16,704,scale,5,10,5,1,00158,India
921433,2023-07-16,701,gel pen,5,10,5,1,00253,India
921433,2023-07-16,702,pencil,2,5,3,1,00253,India
921433,2023-07-16,703,eraser,1,3,2,1,00253,India
844325,2023-07-17,717,spiral bound book,50,100,50,1,00359,India
844325,2023-07-17,709,notebook,30,60,30,1,00359,India
844325,2023-07-17,714,carbon paper,15,30,15,1,00359,India
918225,2023-07-17,707,marker,20,40,20,1,00293,India
457771,2023-07-17,706,sharpener,3,8,5,1,00008,India
457771,2023-07-17,701,gel pen,5,10,5,1,00008,India
748128,2023-07-17,710,geometry box,100,150,50,1,00464,India
748128,2023-07-17,707,marker,20,40,20,1,00464,India
758215,2023-07-17,703,eraser,1,3,2,1,00251,India
758215,2023-07-17,711,TD kit,150,300,150,1,00251,India
335301,2023-07-17,704,scale,5,10,5,1,00038,India
335301,2023-07-17,712,graph paper,20,40,20,1,00038,India
808922,2023-07-17,709,notebook,30,60,30,1,00060,India
808922,2023-07-17,717,spiral bound book,50,100,50,1,00060,India
356237,2023-07-17,709,notebook,30,60,30,1,00448,India
521971,2023-07-17,701,gel pen,5,10,5,1,00033,India
521971,2023-07-17,709,notebook,30,60,30,1,00033,India
313590,2023-07-17,714,carbon paper,15,30,15,1,00179,India
313590,2023-07-17,702,pencil,2,5,3,1,00179,India
313590,2023-07-17,712,graph paper,20,40,20,1,00179,India
313590,2023-07-17,706,sharpener,3,8,5,1,00179,India
832749,2023-07-17,712,graph paper,20,40,20,1,00259,India
832749,2023-07-17,711,TD kit,150,300,150,1,00259,India
832749,2023-07-17,716,printing paper,200,400,200,1,00259,India
757385,2023-07-17,710,geometry box,100,150,50,1,00075,India
757385,2023-07-17,715,folder,5,15,10,1,00075,India
757385,2023-07-17,712,graph paper,20,40,20,1,00075,India
338741,2023-07-17,710,geometry box,100,150,50,1,00498,India
338741,2023-07-17,703,eraser,1,3,2,1,00498,India
338741,2023-07-17,701,gel pen,5,10,5,1,00498,India
338741,2023-07-17,711,TD kit,150,300,150,1,00498,India
925344,2023-07-17,714,carbon paper,15,30,15,1,00038,India
925344,2023-07-17,710,geometry box,100,150,50,1,00038,India
521345,2023-07-17,702,pencil,2,5,3,1,00156,India
521345,2023-07-17,711,TD kit,150,300,150,1,00156,India
852112,2023-07-17,702,pencil,2,5,3,1,00220,India
852112,2023-07-17,713,ball pen,5,10,5,1,00220,India
852112,2023-07-17,717,spiral bound book,50,100,50,1,00220,India
970256,2023-07-17,702,pencil,2,5,3,1,00264,India
620209,2023-07-17,706,sharpener,3,8,5,1,00198,India
620209,2023-07-17,704,scale,5,10,5,1,00198,India
620209,2023-07-17,711,TD kit,150,300,150,1,00198,India
620209,2023-07-17,709,notebook,30,60,30,1,00198,India
457298,2023-07-17,708,sketchpen,15,40,25,1,00284,India
457298,2023-07-17,711,TD kit,150,300,150,1,00284,India
457298,2023-07-17,704,scale,5,10,5,1,00284,India
132478,2023-07-17,704,scale,5,10,5,1,00049,India
132478,2023-07-17,701,gel pen,5,10,5,1,00049,India
647920,2023-07-17,716,printing paper,200,400,200,1,00354,India
647920,2023-07-17,705,stencil,10,20,10,1,00354,India
647920,2023-07-17,717,spiral bound book,50,100,50,1,00354,India
974750,2023-07-17,715,folder,5,15,10,1,00452,India
974750,2023-07-17,710,geometry box,100,150,50,1,00452,India
974750,2023-07-17,707,marker,20,40,20,1,00452,India
974750,2023-07-17,704,scale,5,10,5,1,00452,India
149649,2023-07-17,711,TD kit,150,300,150,1,00275,India
348657,2023-07-17,711,TD kit,150,300,150,1,00040,India
348657,2023-07-17,706,sharpener,3,8,5,1,00040,India
348657,2023-07-17,708,sketchpen,15,40,25,1,00040,India
487036,2023-07-17,716,printing paper,200,400,200,1,00445,India
487036,2023-07-17,714,carbon paper,15,30,15,1,00445,India
840245,2023-07-17,712,graph paper,20,40,20,1,00187,India
529884,2023-07-17,712,graph paper,20,40,20,1,00491,India
290663,2023-07-17,714,carbon paper,15,30,15,1,00384,India
290663,2023-07-17,701,gel pen,5,10,5,1,00384,India
290663,2023-07-17,713,ball pen,5,10,5,1,00384,India
290663,2023-07-17,708,sketchpen,15,40,25,1,00384,India
290663,2023-07-17,717,spiral bound book,50,100,50,1,00384,India
865106,2023-07-17,709,notebook,30,60,30,1,00015,India
865106,2023-07-17,702,pencil,2,5,3,1,00015,India
542683,2023-07-17,705,stencil,10,20,10,1,00191,India
542683,2023-07-17,711,TD kit,150,300,150,1,00191,India
542683,2023-07-17,710,geometry box,100,150,50,1,00191,India
542683,2023-07-17,702,pencil,2,5,3,1,00191,India
173650,2023-07-17,706,sharpener,3,8,5,1,00214,India
173650,2023-07-17,715,folder,5,15,10,1,00214,India
173650,2023-07-17,711,TD kit,150,300,150,1,00214,India
908452,2023-07-17,701,gel pen,5,10,5,1,00251,India
908452,2023-07-17,710,geometry box,100,150,50,1,00251,India
949961,2023-07-17,704,scale,5,10,5,1,00211,India
268874,2023-07-17,712,graph paper,20,40,20,1,00119,India
268874,2023-07-17,703,eraser,1,3,2,1,00119,India
709624,2023-07-17,712,graph paper,20,40,20,1,00083,India
709624,2023-07-17,711,TD kit,150,300,150,1,00083,India
709624,2023-07-17,713,ball pen,5,10,5,1,00083,India
495348,2023-07-17,717,spiral bound book,50,100,50,1,00297,India
495348,2023-07-17,708,sketchpen,15,40,25,1,00297,India
495348,2023-07-17,714,carbon paper,15,30,15,1,00297,India
495348,2023-07-17,712,graph paper,20,40,20,1,00297,India
495348,2023-07-17,704,scale,5,10,5,1,00297,India
165772,2023-07-17,705,stencil,10,20,10,1,00220,India
170829,2023-07-17,708,sketchpen,15,40,25,1,00492,India
170829,2023-07-17,717,spiral bound book,50,100,50,1,00492,India
170829,2023-07-17,706,sharpener,3,8,5,1,00492,India
607664,2023-07-17,701,gel pen,5,10,5,1,00164,India
607664,2023-07-17,707,marker,20,40,20,1,00164,India
607664,2023-07-17,705,stencil,10,20,10,1,00164,India
607664,2023-07-17,710,geometry box,100,150,50,1,00164,India
146699,2023-07-17,710,geometry box,100,150,50,1,00198,India
146699,2023-07-17,701,gel pen,5,10,5,1,00198,India
146699,2023-07-17,709,notebook,30,60,30,1,00198,India
146699,2023-07-17,704,scale,5,10,5,1,00198,India
146699,2023-07-17,708,sketchpen,15,40,25,1,00198,India
558759,2023-07-17,709,notebook,30,60,30,1,00192,India
837221,2023-07-17,715,folder,5,15,10,1,00344,India
837221,2023-07-17,703,eraser,1,3,2,1,00344,India
708883,2023-07-17,707,marker,20,40,20,1,00468,India
708883,2023-07-17,703,eraser,1,3,2,1,00468,India
708883,2023-07-17,713,ball pen,5,10,5,1,00468,India
708883,2023-07-17,706,sharpener,3,8,5,1,00468,India
765566,2023-07-17,714,carbon paper,15,30,15,1,00172,India
765566,2023-07-17,706,sharpener,3,8,5,1,00172,India
765566,2023-07-17,707,marker,20,40,20,1,00172,India
765566,2023-07-17,709,notebook,30,60,30,1,00172,India
679481,2023-07-17,716,printing paper,200,400,200,1,00437,India
679481,2023-07-17,713,ball pen,5,10,5,1,00437,India
679481,2023-07-17,715,folder,5,15,10,1,00437,India
679481,2023-07-17,712,graph paper,20,40,20,1,00437,India
182489,2023-07-18,715,folder,5,15,10,1,00020,India
524024,2023-07-18,710,geometry box,100,150,50,1,00302,India
524024,2023-07-18,711,TD kit,150,300,150,1,00302,India
524024,2023-07-18,712,graph paper,20,40,20,1,00302,India
524024,2023-07-18,707,marker,20,40,20,1,00302,India
519862,2023-07-18,706,sharpener,3,8,5,1,00168,India
519862,2023-07-18,703,eraser,1,3,2,1,00168,India
464685,2023-07-18,714,carbon paper,15,30,15,1,00246,India
464685,2023-07-18,711,TD kit,150,300,150,1,00246,India
464685,2023-07-18,715,folder,5,15,10,1,00246,India
464685,2023-07-18,712,graph paper,20,40,20,1,00246,India
779351,2023-07-18,701,gel pen,5,10,5,1,00089,India
779351,2023-07-18,702,pencil,2,5,3,1,00089,India
814305,2023-07-18,717,spiral bound book,50,100,50,1,00380,India
814305,2023-07-18,716,printing paper,200,400,200,1,00380,India
814305,2023-07-18,710,geometry box,100,150,50,1,00380,India
814305,2023-07-18,714,carbon paper,15,30,15,1,00380,India
814305,2023-07-18,701,gel pen,5,10,5,1,00380,India
151865,2023-07-18,715,folder,5,15,10,1,00244,India
151865,2023-07-18,708,sketchpen,15,40,25,1,00244,India
151865,2023-07-18,714,carbon paper,15,30,15,1,00244,India
849774,2023-07-18,702,pencil,2,5,3,1,00278,India
364063,2023-07-18,706,sharpener,3,8,5,1,00107,India
364063,2023-07-18,707,marker,20,40,20,1,00107,India
364063,2023-07-18,703,eraser,1,3,2,1,00107,India
364063,2023-07-18,714,carbon paper,15,30,15,1,00107,India
624062,2023-07-18,701,gel pen,5,10,5,1,00061,India
624062,2023-07-18,705,stencil,10,20,10,1,00061,India
624062,2023-07-18,708,sketchpen,15,40,25,1,00061,India
624062,2023-07-18,712,graph paper,20,40,20,1,00061,India
667443,2023-07-18,708,sketchpen,15,40,25,1,00364,India
667443,2023-07-18,716,printing paper,200,400,200,1,00364,India
667443,2023-07-18,701,gel pen,5,10,5,1,00364,India
667443,2023-07-18,705,stencil,10,20,10,1,00364,India
667443,2023-07-18,706,sharpener,3,8,5,1,00364,India
624690,2023-07-18,716,printing paper,200,400,200,1,00377,India
624690,2023-07-18,713,ball pen,5,10,5,1,00377,India
799792,2023-07-18,701,gel pen,5,10,5,1,00132,India
807236,2023-07-18,701,gel pen,5,10,5,1,00002,India
807236,2023-07-18,703,eraser,1,3,2,1,00002,India
472961,2023-07-18,706,sharpener,3,8,5,1,00135,India
472961,2023-07-18,703,eraser,1,3,2,1,00135,India
340406,2023-07-18,717,spiral bound book,50,100,50,1,00049,India
340406,2023-07-18,705,stencil,10,20,10,1,00049,India
340406,2023-07-18,714,carbon paper,15,30,15,1,00049,India
340406,2023-07-18,710,geometry box,100,150,50,1,00049,India
340406,2023-07-18,712,graph paper,20,40,20,1,00049,India
330379,2023-07-18,706,sharpener,3,8,5,1,00477,India
330379,2023-07-18,703,eraser,1,3,2,1,00477,India
142838,2023-07-18,702,pencil,2,5,3,1,00264,India
142838,2023-07-18,707,marker,20,40,20,1,00264,India
134646,2023-07-18,708,sketchpen,15,40,25,1,00425,India
134646,2023-07-18,705,stencil,10,20,10,1,00425,India
134646,2023-07-18,707,marker,20,40,20,1,00425,India
685706,2023-07-18,709,notebook,30,60,30,1,00214,India
685706,2023-07-18,713,ball pen,5,10,5,1,00214,India
685706,2023-07-18,703,eraser,1,3,2,1,00214,India
739759,2023-07-18,715,folder,5,15,10,1,00464,India
739759,2023-07-18,708,sketchpen,15,40,25,1,00464,India
891422,2023-07-18,708,sketchpen,15,40,25,1,00408,India
891422,2023-07-18,717,spiral bound book,50,100,50,1,00408,India
891422,2023-07-18,707,marker,20,40,20,1,00408,India
386138,2023-07-18,713,ball pen,5,10,5,1,00119,India
386138,2023-07-18,717,spiral bound book,50,100,50,1,00119,India
386138,2023-07-18,707,marker,20,40,20,1,00119,India
386138,2023-07-18,708,sketchpen,15,40,25,1,00119,India
877567,2023-07-18,708,sketchpen,15,40,25,1,00410,India
274481,2023-07-18,708,sketchpen,15,40,25,1,00002,India
274481,2023-07-18,709,notebook,30,60,30,1,00002,India
274481,2023-07-18,711,TD kit,150,300,150,1,00002,India
274481,2023-07-18,705,stencil,10,20,10,1,00002,India
784416,2023-07-18,705,stencil,10,20,10,1,00328,India
784416,2023-07-18,702,pencil,2,5,3,1,00328,India
784416,2023-07-18,712,graph paper,20,40,20,1,00328,India
784416,2023-07-18,701,gel pen,5,10,5,1,00328,India
784416,2023-07-18,708,sketchpen,15,40,25,1,00328,India
905257,2023-07-18,713,ball pen,5,10,5,1,00428,India
877847,2023-07-18,715,folder,5,15,10,1,00239,India
877847,2023-07-18,710,geometry box,100,150,50,1,00239,India
877847,2023-07-18,713,ball pen,5,10,5,1,00239,India
877847,2023-07-18,708,sketchpen,15,40,25,1,00239,India
877847,2023-07-18,714,carbon paper,15,30,15,1,00239,India
117138,2023-07-18,717,spiral bound book,50,100,50,1,00046,India
117138,2023-07-18,707,marker,20,40,20,1,00046,India
117138,2023-07-18,703,eraser,1,3,2,1,00046,India
306148,2023-07-18,713,ball pen,5,10,5,1,00287,India
947810,2023-07-18,716,printing paper,200,400,200,1,00243,India
755926,2023-07-18,716,printing paper,200,400,200,1,00140,India
755926,2023-07-18,702,pencil,2,5,3,1,00140,India
644526,2023-07-18,707,marker,20,40,20,1,00425,India
981810,2023-07-18,716,printing paper,200,400,200,1,00360,India
813571,2023-07-18,712,graph paper,20,40,20,1,00170,India
919482,2023-07-18,704,scale,5,10,5,1,00286,India
919482,2023-07-18,709,notebook,30,60,30,1,00286,India
373432,2023-07-18,706,sharpener,3,8,5,1,00068,India
373432,2023-07-18,712,graph paper,20,40,20,1,00068,India
382544,2023-07-19,712,graph paper,20,40,20,1,00214,India
382544,2023-07-19,706,sharpener,3,8,5,1,00214,India
382544,2023-07-19,713,ball pen,5,10,5,1,00214,India
546759,2023-07-19,703,eraser,1,3,2,1,00244,India
546759,2023-07-19,713,ball pen,5,10,5,1,00244,India
546759,2023-07-19,705,stencil,10,20,10,1,00244,India
546759,2023-07-19,708,sketchpen,15,40,25,1,00244,India
215248,2023-07-19,711,TD kit,150,300,150,1,00376,India
215248,2023-07-19,708,sketchpen,15,40,25,1,00376,India
361528,2023-07-19,707,marker,20,40,20,1,00301,India
361528,2023-07-19,701,gel pen,5,10,5,1,00301,India
724948,2023-07-19,706,sharpener,3,8,5,1,00492,India
724948,2023-07-19,713,ball pen,5,10,5,1,00492,India
954303,2023-07-19,707,marker,20,40,20,1,00100,India
954303,2023-07-19,702,pencil,2,5,3,1,00100,India
954303,2023-07-19,705,stencil,10,20,10,1,00100,India
954303,2023-07-19,708,sketchpen,15,40,25,1,00100,India
954303,2023-07-19,717,spiral bound book,50,100,50,1,00100,India
616808,2023-07-19,705,stencil,10,20,10,1,00112,India
784835,2023-07-19,703,eraser,1,3,2,1,00247,India
784835,2023-07-19,708,sketchpen,15,40,25,1,00247,India
784835,2023-07-19,702,pencil,2,5,3,1,00247,India
119883,2023-07-19,706,sharpener,3,8,5,1,00101,India
440544,2023-07-19,712,graph paper,20,40,20,1,00494,India
440544,2023-07-19,706,sharpener,3,8,5,1,00494,India
440544,2023-07-19,703,eraser,1,3,2,1,00494,India
440544,2023-07-19,714,carbon paper,15,30,15,1,00494,India
855340,2023-07-19,706,sharpener,3,8,5,1,00088,India
855340,2023-07-19,711,TD kit,150,300,150,1,00088,India
855340,2023-07-19,708,sketchpen,15,40,25,1,00088,India
855340,2023-07-19,715,folder,5,15,10,1,00088,India
197093,2023-07-19,704,scale,5,10,5,1,00350,India
197093,2023-07-19,701,gel pen,5,10,5,1,00350,India
197093,2023-07-19,714,carbon paper,15,30,15,1,00350,India
708927,2023-07-19,712,graph paper,20,40,20,1,00053,India
708927,2023-07-19,703,eraser,1,3,2,1,00053,India
708927,2023-07-19,708,sketchpen,15,40,25,1,00053,India
708927,2023-07-19,710,geometry box,100,150,50,1,00053,India
448302,2023-07-19,708,sketchpen,15,40,25,1,00399,India
448302,2023-07-19,717,spiral bound book,50,100,50,1,00399,India
448302,2023-07-19,711,TD kit,150,300,150,1,00399,India
448302,2023-07-19,707,marker,20,40,20,1,00399,India
599345,2023-07-19,702,pencil,2,5,3,1,00494,India
599345,2023-07-19,703,eraser,1,3,2,1,00494,India
251725,2023-07-19,717,spiral bound book,50,100,50,1,00209,India
251725,2023-07-19,710,geometry box,100,150,50,1,00209,India
251725,2023-07-19,712,graph paper,20,40,20,1,00209,India
251725,2023-07-19,701,gel pen,5,10,5,1,00209,India
251725,2023-07-19,713,ball pen,5,10,5,1,00209,India
661082,2023-07-19,713,ball pen,5,10,5,1,00101,India
661082,2023-07-19,707,marker,20,40,20,1,00101,India
383555,2023-07-19,715,folder,5,15,10,1,00393,India
959216,2023-07-19,712,graph paper,20,40,20,1,00358,India
959216,2023-07-19,704,scale,5,10,5,1,00358,India
959216,2023-07-19,709,notebook,30,60,30,1,00358,India
894127,2023-07-19,709,notebook,30,60,30,1,00359,India
894127,2023-07-19,713,ball pen,5,10,5,1,00359,India
311861,2023-07-19,716,printing paper,200,400,200,1,00180,India
369369,2023-07-19,701,gel pen,5,10,5,1,00376,India
782658,2023-07-19,717,spiral bound book,50,100,50,1,00388,India
782658,2023-07-19,707,marker,20,40,20,1,00388,India
132390,2023-07-19,715,folder,5,15,10,1,00098,India
132390,2023-07-19,714,carbon paper,15,30,15,1,00098,India
132390,2023-07-19,716,printing paper,200,400,200,1,00098,India
132390,2023-07-19,713,ball pen,5,10,5,1,00098,India
132390,2023-07-19,712,graph paper,20,40,20,1,00098,India
615278,2023-07-19,715,folder,5,15,10,1,00009,India
615278,2023-07-19,712,graph paper,20,40,20,1,00009,India
694582,2023-07-19,705,stencil,10,20,10,1,00301,India
542488,2023-07-19,716,printing paper,200,400,200,1,00036,India
494098,2023-07-19,705,stencil,10,20,10,1,00107,India
494098,2023-07-19,714,carbon paper,15,30,15,1,00107,India
960029,2023-07-19,707,marker,20,40,20,1,00286,India
960029,2023-07-19,705,stencil,10,20,10,1,00286,India
960029,2023-07-19,711,TD kit,150,300,150,1,00286,India
926361,2023-07-19,703,eraser,1,3,2,1,00033,India
926361,2023-07-19,710,geometry box,100,150,50,1,00033,India
465164,2023-07-19,717,spiral bound book,50,100,50,1,00486,India
465164,2023-07-19,716,printing paper,200,400,200,1,00486,India
169335,2023-07-19,707,marker,20,40,20,1,00273,India
169335,2023-07-19,711,TD kit,150,300,150,1,00273,India
169335,2023-07-19,715,folder,5,15,10,1,00273,India
169335,2023-07-19,712,graph paper,20,40,20,1,00273,India
169335,2023-07-19,717,spiral bound book,50,100,50,1,00273,India
361182,2023-07-19,706,sharpener,3,8,5,1,00400,India
361182,2023-07-19,705,stencil,10,20,10,1,00400,India
361182,2023-07-19,702,pencil,2,5,3,1,00400,India
361182,2023-07-19,708,sketchpen,15,40,25,1,00400,India
139960,2023-07-19,715,folder,5,15,10,1,00006,India
139960,2023-07-19,710,geometry box,100,150,50,1,00006,India
229350,2023-07-19,709,notebook,30,60,30,1,00204,India
988523,2023-07-19,715,folder,5,15,10,1,00367,India
988523,2023-07-19,711,TD kit,150,300,150,1,00367,India
988523,2023-07-19,708,sketchpen,15,40,25,1,00367,India
988523,2023-07-19,713,ball pen,5,10,5,1,00367,India
988523,2023-07-19,712,graph paper,20,40,20,1,00367,India
315823,2023-07-19,714,carbon paper,15,30,15,1,00010,India
315823,2023-07-19,717,spiral bound book,50,100,50,1,00010,India
245876,2023-07-19,715,folder,5,15,10,1,00018,India
245876,2023-07-19,703,eraser,1,3,2,1,00018,India
197110,2023-07-19,716,printing paper,200,400,200,1,00131,India
197110,2023-07-19,703,eraser,1,3,2,1,00131,India
788313,2023-07-20,713,ball pen,5,10,5,1,00110,India
788313,2023-07-20,709,notebook,30,60,30,1,00110,India
717392,2023-07-20,710,geometry box,100,150,50,1,00371,India
717392,2023-07-20,705,stencil,10,20,10,1,00371,India
310981,2023-07-20,714,carbon paper,15,30,15,1,00256,India
984135,2023-07-20,712,graph paper,20,40,20,1,00413,India
332936,2023-07-20,714,carbon paper,15,30,15,1,00210,India
332936,2023-07-20,713,ball pen,5,10,5,1,00210,India
909928,2023-07-20,704,scale,5,10,5,1,00145,India
909928,2023-07-20,703,eraser,1,3,2,1,00145,India
604286,2023-07-20,712,graph paper,20,40,20,1,00021,India
592239,2023-07-20,716,printing paper,200,400,200,1,00456,India
592239,2023-07-20,712,graph paper,20,40,20,1,00456,India
592239,2023-07-20,703,eraser,1,3,2,1,00456,India
727726,2023-07-20,714,carbon paper,15,30,15,1,00366,India
727726,2023-07-20,705,stencil,10,20,10,1,00366,India
727726,2023-07-20,711,TD kit,150,300,150,1,00366,India
727726,2023-07-20,710,geometry box,100,150,50,1,00366,India
613762,2023-07-20,710,geometry box,100,150,50,1,00177,India
613762,2023-07-20,704,scale,5,10,5,1,00177,India
613762,2023-07-20,705,stencil,10,20,10,1,00177,India
419869,2023-07-20,716,printing paper,200,400,200,1,00408,India
419869,2023-07-20,715,folder,5,15,10,1,00408,India
216464,2023-07-20,716,printing paper,200,400,200,1,00422,India
216464,2023-07-20,704,scale,5,10,5,1,00422,India
216464,2023-07-20,702,pencil,2,5,3,1,00422,India
216464,2023-07-20,714,carbon paper,15,30,15,1,00422,India
985107,2023-07-20,715,folder,5,15,10,1,00047,India
711243,2023-07-20,709,notebook,30,60,30,1,00127,India
711243,2023-07-20,701,gel pen,5,10,5,1,00127,India
711243,2023-07-20,702,pencil,2,5,3,1,00127,India
711243,2023-07-20,714,carbon paper,15,30,15,1,00127,India
711243,2023-07-20,711,TD kit,150,300,150,1,00127,India
183672,2023-07-20,704,scale,5,10,5,1,00141,India
183672,2023-07-20,708,sketchpen,15,40,25,1,00141,India
871708,2023-07-20,703,eraser,1,3,2,1,00267,India
871708,2023-07-20,704,scale,5,10,5,1,00267,India
871708,2023-07-20,717,spiral bound book,50,100,50,1,00267,India
871708,2023-07-20,715,folder,5,15,10,1,00267,India
871708,2023-07-20,710,geometry box,100,150,50,1,00267,India
125712,2023-07-20,707,marker,20,40,20,1,00032,India
692619,2023-07-20,708,sketchpen,15,40,25,1,00467,India
714192,2023-07-20,701,gel pen,5,10,5,1,00242,India
714192,2023-07-20,707,marker,20,40,20,1,00242,India
714192,2023-07-20,709,notebook,30,60,30,1,00242,India
714192,2023-07-20,703,eraser,1,3,2,1,00242,India
714192,2023-07-20,706,sharpener,3,8,5,1,00242,India
724606,2023-07-20,703,eraser,1,3,2,1,00411,India
724606,2023-07-20,708,sketchpen,15,40,25,1,00411,India
724606,2023-07-20,717,spiral bound book,50,100,50,1,00411,India
724606,2023-07-20,711,TD kit,150,300,150,1,00411,India
724606,2023-07-20,714,carbon paper,15,30,15,1,00411,India
592059,2023-07-20,701,gel pen,5,10,5,1,00063,India
592059,2023-07-20,708,sketchpen,15,40,25,1,00063,India
592059,2023-07-20,714,carbon paper,15,30,15,1,00063,India
462962,2023-07-20,702,pencil,2,5,3,1,00311,India
462962,2023-07-20,708,sketchpen,15,40,25,1,00311,India
462962,2023-07-20,705,stencil,10,20,10,1,00311,India
462962,2023-07-20,711,TD kit,150,300,150,1,00311,India
462962,2023-07-20,715,folder,5,15,10,1,00311,India
894799,2023-07-20,704,scale,5,10,5,1,00392,India
894799,2023-07-20,706,sharpener,3,8,5,1,00392,India
894799,2023-07-20,708,sketchpen,15,40,25,1,00392,India
894799,2023-07-20,714,carbon paper,15,30,15,1,00392,India
262676,2023-07-20,711,TD kit,150,300,150,1,00080,India
262676,2023-07-20,705,stencil,10,20,10,1,00080,India
262676,2023-07-20,714,carbon paper,15,30,15,1,00080,India
262676,2023-07-20,716,printing paper,200,400,200,1,00080,India
799864,2023-07-20,711,TD kit,150,300,150,1,00425,India
799864,2023-07-20,713,ball pen,5,10,5,1,00425,India
977683,2023-07-20,708,sketchpen,15,40,25,1,00015,India
395866,2023-07-20,715,folder,5,15,10,1,00307,India
395866,2023-07-20,709,notebook,30,60,30,1,00307,India
395866,2023-07-20,717,spiral bound book,50,100,50,1,00307,India
395866,2023-07-20,702,pencil,2,5,3,1,00307,India
107658,2023-07-20,711,TD kit,150,300,150,1,00100,India
107658,2023-07-20,705,stencil,10,20,10,1,00100,India
107658,2023-07-20,709,notebook,30,60,30,1,00100,India
107658,2023-07-20,702,pencil,2,5,3,1,00100,India
248966,2023-07-20,717,spiral bound book,50,100,50,1,00406,India
286275,2023-07-20,708,sketchpen,15,40,25,1,00446,India
286275,2023-07-20,710,geometry box,100,150,50,1,00446,India
286275,2023-07-20,712,graph paper,20,40,20,1,00446,India
286275,2023-07-20,702,pencil,2,5,3,1,00446,India
248496,2023-07-20,703,eraser,1,3,2,1,00198,India
248496,2023-07-20,704,scale,5,10,5,1,00198,India
248496,2023-07-20,706,sharpener,3,8,5,1,00198,India
426758,2023-07-20,704,scale,5,10,5,1,00154,India
426758,2023-07-20,707,marker,20,40,20,1,00154,India
426758,2023-07-20,708,sketchpen,15,40,25,1,00154,India
671363,2023-07-20,702,pencil,2,5,3,1,00027,India
671363,2023-07-20,712,graph paper,20,40,20,1,00027,India
671363,2023-07-20,706,sharpener,3,8,5,1,00027,India
671363,2023-07-20,705,stencil,10,20,10,1,00027,India
671363,2023-07-20,703,eraser,1,3,2,1,00027,India
845722,2023-07-20,707,marker,20,40,20,1,00200,India
845722,2023-07-20,715,folder,5,15,10,1,00200,India
730995,2023-07-20,708,sketchpen,15,40,25,1,00008,India
730995,2023-07-20,715,folder,5,15,10,1,00008,India
730995,2023-07-20,717,spiral bound book,50,100,50,1,00008,India
730995,2023-07-20,707,marker,20,40,20,1,00008,India
110488,2023-07-20,708,sketchpen,15,40,25,1,00255,India
110488,2023-07-20,703,eraser,1,3,2,1,00255,India
110488,2023-07-20,713,ball pen,5,10,5,1,00255,India
110488,2023-07-20,704,scale,5,10,5,1,00255,India
430845,2023-07-20,709,notebook,30,60,30,1,00376,India
430845,2023-07-20,715,folder,5,15,10,1,00376,India
367505,2023-07-20,717,spiral bound book,50,100,50,1,00418,India
367505,2023-07-20,708,sketchpen,15,40,25,1,00418,India
584155,2023-07-20,702,pencil,2,5,3,1,00422,India
584155,2023-07-20,712,graph paper,20,40,20,1,00422,India
584155,2023-07-20,705,stencil,10,20,10,1,00422,India
334733,2023-07-20,703,eraser,1,3,2,1,00243,India
804613,2023-07-21,705,stencil,10,20,10,1,00010,India
804613,2023-07-21,713,ball pen,5,10,5,1,00010,India
398688,2023-07-21,715,folder,5,15,10,1,00189,India
398688,2023-07-21,701,gel pen,5,10,5,1,00189,India
239764,2023-07-21,715,folder,5,15,10,1,00206,India
411713,2023-07-21,704,scale,5,10,5,1,00027,India
411713,2023-07-21,712,graph paper,20,40,20,1,00027,India
603951,2023-07-21,717,spiral bound book,50,100,50,1,00072,India
603951,2023-07-21,713,ball pen,5,10,5,1,00072,India
427523,2023-07-21,701,gel pen,5,10,5,1,00377,India
201293,2023-07-21,717,spiral bound book,50,100,50,1,00471,India
719131,2023-07-21,708,sketchpen,15,40,25,1,00068,India
719131,2023-07-21,712,graph paper,20,40,20,1,00068,India
944233,2023-07-21,711,TD kit,150,300,150,1,00478,India
734187,2023-07-21,714,carbon paper,15,30,15,1,00136,India
482762,2023-07-21,701,gel pen,5,10,5,1,00236,India
482762,2023-07-21,703,eraser,1,3,2,1,00236,India
482762,2023-07-21,710,geometry box,100,150,50,1,00236,India
482762,2023-07-21,706,sharpener,3,8,5,1,00236,India
482762,2023-07-21,714,carbon paper,15,30,15,1,00236,India
486607,2023-07-21,707,marker,20,40,20,1,00453,India
125420,2023-07-21,716,printing paper,200,400,200,1,00142,India
125420,2023-07-21,702,pencil,2,5,3,1,00142,India
125420,2023-07-21,707,marker,20,40,20,1,00142,India
125420,2023-07-21,706,sharpener,3,8,5,1,00142,India
732549,2023-07-21,713,ball pen,5,10,5,1,00442,India
732549,2023-07-21,710,geometry box,100,150,50,1,00442,India
732549,2023-07-21,707,marker,20,40,20,1,00442,India
732549,2023-07-21,706,sharpener,3,8,5,1,00442,India
698539,2023-07-21,704,scale,5,10,5,1,00076,India
468194,2023-07-21,701,gel pen,5,10,5,1,00015,India
468194,2023-07-21,712,graph paper,20,40,20,1,00015,India
468194,2023-07-21,717,spiral bound book,50,100,50,1,00015,India
468194,2023-07-21,704,scale,5,10,5,1,00015,India
601975,2023-07-21,705,stencil,10,20,10,1,00071,India
601975,2023-07-21,715,folder,5,15,10,1,00071,India
601975,2023-07-21,717,spiral bound book,50,100,50,1,00071,India
162515,2023-07-21,706,sharpener,3,8,5,1,00172,India
162515,2023-07-21,714,carbon paper,15,30,15,1,00172,India
162515,2023-07-21,708,sketchpen,15,40,25,1,00172,India
832539,2023-07-21,715,folder,5,15,10,1,00042,India
960500,2023-07-21,711,TD kit,150,300,150,1,00232,India
960500,2023-07-21,701,gel pen,5,10,5,1,00232,India
960500,2023-07-21,705,stencil,10,20,10,1,00232,India
283417,2023-07-21,707,marker,20,40,20,1,00410,India
283417,2023-07-21,702,pencil,2,5,3,1,00410,India
561624,2023-07-21,710,geometry box,100,150,50,1,00462,India
818769,2023-07-21,715,folder,5,15,10,1,00433,India
449500,2023-07-21,706,sharpener,3,8,5,1,00401,India
449500,2023-07-21,717,spiral bound book,50,100,50,1,00401,India
449500,2023-07-21,710,geometry box,100,150,50,1,00401,India
449500,2023-07-21,705,stencil,10,20,10,1,00401,India
449500,2023-07-21,716,printing paper,200,400,200,1,00401,India
515168,2023-07-21,715,folder,5,15,10,1,00232,India
705981,2023-07-21,702,pencil,2,5,3,1,00275,India
705981,2023-07-21,706,sharpener,3,8,5,1,00275,India
705981,2023-07-21,716,printing paper,200,400,200,1,00275,India
705981,2023-07-21,710,geometry box,100,150,50,1,00275,India
481487,2023-07-21,713,ball pen,5,10,5,1,00344,India
481487,2023-07-21,703,eraser,1,3,2,1,00344,India
481487,2023-07-21,714,carbon paper,15,30,15,1,00344,India
481487,2023-07-21,716,printing paper,200,400,200,1,00344,India
811243,2023-07-21,706,sharpener,3,8,5,1,00364,India
811243,2023-07-21,717,spiral bound book,50,100,50,1,00364,India
811243,2023-07-21,702,pencil,2,5,3,1,00364,India
865421,2023-07-21,703,eraser,1,3,2,1,00123,India
865421,2023-07-21,714,carbon paper,15,30,15,1,00123,India
530550,2023-07-21,707,marker,20,40,20,1,00382,India
530550,2023-07-21,716,printing paper,200,400,200,1,00382,India
530550,2023-07-21,712,graph paper,20,40,20,1,00382,India
530550,2023-07-21,704,scale,5,10,5,1,00382,India
369096,2023-07-21,702,pencil,2,5,3,1,00500,India
369096,2023-07-21,716,printing paper,200,400,200,1,00500,India
369096,2023-07-21,717,spiral bound book,50,100,50,1,00500,India
265469,2023-07-21,713,ball pen,5,10,5,1,00259,India
265469,2023-07-21,716,printing paper,200,400,200,1,00259,India
265469,2023-07-21,710,geometry box,100,150,50,1,00259,India
199521,2023-07-21,716,printing paper,200,400,200,1,00194,India
419442,2023-07-21,705,stencil,10,20,10,1,00315,India
646180,2023-07-21,702,pencil,2,5,3,1,00182,India
646180,2023-07-21,715,folder,5,15,10,1,00182,India
856494,2023-07-21,713,ball pen,5,10,5,1,00087,India
856494,2023-07-21,712,graph paper,20,40,20,1,00087,India
856494,2023-07-21,706,sharpener,3,8,5,1,00087,India
856494,2023-07-21,711,TD kit,150,300,150,1,00087,India
856494,2023-07-21,710,geometry box,100,150,50,1,00087,India
177520,2023-07-21,715,folder,5,15,10,1,00369,India
177520,2023-07-21,701,gel pen,5,10,5,1,00369,India
177520,2023-07-21,707,marker,20,40,20,1,00369,India
983010,2023-07-21,710,geometry box,100,150,50,1,00381,India
764668,2023-07-21,705,stencil,10,20,10,1,00052,India
764668,2023-07-21,715,folder,5,15,10,1,00052,India
913819,2023-07-21,706,sharpener,3,8,5,1,00443,India
913819,2023-07-21,707,marker,20,40,20,1,00443,India
913819,2023-07-21,704,scale,5,10,5,1,00443,India
913819,2023-07-21,715,folder,5,15,10,1,00443,India
913819,2023-07-21,717,spiral bound book,50,100,50,1,00443,India
956993,2023-07-21,703,eraser,1,3,2,1,00073,India
550186,2023-07-21,709,notebook,30,60,30,1,00209,India
550186,2023-07-21,712,graph paper,20,40,20,1,00209,India
481415,2023-07-21,708,sketchpen,15,40,25,1,00420,India
481415,2023-07-21,707,marker,20,40,20,1,00420,India
481415,2023-07-21,705,stencil,10,20,10,1,00420,India
115360,2023-07-21,708,sketchpen,15,40,25,1,00023,India
115360,2023-07-21,703,eraser,1,3,2,1,00023,India
115360,2023-07-21,711,TD kit,150,300,150,1,00023,India
115360,2023-07-21,715,folder,5,15,10,1,00023,India
115360,2023-07-21,710,geometry box,100,150,50,1,00023,India
425593,2023-07-21,714,carbon paper,15,30,15,1,00353,India
425593,2023-07-21,713,ball pen,5,10,5,1,00353,India
715638,2023-07-21,705,stencil,10,20,10,1,00226,India
715638,2023-07-21,714,carbon paper,15,30,15,1,00226,India
463092,2023-07-21,706,sharpener,3,8,5,1,00438,India
807264,2023-07-21,712,graph paper,20,40,20,1,00034,India
807264,2023-07-21,708,sketchpen,15,40,25,1,00034,India
807264,2023-07-21,714,carbon paper,15,30,15,1,00034,India
807264,2023-07-21,713,ball pen,5,10,5,1,00034,India
653119,2023-07-21,709,notebook,30,60,30,1,00112,India
653119,2023-07-21,703,eraser,1,3,2,1,00112,India
164428,2023-07-21,714,carbon paper,15,30,15,1,00071,India
718804,2023-07-22,706,sharpener,3,8,5,1,00387,India
718804,2023-07-22,703,eraser,1,3,2,1,00387,India
718804,2023-07-22,701,gel pen,5,10,5,1,00387,India
804281,2023-07-22,708,sketchpen,15,40,25,1,00053,India
804281,2023-07-22,707,marker,20,40,20,1,00053,India
302199,2023-07-22,706,sharpener,3,8,5,1,00087,India
302199,2023-07-22,703,eraser,1,3,2,1,00087,India
302199,2023-07-22,714,carbon paper,15,30,15,1,00087,India
638123,2023-07-22,701,gel pen,5,10,5,1,00427,India
765626,2023-07-22,714,carbon paper,15,30,15,1,00014,India
417531,2023-07-22,701,gel pen,5,10,5,1,00013,India
417531,2023-07-22,705,stencil,10,20,10,1,00013,India
859969,2023-07-22,717,spiral bound book,50,100,50,1,00292,India
859969,2023-07-22,716,printing paper,200,400,200,1,00292,India
709351,2023-07-22,714,carbon paper,15,30,15,1,00352,India
709351,2023-07-22,705,stencil,10,20,10,1,00352,India
709351,2023-07-22,715,folder,5,15,10,1,00352,India
709351,2023-07-22,704,scale,5,10,5,1,00352,India
120055,2023-07-22,701,gel pen,5,10,5,1,00101,India
728693,2023-07-22,709,notebook,30,60,30,1,00257,India
438423,2023-07-22,709,notebook,30,60,30,1,00035,India
402327,2023-07-22,708,sketchpen,15,40,25,1,00049,India
402327,2023-07-22,710,geometry box,100,150,50,1,00049,India
289456,2023-07-22,705,stencil,10,20,10,1,00060,India
289456,2023-07-22,717,spiral bound book,50,100,50,1,00060,India
289456,2023-07-22,702,pencil,2,5,3,1,00060,India
289456,2023-07-22,707,marker,20,40,20,1,00060,India
286827,2023-07-22,704,scale,5,10,5,1,00160,India
286827,2023-07-22,709,notebook,30,60,30,1,00160,India
416010,2023-07-22,703,eraser,1,3,2,1,00249,India
416010,2023-07-22,707,marker,20,40,20,1,00249,India
416010,2023-07-22,716,printing paper,200,400,200,1,00249,India
352323,2023-07-22,710,geometry box,100,150,50,1,00447,India
352323,2023-07-22,716,printing paper,200,400,200,1,00447,India
352323,2023-07-22,701,gel pen,5,10,5,1,00447,India
849884,2023-07-22,717,spiral bound book,50,100,50,1,00095,India
849884,2023-07-22,708,sketchpen,15,40,25,1,00095,India
708366,2023-07-22,715,folder,5,15,10,1,00427,India
439371,2023-07-22,702,pencil,2,5,3,1,00170,India
439371,2023-07-22,707,marker,20,40,20,1,00170,India
439371,2023-07-22,712,graph paper,20,40,20,1,00170,India
439371,2023-07-22,710,geometry box,100,150,50,1,00170,India
526180,2023-07-22,716,printing paper,200,400,200,1,00235,India
526180,2023-07-22,708,sketchpen,15,40,25,1,00235,India
161768,2023-07-22,702,pencil,2,5,3,1,00212,India
161768,2023-07-22,717,spiral bound book,50,100,50,1,00212,India
161768,2023-07-22,714,carbon paper,15,30,15,1,00212,India
795533,2023-07-22,704,scale,5,10,5,1,00406,India
795533,2023-07-22,713,ball pen,5,10,5,1,00406,India
578368,2023-07-22,710,geometry box,100,150,50,1,00229,India
148344,2023-07-22,713,ball pen,5,10,5,1,00372,India
148344,2023-07-22,705,stencil,10,20,10,1,00372,India
869181,2023-07-22,712,graph paper,20,40,20,1,00215,India
869181,2023-07-22,716,printing paper,200,400,200,1,00215,India
869181,2023-07-22,709,notebook,30,60,30,1,00215,India
869181,2023-07-22,708,sketchpen,15,40,25,1,00215,India
869181,2023-07-22,703,eraser,1,3,2,1,00215,India
470943,2023-07-22,716,printing paper,200,400,200,1,00471,India
470943,2023-07-22,706,sharpener,3,8,5,1,00471,India
470943,2023-07-22,717,spiral bound book,50,100,50,1,00471,India
470943,2023-07-22,701,gel pen,5,10,5,1,00471,India
472016,2023-07-22,711,TD kit,150,300,150,1,00210,India
472016,2023-07-22,702,pencil,2,5,3,1,00210,India
472016,2023-07-22,715,folder,5,15,10,1,00210,India
472016,2023-07-22,714,carbon paper,15,30,15,1,00210,India
111587,2023-07-22,703,eraser,1,3,2,1,00136,India
111587,2023-07-22,710,geometry box,100,150,50,1,00136,India
111587,2023-07-22,709,notebook,30,60,30,1,00136,India
111587,2023-07-22,706,sharpener,3,8,5,1,00136,India
758298,2023-07-22,710,geometry box,100,150,50,1,00361,India
758298,2023-07-22,709,notebook,30,60,30,1,00361,India
758298,2023-07-22,715,folder,5,15,10,1,00361,India
758298,2023-07-22,705,stencil,10,20,10,1,00361,India
870975,2023-07-22,711,TD kit,150,300,150,1,00298,India
870975,2023-07-22,704,scale,5,10,5,1,00298,India
329336,2023-07-22,703,eraser,1,3,2,1,00084,India
329336,2023-07-22,715,folder,5,15,10,1,00084,India
385266,2023-07-22,715,folder,5,15,10,1,00089,India
385266,2023-07-22,703,eraser,1,3,2,1,00089,India
385266,2023-07-22,716,printing paper,200,400,200,1,00089,India
598114,2023-07-22,702,pencil,2,5,3,1,00200,India
598114,2023-07-22,712,graph paper,20,40,20,1,00200,India
598114,2023-07-22,705,stencil,10,20,10,1,00200,India
598114,2023-07-22,710,geometry box,100,150,50,1,00200,India
598114,2023-07-22,711,TD kit,150,300,150,1,00200,India
640988,2023-07-22,717,spiral bound book,50,100,50,1,00078,India
640988,2023-07-22,710,geometry box,100,150,50,1,00078,India
112832,2023-07-22,716,printing paper,200,400,200,1,00498,India
112832,2023-07-22,702,pencil,2,5,3,1,00498,India
104454,2023-07-22,714,carbon paper,15,30,15,1,00097,India
104454,2023-07-22,705,stencil,10,20,10,1,00097,India
520654,2023-07-22,708,sketchpen,15,40,25,1,00114,India
520654,2023-07-22,715,folder,5,15,10,1,00114,India
520654,2023-07-22,711,TD kit,150,300,150,1,00114,India
520654,2023-07-22,704,scale,5,10,5,1,00114,India
885495,2023-07-22,705,stencil,10,20,10,1,00100,India
885495,2023-07-22,717,spiral bound book,50,100,50,1,00100,India
885495,2023-07-22,716,printing paper,200,400,200,1,00100,India
954687,2023-07-22,715,folder,5,15,10,1,00475,India
954687,2023-07-22,710,geometry box,100,150,50,1,00475,India
188809,2023-07-23,707,marker,20,40,20,1,00042,India
188809,2023-07-23,706,sharpener,3,8,5,1,00042,India
188809,2023-07-23,701,gel pen,5,10,5,1,00042,India
188809,2023-07-23,717,spiral bound book,50,100,50,1,00042,India
188809,2023-07-23,702,pencil,2,5,3,1,00042,India
950392,2023-07-23,714,carbon paper,15,30,15,1,00448,India
950392,2023-07-23,711,TD kit,150,300,150,1,00448,India
950392,2023-07-23,702,pencil,2,5,3,1,00448,India
950392,2023-07-23,704,scale,5,10,5,1,00448,India
703155,2023-07-23,705,stencil,10,20,10,1,00006,India
703155,2023-07-23,709,notebook,30,60,30,1,00006,India
703155,2023-07-23,713,ball pen,5,10,5,1,00006,India
703155,2023-07-23,714,carbon paper,15,30,15,1,00006,India
527469,2023-07-23,701,gel pen,5,10,5,1,00051,India
527469,2023-07-23,710,geometry box,100,150,50,1,00051,India
527469,2023-07-23,706,sharpener,3,8,5,1,00051,India
527469,2023-07-23,715,folder,5,15,10,1,00051,India
468538,2023-07-23,716,printing paper,200,400,200,1,00074,India
468538,2023-07-23,705,stencil,10,20,10,1,00074,India
468538,2023-07-23,703,eraser,1,3,2,1,00074,India
468538,2023-07-23,706,sharpener,3,8,5,1,00074,India
466897,2023-07-23,701,gel pen,5,10,5,1,00260,India
853160,2023-07-23,710,geometry box,100,150,50,1,00275,India
853160,2023-07-23,703,eraser,1,3,2,1,00275,India
853160,2023-07-23,709,notebook,30,60,30,1,00275,India
853160,2023-07-23,706,sharpener,3,8,5,1,00275,India
853160,2023-07-23,711,TD kit,150,300,150,1,00275,India
296598,2023-07-23,715,folder,5,15,10,1,00231,India
721252,2023-07-23,705,stencil,10,20,10,1,00106,India
932151,2023-07-23,703,eraser,1,3,2,1,00195,India
932151,2023-07-23,708,sketchpen,15,40,25,1,00195,India
132192,2023-07-23,701,gel pen,5,10,5,1,00219,India
618397,2023-07-23,711,TD kit,150,300,150,1,00472,India
618397,2023-07-23,701,gel pen,5,10,5,1,00472,India
859831,2023-07-23,706,sharpener,3,8,5,1,00393,India
859831,2023-07-23,708,sketchpen,15,40,25,1,00393,India
859831,2023-07-23,711,TD kit,150,300,150,1,00393,India
859831,2023-07-23,709,notebook,30,60,30,1,00393,India
843267,2023-07-23,708,sketchpen,15,40,25,1,00226,India
843267,2023-07-23,704,scale,5,10,5,1,00226,India
886504,2023-07-23,708,sketchpen,15,40,25,1,00320,India
886504,2023-07-23,712,graph paper,20,40,20,1,00320,India
886504,2023-07-23,716,printing paper,200,400,200,1,00320,India
584549,2023-07-23,715,folder,5,15,10,1,00254,India
584549,2023-07-23,705,stencil,10,20,10,1,00254,India
584549,2023-07-23,713,ball pen,5,10,5,1,00254,India
584549,2023-07-23,716,printing paper,200,400,200,1,00254,India
584549,2023-07-23,708,sketchpen,15,40,25,1,00254,India
872462,2023-07-23,704,scale,5,10,5,1,00498,India
684960,2023-07-23,704,scale,5,10,5,1,00116,India
684960,2023-07-23,708,sketchpen,15,40,25,1,00116,India
684960,2023-07-23,701,gel pen,5,10,5,1,00116,India
684960,2023-07-23,714,carbon paper,15,30,15,1,00116,India
180702,2023-07-23,701,gel pen,5,10,5,1,00152,India
596222,2023-07-23,715,folder,5,15,10,1,00009,India
596222,2023-07-23,717,spiral bound book,50,100,50,1,00009,India
547508,2023-07-23,717,spiral bound book,50,100,50,1,00353,India
547508,2023-07-23,716,printing paper,200,400,200,1,00353,India
547508,2023-07-23,704,scale,5,10,5,1,00353,India
547508,2023-07-23,709,notebook,30,60,30,1,00353,India
547508,2023-07-23,707,marker,20,40,20,1,00353,India
723226,2023-07-23,701,gel pen,5,10,5,1,00146,India
723226,2023-07-23,716,printing paper,200,400,200,1,00146,India
723226,2023-07-23,705,stencil,10,20,10,1,00146,India
723226,2023-07-23,715,folder,5,15,10,1,00146,India
723226,2023-07-23,702,pencil,2,5,3,1,00146,India
594495,2023-07-23,709,notebook,30,60,30,1,00089,India
594495,2023-07-23,713,ball pen,5,10,5,1,00089,India
594495,2023-07-23,707,marker,20,40,20,1,00089,India
141893,2023-07-23,703,eraser,1,3,2,1,00440,India
141893,2023-07-23,707,marker,20,40,20,1,00440,India
909726,2023-07-23,710,geometry box,100,150,50,1,00310,India
909726,2023-07-23,707,marker,20,40,20,1,00310,India
909726,2023-07-23,706,sharpener,3,8,5,1,00310,India
348265,2023-07-23,712,graph paper,20,40,20,1,00261,India
348265,2023-07-23,717,spiral bound book,50,100,50,1,00261,India
971902,2023-07-23,710,geometry box,100,150,50,1,00307,India
989830,2023-07-23,703,eraser,1,3,2,1,00227,India
989830,2023-07-23,707,marker,20,40,20,1,00227,India
989830,2023-07-23,705,stencil,10,20,10,1,00227,India
316810,2023-07-23,713,ball pen,5,10,5,1,00283,India
316810,2023-07-23,717,spiral bound book,50,100,50,1,00283,India
316810,2023-07-23,704,scale,5,10,5,1,00283,India
316810,2023-07-23,703,eraser,1,3,2,1,00283,India
213540,2023-07-23,702,pencil,2,5,3,1,00467,India
213540,2023-07-23,709,notebook,30,60,30,1,00467,India
152523,2023-07-23,708,sketchpen,15,40,25,1,00206,India
152523,2023-07-23,703,eraser,1,3,2,1,00206,India
152523,2023-07-23,717,spiral bound book,50,100,50,1,00206,India
498462,2023-07-23,715,folder,5,15,10,1,00247,India
498462,2023-07-23,713,ball pen,5,10,5,1,00247,India
233740,2023-07-23,713,ball pen,5,10,5,1,00010,India
233740,2023-07-23,717,spiral bound book,50,100,50,1,00010,India
233740,2023-07-23,706,sharpener,3,8,5,1,00010,India
233740,2023-07-23,707,marker,20,40,20,1,00010,India
916604,2023-07-23,707,marker,20,40,20,1,00216,India
642969,2023-07-23,712,graph paper,20,40,20,1,00337,India
642969,2023-07-23,709,notebook,30,60,30,1,00337,India
642969,2023-07-23,703,eraser,1,3,2,1,00337,India
642969,2023-07-23,717,spiral bound book,50,100,50,1,00337,India
168122,2023-07-23,707,marker,20,40,20,1,00010,India
168122,2023-07-23,714,carbon paper,15,30,15,1,00010,India
168122,2023-07-23,711,TD kit,150,300,150,1,00010,India
168122,2023-07-23,712,graph paper,20,40,20,1,00010,India
575511,2023-07-23,708,sketchpen,15,40,25,1,00226,India
575511,2023-07-23,701,gel pen,5,10,5,1,00226,India
575511,2023-07-23,703,eraser,1,3,2,1,00226,India
575511,2023-07-23,712,graph paper,20,40,20,1,00226,India
575511,2023-07-23,707,marker,20,40,20,1,00226,India
253561,2023-07-23,713,ball pen,5,10,5,1,00274,India
253561,2023-07-23,704,scale,5,10,5,1,00274,India
253561,2023-07-23,707,marker,20,40,20,1,00274,India
253561,2023-07-23,715,folder,5,15,10,1,00274,India
543842,2023-07-23,704,scale,5,10,5,1,00351,India
543842,2023-07-23,713,ball pen,5,10,5,1,00351,India
543842,2023-07-23,710,geometry box,100,150,50,1,00351,India
543842,2023-07-23,717,spiral bound book,50,100,50,1,00351,India
218832,2023-07-24,707,marker,20,40,20,1,00380,India
218832,2023-07-24,709,notebook,30,60,30,1,00380,India
491303,2023-07-24,702,pencil,2,5,3,1,00218,India
491303,2023-07-24,706,sharpener,3,8,5,1,00218,India
491303,2023-07-24,717,spiral bound book,50,100,50,1,00218,India
491303,2023-07-24,713,ball pen,5,10,5,1,00218,India
335991,2023-07-24,713,ball pen,5,10,5,1,00083,India
335991,2023-07-24,714,carbon paper,15,30,15,1,00083,India
335991,2023-07-24,717,spiral bound book,50,100,50,1,00083,India
875061,2023-07-24,707,marker,20,40,20,1,00426,India
875061,2023-07-24,709,notebook,30,60,30,1,00426,India
875061,2023-07-24,704,scale,5,10,5,1,00426,India
875061,2023-07-24,715,folder,5,15,10,1,00426,India
846994,2023-07-24,701,gel pen,5,10,5,1,00326,India
846994,2023-07-24,705,stencil,10,20,10,1,00326,India
846994,2023-07-24,717,spiral bound book,50,100,50,1,00326,India
860010,2023-07-24,701,gel pen,5,10,5,1,00456,India
860010,2023-07-24,708,sketchpen,15,40,25,1,00456,India
860010,2023-07-24,717,spiral bound book,50,100,50,1,00456,India
340238,2023-07-24,702,pencil,2,5,3,1,00072,India
340238,2023-07-24,714,carbon paper,15,30,15,1,00072,India
340238,2023-07-24,712,graph paper,20,40,20,1,00072,India
340238,2023-07-24,707,marker,20,40,20,1,00072,India
206655,2023-07-24,701,gel pen,5,10,5,1,00144,India
952085,2023-07-24,710,geometry box,100,150,50,1,00154,India
141716,2023-07-24,704,scale,5,10,5,1,00440,India
141716,2023-07-24,701,gel pen,5,10,5,1,00440,India
141716,2023-07-24,716,printing paper,200,400,200,1,00440,India
141716,2023-07-24,713,ball pen,5,10,5,1,00440,India
475848,2023-07-24,705,stencil,10,20,10,1,00268,India
475848,2023-07-24,715,folder,5,15,10,1,00268,India
475848,2023-07-24,714,carbon paper,15,30,15,1,00268,India
475848,2023-07-24,709,notebook,30,60,30,1,00268,India
829713,2023-07-24,701,gel pen,5,10,5,1,00047,India
829713,2023-07-24,702,pencil,2,5,3,1,00047,India
747606,2023-07-24,710,geometry box,100,150,50,1,00251,India
747606,2023-07-24,715,folder,5,15,10,1,00251,India
747606,2023-07-24,713,ball pen,5,10,5,1,00251,India
191058,2023-07-24,707,marker,20,40,20,1,00153,India
191058,2023-07-24,703,eraser,1,3,2,1,00153,India
435755,2023-07-24,710,geometry box,100,150,50,1,00298,India
435755,2023-07-24,704,scale,5,10,5,1,00298,India
435755,2023-07-24,703,eraser,1,3,2,1,00298,India
435755,2023-07-24,716,printing paper,200,400,200,1,00298,India
350687,2023-07-24,712,graph paper,20,40,20,1,00308,India
219602,2023-07-24,713,ball pen,5,10,5,1,00313,India
178300,2023-07-24,711,TD kit,150,300,150,1,00252,India
554967,2023-07-24,702,pencil,2,5,3,1,00388,India
554967,2023-07-24,706,sharpener,3,8,5,1,00388,India
554967,2023-07-24,708,sketchpen,15,40,25,1,00388,India
554967,2023-07-24,711,TD kit,150,300,150,1,00388,India
562046,2023-07-24,705,stencil,10,20,10,1,00330,India
562046,2023-07-24,716,printing paper,200,400,200,1,00330,India
562046,2023-07-24,717,spiral bound book,50,100,50,1,00330,India
562046,2023-07-24,712,graph paper,20,40,20,1,00330,India
562046,2023-07-24,701,gel pen,5,10,5,1,00330,India
537254,2023-07-24,709,notebook,30,60,30,1,00290,India
537254,2023-07-24,713,ball pen,5,10,5,1,00290,India
906224,2023-07-24,714,carbon paper,15,30,15,1,00101,India
906224,2023-07-24,702,pencil,2,5,3,1,00101,India
932281,2023-07-24,704,scale,5,10,5,1,00056,India
585709,2023-07-24,710,geometry box,100,150,50,1,00051,India
549811,2023-07-24,701,gel pen,5,10,5,1,00398,India
502500,2023-07-24,715,folder,5,15,10,1,00465,India
326811,2023-07-24,710,geometry box,100,150,50,1,00412,India
326811,2023-07-24,711,TD kit,150,300,150,1,00412,India
326811,2023-07-24,715,folder,5,15,10,1,00412,India
234012,2023-07-24,711,TD kit,150,300,150,1,00205,India
234012,2023-07-24,708,sketchpen,15,40,25,1,00205,India
616091,2023-07-24,717,spiral bound book,50,100,50,1,00239,India
616091,2023-07-24,711,TD kit,150,300,150,1,00239,India
616091,2023-07-24,707,marker,20,40,20,1,00239,India
616091,2023-07-24,714,carbon paper,15,30,15,1,00239,India
285214,2023-07-24,710,geometry box,100,150,50,1,00383,India
285214,2023-07-24,711,TD kit,150,300,150,1,00383,India
285214,2023-07-24,713,ball pen,5,10,5,1,00383,India
285214,2023-07-24,709,notebook,30,60,30,1,00383,India
991743,2023-07-25,716,printing paper,200,400,200,1,00061,India
991743,2023-07-25,707,marker,20,40,20,1,00061,India
991743,2023-07-25,713,ball pen,5,10,5,1,00061,India
169953,2023-07-25,702,pencil,2,5,3,1,00406,India
169953,2023-07-25,709,notebook,30,60,30,1,00406,India
111628,2023-07-25,707,marker,20,40,20,1,00024,India
111628,2023-07-25,705,stencil,10,20,10,1,00024,India
111628,2023-07-25,713,ball pen,5,10,5,1,00024,India
111628,2023-07-25,715,folder,5,15,10,1,00024,India
574964,2023-07-25,701,gel pen,5,10,5,1,00037,India
574964,2023-07-25,717,spiral bound book,50,100,50,1,00037,India
574964,2023-07-25,714,carbon paper,15,30,15,1,00037,India
278419,2023-07-25,708,sketchpen,15,40,25,1,00378,India
278419,2023-07-25,713,ball pen,5,10,5,1,00378,India
278419,2023-07-25,705,stencil,10,20,10,1,00378,India
278419,2023-07-25,714,carbon paper,15,30,15,1,00378,India
278419,2023-07-25,715,folder,5,15,10,1,00378,India
264384,2023-07-25,707,marker,20,40,20,1,00066,India
264384,2023-07-25,701,gel pen,5,10,5,1,00066,India
683614,2023-07-25,717,spiral bound book,50,100,50,1,00075,India
683614,2023-07-25,708,sketchpen,15,40,25,1,00075,India
598112,2023-07-25,716,printing paper,200,400,200,1,00477,India
598112,2023-07-25,705,stencil,10,20,10,1,00477,India
571077,2023-07-25,710,geometry box,100,150,50,1,00443,India
571077,2023-07-25,708,sketchpen,15,40,25,1,00443,India
571077,2023-07-25,712,graph paper,20,40,20,1,00443,India
755434,2023-07-25,710,geometry box,100,150,50,1,00166,India
755434,2023-07-25,701,gel pen,5,10,5,1,00166,India
312035,2023-07-25,708,sketchpen,15,40,25,1,00468,India
312035,2023-07-25,710,geometry box,100,150,50,1,00468,India
312035,2023-07-25,706,sharpener,3,8,5,1,00468,India
312035,2023-07-25,716,printing paper,200,400,200,1,00468,India
435199,2023-07-25,717,spiral bound book,50,100,50,1,00001,India
896595,2023-07-25,709,notebook,30,60,30,1,00413,India
896595,2023-07-25,714,carbon paper,15,30,15,1,00413,India
896595,2023-07-25,706,sharpener,3,8,5,1,00413,India
761303,2023-07-25,716,printing paper,200,400,200,1,00143,India
761303,2023-07-25,712,graph paper,20,40,20,1,00143,India
223831,2023-07-25,717,spiral bound book,50,100,50,1,00496,India
223831,2023-07-25,713,ball pen,5,10,5,1,00496,India
770299,2023-07-25,716,printing paper,200,400,200,1,00242,India
770299,2023-07-25,713,ball pen,5,10,5,1,00242,India
770299,2023-07-25,702,pencil,2,5,3,1,00242,India
770299,2023-07-25,704,scale,5,10,5,1,00242,India
495253,2023-07-25,702,pencil,2,5,3,1,00200,India
495253,2023-07-25,701,gel pen,5,10,5,1,00200,India
495253,2023-07-25,711,TD kit,150,300,150,1,00200,India
495253,2023-07-25,716,printing paper,200,400,200,1,00200,India
693315,2023-07-25,708,sketchpen,15,40,25,1,00198,India
693315,2023-07-25,710,geometry box,100,150,50,1,00198,India
693315,2023-07-25,714,carbon paper,15,30,15,1,00198,India
693315,2023-07-25,713,ball pen,5,10,5,1,00198,India
693315,2023-07-25,716,printing paper,200,400,200,1,00198,India
506405,2023-07-25,711,TD kit,150,300,150,1,00093,India
594756,2023-07-25,708,sketchpen,15,40,25,1,00285,India
594756,2023-07-25,711,TD kit,150,300,150,1,00285,India
594756,2023-07-25,710,geometry box,100,150,50,1,00285,India
594756,2023-07-25,715,folder,5,15,10,1,00285,India
594756,2023-07-25,702,pencil,2,5,3,1,00285,India
819109,2023-07-25,710,geometry box,100,150,50,1,00377,India
819109,2023-07-25,716,printing paper,200,400,200,1,00377,India
819109,2023-07-25,713,ball pen,5,10,5,1,00377,India
819109,2023-07-25,714,carbon paper,15,30,15,1,00377,India
239040,2023-07-25,704,scale,5,10,5,1,00035,India
239040,2023-07-25,714,carbon paper,15,30,15,1,00035,India
239040,2023-07-25,705,stencil,10,20,10,1,00035,India
454268,2023-07-25,713,ball pen,5,10,5,1,00171,India
454268,2023-07-25,717,spiral bound book,50,100,50,1,00171,India
454268,2023-07-25,711,TD kit,150,300,150,1,00171,India
454268,2023-07-25,704,scale,5,10,5,1,00171,India
440640,2023-07-25,713,ball pen,5,10,5,1,00365,India
197285,2023-07-25,716,printing paper,200,400,200,1,00059,India
197285,2023-07-25,712,graph paper,20,40,20,1,00059,India
875931,2023-07-25,714,carbon paper,15,30,15,1,00230,India
875931,2023-07-25,712,graph paper,20,40,20,1,00230,India
875931,2023-07-25,705,stencil,10,20,10,1,00230,India
176015,2023-07-25,717,spiral bound book,50,100,50,1,00160,India
312665,2023-07-25,711,TD kit,150,300,150,1,00169,India
312665,2023-07-25,717,spiral bound book,50,100,50,1,00169,India
312665,2023-07-25,715,folder,5,15,10,1,00169,India
312665,2023-07-25,712,graph paper,20,40,20,1,00169,India
622115,2023-07-25,709,notebook,30,60,30,1,00125,India
622115,2023-07-25,704,scale,5,10,5,1,00125,India
622115,2023-07-25,714,carbon paper,15,30,15,1,00125,India
284427,2023-07-25,702,pencil,2,5,3,1,00243,India
284427,2023-07-25,717,spiral bound book,50,100,50,1,00243,India
821191,2023-07-25,715,folder,5,15,10,1,00340,India
821191,2023-07-25,702,pencil,2,5,3,1,00340,India
401648,2023-07-25,713,ball pen,5,10,5,1,00500,India
401648,2023-07-25,707,marker,20,40,20,1,00500,India
999682,2023-07-25,713,ball pen,5,10,5,1,00484,India
999682,2023-07-25,707,marker,20,40,20,1,00484,India
999682,2023-07-25,703,eraser,1,3,2,1,00484,India
671195,2023-07-25,701,gel pen,5,10,5,1,00082,India
671195,2023-07-25,711,TD kit,150,300,150,1,00082,India
366762,2023-07-25,714,carbon paper,15,30,15,1,00385,India
366762,2023-07-25,716,printing paper,200,400,200,1,00385,India
366762,2023-07-25,705,stencil,10,20,10,1,00385,India
366762,2023-07-25,715,folder,5,15,10,1,00385,India
366762,2023-07-25,713,ball pen,5,10,5,1,00385,India
179122,2023-07-25,712,graph paper,20,40,20,1,00447,India
709359,2023-07-25,709,notebook,30,60,30,1,00203,India
709359,2023-07-25,714,carbon paper,15,30,15,1,00203,India
709359,2023-07-25,706,sharpener,3,8,5,1,00203,India
709359,2023-07-25,710,geometry box,100,150,50,1,00203,India
696002,2023-07-25,711,TD kit,150,300,150,1,00375,India
696002,2023-07-25,714,carbon paper,15,30,15,1,00375,India
696002,2023-07-25,712,graph paper,20,40,20,1,00375,India
459257,2023-07-25,706,sharpener,3,8,5,1,00231,India
459257,2023-07-25,713,ball pen,5,10,5,1,00231,India
459257,2023-07-25,705,stencil,10,20,10,1,00231,India
459257,2023-07-25,702,pencil,2,5,3,1,00231,India
619880,2023-07-25,716,printing paper,200,400,200,1,00353,India
619880,2023-07-25,703,eraser,1,3,2,1,00353,India
619880,2023-07-25,707,marker,20,40,20,1,00353,India
286570,2023-07-25,714,carbon paper,15,30,15,1,00480,India
286570,2023-07-25,703,eraser,1,3,2,1,00480,India
286570,2023-07-25,702,pencil,2,5,3,1,00480,India
954294,2023-07-25,701,gel pen,5,10,5,1,00047,India
954294,2023-07-25,702,pencil,2,5,3,1,00047,India
327056,2023-07-25,712,graph paper,20,40,20,1,00331,India
327056,2023-07-25,703,eraser,1,3,2,1,00331,India
327056,2023-07-25,715,folder,5,15,10,1,00331,India
327056,2023-07-25,716,printing paper,200,400,200,1,00331,India
114273,2023-07-25,709,notebook,30,60,30,1,00171,India
114273,2023-07-25,702,pencil,2,5,3,1,00171,India
114273,2023-07-25,712,graph paper,20,40,20,1,00171,India
323489,2023-07-25,717,spiral bound book,50,100,50,1,00003,India
702751,2023-07-25,713,ball pen,5,10,5,1,00189,India
702751,2023-07-25,714,carbon paper,15,30,15,1,00189,India
702751,2023-07-25,705,stencil,10,20,10,1,00189,India
702751,2023-07-25,704,scale,5,10,5,1,00189,India
659926,2023-07-26,708,sketchpen,15,40,25,1,00349,India
659926,2023-07-26,701,gel pen,5,10,5,1,00349,India
705255,2023-07-26,702,pencil,2,5,3,1,00391,India
705255,2023-07-26,707,marker,20,40,20,1,00391,India
705255,2023-07-26,708,sketchpen,15,40,25,1,00391,India
705255,2023-07-26,706,sharpener,3,8,5,1,00391,India
556211,2023-07-26,704,scale,5,10,5,1,00475,India
556211,2023-07-26,713,ball pen,5,10,5,1,00475,India
556211,2023-07-26,708,sketchpen,15,40,25,1,00475,India
142149,2023-07-26,714,carbon paper,15,30,15,1,00281,India
142149,2023-07-26,716,printing paper,200,400,200,1,00281,India
142149,2023-07-26,702,pencil,2,5,3,1,00281,India
125221,2023-07-26,706,sharpener,3,8,5,1,00149,India
125221,2023-07-26,708,sketchpen,15,40,25,1,00149,India
274175,2023-07-26,714,carbon paper,15,30,15,1,00393,India
491006,2023-07-26,717,spiral bound book,50,100,50,1,00408,India
491006,2023-07-26,711,TD kit,150,300,150,1,00408,India
828699,2023-07-26,715,folder,5,15,10,1,00255,India
828699,2023-07-26,702,pencil,2,5,3,1,00255,India
828699,2023-07-26,713,ball pen,5,10,5,1,00255,India
950929,2023-07-26,715,folder,5,15,10,1,00240,India
950929,2023-07-26,707,marker,20,40,20,1,00240,India
950929,2023-07-26,706,sharpener,3,8,5,1,00240,India
270252,2023-07-26,714,carbon paper,15,30,15,1,00070,India
802194,2023-07-26,717,spiral bound book,50,100,50,1,00465,India
802194,2023-07-26,711,TD kit,150,300,150,1,00465,India
802194,2023-07-26,715,folder,5,15,10,1,00465,India
802194,2023-07-26,702,pencil,2,5,3,1,00465,India
958789,2023-07-26,706,sharpener,3,8,5,1,00298,India
958789,2023-07-26,714,carbon paper,15,30,15,1,00298,India
958789,2023-07-26,712,graph paper,20,40,20,1,00298,India
958789,2023-07-26,710,geometry box,100,150,50,1,00298,India
280406,2023-07-26,706,sharpener,3,8,5,1,00423,India
280406,2023-07-26,704,scale,5,10,5,1,00423,India
280406,2023-07-26,708,sketchpen,15,40,25,1,00423,India
280406,2023-07-26,711,TD kit,150,300,150,1,00423,India
262042,2023-07-26,717,spiral bound book,50,100,50,1,00389,India
256588,2023-07-26,702,pencil,2,5,3,1,00405,India
256588,2023-07-26,715,folder,5,15,10,1,00405,India
521491,2023-07-26,706,sharpener,3,8,5,1,00211,India
386866,2023-07-26,707,marker,20,40,20,1,00408,India
386866,2023-07-26,706,sharpener,3,8,5,1,00408,India
386866,2023-07-26,704,scale,5,10,5,1,00408,India
386866,2023-07-26,715,folder,5,15,10,1,00408,India
938528,2023-07-26,701,gel pen,5,10,5,1,00339,India
938528,2023-07-26,706,sharpener,3,8,5,1,00339,India
938528,2023-07-26,714,carbon paper,15,30,15,1,00339,India
785813,2023-07-26,713,ball pen,5,10,5,1,00327,India
416876,2023-07-26,713,ball pen,5,10,5,1,00011,India
416876,2023-07-26,707,marker,20,40,20,1,00011,India
416876,2023-07-26,704,scale,5,10,5,1,00011,India
871463,2023-07-26,714,carbon paper,15,30,15,1,00058,India
601792,2023-07-26,708,sketchpen,15,40,25,1,00166,India
601792,2023-07-26,704,scale,5,10,5,1,00166,India
601792,2023-07-26,706,sharpener,3,8,5,1,00166,India
560418,2023-07-26,708,sketchpen,15,40,25,1,00454,India
420709,2023-07-26,712,graph paper,20,40,20,1,00130,India
420709,2023-07-26,702,pencil,2,5,3,1,00130,India
420709,2023-07-26,715,folder,5,15,10,1,00130,India
957664,2023-07-26,701,gel pen,5,10,5,1,00401,India
261248,2023-07-26,710,geometry box,100,150,50,1,00445,India
261248,2023-07-26,717,spiral bound book,50,100,50,1,00445,India
261248,2023-07-26,706,sharpener,3,8,5,1,00445,India
261248,2023-07-26,702,pencil,2,5,3,1,00445,India
222822,2023-07-26,706,sharpener,3,8,5,1,00316,India
222822,2023-07-26,703,eraser,1,3,2,1,00316,India
222822,2023-07-26,704,scale,5,10,5,1,00316,India
222822,2023-07-26,710,geometry box,100,150,50,1,00316,India
280789,2023-07-26,702,pencil,2,5,3,1,00434,India
168953,2023-07-26,701,gel pen,5,10,5,1,00327,India
605570,2023-07-26,704,scale,5,10,5,1,00423,India
605570,2023-07-26,705,stencil,10,20,10,1,00423,India
605570,2023-07-26,701,gel pen,5,10,5,1,00423,India
262858,2023-07-26,702,pencil,2,5,3,1,00035,India
620155,2023-07-26,709,notebook,30,60,30,1,00012,India
620155,2023-07-26,705,stencil,10,20,10,1,00012,India
620155,2023-07-26,714,carbon paper,15,30,15,1,00012,India
620155,2023-07-26,704,scale,5,10,5,1,00012,India
898354,2023-07-26,702,pencil,2,5,3,1,00432,India
898354,2023-07-26,709,notebook,30,60,30,1,00432,India
898354,2023-07-26,708,sketchpen,15,40,25,1,00432,India
287536,2023-07-26,709,notebook,30,60,30,1,00286,India
287536,2023-07-26,716,printing paper,200,400,200,1,00286,India
287536,2023-07-26,717,spiral bound book,50,100,50,1,00286,India
191521,2023-07-26,709,notebook,30,60,30,1,00425,India
191521,2023-07-26,714,carbon paper,15,30,15,1,00425,India
191521,2023-07-26,701,gel pen,5,10,5,1,00425,India
191521,2023-07-26,713,ball pen,5,10,5,1,00425,India
977993,2023-07-26,703,eraser,1,3,2,1,00187,India
977993,2023-07-26,714,carbon paper,15,30,15,1,00187,India
977993,2023-07-26,705,stencil,10,20,10,1,00187,India
849869,2023-07-26,704,scale,5,10,5,1,00003,India
422811,2023-07-26,704,scale,5,10,5,1,00344,India
422811,2023-07-26,703,eraser,1,3,2,1,00344,India
191524,2023-07-26,713,ball pen,5,10,5,1,00307,India
773415,2023-07-26,714,carbon paper,15,30,15,1,00093,India
773415,2023-07-26,708,sketchpen,15,40,25,1,00093,India
717902,2023-07-27,713,ball pen,5,10,5,1,00043,India
717902,2023-07-27,702,pencil,2,5,3,1,00043,India
717902,2023-07-27,711,TD kit,150,300,150,1,00043,India
717902,2023-07-27,712,graph paper,20,40,20,1,00043,India
599740,2023-07-27,713,ball pen,5,10,5,1,00316,India
599740,2023-07-27,707,marker,20,40,20,1,00316,India
599740,2023-07-27,712,graph paper,20,40,20,1,00316,India
537493,2023-07-27,716,printing paper,200,400,200,1,00377,India
537493,2023-07-27,707,marker,20,40,20,1,00377,India
787981,2023-07-27,717,spiral bound book,50,100,50,1,00396,India
766942,2023-07-27,706,sharpener,3,8,5,1,00087,India
104076,2023-07-27,712,graph paper,20,40,20,1,00305,India
104076,2023-07-27,703,eraser,1,3,2,1,00305,India
104076,2023-07-27,716,printing paper,200,400,200,1,00305,India
943758,2023-07-27,709,notebook,30,60,30,1,00286,India
943758,2023-07-27,707,marker,20,40,20,1,00286,India
943758,2023-07-27,716,printing paper,200,400,200,1,00286,India
943758,2023-07-27,713,ball pen,5,10,5,1,00286,India
372389,2023-07-27,702,pencil,2,5,3,1,00379,India
372389,2023-07-27,713,ball pen,5,10,5,1,00379,India
372389,2023-07-27,706,sharpener,3,8,5,1,00379,India
372389,2023-07-27,703,eraser,1,3,2,1,00379,India
567856,2023-07-27,701,gel pen,5,10,5,1,00459,India
567856,2023-07-27,703,eraser,1,3,2,1,00459,India
567856,2023-07-27,702,pencil,2,5,3,1,00459,India
480857,2023-07-27,713,ball pen,5,10,5,1,00207,India
951182,2023-07-27,705,stencil,10,20,10,1,00117,India
951182,2023-07-27,713,ball pen,5,10,5,1,00117,India
951182,2023-07-27,710,geometry box,100,150,50,1,00117,India
951182,2023-07-27,714,carbon paper,15,30,15,1,00117,India
942429,2023-07-27,701,gel pen,5,10,5,1,00197,India
942429,2023-07-27,715,folder,5,15,10,1,00197,India
918738,2023-07-27,716,printing paper,200,400,200,1,00030,India
918738,2023-07-27,705,stencil,10,20,10,1,00030,India
918738,2023-07-27,714,carbon paper,15,30,15,1,00030,India
918738,2023-07-27,715,folder,5,15,10,1,00030,India
457795,2023-07-27,710,geometry box,100,150,50,1,00104,India
457795,2023-07-27,713,ball pen,5,10,5,1,00104,India
457795,2023-07-27,709,notebook,30,60,30,1,00104,India
869976,2023-07-27,706,sharpener,3,8,5,1,00386,India
869976,2023-07-27,702,pencil,2,5,3,1,00386,India
869976,2023-07-27,717,spiral bound book,50,100,50,1,00386,India
869976,2023-07-27,704,scale,5,10,5,1,00386,India
178692,2023-07-27,708,sketchpen,15,40,25,1,00269,India
850067,2023-07-27,706,sharpener,3,8,5,1,00411,India
850067,2023-07-27,712,graph paper,20,40,20,1,00411,India
850067,2023-07-27,703,eraser,1,3,2,1,00411,India
850067,2023-07-27,716,printing paper,200,400,200,1,00411,India
176923,2023-07-27,716,printing paper,200,400,200,1,00329,India
176923,2023-07-27,717,spiral bound book,50,100,50,1,00329,India
176923,2023-07-27,712,graph paper,20,40,20,1,00329,India
176923,2023-07-27,708,sketchpen,15,40,25,1,00329,India
420230,2023-07-27,702,pencil,2,5,3,1,00437,India
420230,2023-07-27,712,graph paper,20,40,20,1,00437,India
420230,2023-07-27,704,scale,5,10,5,1,00437,India
317472,2023-07-27,715,folder,5,15,10,1,00401,India
317472,2023-07-27,717,spiral bound book,50,100,50,1,00401,India
317472,2023-07-27,714,carbon paper,15,30,15,1,00401,India
981393,2023-07-27,713,ball pen,5,10,5,1,00382,India
981393,2023-07-27,711,TD kit,150,300,150,1,00382,India
981393,2023-07-27,710,geometry box,100,150,50,1,00382,India
981393,2023-07-27,706,sharpener,3,8,5,1,00382,India
981393,2023-07-27,701,gel pen,5,10,5,1,00382,India
886921,2023-07-27,701,gel pen,5,10,5,1,00078,India
886921,2023-07-27,716,printing paper,200,400,200,1,00078,India
589728,2023-07-27,708,sketchpen,15,40,25,1,00074,India
589728,2023-07-27,702,pencil,2,5,3,1,00074,India
794410,2023-07-27,706,sharpener,3,8,5,1,00210,India
794410,2023-07-27,710,geometry box,100,150,50,1,00210,India
794410,2023-07-27,715,folder,5,15,10,1,00210,India
794410,2023-07-27,702,pencil,2,5,3,1,00210,India
873851,2023-07-27,712,graph paper,20,40,20,1,00323,India
873851,2023-07-27,708,sketchpen,15,40,25,1,00323,India
476636,2023-07-27,704,scale,5,10,5,1,00400,India
476636,2023-07-27,711,TD kit,150,300,150,1,00400,India
476636,2023-07-27,703,eraser,1,3,2,1,00400,India
476636,2023-07-27,708,sketchpen,15,40,25,1,00400,India
476636,2023-07-27,713,ball pen,5,10,5,1,00400,India
957011,2023-07-27,709,notebook,30,60,30,1,00230,India
957011,2023-07-27,703,eraser,1,3,2,1,00230,India
582411,2023-07-27,711,TD kit,150,300,150,1,00335,India
582411,2023-07-27,712,graph paper,20,40,20,1,00335,India
582411,2023-07-27,706,sharpener,3,8,5,1,00335,India
582411,2023-07-27,707,marker,20,40,20,1,00335,India
164914,2023-07-27,713,ball pen,5,10,5,1,00369,India
164914,2023-07-27,714,carbon paper,15,30,15,1,00369,India
164914,2023-07-27,701,gel pen,5,10,5,1,00369,India
164914,2023-07-27,702,pencil,2,5,3,1,00369,India
211233,2023-07-27,713,ball pen,5,10,5,1,00448,India
211233,2023-07-27,704,scale,5,10,5,1,00448,India
211233,2023-07-27,711,TD kit,150,300,150,1,00448,India
211233,2023-07-27,702,pencil,2,5,3,1,00448,India
211233,2023-07-27,715,folder,5,15,10,1,00448,India
736672,2023-07-27,702,pencil,2,5,3,1,00162,India
158223,2023-07-27,717,spiral bound book,50,100,50,1,00227,India
158223,2023-07-27,710,geometry box,100,150,50,1,00227,India
771684,2023-07-27,709,notebook,30,60,30,1,00072,India
771684,2023-07-27,713,ball pen,5,10,5,1,00072,India
771684,2023-07-27,706,sharpener,3,8,5,1,00072,India
771684,2023-07-27,710,geometry box,100,150,50,1,00072,India
347164,2023-07-27,701,gel pen,5,10,5,1,00109,India
347164,2023-07-27,715,folder,5,15,10,1,00109,India
347164,2023-07-27,710,geometry box,100,150,50,1,00109,India
347164,2023-07-27,709,notebook,30,60,30,1,00109,India
786541,2023-07-28,717,spiral bound book,50,100,50,1,00299,India
786541,2023-07-28,704,scale,5,10,5,1,00299,India
786541,2023-07-28,710,geometry box,100,150,50,1,00299,India
786541,2023-07-28,714,carbon paper,15,30,15,1,00299,India
786541,2023-07-28,712,graph paper,20,40,20,1,00299,India
516289,2023-07-28,715,folder,5,15,10,1,00431,India
516289,2023-07-28,711,TD kit,150,300,150,1,00431,India
516289,2023-07-28,709,notebook,30,60,30,1,00431,India
679639,2023-07-28,714,carbon paper,15,30,15,1,00312,India
679639,2023-07-28,707,marker,20,40,20,1,00312,India
116182,2023-07-28,705,stencil,10,20,10,1,00428,India
116182,2023-07-28,711,TD kit,150,300,150,1,00428,India
116182,2023-07-28,701,gel pen,5,10,5,1,00428,India
116182,2023-07-28,706,sharpener,3,8,5,1,00428,India
191537,2023-07-28,705,stencil,10,20,10,1,00117,India
994359,2023-07-28,714,carbon paper,15,30,15,1,00221,India
994359,2023-07-28,710,geometry box,100,150,50,1,00221,India
994359,2023-07-28,708,sketchpen,15,40,25,1,00221,India
654930,2023-07-28,712,graph paper,20,40,20,1,00096,India
654930,2023-07-28,717,spiral bound book,50,100,50,1,00096,India
654930,2023-07-28,714,carbon paper,15,30,15,1,00096,India
510039,2023-07-28,703,eraser,1,3,2,1,00124,India
924444,2023-07-28,706,sharpener,3,8,5,1,00193,India
924444,2023-07-28,716,printing paper,200,400,200,1,00193,India
924444,2023-07-28,715,folder,5,15,10,1,00193,India
924444,2023-07-28,714,carbon paper,15,30,15,1,00193,India
741193,2023-07-28,704,scale,5,10,5,1,00169,India
741193,2023-07-28,712,graph paper,20,40,20,1,00169,India
741193,2023-07-28,717,spiral bound book,50,100,50,1,00169,India
741193,2023-07-28,708,sketchpen,15,40,25,1,00169,India
741193,2023-07-28,710,geometry box,100,150,50,1,00169,India
826406,2023-07-28,702,pencil,2,5,3,1,00008,India
826406,2023-07-28,707,marker,20,40,20,1,00008,India
826406,2023-07-28,714,carbon paper,15,30,15,1,00008,India
711683,2023-07-28,706,sharpener,3,8,5,1,00112,India
711683,2023-07-28,701,gel pen,5,10,5,1,00112,India
711683,2023-07-28,705,stencil,10,20,10,1,00112,India
711683,2023-07-28,717,spiral bound book,50,100,50,1,00112,India
756377,2023-07-28,709,notebook,30,60,30,1,00146,India
331367,2023-07-28,705,stencil,10,20,10,1,00333,India
331367,2023-07-28,706,sharpener,3,8,5,1,00333,India
331367,2023-07-28,710,geometry box,100,150,50,1,00333,India
247417,2023-07-28,716,printing paper,200,400,200,1,00348,India
247417,2023-07-28,713,ball pen,5,10,5,1,00348,India
247417,2023-07-28,709,notebook,30,60,30,1,00348,India
247417,2023-07-28,714,carbon paper,15,30,15,1,00348,India
907546,2023-07-28,713,ball pen,5,10,5,1,00038,India
417564,2023-07-28,701,gel pen,5,10,5,1,00247,India
417564,2023-07-28,703,eraser,1,3,2,1,00247,India
417564,2023-07-28,710,geometry box,100,150,50,1,00247,India
418619,2023-07-28,709,notebook,30,60,30,1,00166,India
418619,2023-07-28,703,eraser,1,3,2,1,00166,India
418619,2023-07-28,715,folder,5,15,10,1,00166,India
810605,2023-07-28,714,carbon paper,15,30,15,1,00091,India
810605,2023-07-28,711,TD kit,150,300,150,1,00091,India
810605,2023-07-28,706,sharpener,3,8,5,1,00091,India
810605,2023-07-28,704,scale,5,10,5,1,00091,India
758595,2023-07-28,710,geometry box,100,150,50,1,00436,India
758595,2023-07-28,702,pencil,2,5,3,1,00436,India
758595,2023-07-28,706,sharpener,3,8,5,1,00436,India
337159,2023-07-28,705,stencil,10,20,10,1,00344,India
433237,2023-07-28,711,TD kit,150,300,150,1,00049,India
433237,2023-07-28,703,eraser,1,3,2,1,00049,India
433237,2023-07-28,701,gel pen,5,10,5,1,00049,India
433237,2023-07-28,708,sketchpen,15,40,25,1,00049,India
164400,2023-07-28,710,geometry box,100,150,50,1,00248,India
164400,2023-07-28,711,TD kit,150,300,150,1,00248,India
164400,2023-07-28,717,spiral bound book,50,100,50,1,00248,India
164400,2023-07-28,715,folder,5,15,10,1,00248,India
495593,2023-07-28,711,TD kit,150,300,150,1,00250,India
402099,2023-07-28,706,sharpener,3,8,5,1,00464,India
402099,2023-07-28,711,TD kit,150,300,150,1,00464,India
583348,2023-07-28,711,TD kit,150,300,150,1,00370,India
583348,2023-07-28,706,sharpener,3,8,5,1,00370,India
583348,2023-07-28,716,printing paper,200,400,200,1,00370,India
583348,2023-07-28,702,pencil,2,5,3,1,00370,India
106914,2023-07-28,701,gel pen,5,10,5,1,00303,India
106914,2023-07-28,702,pencil,2,5,3,1,00303,India
296667,2023-07-28,713,ball pen,5,10,5,1,00498,India
296667,2023-07-28,702,pencil,2,5,3,1,00498,India
296667,2023-07-28,715,folder,5,15,10,1,00498,India
776337,2023-07-28,707,marker,20,40,20,1,00011,India
829192,2023-07-28,705,stencil,10,20,10,1,00474,India
829192,2023-07-28,706,sharpener,3,8,5,1,00474,India
619632,2023-07-28,707,marker,20,40,20,1,00311,India
619632,2023-07-28,709,notebook,30,60,30,1,00311,India
619632,2023-07-28,711,TD kit,150,300,150,1,00311,India
619632,2023-07-28,701,gel pen,5,10,5,1,00311,India
619632,2023-07-28,716,printing paper,200,400,200,1,00311,India
953716,2023-07-28,711,TD kit,150,300,150,1,00295,India
953716,2023-07-28,716,printing paper,200,400,200,1,00295,India
953716,2023-07-28,712,graph paper,20,40,20,1,00295,India
953716,2023-07-28,710,geometry box,100,150,50,1,00295,India
736438,2023-07-28,713,ball pen,5,10,5,1,00254,India
736438,2023-07-28,703,eraser,1,3,2,1,00254,India
736438,2023-07-28,712,graph paper,20,40,20,1,00254,India
399644,2023-07-28,702,pencil,2,5,3,1,00255,India
399644,2023-07-28,716,printing paper,200,400,200,1,00255,India
399644,2023-07-28,707,marker,20,40,20,1,00255,India
399644,2023-07-28,711,TD kit,150,300,150,1,00255,India
399644,2023-07-28,704,scale,5,10,5,1,00255,India
717253,2023-07-28,712,graph paper,20,40,20,1,00019,India
173441,2023-07-28,701,gel pen,5,10,5,1,00462,India
173441,2023-07-28,704,scale,5,10,5,1,00462,India
173441,2023-07-28,702,pencil,2,5,3,1,00462,India
826279,2023-07-28,717,spiral bound book,50,100,50,1,00180,India
826279,2023-07-28,714,carbon paper,15,30,15,1,00180,India
737190,2023-07-28,707,marker,20,40,20,1,00135,India
737190,2023-07-28,705,stencil,10,20,10,1,00135,India
715295,2023-07-28,702,pencil,2,5,3,1,00055,India
715295,2023-07-28,715,folder,5,15,10,1,00055,India
715295,2023-07-28,711,TD kit,150,300,150,1,00055,India
860734,2023-07-28,712,graph paper,20,40,20,1,00349,India
860734,2023-07-28,715,folder,5,15,10,1,00349,India
860734,2023-07-28,708,sketchpen,15,40,25,1,00349,India
261602,2023-07-28,708,sketchpen,15,40,25,1,00196,India
261602,2023-07-28,714,carbon paper,15,30,15,1,00196,India
258799,2023-07-28,715,folder,5,15,10,1,00032,India
258799,2023-07-28,704,scale,5,10,5,1,00032,India
258799,2023-07-28,708,sketchpen,15,40,25,1,00032,India
351651,2023-07-28,706,sharpener,3,8,5,1,00277,India
351651,2023-07-28,716,printing paper,200,400,200,1,00277,India
351651,2023-07-28,705,stencil,10,20,10,1,00277,India
351651,2023-07-28,702,pencil,2,5,3,1,00277,India
351651,2023-07-28,710,geometry box,100,150,50,1,00277,India
438697,2023-07-28,709,notebook,30,60,30,1,00259,India
438697,2023-07-28,710,geometry box,100,150,50,1,00259,India
438697,2023-07-28,714,carbon paper,15,30,15,1,00259,India
438697,2023-07-28,716,printing paper,200,400,200,1,00259,India
363260,2023-07-29,703,eraser,1,3,2,1,00432,India
363260,2023-07-29,712,graph paper,20,40,20,1,00432,India
363260,2023-07-29,707,marker,20,40,20,1,00432,India
288536,2023-07-29,703,eraser,1,3,2,1,00109,India
288536,2023-07-29,712,graph paper,20,40,20,1,00109,India
288536,2023-07-29,705,stencil,10,20,10,1,00109,India
288536,2023-07-29,717,spiral bound book,50,100,50,1,00109,India
288536,2023-07-29,715,folder,5,15,10,1,00109,India
214954,2023-07-29,715,folder,5,15,10,1,00142,India
214954,2023-07-29,714,carbon paper,15,30,15,1,00142,India
214954,2023-07-29,712,graph paper,20,40,20,1,00142,India
214954,2023-07-29,711,TD kit,150,300,150,1,00142,India
214954,2023-07-29,710,geometry box,100,150,50,1,00142,India
322233,2023-07-29,716,printing paper,200,400,200,1,00176,India
322233,2023-07-29,712,graph paper,20,40,20,1,00176,India
636059,2023-07-29,712,graph paper,20,40,20,1,00368,India
518843,2023-07-29,708,sketchpen,15,40,25,1,00193,India
518843,2023-07-29,713,ball pen,5,10,5,1,00193,India
518843,2023-07-29,705,stencil,10,20,10,1,00193,India
645762,2023-07-29,706,sharpener,3,8,5,1,00268,India
146840,2023-07-29,715,folder,5,15,10,1,00264,India
146840,2023-07-29,702,pencil,2,5,3,1,00264,India
146840,2023-07-29,704,scale,5,10,5,1,00264,India
958346,2023-07-29,712,graph paper,20,40,20,1,00156,India
958346,2023-07-29,703,eraser,1,3,2,1,00156,India
958346,2023-07-29,717,spiral bound book,50,100,50,1,00156,India
525584,2023-07-29,715,folder,5,15,10,1,00491,India
525584,2023-07-29,701,gel pen,5,10,5,1,00491,India
525584,2023-07-29,709,notebook,30,60,30,1,00491,India
525584,2023-07-29,717,spiral bound book,50,100,50,1,00491,India
351501,2023-07-29,701,gel pen,5,10,5,1,00305,India
351501,2023-07-29,709,notebook,30,60,30,1,00305,India
351501,2023-07-29,714,carbon paper,15,30,15,1,00305,India
796894,2023-07-29,705,stencil,10,20,10,1,00371,India
796894,2023-07-29,714,carbon paper,15,30,15,1,00371,India
796894,2023-07-29,713,ball pen,5,10,5,1,00371,India
752184,2023-07-29,708,sketchpen,15,40,25,1,00363,India
752184,2023-07-29,712,graph paper,20,40,20,1,00363,India
752184,2023-07-29,701,gel pen,5,10,5,1,00363,India
752184,2023-07-29,707,marker,20,40,20,1,00363,India
108364,2023-07-29,713,ball pen,5,10,5,1,00196,India
435584,2023-07-29,708,sketchpen,15,40,25,1,00264,India
270462,2023-07-29,709,notebook,30,60,30,1,00078,India
270462,2023-07-29,707,marker,20,40,20,1,00078,India
270462,2023-07-29,701,gel pen,5,10,5,1,00078,India
270462,2023-07-29,706,sharpener,3,8,5,1,00078,India
257621,2023-07-29,707,marker,20,40,20,1,00347,India
257621,2023-07-29,711,TD kit,150,300,150,1,00347,India
257621,2023-07-29,713,ball pen,5,10,5,1,00347,India
514034,2023-07-29,712,graph paper,20,40,20,1,00272,India
131532,2023-07-29,707,marker,20,40,20,1,00125,India
131532,2023-07-29,714,carbon paper,15,30,15,1,00125,India
131532,2023-07-29,716,printing paper,200,400,200,1,00125,India
131532,2023-07-29,704,scale,5,10,5,1,00125,India
131532,2023-07-29,702,pencil,2,5,3,1,00125,India
633290,2023-07-29,715,folder,5,15,10,1,00430,India
913861,2023-07-29,701,gel pen,5,10,5,1,00398,India
913861,2023-07-29,715,folder,5,15,10,1,00398,India
984289,2023-07-29,716,printing paper,200,400,200,1,00465,India
427321,2023-07-29,711,TD kit,150,300,150,1,00207,India
427321,2023-07-29,716,printing paper,200,400,200,1,00207,India
726427,2023-07-29,702,pencil,2,5,3,1,00379,India
164723,2023-07-29,716,printing paper,200,400,200,1,00307,India
164723,2023-07-29,713,ball pen,5,10,5,1,00307,India
643694,2023-07-29,709,notebook,30,60,30,1,00063,India
643694,2023-07-29,711,TD kit,150,300,150,1,00063,India
197260,2023-07-29,713,ball pen,5,10,5,1,00161,India
197260,2023-07-29,707,marker,20,40,20,1,00161,India
197260,2023-07-29,710,geometry box,100,150,50,1,00161,India
197260,2023-07-29,717,spiral bound book,50,100,50,1,00161,India
743065,2023-07-29,712,graph paper,20,40,20,1,00305,India
743065,2023-07-29,702,pencil,2,5,3,1,00305,India
743065,2023-07-29,709,notebook,30,60,30,1,00305,India
125586,2023-07-29,709,notebook,30,60,30,1,00425,India
125586,2023-07-29,715,folder,5,15,10,1,00425,India
999770,2023-07-29,701,gel pen,5,10,5,1,00044,India
778455,2023-07-29,712,graph paper,20,40,20,1,00193,India
482528,2023-07-29,714,carbon paper,15,30,15,1,00250,India
482528,2023-07-29,707,marker,20,40,20,1,00250,India
919686,2023-07-29,701,gel pen,5,10,5,1,00347,India
919686,2023-07-29,713,ball pen,5,10,5,1,00347,India
915115,2023-07-30,703,eraser,1,3,2,1,00369,India
915115,2023-07-30,711,TD kit,150,300,150,1,00369,India
793467,2023-07-30,715,folder,5,15,10,1,00419,India
265656,2023-07-30,707,marker,20,40,20,1,00025,India
434722,2023-07-30,703,eraser,1,3,2,1,00151,India
434722,2023-07-30,710,geometry box,100,150,50,1,00151,India
434722,2023-07-30,716,printing paper,200,400,200,1,00151,India
588457,2023-07-30,712,graph paper,20,40,20,1,00460,India
588457,2023-07-30,711,TD kit,150,300,150,1,00460,India
588457,2023-07-30,717,spiral bound book,50,100,50,1,00460,India
256362,2023-07-30,702,pencil,2,5,3,1,00075,India
256362,2023-07-30,717,spiral bound book,50,100,50,1,00075,India
256362,2023-07-30,711,TD kit,150,300,150,1,00075,India
540053,2023-07-30,715,folder,5,15,10,1,00390,India
540053,2023-07-30,706,sharpener,3,8,5,1,00390,India
540053,2023-07-30,708,sketchpen,15,40,25,1,00390,India
540053,2023-07-30,705,stencil,10,20,10,1,00390,India
103728,2023-07-30,703,eraser,1,3,2,1,00334,India
103728,2023-07-30,712,graph paper,20,40,20,1,00334,India
103728,2023-07-30,710,geometry box,100,150,50,1,00334,India
103728,2023-07-30,709,notebook,30,60,30,1,00334,India
103728,2023-07-30,708,sketchpen,15,40,25,1,00334,India
111792,2023-07-30,708,sketchpen,15,40,25,1,00039,India
111792,2023-07-30,703,eraser,1,3,2,1,00039,India
111792,2023-07-30,715,folder,5,15,10,1,00039,India
111792,2023-07-30,717,spiral bound book,50,100,50,1,00039,India
581236,2023-07-30,707,marker,20,40,20,1,00320,India
581236,2023-07-30,708,sketchpen,15,40,25,1,00320,India
680693,2023-07-30,716,printing paper,200,400,200,1,00227,India
680693,2023-07-30,707,marker,20,40,20,1,00227,India
292088,2023-07-30,704,scale,5,10,5,1,00102,India
352349,2023-07-30,710,geometry box,100,150,50,1,00131,India
352349,2023-07-30,712,graph paper,20,40,20,1,00131,India
352349,2023-07-30,707,marker,20,40,20,1,00131,India
107050,2023-07-30,711,TD kit,150,300,150,1,00441,India
171040,2023-07-30,701,gel pen,5,10,5,1,00369,India
171040,2023-07-30,703,eraser,1,3,2,1,00369,India
171040,2023-07-30,717,spiral bound book,50,100,50,1,00369,India
171040,2023-07-30,712,graph paper,20,40,20,1,00369,India
171040,2023-07-30,707,marker,20,40,20,1,00369,India
670015,2023-07-30,703,eraser,1,3,2,1,00082,India
670015,2023-07-30,717,spiral bound book,50,100,50,1,00082,India
670015,2023-07-30,712,graph paper,20,40,20,1,00082,India
670015,2023-07-30,702,pencil,2,5,3,1,00082,India
377412,2023-07-30,714,carbon paper,15,30,15,1,00259,India
377412,2023-07-30,706,sharpener,3,8,5,1,00259,India
377412,2023-07-30,702,pencil,2,5,3,1,00259,India
377412,2023-07-30,717,spiral bound book,50,100,50,1,00259,India
377412,2023-07-30,705,stencil,10,20,10,1,00259,India
693676,2023-07-30,703,eraser,1,3,2,1,00189,India
693676,2023-07-30,704,scale,5,10,5,1,00189,India
693676,2023-07-30,710,geometry box,100,150,50,1,00189,India
560312,2023-07-30,710,geometry box,100,150,50,1,00142,India
560312,2023-07-30,706,sharpener,3,8,5,1,00142,India
560312,2023-07-30,714,carbon paper,15,30,15,1,00142,India
560312,2023-07-30,705,stencil,10,20,10,1,00142,India
331338,2023-07-30,712,graph paper,20,40,20,1,00354,India
859939,2023-07-30,703,eraser,1,3,2,1,00293,India
859939,2023-07-30,701,gel pen,5,10,5,1,00293,India
859939,2023-07-30,708,sketchpen,15,40,25,1,00293,India
709677,2023-07-30,713,ball pen,5,10,5,1,00371,India
709677,2023-07-30,702,pencil,2,5,3,1,00371,India
709677,2023-07-30,710,geometry box,100,150,50,1,00371,India
709677,2023-07-30,712,graph paper,20,40,20,1,00371,India
777279,2023-07-30,713,ball pen,5,10,5,1,00102,India
777279,2023-07-30,708,sketchpen,15,40,25,1,00102,India
777279,2023-07-30,707,marker,20,40,20,1,00102,India
599440,2023-07-30,703,eraser,1,3,2,1,00497,India
599440,2023-07-30,717,spiral bound book,50,100,50,1,00497,India
553421,2023-07-30,712,graph paper,20,40,20,1,00065,India
553421,2023-07-30,701,gel pen,5,10,5,1,00065,India
680375,2023-07-30,703,eraser,1,3,2,1,00097,India
680375,2023-07-30,716,printing paper,200,400,200,1,00097,India
680375,2023-07-30,707,marker,20,40,20,1,00097,India
225244,2023-07-30,713,ball pen,5,10,5,1,00141,India
225244,2023-07-30,715,folder,5,15,10,1,00141,India
225244,2023-07-30,710,geometry box,100,150,50,1,00141,India
225244,2023-07-30,709,notebook,30,60,30,1,00141,India
786866,2023-07-30,714,carbon paper,15,30,15,1,00008,India
786866,2023-07-30,717,spiral bound book,50,100,50,1,00008,India
786866,2023-07-30,713,ball pen,5,10,5,1,00008,India
786866,2023-07-30,707,marker,20,40,20,1,00008,India
786866,2023-07-30,715,folder,5,15,10,1,00008,India
764526,2023-07-30,702,pencil,2,5,3,1,00418,India
373850,2023-07-30,712,graph paper,20,40,20,1,00191,India
373850,2023-07-30,702,pencil,2,5,3,1,00191,India
193884,2023-07-30,708,sketchpen,15,40,25,1,00087,India
193884,2023-07-30,715,folder,5,15,10,1,00087,India
193884,2023-07-30,712,graph paper,20,40,20,1,00087,India
193884,2023-07-30,706,sharpener,3,8,5,1,00087,India
989771,2023-07-30,706,sharpener,3,8,5,1,00104,India
989771,2023-07-30,715,folder,5,15,10,1,00104,India
513877,2023-07-30,711,TD kit,150,300,150,1,00089,India
513877,2023-07-30,714,carbon paper,15,30,15,1,00089,India
773171,2023-07-30,703,eraser,1,3,2,1,00347,India
773171,2023-07-30,717,spiral bound book,50,100,50,1,00347,India
773171,2023-07-30,702,pencil,2,5,3,1,00347,India
106010,2023-07-30,706,sharpener,3,8,5,1,00500,India
682336,2023-07-30,707,marker,20,40,20,1,00003,India
682336,2023-07-30,710,geometry box,100,150,50,1,00003,India
682336,2023-07-30,701,gel pen,5,10,5,1,00003,India
682336,2023-07-30,704,scale,5,10,5,1,00003,India
682336,2023-07-30,708,sketchpen,15,40,25,1,00003,India
483788,2023-07-30,709,notebook,30,60,30,1,00387,India
489828,2023-07-30,704,scale,5,10,5,1,00187,India
489828,2023-07-30,716,printing paper,200,400,200,1,00187,India
489828,2023-07-30,703,eraser,1,3,2,1,00187,India
489828,2023-07-30,701,gel pen,5,10,5,1,00187,India
515432,2023-07-30,712,graph paper,20,40,20,1,00032,India
515432,2023-07-30,704,scale,5,10,5,1,00032,India
330999,2023-07-30,704,scale,5,10,5,1,00003,India
330999,2023-07-30,706,sharpener,3,8,5,1,00003,India
330999,2023-07-30,711,TD kit,150,300,150,1,00003,India
330999,2023-07-30,715,folder,5,15,10,1,00003,India
127349,2023-07-30,712,graph paper,20,40,20,1,00051,India
127349,2023-07-30,717,spiral bound book,50,100,50,1,00051,India
325391,2023-07-30,709,notebook,30,60,30,1,00222,India
325391,2023-07-30,713,ball pen,5,10,5,1,00222,India
325391,2023-07-30,708,sketchpen,15,40,25,1,00222,India
794481,2023-07-30,703,eraser,1,3,2,1,00439,India
794481,2023-07-30,710,geometry box,100,150,50,1,00439,India
794481,2023-07-30,707,marker,20,40,20,1,00439,India
403141,2023-07-30,714,carbon paper,15,30,15,1,00060,India
314910,2023-07-30,710,geometry box,100,150,50,1,00144,India
314910,2023-07-30,709,notebook,30,60,30,1,00144,India
314910,2023-07-30,712,graph paper,20,40,20,1,00144,India
314910,2023-07-30,702,pencil,2,5,3,1,00144,India
562932,2023-07-30,708,sketchpen,15,40,25,1,00026,India
562932,2023-07-30,711,TD kit,150,300,150,1,00026,India
562932,2023-07-30,716,printing paper,200,400,200,1,00026,India
562932,2023-07-30,703,eraser,1,3,2,1,00026,India
562932,2023-07-30,704,scale,5,10,5,1,00026,India
906617,2023-07-30,710,geometry box,100,150,50,1,00038,India
906617,2023-07-30,711,TD kit,150,300,150,1,00038,India
998198,2023-07-31,713,ball pen,5,10,5,1,00056,India
998198,2023-07-31,716,printing paper,200,400,200,1,00056,India
546902,2023-07-31,710,geometry box,100,150,50,1,00045,India
546902,2023-07-31,706,sharpener,3,8,5,1,00045,India
546902,2023-07-31,705,stencil,10,20,10,1,00045,India
881417,2023-07-31,714,carbon paper,15,30,15,1,00428,India
881417,2023-07-31,704,scale,5,10,5,1,00428,India
881417,2023-07-31,709,notebook,30,60,30,1,00428,India
391376,2023-07-31,711,TD kit,150,300,150,1,00259,India
313317,2023-07-31,713,ball pen,5,10,5,1,00043,India
313317,2023-07-31,704,scale,5,10,5,1,00043,India
353884,2023-07-31,715,folder,5,15,10,1,00200,India
353884,2023-07-31,711,TD kit,150,300,150,1,00200,India
353884,2023-07-31,702,pencil,2,5,3,1,00200,India
914036,2023-07-31,713,ball pen,5,10,5,1,00383,India
914036,2023-07-31,714,carbon paper,15,30,15,1,00383,India
914036,2023-07-31,706,sharpener,3,8,5,1,00383,India
914036,2023-07-31,701,gel pen,5,10,5,1,00383,India
914036,2023-07-31,705,stencil,10,20,10,1,00383,India
650458,2023-07-31,714,carbon paper,15,30,15,1,00206,India
650458,2023-07-31,706,sharpener,3,8,5,1,00206,India
465677,2023-07-31,703,eraser,1,3,2,1,00374,India
465677,2023-07-31,707,marker,20,40,20,1,00374,India
116327,2023-07-31,712,graph paper,20,40,20,1,00458,India
116327,2023-07-31,708,sketchpen,15,40,25,1,00458,India
116327,2023-07-31,706,sharpener,3,8,5,1,00458,India
116327,2023-07-31,716,printing paper,200,400,200,1,00458,India
943139,2023-07-31,707,marker,20,40,20,1,00288,India
943139,2023-07-31,701,gel pen,5,10,5,1,00288,India
943139,2023-07-31,710,geometry box,100,150,50,1,00288,India
943139,2023-07-31,714,carbon paper,15,30,15,1,00288,India
943139,2023-07-31,715,folder,5,15,10,1,00288,India
561099,2023-07-31,708,sketchpen,15,40,25,1,00297,India
561099,2023-07-31,716,printing paper,200,400,200,1,00297,India
166618,2023-07-31,714,carbon paper,15,30,15,1,00219,India
166618,2023-07-31,716,printing paper,200,400,200,1,00219,India
166618,2023-07-31,713,ball pen,5,10,5,1,00219,India
166618,2023-07-31,708,sketchpen,15,40,25,1,00219,India
166618,2023-07-31,709,notebook,30,60,30,1,00219,India
643483,2023-07-31,717,spiral bound book,50,100,50,1,00323,India
643483,2023-07-31,712,graph paper,20,40,20,1,00323,India
643483,2023-07-31,704,scale,5,10,5,1,00323,India
998129,2023-07-31,716,printing paper,200,400,200,1,00004,India
444239,2023-07-31,711,TD kit,150,300,150,1,00456,India
444239,2023-07-31,707,marker,20,40,20,1,00456,India
444239,2023-07-31,715,folder,5,15,10,1,00456,India
444239,2023-07-31,708,sketchpen,15,40,25,1,00456,India
137214,2023-07-31,709,notebook,30,60,30,1,00166,India
137214,2023-07-31,704,scale,5,10,5,1,00166,India
137214,2023-07-31,710,geometry box,100,150,50,1,00166,India
137214,2023-07-31,707,marker,20,40,20,1,00166,India
647196,2023-07-31,702,pencil,2,5,3,1,00090,India
647196,2023-07-31,711,TD kit,150,300,150,1,00090,India
647196,2023-07-31,714,carbon paper,15,30,15,1,00090,India
647196,2023-07-31,713,ball pen,5,10,5,1,00090,India
625149,2023-07-31,713,ball pen,5,10,5,1,00300,India
625149,2023-07-31,714,carbon paper,15,30,15,1,00300,India
625149,2023-07-31,703,eraser,1,3,2,1,00300,India
625149,2023-07-31,709,notebook,30,60,30,1,00300,India
625149,2023-07-31,712,graph paper,20,40,20,1,00300,India
834846,2023-07-31,712,graph paper,20,40,20,1,00022,India
834846,2023-07-31,713,ball pen,5,10,5,1,00022,India
320545,2023-07-31,702,pencil,2,5,3,1,00498,India
320545,2023-07-31,704,scale,5,10,5,1,00498,India
320545,2023-07-31,706,sharpener,3,8,5,1,00498,India
282378,2023-07-31,707,marker,20,40,20,1,00023,India
282378,2023-07-31,703,eraser,1,3,2,1,00023,India
282378,2023-07-31,705,stencil,10,20,10,1,00023,India
528581,2023-07-31,702,pencil,2,5,3,1,00493,India
528581,2023-07-31,717,spiral bound book,50,100,50,1,00493,India
889516,2023-07-31,701,gel pen,5,10,5,1,00176,India
889516,2023-07-31,707,marker,20,40,20,1,00176,India
797379,2023-07-31,704,scale,5,10,5,1,00304,India
797379,2023-07-31,702,pencil,2,5,3,1,00304,India
797379,2023-07-31,707,marker,20,40,20,1,00304,India
797379,2023-07-31,715,folder,5,15,10,1,00304,India
184327,2023-07-31,713,ball pen,5,10,5,1,00394,India
184327,2023-07-31,712,graph paper,20,40,20,1,00394,India
184327,2023-07-31,704,scale,5,10,5,1,00394,India
188154,2023-07-31,711,TD kit,150,300,150,1,00218,India
188154,2023-07-31,716,printing paper,200,400,200,1,00218,India
843892,2023-07-31,710,geometry box,100,150,50,1,00297,India
843892,2023-07-31,714,carbon paper,15,30,15,1,00297,India
385677,2023-07-31,713,ball pen,5,10,5,1,00053,India
385677,2023-07-31,708,sketchpen,15,40,25,1,00053,India
385677,2023-07-31,711,TD kit,150,300,150,1,00053,India
526395,2023-07-31,711,TD kit,150,300,150,1,00009,India
526395,2023-07-31,716,printing paper,200,400,200,1,00009,India
526395,2023-07-31,709,notebook,30,60,30,1,00009,India
526395,2023-07-31,704,scale,5,10,5,1,00009,India
742739,2023-07-31,710,geometry box,100,150,50,1,00109,India
742739,2023-07-31,701,gel pen,5,10,5,1,00109,India
100933,2023-07-31,711,TD kit,150,300,150,1,00124,India
100933,2023-07-31,717,spiral bound book,50,100,50,1,00124,India
861867,2023-07-31,703,eraser,1,3,2,1,00112,India
861867,2023-07-31,717,spiral bound book,50,100,50,1,00112,India
861867,2023-07-31,707,marker,20,40,20,1,00112,India
631807,2023-07-31,701,gel pen,5,10,5,1,00295,India
631807,2023-07-31,702,pencil,2,5,3,1,00295,India
631807,2023-07-31,707,marker,20,40,20,1,00295,India
631807,2023-07-31,712,graph paper,20,40,20,1,00295,India
743296,2023-08-01,713,ball pen,5,10,5,1,00270,India
743296,2023-08-01,709,notebook,30,60,30,1,00270,India
743296,2023-08-01,701,gel pen,5,10,5,1,00270,India
415263,2023-08-01,703,eraser,1,3,2,1,00351,India
415263,2023-08-01,710,geometry box,100,150,50,1,00351,India
605115,2023-08-01,717,spiral bound book,50,100,50,1,00087,India
605115,2023-08-01,710,geometry box,100,150,50,1,00087,India
605115,2023-08-01,711,TD kit,150,300,150,1,00087,India
613604,2023-08-01,713,ball pen,5,10,5,1,00392,India
613604,2023-08-01,707,marker,20,40,20,1,00392,India
868989,2023-08-01,715,folder,5,15,10,1,00081,India
868989,2023-08-01,707,marker,20,40,20,1,00081,India
868989,2023-08-01,701,gel pen,5,10,5,1,00081,India
711388,2023-08-01,717,spiral bound book,50,100,50,1,00263,India
711388,2023-08-01,703,eraser,1,3,2,1,00263,India
711388,2023-08-01,711,TD kit,150,300,150,1,00263,India
711388,2023-08-01,704,scale,5,10,5,1,00263,India
347262,2023-08-01,707,marker,20,40,20,1,00188,India
347262,2023-08-01,716,printing paper,200,400,200,1,00188,India
347262,2023-08-01,709,notebook,30,60,30,1,00188,India
894475,2023-08-01,703,eraser,1,3,2,1,00169,India
894475,2023-08-01,710,geometry box,100,150,50,1,00169,India
894475,2023-08-01,715,folder,5,15,10,1,00169,India
373686,2023-08-01,706,sharpener,3,8,5,1,00214,India
202398,2023-08-01,710,geometry box,100,150,50,1,00275,India
202398,2023-08-01,708,sketchpen,15,40,25,1,00275,India
997462,2023-08-01,710,geometry box,100,150,50,1,00412,India
783946,2023-08-01,710,geometry box,100,150,50,1,00397,India
783946,2023-08-01,713,ball pen,5,10,5,1,00397,India
247571,2023-08-01,717,spiral bound book,50,100,50,1,00353,India
155989,2023-08-01,709,notebook,30,60,30,1,00197,India
255407,2023-08-01,714,carbon paper,15,30,15,1,00404,India
255407,2023-08-01,713,ball pen,5,10,5,1,00404,India
255407,2023-08-01,716,printing paper,200,400,200,1,00404,India
255407,2023-08-01,712,graph paper,20,40,20,1,00404,India
856628,2023-08-01,710,geometry box,100,150,50,1,00479,India
856628,2023-08-01,707,marker,20,40,20,1,00479,India
856628,2023-08-01,712,graph paper,20,40,20,1,00479,India
856628,2023-08-01,701,gel pen,5,10,5,1,00479,India
762805,2023-08-01,715,folder,5,15,10,1,00137,India
762805,2023-08-01,703,eraser,1,3,2,1,00137,India
762805,2023-08-01,713,ball pen,5,10,5,1,00137,India
278983,2023-08-01,711,TD kit,150,300,150,1,00047,India
278983,2023-08-01,703,eraser,1,3,2,1,00047,India
351104,2023-08-01,713,ball pen,5,10,5,1,00367,India
351104,2023-08-01,710,geometry box,100,150,50,1,00367,India
351104,2023-08-01,715,folder,5,15,10,1,00367,India
351104,2023-08-01,707,marker,20,40,20,1,00367,India
503504,2023-08-01,714,carbon paper,15,30,15,1,00148,India
503504,2023-08-01,705,stencil,10,20,10,1,00148,India
503504,2023-08-01,711,TD kit,150,300,150,1,00148,India
503504,2023-08-01,712,graph paper,20,40,20,1,00148,India
106242,2023-08-01,704,scale,5,10,5,1,00207,India
223755,2023-08-01,704,scale,5,10,5,1,00456,India
850743,2023-08-01,703,eraser,1,3,2,1,00158,India
850743,2023-08-01,710,geometry box,100,150,50,1,00158,India
850743,2023-08-01,712,graph paper,20,40,20,1,00158,India
867552,2023-08-01,704,scale,5,10,5,1,00085,India
867552,2023-08-01,717,spiral bound book,50,100,50,1,00085,India
867552,2023-08-01,709,notebook,30,60,30,1,00085,India
867552,2023-08-01,701,gel pen,5,10,5,1,00085,India
399831,2023-08-01,703,eraser,1,3,2,1,00419,India
399831,2023-08-01,714,carbon paper,15,30,15,1,00419,India
399831,2023-08-01,706,sharpener,3,8,5,1,00419,India
399831,2023-08-01,704,scale,5,10,5,1,00419,India
697328,2023-08-01,712,graph paper,20,40,20,1,00085,India
833107,2023-08-01,702,pencil,2,5,3,1,00132,India
833107,2023-08-01,711,TD kit,150,300,150,1,00132,India
833107,2023-08-01,710,geometry box,100,150,50,1,00132,India
922496,2023-08-01,709,notebook,30,60,30,1,00144,India
922496,2023-08-01,714,carbon paper,15,30,15,1,00144,India
922496,2023-08-01,703,eraser,1,3,2,1,00144,India
922496,2023-08-01,706,sharpener,3,8,5,1,00144,India
922496,2023-08-01,707,marker,20,40,20,1,00144,India
468982,2023-08-01,716,printing paper,200,400,200,1,00126,India
468982,2023-08-01,717,spiral bound book,50,100,50,1,00126,India
601581,2023-08-01,701,gel pen,5,10,5,1,00059,India
601581,2023-08-01,702,pencil,2,5,3,1,00059,India
601581,2023-08-01,703,eraser,1,3,2,1,00059,India
955815,2023-08-01,717,spiral bound book,50,100,50,1,00042,India
955815,2023-08-01,701,gel pen,5,10,5,1,00042,India
955815,2023-08-01,714,carbon paper,15,30,15,1,00042,India
839160,2023-08-01,712,graph paper,20,40,20,1,00365,India
839160,2023-08-01,715,folder,5,15,10,1,00365,India
839160,2023-08-01,701,gel pen,5,10,5,1,00365,India
839160,2023-08-01,716,printing paper,200,400,200,1,00365,India
853932,2023-08-01,711,TD kit,150,300,150,1,00164,India
853932,2023-08-01,712,graph paper,20,40,20,1,00164,India
607166,2023-08-01,711,TD kit,150,300,150,1,00121,India
607166,2023-08-01,713,ball pen,5,10,5,1,00121,India
111108,2023-08-01,705,stencil,10,20,10,1,00136,India
111108,2023-08-01,711,TD kit,150,300,150,1,00136,India
111108,2023-08-01,701,gel pen,5,10,5,1,00136,India
502712,2023-08-01,702,pencil,2,5,3,1,00114,India
502712,2023-08-01,701,gel pen,5,10,5,1,00114,India
502712,2023-08-01,710,geometry box,100,150,50,1,00114,India
502712,2023-08-01,714,carbon paper,15,30,15,1,00114,India
158243,2023-08-01,701,gel pen,5,10,5,1,00374,India
158243,2023-08-01,716,printing paper,200,400,200,1,00374,India
483444,2023-08-01,704,scale,5,10,5,1,00172,India
483444,2023-08-01,709,notebook,30,60,30,1,00172,India
483444,2023-08-01,712,graph paper,20,40,20,1,00172,India
483444,2023-08-01,716,printing paper,200,400,200,1,00172,India
483444,2023-08-01,701,gel pen,5,10,5,1,00172,India
587833,2023-08-01,711,TD kit,150,300,150,1,00074,India
984590,2023-08-01,710,geometry box,100,150,50,1,00271,India
984590,2023-08-01,705,stencil,10,20,10,1,00271,India
193783,2023-08-01,713,ball pen,5,10,5,1,00222,India
193783,2023-08-01,714,carbon paper,15,30,15,1,00222,India
193783,2023-08-01,717,spiral bound book,50,100,50,1,00222,India
193783,2023-08-01,709,notebook,30,60,30,1,00222,India
351855,2023-08-01,712,graph paper,20,40,20,1,00119,India
351855,2023-08-01,702,pencil,2,5,3,1,00119,India
351855,2023-08-01,711,TD kit,150,300,150,1,00119,India
351855,2023-08-01,710,geometry box,100,150,50,1,00119,India
241210,2023-08-01,702,pencil,2,5,3,1,00442,India
241210,2023-08-01,717,spiral bound book,50,100,50,1,00442,India
241210,2023-08-01,716,printing paper,200,400,200,1,00442,India
241210,2023-08-01,707,marker,20,40,20,1,00442,India
234858,2023-08-01,703,eraser,1,3,2,1,00013,India
234858,2023-08-01,706,sharpener,3,8,5,1,00013,India
234858,2023-08-01,713,ball pen,5,10,5,1,00013,India
310442,2023-08-01,711,TD kit,150,300,150,1,00363,India
310442,2023-08-01,706,sharpener,3,8,5,1,00363,India
310442,2023-08-01,713,ball pen,5,10,5,1,00363,India
294348,2023-08-01,711,TD kit,150,300,150,1,00399,India
294348,2023-08-01,710,geometry box,100,150,50,1,00399,India
294348,2023-08-01,701,gel pen,5,10,5,1,00399,India
538994,2023-08-01,714,carbon paper,15,30,15,1,00328,India
538994,2023-08-01,702,pencil,2,5,3,1,00328,India
694841,2023-08-01,709,notebook,30,60,30,1,00047,India
694841,2023-08-01,712,graph paper,20,40,20,1,00047,India
694841,2023-08-01,716,printing paper,200,400,200,1,00047,India
354161,2023-08-01,706,sharpener,3,8,5,1,00020,India
354161,2023-08-01,714,carbon paper,15,30,15,1,00020,India
354161,2023-08-01,710,geometry box,100,150,50,1,00020,India
354161,2023-08-01,716,printing paper,200,400,200,1,00020,India
149872,2023-08-01,702,pencil,2,5,3,1,00279,India
149872,2023-08-01,701,gel pen,5,10,5,1,00279,India
149872,2023-08-01,705,stencil,10,20,10,1,00279,India
149872,2023-08-01,712,graph paper,20,40,20,1,00279,India
793252,2023-08-02,705,stencil,10,20,10,1,00058,India
793252,2023-08-02,709,notebook,30,60,30,1,00058,India
369922,2023-08-02,706,sharpener,3,8,5,1,00458,India
369922,2023-08-02,714,carbon paper,15,30,15,1,00458,India
841085,2023-08-02,712,graph paper,20,40,20,1,00062,India
841085,2023-08-02,708,sketchpen,15,40,25,1,00062,India
877002,2023-08-02,706,sharpener,3,8,5,1,00106,India
877002,2023-08-02,710,geometry box,100,150,50,1,00106,India
877002,2023-08-02,704,scale,5,10,5,1,00106,India
417021,2023-08-02,708,sketchpen,15,40,25,1,00100,India
417021,2023-08-02,707,marker,20,40,20,1,00100,India
312318,2023-08-02,703,eraser,1,3,2,1,00388,India
312318,2023-08-02,716,printing paper,200,400,200,1,00388,India
312318,2023-08-02,714,carbon paper,15,30,15,1,00388,India
834404,2023-08-02,707,marker,20,40,20,1,00317,India
834404,2023-08-02,706,sharpener,3,8,5,1,00317,India
834404,2023-08-02,701,gel pen,5,10,5,1,00317,India
700148,2023-08-02,710,geometry box,100,150,50,1,00222,India
700148,2023-08-02,716,printing paper,200,400,200,1,00222,India
700148,2023-08-02,711,TD kit,150,300,150,1,00222,India
700148,2023-08-02,714,carbon paper,15,30,15,1,00222,India
156297,2023-08-02,701,gel pen,5,10,5,1,00071,India
766708,2023-08-02,711,TD kit,150,300,150,1,00041,India
766708,2023-08-02,709,notebook,30,60,30,1,00041,India
766708,2023-08-02,712,graph paper,20,40,20,1,00041,India
766708,2023-08-02,710,geometry box,100,150,50,1,00041,India
724208,2023-08-02,703,eraser,1,3,2,1,00150,India
911327,2023-08-02,711,TD kit,150,300,150,1,00155,India
911327,2023-08-02,706,sharpener,3,8,5,1,00155,India
911327,2023-08-02,708,sketchpen,15,40,25,1,00155,India
911327,2023-08-02,703,eraser,1,3,2,1,00155,India
929219,2023-08-02,702,pencil,2,5,3,1,00175,India
929219,2023-08-02,703,eraser,1,3,2,1,00175,India
929219,2023-08-02,705,stencil,10,20,10,1,00175,India
929219,2023-08-02,711,TD kit,150,300,150,1,00175,India
902897,2023-08-02,713,ball pen,5,10,5,1,00429,India
902897,2023-08-02,704,scale,5,10,5,1,00429,India
902897,2023-08-02,707,marker,20,40,20,1,00429,India
902897,2023-08-02,717,spiral bound book,50,100,50,1,00429,India
902897,2023-08-02,711,TD kit,150,300,150,1,00429,India
823095,2023-08-02,703,eraser,1,3,2,1,00038,India
823095,2023-08-02,709,notebook,30,60,30,1,00038,India
101726,2023-08-02,711,TD kit,150,300,150,1,00215,India
101726,2023-08-02,710,geometry box,100,150,50,1,00215,India
101726,2023-08-02,712,graph paper,20,40,20,1,00215,India
101726,2023-08-02,703,eraser,1,3,2,1,00215,India
478485,2023-08-02,708,sketchpen,15,40,25,1,00491,India
478485,2023-08-02,711,TD kit,150,300,150,1,00491,India
193237,2023-08-02,705,stencil,10,20,10,1,00053,India
193237,2023-08-02,704,scale,5,10,5,1,00053,India
193237,2023-08-02,702,pencil,2,5,3,1,00053,India
816439,2023-08-02,712,graph paper,20,40,20,1,00347,India
816439,2023-08-02,701,gel pen,5,10,5,1,00347,India
816439,2023-08-02,710,geometry box,100,150,50,1,00347,India
816439,2023-08-02,707,marker,20,40,20,1,00347,India
213354,2023-08-02,715,folder,5,15,10,1,00107,India
356657,2023-08-02,709,notebook,30,60,30,1,00359,India
356657,2023-08-02,714,carbon paper,15,30,15,1,00359,India
356657,2023-08-02,713,ball pen,5,10,5,1,00359,India
356657,2023-08-02,711,TD kit,150,300,150,1,00359,India
858013,2023-08-02,712,graph paper,20,40,20,1,00078,India
858013,2023-08-02,701,gel pen,5,10,5,1,00078,India
858013,2023-08-02,713,ball pen,5,10,5,1,00078,India
578982,2023-08-02,715,folder,5,15,10,1,00493,India
578982,2023-08-02,704,scale,5,10,5,1,00493,India
384016,2023-08-02,705,stencil,10,20,10,1,00120,India
384016,2023-08-02,702,pencil,2,5,3,1,00120,India
384016,2023-08-02,713,ball pen,5,10,5,1,00120,India
384016,2023-08-02,704,scale,5,10,5,1,00120,India
384016,2023-08-02,706,sharpener,3,8,5,1,00120,India
775551,2023-08-02,713,ball pen,5,10,5,1,00472,India
219005,2023-08-02,710,geometry box,100,150,50,1,00363,India
219005,2023-08-02,711,TD kit,150,300,150,1,00363,India
219005,2023-08-02,701,gel pen,5,10,5,1,00363,India
229956,2023-08-02,713,ball pen,5,10,5,1,00052,India
229956,2023-08-02,704,scale,5,10,5,1,00052,India
229956,2023-08-02,703,eraser,1,3,2,1,00052,India
908068,2023-08-02,706,sharpener,3,8,5,1,00140,India
908068,2023-08-02,713,ball pen,5,10,5,1,00140,India
280892,2023-08-02,716,printing paper,200,400,200,1,00082,India
997086,2023-08-02,711,TD kit,150,300,150,1,00285,India
997086,2023-08-02,709,notebook,30,60,30,1,00285,India
997086,2023-08-02,703,eraser,1,3,2,1,00285,India
997086,2023-08-02,704,scale,5,10,5,1,00285,India
997086,2023-08-02,717,spiral bound book,50,100,50,1,00285,India
130264,2023-08-02,714,carbon paper,15,30,15,1,00475,India
130264,2023-08-02,715,folder,5,15,10,1,00475,India
130264,2023-08-02,701,gel pen,5,10,5,1,00475,India
130264,2023-08-02,710,geometry box,100,150,50,1,00475,India
646114,2023-08-02,717,spiral bound book,50,100,50,1,00496,India
646114,2023-08-02,704,scale,5,10,5,1,00496,India
460830,2023-08-02,704,scale,5,10,5,1,00041,India
460830,2023-08-02,715,folder,5,15,10,1,00041,India
460830,2023-08-02,708,sketchpen,15,40,25,1,00041,India
848173,2023-08-02,715,folder,5,15,10,1,00316,India
848173,2023-08-02,702,pencil,2,5,3,1,00316,India
848173,2023-08-02,717,spiral bound book,50,100,50,1,00316,India
848173,2023-08-02,710,geometry box,100,150,50,1,00316,India
848173,2023-08-02,716,printing paper,200,400,200,1,00316,India
783840,2023-08-02,713,ball pen,5,10,5,1,00431,India
783840,2023-08-02,702,pencil,2,5,3,1,00431,India
562118,2023-08-02,701,gel pen,5,10,5,1,00091,India
562118,2023-08-02,711,TD kit,150,300,150,1,00091,India
562118,2023-08-02,702,pencil,2,5,3,1,00091,India
562118,2023-08-02,704,scale,5,10,5,1,00091,India
250934,2023-08-02,707,marker,20,40,20,1,00453,India
250934,2023-08-02,704,scale,5,10,5,1,00453,India
250934,2023-08-02,706,sharpener,3,8,5,1,00453,India
250934,2023-08-02,714,carbon paper,15,30,15,1,00453,India
665664,2023-08-02,713,ball pen,5,10,5,1,00231,India
665664,2023-08-02,703,eraser,1,3,2,1,00231,India
665664,2023-08-02,704,scale,5,10,5,1,00231,India
665664,2023-08-02,714,carbon paper,15,30,15,1,00231,India
708374,2023-08-02,709,notebook,30,60,30,1,00116,India
708374,2023-08-02,712,graph paper,20,40,20,1,00116,India
267235,2023-08-02,713,ball pen,5,10,5,1,00045,India
267235,2023-08-02,710,geometry box,100,150,50,1,00045,India
267235,2023-08-02,716,printing paper,200,400,200,1,00045,India
267235,2023-08-02,705,stencil,10,20,10,1,00045,India
176306,2023-08-02,706,sharpener,3,8,5,1,00433,India
176306,2023-08-02,709,notebook,30,60,30,1,00433,India
673074,2023-08-02,709,notebook,30,60,30,1,00039,India
673074,2023-08-02,710,geometry box,100,150,50,1,00039,India
673074,2023-08-02,703,eraser,1,3,2,1,00039,India
186394,2023-08-02,716,printing paper,200,400,200,1,00276,India
186394,2023-08-02,706,sharpener,3,8,5,1,00276,India
660747,2023-08-02,705,stencil,10,20,10,1,00270,India
128785,2023-08-02,702,pencil,2,5,3,1,00387,India
128785,2023-08-02,713,ball pen,5,10,5,1,00387,India
128785,2023-08-02,717,spiral bound book,50,100,50,1,00387,India
128785,2023-08-02,706,sharpener,3,8,5,1,00387,India
128785,2023-08-02,709,notebook,30,60,30,1,00387,India
133701,2023-08-02,705,stencil,10,20,10,1,00326,India
133701,2023-08-02,714,carbon paper,15,30,15,1,00326,India
133701,2023-08-02,711,TD kit,150,300,150,1,00326,India
709107,2023-08-03,706,sharpener,3,8,5,1,00109,India
265912,2023-08-03,713,ball pen,5,10,5,1,00450,India
265912,2023-08-03,714,carbon paper,15,30,15,1,00450,India
265912,2023-08-03,708,sketchpen,15,40,25,1,00450,India
265912,2023-08-03,702,pencil,2,5,3,1,00450,India
137553,2023-08-03,715,folder,5,15,10,1,00150,India
137553,2023-08-03,709,notebook,30,60,30,1,00150,India
137553,2023-08-03,710,geometry box,100,150,50,1,00150,India
632171,2023-08-03,712,graph paper,20,40,20,1,00382,India
632171,2023-08-03,717,spiral bound book,50,100,50,1,00382,India
512455,2023-08-03,706,sharpener,3,8,5,1,00448,India
175240,2023-08-03,714,carbon paper,15,30,15,1,00463,India
175240,2023-08-03,703,eraser,1,3,2,1,00463,India
175240,2023-08-03,709,notebook,30,60,30,1,00463,India
268487,2023-08-03,707,marker,20,40,20,1,00040,India
847631,2023-08-03,711,TD kit,150,300,150,1,00295,India
847631,2023-08-03,710,geometry box,100,150,50,1,00295,India
847631,2023-08-03,704,scale,5,10,5,1,00295,India
678550,2023-08-03,715,folder,5,15,10,1,00243,India
829776,2023-08-03,705,stencil,10,20,10,1,00484,India
550676,2023-08-03,702,pencil,2,5,3,1,00298,India
550676,2023-08-03,705,stencil,10,20,10,1,00298,India
550676,2023-08-03,703,eraser,1,3,2,1,00298,India
179977,2023-08-03,710,geometry box,100,150,50,1,00307,India
179977,2023-08-03,701,gel pen,5,10,5,1,00307,India
179977,2023-08-03,704,scale,5,10,5,1,00307,India
305624,2023-08-03,716,printing paper,200,400,200,1,00233,India
487921,2023-08-03,707,marker,20,40,20,1,00241,India
487921,2023-08-03,705,stencil,10,20,10,1,00241,India
487921,2023-08-03,715,folder,5,15,10,1,00241,India
487921,2023-08-03,713,ball pen,5,10,5,1,00241,India
299760,2023-08-03,708,sketchpen,15,40,25,1,00335,India
299760,2023-08-03,711,TD kit,150,300,150,1,00335,India
299760,2023-08-03,713,ball pen,5,10,5,1,00335,India
238093,2023-08-03,701,gel pen,5,10,5,1,00360,India
238093,2023-08-03,711,TD kit,150,300,150,1,00360,India
238093,2023-08-03,709,notebook,30,60,30,1,00360,India
238093,2023-08-03,705,stencil,10,20,10,1,00360,India
843334,2023-08-03,712,graph paper,20,40,20,1,00359,India
843334,2023-08-03,703,eraser,1,3,2,1,00359,India
843334,2023-08-03,717,spiral bound book,50,100,50,1,00359,India
843334,2023-08-03,716,printing paper,200,400,200,1,00359,India
335324,2023-08-03,708,sketchpen,15,40,25,1,00126,India
335324,2023-08-03,706,sharpener,3,8,5,1,00126,India
531287,2023-08-03,701,gel pen,5,10,5,1,00044,India
531287,2023-08-03,717,spiral bound book,50,100,50,1,00044,India
531287,2023-08-03,708,sketchpen,15,40,25,1,00044,India
531287,2023-08-03,715,folder,5,15,10,1,00044,India
679336,2023-08-03,717,spiral bound book,50,100,50,1,00425,India
679336,2023-08-03,709,notebook,30,60,30,1,00425,India
872125,2023-08-03,703,eraser,1,3,2,1,00108,India
872125,2023-08-03,717,spiral bound book,50,100,50,1,00108,India
872125,2023-08-03,710,geometry box,100,150,50,1,00108,India
872125,2023-08-03,709,notebook,30,60,30,1,00108,India
575558,2023-08-03,705,stencil,10,20,10,1,00157,India
941295,2023-08-03,710,geometry box,100,150,50,1,00192,India
447823,2023-08-03,703,eraser,1,3,2,1,00038,India
447823,2023-08-03,714,carbon paper,15,30,15,1,00038,India
447823,2023-08-03,707,marker,20,40,20,1,00038,India
271976,2023-08-03,708,sketchpen,15,40,25,1,00246,India
139725,2023-08-03,710,geometry box,100,150,50,1,00203,India
139725,2023-08-03,704,scale,5,10,5,1,00203,India
139725,2023-08-03,705,stencil,10,20,10,1,00203,India
139725,2023-08-03,707,marker,20,40,20,1,00203,India
139725,2023-08-03,709,notebook,30,60,30,1,00203,India
810448,2023-08-03,710,geometry box,100,150,50,1,00435,India
810448,2023-08-03,707,marker,20,40,20,1,00435,India
983998,2023-08-03,716,printing paper,200,400,200,1,00469,India
125944,2023-08-03,713,ball pen,5,10,5,1,00054,India
125944,2023-08-03,711,TD kit,150,300,150,1,00054,India
266115,2023-08-03,702,pencil,2,5,3,1,00199,India
601295,2023-08-03,705,stencil,10,20,10,1,00329,India
601295,2023-08-03,703,eraser,1,3,2,1,00329,India
218215,2023-08-03,712,graph paper,20,40,20,1,00150,India
218215,2023-08-03,702,pencil,2,5,3,1,00150,India
218215,2023-08-03,717,spiral bound book,50,100,50,1,00150,India
257338,2023-08-03,713,ball pen,5,10,5,1,00494,India
257338,2023-08-03,709,notebook,30,60,30,1,00494,India
257338,2023-08-03,712,graph paper,20,40,20,1,00494,India
257338,2023-08-03,703,eraser,1,3,2,1,00494,India
377772,2023-08-03,706,sharpener,3,8,5,1,00341,India
377772,2023-08-03,705,stencil,10,20,10,1,00341,India
377772,2023-08-03,701,gel pen,5,10,5,1,00341,India
518925,2023-08-03,702,pencil,2,5,3,1,00246,India
518925,2023-08-03,717,spiral bound book,50,100,50,1,00246,India
307524,2023-08-03,710,geometry box,100,150,50,1,00426,India
220845,2023-08-03,711,TD kit,150,300,150,1,00269,India
220845,2023-08-03,710,geometry box,100,150,50,1,00269,India
220845,2023-08-03,709,notebook,30,60,30,1,00269,India
220845,2023-08-03,704,scale,5,10,5,1,00269,India
220845,2023-08-03,717,spiral bound book,50,100,50,1,00269,India
532791,2023-08-03,710,geometry box,100,150,50,1,00163,India
532791,2023-08-03,705,stencil,10,20,10,1,00163,India
532791,2023-08-03,704,scale,5,10,5,1,00163,India
232924,2023-08-03,705,stencil,10,20,10,1,00250,India
232924,2023-08-03,710,geometry box,100,150,50,1,00250,India
232924,2023-08-03,707,marker,20,40,20,1,00250,India
388948,2023-08-03,713,ball pen,5,10,5,1,00298,India
388948,2023-08-03,711,TD kit,150,300,150,1,00298,India
388545,2023-08-03,703,eraser,1,3,2,1,00367,India
646899,2023-08-03,707,marker,20,40,20,1,00260,India
638337,2023-08-03,716,printing paper,200,400,200,1,00314,India
638337,2023-08-03,714,carbon paper,15,30,15,1,00314,India
247672,2023-08-03,703,eraser,1,3,2,1,00400,India
247672,2023-08-03,705,stencil,10,20,10,1,00400,India
247672,2023-08-03,713,ball pen,5,10,5,1,00400,India
136773,2023-08-03,714,carbon paper,15,30,15,1,00266,India
136773,2023-08-03,717,spiral bound book,50,100,50,1,00266,India
136773,2023-08-03,710,geometry box,100,150,50,1,00266,India
136773,2023-08-03,701,gel pen,5,10,5,1,00266,India
318849,2023-08-03,716,printing paper,200,400,200,1,00253,India
301422,2023-08-03,717,spiral bound book,50,100,50,1,00261,India
301422,2023-08-03,702,pencil,2,5,3,1,00261,India
141962,2023-08-03,710,geometry box,100,150,50,1,00015,India
141962,2023-08-03,701,gel pen,5,10,5,1,00015,India
141962,2023-08-03,704,scale,5,10,5,1,00015,India
141962,2023-08-03,713,ball pen,5,10,5,1,00015,India
888281,2023-08-03,712,graph paper,20,40,20,1,00496,India
888281,2023-08-03,714,carbon paper,15,30,15,1,00496,India
233727,2023-08-04,701,gel pen,5,10,5,1,00437,India
233727,2023-08-04,713,ball pen,5,10,5,1,00437,India
318691,2023-08-04,708,sketchpen,15,40,25,1,00167,India
318691,2023-08-04,713,ball pen,5,10,5,1,00167,India
318691,2023-08-04,710,geometry box,100,150,50,1,00167,India
827123,2023-08-04,715,folder,5,15,10,1,00485,India
827123,2023-08-04,704,scale,5,10,5,1,00485,India
664963,2023-08-04,701,gel pen,5,10,5,1,00296,India
664963,2023-08-04,711,TD kit,150,300,150,1,00296,India
664963,2023-08-04,702,pencil,2,5,3,1,00296,India
664963,2023-08-04,717,spiral bound book,50,100,50,1,00296,India
532421,2023-08-04,705,stencil,10,20,10,1,00032,India
532421,2023-08-04,709,notebook,30,60,30,1,00032,India
532421,2023-08-04,716,printing paper,200,400,200,1,00032,India
458310,2023-08-04,711,TD kit,150,300,150,1,00222,India
458310,2023-08-04,704,scale,5,10,5,1,00222,India
458310,2023-08-04,717,spiral bound book,50,100,50,1,00222,India
458310,2023-08-04,708,sketchpen,15,40,25,1,00222,India
986903,2023-08-04,710,geometry box,100,150,50,1,00138,India
986903,2023-08-04,702,pencil,2,5,3,1,00138,India
986903,2023-08-04,711,TD kit,150,300,150,1,00138,India
986903,2023-08-04,714,carbon paper,15,30,15,1,00138,India
193088,2023-08-04,705,stencil,10,20,10,1,00457,India
193088,2023-08-04,713,ball pen,5,10,5,1,00457,India
193088,2023-08-04,717,spiral bound book,50,100,50,1,00457,India
425242,2023-08-04,702,pencil,2,5,3,1,00233,India
425242,2023-08-04,717,spiral bound book,50,100,50,1,00233,India
672111,2023-08-04,712,graph paper,20,40,20,1,00394,India
672111,2023-08-04,714,carbon paper,15,30,15,1,00394,India
672111,2023-08-04,702,pencil,2,5,3,1,00394,India
672111,2023-08-04,715,folder,5,15,10,1,00394,India
812089,2023-08-04,713,ball pen,5,10,5,1,00238,India
812089,2023-08-04,707,marker,20,40,20,1,00238,India
812089,2023-08-04,704,scale,5,10,5,1,00238,India
225747,2023-08-04,717,spiral bound book,50,100,50,1,00472,India
225747,2023-08-04,705,stencil,10,20,10,1,00472,India
245053,2023-08-04,716,printing paper,200,400,200,1,00256,India
706511,2023-08-04,712,graph paper,20,40,20,1,00095,India
194434,2023-08-04,712,graph paper,20,40,20,1,00320,India
194434,2023-08-04,710,geometry box,100,150,50,1,00320,India
194434,2023-08-04,714,carbon paper,15,30,15,1,00320,India
665184,2023-08-04,709,notebook,30,60,30,1,00437,India
472144,2023-08-04,707,marker,20,40,20,1,00420,India
472144,2023-08-04,708,sketchpen,15,40,25,1,00420,India
472144,2023-08-04,710,geometry box,100,150,50,1,00420,India
499068,2023-08-04,706,sharpener,3,8,5,1,00267,India
499068,2023-08-04,712,graph paper,20,40,20,1,00267,India
932062,2023-08-04,714,carbon paper,15,30,15,1,00130,India
932062,2023-08-04,713,ball pen,5,10,5,1,00130,India
999509,2023-08-04,702,pencil,2,5,3,1,00221,India
999509,2023-08-04,707,marker,20,40,20,1,00221,India
999509,2023-08-04,710,geometry box,100,150,50,1,00221,India
227293,2023-08-04,712,graph paper,20,40,20,1,00261,India
227293,2023-08-04,702,pencil,2,5,3,1,00261,India
227293,2023-08-04,714,carbon paper,15,30,15,1,00261,India
227293,2023-08-04,713,ball pen,5,10,5,1,00261,India
269509,2023-08-04,705,stencil,10,20,10,1,00356,India
269509,2023-08-04,701,gel pen,5,10,5,1,00356,India
269509,2023-08-04,712,graph paper,20,40,20,1,00356,India
269509,2023-08-04,709,notebook,30,60,30,1,00356,India
269509,2023-08-04,706,sharpener,3,8,5,1,00356,India
736263,2023-08-04,714,carbon paper,15,30,15,1,00306,India
731062,2023-08-04,708,sketchpen,15,40,25,1,00004,India
731062,2023-08-04,709,notebook,30,60,30,1,00004,India
731062,2023-08-04,717,spiral bound book,50,100,50,1,00004,India
763414,2023-08-04,710,geometry box,100,150,50,1,00490,India
763414,2023-08-04,701,gel pen,5,10,5,1,00490,India
779813,2023-08-04,714,carbon paper,15,30,15,1,00271,India
314449,2023-08-04,703,eraser,1,3,2,1,00459,India
851201,2023-08-04,712,graph paper,20,40,20,1,00443,India
620661,2023-08-04,706,sharpener,3,8,5,1,00151,India
620661,2023-08-04,713,ball pen,5,10,5,1,00151,India
552395,2023-08-04,702,pencil,2,5,3,1,00168,India
552395,2023-08-04,716,printing paper,200,400,200,1,00168,India
552395,2023-08-04,701,gel pen,5,10,5,1,00168,India
140127,2023-08-04,702,pencil,2,5,3,1,00228,India
140127,2023-08-04,715,folder,5,15,10,1,00228,India
140127,2023-08-04,707,marker,20,40,20,1,00228,India
140127,2023-08-04,709,notebook,30,60,30,1,00228,India
140127,2023-08-04,717,spiral bound book,50,100,50,1,00228,India
488339,2023-08-04,708,sketchpen,15,40,25,1,00028,India
488339,2023-08-04,704,scale,5,10,5,1,00028,India
488339,2023-08-04,714,carbon paper,15,30,15,1,00028,India
542418,2023-08-04,707,marker,20,40,20,1,00359,India
542418,2023-08-04,717,spiral bound book,50,100,50,1,00359,India
542418,2023-08-04,716,printing paper,200,400,200,1,00359,India
119730,2023-08-04,713,ball pen,5,10,5,1,00051,India
119730,2023-08-04,704,scale,5,10,5,1,00051,India
119730,2023-08-04,715,folder,5,15,10,1,00051,India
955201,2023-08-04,708,sketchpen,15,40,25,1,00492,India
955201,2023-08-04,707,marker,20,40,20,1,00492,India
955201,2023-08-04,702,pencil,2,5,3,1,00492,India
955201,2023-08-04,714,carbon paper,15,30,15,1,00492,India
681029,2023-08-05,715,folder,5,15,10,1,00414,India
681029,2023-08-05,702,pencil,2,5,3,1,00414,India
681029,2023-08-05,716,printing paper,200,400,200,1,00414,India
145973,2023-08-05,712,graph paper,20,40,20,1,00325,India
145973,2023-08-05,716,printing paper,200,400,200,1,00325,India
145973,2023-08-05,709,notebook,30,60,30,1,00325,India
145973,2023-08-05,708,sketchpen,15,40,25,1,00325,India
145973,2023-08-05,717,spiral bound book,50,100,50,1,00325,India
280301,2023-08-05,707,marker,20,40,20,1,00438,India
280301,2023-08-05,702,pencil,2,5,3,1,00438,India
280301,2023-08-05,710,geometry box,100,150,50,1,00438,India
280301,2023-08-05,703,eraser,1,3,2,1,00438,India
280301,2023-08-05,709,notebook,30,60,30,1,00438,India
980249,2023-08-05,708,sketchpen,15,40,25,1,00384,India
980249,2023-08-05,709,notebook,30,60,30,1,00384,India
980249,2023-08-05,716,printing paper,200,400,200,1,00384,India
980249,2023-08-05,707,marker,20,40,20,1,00384,India
980249,2023-08-05,713,ball pen,5,10,5,1,00384,India
915391,2023-08-05,711,TD kit,150,300,150,1,00091,India
915391,2023-08-05,716,printing paper,200,400,200,1,00091,India
915391,2023-08-05,714,carbon paper,15,30,15,1,00091,India
915391,2023-08-05,705,stencil,10,20,10,1,00091,India
915391,2023-08-05,717,spiral bound book,50,100,50,1,00091,India
932674,2023-08-05,708,sketchpen,15,40,25,1,00349,India
932674,2023-08-05,704,scale,5,10,5,1,00349,India
932674,2023-08-05,701,gel pen,5,10,5,1,00349,India
129333,2023-08-05,710,geometry box,100,150,50,1,00393,India
129333,2023-08-05,711,TD kit,150,300,150,1,00393,India
129333,2023-08-05,712,graph paper,20,40,20,1,00393,India
129333,2023-08-05,716,printing paper,200,400,200,1,00393,India
706208,2023-08-05,708,sketchpen,15,40,25,1,00074,India
706208,2023-08-05,704,scale,5,10,5,1,00074,India
706208,2023-08-05,707,marker,20,40,20,1,00074,India
706208,2023-08-05,702,pencil,2,5,3,1,00074,India
689662,2023-08-05,711,TD kit,150,300,150,1,00388,India
689662,2023-08-05,702,pencil,2,5,3,1,00388,India
689662,2023-08-05,706,sharpener,3,8,5,1,00388,India
689662,2023-08-05,708,sketchpen,15,40,25,1,00388,India
689662,2023-08-05,709,notebook,30,60,30,1,00388,India
993397,2023-08-05,711,TD kit,150,300,150,1,00224,India
993397,2023-08-05,708,sketchpen,15,40,25,1,00224,India
993397,2023-08-05,705,stencil,10,20,10,1,00224,India
993397,2023-08-05,710,geometry box,100,150,50,1,00224,India
993397,2023-08-05,706,sharpener,3,8,5,1,00224,India
291679,2023-08-05,717,spiral bound book,50,100,50,1,00489,India
291679,2023-08-05,709,notebook,30,60,30,1,00489,India
291679,2023-08-05,705,stencil,10,20,10,1,00489,India
931257,2023-08-05,712,graph paper,20,40,20,1,00267,India
335717,2023-08-05,706,sharpener,3,8,5,1,00345,India
335717,2023-08-05,701,gel pen,5,10,5,1,00345,India
112342,2023-08-05,714,carbon paper,15,30,15,1,00214,India
112342,2023-08-05,713,ball pen,5,10,5,1,00214,India
835398,2023-08-05,717,spiral bound book,50,100,50,1,00062,India
422770,2023-08-05,706,sharpener,3,8,5,1,00060,India
422770,2023-08-05,712,graph paper,20,40,20,1,00060,India
147571,2023-08-05,701,gel pen,5,10,5,1,00453,India
147571,2023-08-05,716,printing paper,200,400,200,1,00453,India
136962,2023-08-05,704,scale,5,10,5,1,00302,India
136962,2023-08-05,707,marker,20,40,20,1,00302,India
136962,2023-08-05,706,sharpener,3,8,5,1,00302,India
548985,2023-08-05,714,carbon paper,15,30,15,1,00360,India
548985,2023-08-05,704,scale,5,10,5,1,00360,India
548985,2023-08-05,702,pencil,2,5,3,1,00360,India
548985,2023-08-05,703,eraser,1,3,2,1,00360,India
548985,2023-08-05,712,graph paper,20,40,20,1,00360,India
845513,2023-08-05,701,gel pen,5,10,5,1,00362,India
845513,2023-08-05,713,ball pen,5,10,5,1,00362,India
845513,2023-08-05,708,sketchpen,15,40,25,1,00362,India
497852,2023-08-05,716,printing paper,200,400,200,1,00447,India
497852,2023-08-05,706,sharpener,3,8,5,1,00447,India
497852,2023-08-05,707,marker,20,40,20,1,00447,India
496183,2023-08-05,714,carbon paper,15,30,15,1,00464,India
496183,2023-08-05,715,folder,5,15,10,1,00464,India
496183,2023-08-05,708,sketchpen,15,40,25,1,00464,India
496183,2023-08-05,712,graph paper,20,40,20,1,00464,India
496183,2023-08-05,701,gel pen,5,10,5,1,00464,India
691561,2023-08-05,716,printing paper,200,400,200,1,00329,India
813035,2023-08-05,703,eraser,1,3,2,1,00449,India
813035,2023-08-05,712,graph paper,20,40,20,1,00449,India
813035,2023-08-05,704,scale,5,10,5,1,00449,India
813035,2023-08-05,711,TD kit,150,300,150,1,00449,India
813035,2023-08-05,701,gel pen,5,10,5,1,00449,India
303869,2023-08-05,702,pencil,2,5,3,1,00436,India
303869,2023-08-05,715,folder,5,15,10,1,00436,India
757494,2023-08-05,705,stencil,10,20,10,1,00250,India
757494,2023-08-05,707,marker,20,40,20,1,00250,India
422257,2023-08-05,701,gel pen,5,10,5,1,00332,India
131123,2023-08-05,702,pencil,2,5,3,1,00212,India
847191,2023-08-05,715,folder,5,15,10,1,00332,India
847191,2023-08-05,705,stencil,10,20,10,1,00332,India
847191,2023-08-05,714,carbon paper,15,30,15,1,00332,India
847191,2023-08-05,708,sketchpen,15,40,25,1,00332,India
544639,2023-08-05,703,eraser,1,3,2,1,00320,India
544639,2023-08-05,701,gel pen,5,10,5,1,00320,India
544639,2023-08-05,704,scale,5,10,5,1,00320,India
882699,2023-08-05,707,marker,20,40,20,1,00288,India
882699,2023-08-05,715,folder,5,15,10,1,00288,India
882699,2023-08-05,706,sharpener,3,8,5,1,00288,India
882699,2023-08-05,713,ball pen,5,10,5,1,00288,India
913380,2023-08-05,712,graph paper,20,40,20,1,00322,India
913380,2023-08-05,701,gel pen,5,10,5,1,00322,India
913380,2023-08-05,702,pencil,2,5,3,1,00322,India
913380,2023-08-05,713,ball pen,5,10,5,1,00322,India
307365,2023-08-05,706,sharpener,3,8,5,1,00053,India
935879,2023-08-05,702,pencil,2,5,3,1,00481,India
935879,2023-08-05,711,TD kit,150,300,150,1,00481,India
935879,2023-08-05,712,graph paper,20,40,20,1,00481,India
935879,2023-08-05,710,geometry box,100,150,50,1,00481,India
984834,2023-08-05,702,pencil,2,5,3,1,00258,India
984834,2023-08-05,706,sharpener,3,8,5,1,00258,India
984834,2023-08-05,713,ball pen,5,10,5,1,00258,India
984834,2023-08-05,710,geometry box,100,150,50,1,00258,India
648931,2023-08-05,702,pencil,2,5,3,1,00099,India
648931,2023-08-05,701,gel pen,5,10,5,1,00099,India
648931,2023-08-05,709,notebook,30,60,30,1,00099,India
648931,2023-08-05,708,sketchpen,15,40,25,1,00099,India
103115,2023-08-05,710,geometry box,100,150,50,1,00030,India
294213,2023-08-05,712,graph paper,20,40,20,1,00016,India
294213,2023-08-05,714,carbon paper,15,30,15,1,00016,India
571213,2023-08-05,710,geometry box,100,150,50,1,00215,India
798751,2023-08-06,701,gel pen,5,10,5,1,00431,India
798751,2023-08-06,704,scale,5,10,5,1,00431,India
262548,2023-08-06,713,ball pen,5,10,5,1,00144,India
262548,2023-08-06,717,spiral bound book,50,100,50,1,00144,India
759903,2023-08-06,709,notebook,30,60,30,1,00214,India
759903,2023-08-06,702,pencil,2,5,3,1,00214,India
759903,2023-08-06,701,gel pen,5,10,5,1,00214,India
891314,2023-08-06,710,geometry box,100,150,50,1,00275,India
891314,2023-08-06,702,pencil,2,5,3,1,00275,India
447831,2023-08-06,709,notebook,30,60,30,1,00372,India
447831,2023-08-06,713,ball pen,5,10,5,1,00372,India
708337,2023-08-06,702,pencil,2,5,3,1,00078,India
708337,2023-08-06,713,ball pen,5,10,5,1,00078,India
979920,2023-08-06,706,sharpener,3,8,5,1,00367,India
979920,2023-08-06,715,folder,5,15,10,1,00367,India
979920,2023-08-06,717,spiral bound book,50,100,50,1,00367,India
979920,2023-08-06,707,marker,20,40,20,1,00367,India
979920,2023-08-06,711,TD kit,150,300,150,1,00367,India
637259,2023-08-06,707,marker,20,40,20,1,00259,India
830078,2023-08-06,711,TD kit,150,300,150,1,00181,India
830078,2023-08-06,712,graph paper,20,40,20,1,00181,India
471093,2023-08-06,714,carbon paper,15,30,15,1,00146,India
471093,2023-08-06,713,ball pen,5,10,5,1,00146,India
471093,2023-08-06,711,TD kit,150,300,150,1,00146,India
487009,2023-08-06,702,pencil,2,5,3,1,00186,India
487009,2023-08-06,711,TD kit,150,300,150,1,00186,India
486910,2023-08-06,714,carbon paper,15,30,15,1,00443,India
486910,2023-08-06,712,graph paper,20,40,20,1,00443,India
486910,2023-08-06,705,stencil,10,20,10,1,00443,India
850591,2023-08-06,705,stencil,10,20,10,1,00185,India
850591,2023-08-06,707,marker,20,40,20,1,00185,India
140780,2023-08-06,703,eraser,1,3,2,1,00102,India
140780,2023-08-06,708,sketchpen,15,40,25,1,00102,India
140780,2023-08-06,713,ball pen,5,10,5,1,00102,India
700291,2023-08-06,716,printing paper,200,400,200,1,00239,India
700291,2023-08-06,705,stencil,10,20,10,1,00239,India
700291,2023-08-06,708,sketchpen,15,40,25,1,00239,India
700291,2023-08-06,713,ball pen,5,10,5,1,00239,India
171793,2023-08-06,703,eraser,1,3,2,1,00054,India
171793,2023-08-06,701,gel pen,5,10,5,1,00054,India
171793,2023-08-06,706,sharpener,3,8,5,1,00054,India
785174,2023-08-06,709,notebook,30,60,30,1,00464,India
988606,2023-08-06,702,pencil,2,5,3,1,00070,India
988606,2023-08-06,704,scale,5,10,5,1,00070,India
988606,2023-08-06,707,marker,20,40,20,1,00070,India
950778,2023-08-06,715,folder,5,15,10,1,00392,India
950778,2023-08-06,712,graph paper,20,40,20,1,00392,India
950778,2023-08-06,707,marker,20,40,20,1,00392,India
715920,2023-08-06,703,eraser,1,3,2,1,00158,India
715920,2023-08-06,714,carbon paper,15,30,15,1,00158,India
715920,2023-08-06,711,TD kit,150,300,150,1,00158,India
655994,2023-08-06,709,notebook,30,60,30,1,00283,India
655994,2023-08-06,717,spiral bound book,50,100,50,1,00283,India
655994,2023-08-06,710,geometry box,100,150,50,1,00283,India
513251,2023-08-06,705,stencil,10,20,10,1,00311,India
513251,2023-08-06,712,graph paper,20,40,20,1,00311,India
513251,2023-08-06,706,sharpener,3,8,5,1,00311,India
838271,2023-08-06,708,sketchpen,15,40,25,1,00352,India
838271,2023-08-06,704,scale,5,10,5,1,00352,India
838271,2023-08-06,701,gel pen,5,10,5,1,00352,India
987226,2023-08-06,702,pencil,2,5,3,1,00445,India
987226,2023-08-06,709,notebook,30,60,30,1,00445,India
987226,2023-08-06,714,carbon paper,15,30,15,1,00445,India
987226,2023-08-06,713,ball pen,5,10,5,1,00445,India
987226,2023-08-06,716,printing paper,200,400,200,1,00445,India
842635,2023-08-06,709,notebook,30,60,30,1,00403,India
842635,2023-08-06,706,sharpener,3,8,5,1,00403,India
842635,2023-08-06,710,geometry box,100,150,50,1,00403,India
842635,2023-08-06,717,spiral bound book,50,100,50,1,00403,India
842635,2023-08-06,715,folder,5,15,10,1,00403,India
668711,2023-08-06,711,TD kit,150,300,150,1,00062,India
387881,2023-08-06,709,notebook,30,60,30,1,00371,India
387881,2023-08-06,705,stencil,10,20,10,1,00371,India
387881,2023-08-06,713,ball pen,5,10,5,1,00371,India
159822,2023-08-06,705,stencil,10,20,10,1,00228,India
520237,2023-08-06,704,scale,5,10,5,1,00368,India
520237,2023-08-06,710,geometry box,100,150,50,1,00368,India
520237,2023-08-06,717,spiral bound book,50,100,50,1,00368,India
520237,2023-08-06,701,gel pen,5,10,5,1,00368,India
827669,2023-08-06,702,pencil,2,5,3,1,00392,India
827669,2023-08-06,708,sketchpen,15,40,25,1,00392,India
827669,2023-08-06,712,graph paper,20,40,20,1,00392,India
827669,2023-08-06,715,folder,5,15,10,1,00392,India
663164,2023-08-06,716,printing paper,200,400,200,1,00322,India
663164,2023-08-06,710,geometry box,100,150,50,1,00322,India
663164,2023-08-06,706,sharpener,3,8,5,1,00322,India
663164,2023-08-06,703,eraser,1,3,2,1,00322,India
557477,2023-08-06,706,sharpener,3,8,5,1,00498,India
557477,2023-08-06,702,pencil,2,5,3,1,00498,India
557477,2023-08-06,707,marker,20,40,20,1,00498,India
557477,2023-08-06,709,notebook,30,60,30,1,00498,India
557477,2023-08-06,716,printing paper,200,400,200,1,00498,India
698348,2023-08-06,712,graph paper,20,40,20,1,00489,India
698348,2023-08-06,706,sharpener,3,8,5,1,00489,India
249528,2023-08-06,708,sketchpen,15,40,25,1,00163,India
249528,2023-08-06,715,folder,5,15,10,1,00163,India
249528,2023-08-06,712,graph paper,20,40,20,1,00163,India
849798,2023-08-07,715,folder,5,15,10,1,00333,India
849798,2023-08-07,705,stencil,10,20,10,1,00333,India
849798,2023-08-07,707,marker,20,40,20,1,00333,India
849798,2023-08-07,703,eraser,1,3,2,1,00333,India
342001,2023-08-07,703,eraser,1,3,2,1,00034,India
342001,2023-08-07,704,scale,5,10,5,1,00034,India
342001,2023-08-07,701,gel pen,5,10,5,1,00034,India
332861,2023-08-07,704,scale,5,10,5,1,00050,India
318186,2023-08-07,705,stencil,10,20,10,1,00259,India
840456,2023-08-07,703,eraser,1,3,2,1,00091,India
840456,2023-08-07,712,graph paper,20,40,20,1,00091,India
840456,2023-08-07,715,folder,5,15,10,1,00091,India
837299,2023-08-07,701,gel pen,5,10,5,1,00420,India
837299,2023-08-07,703,eraser,1,3,2,1,00420,India
837299,2023-08-07,716,printing paper,200,400,200,1,00420,India
837299,2023-08-07,715,folder,5,15,10,1,00420,India
368403,2023-08-07,715,folder,5,15,10,1,00454,India
368403,2023-08-07,707,marker,20,40,20,1,00454,India
368403,2023-08-07,703,eraser,1,3,2,1,00454,India
695583,2023-08-07,711,TD kit,150,300,150,1,00073,India
695583,2023-08-07,707,marker,20,40,20,1,00073,India
695583,2023-08-07,709,notebook,30,60,30,1,00073,India
695583,2023-08-07,702,pencil,2,5,3,1,00073,India
542267,2023-08-07,707,marker,20,40,20,1,00076,India
542267,2023-08-07,705,stencil,10,20,10,1,00076,India
542267,2023-08-07,716,printing paper,200,400,200,1,00076,India
133746,2023-08-07,717,spiral bound book,50,100,50,1,00389,India
133746,2023-08-07,703,eraser,1,3,2,1,00389,India
133746,2023-08-07,702,pencil,2,5,3,1,00389,India
870984,2023-08-07,714,carbon paper,15,30,15,1,00020,India
870984,2023-08-07,712,graph paper,20,40,20,1,00020,India
870984,2023-08-07,716,printing paper,200,400,200,1,00020,India
532144,2023-08-07,711,TD kit,150,300,150,1,00043,India
511971,2023-08-07,703,eraser,1,3,2,1,00410,India
511971,2023-08-07,701,gel pen,5,10,5,1,00410,India
511971,2023-08-07,713,ball pen,5,10,5,1,00410,India
511971,2023-08-07,702,pencil,2,5,3,1,00410,India
234354,2023-08-07,703,eraser,1,3,2,1,00294,India
457996,2023-08-07,703,eraser,1,3,2,1,00020,India
457996,2023-08-07,716,printing paper,200,400,200,1,00020,India
457996,2023-08-07,711,TD kit,150,300,150,1,00020,India
457996,2023-08-07,708,sketchpen,15,40,25,1,00020,India
775612,2023-08-07,717,spiral bound book,50,100,50,1,00279,India
775612,2023-08-07,706,sharpener,3,8,5,1,00279,India
621106,2023-08-07,710,geometry box,100,150,50,1,00179,India
621106,2023-08-07,714,carbon paper,15,30,15,1,00179,India
621106,2023-08-07,702,pencil,2,5,3,1,00179,India
621106,2023-08-07,711,TD kit,150,300,150,1,00179,India
312161,2023-08-07,708,sketchpen,15,40,25,1,00197,India
312161,2023-08-07,715,folder,5,15,10,1,00197,India
223636,2023-08-07,715,folder,5,15,10,1,00038,India
362590,2023-08-07,707,marker,20,40,20,1,00270,India
362590,2023-08-07,713,ball pen,5,10,5,1,00270,India
362590,2023-08-07,715,folder,5,15,10,1,00270,India
362590,2023-08-07,708,sketchpen,15,40,25,1,00270,India
177420,2023-08-07,703,eraser,1,3,2,1,00385,India
177420,2023-08-07,706,sharpener,3,8,5,1,00385,India
177420,2023-08-07,708,sketchpen,15,40,25,1,00385,India
972799,2023-08-07,706,sharpener,3,8,5,1,00134,India
972799,2023-08-07,702,pencil,2,5,3,1,00134,India
504462,2023-08-07,705,stencil,10,20,10,1,00366,India
504462,2023-08-07,712,graph paper,20,40,20,1,00366,India
504462,2023-08-07,715,folder,5,15,10,1,00366,India
504462,2023-08-07,707,marker,20,40,20,1,00366,India
104662,2023-08-07,701,gel pen,5,10,5,1,00002,India
602084,2023-08-07,711,TD kit,150,300,150,1,00005,India
398907,2023-08-07,703,eraser,1,3,2,1,00438,India
398907,2023-08-07,715,folder,5,15,10,1,00438,India
781093,2023-08-07,717,spiral bound book,50,100,50,1,00483,India
781093,2023-08-07,713,ball pen,5,10,5,1,00483,India
100093,2023-08-07,702,pencil,2,5,3,1,00001,India
100093,2023-08-07,703,eraser,1,3,2,1,00001,India
100093,2023-08-07,712,graph paper,20,40,20,1,00001,India
497450,2023-08-07,714,carbon paper,15,30,15,1,00023,India
497450,2023-08-07,709,notebook,30,60,30,1,00023,India
497450,2023-08-07,705,stencil,10,20,10,1,00023,India
497450,2023-08-07,704,scale,5,10,5,1,00023,India
200599,2023-08-07,706,sharpener,3,8,5,1,00442,India
200599,2023-08-07,710,geometry box,100,150,50,1,00442,India
384293,2023-08-07,702,pencil,2,5,3,1,00484,India
384293,2023-08-07,716,printing paper,200,400,200,1,00484,India
384293,2023-08-07,714,carbon paper,15,30,15,1,00484,India
384293,2023-08-07,713,ball pen,5,10,5,1,00484,India
949906,2023-08-07,706,sharpener,3,8,5,1,00351,India
949906,2023-08-07,701,gel pen,5,10,5,1,00351,India
949906,2023-08-07,717,spiral bound book,50,100,50,1,00351,India
949906,2023-08-07,714,carbon paper,15,30,15,1,00351,India
949906,2023-08-07,713,ball pen,5,10,5,1,00351,India
923672,2023-08-07,705,stencil,10,20,10,1,00453,India
923672,2023-08-07,708,sketchpen,15,40,25,1,00453,India
923672,2023-08-07,704,scale,5,10,5,1,00453,India
639656,2023-08-07,716,printing paper,200,400,200,1,00473,India
639656,2023-08-07,715,folder,5,15,10,1,00473,India
639656,2023-08-07,703,eraser,1,3,2,1,00473,India
718138,2023-08-07,708,sketchpen,15,40,25,1,00033,India
718138,2023-08-07,702,pencil,2,5,3,1,00033,India
718138,2023-08-07,712,graph paper,20,40,20,1,00033,India
718138,2023-08-07,716,printing paper,200,400,200,1,00033,India
718138,2023-08-07,710,geometry box,100,150,50,1,00033,India
982311,2023-08-07,717,spiral bound book,50,100,50,1,00018,India
982311,2023-08-07,713,ball pen,5,10,5,1,00018,India
690911,2023-08-07,703,eraser,1,3,2,1,00076,India
690911,2023-08-07,705,stencil,10,20,10,1,00076,India
690911,2023-08-07,709,notebook,30,60,30,1,00076,India
690911,2023-08-07,715,folder,5,15,10,1,00076,India
890649,2023-08-07,708,sketchpen,15,40,25,1,00010,India
890649,2023-08-07,701,gel pen,5,10,5,1,00010,India
890649,2023-08-07,713,ball pen,5,10,5,1,00010,India
890649,2023-08-07,709,notebook,30,60,30,1,00010,India
513937,2023-08-07,709,notebook,30,60,30,1,00459,India
513937,2023-08-07,706,sharpener,3,8,5,1,00459,India
513937,2023-08-07,713,ball pen,5,10,5,1,00459,India
406837,2023-08-07,712,graph paper,20,40,20,1,00216,India
406837,2023-08-07,711,TD kit,150,300,150,1,00216,India
413667,2023-08-07,702,pencil,2,5,3,1,00200,India
376912,2023-08-07,710,geometry box,100,150,50,1,00361,India
376912,2023-08-07,708,sketchpen,15,40,25,1,00361,India
376912,2023-08-07,711,TD kit,150,300,150,1,00361,India
376912,2023-08-07,712,graph paper,20,40,20,1,00361,India
388235,2023-08-08,707,marker,20,40,20,1,00328,India
388235,2023-08-08,703,eraser,1,3,2,1,00328,India
388235,2023-08-08,709,notebook,30,60,30,1,00328,India
388235,2023-08-08,715,folder,5,15,10,1,00328,India
248607,2023-08-08,708,sketchpen,15,40,25,1,00095,India
447296,2023-08-08,715,folder,5,15,10,1,00191,India
447296,2023-08-08,707,marker,20,40,20,1,00191,India
447296,2023-08-08,712,graph paper,20,40,20,1,00191,India
447296,2023-08-08,717,spiral bound book,50,100,50,1,00191,India
447296,2023-08-08,714,carbon paper,15,30,15,1,00191,India
762264,2023-08-08,705,stencil,10,20,10,1,00138,India
762264,2023-08-08,707,marker,20,40,20,1,00138,India
762264,2023-08-08,702,pencil,2,5,3,1,00138,India
517733,2023-08-08,717,spiral bound book,50,100,50,1,00075,India
517733,2023-08-08,715,folder,5,15,10,1,00075,India
816524,2023-08-08,710,geometry box,100,150,50,1,00136,India
699317,2023-08-08,706,sharpener,3,8,5,1,00004,India
699317,2023-08-08,707,marker,20,40,20,1,00004,India
945567,2023-08-08,706,sharpener,3,8,5,1,00425,India
945567,2023-08-08,707,marker,20,40,20,1,00425,India
945567,2023-08-08,713,ball pen,5,10,5,1,00425,India
966768,2023-08-08,703,eraser,1,3,2,1,00049,India
966768,2023-08-08,717,spiral bound book,50,100,50,1,00049,India
246164,2023-08-08,715,folder,5,15,10,1,00116,India
246164,2023-08-08,713,ball pen,5,10,5,1,00116,India
246164,2023-08-08,710,geometry box,100,150,50,1,00116,India
569474,2023-08-08,701,gel pen,5,10,5,1,00226,India
569474,2023-08-08,706,sharpener,3,8,5,1,00226,India
548402,2023-08-08,717,spiral bound book,50,100,50,1,00489,India
548402,2023-08-08,710,geometry box,100,150,50,1,00489,India
938746,2023-08-08,709,notebook,30,60,30,1,00251,India
938746,2023-08-08,703,eraser,1,3,2,1,00251,India
938746,2023-08-08,713,ball pen,5,10,5,1,00251,India
817268,2023-08-08,709,notebook,30,60,30,1,00145,India
817268,2023-08-08,705,stencil,10,20,10,1,00145,India
277816,2023-08-08,701,gel pen,5,10,5,1,00225,India
277816,2023-08-08,704,scale,5,10,5,1,00225,India
476415,2023-08-08,709,notebook,30,60,30,1,00415,India
476415,2023-08-08,710,geometry box,100,150,50,1,00415,India
476415,2023-08-08,703,eraser,1,3,2,1,00415,India
564326,2023-08-08,705,stencil,10,20,10,1,00426,India
434261,2023-08-08,716,printing paper,200,400,200,1,00354,India
434261,2023-08-08,701,gel pen,5,10,5,1,00354,India
434261,2023-08-08,717,spiral bound book,50,100,50,1,00354,India
197549,2023-08-08,704,scale,5,10,5,1,00106,India
197549,2023-08-08,706,sharpener,3,8,5,1,00106,India
197549,2023-08-08,709,notebook,30,60,30,1,00106,India
404954,2023-08-08,713,ball pen,5,10,5,1,00320,India
404954,2023-08-08,706,sharpener,3,8,5,1,00320,India
404954,2023-08-08,714,carbon paper,15,30,15,1,00320,India
597171,2023-08-08,716,printing paper,200,400,200,1,00351,India
597171,2023-08-08,704,scale,5,10,5,1,00351,India
597171,2023-08-08,702,pencil,2,5,3,1,00351,India
597171,2023-08-08,709,notebook,30,60,30,1,00351,India
756140,2023-08-08,712,graph paper,20,40,20,1,00241,India
756140,2023-08-08,708,sketchpen,15,40,25,1,00241,India
756140,2023-08-08,711,TD kit,150,300,150,1,00241,India
280992,2023-08-08,716,printing paper,200,400,200,1,00428,India
258080,2023-08-08,703,eraser,1,3,2,1,00038,India
258080,2023-08-08,705,stencil,10,20,10,1,00038,India
258080,2023-08-08,701,gel pen,5,10,5,1,00038,India
708293,2023-08-08,712,graph paper,20,40,20,1,00018,India
708293,2023-08-08,706,sharpener,3,8,5,1,00018,India
708293,2023-08-08,702,pencil,2,5,3,1,00018,India
708293,2023-08-08,705,stencil,10,20,10,1,00018,India
380358,2023-08-08,702,pencil,2,5,3,1,00349,India
380358,2023-08-08,709,notebook,30,60,30,1,00349,India
380358,2023-08-08,717,spiral bound book,50,100,50,1,00349,India
380358,2023-08-08,701,gel pen,5,10,5,1,00349,India
924447,2023-08-08,703,eraser,1,3,2,1,00267,India
924447,2023-08-08,710,geometry box,100,150,50,1,00267,India
924447,2023-08-08,715,folder,5,15,10,1,00267,India
924447,2023-08-08,709,notebook,30,60,30,1,00267,India
924447,2023-08-08,704,scale,5,10,5,1,00267,India
220886,2023-08-08,708,sketchpen,15,40,25,1,00381,India
220886,2023-08-08,705,stencil,10,20,10,1,00381,India
220886,2023-08-08,711,TD kit,150,300,150,1,00381,India
486523,2023-08-08,713,ball pen,5,10,5,1,00492,India
231654,2023-08-08,714,carbon paper,15,30,15,1,00232,India
231654,2023-08-08,701,gel pen,5,10,5,1,00232,India
231654,2023-08-08,703,eraser,1,3,2,1,00232,India
231654,2023-08-08,712,graph paper,20,40,20,1,00232,India
231654,2023-08-08,715,folder,5,15,10,1,00232,India
501783,2023-08-08,712,graph paper,20,40,20,1,00087,India
501783,2023-08-08,716,printing paper,200,400,200,1,00087,India
501783,2023-08-08,715,folder,5,15,10,1,00087,India
422423,2023-08-08,717,spiral bound book,50,100,50,1,00485,India
422423,2023-08-08,714,carbon paper,15,30,15,1,00485,India
422423,2023-08-08,712,graph paper,20,40,20,1,00485,India
555259,2023-08-08,707,marker,20,40,20,1,00098,India
801165,2023-08-08,704,scale,5,10,5,1,00117,India
169172,2023-08-08,706,sharpener,3,8,5,1,00286,India
137163,2023-08-08,714,carbon paper,15,30,15,1,00479,India
137163,2023-08-08,703,eraser,1,3,2,1,00479,India
137163,2023-08-08,705,stencil,10,20,10,1,00479,India
137163,2023-08-08,711,TD kit,150,300,150,1,00479,India
281606,2023-08-08,702,pencil,2,5,3,1,00145,India
839924,2023-08-08,703,eraser,1,3,2,1,00235,India
839924,2023-08-08,701,gel pen,5,10,5,1,00235,India
839924,2023-08-08,716,printing paper,200,400,200,1,00235,India
839924,2023-08-08,712,graph paper,20,40,20,1,00235,India
771381,2023-08-08,701,gel pen,5,10,5,1,00067,India
771381,2023-08-08,709,notebook,30,60,30,1,00067,India
771381,2023-08-08,717,spiral bound book,50,100,50,1,00067,India
771381,2023-08-08,707,marker,20,40,20,1,00067,India
920197,2023-08-08,716,printing paper,200,400,200,1,00345,India
920197,2023-08-08,707,marker,20,40,20,1,00345,India
920197,2023-08-08,704,scale,5,10,5,1,00345,India
920197,2023-08-08,706,sharpener,3,8,5,1,00345,India
873808,2023-08-08,713,ball pen,5,10,5,1,00008,India
873808,2023-08-08,716,printing paper,200,400,200,1,00008,India
617436,2023-08-08,705,stencil,10,20,10,1,00217,India
820163,2023-08-08,706,sharpener,3,8,5,1,00117,India
820163,2023-08-08,717,spiral bound book,50,100,50,1,00117,India
820163,2023-08-08,713,ball pen,5,10,5,1,00117,India
165372,2023-08-08,701,gel pen,5,10,5,1,00169,India
514870,2023-08-08,714,carbon paper,15,30,15,1,00071,India
548300,2023-08-08,703,eraser,1,3,2,1,00204,India
548300,2023-08-08,711,TD kit,150,300,150,1,00204,India
548300,2023-08-08,708,sketchpen,15,40,25,1,00204,India
195360,2023-08-09,701,gel pen,5,10,5,1,00153,India
195360,2023-08-09,713,ball pen,5,10,5,1,00153,India
195360,2023-08-09,706,sharpener,3,8,5,1,00153,India
195360,2023-08-09,712,graph paper,20,40,20,1,00153,India
195360,2023-08-09,704,scale,5,10,5,1,00153,India
593565,2023-08-09,705,stencil,10,20,10,1,00298,India
593565,2023-08-09,715,folder,5,15,10,1,00298,India
326350,2023-08-09,708,sketchpen,15,40,25,1,00247,India
326350,2023-08-09,712,graph paper,20,40,20,1,00247,India
326350,2023-08-09,714,carbon paper,15,30,15,1,00247,India
508458,2023-08-09,712,graph paper,20,40,20,1,00310,India
508458,2023-08-09,713,ball pen,5,10,5,1,00310,India
508458,2023-08-09,709,notebook,30,60,30,1,00310,India
508458,2023-08-09,704,scale,5,10,5,1,00310,India
381361,2023-08-09,702,pencil,2,5,3,1,00404,India
381361,2023-08-09,716,printing paper,200,400,200,1,00404,India
186114,2023-08-09,705,stencil,10,20,10,1,00193,India
186114,2023-08-09,709,notebook,30,60,30,1,00193,India
186114,2023-08-09,707,marker,20,40,20,1,00193,India
186114,2023-08-09,713,ball pen,5,10,5,1,00193,India
204547,2023-08-09,713,ball pen,5,10,5,1,00184,India
568836,2023-08-09,705,stencil,10,20,10,1,00304,India
568836,2023-08-09,714,carbon paper,15,30,15,1,00304,India
568836,2023-08-09,712,graph paper,20,40,20,1,00304,India
568836,2023-08-09,703,eraser,1,3,2,1,00304,India
712851,2023-08-09,706,sharpener,3,8,5,1,00302,India
712851,2023-08-09,703,eraser,1,3,2,1,00302,India
382937,2023-08-09,702,pencil,2,5,3,1,00354,India
382937,2023-08-09,712,graph paper,20,40,20,1,00354,India
382937,2023-08-09,708,sketchpen,15,40,25,1,00354,India
307587,2023-08-09,705,stencil,10,20,10,1,00428,India
307587,2023-08-09,713,ball pen,5,10,5,1,00428,India
307587,2023-08-09,716,printing paper,200,400,200,1,00428,India
307587,2023-08-09,706,sharpener,3,8,5,1,00428,India
557815,2023-08-09,710,geometry box,100,150,50,1,00240,India
557815,2023-08-09,715,folder,5,15,10,1,00240,India
557815,2023-08-09,702,pencil,2,5,3,1,00240,India
254501,2023-08-09,709,notebook,30,60,30,1,00286,India
254501,2023-08-09,711,TD kit,150,300,150,1,00286,India
992974,2023-08-09,703,eraser,1,3,2,1,00191,India
992974,2023-08-09,715,folder,5,15,10,1,00191,India
992974,2023-08-09,710,geometry box,100,150,50,1,00191,India
992974,2023-08-09,706,sharpener,3,8,5,1,00191,India
992974,2023-08-09,708,sketchpen,15,40,25,1,00191,India
482242,2023-08-09,713,ball pen,5,10,5,1,00344,India
482242,2023-08-09,707,marker,20,40,20,1,00344,India
482242,2023-08-09,714,carbon paper,15,30,15,1,00344,India
409401,2023-08-09,716,printing paper,200,400,200,1,00092,India
409401,2023-08-09,711,TD kit,150,300,150,1,00092,India
409401,2023-08-09,709,notebook,30,60,30,1,00092,India
409401,2023-08-09,708,sketchpen,15,40,25,1,00092,India
370689,2023-08-09,707,marker,20,40,20,1,00462,India
760439,2023-08-09,711,TD kit,150,300,150,1,00377,India
445843,2023-08-09,715,folder,5,15,10,1,00281,India
144293,2023-08-09,707,marker,20,40,20,1,00087,India
144293,2023-08-09,711,TD kit,150,300,150,1,00087,India
144293,2023-08-09,706,sharpener,3,8,5,1,00087,India
144293,2023-08-09,715,folder,5,15,10,1,00087,India
934848,2023-08-09,713,ball pen,5,10,5,1,00145,India
934848,2023-08-09,717,spiral bound book,50,100,50,1,00145,India
934848,2023-08-09,711,TD kit,150,300,150,1,00145,India
934848,2023-08-09,715,folder,5,15,10,1,00145,India
189104,2023-08-09,714,carbon paper,15,30,15,1,00133,India
189104,2023-08-09,717,spiral bound book,50,100,50,1,00133,India
189104,2023-08-09,706,sharpener,3,8,5,1,00133,India
189104,2023-08-09,705,stencil,10,20,10,1,00133,India
144641,2023-08-09,714,carbon paper,15,30,15,1,00288,India
144641,2023-08-09,708,sketchpen,15,40,25,1,00288,India
345602,2023-08-09,703,eraser,1,3,2,1,00265,India
345602,2023-08-09,715,folder,5,15,10,1,00265,India
345602,2023-08-09,701,gel pen,5,10,5,1,00265,India
404520,2023-08-09,708,sketchpen,15,40,25,1,00408,India
404520,2023-08-09,706,sharpener,3,8,5,1,00408,India
268162,2023-08-09,717,spiral bound book,50,100,50,1,00475,India
268162,2023-08-09,707,marker,20,40,20,1,00475,India
268162,2023-08-09,702,pencil,2,5,3,1,00475,India
268162,2023-08-09,705,stencil,10,20,10,1,00475,India
434261,2023-08-09,710,geometry box,100,150,50,1,00354,India
434261,2023-08-09,713,ball pen,5,10,5,1,00354,India
434261,2023-08-09,714,carbon paper,15,30,15,1,00354,India
434261,2023-08-09,709,notebook,30,60,30,1,00354,India
434261,2023-08-09,701,gel pen,5,10,5,1,00354,India
461101,2023-08-09,705,stencil,10,20,10,1,00260,India
461101,2023-08-09,706,sharpener,3,8,5,1,00260,India
461101,2023-08-09,712,graph paper,20,40,20,1,00260,India
128387,2023-08-09,711,TD kit,150,300,150,1,00033,India
128387,2023-08-09,714,carbon paper,15,30,15,1,00033,India
128387,2023-08-09,705,stencil,10,20,10,1,00033,India
350771,2023-08-09,712,graph paper,20,40,20,1,00298,India
350771,2023-08-09,704,scale,5,10,5,1,00298,India
350771,2023-08-09,701,gel pen,5,10,5,1,00298,India
350771,2023-08-09,708,sketchpen,15,40,25,1,00298,India
350771,2023-08-09,716,printing paper,200,400,200,1,00298,India
319737,2023-08-09,703,eraser,1,3,2,1,00245,India
319737,2023-08-09,710,geometry box,100,150,50,1,00245,India
474948,2023-08-09,715,folder,5,15,10,1,00110,India
474948,2023-08-09,708,sketchpen,15,40,25,1,00110,India
474948,2023-08-09,704,scale,5,10,5,1,00110,India
474948,2023-08-09,710,geometry box,100,150,50,1,00110,India
474948,2023-08-09,706,sharpener,3,8,5,1,00110,India
311682,2023-08-09,703,eraser,1,3,2,1,00117,India
365843,2023-08-09,714,carbon paper,15,30,15,1,00302,India
365843,2023-08-09,705,stencil,10,20,10,1,00302,India
897759,2023-08-09,711,TD kit,150,300,150,1,00445,India
897759,2023-08-09,709,notebook,30,60,30,1,00445,India
958454,2023-08-09,704,scale,5,10,5,1,00472,India
958454,2023-08-09,713,ball pen,5,10,5,1,00472,India
958454,2023-08-09,710,geometry box,100,150,50,1,00472,India
404671,2023-08-09,716,printing paper,200,400,200,1,00393,India
404671,2023-08-09,717,spiral bound book,50,100,50,1,00393,India
404671,2023-08-09,712,graph paper,20,40,20,1,00393,India
404671,2023-08-09,715,folder,5,15,10,1,00393,India
404671,2023-08-09,706,sharpener,3,8,5,1,00393,India
367910,2023-08-09,711,TD kit,150,300,150,1,00245,India
367910,2023-08-09,714,carbon paper,15,30,15,1,00245,India
367910,2023-08-09,706,sharpener,3,8,5,1,00245,India
367910,2023-08-09,703,eraser,1,3,2,1,00245,India
396986,2023-08-09,703,eraser,1,3,2,1,00466,India
106803,2023-08-09,702,pencil,2,5,3,1,00305,India
106803,2023-08-09,711,TD kit,150,300,150,1,00305,India
106803,2023-08-09,712,graph paper,20,40,20,1,00305,India
106803,2023-08-09,703,eraser,1,3,2,1,00305,India
867348,2023-08-09,716,printing paper,200,400,200,1,00206,India
630913,2023-08-09,710,geometry box,100,150,50,1,00201,India
630913,2023-08-09,703,eraser,1,3,2,1,00201,India
630913,2023-08-09,706,sharpener,3,8,5,1,00201,India
852968,2023-08-09,706,sharpener,3,8,5,1,00475,India
852968,2023-08-09,712,graph paper,20,40,20,1,00475,India
852968,2023-08-09,708,sketchpen,15,40,25,1,00475,India
852968,2023-08-09,717,spiral bound book,50,100,50,1,00475,India
730327,2023-08-09,702,pencil,2,5,3,1,00003,India
730327,2023-08-09,704,scale,5,10,5,1,00003,India
730327,2023-08-09,703,eraser,1,3,2,1,00003,India
953510,2023-08-09,713,ball pen,5,10,5,1,00462,India
953510,2023-08-09,707,marker,20,40,20,1,00462,India
953510,2023-08-09,712,graph paper,20,40,20,1,00462,India
504675,2023-08-10,715,folder,5,15,10,1,00128,India
762091,2023-08-10,712,graph paper,20,40,20,1,00292,India
762091,2023-08-10,709,notebook,30,60,30,1,00292,India
762091,2023-08-10,716,printing paper,200,400,200,1,00292,India
762091,2023-08-10,713,ball pen,5,10,5,1,00292,India
762091,2023-08-10,706,sharpener,3,8,5,1,00292,India
606534,2023-08-10,702,pencil,2,5,3,1,00247,India
606534,2023-08-10,705,stencil,10,20,10,1,00247,India
606534,2023-08-10,707,marker,20,40,20,1,00247,India
282188,2023-08-10,713,ball pen,5,10,5,1,00418,India
282188,2023-08-10,703,eraser,1,3,2,1,00418,India
282188,2023-08-10,716,printing paper,200,400,200,1,00418,India
501055,2023-08-10,701,gel pen,5,10,5,1,00207,India
501055,2023-08-10,709,notebook,30,60,30,1,00207,India
501055,2023-08-10,712,graph paper,20,40,20,1,00207,India
501055,2023-08-10,716,printing paper,200,400,200,1,00207,India
501055,2023-08-10,710,geometry box,100,150,50,1,00207,India
430341,2023-08-10,710,geometry box,100,150,50,1,00207,India
430341,2023-08-10,711,TD kit,150,300,150,1,00207,India
410945,2023-08-10,705,stencil,10,20,10,1,00373,India
410945,2023-08-10,715,folder,5,15,10,1,00373,India
635562,2023-08-10,704,scale,5,10,5,1,00247,India
635562,2023-08-10,705,stencil,10,20,10,1,00247,India
983501,2023-08-10,707,marker,20,40,20,1,00464,India
594998,2023-08-10,714,carbon paper,15,30,15,1,00402,India
594998,2023-08-10,715,folder,5,15,10,1,00402,India
594998,2023-08-10,703,eraser,1,3,2,1,00402,India
712749,2023-08-10,713,ball pen,5,10,5,1,00148,India
712749,2023-08-10,715,folder,5,15,10,1,00148,India
712749,2023-08-10,711,TD kit,150,300,150,1,00148,India
686446,2023-08-10,709,notebook,30,60,30,1,00341,India
686446,2023-08-10,704,scale,5,10,5,1,00341,India
686446,2023-08-10,717,spiral bound book,50,100,50,1,00341,India
285182,2023-08-10,708,sketchpen,15,40,25,1,00174,India
147889,2023-08-10,702,pencil,2,5,3,1,00051,India
147889,2023-08-10,710,geometry box,100,150,50,1,00051,India
147889,2023-08-10,709,notebook,30,60,30,1,00051,India
147889,2023-08-10,712,graph paper,20,40,20,1,00051,India
192672,2023-08-10,715,folder,5,15,10,1,00341,India
192672,2023-08-10,711,TD kit,150,300,150,1,00341,India
192672,2023-08-10,710,geometry box,100,150,50,1,00341,India
192672,2023-08-10,707,marker,20,40,20,1,00341,India
905525,2023-08-10,713,ball pen,5,10,5,1,00084,India
905525,2023-08-10,710,geometry box,100,150,50,1,00084,India
905525,2023-08-10,714,carbon paper,15,30,15,1,00084,India
905525,2023-08-10,704,scale,5,10,5,1,00084,India
905525,2023-08-10,711,TD kit,150,300,150,1,00084,India
359108,2023-08-10,713,ball pen,5,10,5,1,00085,India
359108,2023-08-10,714,carbon paper,15,30,15,1,00085,India
359108,2023-08-10,709,notebook,30,60,30,1,00085,India
675994,2023-08-10,707,marker,20,40,20,1,00201,India
675994,2023-08-10,709,notebook,30,60,30,1,00201,India
675994,2023-08-10,703,eraser,1,3,2,1,00201,India
512481,2023-08-10,715,folder,5,15,10,1,00378,India
512481,2023-08-10,702,pencil,2,5,3,1,00378,India
512481,2023-08-10,710,geometry box,100,150,50,1,00378,India
512481,2023-08-10,713,ball pen,5,10,5,1,00378,India
512481,2023-08-10,716,printing paper,200,400,200,1,00378,India
761835,2023-08-10,710,geometry box,100,150,50,1,00074,India
174724,2023-08-10,710,geometry box,100,150,50,1,00043,India
753242,2023-08-10,706,sharpener,3,8,5,1,00102,India
753242,2023-08-10,702,pencil,2,5,3,1,00102,India
661392,2023-08-10,715,folder,5,15,10,1,00389,India
661392,2023-08-10,714,carbon paper,15,30,15,1,00389,India
661392,2023-08-10,710,geometry box,100,150,50,1,00389,India
661392,2023-08-10,717,spiral bound book,50,100,50,1,00389,India
661392,2023-08-10,716,printing paper,200,400,200,1,00389,India
734767,2023-08-10,708,sketchpen,15,40,25,1,00220,India
734767,2023-08-10,712,graph paper,20,40,20,1,00220,India
990636,2023-08-10,708,sketchpen,15,40,25,1,00458,India
724479,2023-08-10,715,folder,5,15,10,1,00201,India
715073,2023-08-10,713,ball pen,5,10,5,1,00276,India
715073,2023-08-10,717,spiral bound book,50,100,50,1,00276,India
456785,2023-08-10,701,gel pen,5,10,5,1,00036,India
456785,2023-08-10,715,folder,5,15,10,1,00036,India
881241,2023-08-10,714,carbon paper,15,30,15,1,00400,India
881241,2023-08-10,715,folder,5,15,10,1,00400,India
699791,2023-08-10,702,pencil,2,5,3,1,00293,India
699791,2023-08-10,706,sharpener,3,8,5,1,00293,India
971851,2023-08-10,709,notebook,30,60,30,1,00121,India
620851,2023-08-10,701,gel pen,5,10,5,1,00301,India
620851,2023-08-10,717,spiral bound book,50,100,50,1,00301,India
620851,2023-08-10,715,folder,5,15,10,1,00301,India
620851,2023-08-10,716,printing paper,200,400,200,1,00301,India
676091,2023-08-10,713,ball pen,5,10,5,1,00195,India
676091,2023-08-10,709,notebook,30,60,30,1,00195,India
650988,2023-08-10,711,TD kit,150,300,150,1,00208,India
650988,2023-08-10,703,eraser,1,3,2,1,00208,India
650988,2023-08-10,712,graph paper,20,40,20,1,00208,India
650988,2023-08-10,714,carbon paper,15,30,15,1,00208,India
134904,2023-08-10,702,pencil,2,5,3,1,00377,India
456883,2023-08-10,703,eraser,1,3,2,1,00006,India
456883,2023-08-10,708,sketchpen,15,40,25,1,00006,India
456883,2023-08-10,702,pencil,2,5,3,1,00006,India
845096,2023-08-10,708,sketchpen,15,40,25,1,00244,India
845096,2023-08-10,702,pencil,2,5,3,1,00244,India
845096,2023-08-10,715,folder,5,15,10,1,00244,India
845096,2023-08-10,716,printing paper,200,400,200,1,00244,India
225685,2023-08-10,706,sharpener,3,8,5,1,00047,India
225685,2023-08-10,710,geometry box,100,150,50,1,00047,India
182023,2023-08-10,708,sketchpen,15,40,25,1,00133,India
182023,2023-08-10,712,graph paper,20,40,20,1,00133,India
506775,2023-08-10,715,folder,5,15,10,1,00331,India
608857,2023-08-10,710,geometry box,100,150,50,1,00237,India
804555,2023-08-10,711,TD kit,150,300,150,1,00256,India
804555,2023-08-10,701,gel pen,5,10,5,1,00256,India
804555,2023-08-10,709,notebook,30,60,30,1,00256,India
177510,2023-08-10,717,spiral bound book,50,100,50,1,00297,India
177510,2023-08-10,715,folder,5,15,10,1,00297,India
177510,2023-08-10,716,printing paper,200,400,200,1,00297,India
766395,2023-08-10,709,notebook,30,60,30,1,00332,India
192800,2023-08-10,717,spiral bound book,50,100,50,1,00337,India
192800,2023-08-10,708,sketchpen,15,40,25,1,00337,India
130450,2023-08-10,705,stencil,10,20,10,1,00253,India
374762,2023-08-10,705,stencil,10,20,10,1,00303,India
374762,2023-08-10,709,notebook,30,60,30,1,00303,India
374762,2023-08-10,713,ball pen,5,10,5,1,00303,India
374762,2023-08-10,716,printing paper,200,400,200,1,00303,India
781987,2023-08-10,715,folder,5,15,10,1,00172,India
781987,2023-08-10,707,marker,20,40,20,1,00172,India
781987,2023-08-10,710,geometry box,100,150,50,1,00172,India
781987,2023-08-10,716,printing paper,200,400,200,1,00172,India
257406,2023-08-10,710,geometry box,100,150,50,1,00066,India
523303,2023-08-11,701,gel pen,5,10,5,1,00216,India
956605,2023-08-11,708,sketchpen,15,40,25,1,00230,India
956605,2023-08-11,701,gel pen,5,10,5,1,00230,India
409500,2023-08-11,706,sharpener,3,8,5,1,00100,India
838382,2023-08-11,715,folder,5,15,10,1,00488,India
838382,2023-08-11,704,scale,5,10,5,1,00488,India
838382,2023-08-11,703,eraser,1,3,2,1,00488,India
529546,2023-08-11,709,notebook,30,60,30,1,00099,India
529546,2023-08-11,711,TD kit,150,300,150,1,00099,India
529546,2023-08-11,717,spiral bound book,50,100,50,1,00099,India
848842,2023-08-11,715,folder,5,15,10,1,00122,India
848842,2023-08-11,714,carbon paper,15,30,15,1,00122,India
668443,2023-08-11,701,gel pen,5,10,5,1,00421,India
668443,2023-08-11,706,sharpener,3,8,5,1,00421,India
668443,2023-08-11,709,notebook,30,60,30,1,00421,India
668443,2023-08-11,710,geometry box,100,150,50,1,00421,India
668443,2023-08-11,702,pencil,2,5,3,1,00421,India
862625,2023-08-11,707,marker,20,40,20,1,00044,India
862625,2023-08-11,717,spiral bound book,50,100,50,1,00044,India
862625,2023-08-11,701,gel pen,5,10,5,1,00044,India
432494,2023-08-11,712,graph paper,20,40,20,1,00019,India
432494,2023-08-11,709,notebook,30,60,30,1,00019,India
432494,2023-08-11,704,scale,5,10,5,1,00019,India
432494,2023-08-11,705,stencil,10,20,10,1,00019,India
163346,2023-08-11,715,folder,5,15,10,1,00137,India
163346,2023-08-11,713,ball pen,5,10,5,1,00137,India
163346,2023-08-11,711,TD kit,150,300,150,1,00137,India
163346,2023-08-11,714,carbon paper,15,30,15,1,00137,India
163346,2023-08-11,702,pencil,2,5,3,1,00137,India
129454,2023-08-11,711,TD kit,150,300,150,1,00293,India
129454,2023-08-11,701,gel pen,5,10,5,1,00293,India
129454,2023-08-11,717,spiral bound book,50,100,50,1,00293,India
129454,2023-08-11,716,printing paper,200,400,200,1,00293,India
274148,2023-08-11,716,printing paper,200,400,200,1,00335,India
274148,2023-08-11,711,TD kit,150,300,150,1,00335,India
274148,2023-08-11,703,eraser,1,3,2,1,00335,India
141881,2023-08-11,710,geometry box,100,150,50,1,00422,India
141881,2023-08-11,715,folder,5,15,10,1,00422,India
634263,2023-08-11,710,geometry box,100,150,50,1,00204,India
634263,2023-08-11,702,pencil,2,5,3,1,00204,India
987003,2023-08-11,709,notebook,30,60,30,1,00450,India
987003,2023-08-11,704,scale,5,10,5,1,00450,India
987003,2023-08-11,715,folder,5,15,10,1,00450,India
987003,2023-08-11,702,pencil,2,5,3,1,00450,India
987003,2023-08-11,703,eraser,1,3,2,1,00450,India
401747,2023-08-11,710,geometry box,100,150,50,1,00002,India
497804,2023-08-11,715,folder,5,15,10,1,00158,India
745172,2023-08-11,705,stencil,10,20,10,1,00405,India
745172,2023-08-11,710,geometry box,100,150,50,1,00405,India
745172,2023-08-11,715,folder,5,15,10,1,00405,India
745172,2023-08-11,712,graph paper,20,40,20,1,00405,India
114882,2023-08-11,714,carbon paper,15,30,15,1,00414,India
114882,2023-08-11,701,gel pen,5,10,5,1,00414,India
114882,2023-08-11,707,marker,20,40,20,1,00414,India
750244,2023-08-11,713,ball pen,5,10,5,1,00272,India
391063,2023-08-11,715,folder,5,15,10,1,00401,India
391063,2023-08-11,710,geometry box,100,150,50,1,00401,India
931341,2023-08-11,701,gel pen,5,10,5,1,00120,India
931341,2023-08-11,715,folder,5,15,10,1,00120,India
931341,2023-08-11,716,printing paper,200,400,200,1,00120,India
962651,2023-08-11,711,TD kit,150,300,150,1,00111,India
962651,2023-08-11,702,pencil,2,5,3,1,00111,India
962651,2023-08-11,708,sketchpen,15,40,25,1,00111,India
962651,2023-08-11,701,gel pen,5,10,5,1,00111,India
708235,2023-08-11,704,scale,5,10,5,1,00061,India
672155,2023-08-11,703,eraser,1,3,2,1,00097,India
223506,2023-08-11,715,folder,5,15,10,1,00460,India
223506,2023-08-11,713,ball pen,5,10,5,1,00460,India
605595,2023-08-11,712,graph paper,20,40,20,1,00369,India
862380,2023-08-11,712,graph paper,20,40,20,1,00403,India
862380,2023-08-11,710,geometry box,100,150,50,1,00403,India
862380,2023-08-11,707,marker,20,40,20,1,00403,India
388135,2023-08-11,714,carbon paper,15,30,15,1,00284,India
388135,2023-08-11,708,sketchpen,15,40,25,1,00284,India
388135,2023-08-11,701,gel pen,5,10,5,1,00284,India
319523,2023-08-11,710,geometry box,100,150,50,1,00437,India
319523,2023-08-11,706,sharpener,3,8,5,1,00437,India
319523,2023-08-11,711,TD kit,150,300,150,1,00437,India
154921,2023-08-11,713,ball pen,5,10,5,1,00023,India
154921,2023-08-11,702,pencil,2,5,3,1,00023,India
339194,2023-08-11,708,sketchpen,15,40,25,1,00183,India
339194,2023-08-11,703,eraser,1,3,2,1,00183,India
665595,2023-08-11,716,printing paper,200,400,200,1,00105,India
665595,2023-08-11,703,eraser,1,3,2,1,00105,India
665595,2023-08-11,712,graph paper,20,40,20,1,00105,India
740882,2023-08-11,701,gel pen,5,10,5,1,00308,India
740882,2023-08-11,711,TD kit,150,300,150,1,00308,India
740882,2023-08-11,705,stencil,10,20,10,1,00308,India
740882,2023-08-11,709,notebook,30,60,30,1,00308,India
512160,2023-08-11,711,TD kit,150,300,150,1,00288,India
512160,2023-08-11,701,gel pen,5,10,5,1,00288,India
380234,2023-08-11,702,pencil,2,5,3,1,00262,India
909177,2023-08-11,708,sketchpen,15,40,25,1,00246,India
909177,2023-08-11,706,sharpener,3,8,5,1,00246,India
932061,2023-08-11,705,stencil,10,20,10,1,00277,India
932061,2023-08-11,713,ball pen,5,10,5,1,00277,India
932061,2023-08-11,701,gel pen,5,10,5,1,00277,India
932061,2023-08-11,706,sharpener,3,8,5,1,00277,India
699893,2023-08-11,710,geometry box,100,150,50,1,00119,India
699893,2023-08-11,716,printing paper,200,400,200,1,00119,India
699893,2023-08-11,711,TD kit,150,300,150,1,00119,India
699893,2023-08-11,705,stencil,10,20,10,1,00119,India
699893,2023-08-11,709,notebook,30,60,30,1,00119,India
488967,2023-08-11,714,carbon paper,15,30,15,1,00498,India
161078,2023-08-11,717,spiral bound book,50,100,50,1,00156,India
738479,2023-08-11,716,printing paper,200,400,200,1,00154,India
311326,2023-08-11,715,folder,5,15,10,1,00465,India
311326,2023-08-11,713,ball pen,5,10,5,1,00465,India
311326,2023-08-11,710,geometry box,100,150,50,1,00465,India
256252,2023-08-11,712,graph paper,20,40,20,1,00406,India
256252,2023-08-11,708,sketchpen,15,40,25,1,00406,India
256252,2023-08-11,713,ball pen,5,10,5,1,00406,India
982518,2023-08-12,702,pencil,2,5,3,1,00174,India
982518,2023-08-12,708,sketchpen,15,40,25,1,00174,India
982518,2023-08-12,713,ball pen,5,10,5,1,00174,India
276776,2023-08-12,709,notebook,30,60,30,1,00003,India
276776,2023-08-12,702,pencil,2,5,3,1,00003,India
276776,2023-08-12,716,printing paper,200,400,200,1,00003,India
481244,2023-08-12,709,notebook,30,60,30,1,00104,India
711232,2023-08-12,703,eraser,1,3,2,1,00090,India
711232,2023-08-12,715,folder,5,15,10,1,00090,India
868929,2023-08-12,704,scale,5,10,5,1,00311,India
868929,2023-08-12,707,marker,20,40,20,1,00311,India
868929,2023-08-12,701,gel pen,5,10,5,1,00311,India
868929,2023-08-12,708,sketchpen,15,40,25,1,00311,India
410423,2023-08-12,709,notebook,30,60,30,1,00148,India
410423,2023-08-12,705,stencil,10,20,10,1,00148,India
410423,2023-08-12,701,gel pen,5,10,5,1,00148,India
410423,2023-08-12,713,ball pen,5,10,5,1,00148,India
410423,2023-08-12,703,eraser,1,3,2,1,00148,India
886786,2023-08-12,714,carbon paper,15,30,15,1,00147,India
886786,2023-08-12,705,stencil,10,20,10,1,00147,India
886786,2023-08-12,708,sketchpen,15,40,25,1,00147,India
573488,2023-08-12,717,spiral bound book,50,100,50,1,00174,India
827522,2023-08-12,708,sketchpen,15,40,25,1,00363,India
827522,2023-08-12,711,TD kit,150,300,150,1,00363,India
698929,2023-08-12,706,sharpener,3,8,5,1,00226,India
698929,2023-08-12,713,ball pen,5,10,5,1,00226,India
698929,2023-08-12,707,marker,20,40,20,1,00226,India
643571,2023-08-12,717,spiral bound book,50,100,50,1,00118,India
643571,2023-08-12,703,eraser,1,3,2,1,00118,India
382442,2023-08-12,709,notebook,30,60,30,1,00066,India
382442,2023-08-12,710,geometry box,100,150,50,1,00066,India
919729,2023-08-12,703,eraser,1,3,2,1,00042,India
919729,2023-08-12,701,gel pen,5,10,5,1,00042,India
919729,2023-08-12,717,spiral bound book,50,100,50,1,00042,India
919729,2023-08-12,705,stencil,10,20,10,1,00042,India
764725,2023-08-12,713,ball pen,5,10,5,1,00082,India
764725,2023-08-12,705,stencil,10,20,10,1,00082,India
764725,2023-08-12,701,gel pen,5,10,5,1,00082,India
780568,2023-08-12,706,sharpener,3,8,5,1,00156,India
780568,2023-08-12,716,printing paper,200,400,200,1,00156,India
780568,2023-08-12,714,carbon paper,15,30,15,1,00156,India
103235,2023-08-12,703,eraser,1,3,2,1,00187,India
103235,2023-08-12,715,folder,5,15,10,1,00187,India
468975,2023-08-12,708,sketchpen,15,40,25,1,00444,India
468975,2023-08-12,717,spiral bound book,50,100,50,1,00444,India
468975,2023-08-12,714,carbon paper,15,30,15,1,00444,India
468975,2023-08-12,712,graph paper,20,40,20,1,00444,India
468975,2023-08-12,703,eraser,1,3,2,1,00444,India
247655,2023-08-12,710,geometry box,100,150,50,1,00002,India
247655,2023-08-12,715,folder,5,15,10,1,00002,India
247655,2023-08-12,714,carbon paper,15,30,15,1,00002,India
247655,2023-08-12,713,ball pen,5,10,5,1,00002,India
434831,2023-08-12,702,pencil,2,5,3,1,00022,India
434831,2023-08-12,714,carbon paper,15,30,15,1,00022,India
892729,2023-08-12,712,graph paper,20,40,20,1,00424,India
892729,2023-08-12,706,sharpener,3,8,5,1,00424,India
892729,2023-08-12,713,ball pen,5,10,5,1,00424,India
892729,2023-08-12,704,scale,5,10,5,1,00424,India
892729,2023-08-12,702,pencil,2,5,3,1,00424,India
283111,2023-08-12,711,TD kit,150,300,150,1,00292,India
283111,2023-08-12,716,printing paper,200,400,200,1,00292,India
582808,2023-08-12,712,graph paper,20,40,20,1,00446,India
582808,2023-08-12,702,pencil,2,5,3,1,00446,India
534345,2023-08-12,711,TD kit,150,300,150,1,00200,India
534345,2023-08-12,714,carbon paper,15,30,15,1,00200,India
534345,2023-08-12,717,spiral bound book,50,100,50,1,00200,India
133592,2023-08-12,705,stencil,10,20,10,1,00484,India
347405,2023-08-12,702,pencil,2,5,3,1,00208,India
347405,2023-08-12,711,TD kit,150,300,150,1,00208,India
347405,2023-08-12,703,eraser,1,3,2,1,00208,India
347405,2023-08-12,705,stencil,10,20,10,1,00208,India
724013,2023-08-12,706,sharpener,3,8,5,1,00212,India
724013,2023-08-12,710,geometry box,100,150,50,1,00212,India
273435,2023-08-12,711,TD kit,150,300,150,1,00210,India
800311,2023-08-12,704,scale,5,10,5,1,00328,India
800311,2023-08-12,711,TD kit,150,300,150,1,00328,India
800311,2023-08-12,716,printing paper,200,400,200,1,00328,India
800311,2023-08-12,717,spiral bound book,50,100,50,1,00328,India
800311,2023-08-12,707,marker,20,40,20,1,00328,India
153096,2023-08-12,701,gel pen,5,10,5,1,00150,India
153096,2023-08-12,704,scale,5,10,5,1,00150,India
153096,2023-08-12,714,carbon paper,15,30,15,1,00150,India
804513,2023-08-12,716,printing paper,200,400,200,1,00106,India
804513,2023-08-12,711,TD kit,150,300,150,1,00106,India
569723,2023-08-12,709,notebook,30,60,30,1,00285,India
569723,2023-08-12,707,marker,20,40,20,1,00285,India
569723,2023-08-12,710,geometry box,100,150,50,1,00285,India
569723,2023-08-12,717,spiral bound book,50,100,50,1,00285,India
870699,2023-08-12,707,marker,20,40,20,1,00096,India
870699,2023-08-12,716,printing paper,200,400,200,1,00096,India
917438,2023-08-12,713,ball pen,5,10,5,1,00279,India
917438,2023-08-12,716,printing paper,200,400,200,1,00279,India
917438,2023-08-12,703,eraser,1,3,2,1,00279,India
917438,2023-08-12,709,notebook,30,60,30,1,00279,India
333310,2023-08-12,701,gel pen,5,10,5,1,00432,India
333310,2023-08-12,704,scale,5,10,5,1,00432,India
333310,2023-08-12,707,marker,20,40,20,1,00432,India
333310,2023-08-12,703,eraser,1,3,2,1,00432,India
415888,2023-08-12,705,stencil,10,20,10,1,00167,India
415888,2023-08-12,706,sharpener,3,8,5,1,00167,India
415888,2023-08-12,714,carbon paper,15,30,15,1,00167,India
165973,2023-08-12,714,carbon paper,15,30,15,1,00015,India
165973,2023-08-12,701,gel pen,5,10,5,1,00015,India
709668,2023-08-12,709,notebook,30,60,30,1,00438,India
453087,2023-08-12,709,notebook,30,60,30,1,00440,India
453087,2023-08-12,712,graph paper,20,40,20,1,00440,India
453087,2023-08-12,701,gel pen,5,10,5,1,00440,India
453087,2023-08-12,714,carbon paper,15,30,15,1,00440,India
521983,2023-08-12,717,spiral bound book,50,100,50,1,00021,India
521983,2023-08-12,706,sharpener,3,8,5,1,00021,India
407599,2023-08-12,711,TD kit,150,300,150,1,00263,India
308005,2023-08-12,715,folder,5,15,10,1,00490,India
308005,2023-08-12,703,eraser,1,3,2,1,00490,India
308005,2023-08-12,702,pencil,2,5,3,1,00490,India
308005,2023-08-12,707,marker,20,40,20,1,00490,India
910608,2023-08-12,701,gel pen,5,10,5,1,00350,India
424384,2023-08-12,704,scale,5,10,5,1,00036,India
424384,2023-08-12,702,pencil,2,5,3,1,00036,India
424384,2023-08-12,708,sketchpen,15,40,25,1,00036,India
424384,2023-08-12,714,carbon paper,15,30,15,1,00036,India
424384,2023-08-12,716,printing paper,200,400,200,1,00036,India
114462,2023-08-12,716,printing paper,200,400,200,1,00047,India
114462,2023-08-12,717,spiral bound book,50,100,50,1,00047,India
114462,2023-08-12,706,sharpener,3,8,5,1,00047,India
114462,2023-08-12,714,carbon paper,15,30,15,1,00047,India
818205,2023-08-12,705,stencil,10,20,10,1,00311,India
818205,2023-08-12,703,eraser,1,3,2,1,00311,India
818205,2023-08-12,708,sketchpen,15,40,25,1,00311,India
818205,2023-08-12,701,gel pen,5,10,5,1,00311,India
818205,2023-08-12,706,sharpener,3,8,5,1,00311,India
346053,2023-08-12,710,geometry box,100,150,50,1,00074,India
346053,2023-08-12,708,sketchpen,15,40,25,1,00074,India
346053,2023-08-12,702,pencil,2,5,3,1,00074,India
346053,2023-08-12,715,folder,5,15,10,1,00074,India
336852,2023-08-12,701,gel pen,5,10,5,1,00167,India
336852,2023-08-12,705,stencil,10,20,10,1,00167,India
336852,2023-08-12,702,pencil,2,5,3,1,00167,India
336852,2023-08-12,706,sharpener,3,8,5,1,00167,India
428344,2023-08-13,709,notebook,30,60,30,1,00453,India
428344,2023-08-13,714,carbon paper,15,30,15,1,00453,India
428344,2023-08-13,715,folder,5,15,10,1,00453,India
428344,2023-08-13,717,spiral bound book,50,100,50,1,00453,India
753286,2023-08-13,707,marker,20,40,20,1,00072,India
753286,2023-08-13,701,gel pen,5,10,5,1,00072,India
753286,2023-08-13,709,notebook,30,60,30,1,00072,India
753286,2023-08-13,711,TD kit,150,300,150,1,00072,India
309713,2023-08-13,703,eraser,1,3,2,1,00496,India
168175,2023-08-13,705,stencil,10,20,10,1,00062,India
793466,2023-08-13,714,carbon paper,15,30,15,1,00114,India
199151,2023-08-13,704,scale,5,10,5,1,00103,India
199151,2023-08-13,717,spiral bound book,50,100,50,1,00103,India
199151,2023-08-13,715,folder,5,15,10,1,00103,India
199151,2023-08-13,711,TD kit,150,300,150,1,00103,India
362190,2023-08-13,711,TD kit,150,300,150,1,00243,India
362190,2023-08-13,710,geometry box,100,150,50,1,00243,India
230009,2023-08-13,717,spiral bound book,50,100,50,1,00405,India
230009,2023-08-13,701,gel pen,5,10,5,1,00405,India
230009,2023-08-13,709,notebook,30,60,30,1,00405,India
230009,2023-08-13,708,sketchpen,15,40,25,1,00405,India
685273,2023-08-13,712,graph paper,20,40,20,1,00292,India
685273,2023-08-13,716,printing paper,200,400,200,1,00292,India
685273,2023-08-13,708,sketchpen,15,40,25,1,00292,India
685273,2023-08-13,706,sharpener,3,8,5,1,00292,India
685273,2023-08-13,710,geometry box,100,150,50,1,00292,India
392573,2023-08-13,716,printing paper,200,400,200,1,00426,India
392573,2023-08-13,710,geometry box,100,150,50,1,00426,India
392573,2023-08-13,717,spiral bound book,50,100,50,1,00426,India
357971,2023-08-13,712,graph paper,20,40,20,1,00154,India
357971,2023-08-13,707,marker,20,40,20,1,00154,India
357971,2023-08-13,714,carbon paper,15,30,15,1,00154,India
228565,2023-08-13,706,sharpener,3,8,5,1,00019,India
228565,2023-08-13,705,stencil,10,20,10,1,00019,India
412365,2023-08-13,704,scale,5,10,5,1,00417,India
412365,2023-08-13,705,stencil,10,20,10,1,00417,India
412365,2023-08-13,713,ball pen,5,10,5,1,00417,India
412365,2023-08-13,706,sharpener,3,8,5,1,00417,India
592162,2023-08-13,703,eraser,1,3,2,1,00101,India
592162,2023-08-13,705,stencil,10,20,10,1,00101,India
703427,2023-08-13,715,folder,5,15,10,1,00212,India
421415,2023-08-13,715,folder,5,15,10,1,00441,India
421415,2023-08-13,705,stencil,10,20,10,1,00441,India
421415,2023-08-13,711,TD kit,150,300,150,1,00441,India
421415,2023-08-13,706,sharpener,3,8,5,1,00441,India
446290,2023-08-13,705,stencil,10,20,10,1,00482,India
446290,2023-08-13,714,carbon paper,15,30,15,1,00482,India
446290,2023-08-13,717,spiral bound book,50,100,50,1,00482,India
446290,2023-08-13,704,scale,5,10,5,1,00482,India
715101,2023-08-13,709,notebook,30,60,30,1,00490,India
715101,2023-08-13,715,folder,5,15,10,1,00490,India
599139,2023-08-13,711,TD kit,150,300,150,1,00177,India
599139,2023-08-13,715,folder,5,15,10,1,00177,India
599139,2023-08-13,714,carbon paper,15,30,15,1,00177,India
599139,2023-08-13,708,sketchpen,15,40,25,1,00177,India
110798,2023-08-13,717,spiral bound book,50,100,50,1,00084,India
110798,2023-08-13,714,carbon paper,15,30,15,1,00084,India
110798,2023-08-13,712,graph paper,20,40,20,1,00084,India
110798,2023-08-13,715,folder,5,15,10,1,00084,India
862294,2023-08-13,705,stencil,10,20,10,1,00262,India
862294,2023-08-13,703,eraser,1,3,2,1,00262,India
862294,2023-08-13,701,gel pen,5,10,5,1,00262,India
235093,2023-08-13,711,TD kit,150,300,150,1,00390,India
235093,2023-08-13,710,geometry box,100,150,50,1,00390,India
484299,2023-08-13,711,TD kit,150,300,150,1,00497,India
484299,2023-08-13,708,sketchpen,15,40,25,1,00497,India
484299,2023-08-13,717,spiral bound book,50,100,50,1,00497,India
585935,2023-08-13,710,geometry box,100,150,50,1,00265,India
585935,2023-08-13,707,marker,20,40,20,1,00265,India
585935,2023-08-13,708,sketchpen,15,40,25,1,00265,India
585935,2023-08-13,709,notebook,30,60,30,1,00265,India
585935,2023-08-13,705,stencil,10,20,10,1,00265,India
265167,2023-08-13,716,printing paper,200,400,200,1,00050,India
265167,2023-08-13,717,spiral bound book,50,100,50,1,00050,India
488718,2023-08-13,710,geometry box,100,150,50,1,00168,India
488718,2023-08-13,711,TD kit,150,300,150,1,00168,India
488718,2023-08-13,714,carbon paper,15,30,15,1,00168,India
488718,2023-08-13,712,graph paper,20,40,20,1,00168,India
861133,2023-08-13,711,TD kit,150,300,150,1,00272,India
861133,2023-08-13,702,pencil,2,5,3,1,00272,India
861133,2023-08-13,709,notebook,30,60,30,1,00272,India
402436,2023-08-13,717,spiral bound book,50,100,50,1,00071,India
402436,2023-08-13,705,stencil,10,20,10,1,00071,India
402436,2023-08-13,714,carbon paper,15,30,15,1,00071,India
402436,2023-08-13,703,eraser,1,3,2,1,00071,India
671459,2023-08-13,714,carbon paper,15,30,15,1,00410,India
671459,2023-08-13,716,printing paper,200,400,200,1,00410,India
671459,2023-08-13,712,graph paper,20,40,20,1,00410,India
361238,2023-08-13,708,sketchpen,15,40,25,1,00367,India
470449,2023-08-13,715,folder,5,15,10,1,00344,India
470449,2023-08-13,702,pencil,2,5,3,1,00344,India
470449,2023-08-13,707,marker,20,40,20,1,00344,India
276490,2023-08-13,706,sharpener,3,8,5,1,00012,India
838853,2023-08-13,714,carbon paper,15,30,15,1,00283,India
922940,2023-08-13,710,geometry box,100,150,50,1,00224,India
922940,2023-08-13,707,marker,20,40,20,1,00224,India
670133,2023-08-13,709,notebook,30,60,30,1,00499,India
676328,2023-08-13,717,spiral bound book,50,100,50,1,00343,India
676328,2023-08-13,713,ball pen,5,10,5,1,00343,India
676328,2023-08-13,708,sketchpen,15,40,25,1,00343,India
676328,2023-08-13,705,stencil,10,20,10,1,00343,India
675375,2023-08-13,710,geometry box,100,150,50,1,00205,India
675375,2023-08-13,703,eraser,1,3,2,1,00205,India
675375,2023-08-13,716,printing paper,200,400,200,1,00205,India
675375,2023-08-13,717,spiral bound book,50,100,50,1,00205,India
675375,2023-08-13,711,TD kit,150,300,150,1,00205,India
125986,2023-08-13,712,graph paper,20,40,20,1,00493,India
125986,2023-08-13,701,gel pen,5,10,5,1,00493,India
635483,2023-08-13,715,folder,5,15,10,1,00243,India
635483,2023-08-13,702,pencil,2,5,3,1,00243,India
635483,2023-08-13,714,carbon paper,15,30,15,1,00243,India
749750,2023-08-13,711,TD kit,150,300,150,1,00382,India
172902,2023-08-13,712,graph paper,20,40,20,1,00149,India
172902,2023-08-13,708,sketchpen,15,40,25,1,00149,India
554366,2023-08-13,708,sketchpen,15,40,25,1,00398,India
554366,2023-08-13,701,gel pen,5,10,5,1,00398,India
554366,2023-08-13,715,folder,5,15,10,1,00398,India
311239,2023-08-13,704,scale,5,10,5,1,00166,India
311239,2023-08-13,701,gel pen,5,10,5,1,00166,India
311239,2023-08-13,712,graph paper,20,40,20,1,00166,India
914847,2023-08-13,709,notebook,30,60,30,1,00128,India
914847,2023-08-13,707,marker,20,40,20,1,00128,India
526792,2023-08-13,709,notebook,30,60,30,1,00406,India
526792,2023-08-13,711,TD kit,150,300,150,1,00406,India
526792,2023-08-13,707,marker,20,40,20,1,00406,India
918821,2023-08-13,703,eraser,1,3,2,1,00165,India
200665,2023-08-13,715,folder,5,15,10,1,00289,India
200665,2023-08-13,701,gel pen,5,10,5,1,00289,India
200665,2023-08-13,706,sharpener,3,8,5,1,00289,India
200665,2023-08-13,705,stencil,10,20,10,1,00289,India
200665,2023-08-13,716,printing paper,200,400,200,1,00289,India
449064,2023-08-13,709,notebook,30,60,30,1,00300,India
449064,2023-08-13,706,sharpener,3,8,5,1,00300,India
449064,2023-08-13,704,scale,5,10,5,1,00300,India
974943,2023-08-13,706,sharpener,3,8,5,1,00280,India
974943,2023-08-13,702,pencil,2,5,3,1,00280,India
974943,2023-08-13,716,printing paper,200,400,200,1,00280,India
974943,2023-08-13,708,sketchpen,15,40,25,1,00280,India
678095,2023-08-13,713,ball pen,5,10,5,1,00268,India
678095,2023-08-13,714,carbon paper,15,30,15,1,00268,India
678095,2023-08-13,707,marker,20,40,20,1,00268,India
678095,2023-08-13,715,folder,5,15,10,1,00268,India
967199,2023-08-14,703,eraser,1,3,2,1,00081,India
967199,2023-08-14,701,gel pen,5,10,5,1,00081,India
967199,2023-08-14,712,graph paper,20,40,20,1,00081,India
967199,2023-08-14,711,TD kit,150,300,150,1,00081,India
826202,2023-08-14,716,printing paper,200,400,200,1,00208,India
826202,2023-08-14,702,pencil,2,5,3,1,00208,India
291473,2023-08-14,703,eraser,1,3,2,1,00399,India
291473,2023-08-14,714,carbon paper,15,30,15,1,00399,India
291473,2023-08-14,713,ball pen,5,10,5,1,00399,India
291473,2023-08-14,717,spiral bound book,50,100,50,1,00399,India
291473,2023-08-14,705,stencil,10,20,10,1,00399,India
925244,2023-08-14,702,pencil,2,5,3,1,00255,India
925244,2023-08-14,716,printing paper,200,400,200,1,00255,India
925244,2023-08-14,710,geometry box,100,150,50,1,00255,India
925244,2023-08-14,708,sketchpen,15,40,25,1,00255,India
925244,2023-08-14,707,marker,20,40,20,1,00255,India
498684,2023-08-14,712,graph paper,20,40,20,1,00211,India
498684,2023-08-14,711,TD kit,150,300,150,1,00211,India
498684,2023-08-14,702,pencil,2,5,3,1,00211,India
592919,2023-08-14,702,pencil,2,5,3,1,00419,India
592919,2023-08-14,704,scale,5,10,5,1,00419,India
592919,2023-08-14,707,marker,20,40,20,1,00419,India
592919,2023-08-14,709,notebook,30,60,30,1,00419,India
787229,2023-08-14,702,pencil,2,5,3,1,00334,India
787229,2023-08-14,708,sketchpen,15,40,25,1,00334,India
787229,2023-08-14,706,sharpener,3,8,5,1,00334,India
253909,2023-08-14,716,printing paper,200,400,200,1,00431,India
253909,2023-08-14,704,scale,5,10,5,1,00431,India
253909,2023-08-14,701,gel pen,5,10,5,1,00431,India
737448,2023-08-14,711,TD kit,150,300,150,1,00281,India
737448,2023-08-14,702,pencil,2,5,3,1,00281,India
317928,2023-08-14,708,sketchpen,15,40,25,1,00077,India
623950,2023-08-14,712,graph paper,20,40,20,1,00416,India
351230,2023-08-14,704,scale,5,10,5,1,00051,India
351230,2023-08-14,703,eraser,1,3,2,1,00051,India
158286,2023-08-14,701,gel pen,5,10,5,1,00480,India
158286,2023-08-14,710,geometry box,100,150,50,1,00480,India
158286,2023-08-14,717,spiral bound book,50,100,50,1,00480,India
695679,2023-08-14,713,ball pen,5,10,5,1,00002,India
695679,2023-08-14,708,sketchpen,15,40,25,1,00002,India
695679,2023-08-14,715,folder,5,15,10,1,00002,India
695679,2023-08-14,703,eraser,1,3,2,1,00002,India
393586,2023-08-14,714,carbon paper,15,30,15,1,00065,India
393586,2023-08-14,716,printing paper,200,400,200,1,00065,India
393586,2023-08-14,709,notebook,30,60,30,1,00065,India
393586,2023-08-14,705,stencil,10,20,10,1,00065,India
782392,2023-08-14,704,scale,5,10,5,1,00102,India
782392,2023-08-14,711,TD kit,150,300,150,1,00102,India
452426,2023-08-14,701,gel pen,5,10,5,1,00101,India
511576,2023-08-14,716,printing paper,200,400,200,1,00439,India
511576,2023-08-14,714,carbon paper,15,30,15,1,00439,India
599019,2023-08-14,713,ball pen,5,10,5,1,00480,India
599019,2023-08-14,711,TD kit,150,300,150,1,00480,India
599019,2023-08-14,702,pencil,2,5,3,1,00480,India
599019,2023-08-14,709,notebook,30,60,30,1,00480,India
337981,2023-08-14,716,printing paper,200,400,200,1,00101,India
805963,2023-08-14,704,scale,5,10,5,1,00342,India
805963,2023-08-14,706,sharpener,3,8,5,1,00342,India
805963,2023-08-14,715,folder,5,15,10,1,00342,India
805963,2023-08-14,710,geometry box,100,150,50,1,00342,India
504844,2023-08-14,713,ball pen,5,10,5,1,00382,India
504844,2023-08-14,702,pencil,2,5,3,1,00382,India
504844,2023-08-14,712,graph paper,20,40,20,1,00382,India
504844,2023-08-14,703,eraser,1,3,2,1,00382,India
422915,2023-08-14,715,folder,5,15,10,1,00461,India
422915,2023-08-14,717,spiral bound book,50,100,50,1,00461,India
940268,2023-08-14,704,scale,5,10,5,1,00018,India
940268,2023-08-14,701,gel pen,5,10,5,1,00018,India
940268,2023-08-14,717,spiral bound book,50,100,50,1,00018,India
940268,2023-08-14,713,ball pen,5,10,5,1,00018,India
810167,2023-08-14,717,spiral bound book,50,100,50,1,00223,India
810167,2023-08-14,708,sketchpen,15,40,25,1,00223,India
810167,2023-08-14,710,geometry box,100,150,50,1,00223,India
810167,2023-08-14,705,stencil,10,20,10,1,00223,India
810167,2023-08-14,701,gel pen,5,10,5,1,00223,India
134375,2023-08-14,706,sharpener,3,8,5,1,00359,India
134375,2023-08-14,708,sketchpen,15,40,25,1,00359,India
134375,2023-08-14,713,ball pen,5,10,5,1,00359,India
134375,2023-08-14,709,notebook,30,60,30,1,00359,India
788225,2023-08-14,711,TD kit,150,300,150,1,00054,India
788225,2023-08-14,714,carbon paper,15,30,15,1,00054,India
443683,2023-08-14,706,sharpener,3,8,5,1,00085,India
615352,2023-08-14,704,scale,5,10,5,1,00278,India
615352,2023-08-14,703,eraser,1,3,2,1,00278,India
615352,2023-08-14,712,graph paper,20,40,20,1,00278,India
557177,2023-08-14,709,notebook,30,60,30,1,00244,India
557177,2023-08-14,714,carbon paper,15,30,15,1,00244,India
557177,2023-08-14,704,scale,5,10,5,1,00244,India
557177,2023-08-14,716,printing paper,200,400,200,1,00244,India
557177,2023-08-14,706,sharpener,3,8,5,1,00244,India
394260,2023-08-14,704,scale,5,10,5,1,00333,India
394260,2023-08-14,701,gel pen,5,10,5,1,00333,India
691592,2023-08-14,706,sharpener,3,8,5,1,00474,India
691592,2023-08-14,717,spiral bound book,50,100,50,1,00474,India
844135,2023-08-14,717,spiral bound book,50,100,50,1,00461,India
952276,2023-08-14,713,ball pen,5,10,5,1,00358,India
141773,2023-08-14,705,stencil,10,20,10,1,00426,India
141773,2023-08-14,712,graph paper,20,40,20,1,00426,India
141773,2023-08-14,717,spiral bound book,50,100,50,1,00426,India
141773,2023-08-14,711,TD kit,150,300,150,1,00426,India
478986,2023-08-14,707,marker,20,40,20,1,00362,India
478986,2023-08-14,713,ball pen,5,10,5,1,00362,India
478986,2023-08-14,703,eraser,1,3,2,1,00362,India
478986,2023-08-14,701,gel pen,5,10,5,1,00362,India
167510,2023-08-14,716,printing paper,200,400,200,1,00078,India
167510,2023-08-14,701,gel pen,5,10,5,1,00078,India
167510,2023-08-14,706,sharpener,3,8,5,1,00078,India
859953,2023-08-14,710,geometry box,100,150,50,1,00351,India
859953,2023-08-14,717,spiral bound book,50,100,50,1,00351,India
859953,2023-08-14,705,stencil,10,20,10,1,00351,India
859953,2023-08-14,711,TD kit,150,300,150,1,00351,India
182895,2023-08-14,702,pencil,2,5,3,1,00154,India
182895,2023-08-14,701,gel pen,5,10,5,1,00154,India
182895,2023-08-14,708,sketchpen,15,40,25,1,00154,India
254781,2023-08-14,716,printing paper,200,400,200,1,00363,India
254781,2023-08-14,712,graph paper,20,40,20,1,00363,India
254781,2023-08-14,703,eraser,1,3,2,1,00363,India
215307,2023-08-15,706,sharpener,3,8,5,1,00357,India
215307,2023-08-15,711,TD kit,150,300,150,1,00357,India
912225,2023-08-15,711,TD kit,150,300,150,1,00328,India
763039,2023-08-15,702,pencil,2,5,3,1,00382,India
763039,2023-08-15,717,spiral bound book,50,100,50,1,00382,India
763039,2023-08-15,716,printing paper,200,400,200,1,00382,India
105312,2023-08-15,709,notebook,30,60,30,1,00045,India
602315,2023-08-15,715,folder,5,15,10,1,00105,India
602315,2023-08-15,712,graph paper,20,40,20,1,00105,India
129395,2023-08-15,704,scale,5,10,5,1,00381,India
129395,2023-08-15,711,TD kit,150,300,150,1,00381,India
129395,2023-08-15,703,eraser,1,3,2,1,00381,India
362857,2023-08-15,701,gel pen,5,10,5,1,00088,India
864637,2023-08-15,709,notebook,30,60,30,1,00267,India
864637,2023-08-15,708,sketchpen,15,40,25,1,00267,India
864637,2023-08-15,710,geometry box,100,150,50,1,00267,India
864637,2023-08-15,702,pencil,2,5,3,1,00267,India
956053,2023-08-15,702,pencil,2,5,3,1,00060,India
956053,2023-08-15,703,eraser,1,3,2,1,00060,India
956053,2023-08-15,705,stencil,10,20,10,1,00060,India
956053,2023-08-15,717,spiral bound book,50,100,50,1,00060,India
772246,2023-08-15,715,folder,5,15,10,1,00199,India
973050,2023-08-15,705,stencil,10,20,10,1,00400,India
973050,2023-08-15,704,scale,5,10,5,1,00400,India
973050,2023-08-15,708,sketchpen,15,40,25,1,00400,India
973050,2023-08-15,710,geometry box,100,150,50,1,00400,India
679915,2023-08-15,704,scale,5,10,5,1,00011,India
679915,2023-08-15,701,gel pen,5,10,5,1,00011,India
679915,2023-08-15,706,sharpener,3,8,5,1,00011,India
869906,2023-08-15,706,sharpener,3,8,5,1,00263,India
869906,2023-08-15,708,sketchpen,15,40,25,1,00263,India
869906,2023-08-15,701,gel pen,5,10,5,1,00263,India
869906,2023-08-15,712,graph paper,20,40,20,1,00263,India
513697,2023-08-15,703,eraser,1,3,2,1,00063,India
513697,2023-08-15,716,printing paper,200,400,200,1,00063,India
513697,2023-08-15,708,sketchpen,15,40,25,1,00063,India
513697,2023-08-15,709,notebook,30,60,30,1,00063,India
508408,2023-08-15,717,spiral bound book,50,100,50,1,00115,India
508408,2023-08-15,716,printing paper,200,400,200,1,00115,India
508408,2023-08-15,713,ball pen,5,10,5,1,00115,India
508408,2023-08-15,703,eraser,1,3,2,1,00115,India
537292,2023-08-15,705,stencil,10,20,10,1,00201,India
830098,2023-08-15,704,scale,5,10,5,1,00244,India
830098,2023-08-15,707,marker,20,40,20,1,00244,India
830098,2023-08-15,701,gel pen,5,10,5,1,00244,India
830098,2023-08-15,716,printing paper,200,400,200,1,00244,India
608921,2023-08-15,702,pencil,2,5,3,1,00482,India
608921,2023-08-15,703,eraser,1,3,2,1,00482,India
608921,2023-08-15,712,graph paper,20,40,20,1,00482,India
608921,2023-08-15,717,spiral bound book,50,100,50,1,00482,India
513576,2023-08-15,707,marker,20,40,20,1,00121,India
513576,2023-08-15,710,geometry box,100,150,50,1,00121,India
513576,2023-08-15,711,TD kit,150,300,150,1,00121,India
578606,2023-08-15,701,gel pen,5,10,5,1,00345,India
578606,2023-08-15,704,scale,5,10,5,1,00345,India
578606,2023-08-15,709,notebook,30,60,30,1,00345,India
578606,2023-08-15,707,marker,20,40,20,1,00345,India
578606,2023-08-15,714,carbon paper,15,30,15,1,00345,India
143325,2023-08-15,701,gel pen,5,10,5,1,00054,India
143325,2023-08-15,705,stencil,10,20,10,1,00054,India
143325,2023-08-15,714,carbon paper,15,30,15,1,00054,India
143325,2023-08-15,707,marker,20,40,20,1,00054,India
143325,2023-08-15,715,folder,5,15,10,1,00054,India
961908,2023-08-15,710,geometry box,100,150,50,1,00367,India
961908,2023-08-15,702,pencil,2,5,3,1,00367,India
264684,2023-08-15,710,geometry box,100,150,50,1,00491,India
264684,2023-08-15,704,scale,5,10,5,1,00491,India
264684,2023-08-15,707,marker,20,40,20,1,00491,India
220255,2023-08-15,714,carbon paper,15,30,15,1,00364,India
220255,2023-08-15,711,TD kit,150,300,150,1,00364,India
740479,2023-08-15,715,folder,5,15,10,1,00423,India
740479,2023-08-15,711,TD kit,150,300,150,1,00423,India
611050,2023-08-15,702,pencil,2,5,3,1,00023,India
611050,2023-08-15,717,spiral bound book,50,100,50,1,00023,India
611050,2023-08-15,703,eraser,1,3,2,1,00023,India
611050,2023-08-15,713,ball pen,5,10,5,1,00023,India
611050,2023-08-15,712,graph paper,20,40,20,1,00023,India
425477,2023-08-15,712,graph paper,20,40,20,1,00087,India
425477,2023-08-15,701,gel pen,5,10,5,1,00087,India
796034,2023-08-15,707,marker,20,40,20,1,00397,India
796034,2023-08-15,706,sharpener,3,8,5,1,00397,India
845815,2023-08-15,705,stencil,10,20,10,1,00228,India
207834,2023-08-15,708,sketchpen,15,40,25,1,00494,India
207834,2023-08-15,703,eraser,1,3,2,1,00494,India
207834,2023-08-15,709,notebook,30,60,30,1,00494,India
306165,2023-08-15,704,scale,5,10,5,1,00294,India
306165,2023-08-15,708,sketchpen,15,40,25,1,00294,India
306165,2023-08-15,707,marker,20,40,20,1,00294,India
306165,2023-08-15,703,eraser,1,3,2,1,00294,India
566232,2023-08-15,714,carbon paper,15,30,15,1,00378,India
566232,2023-08-15,704,scale,5,10,5,1,00378,India
566232,2023-08-15,701,gel pen,5,10,5,1,00378,India
625686,2023-08-15,716,printing paper,200,400,200,1,00067,India
625686,2023-08-15,705,stencil,10,20,10,1,00067,India
853965,2023-08-15,703,eraser,1,3,2,1,00057,India
853965,2023-08-15,701,gel pen,5,10,5,1,00057,India
853965,2023-08-15,715,folder,5,15,10,1,00057,India
716266,2023-08-15,703,eraser,1,3,2,1,00371,India
716266,2023-08-15,704,scale,5,10,5,1,00371,India
716266,2023-08-15,702,pencil,2,5,3,1,00371,India
716266,2023-08-15,708,sketchpen,15,40,25,1,00371,India
716266,2023-08-15,701,gel pen,5,10,5,1,00371,India
567473,2023-08-15,703,eraser,1,3,2,1,00056,India
567473,2023-08-15,714,carbon paper,15,30,15,1,00056,India
567473,2023-08-15,715,folder,5,15,10,1,00056,India
567473,2023-08-15,710,geometry box,100,150,50,1,00056,India
673609,2023-08-15,708,sketchpen,15,40,25,1,00181,India
673609,2023-08-15,716,printing paper,200,400,200,1,00181,India
673609,2023-08-15,712,graph paper,20,40,20,1,00181,India
673609,2023-08-15,714,carbon paper,15,30,15,1,00181,India
897713,2023-08-15,709,notebook,30,60,30,1,00204,India
897713,2023-08-15,707,marker,20,40,20,1,00204,India
130813,2023-08-15,703,eraser,1,3,2,1,00247,India
130813,2023-08-15,712,graph paper,20,40,20,1,00247,India
130813,2023-08-15,714,carbon paper,15,30,15,1,00247,India
410866,2023-08-15,715,folder,5,15,10,1,00318,India
530404,2023-08-15,701,gel pen,5,10,5,1,00101,India
530404,2023-08-15,716,printing paper,200,400,200,1,00101,India
530404,2023-08-15,704,scale,5,10,5,1,00101,India
530404,2023-08-15,711,TD kit,150,300,150,1,00101,India
345419,2023-08-15,702,pencil,2,5,3,1,00009,India
345419,2023-08-15,715,folder,5,15,10,1,00009,India
345419,2023-08-15,713,ball pen,5,10,5,1,00009,India
345419,2023-08-15,704,scale,5,10,5,1,00009,India
211509,2023-08-15,701,gel pen,5,10,5,1,00069,India
715641,2023-08-15,716,printing paper,200,400,200,1,00001,India
454733,2023-08-15,706,sharpener,3,8,5,1,00340,India
454733,2023-08-15,711,TD kit,150,300,150,1,00340,India
454733,2023-08-15,717,spiral bound book,50,100,50,1,00340,India
935230,2023-08-15,708,sketchpen,15,40,25,1,00336,India
440962,2023-08-15,704,scale,5,10,5,1,00203,India
900421,2023-08-16,710,geometry box,100,150,50,1,00079,India
900421,2023-08-16,705,stencil,10,20,10,1,00079,India
198885,2023-08-16,714,carbon paper,15,30,15,1,00034,India
198885,2023-08-16,703,eraser,1,3,2,1,00034,India
755013,2023-08-16,703,eraser,1,3,2,1,00283,India
755013,2023-08-16,709,notebook,30,60,30,1,00283,India
755013,2023-08-16,715,folder,5,15,10,1,00283,India
755013,2023-08-16,708,sketchpen,15,40,25,1,00283,India
515865,2023-08-16,706,sharpener,3,8,5,1,00476,India
515865,2023-08-16,707,marker,20,40,20,1,00476,India
515865,2023-08-16,714,carbon paper,15,30,15,1,00476,India
815224,2023-08-16,706,sharpener,3,8,5,1,00181,India
815224,2023-08-16,711,TD kit,150,300,150,1,00181,India
815224,2023-08-16,705,stencil,10,20,10,1,00181,India
815224,2023-08-16,703,eraser,1,3,2,1,00181,India
478920,2023-08-16,714,carbon paper,15,30,15,1,00429,India
478920,2023-08-16,707,marker,20,40,20,1,00429,India
478920,2023-08-16,705,stencil,10,20,10,1,00429,India
645224,2023-08-16,708,sketchpen,15,40,25,1,00305,India
976192,2023-08-16,716,printing paper,200,400,200,1,00217,India
976192,2023-08-16,713,ball pen,5,10,5,1,00217,India
310205,2023-08-16,708,sketchpen,15,40,25,1,00270,India
813928,2023-08-16,704,scale,5,10,5,1,00318,India
813928,2023-08-16,714,carbon paper,15,30,15,1,00318,India
813928,2023-08-16,703,eraser,1,3,2,1,00318,India
366156,2023-08-16,711,TD kit,150,300,150,1,00314,India
162400,2023-08-16,702,pencil,2,5,3,1,00166,India
162400,2023-08-16,703,eraser,1,3,2,1,00166,India
162400,2023-08-16,706,sharpener,3,8,5,1,00166,India
162400,2023-08-16,714,carbon paper,15,30,15,1,00166,India
346530,2023-08-16,705,stencil,10,20,10,1,00148,India
864381,2023-08-16,705,stencil,10,20,10,1,00380,India
864381,2023-08-16,711,TD kit,150,300,150,1,00380,India
843591,2023-08-16,702,pencil,2,5,3,1,00445,India
843591,2023-08-16,703,eraser,1,3,2,1,00445,India
843591,2023-08-16,710,geometry box,100,150,50,1,00445,India
843591,2023-08-16,709,notebook,30,60,30,1,00445,India
843591,2023-08-16,704,scale,5,10,5,1,00445,India
625205,2023-08-16,706,sharpener,3,8,5,1,00162,India
745850,2023-08-16,708,sketchpen,15,40,25,1,00368,India
763356,2023-08-16,704,scale,5,10,5,1,00086,India
492144,2023-08-16,709,notebook,30,60,30,1,00190,India
491557,2023-08-16,714,carbon paper,15,30,15,1,00325,India
491557,2023-08-16,708,sketchpen,15,40,25,1,00325,India
491557,2023-08-16,717,spiral bound book,50,100,50,1,00325,India
587256,2023-08-16,715,folder,5,15,10,1,00010,India
587256,2023-08-16,708,sketchpen,15,40,25,1,00010,India
587256,2023-08-16,712,graph paper,20,40,20,1,00010,India
587256,2023-08-16,711,TD kit,150,300,150,1,00010,India
587256,2023-08-16,707,marker,20,40,20,1,00010,India
509658,2023-08-16,702,pencil,2,5,3,1,00107,India
504136,2023-08-16,713,ball pen,5,10,5,1,00363,India
504136,2023-08-16,708,sketchpen,15,40,25,1,00363,India
778007,2023-08-16,705,stencil,10,20,10,1,00467,India
778007,2023-08-16,712,graph paper,20,40,20,1,00467,India
778007,2023-08-16,715,folder,5,15,10,1,00467,India
757281,2023-08-16,715,folder,5,15,10,1,00494,India
794632,2023-08-16,712,graph paper,20,40,20,1,00118,India
794632,2023-08-16,703,eraser,1,3,2,1,00118,India
794632,2023-08-16,706,sharpener,3,8,5,1,00118,India
968943,2023-08-16,701,gel pen,5,10,5,1,00358,India
968943,2023-08-16,702,pencil,2,5,3,1,00358,India
968943,2023-08-16,713,ball pen,5,10,5,1,00358,India
968943,2023-08-16,714,carbon paper,15,30,15,1,00358,India
996664,2023-08-16,709,notebook,30,60,30,1,00094,India
996664,2023-08-16,716,printing paper,200,400,200,1,00094,India
895812,2023-08-16,707,marker,20,40,20,1,00377,India
839780,2023-08-16,710,geometry box,100,150,50,1,00491,India
839780,2023-08-16,712,graph paper,20,40,20,1,00491,India
839780,2023-08-16,716,printing paper,200,400,200,1,00491,India
518450,2023-08-16,710,geometry box,100,150,50,1,00150,India
518450,2023-08-16,712,graph paper,20,40,20,1,00150,India
518450,2023-08-16,708,sketchpen,15,40,25,1,00150,India
518450,2023-08-16,715,folder,5,15,10,1,00150,India
518450,2023-08-16,704,scale,5,10,5,1,00150,India
332724,2023-08-16,705,stencil,10,20,10,1,00104,India
332724,2023-08-16,701,gel pen,5,10,5,1,00104,India
332724,2023-08-16,703,eraser,1,3,2,1,00104,India
818788,2023-08-16,710,geometry box,100,150,50,1,00274,India
818788,2023-08-16,714,carbon paper,15,30,15,1,00274,India
124751,2023-08-16,701,gel pen,5,10,5,1,00498,India
124751,2023-08-16,705,stencil,10,20,10,1,00498,India
124751,2023-08-16,708,sketchpen,15,40,25,1,00498,India
124751,2023-08-16,704,scale,5,10,5,1,00498,India
670591,2023-08-16,707,marker,20,40,20,1,00465,India
670591,2023-08-16,712,graph paper,20,40,20,1,00465,India
670591,2023-08-16,716,printing paper,200,400,200,1,00465,India
577083,2023-08-16,717,spiral bound book,50,100,50,1,00046,India
577083,2023-08-16,715,folder,5,15,10,1,00046,India
577083,2023-08-16,702,pencil,2,5,3,1,00046,India
830429,2023-08-16,707,marker,20,40,20,1,00195,India
303304,2023-08-16,706,sharpener,3,8,5,1,00434,India
303304,2023-08-16,702,pencil,2,5,3,1,00434,India
303304,2023-08-16,714,carbon paper,15,30,15,1,00434,India
303304,2023-08-16,705,stencil,10,20,10,1,00434,India
339309,2023-08-16,716,printing paper,200,400,200,1,00221,India
339309,2023-08-16,710,geometry box,100,150,50,1,00221,India
339309,2023-08-16,714,carbon paper,15,30,15,1,00221,India
339309,2023-08-16,707,marker,20,40,20,1,00221,India
685433,2023-08-16,714,carbon paper,15,30,15,1,00107,India
685433,2023-08-16,715,folder,5,15,10,1,00107,India
685433,2023-08-16,712,graph paper,20,40,20,1,00107,India
685433,2023-08-16,705,stencil,10,20,10,1,00107,India
238714,2023-08-16,717,spiral bound book,50,100,50,1,00299,India
238714,2023-08-16,715,folder,5,15,10,1,00299,India
357251,2023-08-16,706,sharpener,3,8,5,1,00330,India
357251,2023-08-16,704,scale,5,10,5,1,00330,India
357251,2023-08-16,715,folder,5,15,10,1,00330,India
357251,2023-08-16,713,ball pen,5,10,5,1,00330,India
357251,2023-08-16,712,graph paper,20,40,20,1,00330,India
146000,2023-08-16,706,sharpener,3,8,5,1,00256,India
146000,2023-08-16,701,gel pen,5,10,5,1,00256,India
146000,2023-08-16,703,eraser,1,3,2,1,00256,India
538171,2023-08-16,709,notebook,30,60,30,1,00128,India
538171,2023-08-16,702,pencil,2,5,3,1,00128,India
449488,2023-08-16,714,carbon paper,15,30,15,1,00471,India
449488,2023-08-16,706,sharpener,3,8,5,1,00471,India
449488,2023-08-16,707,marker,20,40,20,1,00471,India
189309,2023-08-16,712,graph paper,20,40,20,1,00254,India
176589,2023-08-16,709,notebook,30,60,30,1,00363,India
176589,2023-08-16,707,marker,20,40,20,1,00363,India
176589,2023-08-16,703,eraser,1,3,2,1,00363,India
369493,2023-08-16,717,spiral bound book,50,100,50,1,00250,India
369493,2023-08-16,711,TD kit,150,300,150,1,00250,India
369493,2023-08-16,704,scale,5,10,5,1,00250,India
369493,2023-08-16,703,eraser,1,3,2,1,00250,India
864878,2023-08-16,710,geometry box,100,150,50,1,00427,India
864878,2023-08-16,717,spiral bound book,50,100,50,1,00427,India
864878,2023-08-16,715,folder,5,15,10,1,00427,India
446790,2023-08-17,701,gel pen,5,10,5,1,00066,India
446790,2023-08-17,716,printing paper,200,400,200,1,00066,India
446790,2023-08-17,704,scale,5,10,5,1,00066,India
446790,2023-08-17,711,TD kit,150,300,150,1,00066,India
242227,2023-08-17,707,marker,20,40,20,1,00054,India
242227,2023-08-17,709,notebook,30,60,30,1,00054,India
794226,2023-08-17,710,geometry box,100,150,50,1,00420,India
387478,2023-08-17,712,graph paper,20,40,20,1,00360,India
387478,2023-08-17,703,eraser,1,3,2,1,00360,India
712604,2023-08-17,701,gel pen,5,10,5,1,00257,India
712604,2023-08-17,704,scale,5,10,5,1,00257,India
712604,2023-08-17,705,stencil,10,20,10,1,00257,India
712604,2023-08-17,702,pencil,2,5,3,1,00257,India
179755,2023-08-17,706,sharpener,3,8,5,1,00230,India
317245,2023-08-17,711,TD kit,150,300,150,1,00492,India
317245,2023-08-17,712,graph paper,20,40,20,1,00492,India
317245,2023-08-17,713,ball pen,5,10,5,1,00492,India
317245,2023-08-17,715,folder,5,15,10,1,00492,India
317245,2023-08-17,706,sharpener,3,8,5,1,00492,India
772915,2023-08-17,706,sharpener,3,8,5,1,00438,India
772915,2023-08-17,717,spiral bound book,50,100,50,1,00438,India
772915,2023-08-17,704,scale,5,10,5,1,00438,India
868871,2023-08-17,711,TD kit,150,300,150,1,00295,India
868871,2023-08-17,706,sharpener,3,8,5,1,00295,India
868871,2023-08-17,704,scale,5,10,5,1,00295,India
868871,2023-08-17,716,printing paper,200,400,200,1,00295,India
868871,2023-08-17,703,eraser,1,3,2,1,00295,India
873653,2023-08-17,708,sketchpen,15,40,25,1,00403,India
873653,2023-08-17,705,stencil,10,20,10,1,00403,India
873653,2023-08-17,707,marker,20,40,20,1,00403,India
873653,2023-08-17,714,carbon paper,15,30,15,1,00403,India
592634,2023-08-17,716,printing paper,200,400,200,1,00349,India
592634,2023-08-17,701,gel pen,5,10,5,1,00349,India
467576,2023-08-17,704,scale,5,10,5,1,00371,India
754050,2023-08-17,711,TD kit,150,300,150,1,00113,India
816027,2023-08-17,715,folder,5,15,10,1,00161,India
183256,2023-08-17,702,pencil,2,5,3,1,00462,India
183256,2023-08-17,713,ball pen,5,10,5,1,00462,India
183256,2023-08-17,707,marker,20,40,20,1,00462,India
183256,2023-08-17,704,scale,5,10,5,1,00462,India
944624,2023-08-17,715,folder,5,15,10,1,00085,India
670279,2023-08-17,715,folder,5,15,10,1,00298,India
670279,2023-08-17,703,eraser,1,3,2,1,00298,India
670279,2023-08-17,705,stencil,10,20,10,1,00298,India
665444,2023-08-17,716,printing paper,200,400,200,1,00413,India
665444,2023-08-17,717,spiral bound book,50,100,50,1,00413,India
755176,2023-08-17,703,eraser,1,3,2,1,00385,India
755176,2023-08-17,711,TD kit,150,300,150,1,00385,India
755176,2023-08-17,712,graph paper,20,40,20,1,00385,India
755176,2023-08-17,701,gel pen,5,10,5,1,00385,India
755176,2023-08-17,705,stencil,10,20,10,1,00385,India
483791,2023-08-17,707,marker,20,40,20,1,00323,India
483791,2023-08-17,713,ball pen,5,10,5,1,00323,India
483791,2023-08-17,716,printing paper,200,400,200,1,00323,India
483791,2023-08-17,714,carbon paper,15,30,15,1,00323,India
984925,2023-08-17,712,graph paper,20,40,20,1,00181,India
984925,2023-08-17,708,sketchpen,15,40,25,1,00181,India
984925,2023-08-17,715,folder,5,15,10,1,00181,India
305745,2023-08-17,715,folder,5,15,10,1,00473,India
305745,2023-08-17,702,pencil,2,5,3,1,00473,India
305745,2023-08-17,710,geometry box,100,150,50,1,00473,India
305745,2023-08-17,717,spiral bound book,50,100,50,1,00473,India
298980,2023-08-17,713,ball pen,5,10,5,1,00243,India
298980,2023-08-17,705,stencil,10,20,10,1,00243,India
234696,2023-08-17,703,eraser,1,3,2,1,00091,India
234696,2023-08-17,710,geometry box,100,150,50,1,00091,India
234696,2023-08-17,705,stencil,10,20,10,1,00091,India
234696,2023-08-17,717,spiral bound book,50,100,50,1,00091,India
383405,2023-08-17,714,carbon paper,15,30,15,1,00434,India
779261,2023-08-17,703,eraser,1,3,2,1,00497,India
850514,2023-08-17,704,scale,5,10,5,1,00370,India
850514,2023-08-17,717,spiral bound book,50,100,50,1,00370,India
380355,2023-08-17,701,gel pen,5,10,5,1,00037,India
380355,2023-08-17,704,scale,5,10,5,1,00037,India
835204,2023-08-17,715,folder,5,15,10,1,00429,India
835204,2023-08-17,713,ball pen,5,10,5,1,00429,India
605988,2023-08-17,710,geometry box,100,150,50,1,00239,India
127348,2023-08-17,708,sketchpen,15,40,25,1,00468,India
402693,2023-08-17,703,eraser,1,3,2,1,00188,India
597242,2023-08-17,708,sketchpen,15,40,25,1,00442,India
407068,2023-08-17,701,gel pen,5,10,5,1,00225,India
407068,2023-08-17,707,marker,20,40,20,1,00225,India
407068,2023-08-17,705,stencil,10,20,10,1,00225,India
469903,2023-08-17,714,carbon paper,15,30,15,1,00402,India
469903,2023-08-17,708,sketchpen,15,40,25,1,00402,India
539972,2023-08-17,710,geometry box,100,150,50,1,00265,India
264055,2023-08-17,701,gel pen,5,10,5,1,00291,India
264055,2023-08-17,714,carbon paper,15,30,15,1,00291,India
264055,2023-08-17,706,sharpener,3,8,5,1,00291,India
597817,2023-08-17,712,graph paper,20,40,20,1,00329,India
597817,2023-08-17,713,ball pen,5,10,5,1,00329,India
265701,2023-08-17,715,folder,5,15,10,1,00166,India
265701,2023-08-17,711,TD kit,150,300,150,1,00166,India
425294,2023-08-17,715,folder,5,15,10,1,00428,India
425294,2023-08-17,706,sharpener,3,8,5,1,00428,India
425294,2023-08-17,701,gel pen,5,10,5,1,00428,India
125383,2023-08-17,714,carbon paper,15,30,15,1,00116,India
125383,2023-08-17,710,geometry box,100,150,50,1,00116,India
125383,2023-08-17,707,marker,20,40,20,1,00116,India
125383,2023-08-17,712,graph paper,20,40,20,1,00116,India
125383,2023-08-17,713,ball pen,5,10,5,1,00116,India
836567,2023-08-18,713,ball pen,5,10,5,1,00261,India
836567,2023-08-18,709,notebook,30,60,30,1,00261,India
168331,2023-08-18,704,scale,5,10,5,1,00017,India
168331,2023-08-18,703,eraser,1,3,2,1,00017,India
688835,2023-08-18,701,gel pen,5,10,5,1,00223,India
688835,2023-08-18,711,TD kit,150,300,150,1,00223,India
688835,2023-08-18,706,sharpener,3,8,5,1,00223,India
688835,2023-08-18,715,folder,5,15,10,1,00223,India
848569,2023-08-18,711,TD kit,150,300,150,1,00007,India
802865,2023-08-18,703,eraser,1,3,2,1,00019,India
802865,2023-08-18,714,carbon paper,15,30,15,1,00019,India
802865,2023-08-18,716,printing paper,200,400,200,1,00019,India
168804,2023-08-18,712,graph paper,20,40,20,1,00459,India
168804,2023-08-18,704,scale,5,10,5,1,00459,India
168804,2023-08-18,710,geometry box,100,150,50,1,00459,India
168804,2023-08-18,707,marker,20,40,20,1,00459,India
716133,2023-08-18,704,scale,5,10,5,1,00182,India
716133,2023-08-18,708,sketchpen,15,40,25,1,00182,India
200192,2023-08-18,717,spiral bound book,50,100,50,1,00222,India
715929,2023-08-18,713,ball pen,5,10,5,1,00200,India
953811,2023-08-18,712,graph paper,20,40,20,1,00023,India
953811,2023-08-18,705,stencil,10,20,10,1,00023,India
305431,2023-08-18,714,carbon paper,15,30,15,1,00418,India
305431,2023-08-18,712,graph paper,20,40,20,1,00418,India
329344,2023-08-18,705,stencil,10,20,10,1,00391,India
737171,2023-08-18,707,marker,20,40,20,1,00301,India
737171,2023-08-18,701,gel pen,5,10,5,1,00301,India
943323,2023-08-18,708,sketchpen,15,40,25,1,00496,India
943323,2023-08-18,713,ball pen,5,10,5,1,00496,India
943323,2023-08-18,711,TD kit,150,300,150,1,00496,India
231675,2023-08-18,704,scale,5,10,5,1,00098,India
231675,2023-08-18,715,folder,5,15,10,1,00098,India
231675,2023-08-18,714,carbon paper,15,30,15,1,00098,India
231675,2023-08-18,713,ball pen,5,10,5,1,00098,India
231675,2023-08-18,705,stencil,10,20,10,1,00098,India
297686,2023-08-18,703,eraser,1,3,2,1,00449,India
297686,2023-08-18,713,ball pen,5,10,5,1,00449,India
297686,2023-08-18,712,graph paper,20,40,20,1,00449,India
877891,2023-08-18,716,printing paper,200,400,200,1,00415,India
773455,2023-08-18,702,pencil,2,5,3,1,00450,India
494913,2023-08-18,713,ball pen,5,10,5,1,00376,India
494913,2023-08-18,703,eraser,1,3,2,1,00376,India
494913,2023-08-18,714,carbon paper,15,30,15,1,00376,India
494913,2023-08-18,704,scale,5,10,5,1,00376,India
966372,2023-08-18,702,pencil,2,5,3,1,00103,India
966372,2023-08-18,712,graph paper,20,40,20,1,00103,India
966372,2023-08-18,709,notebook,30,60,30,1,00103,India
903559,2023-08-18,710,geometry box,100,150,50,1,00441,India
903559,2023-08-18,715,folder,5,15,10,1,00441,India
903559,2023-08-18,716,printing paper,200,400,200,1,00441,India
903559,2023-08-18,707,marker,20,40,20,1,00441,India
903559,2023-08-18,702,pencil,2,5,3,1,00441,India
407221,2023-08-18,708,sketchpen,15,40,25,1,00026,India
407221,2023-08-18,707,marker,20,40,20,1,00026,India
340180,2023-08-18,715,folder,5,15,10,1,00164,India
340180,2023-08-18,706,sharpener,3,8,5,1,00164,India
340180,2023-08-18,703,eraser,1,3,2,1,00164,India
340180,2023-08-18,708,sketchpen,15,40,25,1,00164,India
384721,2023-08-18,702,pencil,2,5,3,1,00171,India
384721,2023-08-18,711,TD kit,150,300,150,1,00171,India
384721,2023-08-18,715,folder,5,15,10,1,00171,India
384721,2023-08-18,716,printing paper,200,400,200,1,00171,India
491369,2023-08-18,706,sharpener,3,8,5,1,00339,India
136825,2023-08-18,710,geometry box,100,150,50,1,00098,India
136825,2023-08-18,717,spiral bound book,50,100,50,1,00098,India
136825,2023-08-18,703,eraser,1,3,2,1,00098,India
136825,2023-08-18,701,gel pen,5,10,5,1,00098,India
859356,2023-08-18,708,sketchpen,15,40,25,1,00141,India
859356,2023-08-18,704,scale,5,10,5,1,00141,India
876077,2023-08-18,716,printing paper,200,400,200,1,00252,India
876077,2023-08-18,713,ball pen,5,10,5,1,00252,India
876077,2023-08-18,707,marker,20,40,20,1,00252,India
876077,2023-08-18,717,spiral bound book,50,100,50,1,00252,India
472680,2023-08-18,701,gel pen,5,10,5,1,00056,India
472680,2023-08-18,708,sketchpen,15,40,25,1,00056,India
472680,2023-08-18,711,TD kit,150,300,150,1,00056,India
472680,2023-08-18,709,notebook,30,60,30,1,00056,India
564182,2023-08-18,717,spiral bound book,50,100,50,1,00367,India
564182,2023-08-18,710,geometry box,100,150,50,1,00367,India
564182,2023-08-18,705,stencil,10,20,10,1,00367,India
564182,2023-08-18,713,ball pen,5,10,5,1,00367,India
684258,2023-08-18,710,geometry box,100,150,50,1,00214,India
689562,2023-08-18,715,folder,5,15,10,1,00089,India
689562,2023-08-18,701,gel pen,5,10,5,1,00089,India
689562,2023-08-18,714,carbon paper,15,30,15,1,00089,India
689562,2023-08-18,710,geometry box,100,150,50,1,00089,India
689562,2023-08-18,704,scale,5,10,5,1,00089,India
155527,2023-08-18,713,ball pen,5,10,5,1,00346,India
988783,2023-08-18,715,folder,5,15,10,1,00279,India
319793,2023-08-18,716,printing paper,200,400,200,1,00372,India
319793,2023-08-18,715,folder,5,15,10,1,00372,India
319793,2023-08-18,712,graph paper,20,40,20,1,00372,India
319793,2023-08-18,711,TD kit,150,300,150,1,00372,India
297902,2023-08-18,710,geometry box,100,150,50,1,00475,India
297902,2023-08-18,716,printing paper,200,400,200,1,00475,India
297902,2023-08-18,715,folder,5,15,10,1,00475,India
297902,2023-08-18,708,sketchpen,15,40,25,1,00475,India
242784,2023-08-18,703,eraser,1,3,2,1,00181,India
242784,2023-08-18,702,pencil,2,5,3,1,00181,India
861359,2023-08-19,717,spiral bound book,50,100,50,1,00130,India
668406,2023-08-19,712,graph paper,20,40,20,1,00077,India
668406,2023-08-19,709,notebook,30,60,30,1,00077,India
459316,2023-08-19,702,pencil,2,5,3,1,00380,India
459316,2023-08-19,703,eraser,1,3,2,1,00380,India
459316,2023-08-19,713,ball pen,5,10,5,1,00380,India
459316,2023-08-19,701,gel pen,5,10,5,1,00380,India
279046,2023-08-19,706,sharpener,3,8,5,1,00228,India
279046,2023-08-19,713,ball pen,5,10,5,1,00228,India
279046,2023-08-19,701,gel pen,5,10,5,1,00228,India
279046,2023-08-19,703,eraser,1,3,2,1,00228,India
752237,2023-08-19,713,ball pen,5,10,5,1,00320,India
735274,2023-08-19,713,ball pen,5,10,5,1,00498,India
735274,2023-08-19,717,spiral bound book,50,100,50,1,00498,India
735274,2023-08-19,715,folder,5,15,10,1,00498,India
735274,2023-08-19,705,stencil,10,20,10,1,00498,India
910465,2023-08-19,716,printing paper,200,400,200,1,00141,India
910465,2023-08-19,707,marker,20,40,20,1,00141,India
910465,2023-08-19,710,geometry box,100,150,50,1,00141,India
910465,2023-08-19,706,sharpener,3,8,5,1,00141,India
989581,2023-08-19,712,graph paper,20,40,20,1,00438,India
989581,2023-08-19,701,gel pen,5,10,5,1,00438,India
989581,2023-08-19,708,sketchpen,15,40,25,1,00438,India
989581,2023-08-19,711,TD kit,150,300,150,1,00438,India
823160,2023-08-19,703,eraser,1,3,2,1,00036,India
775934,2023-08-19,716,printing paper,200,400,200,1,00479,India
775934,2023-08-19,712,graph paper,20,40,20,1,00479,India
775934,2023-08-19,702,pencil,2,5,3,1,00479,India
775934,2023-08-19,715,folder,5,15,10,1,00479,India
616131,2023-08-19,702,pencil,2,5,3,1,00070,India
616131,2023-08-19,715,folder,5,15,10,1,00070,India
759510,2023-08-19,707,marker,20,40,20,1,00261,India
759510,2023-08-19,717,spiral bound book,50,100,50,1,00261,India
852114,2023-08-19,706,sharpener,3,8,5,1,00026,India
852114,2023-08-19,701,gel pen,5,10,5,1,00026,India
852114,2023-08-19,709,notebook,30,60,30,1,00026,India
384425,2023-08-19,710,geometry box,100,150,50,1,00224,India
342442,2023-08-19,715,folder,5,15,10,1,00440,India
920934,2023-08-19,704,scale,5,10,5,1,00449,India
310523,2023-08-19,717,spiral bound book,50,100,50,1,00384,India
310523,2023-08-19,705,stencil,10,20,10,1,00384,India
310523,2023-08-19,701,gel pen,5,10,5,1,00384,India
310523,2023-08-19,711,TD kit,150,300,150,1,00384,India
310523,2023-08-19,715,folder,5,15,10,1,00384,India
705321,2023-08-19,701,gel pen,5,10,5,1,00418,India
262630,2023-08-19,702,pencil,2,5,3,1,00153,India
262630,2023-08-19,715,folder,5,15,10,1,00153,India
262630,2023-08-19,712,graph paper,20,40,20,1,00153,India
923552,2023-08-19,707,marker,20,40,20,1,00078,India
923552,2023-08-19,708,sketchpen,15,40,25,1,00078,India
923552,2023-08-19,706,sharpener,3,8,5,1,00078,India
923552,2023-08-19,716,printing paper,200,400,200,1,00078,India
607562,2023-08-19,714,carbon paper,15,30,15,1,00454,India
607562,2023-08-19,716,printing paper,200,400,200,1,00454,India
607562,2023-08-19,705,stencil,10,20,10,1,00454,India
607562,2023-08-19,702,pencil,2,5,3,1,00454,India
644340,2023-08-19,715,folder,5,15,10,1,00451,India
644340,2023-08-19,713,ball pen,5,10,5,1,00451,India
644340,2023-08-19,704,scale,5,10,5,1,00451,India
173397,2023-08-19,708,sketchpen,15,40,25,1,00219,India
782816,2023-08-19,707,marker,20,40,20,1,00304,India
782816,2023-08-19,702,pencil,2,5,3,1,00304,India
782816,2023-08-19,713,ball pen,5,10,5,1,00304,India
223083,2023-08-19,716,printing paper,200,400,200,1,00217,India
223083,2023-08-19,705,stencil,10,20,10,1,00217,India
223083,2023-08-19,714,carbon paper,15,30,15,1,00217,India
223083,2023-08-19,711,TD kit,150,300,150,1,00217,India
740931,2023-08-19,707,marker,20,40,20,1,00379,India
890488,2023-08-19,714,carbon paper,15,30,15,1,00379,India
890488,2023-08-19,710,geometry box,100,150,50,1,00379,India
890488,2023-08-19,708,sketchpen,15,40,25,1,00379,India
672679,2023-08-19,701,gel pen,5,10,5,1,00066,India
672679,2023-08-19,714,carbon paper,15,30,15,1,00066,India
417017,2023-08-19,706,sharpener,3,8,5,1,00044,India
417017,2023-08-19,702,pencil,2,5,3,1,00044,India
417017,2023-08-19,717,spiral bound book,50,100,50,1,00044,India
417017,2023-08-19,714,carbon paper,15,30,15,1,00044,India
109317,2023-08-19,714,carbon paper,15,30,15,1,00129,India
109317,2023-08-19,706,sharpener,3,8,5,1,00129,India
109317,2023-08-19,716,printing paper,200,400,200,1,00129,India
109317,2023-08-19,715,folder,5,15,10,1,00129,India
342975,2023-08-19,715,folder,5,15,10,1,00197,India
342975,2023-08-19,705,stencil,10,20,10,1,00197,India
342975,2023-08-19,703,eraser,1,3,2,1,00197,India
342975,2023-08-19,701,gel pen,5,10,5,1,00197,India
364877,2023-08-19,708,sketchpen,15,40,25,1,00429,India
129793,2023-08-19,713,ball pen,5,10,5,1,00292,India
129793,2023-08-19,707,marker,20,40,20,1,00292,India
569821,2023-08-19,711,TD kit,150,300,150,1,00366,India
569821,2023-08-19,710,geometry box,100,150,50,1,00366,India
569821,2023-08-19,705,stencil,10,20,10,1,00366,India
569821,2023-08-19,701,gel pen,5,10,5,1,00366,India
569821,2023-08-19,715,folder,5,15,10,1,00366,India
840734,2023-08-20,709,notebook,30,60,30,1,00165,India
539486,2023-08-20,715,folder,5,15,10,1,00115,India
539486,2023-08-20,703,eraser,1,3,2,1,00115,India
539486,2023-08-20,712,graph paper,20,40,20,1,00115,India
994019,2023-08-20,712,graph paper,20,40,20,1,00203,India
994019,2023-08-20,711,TD kit,150,300,150,1,00203,India
994019,2023-08-20,710,geometry box,100,150,50,1,00203,India
994019,2023-08-20,714,carbon paper,15,30,15,1,00203,India
528495,2023-08-20,709,notebook,30,60,30,1,00452,India
528495,2023-08-20,716,printing paper,200,400,200,1,00452,India
248791,2023-08-20,701,gel pen,5,10,5,1,00242,India
248791,2023-08-20,714,carbon paper,15,30,15,1,00242,India
248791,2023-08-20,716,printing paper,200,400,200,1,00242,India
484563,2023-08-20,711,TD kit,150,300,150,1,00493,India
588428,2023-08-20,711,TD kit,150,300,150,1,00177,India
588428,2023-08-20,701,gel pen,5,10,5,1,00177,India
926356,2023-08-20,706,sharpener,3,8,5,1,00257,India
404463,2023-08-20,705,stencil,10,20,10,1,00355,India
404463,2023-08-20,703,eraser,1,3,2,1,00355,India
404463,2023-08-20,710,geometry box,100,150,50,1,00355,India
112489,2023-08-20,716,printing paper,200,400,200,1,00110,India
112489,2023-08-20,712,graph paper,20,40,20,1,00110,India
112489,2023-08-20,717,spiral bound book,50,100,50,1,00110,India
112489,2023-08-20,713,ball pen,5,10,5,1,00110,India
112489,2023-08-20,704,scale,5,10,5,1,00110,India
649426,2023-08-20,707,marker,20,40,20,1,00382,India
649426,2023-08-20,714,carbon paper,15,30,15,1,00382,India
649426,2023-08-20,704,scale,5,10,5,1,00382,India
649426,2023-08-20,701,gel pen,5,10,5,1,00382,India
543364,2023-08-20,711,TD kit,150,300,150,1,00200,India
543364,2023-08-20,715,folder,5,15,10,1,00200,India
192782,2023-08-20,716,printing paper,200,400,200,1,00064,India
192782,2023-08-20,706,sharpener,3,8,5,1,00064,India
192782,2023-08-20,701,gel pen,5,10,5,1,00064,India
192782,2023-08-20,713,ball pen,5,10,5,1,00064,India
192782,2023-08-20,702,pencil,2,5,3,1,00064,India
894820,2023-08-20,704,scale,5,10,5,1,00327,India
894820,2023-08-20,708,sketchpen,15,40,25,1,00327,India
894820,2023-08-20,709,notebook,30,60,30,1,00327,India
837798,2023-08-20,717,spiral bound book,50,100,50,1,00482,India
837798,2023-08-20,710,geometry box,100,150,50,1,00482,India
837798,2023-08-20,716,printing paper,200,400,200,1,00482,India
327524,2023-08-20,711,TD kit,150,300,150,1,00202,India
327524,2023-08-20,707,marker,20,40,20,1,00202,India
677613,2023-08-20,716,printing paper,200,400,200,1,00032,India
677613,2023-08-20,713,ball pen,5,10,5,1,00032,India
677613,2023-08-20,711,TD kit,150,300,150,1,00032,India
637454,2023-08-20,710,geometry box,100,150,50,1,00136,India
637454,2023-08-20,715,folder,5,15,10,1,00136,India
637454,2023-08-20,714,carbon paper,15,30,15,1,00136,India
637454,2023-08-20,713,ball pen,5,10,5,1,00136,India
534910,2023-08-20,705,stencil,10,20,10,1,00089,India
534910,2023-08-20,717,spiral bound book,50,100,50,1,00089,India
534910,2023-08-20,703,eraser,1,3,2,1,00089,India
134478,2023-08-20,701,gel pen,5,10,5,1,00065,India
134478,2023-08-20,716,printing paper,200,400,200,1,00065,India
786224,2023-08-20,704,scale,5,10,5,1,00028,India
786224,2023-08-20,714,carbon paper,15,30,15,1,00028,India
786224,2023-08-20,707,marker,20,40,20,1,00028,India
150046,2023-08-20,704,scale,5,10,5,1,00267,India
150046,2023-08-20,712,graph paper,20,40,20,1,00267,India
702699,2023-08-20,706,sharpener,3,8,5,1,00383,India
702699,2023-08-20,713,ball pen,5,10,5,1,00383,India
702699,2023-08-20,707,marker,20,40,20,1,00383,India
563248,2023-08-20,715,folder,5,15,10,1,00119,India
563248,2023-08-20,704,scale,5,10,5,1,00119,India
563248,2023-08-20,711,TD kit,150,300,150,1,00119,India
563248,2023-08-20,707,marker,20,40,20,1,00119,India
219202,2023-08-20,716,printing paper,200,400,200,1,00458,India
219202,2023-08-20,714,carbon paper,15,30,15,1,00458,India
219202,2023-08-20,703,eraser,1,3,2,1,00458,India
699299,2023-08-20,705,stencil,10,20,10,1,00124,India
699299,2023-08-20,715,folder,5,15,10,1,00124,India
699299,2023-08-20,701,gel pen,5,10,5,1,00124,India
740713,2023-08-20,713,ball pen,5,10,5,1,00415,India
740713,2023-08-20,706,sharpener,3,8,5,1,00415,India
740713,2023-08-20,717,spiral bound book,50,100,50,1,00415,India
740713,2023-08-20,712,graph paper,20,40,20,1,00415,India
740713,2023-08-20,715,folder,5,15,10,1,00415,India
211297,2023-08-20,702,pencil,2,5,3,1,00457,India
211297,2023-08-20,717,spiral bound book,50,100,50,1,00457,India
211297,2023-08-20,708,sketchpen,15,40,25,1,00457,India
719836,2023-08-20,707,marker,20,40,20,1,00080,India
719836,2023-08-20,705,stencil,10,20,10,1,00080,India
719836,2023-08-20,708,sketchpen,15,40,25,1,00080,India
719836,2023-08-20,703,eraser,1,3,2,1,00080,India
719836,2023-08-20,701,gel pen,5,10,5,1,00080,India
444846,2023-08-20,705,stencil,10,20,10,1,00463,India
764966,2023-08-20,710,geometry box,100,150,50,1,00417,India
764966,2023-08-20,703,eraser,1,3,2,1,00417,India
764966,2023-08-20,705,stencil,10,20,10,1,00417,India
764966,2023-08-20,708,sketchpen,15,40,25,1,00417,India
887761,2023-08-20,701,gel pen,5,10,5,1,00267,India
887761,2023-08-20,702,pencil,2,5,3,1,00267,India
887761,2023-08-20,709,notebook,30,60,30,1,00267,India
887761,2023-08-20,713,ball pen,5,10,5,1,00267,India
887761,2023-08-20,710,geometry box,100,150,50,1,00267,India
432719,2023-08-20,710,geometry box,100,150,50,1,00105,India
432719,2023-08-20,704,scale,5,10,5,1,00105,India
432719,2023-08-20,716,printing paper,200,400,200,1,00105,India
432719,2023-08-20,705,stencil,10,20,10,1,00105,India
817543,2023-08-20,716,printing paper,200,400,200,1,00487,India
540883,2023-08-20,710,geometry box,100,150,50,1,00099,India
540883,2023-08-20,712,graph paper,20,40,20,1,00099,India
540883,2023-08-20,703,eraser,1,3,2,1,00099,India
540883,2023-08-20,709,notebook,30,60,30,1,00099,India
962489,2023-08-20,706,sharpener,3,8,5,1,00473,India
962489,2023-08-20,709,notebook,30,60,30,1,00473,India
962489,2023-08-20,704,scale,5,10,5,1,00473,India
868457,2023-08-20,705,stencil,10,20,10,1,00196,India
868457,2023-08-20,715,folder,5,15,10,1,00196,India
526722,2023-08-20,717,spiral bound book,50,100,50,1,00028,India
526722,2023-08-20,705,stencil,10,20,10,1,00028,India
526722,2023-08-20,716,printing paper,200,400,200,1,00028,India
965247,2023-08-20,704,scale,5,10,5,1,00391,India
965247,2023-08-20,707,marker,20,40,20,1,00391,India
965247,2023-08-20,712,graph paper,20,40,20,1,00391,India
965247,2023-08-20,709,notebook,30,60,30,1,00391,India
226737,2023-08-20,706,sharpener,3,8,5,1,00219,India
226737,2023-08-20,711,TD kit,150,300,150,1,00219,India
226737,2023-08-20,717,spiral bound book,50,100,50,1,00219,India
112682,2023-08-21,703,eraser,1,3,2,1,00136,India
112682,2023-08-21,714,carbon paper,15,30,15,1,00136,India
112682,2023-08-21,708,sketchpen,15,40,25,1,00136,India
112682,2023-08-21,712,graph paper,20,40,20,1,00136,India
874320,2023-08-21,704,scale,5,10,5,1,00428,India
847855,2023-08-21,702,pencil,2,5,3,1,00039,India
462318,2023-08-21,702,pencil,2,5,3,1,00371,India
694869,2023-08-21,712,graph paper,20,40,20,1,00332,India
694869,2023-08-21,709,notebook,30,60,30,1,00332,India
694869,2023-08-21,714,carbon paper,15,30,15,1,00332,India
903646,2023-08-21,706,sharpener,3,8,5,1,00422,India
903646,2023-08-21,702,pencil,2,5,3,1,00422,India
903646,2023-08-21,709,notebook,30,60,30,1,00422,India
903646,2023-08-21,717,spiral bound book,50,100,50,1,00422,India
903646,2023-08-21,703,eraser,1,3,2,1,00422,India
878070,2023-08-21,707,marker,20,40,20,1,00088,India
878070,2023-08-21,706,sharpener,3,8,5,1,00088,India
878070,2023-08-21,701,gel pen,5,10,5,1,00088,India
878070,2023-08-21,712,graph paper,20,40,20,1,00088,India
427871,2023-08-21,708,sketchpen,15,40,25,1,00443,India
427871,2023-08-21,713,ball pen,5,10,5,1,00443,India
427871,2023-08-21,707,marker,20,40,20,1,00443,India
236946,2023-08-21,711,TD kit,150,300,150,1,00299,India
236946,2023-08-21,701,gel pen,5,10,5,1,00299,India
364369,2023-08-21,709,notebook,30,60,30,1,00156,India
364369,2023-08-21,701,gel pen,5,10,5,1,00156,India
596335,2023-08-21,710,geometry box,100,150,50,1,00230,India
596335,2023-08-21,714,carbon paper,15,30,15,1,00230,India
143006,2023-08-21,717,spiral bound book,50,100,50,1,00455,India
143006,2023-08-21,707,marker,20,40,20,1,00455,India
143006,2023-08-21,713,ball pen,5,10,5,1,00455,India
143006,2023-08-21,710,geometry box,100,150,50,1,00455,India
864364,2023-08-21,712,graph paper,20,40,20,1,00129,India
128548,2023-08-21,713,ball pen,5,10,5,1,00016,India
128548,2023-08-21,709,notebook,30,60,30,1,00016,India
128548,2023-08-21,708,sketchpen,15,40,25,1,00016,India
128548,2023-08-21,702,pencil,2,5,3,1,00016,India
837856,2023-08-21,714,carbon paper,15,30,15,1,00491,India
837856,2023-08-21,715,folder,5,15,10,1,00491,India
837856,2023-08-21,717,spiral bound book,50,100,50,1,00491,India
609098,2023-08-21,708,sketchpen,15,40,25,1,00330,India
837660,2023-08-21,711,TD kit,150,300,150,1,00014,India
837660,2023-08-21,714,carbon paper,15,30,15,1,00014,India
997325,2023-08-21,715,folder,5,15,10,1,00490,India
997325,2023-08-21,702,pencil,2,5,3,1,00490,India
997325,2023-08-21,709,notebook,30,60,30,1,00490,India
741031,2023-08-21,706,sharpener,3,8,5,1,00198,India
741031,2023-08-21,709,notebook,30,60,30,1,00198,India
983938,2023-08-21,702,pencil,2,5,3,1,00130,India
983938,2023-08-21,716,printing paper,200,400,200,1,00130,India
354658,2023-08-21,713,ball pen,5,10,5,1,00227,India
354658,2023-08-21,706,sharpener,3,8,5,1,00227,India
354658,2023-08-21,705,stencil,10,20,10,1,00227,India
354658,2023-08-21,711,TD kit,150,300,150,1,00227,India
451294,2023-08-21,705,stencil,10,20,10,1,00320,India
451294,2023-08-21,714,carbon paper,15,30,15,1,00320,India
256676,2023-08-21,702,pencil,2,5,3,1,00460,India
256676,2023-08-21,717,spiral bound book,50,100,50,1,00460,India
256676,2023-08-21,706,sharpener,3,8,5,1,00460,India
256676,2023-08-21,707,marker,20,40,20,1,00460,India
803308,2023-08-21,702,pencil,2,5,3,1,00282,India
803308,2023-08-21,710,geometry box,100,150,50,1,00282,India
803308,2023-08-21,704,scale,5,10,5,1,00282,India
633981,2023-08-21,712,graph paper,20,40,20,1,00311,India
707007,2023-08-21,707,marker,20,40,20,1,00022,India
984981,2023-08-21,704,scale,5,10,5,1,00077,India
134774,2023-08-21,703,eraser,1,3,2,1,00440,India
134774,2023-08-21,708,sketchpen,15,40,25,1,00440,India
134774,2023-08-21,713,ball pen,5,10,5,1,00440,India
134774,2023-08-21,710,geometry box,100,150,50,1,00440,India
952295,2023-08-21,717,spiral bound book,50,100,50,1,00400,India
952295,2023-08-21,710,geometry box,100,150,50,1,00400,India
942136,2023-08-21,701,gel pen,5,10,5,1,00167,India
942136,2023-08-21,713,ball pen,5,10,5,1,00167,India
942136,2023-08-21,708,sketchpen,15,40,25,1,00167,India
942136,2023-08-21,705,stencil,10,20,10,1,00167,India
234689,2023-08-21,710,geometry box,100,150,50,1,00148,India
234689,2023-08-21,706,sharpener,3,8,5,1,00148,India
234689,2023-08-21,703,eraser,1,3,2,1,00148,India
437193,2023-08-21,710,geometry box,100,150,50,1,00208,India
437193,2023-08-21,705,stencil,10,20,10,1,00208,India
437193,2023-08-21,707,marker,20,40,20,1,00208,India
958515,2023-08-21,701,gel pen,5,10,5,1,00340,India
930946,2023-08-21,715,folder,5,15,10,1,00311,India
930946,2023-08-21,711,TD kit,150,300,150,1,00311,India
930946,2023-08-21,717,spiral bound book,50,100,50,1,00311,India
930946,2023-08-21,705,stencil,10,20,10,1,00311,India
439652,2023-08-21,713,ball pen,5,10,5,1,00342,India
439652,2023-08-21,711,TD kit,150,300,150,1,00342,India
439652,2023-08-21,712,graph paper,20,40,20,1,00342,India
455942,2023-08-21,705,stencil,10,20,10,1,00079,India
455942,2023-08-21,710,geometry box,100,150,50,1,00079,India
946898,2023-08-22,703,eraser,1,3,2,1,00355,India
946898,2023-08-22,708,sketchpen,15,40,25,1,00355,India
946898,2023-08-22,713,ball pen,5,10,5,1,00355,India
819356,2023-08-22,715,folder,5,15,10,1,00016,India
819356,2023-08-22,709,notebook,30,60,30,1,00016,India
819356,2023-08-22,706,sharpener,3,8,5,1,00016,India
819356,2023-08-22,716,printing paper,200,400,200,1,00016,India
404504,2023-08-22,708,sketchpen,15,40,25,1,00495,India
404504,2023-08-22,706,sharpener,3,8,5,1,00495,India
163430,2023-08-22,715,folder,5,15,10,1,00324,India
163430,2023-08-22,707,marker,20,40,20,1,00324,India
506452,2023-08-22,705,stencil,10,20,10,1,00003,India
274483,2023-08-22,712,graph paper,20,40,20,1,00152,India
274483,2023-08-22,709,notebook,30,60,30,1,00152,India
274483,2023-08-22,714,carbon paper,15,30,15,1,00152,India
938662,2023-08-22,705,stencil,10,20,10,1,00247,India
938662,2023-08-22,710,geometry box,100,150,50,1,00247,India
938662,2023-08-22,716,printing paper,200,400,200,1,00247,India
938662,2023-08-22,714,carbon paper,15,30,15,1,00247,India
557737,2023-08-22,716,printing paper,200,400,200,1,00447,India
557737,2023-08-22,708,sketchpen,15,40,25,1,00447,India
641615,2023-08-22,703,eraser,1,3,2,1,00237,India
137159,2023-08-22,709,notebook,30,60,30,1,00057,India
137159,2023-08-22,714,carbon paper,15,30,15,1,00057,India
949417,2023-08-22,717,spiral bound book,50,100,50,1,00283,India
949417,2023-08-22,715,folder,5,15,10,1,00283,India
949417,2023-08-22,713,ball pen,5,10,5,1,00283,India
949417,2023-08-22,701,gel pen,5,10,5,1,00283,India
879778,2023-08-22,717,spiral bound book,50,100,50,1,00204,India
931405,2023-08-22,715,folder,5,15,10,1,00318,India
931405,2023-08-22,705,stencil,10,20,10,1,00318,India
931405,2023-08-22,709,notebook,30,60,30,1,00318,India
931405,2023-08-22,716,printing paper,200,400,200,1,00318,India
819102,2023-08-22,709,notebook,30,60,30,1,00326,India
819102,2023-08-22,717,spiral bound book,50,100,50,1,00326,India
819102,2023-08-22,708,sketchpen,15,40,25,1,00326,India
819102,2023-08-22,714,carbon paper,15,30,15,1,00326,India
188002,2023-08-22,713,ball pen,5,10,5,1,00173,India
188002,2023-08-22,710,geometry box,100,150,50,1,00173,India
188002,2023-08-22,705,stencil,10,20,10,1,00173,India
553304,2023-08-22,707,marker,20,40,20,1,00159,India
553304,2023-08-22,701,gel pen,5,10,5,1,00159,India
553304,2023-08-22,702,pencil,2,5,3,1,00159,India
553304,2023-08-22,708,sketchpen,15,40,25,1,00159,India
967366,2023-08-22,710,geometry box,100,150,50,1,00240,India
967366,2023-08-22,714,carbon paper,15,30,15,1,00240,India
967366,2023-08-22,706,sharpener,3,8,5,1,00240,India
967366,2023-08-22,717,spiral bound book,50,100,50,1,00240,India
605778,2023-08-22,707,marker,20,40,20,1,00017,India
130323,2023-08-22,705,stencil,10,20,10,1,00345,India
100266,2023-08-22,710,geometry box,100,150,50,1,00102,India
100266,2023-08-22,703,eraser,1,3,2,1,00102,India
467918,2023-08-22,701,gel pen,5,10,5,1,00240,India
467918,2023-08-22,712,graph paper,20,40,20,1,00240,India
467918,2023-08-22,716,printing paper,200,400,200,1,00240,India
467918,2023-08-22,709,notebook,30,60,30,1,00240,India
467918,2023-08-22,704,scale,5,10,5,1,00240,India
942683,2023-08-22,717,spiral bound book,50,100,50,1,00121,India
942683,2023-08-22,712,graph paper,20,40,20,1,00121,India
942683,2023-08-22,715,folder,5,15,10,1,00121,India
678489,2023-08-22,710,geometry box,100,150,50,1,00096,India
678489,2023-08-22,712,graph paper,20,40,20,1,00096,India
166854,2023-08-22,702,pencil,2,5,3,1,00196,India
166854,2023-08-22,705,stencil,10,20,10,1,00196,India
166854,2023-08-22,706,sharpener,3,8,5,1,00196,India
166854,2023-08-22,701,gel pen,5,10,5,1,00196,India
820033,2023-08-22,713,ball pen,5,10,5,1,00486,India
820033,2023-08-22,709,notebook,30,60,30,1,00486,India
820033,2023-08-22,704,scale,5,10,5,1,00486,India
267993,2023-08-22,711,TD kit,150,300,150,1,00407,India
267993,2023-08-22,704,scale,5,10,5,1,00407,India
267993,2023-08-22,710,geometry box,100,150,50,1,00407,India
267993,2023-08-22,715,folder,5,15,10,1,00407,India
267993,2023-08-22,708,sketchpen,15,40,25,1,00407,India
761290,2023-08-22,717,spiral bound book,50,100,50,1,00269,India
761290,2023-08-22,713,ball pen,5,10,5,1,00269,India
761290,2023-08-22,704,scale,5,10,5,1,00269,India
922270,2023-08-22,710,geometry box,100,150,50,1,00403,India
922270,2023-08-22,708,sketchpen,15,40,25,1,00403,India
922270,2023-08-22,701,gel pen,5,10,5,1,00403,India
922270,2023-08-22,714,carbon paper,15,30,15,1,00403,India
183890,2023-08-22,701,gel pen,5,10,5,1,00382,India
183890,2023-08-22,715,folder,5,15,10,1,00382,India
260475,2023-08-22,706,sharpener,3,8,5,1,00294,India
260475,2023-08-22,703,eraser,1,3,2,1,00294,India
312305,2023-08-22,707,marker,20,40,20,1,00439,India
312305,2023-08-22,708,sketchpen,15,40,25,1,00439,India
312305,2023-08-22,710,geometry box,100,150,50,1,00439,India
312305,2023-08-22,714,carbon paper,15,30,15,1,00439,India
312834,2023-08-22,711,TD kit,150,300,150,1,00339,India
312834,2023-08-22,706,sharpener,3,8,5,1,00339,India
967348,2023-08-22,713,ball pen,5,10,5,1,00183,India
832024,2023-08-22,702,pencil,2,5,3,1,00400,India
832024,2023-08-22,707,marker,20,40,20,1,00400,India
880237,2023-08-22,713,ball pen,5,10,5,1,00089,India
880237,2023-08-22,712,graph paper,20,40,20,1,00089,India
880237,2023-08-22,706,sharpener,3,8,5,1,00089,India
880237,2023-08-22,708,sketchpen,15,40,25,1,00089,India
846170,2023-08-22,704,scale,5,10,5,1,00151,India
846170,2023-08-22,706,sharpener,3,8,5,1,00151,India
846170,2023-08-22,708,sketchpen,15,40,25,1,00151,India
846170,2023-08-22,714,carbon paper,15,30,15,1,00151,India
846170,2023-08-22,702,pencil,2,5,3,1,00151,India
739180,2023-08-22,710,geometry box,100,150,50,1,00277,India
739180,2023-08-22,712,graph paper,20,40,20,1,00277,India
755496,2023-08-22,705,stencil,10,20,10,1,00093,India
755496,2023-08-22,711,TD kit,150,300,150,1,00093,India
194825,2023-08-22,711,TD kit,150,300,150,1,00301,India
194825,2023-08-22,701,gel pen,5,10,5,1,00301,India
194825,2023-08-22,715,folder,5,15,10,1,00301,India
231728,2023-08-22,709,notebook,30,60,30,1,00324,India
788873,2023-08-22,705,stencil,10,20,10,1,00266,India
788873,2023-08-22,711,TD kit,150,300,150,1,00266,India
788873,2023-08-22,710,geometry box,100,150,50,1,00266,India
733466,2023-08-22,709,notebook,30,60,30,1,00324,India
733466,2023-08-22,708,sketchpen,15,40,25,1,00324,India
733466,2023-08-22,716,printing paper,200,400,200,1,00324,India
397544,2023-08-22,705,stencil,10,20,10,1,00447,India
397544,2023-08-22,706,sharpener,3,8,5,1,00447,India
922200,2023-08-22,717,spiral bound book,50,100,50,1,00155,India
922200,2023-08-22,702,pencil,2,5,3,1,00155,India
922200,2023-08-22,714,carbon paper,15,30,15,1,00155,India
922200,2023-08-22,704,scale,5,10,5,1,00155,India
925786,2023-08-22,707,marker,20,40,20,1,00359,India
925786,2023-08-22,717,spiral bound book,50,100,50,1,00359,India
925786,2023-08-22,704,scale,5,10,5,1,00359,India
166518,2023-08-22,707,marker,20,40,20,1,00414,India
166518,2023-08-22,709,notebook,30,60,30,1,00414,India
166518,2023-08-22,716,printing paper,200,400,200,1,00414,India
166518,2023-08-22,705,stencil,10,20,10,1,00414,India
166518,2023-08-22,704,scale,5,10,5,1,00414,India
930717,2023-08-22,705,stencil,10,20,10,1,00025,India
930717,2023-08-22,716,printing paper,200,400,200,1,00025,India
152839,2023-08-23,708,sketchpen,15,40,25,1,00383,India
152839,2023-08-23,703,eraser,1,3,2,1,00383,India
152839,2023-08-23,702,pencil,2,5,3,1,00383,India
152839,2023-08-23,706,sharpener,3,8,5,1,00383,India
359079,2023-08-23,717,spiral bound book,50,100,50,1,00013,India
859668,2023-08-23,708,sketchpen,15,40,25,1,00182,India
859668,2023-08-23,713,ball pen,5,10,5,1,00182,India
733080,2023-08-23,715,folder,5,15,10,1,00492,India
733080,2023-08-23,712,graph paper,20,40,20,1,00492,India
243117,2023-08-23,708,sketchpen,15,40,25,1,00100,India
243117,2023-08-23,707,marker,20,40,20,1,00100,India
255437,2023-08-23,707,marker,20,40,20,1,00334,India
255437,2023-08-23,708,sketchpen,15,40,25,1,00334,India
255437,2023-08-23,701,gel pen,5,10,5,1,00334,India
255437,2023-08-23,710,geometry box,100,150,50,1,00334,India
514319,2023-08-23,716,printing paper,200,400,200,1,00395,India
514319,2023-08-23,701,gel pen,5,10,5,1,00395,India
514319,2023-08-23,705,stencil,10,20,10,1,00395,India
514319,2023-08-23,707,marker,20,40,20,1,00395,India
514319,2023-08-23,708,sketchpen,15,40,25,1,00395,India
416582,2023-08-23,708,sketchpen,15,40,25,1,00262,India
218519,2023-08-23,704,scale,5,10,5,1,00007,India
218519,2023-08-23,707,marker,20,40,20,1,00007,India
218519,2023-08-23,713,ball pen,5,10,5,1,00007,India
218519,2023-08-23,716,printing paper,200,400,200,1,00007,India
218519,2023-08-23,710,geometry box,100,150,50,1,00007,India
978762,2023-08-23,716,printing paper,200,400,200,1,00474,India
978762,2023-08-23,701,gel pen,5,10,5,1,00474,India
124420,2023-08-23,707,marker,20,40,20,1,00046,India
124420,2023-08-23,701,gel pen,5,10,5,1,00046,India
124420,2023-08-23,706,sharpener,3,8,5,1,00046,India
124420,2023-08-23,710,geometry box,100,150,50,1,00046,India
174599,2023-08-23,715,folder,5,15,10,1,00018,India
174599,2023-08-23,711,TD kit,150,300,150,1,00018,India
174599,2023-08-23,716,printing paper,200,400,200,1,00018,India
174599,2023-08-23,713,ball pen,5,10,5,1,00018,India
840517,2023-08-23,706,sharpener,3,8,5,1,00055,India
840517,2023-08-23,715,folder,5,15,10,1,00055,India
840517,2023-08-23,717,spiral bound book,50,100,50,1,00055,India
840517,2023-08-23,707,marker,20,40,20,1,00055,India
840517,2023-08-23,716,printing paper,200,400,200,1,00055,India
967598,2023-08-23,714,carbon paper,15,30,15,1,00314,India
967598,2023-08-23,716,printing paper,200,400,200,1,00314,India
967598,2023-08-23,708,sketchpen,15,40,25,1,00314,India
967598,2023-08-23,706,sharpener,3,8,5,1,00314,India
206185,2023-08-23,709,notebook,30,60,30,1,00267,India
333927,2023-08-23,702,pencil,2,5,3,1,00377,India
333927,2023-08-23,713,ball pen,5,10,5,1,00377,India
767275,2023-08-23,715,folder,5,15,10,1,00492,India
767275,2023-08-23,707,marker,20,40,20,1,00492,India
767275,2023-08-23,706,sharpener,3,8,5,1,00492,India
767275,2023-08-23,708,sketchpen,15,40,25,1,00492,India
767275,2023-08-23,713,ball pen,5,10,5,1,00492,India
544127,2023-08-23,709,notebook,30,60,30,1,00037,India
544127,2023-08-23,712,graph paper,20,40,20,1,00037,India
702328,2023-08-23,715,folder,5,15,10,1,00101,India
702328,2023-08-23,702,pencil,2,5,3,1,00101,India
100468,2023-08-23,709,notebook,30,60,30,1,00434,India
100468,2023-08-23,713,ball pen,5,10,5,1,00434,India
100468,2023-08-23,706,sharpener,3,8,5,1,00434,India
100468,2023-08-23,711,TD kit,150,300,150,1,00434,India
124469,2023-08-23,711,TD kit,150,300,150,1,00075,India
292992,2023-08-23,707,marker,20,40,20,1,00145,India
292992,2023-08-23,710,geometry box,100,150,50,1,00145,India
292992,2023-08-23,713,ball pen,5,10,5,1,00145,India
507528,2023-08-23,712,graph paper,20,40,20,1,00355,India
507528,2023-08-23,711,TD kit,150,300,150,1,00355,India
507528,2023-08-23,716,printing paper,200,400,200,1,00355,India
507528,2023-08-23,714,carbon paper,15,30,15,1,00355,India
273071,2023-08-23,702,pencil,2,5,3,1,00376,India
273071,2023-08-23,707,marker,20,40,20,1,00376,India
462095,2023-08-23,708,sketchpen,15,40,25,1,00475,India
462095,2023-08-23,701,gel pen,5,10,5,1,00475,India
462095,2023-08-23,710,geometry box,100,150,50,1,00475,India
462095,2023-08-23,707,marker,20,40,20,1,00475,India
273635,2023-08-23,710,geometry box,100,150,50,1,00250,India
110451,2023-08-23,716,printing paper,200,400,200,1,00391,India
110451,2023-08-23,703,eraser,1,3,2,1,00391,India
110451,2023-08-23,704,scale,5,10,5,1,00391,India
110451,2023-08-23,705,stencil,10,20,10,1,00391,India
383220,2023-08-23,703,eraser,1,3,2,1,00220,India
383220,2023-08-23,706,sharpener,3,8,5,1,00220,India
383220,2023-08-23,717,spiral bound book,50,100,50,1,00220,India
528293,2023-08-23,706,sharpener,3,8,5,1,00203,India
768560,2023-08-23,713,ball pen,5,10,5,1,00141,India
768560,2023-08-23,701,gel pen,5,10,5,1,00141,India
497948,2023-08-24,705,stencil,10,20,10,1,00391,India
497948,2023-08-24,706,sharpener,3,8,5,1,00391,India
497948,2023-08-24,702,pencil,2,5,3,1,00391,India
497948,2023-08-24,717,spiral bound book,50,100,50,1,00391,India
322297,2023-08-24,712,graph paper,20,40,20,1,00139,India
322297,2023-08-24,716,printing paper,200,400,200,1,00139,India
322297,2023-08-24,708,sketchpen,15,40,25,1,00139,India
322297,2023-08-24,705,stencil,10,20,10,1,00139,India
532097,2023-08-24,707,marker,20,40,20,1,00421,India
532097,2023-08-24,708,sketchpen,15,40,25,1,00421,India
532097,2023-08-24,705,stencil,10,20,10,1,00421,India
777149,2023-08-24,712,graph paper,20,40,20,1,00070,India
777149,2023-08-24,713,ball pen,5,10,5,1,00070,India
918162,2023-08-24,715,folder,5,15,10,1,00142,India
918162,2023-08-24,711,TD kit,150,300,150,1,00142,India
918162,2023-08-24,704,scale,5,10,5,1,00142,India
864949,2023-08-24,714,carbon paper,15,30,15,1,00322,India
918374,2023-08-24,703,eraser,1,3,2,1,00172,India
918374,2023-08-24,711,TD kit,150,300,150,1,00172,India
230827,2023-08-24,717,spiral bound book,50,100,50,1,00051,India
230827,2023-08-24,707,marker,20,40,20,1,00051,India
230827,2023-08-24,716,printing paper,200,400,200,1,00051,India
230827,2023-08-24,705,stencil,10,20,10,1,00051,India
230827,2023-08-24,711,TD kit,150,300,150,1,00051,India
404255,2023-08-24,711,TD kit,150,300,150,1,00202,India
404255,2023-08-24,709,notebook,30,60,30,1,00202,India
488434,2023-08-24,707,marker,20,40,20,1,00094,India
488434,2023-08-24,701,gel pen,5,10,5,1,00094,India
488434,2023-08-24,713,ball pen,5,10,5,1,00094,India
488434,2023-08-24,704,scale,5,10,5,1,00094,India
488434,2023-08-24,712,graph paper,20,40,20,1,00094,India
508633,2023-08-24,702,pencil,2,5,3,1,00289,India
886648,2023-08-24,715,folder,5,15,10,1,00315,India
886648,2023-08-24,717,spiral bound book,50,100,50,1,00315,India
886648,2023-08-24,713,ball pen,5,10,5,1,00315,India
886648,2023-08-24,704,scale,5,10,5,1,00315,India
591960,2023-08-24,707,marker,20,40,20,1,00117,India
591960,2023-08-24,713,ball pen,5,10,5,1,00117,India
874333,2023-08-24,703,eraser,1,3,2,1,00133,India
874333,2023-08-24,705,stencil,10,20,10,1,00133,India
874333,2023-08-24,715,folder,5,15,10,1,00133,India
335351,2023-08-24,714,carbon paper,15,30,15,1,00139,India
139120,2023-08-24,713,ball pen,5,10,5,1,00385,India
139120,2023-08-24,708,sketchpen,15,40,25,1,00385,India
139120,2023-08-24,711,TD kit,150,300,150,1,00385,India
542352,2023-08-24,711,TD kit,150,300,150,1,00431,India
542352,2023-08-24,712,graph paper,20,40,20,1,00431,India
542352,2023-08-24,703,eraser,1,3,2,1,00431,India
542352,2023-08-24,713,ball pen,5,10,5,1,00431,India
796610,2023-08-24,702,pencil,2,5,3,1,00123,India
796610,2023-08-24,708,sketchpen,15,40,25,1,00123,India
796610,2023-08-24,711,TD kit,150,300,150,1,00123,India
796610,2023-08-24,713,ball pen,5,10,5,1,00123,India
796610,2023-08-24,712,graph paper,20,40,20,1,00123,India
227281,2023-08-24,708,sketchpen,15,40,25,1,00049,India
227281,2023-08-24,714,carbon paper,15,30,15,1,00049,India
227281,2023-08-24,701,gel pen,5,10,5,1,00049,India
227281,2023-08-24,710,geometry box,100,150,50,1,00049,India
657674,2023-08-24,704,scale,5,10,5,1,00047,India
657674,2023-08-24,712,graph paper,20,40,20,1,00047,India
657674,2023-08-24,717,spiral bound book,50,100,50,1,00047,India
657674,2023-08-24,706,sharpener,3,8,5,1,00047,India
224148,2023-08-24,717,spiral bound book,50,100,50,1,00394,India
224148,2023-08-24,706,sharpener,3,8,5,1,00394,India
224148,2023-08-24,714,carbon paper,15,30,15,1,00394,India
732186,2023-08-24,715,folder,5,15,10,1,00455,India
172069,2023-08-24,701,gel pen,5,10,5,1,00253,India
172069,2023-08-24,703,eraser,1,3,2,1,00253,India
829727,2023-08-24,702,pencil,2,5,3,1,00304,India
400510,2023-08-24,708,sketchpen,15,40,25,1,00268,India
400510,2023-08-24,711,TD kit,150,300,150,1,00268,India
556352,2023-08-24,715,folder,5,15,10,1,00376,India
556352,2023-08-24,716,printing paper,200,400,200,1,00376,India
556352,2023-08-24,701,gel pen,5,10,5,1,00376,India
496028,2023-08-24,708,sketchpen,15,40,25,1,00026,India
729003,2023-08-24,710,geometry box,100,150,50,1,00330,India
729003,2023-08-24,711,TD kit,150,300,150,1,00330,India
729003,2023-08-24,712,graph paper,20,40,20,1,00330,India
528139,2023-08-24,711,TD kit,150,300,150,1,00090,India
528139,2023-08-24,705,stencil,10,20,10,1,00090,India
911288,2023-08-24,708,sketchpen,15,40,25,1,00087,India
911288,2023-08-24,707,marker,20,40,20,1,00087,India
122253,2023-08-24,708,sketchpen,15,40,25,1,00017,India
122253,2023-08-24,709,notebook,30,60,30,1,00017,India
122253,2023-08-24,703,eraser,1,3,2,1,00017,India
122253,2023-08-24,710,geometry box,100,150,50,1,00017,India
122253,2023-08-24,706,sharpener,3,8,5,1,00017,India
389647,2023-08-24,704,scale,5,10,5,1,00011,India
389647,2023-08-24,708,sketchpen,15,40,25,1,00011,India
389647,2023-08-24,711,TD kit,150,300,150,1,00011,India
190508,2023-08-24,703,eraser,1,3,2,1,00016,India
190508,2023-08-24,715,folder,5,15,10,1,00016,India
916986,2023-08-24,704,scale,5,10,5,1,00154,India
748891,2023-08-24,707,marker,20,40,20,1,00182,India
748891,2023-08-24,712,graph paper,20,40,20,1,00182,India
748891,2023-08-24,709,notebook,30,60,30,1,00182,India
221322,2023-08-24,712,graph paper,20,40,20,1,00228,India
444421,2023-08-24,715,folder,5,15,10,1,00089,India
444421,2023-08-24,703,eraser,1,3,2,1,00089,India
444421,2023-08-24,711,TD kit,150,300,150,1,00089,India
569784,2023-08-24,707,marker,20,40,20,1,00231,India
569784,2023-08-24,710,geometry box,100,150,50,1,00231,India
569784,2023-08-24,716,printing paper,200,400,200,1,00231,India
951546,2023-08-24,709,notebook,30,60,30,1,00187,India
951546,2023-08-24,716,printing paper,200,400,200,1,00187,India
951546,2023-08-24,704,scale,5,10,5,1,00187,India
236875,2023-08-24,708,sketchpen,15,40,25,1,00334,India
236875,2023-08-24,715,folder,5,15,10,1,00334,India
236875,2023-08-24,703,eraser,1,3,2,1,00334,India
169387,2023-08-24,701,gel pen,5,10,5,1,00265,India
169387,2023-08-24,708,sketchpen,15,40,25,1,00265,India
169387,2023-08-24,709,notebook,30,60,30,1,00265,India
169387,2023-08-24,712,graph paper,20,40,20,1,00265,India
169387,2023-08-24,714,carbon paper,15,30,15,1,00265,India
843171,2023-08-24,711,TD kit,150,300,150,1,00375,India
843171,2023-08-24,710,geometry box,100,150,50,1,00375,India
843171,2023-08-24,714,carbon paper,15,30,15,1,00375,India
702425,2023-08-24,717,spiral bound book,50,100,50,1,00045,India
702425,2023-08-24,715,folder,5,15,10,1,00045,India
702425,2023-08-24,701,gel pen,5,10,5,1,00045,India
678775,2023-08-24,717,spiral bound book,50,100,50,1,00130,India
678775,2023-08-24,705,stencil,10,20,10,1,00130,India
678775,2023-08-24,712,graph paper,20,40,20,1,00130,India
678775,2023-08-24,711,TD kit,150,300,150,1,00130,India
987067,2023-08-25,714,carbon paper,15,30,15,1,00379,India
987067,2023-08-25,708,sketchpen,15,40,25,1,00379,India
895953,2023-08-25,703,eraser,1,3,2,1,00237,India
895953,2023-08-25,705,stencil,10,20,10,1,00237,India
895953,2023-08-25,715,folder,5,15,10,1,00237,India
895953,2023-08-25,701,gel pen,5,10,5,1,00237,India
254501,2023-08-25,705,stencil,10,20,10,1,00286,India
254501,2023-08-25,716,printing paper,200,400,200,1,00286,India
254501,2023-08-25,709,notebook,30,60,30,1,00286,India
337377,2023-08-25,708,sketchpen,15,40,25,1,00027,India
337377,2023-08-25,704,scale,5,10,5,1,00027,India
337377,2023-08-25,702,pencil,2,5,3,1,00027,India
337377,2023-08-25,707,marker,20,40,20,1,00027,India
337377,2023-08-25,716,printing paper,200,400,200,1,00027,India
175493,2023-08-25,706,sharpener,3,8,5,1,00496,India
550768,2023-08-25,716,printing paper,200,400,200,1,00487,India
550768,2023-08-25,708,sketchpen,15,40,25,1,00487,India
550768,2023-08-25,703,eraser,1,3,2,1,00487,India
550768,2023-08-25,712,graph paper,20,40,20,1,00487,India
550768,2023-08-25,709,notebook,30,60,30,1,00487,India
889948,2023-08-25,714,carbon paper,15,30,15,1,00197,India
889948,2023-08-25,706,sharpener,3,8,5,1,00197,India
889948,2023-08-25,707,marker,20,40,20,1,00197,India
889948,2023-08-25,715,folder,5,15,10,1,00197,India
695466,2023-08-25,712,graph paper,20,40,20,1,00347,India
482370,2023-08-25,701,gel pen,5,10,5,1,00200,India
281347,2023-08-25,716,printing paper,200,400,200,1,00331,India
281347,2023-08-25,715,folder,5,15,10,1,00331,India
298035,2023-08-25,716,printing paper,200,400,200,1,00154,India
298035,2023-08-25,703,eraser,1,3,2,1,00154,India
499045,2023-08-25,704,scale,5,10,5,1,00156,India
499045,2023-08-25,701,gel pen,5,10,5,1,00156,India
499045,2023-08-25,716,printing paper,200,400,200,1,00156,India
567449,2023-08-25,703,eraser,1,3,2,1,00405,India
567449,2023-08-25,702,pencil,2,5,3,1,00405,India
567449,2023-08-25,707,marker,20,40,20,1,00405,India
681767,2023-08-25,711,TD kit,150,300,150,1,00335,India
681767,2023-08-25,712,graph paper,20,40,20,1,00335,India
681767,2023-08-25,708,sketchpen,15,40,25,1,00335,India
831931,2023-08-25,716,printing paper,200,400,200,1,00247,India
470241,2023-08-25,701,gel pen,5,10,5,1,00049,India
368831,2023-08-25,707,marker,20,40,20,1,00077,India
368831,2023-08-25,710,geometry box,100,150,50,1,00077,India
913402,2023-08-25,705,stencil,10,20,10,1,00490,India
913402,2023-08-25,710,geometry box,100,150,50,1,00490,India
913402,2023-08-25,704,scale,5,10,5,1,00490,India
913402,2023-08-25,714,carbon paper,15,30,15,1,00490,India
489118,2023-08-25,710,geometry box,100,150,50,1,00263,India
489118,2023-08-25,717,spiral bound book,50,100,50,1,00263,India
489118,2023-08-25,715,folder,5,15,10,1,00263,India
782308,2023-08-25,716,printing paper,200,400,200,1,00225,India
782308,2023-08-25,710,geometry box,100,150,50,1,00225,India
782308,2023-08-25,702,pencil,2,5,3,1,00225,India
659478,2023-08-25,704,scale,5,10,5,1,00096,India
659478,2023-08-25,707,marker,20,40,20,1,00096,India
307191,2023-08-25,716,printing paper,200,400,200,1,00434,India
307191,2023-08-25,713,ball pen,5,10,5,1,00434,India
307191,2023-08-25,701,gel pen,5,10,5,1,00434,India
440084,2023-08-25,713,ball pen,5,10,5,1,00431,India
440084,2023-08-25,703,eraser,1,3,2,1,00431,India
440084,2023-08-25,702,pencil,2,5,3,1,00431,India
440084,2023-08-25,704,scale,5,10,5,1,00431,India
539504,2023-08-25,705,stencil,10,20,10,1,00150,India
769919,2023-08-25,709,notebook,30,60,30,1,00270,India
769919,2023-08-25,716,printing paper,200,400,200,1,00270,India
769919,2023-08-25,717,spiral bound book,50,100,50,1,00270,India
769919,2023-08-25,711,TD kit,150,300,150,1,00270,India
829605,2023-08-25,703,eraser,1,3,2,1,00375,India
727041,2023-08-25,704,scale,5,10,5,1,00233,India
727041,2023-08-25,701,gel pen,5,10,5,1,00233,India
727041,2023-08-25,714,carbon paper,15,30,15,1,00233,India
727041,2023-08-25,707,marker,20,40,20,1,00233,India
751238,2023-08-25,706,sharpener,3,8,5,1,00045,India
751238,2023-08-25,707,marker,20,40,20,1,00045,India
751238,2023-08-25,715,folder,5,15,10,1,00045,India
672074,2023-08-25,707,marker,20,40,20,1,00080,India
672074,2023-08-25,715,folder,5,15,10,1,00080,India
672074,2023-08-25,708,sketchpen,15,40,25,1,00080,India
672074,2023-08-25,717,spiral bound book,50,100,50,1,00080,India
672074,2023-08-25,701,gel pen,5,10,5,1,00080,India
204456,2023-08-25,712,graph paper,20,40,20,1,00061,India
204456,2023-08-25,704,scale,5,10,5,1,00061,India
327375,2023-08-25,715,folder,5,15,10,1,00358,India
422854,2023-08-25,704,scale,5,10,5,1,00093,India
203790,2023-08-25,702,pencil,2,5,3,1,00404,India
203790,2023-08-25,704,scale,5,10,5,1,00404,India
203790,2023-08-25,705,stencil,10,20,10,1,00404,India
203790,2023-08-25,714,carbon paper,15,30,15,1,00404,India
554251,2023-08-25,705,stencil,10,20,10,1,00351,India
554251,2023-08-25,704,scale,5,10,5,1,00351,India
554251,2023-08-25,702,pencil,2,5,3,1,00351,India
554251,2023-08-25,703,eraser,1,3,2,1,00351,India
225837,2023-08-25,714,carbon paper,15,30,15,1,00169,India
895401,2023-08-25,710,geometry box,100,150,50,1,00430,India
895401,2023-08-25,712,graph paper,20,40,20,1,00430,India
629256,2023-08-25,711,TD kit,150,300,150,1,00092,India
629256,2023-08-25,710,geometry box,100,150,50,1,00092,India
629256,2023-08-25,704,scale,5,10,5,1,00092,India
629256,2023-08-25,715,folder,5,15,10,1,00092,India
477657,2023-08-25,714,carbon paper,15,30,15,1,00066,India
477657,2023-08-25,713,ball pen,5,10,5,1,00066,India
477657,2023-08-25,715,folder,5,15,10,1,00066,India
477657,2023-08-25,716,printing paper,200,400,200,1,00066,India
477657,2023-08-25,702,pencil,2,5,3,1,00066,India
169440,2023-08-25,712,graph paper,20,40,20,1,00075,India
169440,2023-08-25,702,pencil,2,5,3,1,00075,India
169440,2023-08-25,706,sharpener,3,8,5,1,00075,India
216639,2023-08-25,710,geometry box,100,150,50,1,00397,India
216639,2023-08-25,714,carbon paper,15,30,15,1,00397,India
216639,2023-08-25,717,spiral bound book,50,100,50,1,00397,India
802640,2023-08-25,712,graph paper,20,40,20,1,00364,India
802640,2023-08-25,704,scale,5,10,5,1,00364,India
802640,2023-08-25,701,gel pen,5,10,5,1,00364,India
802640,2023-08-25,715,folder,5,15,10,1,00364,India
572556,2023-08-25,713,ball pen,5,10,5,1,00195,India
768128,2023-08-26,707,marker,20,40,20,1,00395,India
193778,2023-08-26,712,graph paper,20,40,20,1,00038,India
256092,2023-08-26,713,ball pen,5,10,5,1,00224,India
256092,2023-08-26,716,printing paper,200,400,200,1,00224,India
256092,2023-08-26,708,sketchpen,15,40,25,1,00224,India
884630,2023-08-26,704,scale,5,10,5,1,00282,India
884630,2023-08-26,706,sharpener,3,8,5,1,00282,India
978067,2023-08-26,717,spiral bound book,50,100,50,1,00465,India
978067,2023-08-26,710,geometry box,100,150,50,1,00465,India
778435,2023-08-26,714,carbon paper,15,30,15,1,00162,India
778435,2023-08-26,717,spiral bound book,50,100,50,1,00162,India
778435,2023-08-26,705,stencil,10,20,10,1,00162,India
820710,2023-08-26,706,sharpener,3,8,5,1,00434,India
820710,2023-08-26,714,carbon paper,15,30,15,1,00434,India
820710,2023-08-26,702,pencil,2,5,3,1,00434,India
820710,2023-08-26,703,eraser,1,3,2,1,00434,India
820710,2023-08-26,710,geometry box,100,150,50,1,00434,India
483867,2023-08-26,703,eraser,1,3,2,1,00075,India
122657,2023-08-26,706,sharpener,3,8,5,1,00286,India
122657,2023-08-26,709,notebook,30,60,30,1,00286,India
122657,2023-08-26,717,spiral bound book,50,100,50,1,00286,India
122657,2023-08-26,715,folder,5,15,10,1,00286,India
443775,2023-08-26,716,printing paper,200,400,200,1,00388,India
443775,2023-08-26,710,geometry box,100,150,50,1,00388,India
606977,2023-08-26,701,gel pen,5,10,5,1,00051,India
606977,2023-08-26,702,pencil,2,5,3,1,00051,India
606977,2023-08-26,709,notebook,30,60,30,1,00051,India
726915,2023-08-26,711,TD kit,150,300,150,1,00002,India
894952,2023-08-26,711,TD kit,150,300,150,1,00365,India
894952,2023-08-26,712,graph paper,20,40,20,1,00365,India
894952,2023-08-26,708,sketchpen,15,40,25,1,00365,India
894952,2023-08-26,707,marker,20,40,20,1,00365,India
545402,2023-08-26,702,pencil,2,5,3,1,00449,India
545402,2023-08-26,712,graph paper,20,40,20,1,00449,India
545402,2023-08-26,701,gel pen,5,10,5,1,00449,India
837049,2023-08-26,703,eraser,1,3,2,1,00071,India
837049,2023-08-26,713,ball pen,5,10,5,1,00071,India
837049,2023-08-26,715,folder,5,15,10,1,00071,India
217925,2023-08-26,708,sketchpen,15,40,25,1,00201,India
217925,2023-08-26,705,stencil,10,20,10,1,00201,India
232884,2023-08-26,709,notebook,30,60,30,1,00434,India
232884,2023-08-26,712,graph paper,20,40,20,1,00434,India
232884,2023-08-26,708,sketchpen,15,40,25,1,00434,India
232884,2023-08-26,704,scale,5,10,5,1,00434,India
232884,2023-08-26,701,gel pen,5,10,5,1,00434,India
323683,2023-08-26,705,stencil,10,20,10,1,00301,India
625165,2023-08-26,709,notebook,30,60,30,1,00494,India
226318,2023-08-26,705,stencil,10,20,10,1,00422,India
226318,2023-08-26,703,eraser,1,3,2,1,00422,India
226318,2023-08-26,710,geometry box,100,150,50,1,00422,India
225019,2023-08-26,717,spiral bound book,50,100,50,1,00499,India
332633,2023-08-26,713,ball pen,5,10,5,1,00164,India
332633,2023-08-26,710,geometry box,100,150,50,1,00164,India
332633,2023-08-26,709,notebook,30,60,30,1,00164,India
332633,2023-08-26,716,printing paper,200,400,200,1,00164,India
332633,2023-08-26,712,graph paper,20,40,20,1,00164,India
244516,2023-08-26,710,geometry box,100,150,50,1,00312,India
288751,2023-08-26,704,scale,5,10,5,1,00264,India
288751,2023-08-26,709,notebook,30,60,30,1,00264,India
288751,2023-08-26,717,spiral bound book,50,100,50,1,00264,India
599407,2023-08-26,709,notebook,30,60,30,1,00053,India
599407,2023-08-26,715,folder,5,15,10,1,00053,India
599407,2023-08-26,707,marker,20,40,20,1,00053,India
280483,2023-08-26,709,notebook,30,60,30,1,00143,India
280483,2023-08-26,701,gel pen,5,10,5,1,00143,India
280483,2023-08-26,713,ball pen,5,10,5,1,00143,India
326648,2023-08-26,716,printing paper,200,400,200,1,00176,India
326648,2023-08-26,713,ball pen,5,10,5,1,00176,India
491360,2023-08-26,712,graph paper,20,40,20,1,00023,India
586168,2023-08-26,716,printing paper,200,400,200,1,00350,India
586168,2023-08-26,703,eraser,1,3,2,1,00350,India
586168,2023-08-26,713,ball pen,5,10,5,1,00350,India
586168,2023-08-26,715,folder,5,15,10,1,00350,India
873510,2023-08-26,710,geometry box,100,150,50,1,00342,India
873510,2023-08-26,702,pencil,2,5,3,1,00342,India
873510,2023-08-26,711,TD kit,150,300,150,1,00342,India
873510,2023-08-26,713,ball pen,5,10,5,1,00342,India
531355,2023-08-26,704,scale,5,10,5,1,00475,India
531355,2023-08-26,709,notebook,30,60,30,1,00475,India
769926,2023-08-26,713,ball pen,5,10,5,1,00181,India
604244,2023-08-26,709,notebook,30,60,30,1,00168,India
604244,2023-08-26,711,TD kit,150,300,150,1,00168,India
604244,2023-08-26,713,ball pen,5,10,5,1,00168,India
604244,2023-08-26,702,pencil,2,5,3,1,00168,India
643950,2023-08-26,711,TD kit,150,300,150,1,00354,India
643950,2023-08-26,713,ball pen,5,10,5,1,00354,India
643950,2023-08-26,716,printing paper,200,400,200,1,00354,India
258970,2023-08-26,710,geometry box,100,150,50,1,00162,India
854738,2023-08-26,705,stencil,10,20,10,1,00324,India
854738,2023-08-26,704,scale,5,10,5,1,00324,India
854738,2023-08-26,709,notebook,30,60,30,1,00324,India
854738,2023-08-26,710,geometry box,100,150,50,1,00324,India
546791,2023-08-26,704,scale,5,10,5,1,00071,India
546791,2023-08-26,705,stencil,10,20,10,1,00071,India
546791,2023-08-26,717,spiral bound book,50,100,50,1,00071,India
546791,2023-08-26,708,sketchpen,15,40,25,1,00071,India
223390,2023-08-26,706,sharpener,3,8,5,1,00325,India
223390,2023-08-26,708,sketchpen,15,40,25,1,00325,India
223390,2023-08-26,709,notebook,30,60,30,1,00325,India
223390,2023-08-26,711,TD kit,150,300,150,1,00325,India
223390,2023-08-26,712,graph paper,20,40,20,1,00325,India
746561,2023-08-26,702,pencil,2,5,3,1,00244,India
997049,2023-08-26,702,pencil,2,5,3,1,00143,India
997049,2023-08-26,701,gel pen,5,10,5,1,00143,India
624992,2023-08-27,711,TD kit,150,300,150,1,00186,India
624992,2023-08-27,703,eraser,1,3,2,1,00186,India
624992,2023-08-27,715,folder,5,15,10,1,00186,India
624992,2023-08-27,712,graph paper,20,40,20,1,00186,India
866342,2023-08-27,701,gel pen,5,10,5,1,00381,India
866342,2023-08-27,705,stencil,10,20,10,1,00381,India
866342,2023-08-27,708,sketchpen,15,40,25,1,00381,India
866342,2023-08-27,716,printing paper,200,400,200,1,00381,India
798622,2023-08-27,712,graph paper,20,40,20,1,00373,India
798622,2023-08-27,715,folder,5,15,10,1,00373,India
583113,2023-08-27,706,sharpener,3,8,5,1,00441,India
838155,2023-08-27,716,printing paper,200,400,200,1,00101,India
838155,2023-08-27,712,graph paper,20,40,20,1,00101,India
379921,2023-08-27,709,notebook,30,60,30,1,00064,India
379921,2023-08-27,716,printing paper,200,400,200,1,00064,India
379921,2023-08-27,704,scale,5,10,5,1,00064,India
884824,2023-08-27,712,graph paper,20,40,20,1,00051,India
884824,2023-08-27,717,spiral bound book,50,100,50,1,00051,India
884824,2023-08-27,704,scale,5,10,5,1,00051,India
884824,2023-08-27,708,sketchpen,15,40,25,1,00051,India
443384,2023-08-27,710,geometry box,100,150,50,1,00401,India
443384,2023-08-27,706,sharpener,3,8,5,1,00401,India
443384,2023-08-27,713,ball pen,5,10,5,1,00401,India
476648,2023-08-27,706,sharpener,3,8,5,1,00396,India
476648,2023-08-27,712,graph paper,20,40,20,1,00396,India
476648,2023-08-27,716,printing paper,200,400,200,1,00396,India
476648,2023-08-27,709,notebook,30,60,30,1,00396,India
582064,2023-08-27,704,scale,5,10,5,1,00424,India
582064,2023-08-27,716,printing paper,200,400,200,1,00424,India
582064,2023-08-27,702,pencil,2,5,3,1,00424,India
582064,2023-08-27,708,sketchpen,15,40,25,1,00424,India
936865,2023-08-27,717,spiral bound book,50,100,50,1,00054,India
936865,2023-08-27,701,gel pen,5,10,5,1,00054,India
936865,2023-08-27,707,marker,20,40,20,1,00054,India
759087,2023-08-27,717,spiral bound book,50,100,50,1,00124,India
759087,2023-08-27,709,notebook,30,60,30,1,00124,India
759087,2023-08-27,715,folder,5,15,10,1,00124,India
759087,2023-08-27,702,pencil,2,5,3,1,00124,India
888052,2023-08-27,712,graph paper,20,40,20,1,00209,India
888052,2023-08-27,715,folder,5,15,10,1,00209,India
888052,2023-08-27,711,TD kit,150,300,150,1,00209,India
888052,2023-08-27,705,stencil,10,20,10,1,00209,India
649255,2023-08-27,709,notebook,30,60,30,1,00375,India
649255,2023-08-27,702,pencil,2,5,3,1,00375,India
649255,2023-08-27,716,printing paper,200,400,200,1,00375,India
649255,2023-08-27,705,stencil,10,20,10,1,00375,India
945243,2023-08-27,701,gel pen,5,10,5,1,00463,India
163959,2023-08-27,717,spiral bound book,50,100,50,1,00398,India
163959,2023-08-27,708,sketchpen,15,40,25,1,00398,India
163959,2023-08-27,702,pencil,2,5,3,1,00398,India
980184,2023-08-27,715,folder,5,15,10,1,00200,India
980184,2023-08-27,702,pencil,2,5,3,1,00200,India
980184,2023-08-27,701,gel pen,5,10,5,1,00200,India
980184,2023-08-27,713,ball pen,5,10,5,1,00200,India
980184,2023-08-27,714,carbon paper,15,30,15,1,00200,India
629677,2023-08-27,716,printing paper,200,400,200,1,00125,India
697513,2023-08-27,708,sketchpen,15,40,25,1,00058,India
697513,2023-08-27,713,ball pen,5,10,5,1,00058,India
697513,2023-08-27,707,marker,20,40,20,1,00058,India
697513,2023-08-27,716,printing paper,200,400,200,1,00058,India
697513,2023-08-27,712,graph paper,20,40,20,1,00058,India
928756,2023-08-27,701,gel pen,5,10,5,1,00065,India
928756,2023-08-27,704,scale,5,10,5,1,00065,India
928756,2023-08-27,710,geometry box,100,150,50,1,00065,India
928756,2023-08-27,713,ball pen,5,10,5,1,00065,India
928756,2023-08-27,709,notebook,30,60,30,1,00065,India
582975,2023-08-27,703,eraser,1,3,2,1,00285,India
582975,2023-08-27,704,scale,5,10,5,1,00285,India
582975,2023-08-27,717,spiral bound book,50,100,50,1,00285,India
383591,2023-08-27,709,notebook,30,60,30,1,00327,India
383591,2023-08-27,712,graph paper,20,40,20,1,00327,India
358093,2023-08-27,708,sketchpen,15,40,25,1,00485,India
358093,2023-08-27,705,stencil,10,20,10,1,00485,India
358093,2023-08-27,703,eraser,1,3,2,1,00485,India
358093,2023-08-27,712,graph paper,20,40,20,1,00485,India
358093,2023-08-27,706,sharpener,3,8,5,1,00485,India
968297,2023-08-27,710,geometry box,100,150,50,1,00313,India
820790,2023-08-27,715,folder,5,15,10,1,00161,India
820790,2023-08-27,705,stencil,10,20,10,1,00161,India
820790,2023-08-27,706,sharpener,3,8,5,1,00161,India
820790,2023-08-27,711,TD kit,150,300,150,1,00161,India
820790,2023-08-27,707,marker,20,40,20,1,00161,India
112036,2023-08-27,717,spiral bound book,50,100,50,1,00436,India
986598,2023-08-27,701,gel pen,5,10,5,1,00410,India
986598,2023-08-27,705,stencil,10,20,10,1,00410,India
986598,2023-08-27,707,marker,20,40,20,1,00410,India
748786,2023-08-27,717,spiral bound book,50,100,50,1,00479,India
748786,2023-08-27,702,pencil,2,5,3,1,00479,India
748786,2023-08-27,712,graph paper,20,40,20,1,00479,India
748786,2023-08-27,705,stencil,10,20,10,1,00479,India
748786,2023-08-27,715,folder,5,15,10,1,00479,India
148544,2023-08-27,706,sharpener,3,8,5,1,00336,India
148544,2023-08-27,713,ball pen,5,10,5,1,00336,India
339209,2023-08-27,708,sketchpen,15,40,25,1,00212,India
339209,2023-08-27,712,graph paper,20,40,20,1,00212,India
339209,2023-08-27,705,stencil,10,20,10,1,00212,India
768789,2023-08-27,704,scale,5,10,5,1,00462,India
768789,2023-08-27,703,eraser,1,3,2,1,00462,India
768789,2023-08-27,716,printing paper,200,400,200,1,00462,India
662964,2023-08-27,706,sharpener,3,8,5,1,00120,India
662964,2023-08-27,713,ball pen,5,10,5,1,00120,India
662964,2023-08-27,703,eraser,1,3,2,1,00120,India
317847,2023-08-27,712,graph paper,20,40,20,1,00260,India
317847,2023-08-27,713,ball pen,5,10,5,1,00260,India
317847,2023-08-27,705,stencil,10,20,10,1,00260,India
844541,2023-08-27,706,sharpener,3,8,5,1,00176,India
434580,2023-08-27,701,gel pen,5,10,5,1,00265,India
434580,2023-08-27,702,pencil,2,5,3,1,00265,India
434580,2023-08-27,716,printing paper,200,400,200,1,00265,India
434580,2023-08-27,708,sketchpen,15,40,25,1,00265,India
947756,2023-08-27,707,marker,20,40,20,1,00458,India
947756,2023-08-27,712,graph paper,20,40,20,1,00458,India
947756,2023-08-27,711,TD kit,150,300,150,1,00458,India
947756,2023-08-27,713,ball pen,5,10,5,1,00458,India
743710,2023-08-27,707,marker,20,40,20,1,00149,India
527811,2023-08-27,702,pencil,2,5,3,1,00185,India
524522,2023-08-27,715,folder,5,15,10,1,00233,India
524522,2023-08-27,708,sketchpen,15,40,25,1,00233,India
524522,2023-08-27,712,graph paper,20,40,20,1,00233,India
185713,2023-08-27,704,scale,5,10,5,1,00141,India
185713,2023-08-27,713,ball pen,5,10,5,1,00141,India
989169,2023-08-27,703,eraser,1,3,2,1,00299,India
989169,2023-08-27,704,scale,5,10,5,1,00299,India
989169,2023-08-27,716,printing paper,200,400,200,1,00299,India
989169,2023-08-27,705,stencil,10,20,10,1,00299,India
682040,2023-08-27,711,TD kit,150,300,150,1,00413,India
682040,2023-08-27,708,sketchpen,15,40,25,1,00413,India
976561,2023-08-27,710,geometry box,100,150,50,1,00435,India
114229,2023-08-27,714,carbon paper,15,30,15,1,00253,India
114229,2023-08-27,705,stencil,10,20,10,1,00253,India
114229,2023-08-27,709,notebook,30,60,30,1,00253,India
114229,2023-08-27,716,printing paper,200,400,200,1,00253,India
318805,2023-08-27,716,printing paper,200,400,200,1,00490,India
318805,2023-08-27,717,spiral bound book,50,100,50,1,00490,India
318805,2023-08-27,701,gel pen,5,10,5,1,00490,India
286145,2023-08-28,715,folder,5,15,10,1,00010,India
595375,2023-08-28,716,printing paper,200,400,200,1,00020,India
595375,2023-08-28,709,notebook,30,60,30,1,00020,India
595375,2023-08-28,705,stencil,10,20,10,1,00020,India
595375,2023-08-28,703,eraser,1,3,2,1,00020,India
595375,2023-08-28,707,marker,20,40,20,1,00020,India
806106,2023-08-28,711,TD kit,150,300,150,1,00086,India
806106,2023-08-28,706,sharpener,3,8,5,1,00086,India
295349,2023-08-28,712,graph paper,20,40,20,1,00122,India
295349,2023-08-28,702,pencil,2,5,3,1,00122,India
295349,2023-08-28,706,sharpener,3,8,5,1,00122,India
295349,2023-08-28,710,geometry box,100,150,50,1,00122,India
438418,2023-08-28,703,eraser,1,3,2,1,00377,India
438418,2023-08-28,711,TD kit,150,300,150,1,00377,India
438418,2023-08-28,707,marker,20,40,20,1,00377,India
438418,2023-08-28,712,graph paper,20,40,20,1,00377,India
564860,2023-08-28,715,folder,5,15,10,1,00183,India
542105,2023-08-28,717,spiral bound book,50,100,50,1,00251,India
542105,2023-08-28,709,notebook,30,60,30,1,00251,India
542105,2023-08-28,702,pencil,2,5,3,1,00251,India
934107,2023-08-28,701,gel pen,5,10,5,1,00195,India
934107,2023-08-28,712,graph paper,20,40,20,1,00195,India
398765,2023-08-28,701,gel pen,5,10,5,1,00334,India
398765,2023-08-28,710,geometry box,100,150,50,1,00334,India
398765,2023-08-28,712,graph paper,20,40,20,1,00334,India
398765,2023-08-28,706,sharpener,3,8,5,1,00334,India
136733,2023-08-28,710,geometry box,100,150,50,1,00122,India
616796,2023-08-28,710,geometry box,100,150,50,1,00351,India
172962,2023-08-28,709,notebook,30,60,30,1,00423,India
172962,2023-08-28,712,graph paper,20,40,20,1,00423,India
172962,2023-08-28,706,sharpener,3,8,5,1,00423,India
172962,2023-08-28,701,gel pen,5,10,5,1,00423,India
613762,2023-08-28,707,marker,20,40,20,1,00177,India
613762,2023-08-28,711,TD kit,150,300,150,1,00177,India
613762,2023-08-28,713,ball pen,5,10,5,1,00177,India
613762,2023-08-28,710,geometry box,100,150,50,1,00177,India
283848,2023-08-28,705,stencil,10,20,10,1,00027,India
283848,2023-08-28,713,ball pen,5,10,5,1,00027,India
283848,2023-08-28,707,marker,20,40,20,1,00027,India
283848,2023-08-28,711,TD kit,150,300,150,1,00027,India
300883,2023-08-28,707,marker,20,40,20,1,00481,India
591856,2023-08-28,704,scale,5,10,5,1,00445,India
591856,2023-08-28,715,folder,5,15,10,1,00445,India
591856,2023-08-28,707,marker,20,40,20,1,00445,India
591856,2023-08-28,701,gel pen,5,10,5,1,00445,India
277149,2023-08-28,714,carbon paper,15,30,15,1,00399,India
541329,2023-08-28,704,scale,5,10,5,1,00046,India
773947,2023-08-28,702,pencil,2,5,3,1,00188,India
773947,2023-08-28,709,notebook,30,60,30,1,00188,India
318169,2023-08-28,710,geometry box,100,150,50,1,00362,India
318169,2023-08-28,712,graph paper,20,40,20,1,00362,India
998501,2023-08-28,706,sharpener,3,8,5,1,00454,India
611774,2023-08-28,705,stencil,10,20,10,1,00495,India
611774,2023-08-28,706,sharpener,3,8,5,1,00495,India
862971,2023-08-28,704,scale,5,10,5,1,00084,India
862971,2023-08-28,717,spiral bound book,50,100,50,1,00084,India
862971,2023-08-28,703,eraser,1,3,2,1,00084,India
660438,2023-08-28,709,notebook,30,60,30,1,00264,India
660438,2023-08-28,715,folder,5,15,10,1,00264,India
660438,2023-08-28,701,gel pen,5,10,5,1,00264,India
826899,2023-08-28,710,geometry box,100,150,50,1,00163,India
826899,2023-08-28,715,folder,5,15,10,1,00163,India
826899,2023-08-28,712,graph paper,20,40,20,1,00163,India
826899,2023-08-28,713,ball pen,5,10,5,1,00163,India
826899,2023-08-28,705,stencil,10,20,10,1,00163,India
178554,2023-08-28,705,stencil,10,20,10,1,00150,India
178554,2023-08-28,712,graph paper,20,40,20,1,00150,India
178554,2023-08-28,710,geometry box,100,150,50,1,00150,India
178554,2023-08-28,717,spiral bound book,50,100,50,1,00150,India
852395,2023-08-28,705,stencil,10,20,10,1,00473,India
852395,2023-08-28,709,notebook,30,60,30,1,00473,India
852395,2023-08-28,704,scale,5,10,5,1,00473,India
965613,2023-08-28,705,stencil,10,20,10,1,00057,India
965613,2023-08-28,707,marker,20,40,20,1,00057,India
965613,2023-08-28,709,notebook,30,60,30,1,00057,India
965613,2023-08-28,701,gel pen,5,10,5,1,00057,India
965613,2023-08-28,713,ball pen,5,10,5,1,00057,India
117014,2023-08-28,712,graph paper,20,40,20,1,00274,India
117014,2023-08-28,704,scale,5,10,5,1,00274,India
117014,2023-08-28,710,geometry box,100,150,50,1,00274,India
199400,2023-08-28,716,printing paper,200,400,200,1,00098,India
627131,2023-08-28,717,spiral bound book,50,100,50,1,00360,India
122038,2023-08-28,712,graph paper,20,40,20,1,00014,India
122038,2023-08-28,710,geometry box,100,150,50,1,00014,India
122038,2023-08-28,716,printing paper,200,400,200,1,00014,India
122038,2023-08-28,707,marker,20,40,20,1,00014,India
717352,2023-08-28,717,spiral bound book,50,100,50,1,00350,India
717352,2023-08-28,705,stencil,10,20,10,1,00350,India
717352,2023-08-28,709,notebook,30,60,30,1,00350,India
813254,2023-08-29,712,graph paper,20,40,20,1,00208,India
813254,2023-08-29,716,printing paper,200,400,200,1,00208,India
813254,2023-08-29,710,geometry box,100,150,50,1,00208,India
357807,2023-08-29,713,ball pen,5,10,5,1,00113,India
158078,2023-08-29,714,carbon paper,15,30,15,1,00376,India
158078,2023-08-29,703,eraser,1,3,2,1,00376,India
406714,2023-08-29,710,geometry box,100,150,50,1,00332,India
406714,2023-08-29,706,sharpener,3,8,5,1,00332,India
221547,2023-08-29,708,sketchpen,15,40,25,1,00402,India
706747,2023-08-29,702,pencil,2,5,3,1,00449,India
312428,2023-08-29,711,TD kit,150,300,150,1,00358,India
312428,2023-08-29,702,pencil,2,5,3,1,00358,India
312428,2023-08-29,707,marker,20,40,20,1,00358,India
312428,2023-08-29,704,scale,5,10,5,1,00358,India
671927,2023-08-29,714,carbon paper,15,30,15,1,00230,India
671927,2023-08-29,712,graph paper,20,40,20,1,00230,India
838498,2023-08-29,715,folder,5,15,10,1,00212,India
838498,2023-08-29,712,graph paper,20,40,20,1,00212,India
838498,2023-08-29,708,sketchpen,15,40,25,1,00212,India
704738,2023-08-29,714,carbon paper,15,30,15,1,00328,India
704738,2023-08-29,705,stencil,10,20,10,1,00328,India
709657,2023-08-29,706,sharpener,3,8,5,1,00374,India
709657,2023-08-29,704,scale,5,10,5,1,00374,India
709657,2023-08-29,708,sketchpen,15,40,25,1,00374,India
345536,2023-08-29,716,printing paper,200,400,200,1,00275,India
345536,2023-08-29,705,stencil,10,20,10,1,00275,India
856170,2023-08-29,707,marker,20,40,20,1,00211,India
856170,2023-08-29,704,scale,5,10,5,1,00211,India
856170,2023-08-29,705,stencil,10,20,10,1,00211,India
199437,2023-08-29,715,folder,5,15,10,1,00351,India
199437,2023-08-29,714,carbon paper,15,30,15,1,00351,India
199437,2023-08-29,701,gel pen,5,10,5,1,00351,India
199437,2023-08-29,717,spiral bound book,50,100,50,1,00351,India
199437,2023-08-29,702,pencil,2,5,3,1,00351,India
433748,2023-08-29,709,notebook,30,60,30,1,00449,India
433748,2023-08-29,714,carbon paper,15,30,15,1,00449,India
433748,2023-08-29,706,sharpener,3,8,5,1,00449,India
433748,2023-08-29,705,stencil,10,20,10,1,00449,India
825425,2023-08-29,709,notebook,30,60,30,1,00091,India
825425,2023-08-29,710,geometry box,100,150,50,1,00091,India
825425,2023-08-29,714,carbon paper,15,30,15,1,00091,India
825425,2023-08-29,711,TD kit,150,300,150,1,00091,India
143726,2023-08-29,701,gel pen,5,10,5,1,00156,India
143726,2023-08-29,706,sharpener,3,8,5,1,00156,India
143726,2023-08-29,714,carbon paper,15,30,15,1,00156,India
143726,2023-08-29,716,printing paper,200,400,200,1,00156,India
143726,2023-08-29,708,sketchpen,15,40,25,1,00156,India
376610,2023-08-29,714,carbon paper,15,30,15,1,00058,India
376610,2023-08-29,717,spiral bound book,50,100,50,1,00058,India
376610,2023-08-29,703,eraser,1,3,2,1,00058,India
376610,2023-08-29,701,gel pen,5,10,5,1,00058,India
171002,2023-08-29,710,geometry box,100,150,50,1,00494,India
171002,2023-08-29,714,carbon paper,15,30,15,1,00494,India
171002,2023-08-29,702,pencil,2,5,3,1,00494,India
488067,2023-08-29,710,geometry box,100,150,50,1,00066,India
488067,2023-08-29,711,TD kit,150,300,150,1,00066,India
488067,2023-08-29,713,ball pen,5,10,5,1,00066,India
488067,2023-08-29,706,sharpener,3,8,5,1,00066,India
158753,2023-08-29,712,graph paper,20,40,20,1,00182,India
158753,2023-08-29,708,sketchpen,15,40,25,1,00182,India
158753,2023-08-29,709,notebook,30,60,30,1,00182,India
158753,2023-08-29,717,spiral bound book,50,100,50,1,00182,India
905766,2023-08-29,717,spiral bound book,50,100,50,1,00173,India
905766,2023-08-29,708,sketchpen,15,40,25,1,00173,India
905766,2023-08-29,712,graph paper,20,40,20,1,00173,India
905766,2023-08-29,701,gel pen,5,10,5,1,00173,India
958942,2023-08-29,711,TD kit,150,300,150,1,00038,India
958942,2023-08-29,712,graph paper,20,40,20,1,00038,India
958942,2023-08-29,701,gel pen,5,10,5,1,00038,India
958942,2023-08-29,704,scale,5,10,5,1,00038,India
958942,2023-08-29,714,carbon paper,15,30,15,1,00038,India
842639,2023-08-29,704,scale,5,10,5,1,00162,India
842639,2023-08-29,714,carbon paper,15,30,15,1,00162,India
842639,2023-08-29,716,printing paper,200,400,200,1,00162,India
842639,2023-08-29,710,geometry box,100,150,50,1,00162,India
289136,2023-08-29,702,pencil,2,5,3,1,00392,India
289136,2023-08-29,701,gel pen,5,10,5,1,00392,India
289136,2023-08-29,710,geometry box,100,150,50,1,00392,India
289136,2023-08-29,703,eraser,1,3,2,1,00392,India
289136,2023-08-29,712,graph paper,20,40,20,1,00392,India
485408,2023-08-29,716,printing paper,200,400,200,1,00031,India
485408,2023-08-29,711,TD kit,150,300,150,1,00031,India
485408,2023-08-29,713,ball pen,5,10,5,1,00031,India
485408,2023-08-29,704,scale,5,10,5,1,00031,India
653737,2023-08-29,703,eraser,1,3,2,1,00307,India
653737,2023-08-29,706,sharpener,3,8,5,1,00307,India
653737,2023-08-29,707,marker,20,40,20,1,00307,India
100051,2023-08-29,708,sketchpen,15,40,25,1,00085,India
100051,2023-08-29,705,stencil,10,20,10,1,00085,India
100051,2023-08-29,703,eraser,1,3,2,1,00085,India
936749,2023-08-29,715,folder,5,15,10,1,00432,India
936749,2023-08-29,704,scale,5,10,5,1,00432,India
759593,2023-08-29,711,TD kit,150,300,150,1,00168,India
324077,2023-08-29,701,gel pen,5,10,5,1,00388,India
653937,2023-08-29,714,carbon paper,15,30,15,1,00094,India
620271,2023-08-29,707,marker,20,40,20,1,00285,India
620271,2023-08-29,702,pencil,2,5,3,1,00285,India
620271,2023-08-29,711,TD kit,150,300,150,1,00285,India
620271,2023-08-29,708,sketchpen,15,40,25,1,00285,India
759193,2023-08-29,707,marker,20,40,20,1,00065,India
759193,2023-08-29,715,folder,5,15,10,1,00065,India
759193,2023-08-29,701,gel pen,5,10,5,1,00065,India
112179,2023-08-29,713,ball pen,5,10,5,1,00413,India
282400,2023-08-29,705,stencil,10,20,10,1,00451,India
282400,2023-08-29,714,carbon paper,15,30,15,1,00451,India
687387,2023-08-29,705,stencil,10,20,10,1,00229,India
687387,2023-08-29,710,geometry box,100,150,50,1,00229,India
687387,2023-08-29,702,pencil,2,5,3,1,00229,India
687387,2023-08-29,701,gel pen,5,10,5,1,00229,India
381287,2023-08-29,702,pencil,2,5,3,1,00438,India
381287,2023-08-29,711,TD kit,150,300,150,1,00438,India
381287,2023-08-29,706,sharpener,3,8,5,1,00438,India
381287,2023-08-29,703,eraser,1,3,2,1,00438,India
937108,2023-08-29,701,gel pen,5,10,5,1,00241,India
937108,2023-08-29,702,pencil,2,5,3,1,00241,India
237554,2023-08-29,717,spiral bound book,50,100,50,1,00090,India
237554,2023-08-29,708,sketchpen,15,40,25,1,00090,India
237554,2023-08-29,702,pencil,2,5,3,1,00090,India
381816,2023-08-29,708,sketchpen,15,40,25,1,00128,India
381816,2023-08-29,709,notebook,30,60,30,1,00128,India
786791,2023-08-29,714,carbon paper,15,30,15,1,00227,India
786791,2023-08-29,703,eraser,1,3,2,1,00227,India
786791,2023-08-29,708,sketchpen,15,40,25,1,00227,India
786791,2023-08-29,713,ball pen,5,10,5,1,00227,India
335636,2023-08-29,703,eraser,1,3,2,1,00361,India
335636,2023-08-29,711,TD kit,150,300,150,1,00361,India
335636,2023-08-29,705,stencil,10,20,10,1,00361,India
335636,2023-08-29,716,printing paper,200,400,200,1,00361,India
674766,2023-08-29,706,sharpener,3,8,5,1,00452,India
900925,2023-08-29,716,printing paper,200,400,200,1,00346,India
814065,2023-08-29,703,eraser,1,3,2,1,00413,India
814065,2023-08-29,705,stencil,10,20,10,1,00413,India
533506,2023-08-29,715,folder,5,15,10,1,00248,India
533506,2023-08-29,708,sketchpen,15,40,25,1,00248,India
533506,2023-08-29,712,graph paper,20,40,20,1,00248,India
533506,2023-08-29,717,spiral bound book,50,100,50,1,00248,India
268591,2023-08-29,702,pencil,2,5,3,1,00375,India
268591,2023-08-29,708,sketchpen,15,40,25,1,00375,India
268591,2023-08-29,715,folder,5,15,10,1,00375,India
822876,2023-08-29,702,pencil,2,5,3,1,00375,India
822876,2023-08-29,701,gel pen,5,10,5,1,00375,India
822876,2023-08-29,712,graph paper,20,40,20,1,00375,India
367855,2023-08-30,705,stencil,10,20,10,1,00422,India
322016,2023-08-30,710,geometry box,100,150,50,1,00394,India
322016,2023-08-30,707,marker,20,40,20,1,00394,India
322016,2023-08-30,713,ball pen,5,10,5,1,00394,India
322016,2023-08-30,701,gel pen,5,10,5,1,00394,India
581833,2023-08-30,715,folder,5,15,10,1,00279,India
581833,2023-08-30,714,carbon paper,15,30,15,1,00279,India
447448,2023-08-30,712,graph paper,20,40,20,1,00069,India
447448,2023-08-30,716,printing paper,200,400,200,1,00069,India
895104,2023-08-30,713,ball pen,5,10,5,1,00028,India
895104,2023-08-30,709,notebook,30,60,30,1,00028,India
921467,2023-08-30,705,stencil,10,20,10,1,00002,India
921467,2023-08-30,701,gel pen,5,10,5,1,00002,India
921467,2023-08-30,707,marker,20,40,20,1,00002,India
903336,2023-08-30,706,sharpener,3,8,5,1,00420,India
296631,2023-08-30,702,pencil,2,5,3,1,00074,India
296631,2023-08-30,701,gel pen,5,10,5,1,00074,India
296631,2023-08-30,715,folder,5,15,10,1,00074,India
296631,2023-08-30,708,sketchpen,15,40,25,1,00074,India
449922,2023-08-30,713,ball pen,5,10,5,1,00388,India
449922,2023-08-30,712,graph paper,20,40,20,1,00388,India
449922,2023-08-30,710,geometry box,100,150,50,1,00388,India
803276,2023-08-30,705,stencil,10,20,10,1,00130,India
803276,2023-08-30,711,TD kit,150,300,150,1,00130,India
491946,2023-08-30,711,TD kit,150,300,150,1,00288,India
491946,2023-08-30,716,printing paper,200,400,200,1,00288,India
491946,2023-08-30,703,eraser,1,3,2,1,00288,India
579660,2023-08-30,703,eraser,1,3,2,1,00121,India
579660,2023-08-30,714,carbon paper,15,30,15,1,00121,India
579660,2023-08-30,710,geometry box,100,150,50,1,00121,India
203333,2023-08-30,706,sharpener,3,8,5,1,00053,India
203333,2023-08-30,714,carbon paper,15,30,15,1,00053,India
103043,2023-08-30,717,spiral bound book,50,100,50,1,00434,India
103043,2023-08-30,708,sketchpen,15,40,25,1,00434,India
103043,2023-08-30,702,pencil,2,5,3,1,00434,India
103043,2023-08-30,704,scale,5,10,5,1,00434,India
741634,2023-08-30,710,geometry box,100,150,50,1,00419,India
741634,2023-08-30,713,ball pen,5,10,5,1,00419,India
741634,2023-08-30,715,folder,5,15,10,1,00419,India
155716,2023-08-30,713,ball pen,5,10,5,1,00065,India
128207,2023-08-30,712,graph paper,20,40,20,1,00454,India
600688,2023-08-30,707,marker,20,40,20,1,00106,India
518596,2023-08-30,708,sketchpen,15,40,25,1,00441,India
518596,2023-08-30,717,spiral bound book,50,100,50,1,00441,India
518596,2023-08-30,704,scale,5,10,5,1,00441,India
518596,2023-08-30,706,sharpener,3,8,5,1,00441,India
484159,2023-08-30,707,marker,20,40,20,1,00410,India
484159,2023-08-30,703,eraser,1,3,2,1,00410,India
484159,2023-08-30,709,notebook,30,60,30,1,00410,India
770791,2023-08-30,709,notebook,30,60,30,1,00427,India
373622,2023-08-30,717,spiral bound book,50,100,50,1,00248,India
373622,2023-08-30,704,scale,5,10,5,1,00248,India
373622,2023-08-30,716,printing paper,200,400,200,1,00248,India
695287,2023-08-30,712,graph paper,20,40,20,1,00161,India
695287,2023-08-30,707,marker,20,40,20,1,00161,India
695287,2023-08-30,714,carbon paper,15,30,15,1,00161,India
695287,2023-08-30,704,scale,5,10,5,1,00161,India
695287,2023-08-30,709,notebook,30,60,30,1,00161,India
225407,2023-08-30,709,notebook,30,60,30,1,00002,India
225407,2023-08-30,717,spiral bound book,50,100,50,1,00002,India
225407,2023-08-30,701,gel pen,5,10,5,1,00002,India
225407,2023-08-30,706,sharpener,3,8,5,1,00002,India
624966,2023-08-30,703,eraser,1,3,2,1,00448,India
624966,2023-08-30,716,printing paper,200,400,200,1,00448,India
908006,2023-08-30,701,gel pen,5,10,5,1,00466,India
908006,2023-08-30,711,TD kit,150,300,150,1,00466,India
908006,2023-08-30,707,marker,20,40,20,1,00466,India
908006,2023-08-30,708,sketchpen,15,40,25,1,00466,India
796594,2023-08-30,713,ball pen,5,10,5,1,00385,India
796594,2023-08-30,706,sharpener,3,8,5,1,00385,India
796594,2023-08-30,717,spiral bound book,50,100,50,1,00385,India
796594,2023-08-30,702,pencil,2,5,3,1,00385,India
522347,2023-08-30,706,sharpener,3,8,5,1,00186,India
522347,2023-08-30,709,notebook,30,60,30,1,00186,India
566146,2023-08-30,702,pencil,2,5,3,1,00452,India
566146,2023-08-30,714,carbon paper,15,30,15,1,00452,India
566146,2023-08-30,716,printing paper,200,400,200,1,00452,India
856028,2023-08-30,710,geometry box,100,150,50,1,00277,India
856028,2023-08-30,706,sharpener,3,8,5,1,00277,India
856028,2023-08-30,715,folder,5,15,10,1,00277,India
617172,2023-08-30,710,geometry box,100,150,50,1,00267,India
617172,2023-08-30,711,TD kit,150,300,150,1,00267,India
617172,2023-08-30,715,folder,5,15,10,1,00267,India
733142,2023-08-30,705,stencil,10,20,10,1,00211,India
644605,2023-08-30,705,stencil,10,20,10,1,00479,India
644605,2023-08-30,716,printing paper,200,400,200,1,00479,India
382254,2023-08-30,713,ball pen,5,10,5,1,00406,India
382254,2023-08-30,709,notebook,30,60,30,1,00406,India
884755,2023-08-30,702,pencil,2,5,3,1,00040,India
884755,2023-08-30,713,ball pen,5,10,5,1,00040,India
296776,2023-08-30,715,folder,5,15,10,1,00360,India
296776,2023-08-30,708,sketchpen,15,40,25,1,00360,India
296776,2023-08-30,702,pencil,2,5,3,1,00360,India
175643,2023-08-30,706,sharpener,3,8,5,1,00500,India
175643,2023-08-30,709,notebook,30,60,30,1,00500,India
622418,2023-08-30,707,marker,20,40,20,1,00045,India
622418,2023-08-30,710,geometry box,100,150,50,1,00045,India
464868,2023-08-30,704,scale,5,10,5,1,00162,India
755245,2023-08-30,715,folder,5,15,10,1,00255,India
755245,2023-08-30,703,eraser,1,3,2,1,00255,India
755245,2023-08-30,714,carbon paper,15,30,15,1,00255,India
755245,2023-08-30,702,pencil,2,5,3,1,00255,India
126355,2023-08-30,710,geometry box,100,150,50,1,00461,India
126355,2023-08-30,704,scale,5,10,5,1,00461,India
126355,2023-08-30,708,sketchpen,15,40,25,1,00461,India
383012,2023-08-30,716,printing paper,200,400,200,1,00099,India
383012,2023-08-30,701,gel pen,5,10,5,1,00099,India
383012,2023-08-30,703,eraser,1,3,2,1,00099,India
445384,2023-08-30,701,gel pen,5,10,5,1,00448,India
445384,2023-08-30,702,pencil,2,5,3,1,00448,India
445384,2023-08-30,704,scale,5,10,5,1,00448,India
712350,2023-08-30,709,notebook,30,60,30,1,00078,India
712350,2023-08-30,714,carbon paper,15,30,15,1,00078,India
712350,2023-08-30,716,printing paper,200,400,200,1,00078,India
520444,2023-08-30,714,carbon paper,15,30,15,1,00008,India
133742,2023-08-30,705,stencil,10,20,10,1,00371,India
133742,2023-08-30,710,geometry box,100,150,50,1,00371,India
133742,2023-08-30,701,gel pen,5,10,5,1,00371,India
133742,2023-08-30,717,spiral bound book,50,100,50,1,00371,India
357578,2023-08-30,701,gel pen,5,10,5,1,00238,India
357578,2023-08-30,703,eraser,1,3,2,1,00238,India
357578,2023-08-30,715,folder,5,15,10,1,00238,India
256518,2023-08-30,711,TD kit,150,300,150,1,00470,India
256518,2023-08-30,715,folder,5,15,10,1,00470,India
256518,2023-08-30,702,pencil,2,5,3,1,00470,India
239811,2023-08-30,703,eraser,1,3,2,1,00453,India
239811,2023-08-30,708,sketchpen,15,40,25,1,00453,India
239811,2023-08-30,714,carbon paper,15,30,15,1,00453,India
239811,2023-08-30,712,graph paper,20,40,20,1,00453,India
444345,2023-08-31,705,stencil,10,20,10,1,00225,India
444345,2023-08-31,709,notebook,30,60,30,1,00225,India
444345,2023-08-31,714,carbon paper,15,30,15,1,00225,India
444345,2023-08-31,707,marker,20,40,20,1,00225,India
850513,2023-08-31,711,TD kit,150,300,150,1,00048,India
850513,2023-08-31,716,printing paper,200,400,200,1,00048,India
850513,2023-08-31,714,carbon paper,15,30,15,1,00048,India
850513,2023-08-31,703,eraser,1,3,2,1,00048,India
143707,2023-08-31,708,sketchpen,15,40,25,1,00013,India
143707,2023-08-31,716,printing paper,200,400,200,1,00013,India
143707,2023-08-31,710,geometry box,100,150,50,1,00013,India
143707,2023-08-31,707,marker,20,40,20,1,00013,India
980113,2023-08-31,709,notebook,30,60,30,1,00309,India
980113,2023-08-31,711,TD kit,150,300,150,1,00309,India
980113,2023-08-31,714,carbon paper,15,30,15,1,00309,India
507031,2023-08-31,707,marker,20,40,20,1,00219,India
561652,2023-08-31,707,marker,20,40,20,1,00016,India
561652,2023-08-31,709,notebook,30,60,30,1,00016,India
561652,2023-08-31,714,carbon paper,15,30,15,1,00016,India
561652,2023-08-31,710,geometry box,100,150,50,1,00016,India
930633,2023-08-31,711,TD kit,150,300,150,1,00130,India
319588,2023-08-31,703,eraser,1,3,2,1,00065,India
319588,2023-08-31,705,stencil,10,20,10,1,00065,India
319588,2023-08-31,717,spiral bound book,50,100,50,1,00065,India
319588,2023-08-31,706,sharpener,3,8,5,1,00065,India
517058,2023-08-31,713,ball pen,5,10,5,1,00286,India
517058,2023-08-31,711,TD kit,150,300,150,1,00286,India
517058,2023-08-31,705,stencil,10,20,10,1,00286,India
517058,2023-08-31,701,gel pen,5,10,5,1,00286,India
178435,2023-08-31,707,marker,20,40,20,1,00078,India
178435,2023-08-31,710,geometry box,100,150,50,1,00078,India
767053,2023-08-31,713,ball pen,5,10,5,1,00142,India
597691,2023-08-31,707,marker,20,40,20,1,00438,India
597691,2023-08-31,717,spiral bound book,50,100,50,1,00438,India
597691,2023-08-31,713,ball pen,5,10,5,1,00438,India
597691,2023-08-31,704,scale,5,10,5,1,00438,India
597691,2023-08-31,715,folder,5,15,10,1,00438,India
503124,2023-08-31,713,ball pen,5,10,5,1,00416,India
503124,2023-08-31,703,eraser,1,3,2,1,00416,India
503124,2023-08-31,705,stencil,10,20,10,1,00416,India
503124,2023-08-31,704,scale,5,10,5,1,00416,India
503124,2023-08-31,711,TD kit,150,300,150,1,00416,India
704841,2023-08-31,717,spiral bound book,50,100,50,1,00128,India
704841,2023-08-31,716,printing paper,200,400,200,1,00128,India
704841,2023-08-31,709,notebook,30,60,30,1,00128,India
772919,2023-08-31,702,pencil,2,5,3,1,00195,India
772919,2023-08-31,717,spiral bound book,50,100,50,1,00195,India
772919,2023-08-31,704,scale,5,10,5,1,00195,India
492767,2023-08-31,715,folder,5,15,10,1,00244,India
492767,2023-08-31,706,sharpener,3,8,5,1,00244,India
492767,2023-08-31,707,marker,20,40,20,1,00244,India
492767,2023-08-31,703,eraser,1,3,2,1,00244,India
454109,2023-08-31,713,ball pen,5,10,5,1,00128,India
454109,2023-08-31,708,sketchpen,15,40,25,1,00128,India
454109,2023-08-31,716,printing paper,200,400,200,1,00128,India
454109,2023-08-31,710,geometry box,100,150,50,1,00128,India
454109,2023-08-31,701,gel pen,5,10,5,1,00128,India
228006,2023-08-31,709,notebook,30,60,30,1,00167,India
228006,2023-08-31,714,carbon paper,15,30,15,1,00167,India
228006,2023-08-31,704,scale,5,10,5,1,00167,India
211378,2023-08-31,704,scale,5,10,5,1,00065,India
211378,2023-08-31,710,geometry box,100,150,50,1,00065,India
211378,2023-08-31,708,sketchpen,15,40,25,1,00065,India
314355,2023-08-31,707,marker,20,40,20,1,00040,India
314355,2023-08-31,714,carbon paper,15,30,15,1,00040,India
975668,2023-08-31,708,sketchpen,15,40,25,1,00258,India
975668,2023-08-31,702,pencil,2,5,3,1,00258,India
975668,2023-08-31,713,ball pen,5,10,5,1,00258,India
975668,2023-08-31,717,spiral bound book,50,100,50,1,00258,India
274997,2023-08-31,715,folder,5,15,10,1,00379,India
274997,2023-08-31,711,TD kit,150,300,150,1,00379,India
274997,2023-08-31,708,sketchpen,15,40,25,1,00379,India
433687,2023-08-31,711,TD kit,150,300,150,1,00149,India
433687,2023-08-31,717,spiral bound book,50,100,50,1,00149,India
433687,2023-08-31,710,geometry box,100,150,50,1,00149,India
433687,2023-08-31,714,carbon paper,15,30,15,1,00149,India
433687,2023-08-31,713,ball pen,5,10,5,1,00149,India
559315,2023-08-31,710,geometry box,100,150,50,1,00011,India
559315,2023-08-31,712,graph paper,20,40,20,1,00011,India
559315,2023-08-31,717,spiral bound book,50,100,50,1,00011,India
559315,2023-08-31,703,eraser,1,3,2,1,00011,India
484527,2023-08-31,703,eraser,1,3,2,1,00371,India
484527,2023-08-31,707,marker,20,40,20,1,00371,India
458095,2023-08-31,714,carbon paper,15,30,15,1,00143,India
458095,2023-08-31,703,eraser,1,3,2,1,00143,India
458095,2023-08-31,705,stencil,10,20,10,1,00143,India
458095,2023-08-31,716,printing paper,200,400,200,1,00143,India
458095,2023-08-31,715,folder,5,15,10,1,00143,India
720927,2023-08-31,707,marker,20,40,20,1,00079,India
720927,2023-08-31,705,stencil,10,20,10,1,00079,India
763304,2023-08-31,717,spiral bound book,50,100,50,1,00409,India
763304,2023-08-31,714,carbon paper,15,30,15,1,00409,India
630153,2023-08-31,706,sharpener,3,8,5,1,00081,India
630153,2023-08-31,708,sketchpen,15,40,25,1,00081,India
953875,2023-08-31,701,gel pen,5,10,5,1,00045,India
953875,2023-08-31,712,graph paper,20,40,20,1,00045,India
953875,2023-08-31,715,folder,5,15,10,1,00045,India
953875,2023-08-31,703,eraser,1,3,2,1,00045,India
491459,2023-08-31,709,notebook,30,60,30,1,00267,India
630354,2023-08-31,711,TD kit,150,300,150,1,00217,India
630354,2023-08-31,715,folder,5,15,10,1,00217,India
515856,2023-08-31,717,spiral bound book,50,100,50,1,00497,India
529964,2023-08-31,701,gel pen,5,10,5,1,00164,India
631255,2023-08-31,701,gel pen,5,10,5,1,00116,India
631255,2023-08-31,708,sketchpen,15,40,25,1,00116,India
631255,2023-08-31,711,TD kit,150,300,150,1,00116,India
631255,2023-08-31,703,eraser,1,3,2,1,00116,India
190024,2023-08-31,716,printing paper,200,400,200,1,00491,India
190024,2023-08-31,715,folder,5,15,10,1,00491,India
868777,2023-08-31,710,geometry box,100,150,50,1,00114,India
868777,2023-08-31,707,marker,20,40,20,1,00114,India
868777,2023-08-31,716,printing paper,200,400,200,1,00114,India
868777,2023-08-31,703,eraser,1,3,2,1,00114,India
644182,2023-08-31,707,marker,20,40,20,1,00332,India
644182,2023-08-31,702,pencil,2,5,3,1,00332,India
604190,2023-08-31,713,ball pen,5,10,5,1,00449,India
831370,2023-08-31,706,sharpener,3,8,5,1,00362,India
831370,2023-08-31,711,TD kit,150,300,150,1,00362,India
719964,2023-08-31,702,pencil,2,5,3,1,00344,India
226075,2023-08-31,716,printing paper,200,400,200,1,00244,India
226075,2023-08-31,704,scale,5,10,5,1,00244,India
226075,2023-08-31,712,graph paper,20,40,20,1,00244,India
781581,2023-08-31,705,stencil,10,20,10,1,00206,India
781581,2023-08-31,714,carbon paper,15,30,15,1,00206,India
788587,2023-09-01,713,ball pen,5,10,5,1,00433,India
513421,2023-09-01,706,sharpener,3,8,5,1,00270,India
513421,2023-09-01,709,notebook,30,60,30,1,00270,India
513421,2023-09-01,705,stencil,10,20,10,1,00270,India
513421,2023-09-01,712,graph paper,20,40,20,1,00270,India
891373,2023-09-01,717,spiral bound book,50,100,50,1,00399,India
355810,2023-09-01,703,eraser,1,3,2,1,00288,India
355810,2023-09-01,717,spiral bound book,50,100,50,1,00288,India
355810,2023-09-01,707,marker,20,40,20,1,00288,India
355810,2023-09-01,713,ball pen,5,10,5,1,00288,India
591391,2023-09-01,707,marker,20,40,20,1,00144,India
591391,2023-09-01,712,graph paper,20,40,20,1,00144,India
551050,2023-09-01,704,scale,5,10,5,1,00048,India
551050,2023-09-01,716,printing paper,200,400,200,1,00048,India
551050,2023-09-01,715,folder,5,15,10,1,00048,India
106670,2023-09-01,716,printing paper,200,400,200,1,00036,India
106670,2023-09-01,702,pencil,2,5,3,1,00036,India
106670,2023-09-01,705,stencil,10,20,10,1,00036,India
228831,2023-09-01,706,sharpener,3,8,5,1,00420,India
228831,2023-09-01,705,stencil,10,20,10,1,00420,India
228831,2023-09-01,716,printing paper,200,400,200,1,00420,India
880542,2023-09-01,703,eraser,1,3,2,1,00005,India
535630,2023-09-01,706,sharpener,3,8,5,1,00423,India
306982,2023-09-01,716,printing paper,200,400,200,1,00032,India
306982,2023-09-01,701,gel pen,5,10,5,1,00032,India
306982,2023-09-01,705,stencil,10,20,10,1,00032,India
306982,2023-09-01,706,sharpener,3,8,5,1,00032,India
353327,2023-09-01,706,sharpener,3,8,5,1,00011,India
353327,2023-09-01,702,pencil,2,5,3,1,00011,India
353327,2023-09-01,705,stencil,10,20,10,1,00011,India
353327,2023-09-01,714,carbon paper,15,30,15,1,00011,India
902862,2023-09-01,715,folder,5,15,10,1,00227,India
902862,2023-09-01,713,ball pen,5,10,5,1,00227,India
902862,2023-09-01,702,pencil,2,5,3,1,00227,India
902862,2023-09-01,712,graph paper,20,40,20,1,00227,India
771905,2023-09-01,709,notebook,30,60,30,1,00183,India
771905,2023-09-01,717,spiral bound book,50,100,50,1,00183,India
771905,2023-09-01,712,graph paper,20,40,20,1,00183,India
385083,2023-09-01,711,TD kit,150,300,150,1,00259,India
426487,2023-09-01,713,ball pen,5,10,5,1,00074,India
426487,2023-09-01,706,sharpener,3,8,5,1,00074,India
426487,2023-09-01,703,eraser,1,3,2,1,00074,India
426487,2023-09-01,704,scale,5,10,5,1,00074,India
880236,2023-09-01,704,scale,5,10,5,1,00067,India
880236,2023-09-01,711,TD kit,150,300,150,1,00067,India
880236,2023-09-01,709,notebook,30,60,30,1,00067,India
880236,2023-09-01,713,ball pen,5,10,5,1,00067,India
880236,2023-09-01,705,stencil,10,20,10,1,00067,India
802351,2023-09-01,704,scale,5,10,5,1,00060,India
802351,2023-09-01,710,geometry box,100,150,50,1,00060,India
802351,2023-09-01,701,gel pen,5,10,5,1,00060,India
476117,2023-09-01,706,sharpener,3,8,5,1,00053,India
476117,2023-09-01,703,eraser,1,3,2,1,00053,India
476117,2023-09-01,716,printing paper,200,400,200,1,00053,India
552906,2023-09-01,709,notebook,30,60,30,1,00485,India
552906,2023-09-01,704,scale,5,10,5,1,00485,India
193844,2023-09-01,709,notebook,30,60,30,1,00073,India
193844,2023-09-01,703,eraser,1,3,2,1,00073,India
193844,2023-09-01,705,stencil,10,20,10,1,00073,India
656583,2023-09-01,709,notebook,30,60,30,1,00279,India
703633,2023-09-01,706,sharpener,3,8,5,1,00043,India
703633,2023-09-01,715,folder,5,15,10,1,00043,India
703633,2023-09-01,710,geometry box,100,150,50,1,00043,India
694917,2023-09-01,703,eraser,1,3,2,1,00239,India
189553,2023-09-01,709,notebook,30,60,30,1,00072,India
189553,2023-09-01,717,spiral bound book,50,100,50,1,00072,India
189553,2023-09-01,703,eraser,1,3,2,1,00072,India
189553,2023-09-01,712,graph paper,20,40,20,1,00072,India
799901,2023-09-01,716,printing paper,200,400,200,1,00465,India
799901,2023-09-01,712,graph paper,20,40,20,1,00465,India
799901,2023-09-01,702,pencil,2,5,3,1,00465,India
311542,2023-09-01,714,carbon paper,15,30,15,1,00044,India
311542,2023-09-01,712,graph paper,20,40,20,1,00044,India
581738,2023-09-01,709,notebook,30,60,30,1,00364,India
581738,2023-09-01,705,stencil,10,20,10,1,00364,India
581738,2023-09-01,701,gel pen,5,10,5,1,00364,India
488537,2023-09-01,712,graph paper,20,40,20,1,00091,India
488537,2023-09-01,710,geometry box,100,150,50,1,00091,India
488537,2023-09-01,717,spiral bound book,50,100,50,1,00091,India
814097,2023-09-01,710,geometry box,100,150,50,1,00142,India
814097,2023-09-01,708,sketchpen,15,40,25,1,00142,India
814097,2023-09-01,711,TD kit,150,300,150,1,00142,India
814097,2023-09-01,714,carbon paper,15,30,15,1,00142,India
179741,2023-09-01,716,printing paper,200,400,200,1,00009,India
179741,2023-09-01,713,ball pen,5,10,5,1,00009,India
179741,2023-09-01,705,stencil,10,20,10,1,00009,India
179741,2023-09-01,707,marker,20,40,20,1,00009,India
115261,2023-09-01,708,sketchpen,15,40,25,1,00046,India
115261,2023-09-01,712,graph paper,20,40,20,1,00046,India
115261,2023-09-01,703,eraser,1,3,2,1,00046,India
115261,2023-09-01,715,folder,5,15,10,1,00046,India
397490,2023-09-01,713,ball pen,5,10,5,1,00247,India
397490,2023-09-01,702,pencil,2,5,3,1,00247,India
397490,2023-09-01,712,graph paper,20,40,20,1,00247,India
663142,2023-09-01,703,eraser,1,3,2,1,00064,India
663142,2023-09-01,711,TD kit,150,300,150,1,00064,India
663142,2023-09-01,715,folder,5,15,10,1,00064,India
663142,2023-09-01,714,carbon paper,15,30,15,1,00064,India
765311,2023-09-01,710,geometry box,100,150,50,1,00350,India
765311,2023-09-01,703,eraser,1,3,2,1,00350,India
765311,2023-09-01,708,sketchpen,15,40,25,1,00350,India
296873,2023-09-01,713,ball pen,5,10,5,1,00303,India
342322,2023-09-01,717,spiral bound book,50,100,50,1,00017,India
342322,2023-09-01,715,folder,5,15,10,1,00017,India
342322,2023-09-01,713,ball pen,5,10,5,1,00017,India
342322,2023-09-01,701,gel pen,5,10,5,1,00017,India
769625,2023-09-01,715,folder,5,15,10,1,00437,India
930574,2023-09-01,701,gel pen,5,10,5,1,00492,India
930574,2023-09-01,707,marker,20,40,20,1,00492,India
930574,2023-09-01,706,sharpener,3,8,5,1,00492,India
186520,2023-09-01,704,scale,5,10,5,1,00105,India
768614,2023-09-01,707,marker,20,40,20,1,00003,India
768614,2023-09-01,703,eraser,1,3,2,1,00003,India
688716,2023-09-01,715,folder,5,15,10,1,00459,India
490010,2023-09-01,712,graph paper,20,40,20,1,00426,India
911310,2023-09-01,708,sketchpen,15,40,25,1,00355,India
911310,2023-09-01,702,pencil,2,5,3,1,00355,India
911310,2023-09-01,715,folder,5,15,10,1,00355,India
911310,2023-09-01,713,ball pen,5,10,5,1,00355,India
923723,2023-09-01,714,carbon paper,15,30,15,1,00085,India
923723,2023-09-01,703,eraser,1,3,2,1,00085,India
923723,2023-09-01,705,stencil,10,20,10,1,00085,India
923723,2023-09-01,717,spiral bound book,50,100,50,1,00085,India
923723,2023-09-01,709,notebook,30,60,30,1,00085,India
401777,2023-09-01,702,pencil,2,5,3,1,00001,India
940307,2023-09-01,716,printing paper,200,400,200,1,00162,India
940307,2023-09-01,710,geometry box,100,150,50,1,00162,India
940307,2023-09-01,704,scale,5,10,5,1,00162,India
940307,2023-09-01,707,marker,20,40,20,1,00162,India
391516,2023-09-02,716,printing paper,200,400,200,1,00047,India
391516,2023-09-02,704,scale,5,10,5,1,00047,India
738561,2023-09-02,706,sharpener,3,8,5,1,00055,India
865988,2023-09-02,709,notebook,30,60,30,1,00466,India
865988,2023-09-02,711,TD kit,150,300,150,1,00466,India
865988,2023-09-02,701,gel pen,5,10,5,1,00466,India
865988,2023-09-02,712,graph paper,20,40,20,1,00466,India
865988,2023-09-02,703,eraser,1,3,2,1,00466,India
341956,2023-09-02,711,TD kit,150,300,150,1,00090,India
341956,2023-09-02,715,folder,5,15,10,1,00090,India
341956,2023-09-02,701,gel pen,5,10,5,1,00090,India
981606,2023-09-02,705,stencil,10,20,10,1,00166,India
981606,2023-09-02,708,sketchpen,15,40,25,1,00166,India
981606,2023-09-02,711,TD kit,150,300,150,1,00166,India
595411,2023-09-02,715,folder,5,15,10,1,00325,India
639991,2023-09-02,710,geometry box,100,150,50,1,00314,India
639991,2023-09-02,712,graph paper,20,40,20,1,00314,India
639991,2023-09-02,703,eraser,1,3,2,1,00314,India
639991,2023-09-02,702,pencil,2,5,3,1,00314,India
992994,2023-09-02,710,geometry box,100,150,50,1,00293,India
992994,2023-09-02,705,stencil,10,20,10,1,00293,India
992994,2023-09-02,701,gel pen,5,10,5,1,00293,India
992994,2023-09-02,717,spiral bound book,50,100,50,1,00293,India
162892,2023-09-02,708,sketchpen,15,40,25,1,00117,India
162892,2023-09-02,704,scale,5,10,5,1,00117,India
162892,2023-09-02,710,geometry box,100,150,50,1,00117,India
131008,2023-09-02,709,notebook,30,60,30,1,00141,India
131008,2023-09-02,715,folder,5,15,10,1,00141,India
131008,2023-09-02,716,printing paper,200,400,200,1,00141,India
628231,2023-09-02,710,geometry box,100,150,50,1,00180,India
628231,2023-09-02,715,folder,5,15,10,1,00180,India
628231,2023-09-02,713,ball pen,5,10,5,1,00180,India
628231,2023-09-02,706,sharpener,3,8,5,1,00180,India
814047,2023-09-02,709,notebook,30,60,30,1,00159,India
814047,2023-09-02,707,marker,20,40,20,1,00159,India
814047,2023-09-02,714,carbon paper,15,30,15,1,00159,India
814047,2023-09-02,708,sketchpen,15,40,25,1,00159,India
814047,2023-09-02,701,gel pen,5,10,5,1,00159,India
513138,2023-09-02,702,pencil,2,5,3,1,00004,India
513138,2023-09-02,714,carbon paper,15,30,15,1,00004,India
513138,2023-09-02,717,spiral bound book,50,100,50,1,00004,India
513138,2023-09-02,712,graph paper,20,40,20,1,00004,India
412114,2023-09-02,712,graph paper,20,40,20,1,00208,India
412114,2023-09-02,713,ball pen,5,10,5,1,00208,India
412114,2023-09-02,717,spiral bound book,50,100,50,1,00208,India
826436,2023-09-02,715,folder,5,15,10,1,00190,India
826436,2023-09-02,714,carbon paper,15,30,15,1,00190,India
826436,2023-09-02,706,sharpener,3,8,5,1,00190,India
971237,2023-09-02,708,sketchpen,15,40,25,1,00359,India
971237,2023-09-02,717,spiral bound book,50,100,50,1,00359,India
971237,2023-09-02,706,sharpener,3,8,5,1,00359,India
436534,2023-09-02,717,spiral bound book,50,100,50,1,00019,India
436534,2023-09-02,704,scale,5,10,5,1,00019,India
436534,2023-09-02,712,graph paper,20,40,20,1,00019,India
436534,2023-09-02,703,eraser,1,3,2,1,00019,India
367182,2023-09-02,712,graph paper,20,40,20,1,00041,India
367182,2023-09-02,707,marker,20,40,20,1,00041,India
471408,2023-09-02,714,carbon paper,15,30,15,1,00048,India
471408,2023-09-02,712,graph paper,20,40,20,1,00048,India
471408,2023-09-02,716,printing paper,200,400,200,1,00048,India
942770,2023-09-02,703,eraser,1,3,2,1,00131,India
117065,2023-09-02,711,TD kit,150,300,150,1,00312,India
117065,2023-09-02,703,eraser,1,3,2,1,00312,India
737478,2023-09-02,710,geometry box,100,150,50,1,00492,India
737478,2023-09-02,703,eraser,1,3,2,1,00492,India
737478,2023-09-02,714,carbon paper,15,30,15,1,00492,India
291072,2023-09-02,715,folder,5,15,10,1,00143,India
318516,2023-09-02,703,eraser,1,3,2,1,00250,India
318516,2023-09-02,713,ball pen,5,10,5,1,00250,India
387943,2023-09-02,704,scale,5,10,5,1,00254,India
387943,2023-09-02,717,spiral bound book,50,100,50,1,00254,India
387943,2023-09-02,716,printing paper,200,400,200,1,00254,India
387943,2023-09-02,711,TD kit,150,300,150,1,00254,India
594761,2023-09-02,709,notebook,30,60,30,1,00311,India
594761,2023-09-02,714,carbon paper,15,30,15,1,00311,India
594761,2023-09-02,706,sharpener,3,8,5,1,00311,India
448174,2023-09-02,717,spiral bound book,50,100,50,1,00084,India
255069,2023-09-02,713,ball pen,5,10,5,1,00463,India
577044,2023-09-02,701,gel pen,5,10,5,1,00088,India
577044,2023-09-02,717,spiral bound book,50,100,50,1,00088,India
577044,2023-09-02,714,carbon paper,15,30,15,1,00088,India
577044,2023-09-02,705,stencil,10,20,10,1,00088,India
676857,2023-09-02,702,pencil,2,5,3,1,00187,India
109690,2023-09-02,704,scale,5,10,5,1,00193,India
109690,2023-09-02,717,spiral bound book,50,100,50,1,00193,India
109690,2023-09-02,701,gel pen,5,10,5,1,00193,India
295687,2023-09-02,715,folder,5,15,10,1,00364,India
295687,2023-09-02,706,sharpener,3,8,5,1,00364,India
910040,2023-09-02,708,sketchpen,15,40,25,1,00452,India
279085,2023-09-03,710,geometry box,100,150,50,1,00411,India
279085,2023-09-03,706,sharpener,3,8,5,1,00411,India
279085,2023-09-03,703,eraser,1,3,2,1,00411,India
777363,2023-09-03,707,marker,20,40,20,1,00011,India
620956,2023-09-03,710,geometry box,100,150,50,1,00231,India
620956,2023-09-03,709,notebook,30,60,30,1,00231,India
620956,2023-09-03,713,ball pen,5,10,5,1,00231,India
620956,2023-09-03,704,scale,5,10,5,1,00231,India
620956,2023-09-03,705,stencil,10,20,10,1,00231,India
750265,2023-09-03,709,notebook,30,60,30,1,00494,India
855255,2023-09-03,705,stencil,10,20,10,1,00058,India
653160,2023-09-03,705,stencil,10,20,10,1,00093,India
653160,2023-09-03,707,marker,20,40,20,1,00093,India
653160,2023-09-03,714,carbon paper,15,30,15,1,00093,India
653160,2023-09-03,716,printing paper,200,400,200,1,00093,India
960903,2023-09-03,704,scale,5,10,5,1,00404,India
960903,2023-09-03,701,gel pen,5,10,5,1,00404,India
960903,2023-09-03,705,stencil,10,20,10,1,00404,India
256400,2023-09-03,712,graph paper,20,40,20,1,00345,India
256400,2023-09-03,707,marker,20,40,20,1,00345,India
256400,2023-09-03,715,folder,5,15,10,1,00345,India
599716,2023-09-03,703,eraser,1,3,2,1,00011,India
591417,2023-09-03,712,graph paper,20,40,20,1,00118,India
591417,2023-09-03,708,sketchpen,15,40,25,1,00118,India
591417,2023-09-03,713,ball pen,5,10,5,1,00118,India
658382,2023-09-03,712,graph paper,20,40,20,1,00370,India
658382,2023-09-03,704,scale,5,10,5,1,00370,India
658382,2023-09-03,705,stencil,10,20,10,1,00370,India
658382,2023-09-03,716,printing paper,200,400,200,1,00370,India
658382,2023-09-03,707,marker,20,40,20,1,00370,India
334885,2023-09-03,713,ball pen,5,10,5,1,00041,India
334885,2023-09-03,712,graph paper,20,40,20,1,00041,India
473021,2023-09-03,714,carbon paper,15,30,15,1,00366,India
473021,2023-09-03,717,spiral bound book,50,100,50,1,00366,India
473021,2023-09-03,706,sharpener,3,8,5,1,00366,India
766509,2023-09-03,708,sketchpen,15,40,25,1,00131,India
766509,2023-09-03,711,TD kit,150,300,150,1,00131,India
229435,2023-09-03,702,pencil,2,5,3,1,00254,India
229435,2023-09-03,705,stencil,10,20,10,1,00254,India
782039,2023-09-03,717,spiral bound book,50,100,50,1,00004,India
782039,2023-09-03,709,notebook,30,60,30,1,00004,India
782039,2023-09-03,716,printing paper,200,400,200,1,00004,India
782039,2023-09-03,702,pencil,2,5,3,1,00004,India
809664,2023-09-03,706,sharpener,3,8,5,1,00399,India
809664,2023-09-03,716,printing paper,200,400,200,1,00399,India
809664,2023-09-03,707,marker,20,40,20,1,00399,India
701511,2023-09-03,708,sketchpen,15,40,25,1,00021,India
701511,2023-09-03,712,graph paper,20,40,20,1,00021,India
701511,2023-09-03,714,carbon paper,15,30,15,1,00021,India
321701,2023-09-03,714,carbon paper,15,30,15,1,00227,India
321701,2023-09-03,715,folder,5,15,10,1,00227,India
321701,2023-09-03,706,sharpener,3,8,5,1,00227,India
321701,2023-09-03,708,sketchpen,15,40,25,1,00227,India
321701,2023-09-03,705,stencil,10,20,10,1,00227,India
628381,2023-09-03,704,scale,5,10,5,1,00249,India
552446,2023-09-03,701,gel pen,5,10,5,1,00341,India
600963,2023-09-03,708,sketchpen,15,40,25,1,00259,India
600963,2023-09-03,703,eraser,1,3,2,1,00259,India
600963,2023-09-03,710,geometry box,100,150,50,1,00259,India
368970,2023-09-03,710,geometry box,100,150,50,1,00297,India
368970,2023-09-03,706,sharpener,3,8,5,1,00297,India
368970,2023-09-03,709,notebook,30,60,30,1,00297,India
637422,2023-09-03,714,carbon paper,15,30,15,1,00382,India
832969,2023-09-03,711,TD kit,150,300,150,1,00085,India
832969,2023-09-03,704,scale,5,10,5,1,00085,India
832969,2023-09-03,713,ball pen,5,10,5,1,00085,India
250309,2023-09-03,705,stencil,10,20,10,1,00380,India
250309,2023-09-03,715,folder,5,15,10,1,00380,India
250309,2023-09-03,711,TD kit,150,300,150,1,00380,India
250309,2023-09-03,702,pencil,2,5,3,1,00380,India
170380,2023-09-03,711,TD kit,150,300,150,1,00213,India
170380,2023-09-03,710,geometry box,100,150,50,1,00213,India
303417,2023-09-03,708,sketchpen,15,40,25,1,00065,India
303417,2023-09-03,707,marker,20,40,20,1,00065,India
303417,2023-09-03,713,ball pen,5,10,5,1,00065,India
303417,2023-09-03,706,sharpener,3,8,5,1,00065,India
303417,2023-09-03,710,geometry box,100,150,50,1,00065,India
377014,2023-09-03,710,geometry box,100,150,50,1,00230,India
377014,2023-09-03,703,eraser,1,3,2,1,00230,India
377014,2023-09-03,713,ball pen,5,10,5,1,00230,India
431390,2023-09-03,703,eraser,1,3,2,1,00441,India
431390,2023-09-03,712,graph paper,20,40,20,1,00441,India
431390,2023-09-03,710,geometry box,100,150,50,1,00441,India
294664,2023-09-03,702,pencil,2,5,3,1,00294,India
294664,2023-09-03,711,TD kit,150,300,150,1,00294,India
294664,2023-09-03,709,notebook,30,60,30,1,00294,India
294664,2023-09-03,704,scale,5,10,5,1,00294,India
189053,2023-09-03,705,stencil,10,20,10,1,00494,India
189053,2023-09-03,715,folder,5,15,10,1,00494,India
189053,2023-09-03,713,ball pen,5,10,5,1,00494,India
189053,2023-09-03,701,gel pen,5,10,5,1,00494,India
897578,2023-09-03,714,carbon paper,15,30,15,1,00336,India
897578,2023-09-03,709,notebook,30,60,30,1,00336,India
897578,2023-09-03,707,marker,20,40,20,1,00336,India
558790,2023-09-03,717,spiral bound book,50,100,50,1,00185,India
558790,2023-09-03,708,sketchpen,15,40,25,1,00185,India
558790,2023-09-03,711,TD kit,150,300,150,1,00185,India
570045,2023-09-03,701,gel pen,5,10,5,1,00083,India
570045,2023-09-03,711,TD kit,150,300,150,1,00083,India
710609,2023-09-03,715,folder,5,15,10,1,00276,India
710609,2023-09-03,704,scale,5,10,5,1,00276,India
710609,2023-09-03,716,printing paper,200,400,200,1,00276,India
176903,2023-09-03,704,scale,5,10,5,1,00015,India
176903,2023-09-03,717,spiral bound book,50,100,50,1,00015,India
176903,2023-09-03,701,gel pen,5,10,5,1,00015,India
865419,2023-09-03,714,carbon paper,15,30,15,1,00374,India
865419,2023-09-03,706,sharpener,3,8,5,1,00374,India
865419,2023-09-03,716,printing paper,200,400,200,1,00374,India
865419,2023-09-03,704,scale,5,10,5,1,00374,India
865419,2023-09-03,712,graph paper,20,40,20,1,00374,India
606933,2023-09-03,709,notebook,30,60,30,1,00399,India
606933,2023-09-03,715,folder,5,15,10,1,00399,India
606933,2023-09-03,712,graph paper,20,40,20,1,00399,India
588054,2023-09-03,701,gel pen,5,10,5,1,00354,India
588054,2023-09-03,715,folder,5,15,10,1,00354,India
588054,2023-09-03,709,notebook,30,60,30,1,00354,India
588054,2023-09-03,710,geometry box,100,150,50,1,00354,India
268239,2023-09-03,702,pencil,2,5,3,1,00178,India
268239,2023-09-03,715,folder,5,15,10,1,00178,India
542489,2023-09-03,717,spiral bound book,50,100,50,1,00314,India
542489,2023-09-03,712,graph paper,20,40,20,1,00314,India
542489,2023-09-03,716,printing paper,200,400,200,1,00314,India
542489,2023-09-03,710,geometry box,100,150,50,1,00314,India
271690,2023-09-03,717,spiral bound book,50,100,50,1,00153,India
271690,2023-09-03,708,sketchpen,15,40,25,1,00153,India
271690,2023-09-03,701,gel pen,5,10,5,1,00153,India
592675,2023-09-03,709,notebook,30,60,30,1,00038,India
592675,2023-09-03,705,stencil,10,20,10,1,00038,India
592675,2023-09-03,714,carbon paper,15,30,15,1,00038,India
684734,2023-09-04,706,sharpener,3,8,5,1,00476,India
684734,2023-09-04,701,gel pen,5,10,5,1,00476,India
684734,2023-09-04,710,geometry box,100,150,50,1,00476,India
684734,2023-09-04,709,notebook,30,60,30,1,00476,India
982946,2023-09-04,706,sharpener,3,8,5,1,00442,India
982946,2023-09-04,711,TD kit,150,300,150,1,00442,India
101939,2023-09-04,705,stencil,10,20,10,1,00022,India
101939,2023-09-04,708,sketchpen,15,40,25,1,00022,India
581172,2023-09-04,716,printing paper,200,400,200,1,00289,India
581172,2023-09-04,705,stencil,10,20,10,1,00289,India
581172,2023-09-04,707,marker,20,40,20,1,00289,India
581172,2023-09-04,717,spiral bound book,50,100,50,1,00289,India
581172,2023-09-04,711,TD kit,150,300,150,1,00289,India
665014,2023-09-04,716,printing paper,200,400,200,1,00145,India
665014,2023-09-04,717,spiral bound book,50,100,50,1,00145,India
665014,2023-09-04,710,geometry box,100,150,50,1,00145,India
665014,2023-09-04,701,gel pen,5,10,5,1,00145,India
665014,2023-09-04,709,notebook,30,60,30,1,00145,India
420277,2023-09-04,711,TD kit,150,300,150,1,00413,India
420277,2023-09-04,701,gel pen,5,10,5,1,00413,India
420277,2023-09-04,712,graph paper,20,40,20,1,00413,India
283695,2023-09-04,702,pencil,2,5,3,1,00437,India
762923,2023-09-04,717,spiral bound book,50,100,50,1,00355,India
762923,2023-09-04,714,carbon paper,15,30,15,1,00355,India
762923,2023-09-04,710,geometry box,100,150,50,1,00355,India
762923,2023-09-04,704,scale,5,10,5,1,00355,India
218750,2023-09-04,717,spiral bound book,50,100,50,1,00224,India
218750,2023-09-04,709,notebook,30,60,30,1,00224,India
486176,2023-09-04,712,graph paper,20,40,20,1,00360,India
999380,2023-09-04,702,pencil,2,5,3,1,00053,India
999380,2023-09-04,715,folder,5,15,10,1,00053,India
999380,2023-09-04,707,marker,20,40,20,1,00053,India
208818,2023-09-04,705,stencil,10,20,10,1,00040,India
935623,2023-09-04,705,stencil,10,20,10,1,00409,India
136353,2023-09-04,715,folder,5,15,10,1,00137,India
606083,2023-09-04,708,sketchpen,15,40,25,1,00278,India
571217,2023-09-04,712,graph paper,20,40,20,1,00043,India
571217,2023-09-04,705,stencil,10,20,10,1,00043,India
571217,2023-09-04,716,printing paper,200,400,200,1,00043,India
571217,2023-09-04,710,geometry box,100,150,50,1,00043,India
681474,2023-09-04,707,marker,20,40,20,1,00452,India
681474,2023-09-04,709,notebook,30,60,30,1,00452,India
586031,2023-09-04,702,pencil,2,5,3,1,00409,India
586031,2023-09-04,704,scale,5,10,5,1,00409,India
586031,2023-09-04,709,notebook,30,60,30,1,00409,India
338399,2023-09-04,717,spiral bound book,50,100,50,1,00439,India
338399,2023-09-04,715,folder,5,15,10,1,00439,India
338399,2023-09-04,713,ball pen,5,10,5,1,00439,India
338399,2023-09-04,712,graph paper,20,40,20,1,00439,India
244905,2023-09-04,703,eraser,1,3,2,1,00495,India
244905,2023-09-04,715,folder,5,15,10,1,00495,India
244905,2023-09-04,713,ball pen,5,10,5,1,00495,India
244905,2023-09-04,705,stencil,10,20,10,1,00495,India
244905,2023-09-04,711,TD kit,150,300,150,1,00495,India
692865,2023-09-04,702,pencil,2,5,3,1,00450,India
692865,2023-09-04,710,geometry box,100,150,50,1,00450,India
235956,2023-09-04,703,eraser,1,3,2,1,00470,India
235956,2023-09-04,714,carbon paper,15,30,15,1,00470,India
766210,2023-09-04,701,gel pen,5,10,5,1,00398,India
766210,2023-09-04,704,scale,5,10,5,1,00398,India
483686,2023-09-04,706,sharpener,3,8,5,1,00448,India
483686,2023-09-04,703,eraser,1,3,2,1,00448,India
483686,2023-09-04,708,sketchpen,15,40,25,1,00448,India
894022,2023-09-04,716,printing paper,200,400,200,1,00097,India
679367,2023-09-04,716,printing paper,200,400,200,1,00345,India
679367,2023-09-04,714,carbon paper,15,30,15,1,00345,India
679367,2023-09-04,701,gel pen,5,10,5,1,00345,India
679367,2023-09-04,703,eraser,1,3,2,1,00345,India
105991,2023-09-04,710,geometry box,100,150,50,1,00136,India
105991,2023-09-04,703,eraser,1,3,2,1,00136,India
105991,2023-09-04,708,sketchpen,15,40,25,1,00136,India
560296,2023-09-04,706,sharpener,3,8,5,1,00461,India
560296,2023-09-04,711,TD kit,150,300,150,1,00461,India
704599,2023-09-04,701,gel pen,5,10,5,1,00052,India
580490,2023-09-04,703,eraser,1,3,2,1,00399,India
580490,2023-09-04,708,sketchpen,15,40,25,1,00399,India
580490,2023-09-04,705,stencil,10,20,10,1,00399,India
307312,2023-09-04,704,scale,5,10,5,1,00028,India
307312,2023-09-04,709,notebook,30,60,30,1,00028,India
166213,2023-09-04,708,sketchpen,15,40,25,1,00076,India
332411,2023-09-04,704,scale,5,10,5,1,00311,India
332411,2023-09-04,711,TD kit,150,300,150,1,00311,India
332411,2023-09-04,709,notebook,30,60,30,1,00311,India
332411,2023-09-04,717,spiral bound book,50,100,50,1,00311,India
565631,2023-09-04,705,stencil,10,20,10,1,00424,India
565631,2023-09-04,701,gel pen,5,10,5,1,00424,India
565631,2023-09-04,713,ball pen,5,10,5,1,00424,India
450152,2023-09-04,709,notebook,30,60,30,1,00037,India
450152,2023-09-04,716,printing paper,200,400,200,1,00037,India
450152,2023-09-04,705,stencil,10,20,10,1,00037,India
872097,2023-09-04,715,folder,5,15,10,1,00129,India
872097,2023-09-04,710,geometry box,100,150,50,1,00129,India
872097,2023-09-04,708,sketchpen,15,40,25,1,00129,India
730721,2023-09-05,712,graph paper,20,40,20,1,00139,India
730721,2023-09-05,705,stencil,10,20,10,1,00139,India
730721,2023-09-05,711,TD kit,150,300,150,1,00139,India
656091,2023-09-05,706,sharpener,3,8,5,1,00419,India
656091,2023-09-05,709,notebook,30,60,30,1,00419,India
164787,2023-09-05,713,ball pen,5,10,5,1,00252,India
854247,2023-09-05,707,marker,20,40,20,1,00292,India
854247,2023-09-05,703,eraser,1,3,2,1,00292,India
854247,2023-09-05,710,geometry box,100,150,50,1,00292,India
783156,2023-09-05,710,geometry box,100,150,50,1,00359,India
783156,2023-09-05,706,sharpener,3,8,5,1,00359,India
846678,2023-09-05,714,carbon paper,15,30,15,1,00289,India
846678,2023-09-05,701,gel pen,5,10,5,1,00289,India
846678,2023-09-05,704,scale,5,10,5,1,00289,India
846678,2023-09-05,707,marker,20,40,20,1,00289,India
846678,2023-09-05,716,printing paper,200,400,200,1,00289,India
673587,2023-09-05,707,marker,20,40,20,1,00490,India
673587,2023-09-05,704,scale,5,10,5,1,00490,India
909882,2023-09-05,701,gel pen,5,10,5,1,00419,India
909882,2023-09-05,710,geometry box,100,150,50,1,00419,India
909882,2023-09-05,714,carbon paper,15,30,15,1,00419,India
909882,2023-09-05,702,pencil,2,5,3,1,00419,India
909882,2023-09-05,705,stencil,10,20,10,1,00419,India
217492,2023-09-05,705,stencil,10,20,10,1,00444,India
217492,2023-09-05,714,carbon paper,15,30,15,1,00444,India
271859,2023-09-05,711,TD kit,150,300,150,1,00053,India
271859,2023-09-05,717,spiral bound book,50,100,50,1,00053,India
365304,2023-09-05,702,pencil,2,5,3,1,00465,India
411453,2023-09-05,712,graph paper,20,40,20,1,00083,India
411453,2023-09-05,710,geometry box,100,150,50,1,00083,India
411453,2023-09-05,704,scale,5,10,5,1,00083,India
411453,2023-09-05,714,carbon paper,15,30,15,1,00083,India
251777,2023-09-05,707,marker,20,40,20,1,00073,India
251777,2023-09-05,708,sketchpen,15,40,25,1,00073,India
211781,2023-09-05,701,gel pen,5,10,5,1,00204,India
211781,2023-09-05,707,marker,20,40,20,1,00204,India
908324,2023-09-05,717,spiral bound book,50,100,50,1,00062,India
908324,2023-09-05,702,pencil,2,5,3,1,00062,India
908324,2023-09-05,703,eraser,1,3,2,1,00062,India
908324,2023-09-05,709,notebook,30,60,30,1,00062,India
816153,2023-09-05,705,stencil,10,20,10,1,00166,India
816153,2023-09-05,716,printing paper,200,400,200,1,00166,India
816153,2023-09-05,706,sharpener,3,8,5,1,00166,India
904866,2023-09-05,708,sketchpen,15,40,25,1,00078,India
904866,2023-09-05,711,TD kit,150,300,150,1,00078,India
904866,2023-09-05,717,spiral bound book,50,100,50,1,00078,India
532645,2023-09-05,713,ball pen,5,10,5,1,00461,India
141343,2023-09-05,714,carbon paper,15,30,15,1,00320,India
141343,2023-09-05,710,geometry box,100,150,50,1,00320,India
141343,2023-09-05,705,stencil,10,20,10,1,00320,India
993638,2023-09-05,716,printing paper,200,400,200,1,00461,India
993638,2023-09-05,703,eraser,1,3,2,1,00461,India
993638,2023-09-05,707,marker,20,40,20,1,00461,India
993638,2023-09-05,715,folder,5,15,10,1,00461,India
937012,2023-09-05,707,marker,20,40,20,1,00365,India
937012,2023-09-05,712,graph paper,20,40,20,1,00365,India
937012,2023-09-05,704,scale,5,10,5,1,00365,India
455887,2023-09-05,713,ball pen,5,10,5,1,00439,India
455887,2023-09-05,708,sketchpen,15,40,25,1,00439,India
138946,2023-09-05,701,gel pen,5,10,5,1,00179,India
636489,2023-09-05,711,TD kit,150,300,150,1,00349,India
636489,2023-09-05,714,carbon paper,15,30,15,1,00349,India
448106,2023-09-05,715,folder,5,15,10,1,00434,India
319012,2023-09-05,709,notebook,30,60,30,1,00168,India
319012,2023-09-05,711,TD kit,150,300,150,1,00168,India
820429,2023-09-05,705,stencil,10,20,10,1,00191,India
820429,2023-09-05,701,gel pen,5,10,5,1,00191,India
963514,2023-09-05,717,spiral bound book,50,100,50,1,00056,India
963514,2023-09-05,705,stencil,10,20,10,1,00056,India
661264,2023-09-05,704,scale,5,10,5,1,00210,India
661264,2023-09-05,710,geometry box,100,150,50,1,00210,India
362323,2023-09-05,716,printing paper,200,400,200,1,00234,India
362323,2023-09-05,709,notebook,30,60,30,1,00234,India
415178,2023-09-05,703,eraser,1,3,2,1,00320,India
415178,2023-09-05,711,TD kit,150,300,150,1,00320,India
898040,2023-09-05,714,carbon paper,15,30,15,1,00428,India
898040,2023-09-05,712,graph paper,20,40,20,1,00428,India
898040,2023-09-05,709,notebook,30,60,30,1,00428,India
772290,2023-09-05,712,graph paper,20,40,20,1,00143,India
772290,2023-09-05,714,carbon paper,15,30,15,1,00143,India
772290,2023-09-05,710,geometry box,100,150,50,1,00143,India
316808,2023-09-05,714,carbon paper,15,30,15,1,00064,India
316808,2023-09-05,715,folder,5,15,10,1,00064,India
316808,2023-09-05,704,scale,5,10,5,1,00064,India
976374,2023-09-05,708,sketchpen,15,40,25,1,00232,India
492042,2023-09-05,716,printing paper,200,400,200,1,00172,India
492042,2023-09-05,713,ball pen,5,10,5,1,00172,India
492042,2023-09-05,708,sketchpen,15,40,25,1,00172,India
492042,2023-09-05,707,marker,20,40,20,1,00172,India
492042,2023-09-05,704,scale,5,10,5,1,00172,India
392420,2023-09-05,703,eraser,1,3,2,1,00016,India
392420,2023-09-05,709,notebook,30,60,30,1,00016,India
485339,2023-09-05,716,printing paper,200,400,200,1,00324,India
485339,2023-09-05,709,notebook,30,60,30,1,00324,India
485339,2023-09-05,715,folder,5,15,10,1,00324,India
743518,2023-09-05,705,stencil,10,20,10,1,00366,India
743518,2023-09-05,706,sharpener,3,8,5,1,00366,India
743518,2023-09-05,704,scale,5,10,5,1,00366,India
491322,2023-09-06,717,spiral bound book,50,100,50,1,00243,India
491322,2023-09-06,711,TD kit,150,300,150,1,00243,India
771437,2023-09-06,712,graph paper,20,40,20,1,00465,India
771437,2023-09-06,716,printing paper,200,400,200,1,00465,India
771437,2023-09-06,702,pencil,2,5,3,1,00465,India
771437,2023-09-06,707,marker,20,40,20,1,00465,India
366750,2023-09-06,703,eraser,1,3,2,1,00491,India
366750,2023-09-06,706,sharpener,3,8,5,1,00491,India
366750,2023-09-06,704,scale,5,10,5,1,00491,India
366750,2023-09-06,716,printing paper,200,400,200,1,00491,India
631723,2023-09-06,701,gel pen,5,10,5,1,00043,India
631723,2023-09-06,711,TD kit,150,300,150,1,00043,India
631723,2023-09-06,717,spiral bound book,50,100,50,1,00043,India
631723,2023-09-06,709,notebook,30,60,30,1,00043,India
422831,2023-09-06,713,ball pen,5,10,5,1,00062,India
422831,2023-09-06,704,scale,5,10,5,1,00062,India
422831,2023-09-06,712,graph paper,20,40,20,1,00062,India
484825,2023-09-06,711,TD kit,150,300,150,1,00056,India
484825,2023-09-06,704,scale,5,10,5,1,00056,India
484825,2023-09-06,710,geometry box,100,150,50,1,00056,India
507421,2023-09-06,713,ball pen,5,10,5,1,00437,India
507421,2023-09-06,711,TD kit,150,300,150,1,00437,India
507421,2023-09-06,707,marker,20,40,20,1,00437,India
507421,2023-09-06,716,printing paper,200,400,200,1,00437,India
440562,2023-09-06,707,marker,20,40,20,1,00129,India
440562,2023-09-06,702,pencil,2,5,3,1,00129,India
440562,2023-09-06,709,notebook,30,60,30,1,00129,India
612322,2023-09-06,717,spiral bound book,50,100,50,1,00488,India
221083,2023-09-06,706,sharpener,3,8,5,1,00475,India
792423,2023-09-06,713,ball pen,5,10,5,1,00246,India
792423,2023-09-06,702,pencil,2,5,3,1,00246,India
792423,2023-09-06,704,scale,5,10,5,1,00246,India
578406,2023-09-06,716,printing paper,200,400,200,1,00445,India
578406,2023-09-06,714,carbon paper,15,30,15,1,00445,India
578406,2023-09-06,713,ball pen,5,10,5,1,00445,India
578406,2023-09-06,707,marker,20,40,20,1,00445,India
127065,2023-09-06,707,marker,20,40,20,1,00104,India
127065,2023-09-06,708,sketchpen,15,40,25,1,00104,India
104692,2023-09-06,708,sketchpen,15,40,25,1,00078,India
104692,2023-09-06,710,geometry box,100,150,50,1,00078,India
104692,2023-09-06,706,sharpener,3,8,5,1,00078,India
821421,2023-09-06,717,spiral bound book,50,100,50,1,00383,India
821421,2023-09-06,713,ball pen,5,10,5,1,00383,India
827471,2023-09-06,705,stencil,10,20,10,1,00235,India
827471,2023-09-06,713,ball pen,5,10,5,1,00235,India
892380,2023-09-06,713,ball pen,5,10,5,1,00342,India
892380,2023-09-06,715,folder,5,15,10,1,00342,India
892380,2023-09-06,701,gel pen,5,10,5,1,00342,India
892380,2023-09-06,714,carbon paper,15,30,15,1,00342,India
350297,2023-09-06,717,spiral bound book,50,100,50,1,00092,India
350297,2023-09-06,710,geometry box,100,150,50,1,00092,India
350297,2023-09-06,703,eraser,1,3,2,1,00092,India
682016,2023-09-06,712,graph paper,20,40,20,1,00092,India
682016,2023-09-06,701,gel pen,5,10,5,1,00092,India
682016,2023-09-06,715,folder,5,15,10,1,00092,India
469004,2023-09-06,715,folder,5,15,10,1,00315,India
620402,2023-09-06,712,graph paper,20,40,20,1,00135,India
620402,2023-09-06,705,stencil,10,20,10,1,00135,India
620402,2023-09-06,713,ball pen,5,10,5,1,00135,India
620402,2023-09-06,716,printing paper,200,400,200,1,00135,India
620402,2023-09-06,704,scale,5,10,5,1,00135,India
999722,2023-09-06,710,geometry box,100,150,50,1,00432,India
999722,2023-09-06,708,sketchpen,15,40,25,1,00432,India
999722,2023-09-06,706,sharpener,3,8,5,1,00432,India
731451,2023-09-06,713,ball pen,5,10,5,1,00017,India
731451,2023-09-06,702,pencil,2,5,3,1,00017,India
731451,2023-09-06,707,marker,20,40,20,1,00017,India
731451,2023-09-06,708,sketchpen,15,40,25,1,00017,India
148065,2023-09-06,716,printing paper,200,400,200,1,00489,India
148065,2023-09-06,703,eraser,1,3,2,1,00489,India
301964,2023-09-06,709,notebook,30,60,30,1,00098,India
301964,2023-09-06,704,scale,5,10,5,1,00098,India
301964,2023-09-06,716,printing paper,200,400,200,1,00098,India
301964,2023-09-06,703,eraser,1,3,2,1,00098,India
105180,2023-09-06,705,stencil,10,20,10,1,00232,India
105180,2023-09-06,703,eraser,1,3,2,1,00232,India
105180,2023-09-06,701,gel pen,5,10,5,1,00232,India
108431,2023-09-06,701,gel pen,5,10,5,1,00302,India
108431,2023-09-06,703,eraser,1,3,2,1,00302,India
489801,2023-09-06,717,spiral bound book,50,100,50,1,00135,India
489801,2023-09-06,715,folder,5,15,10,1,00135,India
489801,2023-09-06,710,geometry box,100,150,50,1,00135,India
489801,2023-09-06,703,eraser,1,3,2,1,00135,India
489801,2023-09-06,707,marker,20,40,20,1,00135,India
800295,2023-09-06,713,ball pen,5,10,5,1,00103,India
800295,2023-09-06,707,marker,20,40,20,1,00103,India
402994,2023-09-06,712,graph paper,20,40,20,1,00188,India
402994,2023-09-06,709,notebook,30,60,30,1,00188,India
450996,2023-09-06,711,TD kit,150,300,150,1,00247,India
231860,2023-09-06,712,graph paper,20,40,20,1,00179,India
434591,2023-09-06,710,geometry box,100,150,50,1,00263,India
669230,2023-09-06,716,printing paper,200,400,200,1,00339,India
669230,2023-09-06,701,gel pen,5,10,5,1,00339,India
669230,2023-09-06,715,folder,5,15,10,1,00339,India
669230,2023-09-06,706,sharpener,3,8,5,1,00339,India
669230,2023-09-06,714,carbon paper,15,30,15,1,00339,India
299891,2023-09-06,708,sketchpen,15,40,25,1,00355,India
670729,2023-09-06,714,carbon paper,15,30,15,1,00029,India
240918,2023-09-06,703,eraser,1,3,2,1,00283,India
240918,2023-09-06,714,carbon paper,15,30,15,1,00283,India
240918,2023-09-06,709,notebook,30,60,30,1,00283,India
240918,2023-09-06,708,sketchpen,15,40,25,1,00283,India
665103,2023-09-06,711,TD kit,150,300,150,1,00099,India
858623,2023-09-06,704,scale,5,10,5,1,00005,India
858623,2023-09-06,707,marker,20,40,20,1,00005,India
395309,2023-09-06,714,carbon paper,15,30,15,1,00164,India
395309,2023-09-06,709,notebook,30,60,30,1,00164,India
538603,2023-09-06,709,notebook,30,60,30,1,00368,India
538603,2023-09-06,703,eraser,1,3,2,1,00368,India
484412,2023-09-06,707,marker,20,40,20,1,00181,India
484412,2023-09-06,710,geometry box,100,150,50,1,00181,India
484412,2023-09-06,715,folder,5,15,10,1,00181,India
520717,2023-09-06,716,printing paper,200,400,200,1,00037,India
520717,2023-09-06,710,geometry box,100,150,50,1,00037,India
222486,2023-09-06,703,eraser,1,3,2,1,00085,India
222486,2023-09-06,701,gel pen,5,10,5,1,00085,India
222486,2023-09-06,706,sharpener,3,8,5,1,00085,India
222486,2023-09-06,711,TD kit,150,300,150,1,00085,India
514169,2023-09-06,712,graph paper,20,40,20,1,00439,India
514169,2023-09-06,710,geometry box,100,150,50,1,00439,India
514169,2023-09-06,715,folder,5,15,10,1,00439,India
514169,2023-09-06,706,sharpener,3,8,5,1,00439,India
947064,2023-09-06,703,eraser,1,3,2,1,00210,India
947064,2023-09-06,707,marker,20,40,20,1,00210,India
947064,2023-09-06,706,sharpener,3,8,5,1,00210,India
947064,2023-09-06,716,printing paper,200,400,200,1,00210,India
947064,2023-09-06,711,TD kit,150,300,150,1,00210,India
690385,2023-09-07,707,marker,20,40,20,1,00493,India
690385,2023-09-07,715,folder,5,15,10,1,00493,India
690385,2023-09-07,717,spiral bound book,50,100,50,1,00493,India
690385,2023-09-07,708,sketchpen,15,40,25,1,00493,India
690385,2023-09-07,705,stencil,10,20,10,1,00493,India
850639,2023-09-07,703,eraser,1,3,2,1,00224,India
252053,2023-09-07,716,printing paper,200,400,200,1,00412,India
252053,2023-09-07,712,graph paper,20,40,20,1,00412,India
252053,2023-09-07,714,carbon paper,15,30,15,1,00412,India
632229,2023-09-07,710,geometry box,100,150,50,1,00391,India
632229,2023-09-07,712,graph paper,20,40,20,1,00391,India
632229,2023-09-07,709,notebook,30,60,30,1,00391,India
923162,2023-09-07,717,spiral bound book,50,100,50,1,00484,India
923162,2023-09-07,702,pencil,2,5,3,1,00484,India
923162,2023-09-07,704,scale,5,10,5,1,00484,India
923162,2023-09-07,715,folder,5,15,10,1,00484,India
925704,2023-09-07,716,printing paper,200,400,200,1,00408,India
925704,2023-09-07,702,pencil,2,5,3,1,00408,India
925704,2023-09-07,714,carbon paper,15,30,15,1,00408,India
890814,2023-09-07,703,eraser,1,3,2,1,00029,India
890814,2023-09-07,711,TD kit,150,300,150,1,00029,India
266946,2023-09-07,705,stencil,10,20,10,1,00107,India
266946,2023-09-07,709,notebook,30,60,30,1,00107,India
248034,2023-09-07,712,graph paper,20,40,20,1,00113,India
248034,2023-09-07,711,TD kit,150,300,150,1,00113,India
926684,2023-09-07,709,notebook,30,60,30,1,00007,India
926684,2023-09-07,701,gel pen,5,10,5,1,00007,India
842172,2023-09-07,717,spiral bound book,50,100,50,1,00021,India
842172,2023-09-07,713,ball pen,5,10,5,1,00021,India
842172,2023-09-07,707,marker,20,40,20,1,00021,India
283861,2023-09-07,710,geometry box,100,150,50,1,00340,India
283861,2023-09-07,703,eraser,1,3,2,1,00340,India
283861,2023-09-07,705,stencil,10,20,10,1,00340,India
283861,2023-09-07,711,TD kit,150,300,150,1,00340,India
525649,2023-09-07,706,sharpener,3,8,5,1,00382,India
525649,2023-09-07,714,carbon paper,15,30,15,1,00382,India
525649,2023-09-07,705,stencil,10,20,10,1,00382,India
525649,2023-09-07,715,folder,5,15,10,1,00382,India
871057,2023-09-07,705,stencil,10,20,10,1,00095,India
871057,2023-09-07,708,sketchpen,15,40,25,1,00095,India
871057,2023-09-07,714,carbon paper,15,30,15,1,00095,India
871057,2023-09-07,704,scale,5,10,5,1,00095,India
871057,2023-09-07,713,ball pen,5,10,5,1,00095,India
289433,2023-09-07,702,pencil,2,5,3,1,00285,India
289433,2023-09-07,717,spiral bound book,50,100,50,1,00285,India
289433,2023-09-07,704,scale,5,10,5,1,00285,India
289433,2023-09-07,710,geometry box,100,150,50,1,00285,India
289433,2023-09-07,716,printing paper,200,400,200,1,00285,India
884095,2023-09-07,717,spiral bound book,50,100,50,1,00365,India
884095,2023-09-07,715,folder,5,15,10,1,00365,India
884095,2023-09-07,706,sharpener,3,8,5,1,00365,India
884095,2023-09-07,704,scale,5,10,5,1,00365,India
368552,2023-09-07,717,spiral bound book,50,100,50,1,00459,India
368552,2023-09-07,706,sharpener,3,8,5,1,00459,India
368552,2023-09-07,705,stencil,10,20,10,1,00459,India
368552,2023-09-07,711,TD kit,150,300,150,1,00459,India
368552,2023-09-07,708,sketchpen,15,40,25,1,00459,India
503949,2023-09-07,715,folder,5,15,10,1,00023,India
894869,2023-09-07,716,printing paper,200,400,200,1,00018,India
520075,2023-09-07,708,sketchpen,15,40,25,1,00296,India
520075,2023-09-07,713,ball pen,5,10,5,1,00296,India
520075,2023-09-07,714,carbon paper,15,30,15,1,00296,India
324087,2023-09-07,705,stencil,10,20,10,1,00301,India
324087,2023-09-07,706,sharpener,3,8,5,1,00301,India
324087,2023-09-07,709,notebook,30,60,30,1,00301,India
324087,2023-09-07,711,TD kit,150,300,150,1,00301,India
324087,2023-09-07,717,spiral bound book,50,100,50,1,00301,India
628180,2023-09-07,706,sharpener,3,8,5,1,00228,India
628180,2023-09-07,701,gel pen,5,10,5,1,00228,India
628180,2023-09-07,711,TD kit,150,300,150,1,00228,India
628180,2023-09-07,715,folder,5,15,10,1,00228,India
397155,2023-09-07,703,eraser,1,3,2,1,00480,India
397155,2023-09-07,713,ball pen,5,10,5,1,00480,India
397155,2023-09-07,702,pencil,2,5,3,1,00480,India
622290,2023-09-07,714,carbon paper,15,30,15,1,00273,India
622290,2023-09-07,712,graph paper,20,40,20,1,00273,India
622290,2023-09-07,710,geometry box,100,150,50,1,00273,India
331395,2023-09-07,707,marker,20,40,20,1,00334,India
331395,2023-09-07,715,folder,5,15,10,1,00334,India
331395,2023-09-07,703,eraser,1,3,2,1,00334,India
331395,2023-09-07,709,notebook,30,60,30,1,00334,India
805316,2023-09-07,717,spiral bound book,50,100,50,1,00197,India
805316,2023-09-07,711,TD kit,150,300,150,1,00197,India
805316,2023-09-07,703,eraser,1,3,2,1,00197,India
805316,2023-09-07,712,graph paper,20,40,20,1,00197,India
805316,2023-09-07,706,sharpener,3,8,5,1,00197,India
786593,2023-09-07,706,sharpener,3,8,5,1,00020,India
786593,2023-09-07,715,folder,5,15,10,1,00020,India
844643,2023-09-07,702,pencil,2,5,3,1,00051,India
274350,2023-09-07,713,ball pen,5,10,5,1,00290,India
910428,2023-09-07,703,eraser,1,3,2,1,00028,India
161093,2023-09-07,714,carbon paper,15,30,15,1,00181,India
161093,2023-09-07,702,pencil,2,5,3,1,00181,India
161093,2023-09-07,704,scale,5,10,5,1,00181,India
161093,2023-09-07,705,stencil,10,20,10,1,00181,India
759605,2023-09-07,705,stencil,10,20,10,1,00459,India
700794,2023-09-07,704,scale,5,10,5,1,00432,India
700794,2023-09-07,706,sharpener,3,8,5,1,00432,India
700794,2023-09-07,713,ball pen,5,10,5,1,00432,India
700794,2023-09-07,705,stencil,10,20,10,1,00432,India
782072,2023-09-07,708,sketchpen,15,40,25,1,00392,India
782072,2023-09-07,714,carbon paper,15,30,15,1,00392,India
782072,2023-09-07,711,TD kit,150,300,150,1,00392,India
782072,2023-09-07,702,pencil,2,5,3,1,00392,India
166118,2023-09-07,706,sharpener,3,8,5,1,00281,India
538567,2023-09-07,717,spiral bound book,50,100,50,1,00360,India
538567,2023-09-07,702,pencil,2,5,3,1,00360,India
478111,2023-09-07,716,printing paper,200,400,200,1,00273,India
478111,2023-09-07,714,carbon paper,15,30,15,1,00273,India
478111,2023-09-07,710,geometry box,100,150,50,1,00273,India
478111,2023-09-07,701,gel pen,5,10,5,1,00273,India
940114,2023-09-07,713,ball pen,5,10,5,1,00203,India
940114,2023-09-07,712,graph paper,20,40,20,1,00203,India
940114,2023-09-07,709,notebook,30,60,30,1,00203,India
940114,2023-09-07,711,TD kit,150,300,150,1,00203,India
404663,2023-09-07,705,stencil,10,20,10,1,00204,India
727503,2023-09-07,705,stencil,10,20,10,1,00293,India
465691,2023-09-07,712,graph paper,20,40,20,1,00049,India
465691,2023-09-07,706,sharpener,3,8,5,1,00049,India
465691,2023-09-07,705,stencil,10,20,10,1,00049,India
614041,2023-09-07,709,notebook,30,60,30,1,00056,India
614041,2023-09-07,707,marker,20,40,20,1,00056,India
218532,2023-09-07,715,folder,5,15,10,1,00027,India
218532,2023-09-07,701,gel pen,5,10,5,1,00027,India
218532,2023-09-07,707,marker,20,40,20,1,00027,India
218532,2023-09-07,709,notebook,30,60,30,1,00027,India
218532,2023-09-07,717,spiral bound book,50,100,50,1,00027,India
757514,2023-09-07,709,notebook,30,60,30,1,00240,India
757514,2023-09-07,712,graph paper,20,40,20,1,00240,India
757514,2023-09-07,717,spiral bound book,50,100,50,1,00240,India
757514,2023-09-07,708,sketchpen,15,40,25,1,00240,India
757514,2023-09-07,706,sharpener,3,8,5,1,00240,India
574462,2023-09-07,709,notebook,30,60,30,1,00496,India
984707,2023-09-07,704,scale,5,10,5,1,00159,India
409051,2023-09-07,701,gel pen,5,10,5,1,00171,India
948325,2023-09-08,703,eraser,1,3,2,1,00429,India
948325,2023-09-08,717,spiral bound book,50,100,50,1,00429,India
948325,2023-09-08,710,geometry box,100,150,50,1,00429,India
615400,2023-09-08,709,notebook,30,60,30,1,00283,India
615400,2023-09-08,705,stencil,10,20,10,1,00283,India
615400,2023-09-08,713,ball pen,5,10,5,1,00283,India
380061,2023-09-08,709,notebook,30,60,30,1,00071,India
380061,2023-09-08,708,sketchpen,15,40,25,1,00071,India
380061,2023-09-08,706,sharpener,3,8,5,1,00071,India
953473,2023-09-08,704,scale,5,10,5,1,00183,India
953473,2023-09-08,712,graph paper,20,40,20,1,00183,India
153928,2023-09-08,709,notebook,30,60,30,1,00095,India
153928,2023-09-08,710,geometry box,100,150,50,1,00095,India
153928,2023-09-08,705,stencil,10,20,10,1,00095,India
153928,2023-09-08,708,sketchpen,15,40,25,1,00095,India
153928,2023-09-08,703,eraser,1,3,2,1,00095,India
126514,2023-09-08,708,sketchpen,15,40,25,1,00159,India
831114,2023-09-08,717,spiral bound book,50,100,50,1,00472,India
831114,2023-09-08,712,graph paper,20,40,20,1,00472,India
831114,2023-09-08,710,geometry box,100,150,50,1,00472,India
320553,2023-09-08,702,pencil,2,5,3,1,00157,India
320553,2023-09-08,709,notebook,30,60,30,1,00157,India
320553,2023-09-08,705,stencil,10,20,10,1,00157,India
320553,2023-09-08,704,scale,5,10,5,1,00157,India
320553,2023-09-08,716,printing paper,200,400,200,1,00157,India
207980,2023-09-08,710,geometry box,100,150,50,1,00252,India
207980,2023-09-08,705,stencil,10,20,10,1,00252,India
207980,2023-09-08,714,carbon paper,15,30,15,1,00252,India
207980,2023-09-08,707,marker,20,40,20,1,00252,India
222813,2023-09-08,704,scale,5,10,5,1,00281,India
577213,2023-09-08,703,eraser,1,3,2,1,00320,India
577213,2023-09-08,705,stencil,10,20,10,1,00320,India
577213,2023-09-08,710,geometry box,100,150,50,1,00320,India
577213,2023-09-08,715,folder,5,15,10,1,00320,India
516624,2023-09-08,701,gel pen,5,10,5,1,00352,India
516624,2023-09-08,715,folder,5,15,10,1,00352,India
516624,2023-09-08,708,sketchpen,15,40,25,1,00352,India
516624,2023-09-08,709,notebook,30,60,30,1,00352,India
516624,2023-09-08,713,ball pen,5,10,5,1,00352,India
137138,2023-09-08,706,sharpener,3,8,5,1,00023,India
137138,2023-09-08,712,graph paper,20,40,20,1,00023,India
609348,2023-09-08,717,spiral bound book,50,100,50,1,00432,India
609348,2023-09-08,704,scale,5,10,5,1,00432,India
325240,2023-09-08,704,scale,5,10,5,1,00119,India
421008,2023-09-08,717,spiral bound book,50,100,50,1,00177,India
421008,2023-09-08,710,geometry box,100,150,50,1,00177,India
421008,2023-09-08,715,folder,5,15,10,1,00177,India
421008,2023-09-08,716,printing paper,200,400,200,1,00177,India
421008,2023-09-08,712,graph paper,20,40,20,1,00177,India
536386,2023-09-08,709,notebook,30,60,30,1,00099,India
536386,2023-09-08,714,carbon paper,15,30,15,1,00099,India
536386,2023-09-08,701,gel pen,5,10,5,1,00099,India
196365,2023-09-08,708,sketchpen,15,40,25,1,00342,India
645038,2023-09-08,705,stencil,10,20,10,1,00329,India
645038,2023-09-08,706,sharpener,3,8,5,1,00329,India
363016,2023-09-08,717,spiral bound book,50,100,50,1,00270,India
363016,2023-09-08,716,printing paper,200,400,200,1,00270,India
678894,2023-09-08,705,stencil,10,20,10,1,00490,India
678894,2023-09-08,704,scale,5,10,5,1,00490,India
678894,2023-09-08,716,printing paper,200,400,200,1,00490,India
182597,2023-09-08,707,marker,20,40,20,1,00058,India
182597,2023-09-08,704,scale,5,10,5,1,00058,India
577949,2023-09-08,714,carbon paper,15,30,15,1,00410,India
620970,2023-09-08,709,notebook,30,60,30,1,00033,India
463169,2023-09-08,701,gel pen,5,10,5,1,00099,India
463169,2023-09-08,712,graph paper,20,40,20,1,00099,India
463169,2023-09-08,706,sharpener,3,8,5,1,00099,India
103839,2023-09-08,709,notebook,30,60,30,1,00423,India
103839,2023-09-08,716,printing paper,200,400,200,1,00423,India
299146,2023-09-08,706,sharpener,3,8,5,1,00297,India
299146,2023-09-08,704,scale,5,10,5,1,00297,India
299146,2023-09-08,711,TD kit,150,300,150,1,00297,India
504871,2023-09-08,708,sketchpen,15,40,25,1,00279,India
504871,2023-09-08,716,printing paper,200,400,200,1,00279,India
709494,2023-09-08,717,spiral bound book,50,100,50,1,00248,India
709494,2023-09-08,709,notebook,30,60,30,1,00248,India
870813,2023-09-08,704,scale,5,10,5,1,00152,India
870813,2023-09-08,706,sharpener,3,8,5,1,00152,India
726596,2023-09-08,710,geometry box,100,150,50,1,00325,India
612413,2023-09-08,716,printing paper,200,400,200,1,00459,India
612413,2023-09-08,715,folder,5,15,10,1,00459,India
289985,2023-09-08,708,sketchpen,15,40,25,1,00207,India
289985,2023-09-08,713,ball pen,5,10,5,1,00207,India
289985,2023-09-08,704,scale,5,10,5,1,00207,India
885970,2023-09-08,710,geometry box,100,150,50,1,00371,India
885970,2023-09-08,705,stencil,10,20,10,1,00371,India
885970,2023-09-08,712,graph paper,20,40,20,1,00371,India
885970,2023-09-08,707,marker,20,40,20,1,00371,India
885970,2023-09-08,713,ball pen,5,10,5,1,00371,India
837214,2023-09-08,702,pencil,2,5,3,1,00410,India
837214,2023-09-08,717,spiral bound book,50,100,50,1,00410,India
837214,2023-09-08,707,marker,20,40,20,1,00410,India
837214,2023-09-08,701,gel pen,5,10,5,1,00410,India
933002,2023-09-08,702,pencil,2,5,3,1,00405,India
933002,2023-09-08,712,graph paper,20,40,20,1,00405,India
933002,2023-09-08,704,scale,5,10,5,1,00405,India
933659,2023-09-08,714,carbon paper,15,30,15,1,00404,India
933659,2023-09-08,712,graph paper,20,40,20,1,00404,India
933659,2023-09-08,711,TD kit,150,300,150,1,00404,India
836427,2023-09-08,708,sketchpen,15,40,25,1,00405,India
504907,2023-09-08,709,notebook,30,60,30,1,00499,India
504907,2023-09-08,715,folder,5,15,10,1,00499,India
397703,2023-09-08,701,gel pen,5,10,5,1,00181,India
397703,2023-09-08,715,folder,5,15,10,1,00181,India
397703,2023-09-08,704,scale,5,10,5,1,00181,India
397703,2023-09-08,707,marker,20,40,20,1,00181,India
397703,2023-09-08,702,pencil,2,5,3,1,00181,India
915555,2023-09-08,701,gel pen,5,10,5,1,00013,India
915555,2023-09-08,702,pencil,2,5,3,1,00013,India
877078,2023-09-08,710,geometry box,100,150,50,1,00039,India
877078,2023-09-08,711,TD kit,150,300,150,1,00039,India
401753,2023-09-08,710,geometry box,100,150,50,1,00076,India
401753,2023-09-08,714,carbon paper,15,30,15,1,00076,India
401753,2023-09-08,713,ball pen,5,10,5,1,00076,India
317108,2023-09-08,710,geometry box,100,150,50,1,00011,India
317108,2023-09-08,709,notebook,30,60,30,1,00011,India
709319,2023-09-08,703,eraser,1,3,2,1,00391,India
709319,2023-09-08,711,TD kit,150,300,150,1,00391,India
709319,2023-09-08,702,pencil,2,5,3,1,00391,India
709319,2023-09-08,705,stencil,10,20,10,1,00391,India
453792,2023-09-08,701,gel pen,5,10,5,1,00419,India
453792,2023-09-08,707,marker,20,40,20,1,00419,India
453792,2023-09-08,702,pencil,2,5,3,1,00419,India
453792,2023-09-08,706,sharpener,3,8,5,1,00419,India
247972,2023-09-08,712,graph paper,20,40,20,1,00067,India
937658,2023-09-08,713,ball pen,5,10,5,1,00208,India
105777,2023-09-08,708,sketchpen,15,40,25,1,00277,India
105777,2023-09-08,704,scale,5,10,5,1,00277,India
105777,2023-09-08,712,graph paper,20,40,20,1,00277,India
105777,2023-09-08,705,stencil,10,20,10,1,00277,India
105777,2023-09-08,707,marker,20,40,20,1,00277,India
544539,2023-09-08,708,sketchpen,15,40,25,1,00228,India
544539,2023-09-08,715,folder,5,15,10,1,00228,India
417095,2023-09-09,713,ball pen,5,10,5,1,00233,India
417095,2023-09-09,706,sharpener,3,8,5,1,00233,India
417095,2023-09-09,702,pencil,2,5,3,1,00233,India
417095,2023-09-09,710,geometry box,100,150,50,1,00233,India
839466,2023-09-09,708,sketchpen,15,40,25,1,00065,India
839466,2023-09-09,714,carbon paper,15,30,15,1,00065,India
253419,2023-09-09,717,spiral bound book,50,100,50,1,00017,India
253419,2023-09-09,704,scale,5,10,5,1,00017,India
600211,2023-09-09,713,ball pen,5,10,5,1,00284,India
857919,2023-09-09,716,printing paper,200,400,200,1,00421,India
944623,2023-09-09,713,ball pen,5,10,5,1,00462,India
944623,2023-09-09,715,folder,5,15,10,1,00462,India
944623,2023-09-09,714,carbon paper,15,30,15,1,00462,India
944623,2023-09-09,701,gel pen,5,10,5,1,00462,India
411813,2023-09-09,713,ball pen,5,10,5,1,00334,India
411813,2023-09-09,712,graph paper,20,40,20,1,00334,India
498540,2023-09-09,713,ball pen,5,10,5,1,00347,India
498540,2023-09-09,715,folder,5,15,10,1,00347,India
472929,2023-09-09,715,folder,5,15,10,1,00357,India
472929,2023-09-09,707,marker,20,40,20,1,00357,India
472929,2023-09-09,701,gel pen,5,10,5,1,00357,India
587893,2023-09-09,717,spiral bound book,50,100,50,1,00311,India
720425,2023-09-09,707,marker,20,40,20,1,00265,India
720425,2023-09-09,712,graph paper,20,40,20,1,00265,India
720425,2023-09-09,701,gel pen,5,10,5,1,00265,India
720425,2023-09-09,706,sharpener,3,8,5,1,00265,India
990464,2023-09-09,706,sharpener,3,8,5,1,00404,India
990464,2023-09-09,708,sketchpen,15,40,25,1,00404,India
990464,2023-09-09,702,pencil,2,5,3,1,00404,India
990464,2023-09-09,714,carbon paper,15,30,15,1,00404,India
990464,2023-09-09,704,scale,5,10,5,1,00404,India
766552,2023-09-09,717,spiral bound book,50,100,50,1,00290,India
766552,2023-09-09,703,eraser,1,3,2,1,00290,India
726436,2023-09-09,714,carbon paper,15,30,15,1,00187,India
726436,2023-09-09,715,folder,5,15,10,1,00187,India
726436,2023-09-09,713,ball pen,5,10,5,1,00187,India
726436,2023-09-09,702,pencil,2,5,3,1,00187,India
585806,2023-09-09,704,scale,5,10,5,1,00313,India
585806,2023-09-09,701,gel pen,5,10,5,1,00313,India
585158,2023-09-09,717,spiral bound book,50,100,50,1,00068,India
585158,2023-09-09,704,scale,5,10,5,1,00068,India
585158,2023-09-09,716,printing paper,200,400,200,1,00068,India
585158,2023-09-09,702,pencil,2,5,3,1,00068,India
374298,2023-09-09,701,gel pen,5,10,5,1,00324,India
374298,2023-09-09,714,carbon paper,15,30,15,1,00324,India
374298,2023-09-09,705,stencil,10,20,10,1,00324,India
900860,2023-09-09,710,geometry box,100,150,50,1,00250,India
900860,2023-09-09,709,notebook,30,60,30,1,00250,India
900860,2023-09-09,714,carbon paper,15,30,15,1,00250,India
900860,2023-09-09,707,marker,20,40,20,1,00250,India
726860,2023-09-09,710,geometry box,100,150,50,1,00114,India
726860,2023-09-09,703,eraser,1,3,2,1,00114,India
391048,2023-09-09,706,sharpener,3,8,5,1,00164,India
391048,2023-09-09,707,marker,20,40,20,1,00164,India
391048,2023-09-09,711,TD kit,150,300,150,1,00164,India
391048,2023-09-09,710,geometry box,100,150,50,1,00164,India
262842,2023-09-09,702,pencil,2,5,3,1,00499,India
262842,2023-09-09,708,sketchpen,15,40,25,1,00499,India
262842,2023-09-09,711,TD kit,150,300,150,1,00499,India
446748,2023-09-09,701,gel pen,5,10,5,1,00321,India
446748,2023-09-09,709,notebook,30,60,30,1,00321,India
654417,2023-09-09,706,sharpener,3,8,5,1,00125,India
654417,2023-09-09,703,eraser,1,3,2,1,00125,India
654417,2023-09-09,714,carbon paper,15,30,15,1,00125,India
654417,2023-09-09,708,sketchpen,15,40,25,1,00125,India
654417,2023-09-09,702,pencil,2,5,3,1,00125,India
703385,2023-09-09,714,carbon paper,15,30,15,1,00386,India
703385,2023-09-09,711,TD kit,150,300,150,1,00386,India
222103,2023-09-09,713,ball pen,5,10,5,1,00442,India
813909,2023-09-09,708,sketchpen,15,40,25,1,00440,India
813909,2023-09-09,711,TD kit,150,300,150,1,00440,India
739397,2023-09-09,711,TD kit,150,300,150,1,00248,India
739397,2023-09-09,713,ball pen,5,10,5,1,00248,India
739397,2023-09-09,704,scale,5,10,5,1,00248,India
332246,2023-09-09,707,marker,20,40,20,1,00144,India
332246,2023-09-09,710,geometry box,100,150,50,1,00144,India
919426,2023-09-09,717,spiral bound book,50,100,50,1,00218,India
919426,2023-09-09,712,graph paper,20,40,20,1,00218,India
784656,2023-09-09,710,geometry box,100,150,50,1,00049,India
784656,2023-09-09,716,printing paper,200,400,200,1,00049,India
784656,2023-09-09,708,sketchpen,15,40,25,1,00049,India
784656,2023-09-09,712,graph paper,20,40,20,1,00049,India
976332,2023-09-09,715,folder,5,15,10,1,00334,India
976332,2023-09-09,706,sharpener,3,8,5,1,00334,India
976332,2023-09-09,702,pencil,2,5,3,1,00334,India
966060,2023-09-09,709,notebook,30,60,30,1,00115,India
966060,2023-09-09,701,gel pen,5,10,5,1,00115,India
966060,2023-09-09,708,sketchpen,15,40,25,1,00115,India
384132,2023-09-09,708,sketchpen,15,40,25,1,00259,India
384132,2023-09-09,716,printing paper,200,400,200,1,00259,India
108982,2023-09-09,705,stencil,10,20,10,1,00391,India
108982,2023-09-09,704,scale,5,10,5,1,00391,India
108982,2023-09-09,702,pencil,2,5,3,1,00391,India
108982,2023-09-09,709,notebook,30,60,30,1,00391,India
647041,2023-09-09,714,carbon paper,15,30,15,1,00288,India
647041,2023-09-09,706,sharpener,3,8,5,1,00288,India
136051,2023-09-10,714,carbon paper,15,30,15,1,00194,India
136051,2023-09-10,708,sketchpen,15,40,25,1,00194,India
136051,2023-09-10,709,notebook,30,60,30,1,00194,India
136051,2023-09-10,717,spiral bound book,50,100,50,1,00194,India
136051,2023-09-10,705,stencil,10,20,10,1,00194,India
215062,2023-09-10,716,printing paper,200,400,200,1,00470,India
215062,2023-09-10,705,stencil,10,20,10,1,00470,India
215062,2023-09-10,701,gel pen,5,10,5,1,00470,India
215062,2023-09-10,704,scale,5,10,5,1,00470,India
131543,2023-09-10,717,spiral bound book,50,100,50,1,00220,India
131543,2023-09-10,706,sharpener,3,8,5,1,00220,India
342985,2023-09-10,717,spiral bound book,50,100,50,1,00097,India
342985,2023-09-10,715,folder,5,15,10,1,00097,India
342985,2023-09-10,714,carbon paper,15,30,15,1,00097,India
119419,2023-09-10,715,folder,5,15,10,1,00015,India
119419,2023-09-10,714,carbon paper,15,30,15,1,00015,India
874016,2023-09-10,712,graph paper,20,40,20,1,00099,India
874016,2023-09-10,705,stencil,10,20,10,1,00099,India
874016,2023-09-10,717,spiral bound book,50,100,50,1,00099,India
898647,2023-09-10,711,TD kit,150,300,150,1,00490,India
981543,2023-09-10,706,sharpener,3,8,5,1,00062,India
721341,2023-09-10,709,notebook,30,60,30,1,00354,India
721341,2023-09-10,707,marker,20,40,20,1,00354,India
721341,2023-09-10,703,eraser,1,3,2,1,00354,India
721341,2023-09-10,716,printing paper,200,400,200,1,00354,India
300075,2023-09-10,709,notebook,30,60,30,1,00312,India
300075,2023-09-10,716,printing paper,200,400,200,1,00312,India
813623,2023-09-10,701,gel pen,5,10,5,1,00293,India
813623,2023-09-10,710,geometry box,100,150,50,1,00293,India
813623,2023-09-10,707,marker,20,40,20,1,00293,India
834708,2023-09-10,706,sharpener,3,8,5,1,00154,India
834708,2023-09-10,709,notebook,30,60,30,1,00154,India
247349,2023-09-10,715,folder,5,15,10,1,00011,India
247349,2023-09-10,710,geometry box,100,150,50,1,00011,India
247349,2023-09-10,704,scale,5,10,5,1,00011,India
766306,2023-09-10,704,scale,5,10,5,1,00468,India
766306,2023-09-10,702,pencil,2,5,3,1,00468,India
766306,2023-09-10,710,geometry box,100,150,50,1,00468,India
766306,2023-09-10,708,sketchpen,15,40,25,1,00468,India
704389,2023-09-10,706,sharpener,3,8,5,1,00155,India
474377,2023-09-10,715,folder,5,15,10,1,00128,India
474377,2023-09-10,701,gel pen,5,10,5,1,00128,India
474377,2023-09-10,708,sketchpen,15,40,25,1,00128,India
474377,2023-09-10,710,geometry box,100,150,50,1,00128,India
474377,2023-09-10,717,spiral bound book,50,100,50,1,00128,India
363854,2023-09-10,703,eraser,1,3,2,1,00469,India
363854,2023-09-10,702,pencil,2,5,3,1,00469,India
369440,2023-09-10,704,scale,5,10,5,1,00417,India
369440,2023-09-10,708,sketchpen,15,40,25,1,00417,India
847173,2023-09-10,714,carbon paper,15,30,15,1,00031,India
961184,2023-09-10,714,carbon paper,15,30,15,1,00441,India
969568,2023-09-10,708,sketchpen,15,40,25,1,00065,India
969568,2023-09-10,710,geometry box,100,150,50,1,00065,India
969568,2023-09-10,707,marker,20,40,20,1,00065,India
969568,2023-09-10,706,sharpener,3,8,5,1,00065,India
919848,2023-09-10,716,printing paper,200,400,200,1,00398,India
919848,2023-09-10,704,scale,5,10,5,1,00398,India
919848,2023-09-10,714,carbon paper,15,30,15,1,00398,India
919848,2023-09-10,701,gel pen,5,10,5,1,00398,India
919848,2023-09-10,713,ball pen,5,10,5,1,00398,India
275789,2023-09-10,704,scale,5,10,5,1,00467,India
275789,2023-09-10,707,marker,20,40,20,1,00467,India
275789,2023-09-10,711,TD kit,150,300,150,1,00467,India
275789,2023-09-10,712,graph paper,20,40,20,1,00467,India
275789,2023-09-10,717,spiral bound book,50,100,50,1,00467,India
290207,2023-09-10,701,gel pen,5,10,5,1,00442,India
290207,2023-09-10,716,printing paper,200,400,200,1,00442,India
290207,2023-09-10,713,ball pen,5,10,5,1,00442,India
290207,2023-09-10,714,carbon paper,15,30,15,1,00442,India
290207,2023-09-10,710,geometry box,100,150,50,1,00442,India
899409,2023-09-10,707,marker,20,40,20,1,00172,India
899409,2023-09-10,717,spiral bound book,50,100,50,1,00172,India
899409,2023-09-10,715,folder,5,15,10,1,00172,India
872850,2023-09-10,713,ball pen,5,10,5,1,00402,India
872850,2023-09-10,702,pencil,2,5,3,1,00402,India
238414,2023-09-10,713,ball pen,5,10,5,1,00262,India
631707,2023-09-10,706,sharpener,3,8,5,1,00411,India
631707,2023-09-10,710,geometry box,100,150,50,1,00411,India
631707,2023-09-10,708,sketchpen,15,40,25,1,00411,India
945391,2023-09-10,712,graph paper,20,40,20,1,00187,India
945391,2023-09-10,714,carbon paper,15,30,15,1,00187,India
945391,2023-09-10,713,ball pen,5,10,5,1,00187,India
311597,2023-09-10,709,notebook,30,60,30,1,00149,India
311597,2023-09-10,713,ball pen,5,10,5,1,00149,India
311597,2023-09-10,717,spiral bound book,50,100,50,1,00149,India
311597,2023-09-10,710,geometry box,100,150,50,1,00149,India
166251,2023-09-10,704,scale,5,10,5,1,00308,India
166251,2023-09-10,708,sketchpen,15,40,25,1,00308,India
166251,2023-09-10,705,stencil,10,20,10,1,00308,India
166251,2023-09-10,712,graph paper,20,40,20,1,00308,India
166251,2023-09-10,717,spiral bound book,50,100,50,1,00308,India
478201,2023-09-10,712,graph paper,20,40,20,1,00312,India
478201,2023-09-10,705,stencil,10,20,10,1,00312,India
478201,2023-09-10,715,folder,5,15,10,1,00312,India
926296,2023-09-10,714,carbon paper,15,30,15,1,00272,India
926296,2023-09-10,712,graph paper,20,40,20,1,00272,India
926296,2023-09-10,715,folder,5,15,10,1,00272,India
356634,2023-09-10,717,spiral bound book,50,100,50,1,00159,India
356634,2023-09-10,711,TD kit,150,300,150,1,00159,India
767629,2023-09-11,708,sketchpen,15,40,25,1,00095,India
767629,2023-09-11,711,TD kit,150,300,150,1,00095,India
767629,2023-09-11,712,graph paper,20,40,20,1,00095,India
717841,2023-09-11,717,spiral bound book,50,100,50,1,00492,India
460436,2023-09-11,712,graph paper,20,40,20,1,00280,India
460436,2023-09-11,706,sharpener,3,8,5,1,00280,India
460436,2023-09-11,717,spiral bound book,50,100,50,1,00280,India
602728,2023-09-11,701,gel pen,5,10,5,1,00453,India
602728,2023-09-11,702,pencil,2,5,3,1,00453,India
602728,2023-09-11,711,TD kit,150,300,150,1,00453,India
602728,2023-09-11,709,notebook,30,60,30,1,00453,India
197659,2023-09-11,715,folder,5,15,10,1,00122,India
197659,2023-09-11,703,eraser,1,3,2,1,00122,India
197659,2023-09-11,712,graph paper,20,40,20,1,00122,India
197659,2023-09-11,704,scale,5,10,5,1,00122,India
132340,2023-09-11,716,printing paper,200,400,200,1,00146,India
132340,2023-09-11,709,notebook,30,60,30,1,00146,India
132340,2023-09-11,705,stencil,10,20,10,1,00146,India
175564,2023-09-11,703,eraser,1,3,2,1,00440,India
180010,2023-09-11,711,TD kit,150,300,150,1,00188,India
180010,2023-09-11,716,printing paper,200,400,200,1,00188,India
180010,2023-09-11,707,marker,20,40,20,1,00188,India
180010,2023-09-11,714,carbon paper,15,30,15,1,00188,India
783726,2023-09-11,701,gel pen,5,10,5,1,00129,India
750907,2023-09-11,715,folder,5,15,10,1,00238,India
750907,2023-09-11,716,printing paper,200,400,200,1,00238,India
750907,2023-09-11,706,sharpener,3,8,5,1,00238,India
750907,2023-09-11,712,graph paper,20,40,20,1,00238,India
750907,2023-09-11,703,eraser,1,3,2,1,00238,India
878192,2023-09-11,713,ball pen,5,10,5,1,00462,India
365569,2023-09-11,705,stencil,10,20,10,1,00186,India
365569,2023-09-11,701,gel pen,5,10,5,1,00186,India
365569,2023-09-11,704,scale,5,10,5,1,00186,India
666541,2023-09-11,709,notebook,30,60,30,1,00229,India
505241,2023-09-11,712,graph paper,20,40,20,1,00092,India
505241,2023-09-11,707,marker,20,40,20,1,00092,India
505241,2023-09-11,702,pencil,2,5,3,1,00092,India
947602,2023-09-11,703,eraser,1,3,2,1,00231,India
947602,2023-09-11,701,gel pen,5,10,5,1,00231,India
947602,2023-09-11,715,folder,5,15,10,1,00231,India
531588,2023-09-11,704,scale,5,10,5,1,00226,India
531588,2023-09-11,702,pencil,2,5,3,1,00226,India
531588,2023-09-11,709,notebook,30,60,30,1,00226,India
531588,2023-09-11,716,printing paper,200,400,200,1,00226,India
531588,2023-09-11,714,carbon paper,15,30,15,1,00226,India
834714,2023-09-11,703,eraser,1,3,2,1,00111,India
156991,2023-09-11,705,stencil,10,20,10,1,00041,India
156991,2023-09-11,707,marker,20,40,20,1,00041,India
147180,2023-09-11,717,spiral bound book,50,100,50,1,00486,India
147180,2023-09-11,705,stencil,10,20,10,1,00486,India
147180,2023-09-11,708,sketchpen,15,40,25,1,00486,India
147180,2023-09-11,706,sharpener,3,8,5,1,00486,India
695326,2023-09-11,704,scale,5,10,5,1,00226,India
695326,2023-09-11,709,notebook,30,60,30,1,00226,India
695326,2023-09-11,710,geometry box,100,150,50,1,00226,India
695326,2023-09-11,714,carbon paper,15,30,15,1,00226,India
695326,2023-09-11,705,stencil,10,20,10,1,00226,India
546600,2023-09-11,701,gel pen,5,10,5,1,00037,India
263165,2023-09-11,711,TD kit,150,300,150,1,00080,India
847483,2023-09-11,707,marker,20,40,20,1,00350,India
276325,2023-09-11,701,gel pen,5,10,5,1,00020,India
276325,2023-09-11,703,eraser,1,3,2,1,00020,India
276325,2023-09-11,705,stencil,10,20,10,1,00020,India
634412,2023-09-11,702,pencil,2,5,3,1,00150,India
634412,2023-09-11,709,notebook,30,60,30,1,00150,India
521524,2023-09-11,708,sketchpen,15,40,25,1,00166,India
510124,2023-09-11,706,sharpener,3,8,5,1,00024,India
305646,2023-09-11,714,carbon paper,15,30,15,1,00405,India
576272,2023-09-11,717,spiral bound book,50,100,50,1,00033,India
576272,2023-09-11,709,notebook,30,60,30,1,00033,India
576272,2023-09-11,707,marker,20,40,20,1,00033,India
576272,2023-09-11,704,scale,5,10,5,1,00033,India
576272,2023-09-11,713,ball pen,5,10,5,1,00033,India
327946,2023-09-11,702,pencil,2,5,3,1,00221,India
327946,2023-09-11,707,marker,20,40,20,1,00221,India
327946,2023-09-11,709,notebook,30,60,30,1,00221,India
131485,2023-09-11,714,carbon paper,15,30,15,1,00106,India
131485,2023-09-11,701,gel pen,5,10,5,1,00106,India
408596,2023-09-11,713,ball pen,5,10,5,1,00323,India
408596,2023-09-11,717,spiral bound book,50,100,50,1,00323,India
408596,2023-09-11,711,TD kit,150,300,150,1,00323,India
408596,2023-09-11,705,stencil,10,20,10,1,00323,India
966601,2023-09-11,701,gel pen,5,10,5,1,00089,India
966601,2023-09-11,712,graph paper,20,40,20,1,00089,India
966601,2023-09-11,704,scale,5,10,5,1,00089,India
386171,2023-09-11,714,carbon paper,15,30,15,1,00026,India
386171,2023-09-11,701,gel pen,5,10,5,1,00026,India
386171,2023-09-11,715,folder,5,15,10,1,00026,India
893034,2023-09-11,715,folder,5,15,10,1,00310,India
893034,2023-09-11,712,graph paper,20,40,20,1,00310,India
893034,2023-09-11,703,eraser,1,3,2,1,00310,India
893034,2023-09-11,707,marker,20,40,20,1,00310,India
445454,2023-09-11,708,sketchpen,15,40,25,1,00372,India
454392,2023-09-11,715,folder,5,15,10,1,00477,India
454392,2023-09-11,712,graph paper,20,40,20,1,00477,India
454392,2023-09-11,707,marker,20,40,20,1,00477,India
454392,2023-09-11,705,stencil,10,20,10,1,00477,India
207169,2023-09-11,701,gel pen,5,10,5,1,00201,India
207169,2023-09-11,704,scale,5,10,5,1,00201,India
207169,2023-09-11,707,marker,20,40,20,1,00201,India
207169,2023-09-11,710,geometry box,100,150,50,1,00201,India
207169,2023-09-11,716,printing paper,200,400,200,1,00201,India
623041,2023-09-11,711,TD kit,150,300,150,1,00428,India
623041,2023-09-11,713,ball pen,5,10,5,1,00428,India
623041,2023-09-11,707,marker,20,40,20,1,00428,India
623041,2023-09-11,701,gel pen,5,10,5,1,00428,India
623041,2023-09-11,716,printing paper,200,400,200,1,00428,India
937396,2023-09-11,715,folder,5,15,10,1,00212,India
937396,2023-09-11,712,graph paper,20,40,20,1,00212,India
937396,2023-09-11,709,notebook,30,60,30,1,00212,India
937396,2023-09-11,704,scale,5,10,5,1,00212,India
239882,2023-09-11,701,gel pen,5,10,5,1,00484,India
239882,2023-09-11,703,eraser,1,3,2,1,00484,India
239882,2023-09-11,711,TD kit,150,300,150,1,00484,India
140000,2023-09-11,717,spiral bound book,50,100,50,1,00335,India
140000,2023-09-11,714,carbon paper,15,30,15,1,00335,India
140000,2023-09-11,704,scale,5,10,5,1,00335,India
177662,2023-09-11,701,gel pen,5,10,5,1,00437,India
177662,2023-09-11,704,scale,5,10,5,1,00437,India
177662,2023-09-11,702,pencil,2,5,3,1,00437,India
167062,2023-09-11,712,graph paper,20,40,20,1,00046,India
167062,2023-09-11,709,notebook,30,60,30,1,00046,India
167062,2023-09-11,713,ball pen,5,10,5,1,00046,India
167062,2023-09-11,701,gel pen,5,10,5,1,00046,India
545859,2023-09-11,706,sharpener,3,8,5,1,00344,India
545859,2023-09-11,713,ball pen,5,10,5,1,00344,India
545859,2023-09-11,715,folder,5,15,10,1,00344,India
545859,2023-09-11,711,TD kit,150,300,150,1,00344,India
961096,2023-09-11,716,printing paper,200,400,200,1,00421,India
961096,2023-09-11,705,stencil,10,20,10,1,00421,India
961096,2023-09-11,701,gel pen,5,10,5,1,00421,India
961096,2023-09-11,713,ball pen,5,10,5,1,00421,India
964787,2023-09-11,706,sharpener,3,8,5,1,00089,India
964787,2023-09-11,710,geometry box,100,150,50,1,00089,India
964787,2023-09-11,711,TD kit,150,300,150,1,00089,India
964787,2023-09-11,704,scale,5,10,5,1,00089,India
359488,2023-09-11,716,printing paper,200,400,200,1,00128,India
359488,2023-09-11,713,ball pen,5,10,5,1,00128,India
359488,2023-09-11,704,scale,5,10,5,1,00128,India
563166,2023-09-11,716,printing paper,200,400,200,1,00472,India
601837,2023-09-12,702,pencil,2,5,3,1,00165,India
858756,2023-09-12,707,marker,20,40,20,1,00005,India
858756,2023-09-12,710,geometry box,100,150,50,1,00005,India
858756,2023-09-12,717,spiral bound book,50,100,50,1,00005,India
858756,2023-09-12,716,printing paper,200,400,200,1,00005,India
818739,2023-09-12,712,graph paper,20,40,20,1,00033,India
317503,2023-09-12,712,graph paper,20,40,20,1,00399,India
317503,2023-09-12,708,sketchpen,15,40,25,1,00399,India
317503,2023-09-12,714,carbon paper,15,30,15,1,00399,India
317503,2023-09-12,706,sharpener,3,8,5,1,00399,India
317503,2023-09-12,707,marker,20,40,20,1,00399,India
751105,2023-09-12,716,printing paper,200,400,200,1,00395,India
183349,2023-09-12,706,sharpener,3,8,5,1,00445,India
279730,2023-09-12,707,marker,20,40,20,1,00014,India
279730,2023-09-12,708,sketchpen,15,40,25,1,00014,India
313988,2023-09-12,707,marker,20,40,20,1,00407,India
313988,2023-09-12,711,TD kit,150,300,150,1,00407,India
313988,2023-09-12,709,notebook,30,60,30,1,00407,India
313988,2023-09-12,715,folder,5,15,10,1,00407,India
216742,2023-09-12,704,scale,5,10,5,1,00307,India
796383,2023-09-12,717,spiral bound book,50,100,50,1,00479,India
796383,2023-09-12,702,pencil,2,5,3,1,00479,India
796383,2023-09-12,704,scale,5,10,5,1,00479,India
796383,2023-09-12,701,gel pen,5,10,5,1,00479,India
314599,2023-09-12,716,printing paper,200,400,200,1,00485,India
985657,2023-09-12,705,stencil,10,20,10,1,00332,India
985657,2023-09-12,715,folder,5,15,10,1,00332,India
985657,2023-09-12,709,notebook,30,60,30,1,00332,India
985657,2023-09-12,710,geometry box,100,150,50,1,00332,India
879338,2023-09-12,703,eraser,1,3,2,1,00258,India
879338,2023-09-12,708,sketchpen,15,40,25,1,00258,India
137226,2023-09-12,714,carbon paper,15,30,15,1,00221,India
619674,2023-09-12,707,marker,20,40,20,1,00087,India
619674,2023-09-12,712,graph paper,20,40,20,1,00087,India
192713,2023-09-12,712,graph paper,20,40,20,1,00311,India
192713,2023-09-12,706,sharpener,3,8,5,1,00311,India
192713,2023-09-12,705,stencil,10,20,10,1,00311,India
192713,2023-09-12,711,TD kit,150,300,150,1,00311,India
192713,2023-09-12,713,ball pen,5,10,5,1,00311,India
900906,2023-09-12,713,ball pen,5,10,5,1,00198,India
847938,2023-09-12,703,eraser,1,3,2,1,00126,India
847938,2023-09-12,708,sketchpen,15,40,25,1,00126,India
689666,2023-09-12,702,pencil,2,5,3,1,00110,India
689666,2023-09-12,709,notebook,30,60,30,1,00110,India
413307,2023-09-12,705,stencil,10,20,10,1,00330,India
413307,2023-09-12,701,gel pen,5,10,5,1,00330,India
413307,2023-09-12,708,sketchpen,15,40,25,1,00330,India
654823,2023-09-12,716,printing paper,200,400,200,1,00479,India
654823,2023-09-12,714,carbon paper,15,30,15,1,00479,India
654823,2023-09-12,705,stencil,10,20,10,1,00479,India
654823,2023-09-12,707,marker,20,40,20,1,00479,India
654823,2023-09-12,717,spiral bound book,50,100,50,1,00479,India
532472,2023-09-12,705,stencil,10,20,10,1,00419,India
532472,2023-09-12,703,eraser,1,3,2,1,00419,India
888279,2023-09-12,702,pencil,2,5,3,1,00292,India
888279,2023-09-12,701,gel pen,5,10,5,1,00292,India
888279,2023-09-12,704,scale,5,10,5,1,00292,India
888279,2023-09-12,716,printing paper,200,400,200,1,00292,India
132896,2023-09-12,713,ball pen,5,10,5,1,00335,India
132896,2023-09-12,716,printing paper,200,400,200,1,00335,India
132896,2023-09-12,707,marker,20,40,20,1,00335,India
132896,2023-09-12,701,gel pen,5,10,5,1,00335,India
132896,2023-09-12,704,scale,5,10,5,1,00335,India
690540,2023-09-12,712,graph paper,20,40,20,1,00052,India
613663,2023-09-12,707,marker,20,40,20,1,00359,India
613663,2023-09-12,717,spiral bound book,50,100,50,1,00359,India
613663,2023-09-12,705,stencil,10,20,10,1,00359,India
613663,2023-09-12,714,carbon paper,15,30,15,1,00359,India
569696,2023-09-12,717,spiral bound book,50,100,50,1,00059,India
578809,2023-09-12,713,ball pen,5,10,5,1,00322,India
578809,2023-09-12,717,spiral bound book,50,100,50,1,00322,India
111344,2023-09-12,712,graph paper,20,40,20,1,00223,India
111344,2023-09-12,705,stencil,10,20,10,1,00223,India
775297,2023-09-12,716,printing paper,200,400,200,1,00113,India
453997,2023-09-12,709,notebook,30,60,30,1,00351,India
453997,2023-09-12,716,printing paper,200,400,200,1,00351,India
248920,2023-09-12,707,marker,20,40,20,1,00430,India
125971,2023-09-12,717,spiral bound book,50,100,50,1,00246,India
125971,2023-09-12,714,carbon paper,15,30,15,1,00246,India
125971,2023-09-12,711,TD kit,150,300,150,1,00246,India
125971,2023-09-12,701,gel pen,5,10,5,1,00246,India
264262,2023-09-12,708,sketchpen,15,40,25,1,00171,India
264262,2023-09-12,701,gel pen,5,10,5,1,00171,India
264262,2023-09-12,707,marker,20,40,20,1,00171,India
792948,2023-09-12,714,carbon paper,15,30,15,1,00187,India
582645,2023-09-12,709,notebook,30,60,30,1,00441,India
582645,2023-09-12,702,pencil,2,5,3,1,00441,India
582645,2023-09-12,707,marker,20,40,20,1,00441,India
582645,2023-09-12,708,sketchpen,15,40,25,1,00441,India
306831,2023-09-12,707,marker,20,40,20,1,00001,India
306831,2023-09-12,713,ball pen,5,10,5,1,00001,India
306831,2023-09-12,709,notebook,30,60,30,1,00001,India
306831,2023-09-12,714,carbon paper,15,30,15,1,00001,India
306831,2023-09-12,706,sharpener,3,8,5,1,00001,India
621572,2023-09-12,711,TD kit,150,300,150,1,00106,India
175931,2023-09-13,712,graph paper,20,40,20,1,00395,India
175931,2023-09-13,713,ball pen,5,10,5,1,00395,India
175931,2023-09-13,701,gel pen,5,10,5,1,00395,India
984843,2023-09-13,709,notebook,30,60,30,1,00443,India
984843,2023-09-13,702,pencil,2,5,3,1,00443,India
984843,2023-09-13,710,geometry box,100,150,50,1,00443,India
984843,2023-09-13,701,gel pen,5,10,5,1,00443,India
984843,2023-09-13,706,sharpener,3,8,5,1,00443,India
785627,2023-09-13,707,marker,20,40,20,1,00241,India
785627,2023-09-13,704,scale,5,10,5,1,00241,India
455202,2023-09-13,708,sketchpen,15,40,25,1,00218,India
455202,2023-09-13,716,printing paper,200,400,200,1,00218,India
977601,2023-09-13,701,gel pen,5,10,5,1,00490,India
977601,2023-09-13,716,printing paper,200,400,200,1,00490,India
977601,2023-09-13,711,TD kit,150,300,150,1,00490,India
977601,2023-09-13,713,ball pen,5,10,5,1,00490,India
977601,2023-09-13,703,eraser,1,3,2,1,00490,India
708728,2023-09-13,704,scale,5,10,5,1,00343,India
708728,2023-09-13,708,sketchpen,15,40,25,1,00343,India
708728,2023-09-13,710,geometry box,100,150,50,1,00343,India
807617,2023-09-13,714,carbon paper,15,30,15,1,00468,India
807617,2023-09-13,701,gel pen,5,10,5,1,00468,India
807617,2023-09-13,705,stencil,10,20,10,1,00468,India
579886,2023-09-13,706,sharpener,3,8,5,1,00166,India
579886,2023-09-13,716,printing paper,200,400,200,1,00166,India
579886,2023-09-13,714,carbon paper,15,30,15,1,00166,India
190698,2023-09-13,711,TD kit,150,300,150,1,00381,India
190698,2023-09-13,715,folder,5,15,10,1,00381,India
190698,2023-09-13,712,graph paper,20,40,20,1,00381,India
190698,2023-09-13,704,scale,5,10,5,1,00381,India
491901,2023-09-13,712,graph paper,20,40,20,1,00500,India
491901,2023-09-13,702,pencil,2,5,3,1,00500,India
491901,2023-09-13,717,spiral bound book,50,100,50,1,00500,India
491901,2023-09-13,709,notebook,30,60,30,1,00500,India
491901,2023-09-13,715,folder,5,15,10,1,00500,India
178181,2023-09-13,711,TD kit,150,300,150,1,00469,India
178181,2023-09-13,705,stencil,10,20,10,1,00469,India
178181,2023-09-13,714,carbon paper,15,30,15,1,00469,India
178181,2023-09-13,702,pencil,2,5,3,1,00469,India
770639,2023-09-13,716,printing paper,200,400,200,1,00183,India
379651,2023-09-13,709,notebook,30,60,30,1,00026,India
301211,2023-09-13,703,eraser,1,3,2,1,00182,India
301211,2023-09-13,712,graph paper,20,40,20,1,00182,India
301211,2023-09-13,715,folder,5,15,10,1,00182,India
301211,2023-09-13,717,spiral bound book,50,100,50,1,00182,India
301211,2023-09-13,708,sketchpen,15,40,25,1,00182,India
711108,2023-09-13,703,eraser,1,3,2,1,00216,India
711108,2023-09-13,706,sharpener,3,8,5,1,00216,India
711108,2023-09-13,713,ball pen,5,10,5,1,00216,India
711108,2023-09-13,712,graph paper,20,40,20,1,00216,India
842799,2023-09-13,708,sketchpen,15,40,25,1,00106,India
842799,2023-09-13,703,eraser,1,3,2,1,00106,India
842799,2023-09-13,701,gel pen,5,10,5,1,00106,India
842799,2023-09-13,712,graph paper,20,40,20,1,00106,India
945003,2023-09-13,712,graph paper,20,40,20,1,00363,India
945003,2023-09-13,710,geometry box,100,150,50,1,00363,India
799929,2023-09-13,715,folder,5,15,10,1,00384,India
799929,2023-09-13,710,geometry box,100,150,50,1,00384,India
799929,2023-09-13,717,spiral bound book,50,100,50,1,00384,India
799929,2023-09-13,705,stencil,10,20,10,1,00384,India
339050,2023-09-13,703,eraser,1,3,2,1,00010,India
302036,2023-09-13,711,TD kit,150,300,150,1,00198,India
685825,2023-09-13,701,gel pen,5,10,5,1,00367,India
685825,2023-09-13,705,stencil,10,20,10,1,00367,India
758824,2023-09-13,704,scale,5,10,5,1,00038,India
758824,2023-09-13,705,stencil,10,20,10,1,00038,India
758824,2023-09-13,716,printing paper,200,400,200,1,00038,India
562932,2023-09-13,702,pencil,2,5,3,1,00026,India
562932,2023-09-13,714,carbon paper,15,30,15,1,00026,India
340823,2023-09-13,705,stencil,10,20,10,1,00037,India
340823,2023-09-13,703,eraser,1,3,2,1,00037,India
340823,2023-09-13,712,graph paper,20,40,20,1,00037,India
850051,2023-09-13,704,scale,5,10,5,1,00466,India
383184,2023-09-13,712,graph paper,20,40,20,1,00029,India
383184,2023-09-13,709,notebook,30,60,30,1,00029,India
383184,2023-09-13,710,geometry box,100,150,50,1,00029,India
630281,2023-09-13,710,geometry box,100,150,50,1,00117,India
630281,2023-09-13,711,TD kit,150,300,150,1,00117,India
844021,2023-09-13,701,gel pen,5,10,5,1,00145,India
479913,2023-09-13,704,scale,5,10,5,1,00175,India
479913,2023-09-13,701,gel pen,5,10,5,1,00175,India
658617,2023-09-13,704,scale,5,10,5,1,00041,India
658617,2023-09-13,717,spiral bound book,50,100,50,1,00041,India
658617,2023-09-13,716,printing paper,200,400,200,1,00041,India
658617,2023-09-13,701,gel pen,5,10,5,1,00041,India
892455,2023-09-13,713,ball pen,5,10,5,1,00181,India
892455,2023-09-13,712,graph paper,20,40,20,1,00181,India
243220,2023-09-13,705,stencil,10,20,10,1,00313,India
243220,2023-09-13,711,TD kit,150,300,150,1,00313,India
456635,2023-09-13,714,carbon paper,15,30,15,1,00353,India
456635,2023-09-13,701,gel pen,5,10,5,1,00353,India
456635,2023-09-13,716,printing paper,200,400,200,1,00353,India
456635,2023-09-13,715,folder,5,15,10,1,00353,India
938412,2023-09-13,711,TD kit,150,300,150,1,00232,India
938412,2023-09-13,716,printing paper,200,400,200,1,00232,India
938412,2023-09-13,710,geometry box,100,150,50,1,00232,India
938412,2023-09-13,712,graph paper,20,40,20,1,00232,India
938412,2023-09-13,717,spiral bound book,50,100,50,1,00232,India
790749,2023-09-13,714,carbon paper,15,30,15,1,00221,India
790749,2023-09-13,707,marker,20,40,20,1,00221,India
790749,2023-09-13,716,printing paper,200,400,200,1,00221,India
986965,2023-09-13,702,pencil,2,5,3,1,00305,India
986965,2023-09-13,706,sharpener,3,8,5,1,00305,India
986965,2023-09-13,711,TD kit,150,300,150,1,00305,India
986965,2023-09-13,713,ball pen,5,10,5,1,00305,India
559707,2023-09-13,701,gel pen,5,10,5,1,00215,India
559707,2023-09-13,706,sharpener,3,8,5,1,00215,India
559707,2023-09-13,702,pencil,2,5,3,1,00215,India
559707,2023-09-13,716,printing paper,200,400,200,1,00215,India
455054,2023-09-13,717,spiral bound book,50,100,50,1,00301,India
455054,2023-09-13,710,geometry box,100,150,50,1,00301,India
961004,2023-09-13,716,printing paper,200,400,200,1,00006,India
961004,2023-09-13,701,gel pen,5,10,5,1,00006,India
961004,2023-09-13,717,spiral bound book,50,100,50,1,00006,India
965596,2023-09-13,711,TD kit,150,300,150,1,00441,India
965596,2023-09-13,717,spiral bound book,50,100,50,1,00441,India
965596,2023-09-13,703,eraser,1,3,2,1,00441,India
132853,2023-09-13,713,ball pen,5,10,5,1,00051,India
358856,2023-09-13,708,sketchpen,15,40,25,1,00009,India
479734,2023-09-14,717,spiral bound book,50,100,50,1,00279,India
479734,2023-09-14,713,ball pen,5,10,5,1,00279,India
479734,2023-09-14,715,folder,5,15,10,1,00279,India
607308,2023-09-14,702,pencil,2,5,3,1,00082,India
673203,2023-09-14,704,scale,5,10,5,1,00008,India
967802,2023-09-14,707,marker,20,40,20,1,00267,India
967802,2023-09-14,703,eraser,1,3,2,1,00267,India
967802,2023-09-14,714,carbon paper,15,30,15,1,00267,India
967802,2023-09-14,711,TD kit,150,300,150,1,00267,India
967802,2023-09-14,717,spiral bound book,50,100,50,1,00267,India
459813,2023-09-14,711,TD kit,150,300,150,1,00090,India
859201,2023-09-14,706,sharpener,3,8,5,1,00364,India
859201,2023-09-14,708,sketchpen,15,40,25,1,00364,India
845396,2023-09-14,714,carbon paper,15,30,15,1,00215,India
845396,2023-09-14,709,notebook,30,60,30,1,00215,India
324394,2023-09-14,717,spiral bound book,50,100,50,1,00383,India
324394,2023-09-14,705,stencil,10,20,10,1,00383,India
914235,2023-09-14,710,geometry box,100,150,50,1,00217,India
914235,2023-09-14,707,marker,20,40,20,1,00217,India
914235,2023-09-14,703,eraser,1,3,2,1,00217,India
810999,2023-09-14,716,printing paper,200,400,200,1,00354,India
876036,2023-09-14,711,TD kit,150,300,150,1,00206,India
876036,2023-09-14,713,ball pen,5,10,5,1,00206,India
876036,2023-09-14,717,spiral bound book,50,100,50,1,00206,India
876036,2023-09-14,710,geometry box,100,150,50,1,00206,India
223165,2023-09-14,710,geometry box,100,150,50,1,00310,India
223165,2023-09-14,703,eraser,1,3,2,1,00310,India
433382,2023-09-14,715,folder,5,15,10,1,00019,India
433382,2023-09-14,717,spiral bound book,50,100,50,1,00019,India
433382,2023-09-14,703,eraser,1,3,2,1,00019,India
433382,2023-09-14,705,stencil,10,20,10,1,00019,India
614250,2023-09-14,702,pencil,2,5,3,1,00385,India
856278,2023-09-14,708,sketchpen,15,40,25,1,00079,India
958702,2023-09-14,702,pencil,2,5,3,1,00307,India
958702,2023-09-14,708,sketchpen,15,40,25,1,00307,India
958702,2023-09-14,713,ball pen,5,10,5,1,00307,India
443481,2023-09-14,713,ball pen,5,10,5,1,00181,India
443481,2023-09-14,711,TD kit,150,300,150,1,00181,India
443481,2023-09-14,714,carbon paper,15,30,15,1,00181,India
163389,2023-09-14,717,spiral bound book,50,100,50,1,00495,India
163389,2023-09-14,708,sketchpen,15,40,25,1,00495,India
163389,2023-09-14,702,pencil,2,5,3,1,00495,India
163389,2023-09-14,704,scale,5,10,5,1,00495,India
507782,2023-09-14,705,stencil,10,20,10,1,00294,India
246043,2023-09-14,708,sketchpen,15,40,25,1,00059,India
292305,2023-09-14,716,printing paper,200,400,200,1,00164,India
850241,2023-09-14,702,pencil,2,5,3,1,00427,India
850241,2023-09-14,717,spiral bound book,50,100,50,1,00427,India
850241,2023-09-14,706,sharpener,3,8,5,1,00427,India
850241,2023-09-14,713,ball pen,5,10,5,1,00427,India
850241,2023-09-14,703,eraser,1,3,2,1,00427,India
458345,2023-09-14,710,geometry box,100,150,50,1,00326,India
458345,2023-09-14,709,notebook,30,60,30,1,00326,India
458345,2023-09-14,711,TD kit,150,300,150,1,00326,India
458345,2023-09-14,712,graph paper,20,40,20,1,00326,India
655751,2023-09-14,707,marker,20,40,20,1,00181,India
655751,2023-09-14,704,scale,5,10,5,1,00181,India
655751,2023-09-14,701,gel pen,5,10,5,1,00181,India
655751,2023-09-14,712,graph paper,20,40,20,1,00181,India
486233,2023-09-14,712,graph paper,20,40,20,1,00273,India
802237,2023-09-14,707,marker,20,40,20,1,00240,India
802237,2023-09-14,712,graph paper,20,40,20,1,00240,India
802237,2023-09-14,711,TD kit,150,300,150,1,00240,India
920663,2023-09-14,702,pencil,2,5,3,1,00184,India
920663,2023-09-14,703,eraser,1,3,2,1,00184,India
920663,2023-09-14,711,TD kit,150,300,150,1,00184,India
920663,2023-09-14,714,carbon paper,15,30,15,1,00184,India
486150,2023-09-14,710,geometry box,100,150,50,1,00201,India
486150,2023-09-14,702,pencil,2,5,3,1,00201,India
486150,2023-09-14,717,spiral bound book,50,100,50,1,00201,India
239731,2023-09-14,715,folder,5,15,10,1,00442,India
239731,2023-09-14,705,stencil,10,20,10,1,00442,India
239731,2023-09-14,716,printing paper,200,400,200,1,00442,India
239731,2023-09-14,702,pencil,2,5,3,1,00442,India
239731,2023-09-14,712,graph paper,20,40,20,1,00442,India
884635,2023-09-14,708,sketchpen,15,40,25,1,00178,India
884635,2023-09-14,712,graph paper,20,40,20,1,00178,India
884635,2023-09-14,704,scale,5,10,5,1,00178,India
884635,2023-09-14,709,notebook,30,60,30,1,00178,India
673294,2023-09-14,713,ball pen,5,10,5,1,00270,India
673294,2023-09-14,710,geometry box,100,150,50,1,00270,India
673294,2023-09-14,709,notebook,30,60,30,1,00270,India
673294,2023-09-14,705,stencil,10,20,10,1,00270,India
673294,2023-09-14,704,scale,5,10,5,1,00270,India
138339,2023-09-14,715,folder,5,15,10,1,00276,India
138339,2023-09-14,711,TD kit,150,300,150,1,00276,India
314849,2023-09-14,706,sharpener,3,8,5,1,00472,India
475712,2023-09-14,715,folder,5,15,10,1,00375,India
475712,2023-09-14,703,eraser,1,3,2,1,00375,India
560116,2023-09-14,713,ball pen,5,10,5,1,00033,India
560116,2023-09-14,704,scale,5,10,5,1,00033,India
560116,2023-09-14,707,marker,20,40,20,1,00033,India
560116,2023-09-14,717,spiral bound book,50,100,50,1,00033,India
560116,2023-09-14,712,graph paper,20,40,20,1,00033,India
323911,2023-09-14,707,marker,20,40,20,1,00125,India
323911,2023-09-14,705,stencil,10,20,10,1,00125,India
323911,2023-09-14,716,printing paper,200,400,200,1,00125,India
382560,2023-09-14,714,carbon paper,15,30,15,1,00476,India
382560,2023-09-14,711,TD kit,150,300,150,1,00476,India
382560,2023-09-14,708,sketchpen,15,40,25,1,00476,India
382560,2023-09-14,715,folder,5,15,10,1,00476,India
957554,2023-09-14,707,marker,20,40,20,1,00269,India
957554,2023-09-14,714,carbon paper,15,30,15,1,00269,India
671099,2023-09-14,712,graph paper,20,40,20,1,00379,India
671099,2023-09-14,711,TD kit,150,300,150,1,00379,India
671099,2023-09-14,705,stencil,10,20,10,1,00379,India
942243,2023-09-14,704,scale,5,10,5,1,00414,India
942243,2023-09-14,717,spiral bound book,50,100,50,1,00414,India
942243,2023-09-14,712,graph paper,20,40,20,1,00414,India
942243,2023-09-14,701,gel pen,5,10,5,1,00414,India
649524,2023-09-14,716,printing paper,200,400,200,1,00403,India
649524,2023-09-14,701,gel pen,5,10,5,1,00403,India
649524,2023-09-14,702,pencil,2,5,3,1,00403,India
649524,2023-09-14,711,TD kit,150,300,150,1,00403,India
649524,2023-09-14,710,geometry box,100,150,50,1,00403,India
401102,2023-09-14,717,spiral bound book,50,100,50,1,00071,India
557793,2023-09-14,717,spiral bound book,50,100,50,1,00247,India
877885,2023-09-14,715,folder,5,15,10,1,00444,India
877885,2023-09-14,706,sharpener,3,8,5,1,00444,India
877885,2023-09-14,703,eraser,1,3,2,1,00444,India
877885,2023-09-14,716,printing paper,200,400,200,1,00444,India
691645,2023-09-14,708,sketchpen,15,40,25,1,00439,India
691645,2023-09-14,707,marker,20,40,20,1,00439,India
691645,2023-09-14,716,printing paper,200,400,200,1,00439,India
691645,2023-09-14,711,TD kit,150,300,150,1,00439,India
802719,2023-09-15,717,spiral bound book,50,100,50,1,00122,India
802719,2023-09-15,705,stencil,10,20,10,1,00122,India
704359,2023-09-15,710,geometry box,100,150,50,1,00291,India
704359,2023-09-15,707,marker,20,40,20,1,00291,India
704359,2023-09-15,713,ball pen,5,10,5,1,00291,India
704359,2023-09-15,709,notebook,30,60,30,1,00291,India
176490,2023-09-15,702,pencil,2,5,3,1,00235,India
918019,2023-09-15,711,TD kit,150,300,150,1,00319,India
918019,2023-09-15,713,ball pen,5,10,5,1,00319,India
918019,2023-09-15,707,marker,20,40,20,1,00319,India
204044,2023-09-15,711,TD kit,150,300,150,1,00492,India
138952,2023-09-15,711,TD kit,150,300,150,1,00088,India
138952,2023-09-15,717,spiral bound book,50,100,50,1,00088,India
138952,2023-09-15,704,scale,5,10,5,1,00088,India
138952,2023-09-15,712,graph paper,20,40,20,1,00088,India
138952,2023-09-15,713,ball pen,5,10,5,1,00088,India
650421,2023-09-15,711,TD kit,150,300,150,1,00288,India
443869,2023-09-15,711,TD kit,150,300,150,1,00148,India
443869,2023-09-15,716,printing paper,200,400,200,1,00148,India
443869,2023-09-15,702,pencil,2,5,3,1,00148,India
443869,2023-09-15,703,eraser,1,3,2,1,00148,India
506099,2023-09-15,711,TD kit,150,300,150,1,00292,India
506099,2023-09-15,701,gel pen,5,10,5,1,00292,India
156321,2023-09-15,714,carbon paper,15,30,15,1,00496,India
156321,2023-09-15,709,notebook,30,60,30,1,00496,India
156321,2023-09-15,713,ball pen,5,10,5,1,00496,India
156321,2023-09-15,712,graph paper,20,40,20,1,00496,India
481423,2023-09-15,704,scale,5,10,5,1,00288,India
481423,2023-09-15,701,gel pen,5,10,5,1,00288,India
481423,2023-09-15,716,printing paper,200,400,200,1,00288,India
481423,2023-09-15,715,folder,5,15,10,1,00288,India
816434,2023-09-15,704,scale,5,10,5,1,00113,India
816434,2023-09-15,712,graph paper,20,40,20,1,00113,India
816434,2023-09-15,706,sharpener,3,8,5,1,00113,India
816434,2023-09-15,708,sketchpen,15,40,25,1,00113,India
180865,2023-09-15,709,notebook,30,60,30,1,00264,India
180865,2023-09-15,714,carbon paper,15,30,15,1,00264,India
180865,2023-09-15,710,geometry box,100,150,50,1,00264,India
180865,2023-09-15,703,eraser,1,3,2,1,00264,India
589559,2023-09-15,713,ball pen,5,10,5,1,00423,India
589559,2023-09-15,702,pencil,2,5,3,1,00423,India
589559,2023-09-15,711,TD kit,150,300,150,1,00423,India
589559,2023-09-15,714,carbon paper,15,30,15,1,00423,India
126290,2023-09-15,715,folder,5,15,10,1,00368,India
126290,2023-09-15,707,marker,20,40,20,1,00368,India
126290,2023-09-15,708,sketchpen,15,40,25,1,00368,India
312373,2023-09-15,715,folder,5,15,10,1,00490,India
312373,2023-09-15,708,sketchpen,15,40,25,1,00490,India
312373,2023-09-15,714,carbon paper,15,30,15,1,00490,India
748091,2023-09-15,701,gel pen,5,10,5,1,00425,India
748091,2023-09-15,710,geometry box,100,150,50,1,00425,India
748091,2023-09-15,715,folder,5,15,10,1,00425,India
748091,2023-09-15,702,pencil,2,5,3,1,00425,India
626541,2023-09-15,702,pencil,2,5,3,1,00116,India
626541,2023-09-15,713,ball pen,5,10,5,1,00116,India
110787,2023-09-15,715,folder,5,15,10,1,00025,India
110787,2023-09-15,712,graph paper,20,40,20,1,00025,India
285040,2023-09-15,714,carbon paper,15,30,15,1,00263,India
285040,2023-09-15,709,notebook,30,60,30,1,00263,India
285040,2023-09-15,708,sketchpen,15,40,25,1,00263,India
285040,2023-09-15,716,printing paper,200,400,200,1,00263,India
314562,2023-09-15,707,marker,20,40,20,1,00479,India
314562,2023-09-15,711,TD kit,150,300,150,1,00479,India
314562,2023-09-15,713,ball pen,5,10,5,1,00479,India
314562,2023-09-15,716,printing paper,200,400,200,1,00479,India
658523,2023-09-15,710,geometry box,100,150,50,1,00022,India
658523,2023-09-15,712,graph paper,20,40,20,1,00022,India
658523,2023-09-15,713,ball pen,5,10,5,1,00022,India
658523,2023-09-15,715,folder,5,15,10,1,00022,India
153076,2023-09-15,710,geometry box,100,150,50,1,00196,India
102507,2023-09-15,705,stencil,10,20,10,1,00374,India
102507,2023-09-15,713,ball pen,5,10,5,1,00374,India
102507,2023-09-15,704,scale,5,10,5,1,00374,India
784777,2023-09-15,708,sketchpen,15,40,25,1,00409,India
784777,2023-09-15,716,printing paper,200,400,200,1,00409,India
152701,2023-09-15,715,folder,5,15,10,1,00500,India
152701,2023-09-15,703,eraser,1,3,2,1,00500,India
152701,2023-09-15,716,printing paper,200,400,200,1,00500,India
773176,2023-09-15,705,stencil,10,20,10,1,00361,India
773176,2023-09-15,708,sketchpen,15,40,25,1,00361,India
773176,2023-09-15,703,eraser,1,3,2,1,00361,India
644317,2023-09-15,713,ball pen,5,10,5,1,00269,India
644317,2023-09-15,715,folder,5,15,10,1,00269,India
644317,2023-09-15,706,sharpener,3,8,5,1,00269,India
820002,2023-09-15,706,sharpener,3,8,5,1,00232,India
798815,2023-09-15,710,geometry box,100,150,50,1,00144,India
798815,2023-09-15,701,gel pen,5,10,5,1,00144,India
798815,2023-09-15,708,sketchpen,15,40,25,1,00144,India
798815,2023-09-15,704,scale,5,10,5,1,00144,India
172624,2023-09-15,708,sketchpen,15,40,25,1,00341,India
172624,2023-09-15,709,notebook,30,60,30,1,00341,India
172624,2023-09-15,714,carbon paper,15,30,15,1,00341,India
172624,2023-09-15,702,pencil,2,5,3,1,00341,India
644167,2023-09-15,704,scale,5,10,5,1,00020,India
590717,2023-09-15,708,sketchpen,15,40,25,1,00324,India
590717,2023-09-15,712,graph paper,20,40,20,1,00324,India
590717,2023-09-15,710,geometry box,100,150,50,1,00324,India
590717,2023-09-15,713,ball pen,5,10,5,1,00324,India
888168,2023-09-15,709,notebook,30,60,30,1,00265,India
888168,2023-09-15,716,printing paper,200,400,200,1,00265,India
888168,2023-09-15,717,spiral bound book,50,100,50,1,00265,India
888168,2023-09-15,708,sketchpen,15,40,25,1,00265,India
429134,2023-09-15,703,eraser,1,3,2,1,00355,India
567812,2023-09-15,703,eraser,1,3,2,1,00193,India
747292,2023-09-15,702,pencil,2,5,3,1,00403,India
981502,2023-09-15,704,scale,5,10,5,1,00412,India
981502,2023-09-15,702,pencil,2,5,3,1,00412,India
981502,2023-09-15,709,notebook,30,60,30,1,00412,India
461244,2023-09-15,702,pencil,2,5,3,1,00341,India
461244,2023-09-15,715,folder,5,15,10,1,00341,India
975272,2023-09-15,715,folder,5,15,10,1,00194,India
975272,2023-09-15,703,eraser,1,3,2,1,00194,India
975272,2023-09-15,716,printing paper,200,400,200,1,00194,India
975272,2023-09-15,706,sharpener,3,8,5,1,00194,India
368404,2023-09-15,713,ball pen,5,10,5,1,00040,India
706381,2023-09-15,705,stencil,10,20,10,1,00416,India
925989,2023-09-15,704,scale,5,10,5,1,00044,India
925989,2023-09-15,716,printing paper,200,400,200,1,00044,India
925989,2023-09-15,715,folder,5,15,10,1,00044,India
366654,2023-09-16,715,folder,5,15,10,1,00034,India
366654,2023-09-16,717,spiral bound book,50,100,50,1,00034,India
366654,2023-09-16,712,graph paper,20,40,20,1,00034,India
366654,2023-09-16,710,geometry box,100,150,50,1,00034,India
650362,2023-09-16,714,carbon paper,15,30,15,1,00113,India
965723,2023-09-16,702,pencil,2,5,3,1,00496,India
965723,2023-09-16,710,geometry box,100,150,50,1,00496,India
842782,2023-09-16,712,graph paper,20,40,20,1,00084,India
842782,2023-09-16,709,notebook,30,60,30,1,00084,India
189951,2023-09-16,713,ball pen,5,10,5,1,00412,India
525245,2023-09-16,714,carbon paper,15,30,15,1,00172,India
525245,2023-09-16,715,folder,5,15,10,1,00172,India
525245,2023-09-16,701,gel pen,5,10,5,1,00172,India
913839,2023-09-16,703,eraser,1,3,2,1,00318,India
913839,2023-09-16,713,ball pen,5,10,5,1,00318,India
913839,2023-09-16,712,graph paper,20,40,20,1,00318,India
913839,2023-09-16,701,gel pen,5,10,5,1,00318,India
913839,2023-09-16,716,printing paper,200,400,200,1,00318,India
949647,2023-09-16,702,pencil,2,5,3,1,00180,India
949647,2023-09-16,713,ball pen,5,10,5,1,00180,India
949647,2023-09-16,707,marker,20,40,20,1,00180,India
949647,2023-09-16,708,sketchpen,15,40,25,1,00180,India
949647,2023-09-16,711,TD kit,150,300,150,1,00180,India
344730,2023-09-16,711,TD kit,150,300,150,1,00050,India
643776,2023-09-16,705,stencil,10,20,10,1,00423,India
643776,2023-09-16,714,carbon paper,15,30,15,1,00423,India
391514,2023-09-16,716,printing paper,200,400,200,1,00482,India
391514,2023-09-16,710,geometry box,100,150,50,1,00482,India
391514,2023-09-16,713,ball pen,5,10,5,1,00482,India
177841,2023-09-16,707,marker,20,40,20,1,00437,India
177841,2023-09-16,704,scale,5,10,5,1,00437,India
813144,2023-09-16,710,geometry box,100,150,50,1,00142,India
873475,2023-09-16,715,folder,5,15,10,1,00331,India
873475,2023-09-16,717,spiral bound book,50,100,50,1,00331,India
873475,2023-09-16,714,carbon paper,15,30,15,1,00331,India
483124,2023-09-16,710,geometry box,100,150,50,1,00113,India
483124,2023-09-16,701,gel pen,5,10,5,1,00113,India
483124,2023-09-16,702,pencil,2,5,3,1,00113,India
483124,2023-09-16,717,spiral bound book,50,100,50,1,00113,India
483124,2023-09-16,713,ball pen,5,10,5,1,00113,India
742318,2023-09-16,706,sharpener,3,8,5,1,00421,India
870820,2023-09-16,715,folder,5,15,10,1,00253,India
870820,2023-09-16,714,carbon paper,15,30,15,1,00253,India
870820,2023-09-16,706,sharpener,3,8,5,1,00253,India
350863,2023-09-16,704,scale,5,10,5,1,00279,India
754833,2023-09-16,708,sketchpen,15,40,25,1,00269,India
754833,2023-09-16,714,carbon paper,15,30,15,1,00269,India
754833,2023-09-16,712,graph paper,20,40,20,1,00269,India
754833,2023-09-16,716,printing paper,200,400,200,1,00269,India
717719,2023-09-16,715,folder,5,15,10,1,00155,India
546482,2023-09-16,711,TD kit,150,300,150,1,00224,India
706289,2023-09-16,716,printing paper,200,400,200,1,00302,India
706289,2023-09-16,706,sharpener,3,8,5,1,00302,India
517368,2023-09-16,704,scale,5,10,5,1,00387,India
517368,2023-09-16,703,eraser,1,3,2,1,00387,India
517368,2023-09-16,706,sharpener,3,8,5,1,00387,India
517368,2023-09-16,709,notebook,30,60,30,1,00387,India
517368,2023-09-16,701,gel pen,5,10,5,1,00387,India
169964,2023-09-16,702,pencil,2,5,3,1,00027,India
134329,2023-09-16,713,ball pen,5,10,5,1,00384,India
140012,2023-09-16,716,printing paper,200,400,200,1,00239,India
140012,2023-09-16,708,sketchpen,15,40,25,1,00239,India
140012,2023-09-16,709,notebook,30,60,30,1,00239,India
140012,2023-09-16,707,marker,20,40,20,1,00239,India
140012,2023-09-16,710,geometry box,100,150,50,1,00239,India
748923,2023-09-16,712,graph paper,20,40,20,1,00443,India
748923,2023-09-16,704,scale,5,10,5,1,00443,India
576932,2023-09-16,713,ball pen,5,10,5,1,00243,India
576932,2023-09-16,702,pencil,2,5,3,1,00243,India
580958,2023-09-16,705,stencil,10,20,10,1,00231,India
580958,2023-09-16,708,sketchpen,15,40,25,1,00231,India
686702,2023-09-16,706,sharpener,3,8,5,1,00368,India
686702,2023-09-16,702,pencil,2,5,3,1,00368,India
358254,2023-09-17,702,pencil,2,5,3,1,00424,India
358254,2023-09-17,709,notebook,30,60,30,1,00424,India
980156,2023-09-17,710,geometry box,100,150,50,1,00352,India
980156,2023-09-17,702,pencil,2,5,3,1,00352,India
980156,2023-09-17,714,carbon paper,15,30,15,1,00352,India
981278,2023-09-17,703,eraser,1,3,2,1,00271,India
981278,2023-09-17,706,sharpener,3,8,5,1,00271,India
981278,2023-09-17,712,graph paper,20,40,20,1,00271,India
390662,2023-09-17,705,stencil,10,20,10,1,00014,India
390662,2023-09-17,716,printing paper,200,400,200,1,00014,India
524500,2023-09-17,714,carbon paper,15,30,15,1,00041,India
524500,2023-09-17,708,sketchpen,15,40,25,1,00041,India
524500,2023-09-17,705,stencil,10,20,10,1,00041,India
524500,2023-09-17,701,gel pen,5,10,5,1,00041,India
524500,2023-09-17,707,marker,20,40,20,1,00041,India
185467,2023-09-17,717,spiral bound book,50,100,50,1,00486,India
185467,2023-09-17,710,geometry box,100,150,50,1,00486,India
660355,2023-09-17,716,printing paper,200,400,200,1,00104,India
660355,2023-09-17,707,marker,20,40,20,1,00104,India
890803,2023-09-17,715,folder,5,15,10,1,00133,India
890803,2023-09-17,712,graph paper,20,40,20,1,00133,India
357805,2023-09-17,705,stencil,10,20,10,1,00370,India
357805,2023-09-17,716,printing paper,200,400,200,1,00370,India
357805,2023-09-17,706,sharpener,3,8,5,1,00370,India
471870,2023-09-17,713,ball pen,5,10,5,1,00353,India
471870,2023-09-17,706,sharpener,3,8,5,1,00353,India
582064,2023-09-17,711,TD kit,150,300,150,1,00424,India
582064,2023-09-17,705,stencil,10,20,10,1,00424,India
582064,2023-09-17,706,sharpener,3,8,5,1,00424,India
228064,2023-09-17,712,graph paper,20,40,20,1,00138,India
228064,2023-09-17,717,spiral bound book,50,100,50,1,00138,India
228064,2023-09-17,702,pencil,2,5,3,1,00138,India
439481,2023-09-17,712,graph paper,20,40,20,1,00230,India
439481,2023-09-17,701,gel pen,5,10,5,1,00230,India
439481,2023-09-17,707,marker,20,40,20,1,00230,India
439481,2023-09-17,715,folder,5,15,10,1,00230,India
174468,2023-09-17,715,folder,5,15,10,1,00276,India
174468,2023-09-17,717,spiral bound book,50,100,50,1,00276,India
702051,2023-09-17,711,TD kit,150,300,150,1,00009,India
597853,2023-09-17,709,notebook,30,60,30,1,00098,India
597853,2023-09-17,711,TD kit,150,300,150,1,00098,India
597853,2023-09-17,710,geometry box,100,150,50,1,00098,India
926911,2023-09-17,711,TD kit,150,300,150,1,00051,India
926911,2023-09-17,716,printing paper,200,400,200,1,00051,India
926911,2023-09-17,715,folder,5,15,10,1,00051,India
926911,2023-09-17,717,spiral bound book,50,100,50,1,00051,India
926911,2023-09-17,713,ball pen,5,10,5,1,00051,India
270115,2023-09-17,706,sharpener,3,8,5,1,00161,India
270115,2023-09-17,710,geometry box,100,150,50,1,00161,India
270115,2023-09-17,703,eraser,1,3,2,1,00161,India
432533,2023-09-17,706,sharpener,3,8,5,1,00327,India
465497,2023-09-17,708,sketchpen,15,40,25,1,00463,India
465497,2023-09-17,713,ball pen,5,10,5,1,00463,India
113975,2023-09-17,706,sharpener,3,8,5,1,00262,India
113975,2023-09-17,711,TD kit,150,300,150,1,00262,India
113975,2023-09-17,715,folder,5,15,10,1,00262,India
113975,2023-09-17,707,marker,20,40,20,1,00262,India
368659,2023-09-17,716,printing paper,200,400,200,1,00144,India
402821,2023-09-17,706,sharpener,3,8,5,1,00191,India
402821,2023-09-17,701,gel pen,5,10,5,1,00191,India
402821,2023-09-17,714,carbon paper,15,30,15,1,00191,India
402821,2023-09-17,707,marker,20,40,20,1,00191,India
692857,2023-09-17,702,pencil,2,5,3,1,00222,India
692857,2023-09-17,710,geometry box,100,150,50,1,00222,India
692857,2023-09-17,704,scale,5,10,5,1,00222,India
491397,2023-09-17,710,geometry box,100,150,50,1,00219,India
931078,2023-09-17,706,sharpener,3,8,5,1,00457,India
931078,2023-09-17,717,spiral bound book,50,100,50,1,00457,India
931078,2023-09-17,715,folder,5,15,10,1,00457,India
598974,2023-09-17,710,geometry box,100,150,50,1,00003,India
986171,2023-09-17,705,stencil,10,20,10,1,00481,India
986171,2023-09-17,714,carbon paper,15,30,15,1,00481,India
494929,2023-09-17,712,graph paper,20,40,20,1,00154,India
494929,2023-09-17,711,TD kit,150,300,150,1,00154,India
494929,2023-09-17,705,stencil,10,20,10,1,00154,India
494929,2023-09-17,704,scale,5,10,5,1,00154,India
494929,2023-09-17,717,spiral bound book,50,100,50,1,00154,India
344994,2023-09-17,716,printing paper,200,400,200,1,00303,India
344994,2023-09-17,708,sketchpen,15,40,25,1,00303,India
344994,2023-09-17,704,scale,5,10,5,1,00303,India
344994,2023-09-17,715,folder,5,15,10,1,00303,India
667150,2023-09-17,712,graph paper,20,40,20,1,00109,India
667150,2023-09-17,701,gel pen,5,10,5,1,00109,India
880931,2023-09-17,703,eraser,1,3,2,1,00302,India
880931,2023-09-17,712,graph paper,20,40,20,1,00302,India
897154,2023-09-17,709,notebook,30,60,30,1,00003,India
897154,2023-09-17,705,stencil,10,20,10,1,00003,India
897154,2023-09-17,701,gel pen,5,10,5,1,00003,India
897154,2023-09-17,714,carbon paper,15,30,15,1,00003,India
540256,2023-09-17,717,spiral bound book,50,100,50,1,00107,India
540256,2023-09-17,710,geometry box,100,150,50,1,00107,India
540256,2023-09-17,708,sketchpen,15,40,25,1,00107,India
540256,2023-09-17,713,ball pen,5,10,5,1,00107,India
830628,2023-09-17,710,geometry box,100,150,50,1,00297,India
830628,2023-09-17,717,spiral bound book,50,100,50,1,00297,India
830628,2023-09-17,703,eraser,1,3,2,1,00297,India
830628,2023-09-17,709,notebook,30,60,30,1,00297,India
369812,2023-09-18,709,notebook,30,60,30,1,00453,India
362595,2023-09-18,711,TD kit,150,300,150,1,00125,India
362595,2023-09-18,701,gel pen,5,10,5,1,00125,India
650336,2023-09-18,714,carbon paper,15,30,15,1,00343,India
650336,2023-09-18,703,eraser,1,3,2,1,00343,India
650336,2023-09-18,701,gel pen,5,10,5,1,00343,India
545307,2023-09-18,703,eraser,1,3,2,1,00390,India
545307,2023-09-18,702,pencil,2,5,3,1,00390,India
545307,2023-09-18,715,folder,5,15,10,1,00390,India
545307,2023-09-18,711,TD kit,150,300,150,1,00390,India
803337,2023-09-18,717,spiral bound book,50,100,50,1,00213,India
743819,2023-09-18,701,gel pen,5,10,5,1,00004,India
743819,2023-09-18,714,carbon paper,15,30,15,1,00004,India
288006,2023-09-18,707,marker,20,40,20,1,00005,India
288006,2023-09-18,715,folder,5,15,10,1,00005,India
288006,2023-09-18,705,stencil,10,20,10,1,00005,India
109474,2023-09-18,715,folder,5,15,10,1,00115,India
109474,2023-09-18,717,spiral bound book,50,100,50,1,00115,India
109474,2023-09-18,706,sharpener,3,8,5,1,00115,India
109474,2023-09-18,711,TD kit,150,300,150,1,00115,India
983696,2023-09-18,716,printing paper,200,400,200,1,00112,India
983696,2023-09-18,701,gel pen,5,10,5,1,00112,India
983696,2023-09-18,713,ball pen,5,10,5,1,00112,India
983696,2023-09-18,706,sharpener,3,8,5,1,00112,India
983696,2023-09-18,714,carbon paper,15,30,15,1,00112,India
150485,2023-09-18,714,carbon paper,15,30,15,1,00134,India
150485,2023-09-18,713,ball pen,5,10,5,1,00134,India
150485,2023-09-18,705,stencil,10,20,10,1,00134,India
775500,2023-09-18,701,gel pen,5,10,5,1,00027,India
775500,2023-09-18,716,printing paper,200,400,200,1,00027,India
775500,2023-09-18,709,notebook,30,60,30,1,00027,India
171276,2023-09-18,709,notebook,30,60,30,1,00458,India
171276,2023-09-18,706,sharpener,3,8,5,1,00458,India
171276,2023-09-18,711,TD kit,150,300,150,1,00458,India
171276,2023-09-18,705,stencil,10,20,10,1,00458,India
580171,2023-09-18,705,stencil,10,20,10,1,00468,India
580171,2023-09-18,702,pencil,2,5,3,1,00468,India
580171,2023-09-18,710,geometry box,100,150,50,1,00468,India
580171,2023-09-18,716,printing paper,200,400,200,1,00468,India
469556,2023-09-18,716,printing paper,200,400,200,1,00100,India
469556,2023-09-18,713,ball pen,5,10,5,1,00100,India
469556,2023-09-18,709,notebook,30,60,30,1,00100,India
469556,2023-09-18,703,eraser,1,3,2,1,00100,India
865624,2023-09-18,702,pencil,2,5,3,1,00140,India
865624,2023-09-18,711,TD kit,150,300,150,1,00140,India
865624,2023-09-18,717,spiral bound book,50,100,50,1,00140,India
865624,2023-09-18,716,printing paper,200,400,200,1,00140,India
603389,2023-09-18,709,notebook,30,60,30,1,00277,India
603389,2023-09-18,714,carbon paper,15,30,15,1,00277,India
603389,2023-09-18,713,ball pen,5,10,5,1,00277,India
920021,2023-09-18,713,ball pen,5,10,5,1,00043,India
920021,2023-09-18,703,eraser,1,3,2,1,00043,India
920021,2023-09-18,709,notebook,30,60,30,1,00043,India
941034,2023-09-18,708,sketchpen,15,40,25,1,00144,India
941034,2023-09-18,705,stencil,10,20,10,1,00144,India
392622,2023-09-18,717,spiral bound book,50,100,50,1,00089,India
392622,2023-09-18,712,graph paper,20,40,20,1,00089,India
392622,2023-09-18,703,eraser,1,3,2,1,00089,India
392622,2023-09-18,707,marker,20,40,20,1,00089,India
400078,2023-09-18,705,stencil,10,20,10,1,00319,India
400078,2023-09-18,703,eraser,1,3,2,1,00319,India
223775,2023-09-18,710,geometry box,100,150,50,1,00268,India
223775,2023-09-18,706,sharpener,3,8,5,1,00268,India
223775,2023-09-18,716,printing paper,200,400,200,1,00268,India
223775,2023-09-18,703,eraser,1,3,2,1,00268,India
213253,2023-09-18,713,ball pen,5,10,5,1,00376,India
213253,2023-09-18,704,scale,5,10,5,1,00376,India
497504,2023-09-18,704,scale,5,10,5,1,00070,India
497504,2023-09-18,702,pencil,2,5,3,1,00070,India
497504,2023-09-18,711,TD kit,150,300,150,1,00070,India
538754,2023-09-18,715,folder,5,15,10,1,00047,India
538754,2023-09-18,711,TD kit,150,300,150,1,00047,India
538754,2023-09-18,708,sketchpen,15,40,25,1,00047,India
265892,2023-09-18,715,folder,5,15,10,1,00344,India
265892,2023-09-18,703,eraser,1,3,2,1,00344,India
265892,2023-09-18,714,carbon paper,15,30,15,1,00344,India
265892,2023-09-18,711,TD kit,150,300,150,1,00344,India
265892,2023-09-18,713,ball pen,5,10,5,1,00344,India
857935,2023-09-18,714,carbon paper,15,30,15,1,00361,India
857935,2023-09-18,707,marker,20,40,20,1,00361,India
918806,2023-09-18,712,graph paper,20,40,20,1,00062,India
918806,2023-09-18,706,sharpener,3,8,5,1,00062,India
918806,2023-09-18,707,marker,20,40,20,1,00062,India
609577,2023-09-18,713,ball pen,5,10,5,1,00373,India
609577,2023-09-18,705,stencil,10,20,10,1,00373,India
609577,2023-09-18,709,notebook,30,60,30,1,00373,India
609577,2023-09-18,701,gel pen,5,10,5,1,00373,India
405865,2023-09-18,710,geometry box,100,150,50,1,00236,India
405865,2023-09-18,717,spiral bound book,50,100,50,1,00236,India
329705,2023-09-18,703,eraser,1,3,2,1,00208,India
329705,2023-09-18,706,sharpener,3,8,5,1,00208,India
329705,2023-09-18,701,gel pen,5,10,5,1,00208,India
880672,2023-09-18,716,printing paper,200,400,200,1,00439,India
880672,2023-09-18,709,notebook,30,60,30,1,00439,India
880672,2023-09-18,710,geometry box,100,150,50,1,00439,India
221178,2023-09-18,708,sketchpen,15,40,25,1,00001,India
221178,2023-09-18,704,scale,5,10,5,1,00001,India
221178,2023-09-18,705,stencil,10,20,10,1,00001,India
221178,2023-09-18,707,marker,20,40,20,1,00001,India
221178,2023-09-18,713,ball pen,5,10,5,1,00001,India
455708,2023-09-18,705,stencil,10,20,10,1,00197,India
455708,2023-09-18,710,geometry box,100,150,50,1,00197,India
455708,2023-09-18,713,ball pen,5,10,5,1,00197,India
363709,2023-09-19,701,gel pen,5,10,5,1,00155,India
298726,2023-09-19,711,TD kit,150,300,150,1,00385,India
767601,2023-09-19,717,spiral bound book,50,100,50,1,00205,India
767601,2023-09-19,706,sharpener,3,8,5,1,00205,India
767601,2023-09-19,704,scale,5,10,5,1,00205,India
264389,2023-09-19,713,ball pen,5,10,5,1,00260,India
264389,2023-09-19,709,notebook,30,60,30,1,00260,India
499815,2023-09-19,711,TD kit,150,300,150,1,00293,India
499815,2023-09-19,705,stencil,10,20,10,1,00293,India
499815,2023-09-19,702,pencil,2,5,3,1,00293,India
499815,2023-09-19,717,spiral bound book,50,100,50,1,00293,India
680313,2023-09-19,715,folder,5,15,10,1,00470,India
680313,2023-09-19,701,gel pen,5,10,5,1,00470,India
680313,2023-09-19,704,scale,5,10,5,1,00470,India
706839,2023-09-19,702,pencil,2,5,3,1,00482,India
706839,2023-09-19,717,spiral bound book,50,100,50,1,00482,India
945663,2023-09-19,713,ball pen,5,10,5,1,00494,India
945663,2023-09-19,708,sketchpen,15,40,25,1,00494,India
304332,2023-09-19,702,pencil,2,5,3,1,00112,India
304332,2023-09-19,714,carbon paper,15,30,15,1,00112,India
264746,2023-09-19,702,pencil,2,5,3,1,00100,India
264746,2023-09-19,713,ball pen,5,10,5,1,00100,India
264746,2023-09-19,711,TD kit,150,300,150,1,00100,India
717544,2023-09-19,703,eraser,1,3,2,1,00346,India
717544,2023-09-19,707,marker,20,40,20,1,00346,India
717544,2023-09-19,704,scale,5,10,5,1,00346,India
840350,2023-09-19,710,geometry box,100,150,50,1,00178,India
840350,2023-09-19,716,printing paper,200,400,200,1,00178,India
470021,2023-09-19,714,carbon paper,15,30,15,1,00040,India
470021,2023-09-19,717,spiral bound book,50,100,50,1,00040,India
470021,2023-09-19,705,stencil,10,20,10,1,00040,India
256897,2023-09-19,716,printing paper,200,400,200,1,00124,India
256897,2023-09-19,705,stencil,10,20,10,1,00124,India
256897,2023-09-19,712,graph paper,20,40,20,1,00124,India
256897,2023-09-19,717,spiral bound book,50,100,50,1,00124,India
304013,2023-09-19,704,scale,5,10,5,1,00101,India
304013,2023-09-19,705,stencil,10,20,10,1,00101,India
817233,2023-09-19,706,sharpener,3,8,5,1,00300,India
817233,2023-09-19,710,geometry box,100,150,50,1,00300,India
817233,2023-09-19,712,graph paper,20,40,20,1,00300,India
664991,2023-09-19,707,marker,20,40,20,1,00440,India
664991,2023-09-19,709,notebook,30,60,30,1,00440,India
664991,2023-09-19,704,scale,5,10,5,1,00440,India
648768,2023-09-19,703,eraser,1,3,2,1,00060,India
648768,2023-09-19,713,ball pen,5,10,5,1,00060,India
648768,2023-09-19,717,spiral bound book,50,100,50,1,00060,India
648768,2023-09-19,709,notebook,30,60,30,1,00060,India
648768,2023-09-19,707,marker,20,40,20,1,00060,India
234747,2023-09-19,704,scale,5,10,5,1,00271,India
234747,2023-09-19,703,eraser,1,3,2,1,00271,India
234747,2023-09-19,717,spiral bound book,50,100,50,1,00271,India
234747,2023-09-19,711,TD kit,150,300,150,1,00271,India
228535,2023-09-19,714,carbon paper,15,30,15,1,00153,India
552866,2023-09-19,701,gel pen,5,10,5,1,00291,India
552866,2023-09-19,706,sharpener,3,8,5,1,00291,India
552866,2023-09-19,709,notebook,30,60,30,1,00291,India
642982,2023-09-19,711,TD kit,150,300,150,1,00214,India
642982,2023-09-19,706,sharpener,3,8,5,1,00214,India
642982,2023-09-19,705,stencil,10,20,10,1,00214,India
239654,2023-09-19,706,sharpener,3,8,5,1,00484,India
239654,2023-09-19,711,TD kit,150,300,150,1,00484,India
239654,2023-09-19,713,ball pen,5,10,5,1,00484,India
340294,2023-09-19,710,geometry box,100,150,50,1,00083,India
340294,2023-09-19,708,sketchpen,15,40,25,1,00083,India
340294,2023-09-19,714,carbon paper,15,30,15,1,00083,India
340294,2023-09-19,713,ball pen,5,10,5,1,00083,India
707411,2023-09-19,714,carbon paper,15,30,15,1,00052,India
707411,2023-09-19,703,eraser,1,3,2,1,00052,India
862817,2023-09-19,703,eraser,1,3,2,1,00425,India
394091,2023-09-19,715,folder,5,15,10,1,00065,India
394091,2023-09-19,711,TD kit,150,300,150,1,00065,India
394091,2023-09-19,702,pencil,2,5,3,1,00065,India
207536,2023-09-19,701,gel pen,5,10,5,1,00239,India
207536,2023-09-19,710,geometry box,100,150,50,1,00239,India
513291,2023-09-19,704,scale,5,10,5,1,00305,India
513291,2023-09-19,711,TD kit,150,300,150,1,00305,India
513291,2023-09-19,712,graph paper,20,40,20,1,00305,India
701485,2023-09-19,711,TD kit,150,300,150,1,00373,India
701485,2023-09-19,706,sharpener,3,8,5,1,00373,India
701485,2023-09-19,705,stencil,10,20,10,1,00373,India
701485,2023-09-19,714,carbon paper,15,30,15,1,00373,India
701485,2023-09-19,710,geometry box,100,150,50,1,00373,India
803997,2023-09-19,703,eraser,1,3,2,1,00489,India
803997,2023-09-19,713,ball pen,5,10,5,1,00489,India
398308,2023-09-19,712,graph paper,20,40,20,1,00257,India
398308,2023-09-19,702,pencil,2,5,3,1,00257,India
398308,2023-09-19,703,eraser,1,3,2,1,00257,India
398308,2023-09-19,715,folder,5,15,10,1,00257,India
797124,2023-09-19,704,scale,5,10,5,1,00272,India
797124,2023-09-19,710,geometry box,100,150,50,1,00272,India
589136,2023-09-19,715,folder,5,15,10,1,00422,India
589136,2023-09-19,709,notebook,30,60,30,1,00422,India
589136,2023-09-19,717,spiral bound book,50,100,50,1,00422,India
589136,2023-09-19,711,TD kit,150,300,150,1,00422,India
991660,2023-09-19,708,sketchpen,15,40,25,1,00250,India
991660,2023-09-19,716,printing paper,200,400,200,1,00250,India
258412,2023-09-19,701,gel pen,5,10,5,1,00488,India
258412,2023-09-19,710,geometry box,100,150,50,1,00488,India
258412,2023-09-19,714,carbon paper,15,30,15,1,00488,India
734419,2023-09-19,703,eraser,1,3,2,1,00399,India
734419,2023-09-19,705,stencil,10,20,10,1,00399,India
734419,2023-09-19,712,graph paper,20,40,20,1,00399,India
172115,2023-09-19,701,gel pen,5,10,5,1,00235,India
172115,2023-09-19,708,sketchpen,15,40,25,1,00235,India
172115,2023-09-19,710,geometry box,100,150,50,1,00235,India
172115,2023-09-19,714,carbon paper,15,30,15,1,00235,India
121983,2023-09-19,717,spiral bound book,50,100,50,1,00166,India
121983,2023-09-19,713,ball pen,5,10,5,1,00166,India
718423,2023-09-20,714,carbon paper,15,30,15,1,00290,India
718423,2023-09-20,710,geometry box,100,150,50,1,00290,India
718423,2023-09-20,707,marker,20,40,20,1,00290,India
762021,2023-09-20,714,carbon paper,15,30,15,1,00235,India
762021,2023-09-20,701,gel pen,5,10,5,1,00235,India
762021,2023-09-20,715,folder,5,15,10,1,00235,India
762021,2023-09-20,717,spiral bound book,50,100,50,1,00235,India
762021,2023-09-20,704,scale,5,10,5,1,00235,India
469176,2023-09-20,709,notebook,30,60,30,1,00441,India
469176,2023-09-20,711,TD kit,150,300,150,1,00441,India
469176,2023-09-20,704,scale,5,10,5,1,00441,India
469176,2023-09-20,710,geometry box,100,150,50,1,00441,India
469176,2023-09-20,705,stencil,10,20,10,1,00441,India
140871,2023-09-20,706,sharpener,3,8,5,1,00381,India
761962,2023-09-20,706,sharpener,3,8,5,1,00203,India
179778,2023-09-20,705,stencil,10,20,10,1,00257,India
179778,2023-09-20,702,pencil,2,5,3,1,00257,India
806955,2023-09-20,711,TD kit,150,300,150,1,00043,India
806955,2023-09-20,706,sharpener,3,8,5,1,00043,India
925936,2023-09-20,709,notebook,30,60,30,1,00401,India
925936,2023-09-20,705,stencil,10,20,10,1,00401,India
925936,2023-09-20,711,TD kit,150,300,150,1,00401,India
925936,2023-09-20,717,spiral bound book,50,100,50,1,00401,India
136130,2023-09-20,705,stencil,10,20,10,1,00092,India
911162,2023-09-20,711,TD kit,150,300,150,1,00367,India
103184,2023-09-20,705,stencil,10,20,10,1,00043,India
103184,2023-09-20,710,geometry box,100,150,50,1,00043,India
103184,2023-09-20,716,printing paper,200,400,200,1,00043,India
103184,2023-09-20,706,sharpener,3,8,5,1,00043,India
310856,2023-09-20,702,pencil,2,5,3,1,00066,India
310856,2023-09-20,714,carbon paper,15,30,15,1,00066,India
310856,2023-09-20,701,gel pen,5,10,5,1,00066,India
436900,2023-09-20,704,scale,5,10,5,1,00032,India
436900,2023-09-20,710,geometry box,100,150,50,1,00032,India
436900,2023-09-20,707,marker,20,40,20,1,00032,India
965414,2023-09-20,713,ball pen,5,10,5,1,00316,India
965414,2023-09-20,702,pencil,2,5,3,1,00316,India
361168,2023-09-20,708,sketchpen,15,40,25,1,00473,India
141283,2023-09-20,714,carbon paper,15,30,15,1,00065,India
141283,2023-09-20,717,spiral bound book,50,100,50,1,00065,India
751895,2023-09-20,709,notebook,30,60,30,1,00483,India
751895,2023-09-20,713,ball pen,5,10,5,1,00483,India
751895,2023-09-20,704,scale,5,10,5,1,00483,India
751895,2023-09-20,712,graph paper,20,40,20,1,00483,India
751895,2023-09-20,717,spiral bound book,50,100,50,1,00483,India
181625,2023-09-20,710,geometry box,100,150,50,1,00366,India
181625,2023-09-20,705,stencil,10,20,10,1,00366,India
181625,2023-09-20,713,ball pen,5,10,5,1,00366,India
181625,2023-09-20,707,marker,20,40,20,1,00366,India
181625,2023-09-20,715,folder,5,15,10,1,00366,India
468054,2023-09-20,712,graph paper,20,40,20,1,00055,India
302690,2023-09-20,702,pencil,2,5,3,1,00416,India
302690,2023-09-20,711,TD kit,150,300,150,1,00416,India
478444,2023-09-20,704,scale,5,10,5,1,00249,India
478444,2023-09-20,717,spiral bound book,50,100,50,1,00249,India
658975,2023-09-20,716,printing paper,200,400,200,1,00292,India
658975,2023-09-20,705,stencil,10,20,10,1,00292,India
979495,2023-09-20,709,notebook,30,60,30,1,00301,India
979495,2023-09-20,716,printing paper,200,400,200,1,00301,India
979495,2023-09-20,712,graph paper,20,40,20,1,00301,India
979495,2023-09-20,701,gel pen,5,10,5,1,00301,India
208716,2023-09-20,710,geometry box,100,150,50,1,00099,India
208716,2023-09-20,714,carbon paper,15,30,15,1,00099,India
208716,2023-09-20,704,scale,5,10,5,1,00099,India
130678,2023-09-20,704,scale,5,10,5,1,00374,India
526200,2023-09-20,706,sharpener,3,8,5,1,00431,India
526200,2023-09-20,712,graph paper,20,40,20,1,00431,India
768154,2023-09-20,714,carbon paper,15,30,15,1,00279,India
768154,2023-09-20,715,folder,5,15,10,1,00279,India
768154,2023-09-20,716,printing paper,200,400,200,1,00279,India
768154,2023-09-20,706,sharpener,3,8,5,1,00279,India
363011,2023-09-20,715,folder,5,15,10,1,00185,India
363011,2023-09-20,711,TD kit,150,300,150,1,00185,India
363011,2023-09-20,705,stencil,10,20,10,1,00185,India
657226,2023-09-20,712,graph paper,20,40,20,1,00498,India
657226,2023-09-20,701,gel pen,5,10,5,1,00498,India
397792,2023-09-20,708,sketchpen,15,40,25,1,00466,India
397792,2023-09-20,717,spiral bound book,50,100,50,1,00466,India
397792,2023-09-20,702,pencil,2,5,3,1,00466,India
397792,2023-09-20,711,TD kit,150,300,150,1,00466,India
131364,2023-09-20,716,printing paper,200,400,200,1,00423,India
192101,2023-09-20,715,folder,5,15,10,1,00436,India
553513,2023-09-20,704,scale,5,10,5,1,00011,India
553513,2023-09-20,710,geometry box,100,150,50,1,00011,India
542266,2023-09-20,702,pencil,2,5,3,1,00253,India
452981,2023-09-20,708,sketchpen,15,40,25,1,00471,India
452981,2023-09-20,715,folder,5,15,10,1,00471,India
107590,2023-09-20,711,TD kit,150,300,150,1,00076,India
107590,2023-09-20,709,notebook,30,60,30,1,00076,India
107590,2023-09-20,706,sharpener,3,8,5,1,00076,India
107590,2023-09-20,705,stencil,10,20,10,1,00076,India
107590,2023-09-20,717,spiral bound book,50,100,50,1,00076,India
113661,2023-09-20,708,sketchpen,15,40,25,1,00293,India
113661,2023-09-20,712,graph paper,20,40,20,1,00293,India
667680,2023-09-20,709,notebook,30,60,30,1,00499,India
819782,2023-09-20,717,spiral bound book,50,100,50,1,00499,India
819782,2023-09-20,706,sharpener,3,8,5,1,00499,India
121953,2023-09-20,704,scale,5,10,5,1,00419,India
121953,2023-09-20,715,folder,5,15,10,1,00419,India
928774,2023-09-21,705,stencil,10,20,10,1,00206,India
928774,2023-09-21,715,folder,5,15,10,1,00206,India
859323,2023-09-21,709,notebook,30,60,30,1,00156,India
859323,2023-09-21,710,geometry box,100,150,50,1,00156,India
859323,2023-09-21,706,sharpener,3,8,5,1,00156,India
710331,2023-09-21,705,stencil,10,20,10,1,00259,India
710331,2023-09-21,713,ball pen,5,10,5,1,00259,India
712367,2023-09-21,704,scale,5,10,5,1,00114,India
712367,2023-09-21,717,spiral bound book,50,100,50,1,00114,India
712367,2023-09-21,710,geometry box,100,150,50,1,00114,India
712367,2023-09-21,712,graph paper,20,40,20,1,00114,India
717733,2023-09-21,703,eraser,1,3,2,1,00269,India
717733,2023-09-21,706,sharpener,3,8,5,1,00269,India
717733,2023-09-21,714,carbon paper,15,30,15,1,00269,India
314134,2023-09-21,706,sharpener,3,8,5,1,00222,India
314134,2023-09-21,707,marker,20,40,20,1,00222,India
314134,2023-09-21,709,notebook,30,60,30,1,00222,India
870810,2023-09-21,703,eraser,1,3,2,1,00392,India
870810,2023-09-21,704,scale,5,10,5,1,00392,India
870810,2023-09-21,717,spiral bound book,50,100,50,1,00392,India
870810,2023-09-21,708,sketchpen,15,40,25,1,00392,India
738881,2023-09-21,703,eraser,1,3,2,1,00099,India
998372,2023-09-21,713,ball pen,5,10,5,1,00107,India
375762,2023-09-21,714,carbon paper,15,30,15,1,00106,India
836986,2023-09-21,703,eraser,1,3,2,1,00072,India
836986,2023-09-21,705,stencil,10,20,10,1,00072,India
836986,2023-09-21,712,graph paper,20,40,20,1,00072,India
836986,2023-09-21,710,geometry box,100,150,50,1,00072,India
607414,2023-09-21,701,gel pen,5,10,5,1,00295,India
875349,2023-09-21,703,eraser,1,3,2,1,00122,India
875349,2023-09-21,713,ball pen,5,10,5,1,00122,India
585544,2023-09-21,713,ball pen,5,10,5,1,00172,India
585544,2023-09-21,709,notebook,30,60,30,1,00172,India
683669,2023-09-21,701,gel pen,5,10,5,1,00020,India
683669,2023-09-21,716,printing paper,200,400,200,1,00020,India
713126,2023-09-21,715,folder,5,15,10,1,00297,India
713126,2023-09-21,709,notebook,30,60,30,1,00297,India
536602,2023-09-21,707,marker,20,40,20,1,00183,India
536602,2023-09-21,702,pencil,2,5,3,1,00183,India
536602,2023-09-21,712,graph paper,20,40,20,1,00183,India
536602,2023-09-21,714,carbon paper,15,30,15,1,00183,India
536602,2023-09-21,717,spiral bound book,50,100,50,1,00183,India
774991,2023-09-21,716,printing paper,200,400,200,1,00372,India
774991,2023-09-21,701,gel pen,5,10,5,1,00372,India
762078,2023-09-21,701,gel pen,5,10,5,1,00161,India
783952,2023-09-21,701,gel pen,5,10,5,1,00458,India
783952,2023-09-21,715,folder,5,15,10,1,00458,India
725679,2023-09-21,702,pencil,2,5,3,1,00329,India
725679,2023-09-21,705,stencil,10,20,10,1,00329,India
725679,2023-09-21,706,sharpener,3,8,5,1,00329,India
338431,2023-09-21,707,marker,20,40,20,1,00078,India
338431,2023-09-21,713,ball pen,5,10,5,1,00078,India
338431,2023-09-21,703,eraser,1,3,2,1,00078,India
577997,2023-09-21,714,carbon paper,15,30,15,1,00304,India
857411,2023-09-21,711,TD kit,150,300,150,1,00438,India
857411,2023-09-21,708,sketchpen,15,40,25,1,00438,India
857411,2023-09-21,702,pencil,2,5,3,1,00438,India
857411,2023-09-21,704,scale,5,10,5,1,00438,India
462033,2023-09-21,713,ball pen,5,10,5,1,00388,India
452738,2023-09-21,706,sharpener,3,8,5,1,00286,India
329617,2023-09-21,709,notebook,30,60,30,1,00445,India
329617,2023-09-21,713,ball pen,5,10,5,1,00445,India
329617,2023-09-21,702,pencil,2,5,3,1,00445,India
988029,2023-09-21,707,marker,20,40,20,1,00318,India
988029,2023-09-21,710,geometry box,100,150,50,1,00318,India
355246,2023-09-21,715,folder,5,15,10,1,00347,India
355246,2023-09-21,705,stencil,10,20,10,1,00347,India
355246,2023-09-21,704,scale,5,10,5,1,00347,India
355246,2023-09-21,701,gel pen,5,10,5,1,00347,India
883876,2023-09-21,707,marker,20,40,20,1,00373,India
883876,2023-09-21,701,gel pen,5,10,5,1,00373,India
883876,2023-09-21,717,spiral bound book,50,100,50,1,00373,India
883876,2023-09-21,708,sketchpen,15,40,25,1,00373,India
883876,2023-09-21,714,carbon paper,15,30,15,1,00373,India
936005,2023-09-21,711,TD kit,150,300,150,1,00259,India
936005,2023-09-21,703,eraser,1,3,2,1,00259,India
936005,2023-09-21,705,stencil,10,20,10,1,00259,India
849317,2023-09-21,708,sketchpen,15,40,25,1,00111,India
849317,2023-09-21,713,ball pen,5,10,5,1,00111,India
849317,2023-09-21,711,TD kit,150,300,150,1,00111,India
341808,2023-09-21,712,graph paper,20,40,20,1,00234,India
957679,2023-09-21,707,marker,20,40,20,1,00334,India
455911,2023-09-21,708,sketchpen,15,40,25,1,00209,India
455911,2023-09-21,712,graph paper,20,40,20,1,00209,India
455911,2023-09-21,703,eraser,1,3,2,1,00209,India
517285,2023-09-21,714,carbon paper,15,30,15,1,00428,India
517285,2023-09-21,717,spiral bound book,50,100,50,1,00428,India
816987,2023-09-21,712,graph paper,20,40,20,1,00360,India
816987,2023-09-21,709,notebook,30,60,30,1,00360,India
469868,2023-09-21,712,graph paper,20,40,20,1,00498,India
469868,2023-09-21,707,marker,20,40,20,1,00498,India
469868,2023-09-21,716,printing paper,200,400,200,1,00498,India
687870,2023-09-21,709,notebook,30,60,30,1,00411,India
687870,2023-09-21,715,folder,5,15,10,1,00411,India
687870,2023-09-21,704,scale,5,10,5,1,00411,India
381396,2023-09-21,714,carbon paper,15,30,15,1,00418,India
381396,2023-09-21,716,printing paper,200,400,200,1,00418,India
381396,2023-09-21,707,marker,20,40,20,1,00418,India
159828,2023-09-21,710,geometry box,100,150,50,1,00378,India
159828,2023-09-21,707,marker,20,40,20,1,00378,India
159828,2023-09-21,706,sharpener,3,8,5,1,00378,India
470780,2023-09-21,712,graph paper,20,40,20,1,00227,India
470780,2023-09-21,709,notebook,30,60,30,1,00227,India
470780,2023-09-21,701,gel pen,5,10,5,1,00227,India
470780,2023-09-21,708,sketchpen,15,40,25,1,00227,India
372709,2023-09-22,706,sharpener,3,8,5,1,00231,India
372709,2023-09-22,707,marker,20,40,20,1,00231,India
372709,2023-09-22,702,pencil,2,5,3,1,00231,India
372709,2023-09-22,712,graph paper,20,40,20,1,00231,India
453996,2023-09-22,714,carbon paper,15,30,15,1,00105,India
453996,2023-09-22,708,sketchpen,15,40,25,1,00105,India
453996,2023-09-22,709,notebook,30,60,30,1,00105,India
708566,2023-09-22,712,graph paper,20,40,20,1,00272,India
708566,2023-09-22,713,ball pen,5,10,5,1,00272,India
708566,2023-09-22,714,carbon paper,15,30,15,1,00272,India
899693,2023-09-22,712,graph paper,20,40,20,1,00312,India
560316,2023-09-22,711,TD kit,150,300,150,1,00262,India
560316,2023-09-22,708,sketchpen,15,40,25,1,00262,India
560316,2023-09-22,706,sharpener,3,8,5,1,00262,India
604191,2023-09-22,717,spiral bound book,50,100,50,1,00110,India
968900,2023-09-22,711,TD kit,150,300,150,1,00025,India
968900,2023-09-22,703,eraser,1,3,2,1,00025,India
857840,2023-09-22,701,gel pen,5,10,5,1,00499,India
857840,2023-09-22,709,notebook,30,60,30,1,00499,India
857840,2023-09-22,712,graph paper,20,40,20,1,00499,India
107932,2023-09-22,704,scale,5,10,5,1,00412,India
752644,2023-09-22,714,carbon paper,15,30,15,1,00114,India
752644,2023-09-22,715,folder,5,15,10,1,00114,India
752644,2023-09-22,708,sketchpen,15,40,25,1,00114,India
752644,2023-09-22,711,TD kit,150,300,150,1,00114,India
300688,2023-09-22,716,printing paper,200,400,200,1,00484,India
300688,2023-09-22,709,notebook,30,60,30,1,00484,India
218666,2023-09-22,703,eraser,1,3,2,1,00389,India
218666,2023-09-22,711,TD kit,150,300,150,1,00389,India
218666,2023-09-22,701,gel pen,5,10,5,1,00389,India
218666,2023-09-22,716,printing paper,200,400,200,1,00389,India
321731,2023-09-22,712,graph paper,20,40,20,1,00032,India
321731,2023-09-22,714,carbon paper,15,30,15,1,00032,India
321731,2023-09-22,703,eraser,1,3,2,1,00032,India
384821,2023-09-22,705,stencil,10,20,10,1,00287,India
384821,2023-09-22,704,scale,5,10,5,1,00287,India
384821,2023-09-22,709,notebook,30,60,30,1,00287,India
384821,2023-09-22,702,pencil,2,5,3,1,00287,India
704841,2023-09-22,717,spiral bound book,50,100,50,1,00128,India
704841,2023-09-22,715,folder,5,15,10,1,00128,India
704841,2023-09-22,716,printing paper,200,400,200,1,00128,India
704841,2023-09-22,711,TD kit,150,300,150,1,00128,India
704841,2023-09-22,703,eraser,1,3,2,1,00128,India
315706,2023-09-22,711,TD kit,150,300,150,1,00079,India
315706,2023-09-22,703,eraser,1,3,2,1,00079,India
315706,2023-09-22,710,geometry box,100,150,50,1,00079,India
315706,2023-09-22,712,graph paper,20,40,20,1,00079,India
398339,2023-09-22,701,gel pen,5,10,5,1,00477,India
188279,2023-09-22,705,stencil,10,20,10,1,00283,India
188279,2023-09-22,715,folder,5,15,10,1,00283,India
188279,2023-09-22,703,eraser,1,3,2,1,00283,India
758694,2023-09-22,703,eraser,1,3,2,1,00212,India
885056,2023-09-22,710,geometry box,100,150,50,1,00282,India
408031,2023-09-22,714,carbon paper,15,30,15,1,00024,India
408031,2023-09-22,706,sharpener,3,8,5,1,00024,India
408031,2023-09-22,705,stencil,10,20,10,1,00024,India
408031,2023-09-22,712,graph paper,20,40,20,1,00024,India
418193,2023-09-22,712,graph paper,20,40,20,1,00338,India
418193,2023-09-22,701,gel pen,5,10,5,1,00338,India
418193,2023-09-22,702,pencil,2,5,3,1,00338,India
828094,2023-09-22,712,graph paper,20,40,20,1,00332,India
254722,2023-09-22,709,notebook,30,60,30,1,00293,India
254722,2023-09-22,704,scale,5,10,5,1,00293,India
254722,2023-09-22,708,sketchpen,15,40,25,1,00293,India
254722,2023-09-22,701,gel pen,5,10,5,1,00293,India
254722,2023-09-22,706,sharpener,3,8,5,1,00293,India
657261,2023-09-22,717,spiral bound book,50,100,50,1,00105,India
657261,2023-09-22,715,folder,5,15,10,1,00105,India
122220,2023-09-22,715,folder,5,15,10,1,00148,India
122220,2023-09-22,712,graph paper,20,40,20,1,00148,India
122220,2023-09-22,701,gel pen,5,10,5,1,00148,India
122220,2023-09-22,705,stencil,10,20,10,1,00148,India
382944,2023-09-22,715,folder,5,15,10,1,00094,India
382944,2023-09-22,710,geometry box,100,150,50,1,00094,India
382944,2023-09-22,706,sharpener,3,8,5,1,00094,India
382944,2023-09-22,708,sketchpen,15,40,25,1,00094,India
382944,2023-09-22,717,spiral bound book,50,100,50,1,00094,India
953018,2023-09-22,706,sharpener,3,8,5,1,00198,India
953018,2023-09-22,715,folder,5,15,10,1,00198,India
953018,2023-09-22,707,marker,20,40,20,1,00198,India
953018,2023-09-22,714,carbon paper,15,30,15,1,00198,India
953018,2023-09-22,708,sketchpen,15,40,25,1,00198,India
592389,2023-09-22,707,marker,20,40,20,1,00142,India
592389,2023-09-22,701,gel pen,5,10,5,1,00142,India
592389,2023-09-22,712,graph paper,20,40,20,1,00142,India
592389,2023-09-22,708,sketchpen,15,40,25,1,00142,India
592389,2023-09-22,704,scale,5,10,5,1,00142,India
934681,2023-09-22,706,sharpener,3,8,5,1,00364,India
934681,2023-09-22,717,spiral bound book,50,100,50,1,00364,India
934681,2023-09-22,712,graph paper,20,40,20,1,00364,India
934681,2023-09-22,716,printing paper,200,400,200,1,00364,India
290755,2023-09-22,701,gel pen,5,10,5,1,00210,India
223033,2023-09-22,710,geometry box,100,150,50,1,00004,India
223033,2023-09-22,717,spiral bound book,50,100,50,1,00004,India
223033,2023-09-22,716,printing paper,200,400,200,1,00004,India
223033,2023-09-22,712,graph paper,20,40,20,1,00004,India
166977,2023-09-22,709,notebook,30,60,30,1,00322,India
166977,2023-09-22,702,pencil,2,5,3,1,00322,India
166977,2023-09-22,710,geometry box,100,150,50,1,00322,India
690077,2023-09-22,715,folder,5,15,10,1,00376,India
476767,2023-09-22,715,folder,5,15,10,1,00306,India
476767,2023-09-22,716,printing paper,200,400,200,1,00306,India
476767,2023-09-22,712,graph paper,20,40,20,1,00306,India
476767,2023-09-22,711,TD kit,150,300,150,1,00306,India
476767,2023-09-22,708,sketchpen,15,40,25,1,00306,India
490335,2023-09-22,717,spiral bound book,50,100,50,1,00130,India
490335,2023-09-22,713,ball pen,5,10,5,1,00130,India
388151,2023-09-22,702,pencil,2,5,3,1,00376,India
388151,2023-09-22,704,scale,5,10,5,1,00376,India
388151,2023-09-22,709,notebook,30,60,30,1,00376,India
388151,2023-09-22,714,carbon paper,15,30,15,1,00376,India
388151,2023-09-22,705,stencil,10,20,10,1,00376,India
899064,2023-09-22,706,sharpener,3,8,5,1,00271,India
899064,2023-09-22,708,sketchpen,15,40,25,1,00271,India
899064,2023-09-22,701,gel pen,5,10,5,1,00271,India
866957,2023-09-22,712,graph paper,20,40,20,1,00397,India
866957,2023-09-22,714,carbon paper,15,30,15,1,00397,India
637069,2023-09-22,717,spiral bound book,50,100,50,1,00446,India
637069,2023-09-22,711,TD kit,150,300,150,1,00446,India
637069,2023-09-22,710,geometry box,100,150,50,1,00446,India
849242,2023-09-22,702,pencil,2,5,3,1,00491,India
981734,2023-09-22,708,sketchpen,15,40,25,1,00423,India
981734,2023-09-22,707,marker,20,40,20,1,00423,India
981734,2023-09-22,706,sharpener,3,8,5,1,00423,India
981734,2023-09-22,704,scale,5,10,5,1,00423,India
470145,2023-09-22,706,sharpener,3,8,5,1,00124,India
504677,2023-09-22,703,eraser,1,3,2,1,00188,India
504677,2023-09-22,716,printing paper,200,400,200,1,00188,India
504677,2023-09-22,712,graph paper,20,40,20,1,00188,India
504677,2023-09-22,710,geometry box,100,150,50,1,00188,India
133291,2023-09-22,702,pencil,2,5,3,1,00478,India
133291,2023-09-22,716,printing paper,200,400,200,1,00478,India
133291,2023-09-22,706,sharpener,3,8,5,1,00478,India
133291,2023-09-22,711,TD kit,150,300,150,1,00478,India
133291,2023-09-22,703,eraser,1,3,2,1,00478,India
952781,2023-09-23,711,TD kit,150,300,150,1,00160,India
952781,2023-09-23,709,notebook,30,60,30,1,00160,India
104032,2023-09-23,716,printing paper,200,400,200,1,00169,India
104032,2023-09-23,702,pencil,2,5,3,1,00169,India
740062,2023-09-23,717,spiral bound book,50,100,50,1,00489,India
740062,2023-09-23,712,graph paper,20,40,20,1,00489,India
372301,2023-09-23,713,ball pen,5,10,5,1,00277,India
372301,2023-09-23,712,graph paper,20,40,20,1,00277,India
372301,2023-09-23,702,pencil,2,5,3,1,00277,India
372301,2023-09-23,714,carbon paper,15,30,15,1,00277,India
306473,2023-09-23,716,printing paper,200,400,200,1,00320,India
306473,2023-09-23,703,eraser,1,3,2,1,00320,India
306473,2023-09-23,710,geometry box,100,150,50,1,00320,India
306473,2023-09-23,705,stencil,10,20,10,1,00320,India
292010,2023-09-23,706,sharpener,3,8,5,1,00162,India
292010,2023-09-23,709,notebook,30,60,30,1,00162,India
292010,2023-09-23,711,TD kit,150,300,150,1,00162,India
292010,2023-09-23,703,eraser,1,3,2,1,00162,India
430632,2023-09-23,703,eraser,1,3,2,1,00496,India
430632,2023-09-23,713,ball pen,5,10,5,1,00496,India
939002,2023-09-23,715,folder,5,15,10,1,00252,India
939002,2023-09-23,708,sketchpen,15,40,25,1,00252,India
939002,2023-09-23,712,graph paper,20,40,20,1,00252,India
329731,2023-09-23,713,ball pen,5,10,5,1,00063,India
329731,2023-09-23,709,notebook,30,60,30,1,00063,India
777315,2023-09-23,703,eraser,1,3,2,1,00269,India
777315,2023-09-23,716,printing paper,200,400,200,1,00269,India
777315,2023-09-23,713,ball pen,5,10,5,1,00269,India
777315,2023-09-23,706,sharpener,3,8,5,1,00269,India
777315,2023-09-23,704,scale,5,10,5,1,00269,India
911791,2023-09-23,713,ball pen,5,10,5,1,00275,India
911791,2023-09-23,711,TD kit,150,300,150,1,00275,India
911791,2023-09-23,705,stencil,10,20,10,1,00275,India
911791,2023-09-23,717,spiral bound book,50,100,50,1,00275,India
725700,2023-09-23,708,sketchpen,15,40,25,1,00078,India
725700,2023-09-23,703,eraser,1,3,2,1,00078,India
725700,2023-09-23,711,TD kit,150,300,150,1,00078,India
754149,2023-09-23,713,ball pen,5,10,5,1,00371,India
754149,2023-09-23,701,gel pen,5,10,5,1,00371,India
754149,2023-09-23,703,eraser,1,3,2,1,00371,India
754149,2023-09-23,712,graph paper,20,40,20,1,00371,India
117738,2023-09-23,711,TD kit,150,300,150,1,00054,India
590130,2023-09-23,717,spiral bound book,50,100,50,1,00367,India
590130,2023-09-23,708,sketchpen,15,40,25,1,00367,India
590130,2023-09-23,711,TD kit,150,300,150,1,00367,India
590130,2023-09-23,715,folder,5,15,10,1,00367,India
362688,2023-09-23,709,notebook,30,60,30,1,00040,India
362688,2023-09-23,703,eraser,1,3,2,1,00040,India
362688,2023-09-23,716,printing paper,200,400,200,1,00040,India
651023,2023-09-23,716,printing paper,200,400,200,1,00092,India
651023,2023-09-23,714,carbon paper,15,30,15,1,00092,India
651023,2023-09-23,713,ball pen,5,10,5,1,00092,India
599412,2023-09-23,708,sketchpen,15,40,25,1,00227,India
599412,2023-09-23,713,ball pen,5,10,5,1,00227,India
599412,2023-09-23,715,folder,5,15,10,1,00227,India
207760,2023-09-23,709,notebook,30,60,30,1,00043,India
207760,2023-09-23,704,scale,5,10,5,1,00043,India
207760,2023-09-23,702,pencil,2,5,3,1,00043,India
207760,2023-09-23,711,TD kit,150,300,150,1,00043,India
605949,2023-09-23,704,scale,5,10,5,1,00472,India
605949,2023-09-23,702,pencil,2,5,3,1,00472,India
605949,2023-09-23,705,stencil,10,20,10,1,00472,India
647823,2023-09-23,704,scale,5,10,5,1,00137,India
949189,2023-09-23,715,folder,5,15,10,1,00370,India
949189,2023-09-23,716,printing paper,200,400,200,1,00370,India
949189,2023-09-23,701,gel pen,5,10,5,1,00370,India
830824,2023-09-23,716,printing paper,200,400,200,1,00144,India
830824,2023-09-23,715,folder,5,15,10,1,00144,India
853290,2023-09-23,710,geometry box,100,150,50,1,00052,India
853290,2023-09-23,707,marker,20,40,20,1,00052,India
853290,2023-09-23,711,TD kit,150,300,150,1,00052,India
152694,2023-09-23,705,stencil,10,20,10,1,00092,India
152694,2023-09-23,715,folder,5,15,10,1,00092,India
152694,2023-09-23,704,scale,5,10,5,1,00092,India
152694,2023-09-23,713,ball pen,5,10,5,1,00092,India
152694,2023-09-23,708,sketchpen,15,40,25,1,00092,India
311518,2023-09-23,715,folder,5,15,10,1,00467,India
311518,2023-09-23,712,graph paper,20,40,20,1,00467,India
311518,2023-09-23,704,scale,5,10,5,1,00467,India
311518,2023-09-23,711,TD kit,150,300,150,1,00467,India
594512,2023-09-23,710,geometry box,100,150,50,1,00235,India
594512,2023-09-23,705,stencil,10,20,10,1,00235,India
594512,2023-09-23,712,graph paper,20,40,20,1,00235,India
594512,2023-09-23,701,gel pen,5,10,5,1,00235,India
415660,2023-09-23,709,notebook,30,60,30,1,00351,India
415660,2023-09-23,711,TD kit,150,300,150,1,00351,India
415660,2023-09-23,715,folder,5,15,10,1,00351,India
485367,2023-09-23,714,carbon paper,15,30,15,1,00090,India
485367,2023-09-23,701,gel pen,5,10,5,1,00090,India
543452,2023-09-23,712,graph paper,20,40,20,1,00495,India
543452,2023-09-23,711,TD kit,150,300,150,1,00495,India
543452,2023-09-23,716,printing paper,200,400,200,1,00495,India
543452,2023-09-23,702,pencil,2,5,3,1,00495,India
729105,2023-09-23,704,scale,5,10,5,1,00304,India
618326,2023-09-23,708,sketchpen,15,40,25,1,00393,India
618326,2023-09-23,716,printing paper,200,400,200,1,00393,India
618326,2023-09-23,709,notebook,30,60,30,1,00393,India
618326,2023-09-23,710,geometry box,100,150,50,1,00393,India
646459,2023-09-23,705,stencil,10,20,10,1,00009,India
646459,2023-09-23,704,scale,5,10,5,1,00009,India
646459,2023-09-23,709,notebook,30,60,30,1,00009,India
646459,2023-09-23,715,folder,5,15,10,1,00009,India
124528,2023-09-23,708,sketchpen,15,40,25,1,00228,India
124528,2023-09-23,701,gel pen,5,10,5,1,00228,India
124528,2023-09-23,710,geometry box,100,150,50,1,00228,India
124528,2023-09-23,716,printing paper,200,400,200,1,00228,India
124528,2023-09-23,715,folder,5,15,10,1,00228,India
639337,2023-09-23,709,notebook,30,60,30,1,00197,India
639337,2023-09-23,706,sharpener,3,8,5,1,00197,India
893103,2023-09-23,714,carbon paper,15,30,15,1,00033,India
893103,2023-09-23,716,printing paper,200,400,200,1,00033,India
893103,2023-09-23,705,stencil,10,20,10,1,00033,India
893103,2023-09-23,710,geometry box,100,150,50,1,00033,India
676205,2023-09-23,703,eraser,1,3,2,1,00474,India
676205,2023-09-23,705,stencil,10,20,10,1,00474,India
687933,2023-09-23,707,marker,20,40,20,1,00388,India
523309,2023-09-23,704,scale,5,10,5,1,00479,India
523309,2023-09-23,713,ball pen,5,10,5,1,00479,India
380185,2023-09-23,701,gel pen,5,10,5,1,00472,India
380185,2023-09-23,709,notebook,30,60,30,1,00472,India
380185,2023-09-23,702,pencil,2,5,3,1,00472,India
314045,2023-09-23,710,geometry box,100,150,50,1,00404,India
314045,2023-09-23,709,notebook,30,60,30,1,00404,India
969278,2023-09-24,714,carbon paper,15,30,15,1,00357,India
969278,2023-09-24,708,sketchpen,15,40,25,1,00357,India
969278,2023-09-24,716,printing paper,200,400,200,1,00357,India
969278,2023-09-24,703,eraser,1,3,2,1,00357,India
969278,2023-09-24,710,geometry box,100,150,50,1,00357,India
946426,2023-09-24,706,sharpener,3,8,5,1,00289,India
946426,2023-09-24,714,carbon paper,15,30,15,1,00289,India
946426,2023-09-24,705,stencil,10,20,10,1,00289,India
946426,2023-09-24,716,printing paper,200,400,200,1,00289,India
775513,2023-09-24,715,folder,5,15,10,1,00401,India
775513,2023-09-24,704,scale,5,10,5,1,00401,India
615134,2023-09-24,706,sharpener,3,8,5,1,00016,India
615134,2023-09-24,703,eraser,1,3,2,1,00016,India
615134,2023-09-24,709,notebook,30,60,30,1,00016,India
615134,2023-09-24,707,marker,20,40,20,1,00016,India
615134,2023-09-24,717,spiral bound book,50,100,50,1,00016,India
855818,2023-09-24,707,marker,20,40,20,1,00262,India
855818,2023-09-24,709,notebook,30,60,30,1,00262,India
855818,2023-09-24,712,graph paper,20,40,20,1,00262,India
865538,2023-09-24,710,geometry box,100,150,50,1,00233,India
381100,2023-09-24,702,pencil,2,5,3,1,00425,India
381100,2023-09-24,707,marker,20,40,20,1,00425,India
381100,2023-09-24,708,sketchpen,15,40,25,1,00425,India
180818,2023-09-24,704,scale,5,10,5,1,00069,India
180818,2023-09-24,711,TD kit,150,300,150,1,00069,India
180818,2023-09-24,714,carbon paper,15,30,15,1,00069,India
988814,2023-09-24,711,TD kit,150,300,150,1,00311,India
988814,2023-09-24,710,geometry box,100,150,50,1,00311,India
988814,2023-09-24,709,notebook,30,60,30,1,00311,India
875705,2023-09-24,703,eraser,1,3,2,1,00102,India
875705,2023-09-24,701,gel pen,5,10,5,1,00102,India
875705,2023-09-24,707,marker,20,40,20,1,00102,India
875705,2023-09-24,706,sharpener,3,8,5,1,00102,India
761090,2023-09-24,710,geometry box,100,150,50,1,00265,India
761090,2023-09-24,702,pencil,2,5,3,1,00265,India
761090,2023-09-24,714,carbon paper,15,30,15,1,00265,India
761090,2023-09-24,708,sketchpen,15,40,25,1,00265,India
543183,2023-09-24,715,folder,5,15,10,1,00408,India
543183,2023-09-24,710,geometry box,100,150,50,1,00408,India
370804,2023-09-24,705,stencil,10,20,10,1,00485,India
370804,2023-09-24,715,folder,5,15,10,1,00485,India
831654,2023-09-24,706,sharpener,3,8,5,1,00018,India
831654,2023-09-24,709,notebook,30,60,30,1,00018,India
549668,2023-09-24,711,TD kit,150,300,150,1,00315,India
798090,2023-09-24,703,eraser,1,3,2,1,00451,India
537340,2023-09-24,701,gel pen,5,10,5,1,00404,India
537340,2023-09-24,708,sketchpen,15,40,25,1,00404,India
537340,2023-09-24,713,ball pen,5,10,5,1,00404,India
537340,2023-09-24,702,pencil,2,5,3,1,00404,India
532429,2023-09-24,708,sketchpen,15,40,25,1,00023,India
532429,2023-09-24,717,spiral bound book,50,100,50,1,00023,India
532429,2023-09-24,707,marker,20,40,20,1,00023,India
404147,2023-09-24,709,notebook,30,60,30,1,00426,India
404147,2023-09-24,711,TD kit,150,300,150,1,00426,India
404147,2023-09-24,712,graph paper,20,40,20,1,00426,India
508807,2023-09-24,707,marker,20,40,20,1,00047,India
388425,2023-09-24,707,marker,20,40,20,1,00474,India
388425,2023-09-24,716,printing paper,200,400,200,1,00474,India
277672,2023-09-24,702,pencil,2,5,3,1,00265,India
277672,2023-09-24,708,sketchpen,15,40,25,1,00265,India
277672,2023-09-24,704,scale,5,10,5,1,00265,India
277672,2023-09-24,709,notebook,30,60,30,1,00265,India
277672,2023-09-24,707,marker,20,40,20,1,00265,India
542395,2023-09-24,711,TD kit,150,300,150,1,00271,India
542395,2023-09-24,701,gel pen,5,10,5,1,00271,India
542395,2023-09-24,716,printing paper,200,400,200,1,00271,India
542395,2023-09-24,703,eraser,1,3,2,1,00271,India
570637,2023-09-24,711,TD kit,150,300,150,1,00383,India
570637,2023-09-24,705,stencil,10,20,10,1,00383,India
570637,2023-09-24,702,pencil,2,5,3,1,00383,India
570637,2023-09-24,703,eraser,1,3,2,1,00383,India
827382,2023-09-24,708,sketchpen,15,40,25,1,00202,India
827382,2023-09-24,712,graph paper,20,40,20,1,00202,India
827382,2023-09-24,710,geometry box,100,150,50,1,00202,India
827382,2023-09-24,715,folder,5,15,10,1,00202,India
290949,2023-09-24,709,notebook,30,60,30,1,00471,India
290949,2023-09-24,714,carbon paper,15,30,15,1,00471,India
290949,2023-09-24,706,sharpener,3,8,5,1,00471,India
268800,2023-09-24,706,sharpener,3,8,5,1,00117,India
268800,2023-09-24,710,geometry box,100,150,50,1,00117,India
268800,2023-09-24,701,gel pen,5,10,5,1,00117,India
873299,2023-09-24,712,graph paper,20,40,20,1,00411,India
873299,2023-09-24,711,TD kit,150,300,150,1,00411,India
159118,2023-09-24,712,graph paper,20,40,20,1,00214,India
159118,2023-09-24,716,printing paper,200,400,200,1,00214,India
159118,2023-09-24,711,TD kit,150,300,150,1,00214,India
907540,2023-09-24,702,pencil,2,5,3,1,00304,India
907540,2023-09-24,705,stencil,10,20,10,1,00304,India
907540,2023-09-24,712,graph paper,20,40,20,1,00304,India
106461,2023-09-24,703,eraser,1,3,2,1,00486,India
106461,2023-09-24,716,printing paper,200,400,200,1,00486,India
106461,2023-09-24,710,geometry box,100,150,50,1,00486,India
289679,2023-09-24,712,graph paper,20,40,20,1,00496,India
289679,2023-09-24,709,notebook,30,60,30,1,00496,India
364581,2023-09-24,701,gel pen,5,10,5,1,00139,India
364581,2023-09-24,707,marker,20,40,20,1,00139,India
364581,2023-09-24,702,pencil,2,5,3,1,00139,India
286321,2023-09-24,708,sketchpen,15,40,25,1,00359,India
286321,2023-09-24,705,stencil,10,20,10,1,00359,India
286321,2023-09-24,707,marker,20,40,20,1,00359,India
286321,2023-09-24,701,gel pen,5,10,5,1,00359,India
286321,2023-09-24,710,geometry box,100,150,50,1,00359,India
109255,2023-09-24,709,notebook,30,60,30,1,00386,India
898225,2023-09-24,713,ball pen,5,10,5,1,00266,India
898225,2023-09-24,701,gel pen,5,10,5,1,00266,India
163494,2023-09-24,715,folder,5,15,10,1,00343,India
163494,2023-09-24,701,gel pen,5,10,5,1,00343,India
163494,2023-09-24,711,TD kit,150,300,150,1,00343,India
163494,2023-09-24,706,sharpener,3,8,5,1,00343,India
892519,2023-09-24,712,graph paper,20,40,20,1,00486,India
892519,2023-09-24,716,printing paper,200,400,200,1,00486,India
892519,2023-09-24,702,pencil,2,5,3,1,00486,India
892519,2023-09-24,711,TD kit,150,300,150,1,00486,India
549815,2023-09-24,709,notebook,30,60,30,1,00011,India
549815,2023-09-24,701,gel pen,5,10,5,1,00011,India
549815,2023-09-24,703,eraser,1,3,2,1,00011,India
549815,2023-09-24,712,graph paper,20,40,20,1,00011,India
881387,2023-09-24,709,notebook,30,60,30,1,00112,India
881387,2023-09-24,705,stencil,10,20,10,1,00112,India
881387,2023-09-24,712,graph paper,20,40,20,1,00112,India
881387,2023-09-24,714,carbon paper,15,30,15,1,00112,India
701357,2023-09-24,706,sharpener,3,8,5,1,00372,India
701357,2023-09-24,714,carbon paper,15,30,15,1,00372,India
701357,2023-09-24,703,eraser,1,3,2,1,00372,India
701357,2023-09-24,713,ball pen,5,10,5,1,00372,India
689868,2023-09-24,711,TD kit,150,300,150,1,00386,India
689868,2023-09-24,714,carbon paper,15,30,15,1,00386,India
689868,2023-09-24,703,eraser,1,3,2,1,00386,India
174562,2023-09-24,711,TD kit,150,300,150,1,00009,India
174562,2023-09-24,706,sharpener,3,8,5,1,00009,India
600830,2023-09-24,704,scale,5,10,5,1,00356,India
689316,2023-09-24,715,folder,5,15,10,1,00334,India
823613,2023-09-24,715,folder,5,15,10,1,00159,India
101298,2023-09-25,717,spiral bound book,50,100,50,1,00194,India
101298,2023-09-25,703,eraser,1,3,2,1,00194,India
966763,2023-09-25,706,sharpener,3,8,5,1,00223,India
966763,2023-09-25,715,folder,5,15,10,1,00223,India
966763,2023-09-25,714,carbon paper,15,30,15,1,00223,India
865898,2023-09-25,707,marker,20,40,20,1,00148,India
271123,2023-09-25,715,folder,5,15,10,1,00394,India
610871,2023-09-25,714,carbon paper,15,30,15,1,00498,India
610871,2023-09-25,707,marker,20,40,20,1,00498,India
610871,2023-09-25,709,notebook,30,60,30,1,00498,India
281240,2023-09-25,712,graph paper,20,40,20,1,00189,India
281240,2023-09-25,705,stencil,10,20,10,1,00189,India
422233,2023-09-25,715,folder,5,15,10,1,00099,India
422233,2023-09-25,707,marker,20,40,20,1,00099,India
422233,2023-09-25,716,printing paper,200,400,200,1,00099,India
422233,2023-09-25,714,carbon paper,15,30,15,1,00099,India
216270,2023-09-25,708,sketchpen,15,40,25,1,00353,India
936676,2023-09-25,709,notebook,30,60,30,1,00095,India
686716,2023-09-25,714,carbon paper,15,30,15,1,00212,India
686716,2023-09-25,717,spiral bound book,50,100,50,1,00212,India
309976,2023-09-25,709,notebook,30,60,30,1,00400,India
309976,2023-09-25,704,scale,5,10,5,1,00400,India
309976,2023-09-25,706,sharpener,3,8,5,1,00400,India
309976,2023-09-25,710,geometry box,100,150,50,1,00400,India
957271,2023-09-25,706,sharpener,3,8,5,1,00104,India
957271,2023-09-25,712,graph paper,20,40,20,1,00104,India
957271,2023-09-25,710,geometry box,100,150,50,1,00104,India
957271,2023-09-25,703,eraser,1,3,2,1,00104,India
957271,2023-09-25,707,marker,20,40,20,1,00104,India
646978,2023-09-25,705,stencil,10,20,10,1,00250,India
646978,2023-09-25,706,sharpener,3,8,5,1,00250,India
646978,2023-09-25,703,eraser,1,3,2,1,00250,India
646978,2023-09-25,714,carbon paper,15,30,15,1,00250,India
226820,2023-09-25,709,notebook,30,60,30,1,00089,India
226820,2023-09-25,717,spiral bound book,50,100,50,1,00089,India
645421,2023-09-25,706,sharpener,3,8,5,1,00212,India
429850,2023-09-25,707,marker,20,40,20,1,00173,India
429850,2023-09-25,716,printing paper,200,400,200,1,00173,India
180749,2023-09-25,715,folder,5,15,10,1,00059,India
180749,2023-09-25,701,gel pen,5,10,5,1,00059,India
199262,2023-09-25,704,scale,5,10,5,1,00283,India
199262,2023-09-25,713,ball pen,5,10,5,1,00283,India
714547,2023-09-25,713,ball pen,5,10,5,1,00379,India
851522,2023-09-25,707,marker,20,40,20,1,00082,India
851522,2023-09-25,711,TD kit,150,300,150,1,00082,India
851522,2023-09-25,710,geometry box,100,150,50,1,00082,India
851522,2023-09-25,704,scale,5,10,5,1,00082,India
851522,2023-09-25,706,sharpener,3,8,5,1,00082,India
921659,2023-09-25,705,stencil,10,20,10,1,00075,India
471923,2023-09-25,706,sharpener,3,8,5,1,00468,India
471923,2023-09-25,704,scale,5,10,5,1,00468,India
471923,2023-09-25,708,sketchpen,15,40,25,1,00468,India
471923,2023-09-25,712,graph paper,20,40,20,1,00468,India
471923,2023-09-25,703,eraser,1,3,2,1,00468,India
578670,2023-09-25,708,sketchpen,15,40,25,1,00359,India
578670,2023-09-25,709,notebook,30,60,30,1,00359,India
786274,2023-09-25,704,scale,5,10,5,1,00078,India
786274,2023-09-25,707,marker,20,40,20,1,00078,India
786274,2023-09-25,706,sharpener,3,8,5,1,00078,India
786274,2023-09-25,711,TD kit,150,300,150,1,00078,India
457883,2023-09-25,707,marker,20,40,20,1,00169,India
457883,2023-09-25,706,sharpener,3,8,5,1,00169,India
457883,2023-09-25,716,printing paper,200,400,200,1,00169,India
457883,2023-09-25,715,folder,5,15,10,1,00169,India
824918,2023-09-25,710,geometry box,100,150,50,1,00371,India
824918,2023-09-25,717,spiral bound book,50,100,50,1,00371,India
824918,2023-09-25,713,ball pen,5,10,5,1,00371,India
564676,2023-09-25,705,stencil,10,20,10,1,00184,India
564676,2023-09-25,701,gel pen,5,10,5,1,00184,India
564676,2023-09-25,716,printing paper,200,400,200,1,00184,India
564676,2023-09-25,713,ball pen,5,10,5,1,00184,India
763107,2023-09-25,708,sketchpen,15,40,25,1,00027,India
763107,2023-09-25,712,graph paper,20,40,20,1,00027,India
763107,2023-09-25,709,notebook,30,60,30,1,00027,India
472524,2023-09-25,707,marker,20,40,20,1,00305,India
827131,2023-09-25,713,ball pen,5,10,5,1,00201,India
827131,2023-09-25,717,spiral bound book,50,100,50,1,00201,India
827131,2023-09-25,706,sharpener,3,8,5,1,00201,India
638376,2023-09-25,702,pencil,2,5,3,1,00191,India
638376,2023-09-25,706,sharpener,3,8,5,1,00191,India
818676,2023-09-25,711,TD kit,150,300,150,1,00191,India
752498,2023-09-25,701,gel pen,5,10,5,1,00066,India
136147,2023-09-25,709,notebook,30,60,30,1,00253,India
136147,2023-09-25,702,pencil,2,5,3,1,00253,India
136147,2023-09-25,707,marker,20,40,20,1,00253,India
136147,2023-09-25,706,sharpener,3,8,5,1,00253,India
136147,2023-09-25,703,eraser,1,3,2,1,00253,India
398192,2023-09-25,705,stencil,10,20,10,1,00160,India
398192,2023-09-25,715,folder,5,15,10,1,00160,India
537664,2023-09-25,706,sharpener,3,8,5,1,00459,India
638144,2023-09-25,716,printing paper,200,400,200,1,00419,India
638144,2023-09-25,717,spiral bound book,50,100,50,1,00419,India
625717,2023-09-25,709,notebook,30,60,30,1,00268,India
126904,2023-09-25,709,notebook,30,60,30,1,00028,India
126904,2023-09-25,715,folder,5,15,10,1,00028,India
126904,2023-09-25,713,ball pen,5,10,5,1,00028,India
126904,2023-09-25,712,graph paper,20,40,20,1,00028,India
126904,2023-09-25,708,sketchpen,15,40,25,1,00028,India
295723,2023-09-26,703,eraser,1,3,2,1,00294,India
295723,2023-09-26,715,folder,5,15,10,1,00294,India
295723,2023-09-26,704,scale,5,10,5,1,00294,India
295723,2023-09-26,702,pencil,2,5,3,1,00294,India
182323,2023-09-26,708,sketchpen,15,40,25,1,00099,India
182323,2023-09-26,707,marker,20,40,20,1,00099,India
158823,2023-09-26,711,TD kit,150,300,150,1,00250,India
158823,2023-09-26,706,sharpener,3,8,5,1,00250,India
158823,2023-09-26,703,eraser,1,3,2,1,00250,India
158823,2023-09-26,710,geometry box,100,150,50,1,00250,India
148685,2023-09-26,714,carbon paper,15,30,15,1,00391,India
148685,2023-09-26,716,printing paper,200,400,200,1,00391,India
148685,2023-09-26,713,ball pen,5,10,5,1,00391,India
148685,2023-09-26,708,sketchpen,15,40,25,1,00391,India
148685,2023-09-26,702,pencil,2,5,3,1,00391,India
948139,2023-09-26,701,gel pen,5,10,5,1,00420,India
948139,2023-09-26,706,sharpener,3,8,5,1,00420,India
948139,2023-09-26,712,graph paper,20,40,20,1,00420,India
948139,2023-09-26,710,geometry box,100,150,50,1,00420,India
948139,2023-09-26,705,stencil,10,20,10,1,00420,India
158906,2023-09-26,714,carbon paper,15,30,15,1,00102,India
158906,2023-09-26,707,marker,20,40,20,1,00102,India
158906,2023-09-26,712,graph paper,20,40,20,1,00102,India
919626,2023-09-26,708,sketchpen,15,40,25,1,00168,India
919626,2023-09-26,716,printing paper,200,400,200,1,00168,India
919626,2023-09-26,701,gel pen,5,10,5,1,00168,India
919626,2023-09-26,702,pencil,2,5,3,1,00168,India
653942,2023-09-26,709,notebook,30,60,30,1,00154,India
653942,2023-09-26,708,sketchpen,15,40,25,1,00154,India
295987,2023-09-26,701,gel pen,5,10,5,1,00160,India
295987,2023-09-26,716,printing paper,200,400,200,1,00160,India
295987,2023-09-26,712,graph paper,20,40,20,1,00160,India
227983,2023-09-26,713,ball pen,5,10,5,1,00297,India
227983,2023-09-26,703,eraser,1,3,2,1,00297,India
227983,2023-09-26,710,geometry box,100,150,50,1,00297,India
227983,2023-09-26,716,printing paper,200,400,200,1,00297,India
230111,2023-09-26,702,pencil,2,5,3,1,00231,India
230111,2023-09-26,705,stencil,10,20,10,1,00231,India
230111,2023-09-26,701,gel pen,5,10,5,1,00231,India
230111,2023-09-26,717,spiral bound book,50,100,50,1,00231,India
230111,2023-09-26,710,geometry box,100,150,50,1,00231,India
344319,2023-09-26,714,carbon paper,15,30,15,1,00407,India
561777,2023-09-26,709,notebook,30,60,30,1,00341,India
561777,2023-09-26,706,sharpener,3,8,5,1,00341,India
561777,2023-09-26,714,carbon paper,15,30,15,1,00341,India
561777,2023-09-26,713,ball pen,5,10,5,1,00341,India
182745,2023-09-26,707,marker,20,40,20,1,00146,India
182745,2023-09-26,713,ball pen,5,10,5,1,00146,India
182745,2023-09-26,709,notebook,30,60,30,1,00146,India
672225,2023-09-26,707,marker,20,40,20,1,00287,India
672225,2023-09-26,705,stencil,10,20,10,1,00287,India
672225,2023-09-26,708,sketchpen,15,40,25,1,00287,India
129585,2023-09-26,716,printing paper,200,400,200,1,00327,India
129585,2023-09-26,708,sketchpen,15,40,25,1,00327,India
129585,2023-09-26,705,stencil,10,20,10,1,00327,India
129585,2023-09-26,710,geometry box,100,150,50,1,00327,India
129585,2023-09-26,711,TD kit,150,300,150,1,00327,India
935250,2023-09-26,714,carbon paper,15,30,15,1,00470,India
935250,2023-09-26,712,graph paper,20,40,20,1,00470,India
407555,2023-09-26,712,graph paper,20,40,20,1,00164,India
407555,2023-09-26,715,folder,5,15,10,1,00164,India
407555,2023-09-26,707,marker,20,40,20,1,00164,India
206809,2023-09-26,716,printing paper,200,400,200,1,00140,India
206809,2023-09-26,703,eraser,1,3,2,1,00140,India
752652,2023-09-26,717,spiral bound book,50,100,50,1,00415,India
752652,2023-09-26,703,eraser,1,3,2,1,00415,India
752652,2023-09-26,706,sharpener,3,8,5,1,00415,India
752652,2023-09-26,707,marker,20,40,20,1,00415,India
669549,2023-09-26,703,eraser,1,3,2,1,00133,India
669549,2023-09-26,705,stencil,10,20,10,1,00133,India
669549,2023-09-26,706,sharpener,3,8,5,1,00133,India
959468,2023-09-26,710,geometry box,100,150,50,1,00355,India
249784,2023-09-26,705,stencil,10,20,10,1,00175,India
370423,2023-09-26,710,geometry box,100,150,50,1,00372,India
446540,2023-09-26,710,geometry box,100,150,50,1,00115,India
446540,2023-09-26,711,TD kit,150,300,150,1,00115,India
446540,2023-09-26,705,stencil,10,20,10,1,00115,India
446540,2023-09-26,713,ball pen,5,10,5,1,00115,India
446540,2023-09-26,703,eraser,1,3,2,1,00115,India
976256,2023-09-26,704,scale,5,10,5,1,00183,India
976256,2023-09-26,715,folder,5,15,10,1,00183,India
976256,2023-09-26,709,notebook,30,60,30,1,00183,India
976256,2023-09-26,711,TD kit,150,300,150,1,00183,India
762645,2023-09-26,713,ball pen,5,10,5,1,00454,India
762645,2023-09-26,711,TD kit,150,300,150,1,00454,India
762645,2023-09-26,705,stencil,10,20,10,1,00454,India
762645,2023-09-26,715,folder,5,15,10,1,00454,India
670817,2023-09-26,707,marker,20,40,20,1,00365,India
670817,2023-09-26,702,pencil,2,5,3,1,00365,India
670817,2023-09-26,714,carbon paper,15,30,15,1,00365,India
670817,2023-09-26,705,stencil,10,20,10,1,00365,India
157782,2023-09-26,711,TD kit,150,300,150,1,00282,India
157782,2023-09-26,715,folder,5,15,10,1,00282,India
157782,2023-09-26,708,sketchpen,15,40,25,1,00282,India
763348,2023-09-26,712,graph paper,20,40,20,1,00336,India
763348,2023-09-26,716,printing paper,200,400,200,1,00336,India
180367,2023-09-26,713,ball pen,5,10,5,1,00007,India
180367,2023-09-26,702,pencil,2,5,3,1,00007,India
180367,2023-09-26,716,printing paper,200,400,200,1,00007,India
760567,2023-09-26,712,graph paper,20,40,20,1,00261,India
760567,2023-09-26,702,pencil,2,5,3,1,00261,India
760567,2023-09-26,711,TD kit,150,300,150,1,00261,India
760567,2023-09-26,714,carbon paper,15,30,15,1,00261,India
760567,2023-09-26,713,ball pen,5,10,5,1,00261,India
739587,2023-09-26,708,sketchpen,15,40,25,1,00388,India
654820,2023-09-26,712,graph paper,20,40,20,1,00307,India
654820,2023-09-26,705,stencil,10,20,10,1,00307,India
654820,2023-09-26,715,folder,5,15,10,1,00307,India
687698,2023-09-26,710,geometry box,100,150,50,1,00251,India
687698,2023-09-26,711,TD kit,150,300,150,1,00251,India
687698,2023-09-26,717,spiral bound book,50,100,50,1,00251,India
687698,2023-09-26,709,notebook,30,60,30,1,00251,India
687698,2023-09-26,706,sharpener,3,8,5,1,00251,India
227954,2023-09-26,701,gel pen,5,10,5,1,00266,India
227954,2023-09-26,708,sketchpen,15,40,25,1,00266,India
227954,2023-09-26,717,spiral bound book,50,100,50,1,00266,India
291358,2023-09-26,708,sketchpen,15,40,25,1,00378,India
291358,2023-09-26,702,pencil,2,5,3,1,00378,India
291358,2023-09-26,710,geometry box,100,150,50,1,00378,India
291358,2023-09-26,704,scale,5,10,5,1,00378,India
291358,2023-09-26,712,graph paper,20,40,20,1,00378,India
725049,2023-09-26,708,sketchpen,15,40,25,1,00492,India
725049,2023-09-26,709,notebook,30,60,30,1,00492,India
733659,2023-09-26,707,marker,20,40,20,1,00132,India
733659,2023-09-26,702,pencil,2,5,3,1,00132,India
733659,2023-09-26,714,carbon paper,15,30,15,1,00132,India
733659,2023-09-26,716,printing paper,200,400,200,1,00132,India
708314,2023-09-26,701,gel pen,5,10,5,1,00067,India
708314,2023-09-26,709,notebook,30,60,30,1,00067,India
346894,2023-09-26,706,sharpener,3,8,5,1,00261,India
346894,2023-09-26,715,folder,5,15,10,1,00261,India
433819,2023-09-26,707,marker,20,40,20,1,00231,India
433819,2023-09-26,711,TD kit,150,300,150,1,00231,India
433819,2023-09-26,704,scale,5,10,5,1,00231,India
433819,2023-09-26,709,notebook,30,60,30,1,00231,India
884385,2023-09-26,704,scale,5,10,5,1,00049,India
884385,2023-09-26,708,sketchpen,15,40,25,1,00049,India
884385,2023-09-26,712,graph paper,20,40,20,1,00049,India
836041,2023-09-27,715,folder,5,15,10,1,00049,India
884112,2023-09-27,709,notebook,30,60,30,1,00271,India
822174,2023-09-27,713,ball pen,5,10,5,1,00320,India
671278,2023-09-27,715,folder,5,15,10,1,00247,India
671278,2023-09-27,703,eraser,1,3,2,1,00247,India
671278,2023-09-27,701,gel pen,5,10,5,1,00247,India
544155,2023-09-27,713,ball pen,5,10,5,1,00347,India
544155,2023-09-27,705,stencil,10,20,10,1,00347,India
544155,2023-09-27,704,scale,5,10,5,1,00347,India
747732,2023-09-27,709,notebook,30,60,30,1,00233,India
325842,2023-09-27,703,eraser,1,3,2,1,00329,India
325842,2023-09-27,709,notebook,30,60,30,1,00329,India
325842,2023-09-27,705,stencil,10,20,10,1,00329,India
274379,2023-09-27,702,pencil,2,5,3,1,00271,India
274379,2023-09-27,706,sharpener,3,8,5,1,00271,India
733665,2023-09-27,714,carbon paper,15,30,15,1,00214,India
733665,2023-09-27,715,folder,5,15,10,1,00214,India
733665,2023-09-27,702,pencil,2,5,3,1,00214,India
784685,2023-09-27,704,scale,5,10,5,1,00306,India
608908,2023-09-27,712,graph paper,20,40,20,1,00421,India
608908,2023-09-27,704,scale,5,10,5,1,00421,India
847918,2023-09-27,702,pencil,2,5,3,1,00002,India
862222,2023-09-27,717,spiral bound book,50,100,50,1,00285,India
862222,2023-09-27,708,sketchpen,15,40,25,1,00285,India
637257,2023-09-27,702,pencil,2,5,3,1,00066,India
965430,2023-09-27,713,ball pen,5,10,5,1,00463,India
970844,2023-09-27,717,spiral bound book,50,100,50,1,00186,India
970844,2023-09-27,706,sharpener,3,8,5,1,00186,India
936939,2023-09-27,717,spiral bound book,50,100,50,1,00092,India
936939,2023-09-27,701,gel pen,5,10,5,1,00092,India
466074,2023-09-27,708,sketchpen,15,40,25,1,00113,India
466074,2023-09-27,703,eraser,1,3,2,1,00113,India
466074,2023-09-27,710,geometry box,100,150,50,1,00113,India
466074,2023-09-27,707,marker,20,40,20,1,00113,India
466074,2023-09-27,712,graph paper,20,40,20,1,00113,India
106204,2023-09-27,710,geometry box,100,150,50,1,00101,India
106204,2023-09-27,711,TD kit,150,300,150,1,00101,India
449834,2023-09-27,713,ball pen,5,10,5,1,00498,India
293767,2023-09-27,715,folder,5,15,10,1,00060,India
293767,2023-09-27,707,marker,20,40,20,1,00060,India
293767,2023-09-27,716,printing paper,200,400,200,1,00060,India
226221,2023-09-27,707,marker,20,40,20,1,00125,India
226221,2023-09-27,715,folder,5,15,10,1,00125,India
226221,2023-09-27,705,stencil,10,20,10,1,00125,India
423117,2023-09-27,708,sketchpen,15,40,25,1,00197,India
423117,2023-09-27,710,geometry box,100,150,50,1,00197,India
423117,2023-09-27,701,gel pen,5,10,5,1,00197,India
423117,2023-09-27,704,scale,5,10,5,1,00197,India
861628,2023-09-27,707,marker,20,40,20,1,00425,India
861628,2023-09-27,701,gel pen,5,10,5,1,00425,India
861628,2023-09-27,702,pencil,2,5,3,1,00425,India
861628,2023-09-27,710,geometry box,100,150,50,1,00425,India
370079,2023-09-27,707,marker,20,40,20,1,00232,India
370079,2023-09-27,711,TD kit,150,300,150,1,00232,India
404544,2023-09-27,701,gel pen,5,10,5,1,00141,India
404544,2023-09-27,709,notebook,30,60,30,1,00141,India
404544,2023-09-27,711,TD kit,150,300,150,1,00141,India
829012,2023-09-27,703,eraser,1,3,2,1,00214,India
829012,2023-09-27,708,sketchpen,15,40,25,1,00214,India
994807,2023-09-27,709,notebook,30,60,30,1,00117,India
994807,2023-09-27,714,carbon paper,15,30,15,1,00117,India
381344,2023-09-27,711,TD kit,150,300,150,1,00269,India
381344,2023-09-27,703,eraser,1,3,2,1,00269,India
381344,2023-09-27,706,sharpener,3,8,5,1,00269,India
381344,2023-09-27,708,sketchpen,15,40,25,1,00269,India
580993,2023-09-27,706,sharpener,3,8,5,1,00356,India
580993,2023-09-27,705,stencil,10,20,10,1,00356,India
580993,2023-09-27,708,sketchpen,15,40,25,1,00356,India
968092,2023-09-27,701,gel pen,5,10,5,1,00303,India
740621,2023-09-27,708,sketchpen,15,40,25,1,00060,India
740621,2023-09-27,709,notebook,30,60,30,1,00060,India
333080,2023-09-27,717,spiral bound book,50,100,50,1,00348,India
333080,2023-09-27,714,carbon paper,15,30,15,1,00348,India
302392,2023-09-27,709,notebook,30,60,30,1,00191,India
302392,2023-09-27,706,sharpener,3,8,5,1,00191,India
302392,2023-09-27,714,carbon paper,15,30,15,1,00191,India
302392,2023-09-27,710,geometry box,100,150,50,1,00191,India
586023,2023-09-27,717,spiral bound book,50,100,50,1,00126,India
586023,2023-09-27,707,marker,20,40,20,1,00126,India
586023,2023-09-27,708,sketchpen,15,40,25,1,00126,India
586023,2023-09-27,705,stencil,10,20,10,1,00126,India
322494,2023-09-27,714,carbon paper,15,30,15,1,00403,India
322494,2023-09-27,701,gel pen,5,10,5,1,00403,India
322494,2023-09-27,716,printing paper,200,400,200,1,00403,India
322494,2023-09-27,704,scale,5,10,5,1,00403,India
149253,2023-09-28,705,stencil,10,20,10,1,00281,India
149253,2023-09-28,716,printing paper,200,400,200,1,00281,India
149253,2023-09-28,709,notebook,30,60,30,1,00281,India
149253,2023-09-28,711,TD kit,150,300,150,1,00281,India
109700,2023-09-28,708,sketchpen,15,40,25,1,00168,India
109700,2023-09-28,717,spiral bound book,50,100,50,1,00168,India
645612,2023-09-28,708,sketchpen,15,40,25,1,00338,India
645612,2023-09-28,703,eraser,1,3,2,1,00338,India
645612,2023-09-28,710,geometry box,100,150,50,1,00338,India
645612,2023-09-28,711,TD kit,150,300,150,1,00338,India
244021,2023-09-28,703,eraser,1,3,2,1,00393,India
244021,2023-09-28,712,graph paper,20,40,20,1,00393,India
952791,2023-09-28,701,gel pen,5,10,5,1,00379,India
952791,2023-09-28,704,scale,5,10,5,1,00379,India
349327,2023-09-28,717,spiral bound book,50,100,50,1,00250,India
349327,2023-09-28,713,ball pen,5,10,5,1,00250,India
349327,2023-09-28,703,eraser,1,3,2,1,00250,India
349327,2023-09-28,705,stencil,10,20,10,1,00250,India
349327,2023-09-28,701,gel pen,5,10,5,1,00250,India
352487,2023-09-28,706,sharpener,3,8,5,1,00477,India
352487,2023-09-28,709,notebook,30,60,30,1,00477,India
352487,2023-09-28,716,printing paper,200,400,200,1,00477,India
117399,2023-09-28,707,marker,20,40,20,1,00010,India
117399,2023-09-28,705,stencil,10,20,10,1,00010,India
117399,2023-09-28,713,ball pen,5,10,5,1,00010,India
117399,2023-09-28,708,sketchpen,15,40,25,1,00010,India
117399,2023-09-28,711,TD kit,150,300,150,1,00010,India
312550,2023-09-28,703,eraser,1,3,2,1,00384,India
719480,2023-09-28,715,folder,5,15,10,1,00414,India
719480,2023-09-28,706,sharpener,3,8,5,1,00414,India
745103,2023-09-28,707,marker,20,40,20,1,00091,India
745103,2023-09-28,702,pencil,2,5,3,1,00091,India
367219,2023-09-28,710,geometry box,100,150,50,1,00252,India
367219,2023-09-28,711,TD kit,150,300,150,1,00252,India
746510,2023-09-28,717,spiral bound book,50,100,50,1,00257,India
746510,2023-09-28,716,printing paper,200,400,200,1,00257,India
746510,2023-09-28,705,stencil,10,20,10,1,00257,India
759421,2023-09-28,701,gel pen,5,10,5,1,00312,India
759421,2023-09-28,707,marker,20,40,20,1,00312,India
759421,2023-09-28,710,geometry box,100,150,50,1,00312,India
107589,2023-09-28,716,printing paper,200,400,200,1,00391,India
107589,2023-09-28,712,graph paper,20,40,20,1,00391,India
836116,2023-09-28,713,ball pen,5,10,5,1,00039,India
989022,2023-09-28,714,carbon paper,15,30,15,1,00208,India
989022,2023-09-28,702,pencil,2,5,3,1,00208,India
989022,2023-09-28,706,sharpener,3,8,5,1,00208,India
989022,2023-09-28,715,folder,5,15,10,1,00208,India
469962,2023-09-28,708,sketchpen,15,40,25,1,00051,India
469962,2023-09-28,704,scale,5,10,5,1,00051,India
469962,2023-09-28,707,marker,20,40,20,1,00051,India
469962,2023-09-28,703,eraser,1,3,2,1,00051,India
692490,2023-09-28,704,scale,5,10,5,1,00167,India
692490,2023-09-28,703,eraser,1,3,2,1,00167,India
353731,2023-09-28,707,marker,20,40,20,1,00049,India
353731,2023-09-28,713,ball pen,5,10,5,1,00049,India
353731,2023-09-28,712,graph paper,20,40,20,1,00049,India
353731,2023-09-28,714,carbon paper,15,30,15,1,00049,India
353731,2023-09-28,708,sketchpen,15,40,25,1,00049,India
435449,2023-09-28,708,sketchpen,15,40,25,1,00099,India
435449,2023-09-28,701,gel pen,5,10,5,1,00099,India
435449,2023-09-28,706,sharpener,3,8,5,1,00099,India
762916,2023-09-28,707,marker,20,40,20,1,00340,India
762916,2023-09-28,703,eraser,1,3,2,1,00340,India
762916,2023-09-28,710,geometry box,100,150,50,1,00340,India
766617,2023-09-28,704,scale,5,10,5,1,00434,India
766617,2023-09-28,705,stencil,10,20,10,1,00434,India
766617,2023-09-28,710,geometry box,100,150,50,1,00434,India
734001,2023-09-28,706,sharpener,3,8,5,1,00359,India
734001,2023-09-28,717,spiral bound book,50,100,50,1,00359,India
484315,2023-09-28,701,gel pen,5,10,5,1,00431,India
484315,2023-09-28,707,marker,20,40,20,1,00431,India
484315,2023-09-28,717,spiral bound book,50,100,50,1,00431,India
605693,2023-09-28,702,pencil,2,5,3,1,00164,India
605693,2023-09-28,705,stencil,10,20,10,1,00164,India
605693,2023-09-28,709,notebook,30,60,30,1,00164,India
605693,2023-09-28,706,sharpener,3,8,5,1,00164,India
828570,2023-09-28,708,sketchpen,15,40,25,1,00350,India
828570,2023-09-28,715,folder,5,15,10,1,00350,India
828570,2023-09-28,706,sharpener,3,8,5,1,00350,India
828570,2023-09-28,716,printing paper,200,400,200,1,00350,India
990252,2023-09-28,716,printing paper,200,400,200,1,00475,India
990252,2023-09-28,714,carbon paper,15,30,15,1,00475,India
990252,2023-09-28,705,stencil,10,20,10,1,00475,India
575367,2023-09-28,716,printing paper,200,400,200,1,00152,India
684311,2023-09-28,712,graph paper,20,40,20,1,00333,India
555452,2023-09-28,717,spiral bound book,50,100,50,1,00186,India
656164,2023-09-28,708,sketchpen,15,40,25,1,00146,India
656164,2023-09-28,706,sharpener,3,8,5,1,00146,India
656164,2023-09-28,710,geometry box,100,150,50,1,00146,India
656164,2023-09-28,712,graph paper,20,40,20,1,00146,India
656164,2023-09-28,709,notebook,30,60,30,1,00146,India
645560,2023-09-28,705,stencil,10,20,10,1,00402,India
437351,2023-09-28,703,eraser,1,3,2,1,00459,India
792578,2023-09-28,709,notebook,30,60,30,1,00036,India
792578,2023-09-28,714,carbon paper,15,30,15,1,00036,India
792578,2023-09-28,704,scale,5,10,5,1,00036,India
792578,2023-09-28,711,TD kit,150,300,150,1,00036,India
818792,2023-09-28,712,graph paper,20,40,20,1,00080,India
818792,2023-09-28,706,sharpener,3,8,5,1,00080,India
818792,2023-09-28,711,TD kit,150,300,150,1,00080,India
818792,2023-09-28,704,scale,5,10,5,1,00080,India
998346,2023-09-28,702,pencil,2,5,3,1,00090,India
998346,2023-09-28,703,eraser,1,3,2,1,00090,India
998346,2023-09-28,713,ball pen,5,10,5,1,00090,India
998346,2023-09-28,712,graph paper,20,40,20,1,00090,India
998346,2023-09-28,714,carbon paper,15,30,15,1,00090,India
684881,2023-09-28,706,sharpener,3,8,5,1,00123,India
684881,2023-09-28,709,notebook,30,60,30,1,00123,India
876814,2023-09-28,712,graph paper,20,40,20,1,00152,India
876814,2023-09-28,702,pencil,2,5,3,1,00152,India
876814,2023-09-28,707,marker,20,40,20,1,00152,India
876814,2023-09-28,704,scale,5,10,5,1,00152,India
876814,2023-09-28,714,carbon paper,15,30,15,1,00152,India
468516,2023-09-28,717,spiral bound book,50,100,50,1,00159,India
531749,2023-09-28,703,eraser,1,3,2,1,00442,India
531749,2023-09-28,702,pencil,2,5,3,1,00442,India
531749,2023-09-28,715,folder,5,15,10,1,00442,India
986397,2023-09-28,701,gel pen,5,10,5,1,00148,India
986397,2023-09-28,707,marker,20,40,20,1,00148,India
964366,2023-09-28,711,TD kit,150,300,150,1,00386,India
964366,2023-09-28,708,sketchpen,15,40,25,1,00386,India
919367,2023-09-28,705,stencil,10,20,10,1,00412,India
919367,2023-09-28,710,geometry box,100,150,50,1,00412,India
681983,2023-09-28,701,gel pen,5,10,5,1,00394,India
681983,2023-09-28,717,spiral bound book,50,100,50,1,00394,India
681983,2023-09-28,714,carbon paper,15,30,15,1,00394,India
681983,2023-09-28,703,eraser,1,3,2,1,00394,India
681983,2023-09-28,715,folder,5,15,10,1,00394,India
588116,2023-09-28,715,folder,5,15,10,1,00017,India
601213,2023-09-28,714,carbon paper,15,30,15,1,00386,India
601213,2023-09-28,710,geometry box,100,150,50,1,00386,India
639746,2023-09-28,711,TD kit,150,300,150,1,00202,India
639746,2023-09-28,714,carbon paper,15,30,15,1,00202,India
639746,2023-09-28,717,spiral bound book,50,100,50,1,00202,India
374367,2023-09-29,712,graph paper,20,40,20,1,00345,India
788334,2023-09-29,710,geometry box,100,150,50,1,00145,India
788334,2023-09-29,701,gel pen,5,10,5,1,00145,India
788334,2023-09-29,708,sketchpen,15,40,25,1,00145,India
788334,2023-09-29,702,pencil,2,5,3,1,00145,India
217328,2023-09-29,713,ball pen,5,10,5,1,00181,India
217328,2023-09-29,704,scale,5,10,5,1,00181,India
217328,2023-09-29,703,eraser,1,3,2,1,00181,India
217328,2023-09-29,711,TD kit,150,300,150,1,00181,India
401334,2023-09-29,706,sharpener,3,8,5,1,00210,India
401334,2023-09-29,711,TD kit,150,300,150,1,00210,India
974350,2023-09-29,705,stencil,10,20,10,1,00245,India
974350,2023-09-29,710,geometry box,100,150,50,1,00245,India
974350,2023-09-29,717,spiral bound book,50,100,50,1,00245,India
974350,2023-09-29,713,ball pen,5,10,5,1,00245,India
974350,2023-09-29,715,folder,5,15,10,1,00245,India
836942,2023-09-29,715,folder,5,15,10,1,00162,India
188097,2023-09-29,716,printing paper,200,400,200,1,00099,India
188097,2023-09-29,709,notebook,30,60,30,1,00099,India
913024,2023-09-29,716,printing paper,200,400,200,1,00300,India
913024,2023-09-29,704,scale,5,10,5,1,00300,India
913024,2023-09-29,715,folder,5,15,10,1,00300,India
913024,2023-09-29,712,graph paper,20,40,20,1,00300,India
913024,2023-09-29,717,spiral bound book,50,100,50,1,00300,India
673812,2023-09-29,714,carbon paper,15,30,15,1,00254,India
673812,2023-09-29,708,sketchpen,15,40,25,1,00254,India
183398,2023-09-29,715,folder,5,15,10,1,00280,India
183398,2023-09-29,712,graph paper,20,40,20,1,00280,India
442253,2023-09-29,703,eraser,1,3,2,1,00255,India
610722,2023-09-29,715,folder,5,15,10,1,00048,India
610722,2023-09-29,708,sketchpen,15,40,25,1,00048,India
581667,2023-09-29,716,printing paper,200,400,200,1,00369,India
581667,2023-09-29,715,folder,5,15,10,1,00369,India
817995,2023-09-29,713,ball pen,5,10,5,1,00318,India
817995,2023-09-29,710,geometry box,100,150,50,1,00318,India
704805,2023-09-29,706,sharpener,3,8,5,1,00315,India
704805,2023-09-29,702,pencil,2,5,3,1,00315,India
704805,2023-09-29,710,geometry box,100,150,50,1,00315,India
733937,2023-09-29,716,printing paper,200,400,200,1,00395,India
733937,2023-09-29,711,TD kit,150,300,150,1,00395,India
733937,2023-09-29,717,spiral bound book,50,100,50,1,00395,India
972745,2023-09-29,703,eraser,1,3,2,1,00358,India
972745,2023-09-29,707,marker,20,40,20,1,00358,India
279186,2023-09-29,711,TD kit,150,300,150,1,00090,India
279186,2023-09-29,704,scale,5,10,5,1,00090,India
279186,2023-09-29,706,sharpener,3,8,5,1,00090,India
279186,2023-09-29,717,spiral bound book,50,100,50,1,00090,India
279186,2023-09-29,707,marker,20,40,20,1,00090,India
777353,2023-09-29,710,geometry box,100,150,50,1,00001,India
105478,2023-09-29,703,eraser,1,3,2,1,00479,India
105478,2023-09-29,717,spiral bound book,50,100,50,1,00479,India
105478,2023-09-29,711,TD kit,150,300,150,1,00479,India
554167,2023-09-29,709,notebook,30,60,30,1,00082,India
554167,2023-09-29,704,scale,5,10,5,1,00082,India
554167,2023-09-29,713,ball pen,5,10,5,1,00082,India
146278,2023-09-29,704,scale,5,10,5,1,00167,India
221514,2023-09-29,716,printing paper,200,400,200,1,00146,India
221514,2023-09-29,705,stencil,10,20,10,1,00146,India
221514,2023-09-29,707,marker,20,40,20,1,00146,India
444910,2023-09-29,710,geometry box,100,150,50,1,00002,India
444910,2023-09-29,715,folder,5,15,10,1,00002,India
444910,2023-09-29,717,spiral bound book,50,100,50,1,00002,India
444910,2023-09-29,705,stencil,10,20,10,1,00002,India
328804,2023-09-29,711,TD kit,150,300,150,1,00098,India
328804,2023-09-29,702,pencil,2,5,3,1,00098,India
613723,2023-09-29,714,carbon paper,15,30,15,1,00107,India
613723,2023-09-29,708,sketchpen,15,40,25,1,00107,India
819594,2023-09-29,704,scale,5,10,5,1,00006,India
819594,2023-09-29,717,spiral bound book,50,100,50,1,00006,India
819594,2023-09-29,710,geometry box,100,150,50,1,00006,India
289548,2023-09-29,706,sharpener,3,8,5,1,00409,India
289548,2023-09-29,715,folder,5,15,10,1,00409,India
702610,2023-09-29,710,geometry box,100,150,50,1,00311,India
824231,2023-09-29,711,TD kit,150,300,150,1,00143,India
824231,2023-09-29,717,spiral bound book,50,100,50,1,00143,India
170831,2023-09-29,704,scale,5,10,5,1,00249,India
170831,2023-09-29,714,carbon paper,15,30,15,1,00249,India
170831,2023-09-29,701,gel pen,5,10,5,1,00249,India
170831,2023-09-29,705,stencil,10,20,10,1,00249,India
351113,2023-09-29,717,spiral bound book,50,100,50,1,00343,India
604579,2023-09-29,715,folder,5,15,10,1,00010,India
604579,2023-09-29,717,spiral bound book,50,100,50,1,00010,India
516540,2023-09-29,706,sharpener,3,8,5,1,00058,India
516540,2023-09-29,705,stencil,10,20,10,1,00058,India
516540,2023-09-29,709,notebook,30,60,30,1,00058,India
509294,2023-09-29,705,stencil,10,20,10,1,00110,India
807849,2023-09-29,705,stencil,10,20,10,1,00455,India
807849,2023-09-29,708,sketchpen,15,40,25,1,00455,India
807849,2023-09-29,709,notebook,30,60,30,1,00455,India
807849,2023-09-29,714,carbon paper,15,30,15,1,00455,India
807849,2023-09-29,707,marker,20,40,20,1,00455,India
468711,2023-09-29,709,notebook,30,60,30,1,00272,India
365923,2023-09-29,704,scale,5,10,5,1,00091,India
365923,2023-09-29,708,sketchpen,15,40,25,1,00091,India
365923,2023-09-29,711,TD kit,150,300,150,1,00091,India
365923,2023-09-29,706,sharpener,3,8,5,1,00091,India
783591,2023-09-29,715,folder,5,15,10,1,00268,India
783591,2023-09-29,705,stencil,10,20,10,1,00268,India
783591,2023-09-29,707,marker,20,40,20,1,00268,India
582335,2023-09-29,715,folder,5,15,10,1,00434,India
582335,2023-09-29,707,marker,20,40,20,1,00434,India
582335,2023-09-29,716,printing paper,200,400,200,1,00434,India
586500,2023-09-29,709,notebook,30,60,30,1,00370,India
586500,2023-09-29,706,sharpener,3,8,5,1,00370,India
586500,2023-09-29,704,scale,5,10,5,1,00370,India
500991,2023-09-29,711,TD kit,150,300,150,1,00283,India
500991,2023-09-29,715,folder,5,15,10,1,00283,India
500991,2023-09-29,710,geometry box,100,150,50,1,00283,India
500991,2023-09-29,714,carbon paper,15,30,15,1,00283,India
500991,2023-09-29,712,graph paper,20,40,20,1,00283,India
324288,2023-09-29,709,notebook,30,60,30,1,00381,India
324288,2023-09-29,705,stencil,10,20,10,1,00381,India
324288,2023-09-29,701,gel pen,5,10,5,1,00381,India
324288,2023-09-29,702,pencil,2,5,3,1,00381,India
338637,2023-09-29,712,graph paper,20,40,20,1,00016,India
338637,2023-09-29,715,folder,5,15,10,1,00016,India
338637,2023-09-29,714,carbon paper,15,30,15,1,00016,India
338637,2023-09-29,710,geometry box,100,150,50,1,00016,India
338637,2023-09-29,709,notebook,30,60,30,1,00016,India
440666,2023-09-29,716,printing paper,200,400,200,1,00469,India
270559,2023-09-30,714,carbon paper,15,30,15,1,00292,India
190616,2023-09-30,708,sketchpen,15,40,25,1,00267,India
190616,2023-09-30,714,carbon paper,15,30,15,1,00267,India
190616,2023-09-30,712,graph paper,20,40,20,1,00267,India
190616,2023-09-30,709,notebook,30,60,30,1,00267,India
190616,2023-09-30,707,marker,20,40,20,1,00267,India
942353,2023-09-30,716,printing paper,200,400,200,1,00327,India
885304,2023-09-30,701,gel pen,5,10,5,1,00350,India
885304,2023-09-30,710,geometry box,100,150,50,1,00350,India
547903,2023-09-30,714,carbon paper,15,30,15,1,00121,India
415313,2023-09-30,713,ball pen,5,10,5,1,00342,India
415313,2023-09-30,715,folder,5,15,10,1,00342,India
736964,2023-09-30,705,stencil,10,20,10,1,00496,India
736964,2023-09-30,711,TD kit,150,300,150,1,00496,India
736964,2023-09-30,709,notebook,30,60,30,1,00496,India
583627,2023-09-30,708,sketchpen,15,40,25,1,00427,India
583627,2023-09-30,713,ball pen,5,10,5,1,00427,India
583627,2023-09-30,704,scale,5,10,5,1,00427,India
583627,2023-09-30,705,stencil,10,20,10,1,00427,India
583627,2023-09-30,703,eraser,1,3,2,1,00427,India
589041,2023-09-30,703,eraser,1,3,2,1,00021,India
589041,2023-09-30,715,folder,5,15,10,1,00021,India
767542,2023-09-30,701,gel pen,5,10,5,1,00383,India
163801,2023-09-30,702,pencil,2,5,3,1,00460,India
163801,2023-09-30,708,sketchpen,15,40,25,1,00460,India
163801,2023-09-30,717,spiral bound book,50,100,50,1,00460,India
214357,2023-09-30,705,stencil,10,20,10,1,00056,India
214357,2023-09-30,717,spiral bound book,50,100,50,1,00056,India
214357,2023-09-30,711,TD kit,150,300,150,1,00056,India
214357,2023-09-30,715,folder,5,15,10,1,00056,India
583097,2023-09-30,712,graph paper,20,40,20,1,00251,India
583097,2023-09-30,705,stencil,10,20,10,1,00251,India
583097,2023-09-30,701,gel pen,5,10,5,1,00251,India
583097,2023-09-30,704,scale,5,10,5,1,00251,India
583097,2023-09-30,711,TD kit,150,300,150,1,00251,India
200726,2023-09-30,704,scale,5,10,5,1,00498,India
200726,2023-09-30,708,sketchpen,15,40,25,1,00498,India
732267,2023-09-30,708,sketchpen,15,40,25,1,00488,India
732267,2023-09-30,701,gel pen,5,10,5,1,00488,India
732267,2023-09-30,707,marker,20,40,20,1,00488,India
732267,2023-09-30,705,stencil,10,20,10,1,00488,India
108701,2023-09-30,705,stencil,10,20,10,1,00283,India
108701,2023-09-30,713,ball pen,5,10,5,1,00283,India
108701,2023-09-30,716,printing paper,200,400,200,1,00283,India
281052,2023-09-30,705,stencil,10,20,10,1,00406,India
281052,2023-09-30,711,TD kit,150,300,150,1,00406,India
281052,2023-09-30,710,geometry box,100,150,50,1,00406,India
281052,2023-09-30,707,marker,20,40,20,1,00406,India
281052,2023-09-30,704,scale,5,10,5,1,00406,India
101207,2023-09-30,715,folder,5,15,10,1,00398,India
101207,2023-09-30,708,sketchpen,15,40,25,1,00398,India
285417,2023-09-30,713,ball pen,5,10,5,1,00029,India
396558,2023-09-30,713,ball pen,5,10,5,1,00258,India
396558,2023-09-30,704,scale,5,10,5,1,00258,India
396558,2023-09-30,715,folder,5,15,10,1,00258,India
155202,2023-09-30,701,gel pen,5,10,5,1,00277,India
155202,2023-09-30,716,printing paper,200,400,200,1,00277,India
155202,2023-09-30,709,notebook,30,60,30,1,00277,India
155202,2023-09-30,706,sharpener,3,8,5,1,00277,India
630018,2023-09-30,702,pencil,2,5,3,1,00061,India
630018,2023-09-30,708,sketchpen,15,40,25,1,00061,India
630018,2023-09-30,710,geometry box,100,150,50,1,00061,India
630018,2023-09-30,715,folder,5,15,10,1,00061,India
630018,2023-09-30,714,carbon paper,15,30,15,1,00061,India
661104,2023-09-30,715,folder,5,15,10,1,00385,India
661104,2023-09-30,708,sketchpen,15,40,25,1,00385,India
661104,2023-09-30,705,stencil,10,20,10,1,00385,India
661104,2023-09-30,706,sharpener,3,8,5,1,00385,India
411128,2023-09-30,709,notebook,30,60,30,1,00371,India
411128,2023-09-30,708,sketchpen,15,40,25,1,00371,India
325780,2023-09-30,715,folder,5,15,10,1,00042,India
116552,2023-09-30,704,scale,5,10,5,1,00200,India
116552,2023-09-30,706,sharpener,3,8,5,1,00200,India
584757,2023-09-30,709,notebook,30,60,30,1,00461,India
584757,2023-09-30,717,spiral bound book,50,100,50,1,00461,India
584757,2023-09-30,712,graph paper,20,40,20,1,00461,India
584757,2023-09-30,706,sharpener,3,8,5,1,00461,India
584757,2023-09-30,704,scale,5,10,5,1,00461,India
656321,2023-09-30,712,graph paper,20,40,20,1,00159,India
576553,2023-09-30,702,pencil,2,5,3,1,00056,India
576553,2023-09-30,711,TD kit,150,300,150,1,00056,India
775806,2023-09-30,713,ball pen,5,10,5,1,00048,India
775806,2023-09-30,709,notebook,30,60,30,1,00048,India
946728,2023-09-30,702,pencil,2,5,3,1,00459,India
946728,2023-09-30,703,eraser,1,3,2,1,00459,India
946728,2023-09-30,713,ball pen,5,10,5,1,00459,India
862374,2023-09-30,703,eraser,1,3,2,1,00013,India
862374,2023-09-30,713,ball pen,5,10,5,1,00013,India
862374,2023-09-30,705,stencil,10,20,10,1,00013,India
862374,2023-09-30,704,scale,5,10,5,1,00013,India
862374,2023-09-30,708,sketchpen,15,40,25,1,00013,India
617394,2023-09-30,712,graph paper,20,40,20,1,00113,India
617394,2023-09-30,703,eraser,1,3,2,1,00113,India
617394,2023-09-30,711,TD kit,150,300,150,1,00113,India
617394,2023-09-30,716,printing paper,200,400,200,1,00113,India
617394,2023-09-30,713,ball pen,5,10,5,1,00113,India
281466,2023-09-30,708,sketchpen,15,40,25,1,00463,India
281466,2023-09-30,705,stencil,10,20,10,1,00463,India
281466,2023-09-30,701,gel pen,5,10,5,1,00463,India
281466,2023-09-30,715,folder,5,15,10,1,00463,India
281466,2023-09-30,707,marker,20,40,20,1,00463,India
935029,2023-09-30,717,spiral bound book,50,100,50,1,00187,India
935029,2023-09-30,705,stencil,10,20,10,1,00187,India
227307,2023-09-30,703,eraser,1,3,2,1,00334,India
227307,2023-09-30,701,gel pen,5,10,5,1,00334,India
493909,2023-09-30,702,pencil,2,5,3,1,00164,India
493909,2023-09-30,712,graph paper,20,40,20,1,00164,India
493909,2023-09-30,705,stencil,10,20,10,1,00164,India
493909,2023-09-30,704,scale,5,10,5,1,00164,India
493909,2023-09-30,701,gel pen,5,10,5,1,00164,India
689840,2023-09-30,717,spiral bound book,50,100,50,1,00444,India
689840,2023-09-30,715,folder,5,15,10,1,00444,India
689840,2023-09-30,702,pencil,2,5,3,1,00444,India
375440,2023-09-30,709,notebook,30,60,30,1,00166,India
375440,2023-09-30,707,marker,20,40,20,1,00166,India
375440,2023-09-30,713,ball pen,5,10,5,1,00166,India
409469,2023-09-30,705,stencil,10,20,10,1,00198,India
135079,2023-09-30,704,scale,5,10,5,1,00232,India
135079,2023-09-30,710,geometry box,100,150,50,1,00232,India
135079,2023-09-30,702,pencil,2,5,3,1,00232,India
135079,2023-09-30,715,folder,5,15,10,1,00232,India
859950,2023-10-01,716,printing paper,200,400,200,1,00127,India
709167,2023-10-01,717,spiral bound book,50,100,50,1,00018,India
709167,2023-10-01,701,gel pen,5,10,5,1,00018,India
323947,2023-10-01,717,spiral bound book,50,100,50,1,00011,India
323947,2023-10-01,701,gel pen,5,10,5,1,00011,India
323947,2023-10-01,708,sketchpen,15,40,25,1,00011,India
851364,2023-10-01,712,graph paper,20,40,20,1,00098,India
851364,2023-10-01,709,notebook,30,60,30,1,00098,India
851364,2023-10-01,714,carbon paper,15,30,15,1,00098,India
851364,2023-10-01,703,eraser,1,3,2,1,00098,India
450069,2023-10-01,710,geometry box,100,150,50,1,00296,India
450069,2023-10-01,712,graph paper,20,40,20,1,00296,India
450069,2023-10-01,706,sharpener,3,8,5,1,00296,India
450069,2023-10-01,714,carbon paper,15,30,15,1,00296,India
384007,2023-10-01,710,geometry box,100,150,50,1,00267,India
696848,2023-10-01,710,geometry box,100,150,50,1,00126,India
696848,2023-10-01,707,marker,20,40,20,1,00126,India
309135,2023-10-01,713,ball pen,5,10,5,1,00447,India
309135,2023-10-01,711,TD kit,150,300,150,1,00447,India
309135,2023-10-01,714,carbon paper,15,30,15,1,00447,India
309135,2023-10-01,710,geometry box,100,150,50,1,00447,India
309135,2023-10-01,706,sharpener,3,8,5,1,00447,India
651920,2023-10-01,701,gel pen,5,10,5,1,00167,India
363507,2023-10-01,704,scale,5,10,5,1,00455,India
363507,2023-10-01,703,eraser,1,3,2,1,00455,India
404522,2023-10-01,708,sketchpen,15,40,25,1,00305,India
404522,2023-10-01,704,scale,5,10,5,1,00305,India
404522,2023-10-01,701,gel pen,5,10,5,1,00305,India
703850,2023-10-01,713,ball pen,5,10,5,1,00411,India
208494,2023-10-01,704,scale,5,10,5,1,00026,India
208494,2023-10-01,707,marker,20,40,20,1,00026,India
540036,2023-10-01,714,carbon paper,15,30,15,1,00301,India
540036,2023-10-01,705,stencil,10,20,10,1,00301,India
540036,2023-10-01,709,notebook,30,60,30,1,00301,India
518226,2023-10-01,702,pencil,2,5,3,1,00254,India
518226,2023-10-01,708,sketchpen,15,40,25,1,00254,India
947114,2023-10-01,710,geometry box,100,150,50,1,00496,India
947114,2023-10-01,704,scale,5,10,5,1,00496,India
947114,2023-10-01,715,folder,5,15,10,1,00496,India
947114,2023-10-01,717,spiral bound book,50,100,50,1,00496,India
947114,2023-10-01,706,sharpener,3,8,5,1,00496,India
496651,2023-10-01,716,printing paper,200,400,200,1,00112,India
496651,2023-10-01,715,folder,5,15,10,1,00112,India
496651,2023-10-01,705,stencil,10,20,10,1,00112,India
471848,2023-10-01,713,ball pen,5,10,5,1,00137,India
471848,2023-10-01,711,TD kit,150,300,150,1,00137,India
417679,2023-10-01,705,stencil,10,20,10,1,00194,India
417679,2023-10-01,701,gel pen,5,10,5,1,00194,India
417679,2023-10-01,715,folder,5,15,10,1,00194,India
236370,2023-10-01,708,sketchpen,15,40,25,1,00342,India
236370,2023-10-01,713,ball pen,5,10,5,1,00342,India
236370,2023-10-01,714,carbon paper,15,30,15,1,00342,India
236370,2023-10-01,715,folder,5,15,10,1,00342,India
236370,2023-10-01,706,sharpener,3,8,5,1,00342,India
746492,2023-10-01,703,eraser,1,3,2,1,00392,India
746492,2023-10-01,702,pencil,2,5,3,1,00392,India
746492,2023-10-01,712,graph paper,20,40,20,1,00392,India
746492,2023-10-01,705,stencil,10,20,10,1,00392,India
746492,2023-10-01,708,sketchpen,15,40,25,1,00392,India
993986,2023-10-01,717,spiral bound book,50,100,50,1,00403,India
993986,2023-10-01,702,pencil,2,5,3,1,00403,India
993986,2023-10-01,705,stencil,10,20,10,1,00403,India
113726,2023-10-01,703,eraser,1,3,2,1,00098,India
113726,2023-10-01,714,carbon paper,15,30,15,1,00098,India
113726,2023-10-01,709,notebook,30,60,30,1,00098,India
143361,2023-10-01,716,printing paper,200,400,200,1,00450,India
143361,2023-10-01,713,ball pen,5,10,5,1,00450,India
629436,2023-10-01,711,TD kit,150,300,150,1,00198,India
256530,2023-10-01,704,scale,5,10,5,1,00249,India
870973,2023-10-01,716,printing paper,200,400,200,1,00170,India
998946,2023-10-01,704,scale,5,10,5,1,00273,India
998946,2023-10-01,708,sketchpen,15,40,25,1,00273,India
998946,2023-10-01,701,gel pen,5,10,5,1,00273,India
998946,2023-10-01,710,geometry box,100,150,50,1,00273,India
639990,2023-10-01,712,graph paper,20,40,20,1,00223,India
639990,2023-10-01,710,geometry box,100,150,50,1,00223,India
594446,2023-10-01,706,sharpener,3,8,5,1,00144,India
169684,2023-10-01,712,graph paper,20,40,20,1,00264,India
169684,2023-10-01,710,geometry box,100,150,50,1,00264,India
169684,2023-10-01,706,sharpener,3,8,5,1,00264,India
169684,2023-10-01,705,stencil,10,20,10,1,00264,India
169684,2023-10-01,708,sketchpen,15,40,25,1,00264,India
282031,2023-10-01,704,scale,5,10,5,1,00433,India
282031,2023-10-01,709,notebook,30,60,30,1,00433,India
282031,2023-10-01,715,folder,5,15,10,1,00433,India
282031,2023-10-01,712,graph paper,20,40,20,1,00433,India
448451,2023-10-01,708,sketchpen,15,40,25,1,00371,India
979817,2023-10-01,705,stencil,10,20,10,1,00470,India
979817,2023-10-01,712,graph paper,20,40,20,1,00470,India
979817,2023-10-01,702,pencil,2,5,3,1,00470,India
625194,2023-10-01,708,sketchpen,15,40,25,1,00371,India
708130,2023-10-02,716,printing paper,200,400,200,1,00444,India
792268,2023-10-02,707,marker,20,40,20,1,00297,India
792268,2023-10-02,712,graph paper,20,40,20,1,00297,India
792268,2023-10-02,709,notebook,30,60,30,1,00297,India
792268,2023-10-02,716,printing paper,200,400,200,1,00297,India
792268,2023-10-02,713,ball pen,5,10,5,1,00297,India
941738,2023-10-02,712,graph paper,20,40,20,1,00146,India
941738,2023-10-02,706,sharpener,3,8,5,1,00146,India
941738,2023-10-02,708,sketchpen,15,40,25,1,00146,India
355426,2023-10-02,701,gel pen,5,10,5,1,00351,India
355426,2023-10-02,703,eraser,1,3,2,1,00351,India
355426,2023-10-02,707,marker,20,40,20,1,00351,India
355426,2023-10-02,705,stencil,10,20,10,1,00351,India
355426,2023-10-02,717,spiral bound book,50,100,50,1,00351,India
840470,2023-10-02,703,eraser,1,3,2,1,00366,India
840470,2023-10-02,701,gel pen,5,10,5,1,00366,India
571252,2023-10-02,714,carbon paper,15,30,15,1,00395,India
571252,2023-10-02,706,sharpener,3,8,5,1,00395,India
561747,2023-10-02,704,scale,5,10,5,1,00121,India
345989,2023-10-02,707,marker,20,40,20,1,00330,India
225164,2023-10-02,704,scale,5,10,5,1,00338,India
837523,2023-10-02,716,printing paper,200,400,200,1,00334,India
837523,2023-10-02,703,eraser,1,3,2,1,00334,India
837523,2023-10-02,702,pencil,2,5,3,1,00334,India
837523,2023-10-02,711,TD kit,150,300,150,1,00334,India
837523,2023-10-02,707,marker,20,40,20,1,00334,India
294678,2023-10-02,702,pencil,2,5,3,1,00131,India
294678,2023-10-02,711,TD kit,150,300,150,1,00131,India
294678,2023-10-02,713,ball pen,5,10,5,1,00131,India
284806,2023-10-02,709,notebook,30,60,30,1,00331,India
284806,2023-10-02,714,carbon paper,15,30,15,1,00331,India
128204,2023-10-02,703,eraser,1,3,2,1,00145,India
128204,2023-10-02,702,pencil,2,5,3,1,00145,India
612149,2023-10-02,709,notebook,30,60,30,1,00311,India
612149,2023-10-02,702,pencil,2,5,3,1,00311,India
612149,2023-10-02,705,stencil,10,20,10,1,00311,India
612149,2023-10-02,704,scale,5,10,5,1,00311,India
612149,2023-10-02,703,eraser,1,3,2,1,00311,India
354745,2023-10-02,710,geometry box,100,150,50,1,00172,India
354745,2023-10-02,714,carbon paper,15,30,15,1,00172,India
109601,2023-10-02,710,geometry box,100,150,50,1,00300,India
109601,2023-10-02,709,notebook,30,60,30,1,00300,India
109601,2023-10-02,705,stencil,10,20,10,1,00300,India
744196,2023-10-02,705,stencil,10,20,10,1,00079,India
744196,2023-10-02,702,pencil,2,5,3,1,00079,India
744196,2023-10-02,708,sketchpen,15,40,25,1,00079,India
744196,2023-10-02,714,carbon paper,15,30,15,1,00079,India
634642,2023-10-02,705,stencil,10,20,10,1,00180,India
634642,2023-10-02,703,eraser,1,3,2,1,00180,India
634642,2023-10-02,712,graph paper,20,40,20,1,00180,India
709420,2023-10-02,711,TD kit,150,300,150,1,00442,India
709420,2023-10-02,701,gel pen,5,10,5,1,00442,India
709420,2023-10-02,717,spiral bound book,50,100,50,1,00442,India
709420,2023-10-02,714,carbon paper,15,30,15,1,00442,India
709420,2023-10-02,706,sharpener,3,8,5,1,00442,India
427234,2023-10-02,706,sharpener,3,8,5,1,00358,India
427234,2023-10-02,709,notebook,30,60,30,1,00358,India
427234,2023-10-02,716,printing paper,200,400,200,1,00358,India
560836,2023-10-02,701,gel pen,5,10,5,1,00185,India
560836,2023-10-02,705,stencil,10,20,10,1,00185,India
560836,2023-10-02,710,geometry box,100,150,50,1,00185,India
560836,2023-10-02,715,folder,5,15,10,1,00185,India
560836,2023-10-02,711,TD kit,150,300,150,1,00185,India
844192,2023-10-02,706,sharpener,3,8,5,1,00327,India
844192,2023-10-02,702,pencil,2,5,3,1,00327,India
844192,2023-10-02,712,graph paper,20,40,20,1,00327,India
113028,2023-10-02,711,TD kit,150,300,150,1,00065,India
113028,2023-10-02,702,pencil,2,5,3,1,00065,India
113028,2023-10-02,705,stencil,10,20,10,1,00065,India
590404,2023-10-02,703,eraser,1,3,2,1,00222,India
590404,2023-10-02,709,notebook,30,60,30,1,00222,India
590404,2023-10-02,701,gel pen,5,10,5,1,00222,India
887377,2023-10-02,701,gel pen,5,10,5,1,00399,India
887377,2023-10-02,712,graph paper,20,40,20,1,00399,India
887377,2023-10-02,709,notebook,30,60,30,1,00399,India
919849,2023-10-02,717,spiral bound book,50,100,50,1,00097,India
919849,2023-10-02,706,sharpener,3,8,5,1,00097,India
919849,2023-10-02,712,graph paper,20,40,20,1,00097,India
919849,2023-10-02,707,marker,20,40,20,1,00097,India
191177,2023-10-02,708,sketchpen,15,40,25,1,00377,India
191177,2023-10-02,706,sharpener,3,8,5,1,00377,India
191177,2023-10-02,702,pencil,2,5,3,1,00377,India
791726,2023-10-02,704,scale,5,10,5,1,00234,India
791726,2023-10-02,702,pencil,2,5,3,1,00234,India
791726,2023-10-02,706,sharpener,3,8,5,1,00234,India
791726,2023-10-02,707,marker,20,40,20,1,00234,India
978904,2023-10-02,704,scale,5,10,5,1,00340,India
978904,2023-10-02,710,geometry box,100,150,50,1,00340,India
978904,2023-10-02,711,TD kit,150,300,150,1,00340,India
978904,2023-10-02,716,printing paper,200,400,200,1,00340,India
521209,2023-10-02,712,graph paper,20,40,20,1,00351,India
521209,2023-10-02,713,ball pen,5,10,5,1,00351,India
521209,2023-10-02,702,pencil,2,5,3,1,00351,India
128245,2023-10-02,701,gel pen,5,10,5,1,00371,India
128245,2023-10-02,716,printing paper,200,400,200,1,00371,India
128245,2023-10-02,706,sharpener,3,8,5,1,00371,India
128245,2023-10-02,710,geometry box,100,150,50,1,00371,India
128245,2023-10-02,707,marker,20,40,20,1,00371,India
567630,2023-10-02,716,printing paper,200,400,200,1,00309,India
567630,2023-10-02,717,spiral bound book,50,100,50,1,00309,India
849336,2023-10-02,715,folder,5,15,10,1,00011,India
380340,2023-10-02,712,graph paper,20,40,20,1,00026,India
380340,2023-10-02,711,TD kit,150,300,150,1,00026,India
380340,2023-10-02,703,eraser,1,3,2,1,00026,India
380340,2023-10-02,714,carbon paper,15,30,15,1,00026,India
175994,2023-10-03,714,carbon paper,15,30,15,1,00264,India
175994,2023-10-03,705,stencil,10,20,10,1,00264,India
933546,2023-10-03,704,scale,5,10,5,1,00332,India
799639,2023-10-03,704,scale,5,10,5,1,00403,India
799639,2023-10-03,708,sketchpen,15,40,25,1,00403,India
511343,2023-10-03,711,TD kit,150,300,150,1,00247,India
564288,2023-10-03,712,graph paper,20,40,20,1,00025,India
564288,2023-10-03,706,sharpener,3,8,5,1,00025,India
564288,2023-10-03,715,folder,5,15,10,1,00025,India
564288,2023-10-03,709,notebook,30,60,30,1,00025,India
286700,2023-10-03,704,scale,5,10,5,1,00223,India
286700,2023-10-03,701,gel pen,5,10,5,1,00223,India
394118,2023-10-03,709,notebook,30,60,30,1,00224,India
394118,2023-10-03,706,sharpener,3,8,5,1,00224,India
394118,2023-10-03,705,stencil,10,20,10,1,00224,India
394118,2023-10-03,713,ball pen,5,10,5,1,00224,India
198975,2023-10-03,702,pencil,2,5,3,1,00013,India
198975,2023-10-03,705,stencil,10,20,10,1,00013,India
198975,2023-10-03,701,gel pen,5,10,5,1,00013,India
198975,2023-10-03,716,printing paper,200,400,200,1,00013,India
447396,2023-10-03,704,scale,5,10,5,1,00397,India
447396,2023-10-03,712,graph paper,20,40,20,1,00397,India
447396,2023-10-03,701,gel pen,5,10,5,1,00397,India
122599,2023-10-03,717,spiral bound book,50,100,50,1,00359,India
122599,2023-10-03,710,geometry box,100,150,50,1,00359,India
122599,2023-10-03,713,ball pen,5,10,5,1,00359,India
122599,2023-10-03,701,gel pen,5,10,5,1,00359,India
428268,2023-10-03,704,scale,5,10,5,1,00311,India
428268,2023-10-03,713,ball pen,5,10,5,1,00311,India
428268,2023-10-03,706,sharpener,3,8,5,1,00311,India
428268,2023-10-03,714,carbon paper,15,30,15,1,00311,India
428268,2023-10-03,705,stencil,10,20,10,1,00311,India
293221,2023-10-03,703,eraser,1,3,2,1,00044,India
293221,2023-10-03,701,gel pen,5,10,5,1,00044,India
293221,2023-10-03,714,carbon paper,15,30,15,1,00044,India
293221,2023-10-03,704,scale,5,10,5,1,00044,India
858884,2023-10-03,701,gel pen,5,10,5,1,00184,India
858884,2023-10-03,706,sharpener,3,8,5,1,00184,India
275052,2023-10-03,713,ball pen,5,10,5,1,00497,India
275052,2023-10-03,703,eraser,1,3,2,1,00497,India
906102,2023-10-03,708,sketchpen,15,40,25,1,00467,India
363481,2023-10-03,706,sharpener,3,8,5,1,00473,India
855310,2023-10-03,716,printing paper,200,400,200,1,00057,India
855310,2023-10-03,711,TD kit,150,300,150,1,00057,India
517330,2023-10-03,705,stencil,10,20,10,1,00484,India
517330,2023-10-03,712,graph paper,20,40,20,1,00484,India
517330,2023-10-03,716,printing paper,200,400,200,1,00484,India
197297,2023-10-03,707,marker,20,40,20,1,00137,India
197297,2023-10-03,705,stencil,10,20,10,1,00137,India
197297,2023-10-03,706,sharpener,3,8,5,1,00137,India
197297,2023-10-03,708,sketchpen,15,40,25,1,00137,India
713525,2023-10-03,706,sharpener,3,8,5,1,00130,India
713525,2023-10-03,705,stencil,10,20,10,1,00130,India
894032,2023-10-03,710,geometry box,100,150,50,1,00448,India
894032,2023-10-03,705,stencil,10,20,10,1,00448,India
669509,2023-10-03,711,TD kit,150,300,150,1,00241,India
567196,2023-10-03,701,gel pen,5,10,5,1,00376,India
567196,2023-10-03,707,marker,20,40,20,1,00376,India
567196,2023-10-03,708,sketchpen,15,40,25,1,00376,India
567196,2023-10-03,715,folder,5,15,10,1,00376,India
428880,2023-10-03,703,eraser,1,3,2,1,00041,India
428880,2023-10-03,702,pencil,2,5,3,1,00041,India
428880,2023-10-03,704,scale,5,10,5,1,00041,India
717705,2023-10-03,708,sketchpen,15,40,25,1,00412,India
717705,2023-10-03,716,printing paper,200,400,200,1,00412,India
471535,2023-10-03,706,sharpener,3,8,5,1,00439,India
471535,2023-10-03,713,ball pen,5,10,5,1,00439,India
471535,2023-10-03,712,graph paper,20,40,20,1,00439,India
471535,2023-10-03,714,carbon paper,15,30,15,1,00439,India
445177,2023-10-03,704,scale,5,10,5,1,00405,India
445177,2023-10-03,714,carbon paper,15,30,15,1,00405,India
445177,2023-10-03,713,ball pen,5,10,5,1,00405,India
445177,2023-10-03,715,folder,5,15,10,1,00405,India
638856,2023-10-03,702,pencil,2,5,3,1,00131,India
971833,2023-10-03,709,notebook,30,60,30,1,00398,India
971833,2023-10-03,703,eraser,1,3,2,1,00398,India
971833,2023-10-03,708,sketchpen,15,40,25,1,00398,India
915228,2023-10-03,710,geometry box,100,150,50,1,00029,India
915228,2023-10-03,703,eraser,1,3,2,1,00029,India
915228,2023-10-03,707,marker,20,40,20,1,00029,India
837382,2023-10-03,710,geometry box,100,150,50,1,00392,India
837382,2023-10-03,713,ball pen,5,10,5,1,00392,India
837382,2023-10-03,715,folder,5,15,10,1,00392,India
837382,2023-10-03,702,pencil,2,5,3,1,00392,India
979720,2023-10-03,709,notebook,30,60,30,1,00441,India
979720,2023-10-03,707,marker,20,40,20,1,00441,India
979720,2023-10-03,705,stencil,10,20,10,1,00441,India
979720,2023-10-03,711,TD kit,150,300,150,1,00441,India
847468,2023-10-03,711,TD kit,150,300,150,1,00077,India
847468,2023-10-03,706,sharpener,3,8,5,1,00077,India
847468,2023-10-03,701,gel pen,5,10,5,1,00077,India
847468,2023-10-03,710,geometry box,100,150,50,1,00077,India
106671,2023-10-03,704,scale,5,10,5,1,00222,India
106671,2023-10-03,715,folder,5,15,10,1,00222,India
106671,2023-10-03,706,sharpener,3,8,5,1,00222,India
106671,2023-10-03,711,TD kit,150,300,150,1,00222,India
779887,2023-10-03,716,printing paper,200,400,200,1,00433,India
779887,2023-10-03,714,carbon paper,15,30,15,1,00433,India
779887,2023-10-03,701,gel pen,5,10,5,1,00433,India
779887,2023-10-03,708,sketchpen,15,40,25,1,00433,India
266786,2023-10-03,709,notebook,30,60,30,1,00130,India
253199,2023-10-03,717,spiral bound book,50,100,50,1,00208,India
253199,2023-10-03,716,printing paper,200,400,200,1,00208,India
253199,2023-10-03,714,carbon paper,15,30,15,1,00208,India
253199,2023-10-03,710,geometry box,100,150,50,1,00208,India
607906,2023-10-03,710,geometry box,100,150,50,1,00370,India
607906,2023-10-03,704,scale,5,10,5,1,00370,India
607906,2023-10-03,716,printing paper,200,400,200,1,00370,India
607906,2023-10-03,705,stencil,10,20,10,1,00370,India
823230,2023-10-03,705,stencil,10,20,10,1,00344,India
823230,2023-10-03,707,marker,20,40,20,1,00344,India
823230,2023-10-03,709,notebook,30,60,30,1,00344,India
823230,2023-10-03,704,scale,5,10,5,1,00344,India
823230,2023-10-03,710,geometry box,100,150,50,1,00344,India
230079,2023-10-03,712,graph paper,20,40,20,1,00102,India
230079,2023-10-03,711,TD kit,150,300,150,1,00102,India
230079,2023-10-03,710,geometry box,100,150,50,1,00102,India
230079,2023-10-03,717,spiral bound book,50,100,50,1,00102,India
776566,2023-10-03,717,spiral bound book,50,100,50,1,00457,India
649472,2023-10-03,709,notebook,30,60,30,1,00468,India
649472,2023-10-03,715,folder,5,15,10,1,00468,India
341432,2023-10-03,707,marker,20,40,20,1,00405,India
341432,2023-10-03,708,sketchpen,15,40,25,1,00405,India
679863,2023-10-03,708,sketchpen,15,40,25,1,00436,India
679863,2023-10-03,705,stencil,10,20,10,1,00436,India
679863,2023-10-03,707,marker,20,40,20,1,00436,India
679863,2023-10-03,714,carbon paper,15,30,15,1,00436,India
679863,2023-10-03,717,spiral bound book,50,100,50,1,00436,India
425943,2023-10-04,710,geometry box,100,150,50,1,00394,India
425943,2023-10-04,707,marker,20,40,20,1,00394,India
425943,2023-10-04,708,sketchpen,15,40,25,1,00394,India
425943,2023-10-04,715,folder,5,15,10,1,00394,India
631320,2023-10-04,713,ball pen,5,10,5,1,00084,India
631320,2023-10-04,710,geometry box,100,150,50,1,00084,India
631320,2023-10-04,711,TD kit,150,300,150,1,00084,India
308307,2023-10-04,714,carbon paper,15,30,15,1,00019,India
308307,2023-10-04,710,geometry box,100,150,50,1,00019,India
308307,2023-10-04,707,marker,20,40,20,1,00019,India
378718,2023-10-04,713,ball pen,5,10,5,1,00274,India
792864,2023-10-04,704,scale,5,10,5,1,00091,India
792864,2023-10-04,706,sharpener,3,8,5,1,00091,India
792864,2023-10-04,701,gel pen,5,10,5,1,00091,India
854982,2023-10-04,703,eraser,1,3,2,1,00037,India
854982,2023-10-04,710,geometry box,100,150,50,1,00037,India
854982,2023-10-04,717,spiral bound book,50,100,50,1,00037,India
750779,2023-10-04,702,pencil,2,5,3,1,00311,India
750779,2023-10-04,704,scale,5,10,5,1,00311,India
838980,2023-10-04,706,sharpener,3,8,5,1,00130,India
187311,2023-10-04,711,TD kit,150,300,150,1,00142,India
187311,2023-10-04,716,printing paper,200,400,200,1,00142,India
187311,2023-10-04,714,carbon paper,15,30,15,1,00142,India
187311,2023-10-04,707,marker,20,40,20,1,00142,India
136429,2023-10-04,705,stencil,10,20,10,1,00261,India
136429,2023-10-04,708,sketchpen,15,40,25,1,00261,India
517706,2023-10-04,713,ball pen,5,10,5,1,00016,India
517706,2023-10-04,702,pencil,2,5,3,1,00016,India
517706,2023-10-04,707,marker,20,40,20,1,00016,India
517706,2023-10-04,717,spiral bound book,50,100,50,1,00016,India
517706,2023-10-04,703,eraser,1,3,2,1,00016,India
798821,2023-10-04,702,pencil,2,5,3,1,00091,India
798821,2023-10-04,717,spiral bound book,50,100,50,1,00091,India
332660,2023-10-04,706,sharpener,3,8,5,1,00409,India
332660,2023-10-04,710,geometry box,100,150,50,1,00409,India
332660,2023-10-04,708,sketchpen,15,40,25,1,00409,India
332660,2023-10-04,702,pencil,2,5,3,1,00409,India
583562,2023-10-04,711,TD kit,150,300,150,1,00086,India
495764,2023-10-04,712,graph paper,20,40,20,1,00438,India
495764,2023-10-04,707,marker,20,40,20,1,00438,India
495764,2023-10-04,716,printing paper,200,400,200,1,00438,India
495764,2023-10-04,704,scale,5,10,5,1,00438,India
970140,2023-10-04,705,stencil,10,20,10,1,00178,India
970140,2023-10-04,704,scale,5,10,5,1,00178,India
970140,2023-10-04,711,TD kit,150,300,150,1,00178,India
970140,2023-10-04,706,sharpener,3,8,5,1,00178,India
441493,2023-10-04,716,printing paper,200,400,200,1,00035,India
441493,2023-10-04,708,sketchpen,15,40,25,1,00035,India
441493,2023-10-04,715,folder,5,15,10,1,00035,India
441493,2023-10-04,705,stencil,10,20,10,1,00035,India
482200,2023-10-04,709,notebook,30,60,30,1,00373,India
482200,2023-10-04,703,eraser,1,3,2,1,00373,India
482200,2023-10-04,715,folder,5,15,10,1,00373,India
234468,2023-10-04,715,folder,5,15,10,1,00435,India
234468,2023-10-04,705,stencil,10,20,10,1,00435,India
234468,2023-10-04,703,eraser,1,3,2,1,00435,India
234468,2023-10-04,717,spiral bound book,50,100,50,1,00435,India
854175,2023-10-04,705,stencil,10,20,10,1,00300,India
854175,2023-10-04,710,geometry box,100,150,50,1,00300,India
854175,2023-10-04,706,sharpener,3,8,5,1,00300,India
854175,2023-10-04,709,notebook,30,60,30,1,00300,India
854175,2023-10-04,717,spiral bound book,50,100,50,1,00300,India
818369,2023-10-04,709,notebook,30,60,30,1,00054,India
818369,2023-10-04,710,geometry box,100,150,50,1,00054,India
877462,2023-10-04,702,pencil,2,5,3,1,00306,India
877462,2023-10-04,713,ball pen,5,10,5,1,00306,India
877462,2023-10-04,715,folder,5,15,10,1,00306,India
377676,2023-10-04,715,folder,5,15,10,1,00451,India
221938,2023-10-04,711,TD kit,150,300,150,1,00495,India
436328,2023-10-04,711,TD kit,150,300,150,1,00414,India
436328,2023-10-04,703,eraser,1,3,2,1,00414,India
436328,2023-10-04,707,marker,20,40,20,1,00414,India
325390,2023-10-04,701,gel pen,5,10,5,1,00150,India
325390,2023-10-04,717,spiral bound book,50,100,50,1,00150,India
325390,2023-10-04,705,stencil,10,20,10,1,00150,India
325390,2023-10-04,710,geometry box,100,150,50,1,00150,India
577852,2023-10-04,703,eraser,1,3,2,1,00275,India
577852,2023-10-04,713,ball pen,5,10,5,1,00275,India
577852,2023-10-04,716,printing paper,200,400,200,1,00275,India
577852,2023-10-04,704,scale,5,10,5,1,00275,India
618608,2023-10-04,706,sharpener,3,8,5,1,00464,India
618608,2023-10-04,711,TD kit,150,300,150,1,00464,India
791398,2023-10-04,705,stencil,10,20,10,1,00047,India
312813,2023-10-04,704,scale,5,10,5,1,00332,India
737475,2023-10-04,714,carbon paper,15,30,15,1,00364,India
737475,2023-10-04,712,graph paper,20,40,20,1,00364,India
737475,2023-10-04,711,TD kit,150,300,150,1,00364,India
811519,2023-10-04,714,carbon paper,15,30,15,1,00291,India
811519,2023-10-04,709,notebook,30,60,30,1,00291,India
811519,2023-10-04,711,TD kit,150,300,150,1,00291,India
811519,2023-10-04,710,geometry box,100,150,50,1,00291,India
811519,2023-10-04,703,eraser,1,3,2,1,00291,India
959367,2023-10-04,701,gel pen,5,10,5,1,00181,India
959367,2023-10-04,712,graph paper,20,40,20,1,00181,India
636210,2023-10-04,702,pencil,2,5,3,1,00434,India
636210,2023-10-04,708,sketchpen,15,40,25,1,00434,India
636210,2023-10-04,713,ball pen,5,10,5,1,00434,India
813279,2023-10-04,708,sketchpen,15,40,25,1,00026,India
813279,2023-10-04,714,carbon paper,15,30,15,1,00026,India
520417,2023-10-04,710,geometry box,100,150,50,1,00430,India
652367,2023-10-04,706,sharpener,3,8,5,1,00486,India
652367,2023-10-04,710,geometry box,100,150,50,1,00486,India
842729,2023-10-04,701,gel pen,5,10,5,1,00305,India
842729,2023-10-04,716,printing paper,200,400,200,1,00305,India
842729,2023-10-04,715,folder,5,15,10,1,00305,India
781922,2023-10-04,711,TD kit,150,300,150,1,00474,India
781922,2023-10-04,714,carbon paper,15,30,15,1,00474,India
781922,2023-10-04,715,folder,5,15,10,1,00474,India
781922,2023-10-04,707,marker,20,40,20,1,00474,India
425916,2023-10-04,710,geometry box,100,150,50,1,00014,India
425916,2023-10-04,715,folder,5,15,10,1,00014,India
425916,2023-10-04,716,printing paper,200,400,200,1,00014,India
425916,2023-10-04,713,ball pen,5,10,5,1,00014,India
366150,2023-10-04,704,scale,5,10,5,1,00473,India
366150,2023-10-04,706,sharpener,3,8,5,1,00473,India
198087,2023-10-05,702,pencil,2,5,3,1,00480,India
959898,2023-10-05,717,spiral bound book,50,100,50,1,00029,India
959898,2023-10-05,702,pencil,2,5,3,1,00029,India
674049,2023-10-05,706,sharpener,3,8,5,1,00057,India
674049,2023-10-05,707,marker,20,40,20,1,00057,India
674049,2023-10-05,703,eraser,1,3,2,1,00057,India
441234,2023-10-05,715,folder,5,15,10,1,00105,India
441234,2023-10-05,710,geometry box,100,150,50,1,00105,India
980020,2023-10-05,713,ball pen,5,10,5,1,00359,India
980020,2023-10-05,717,spiral bound book,50,100,50,1,00359,India
478970,2023-10-05,714,carbon paper,15,30,15,1,00461,India
478970,2023-10-05,707,marker,20,40,20,1,00461,India
478970,2023-10-05,703,eraser,1,3,2,1,00461,India
478970,2023-10-05,704,scale,5,10,5,1,00461,India
661341,2023-10-05,706,sharpener,3,8,5,1,00442,India
685867,2023-10-05,713,ball pen,5,10,5,1,00467,India
685867,2023-10-05,706,sharpener,3,8,5,1,00467,India
685867,2023-10-05,716,printing paper,200,400,200,1,00467,India
749712,2023-10-05,709,notebook,30,60,30,1,00021,India
749712,2023-10-05,717,spiral bound book,50,100,50,1,00021,India
827072,2023-10-05,714,carbon paper,15,30,15,1,00037,India
572582,2023-10-05,709,notebook,30,60,30,1,00054,India
779064,2023-10-05,715,folder,5,15,10,1,00338,India
779064,2023-10-05,702,pencil,2,5,3,1,00338,India
499366,2023-10-05,704,scale,5,10,5,1,00136,India
499366,2023-10-05,703,eraser,1,3,2,1,00136,India
527569,2023-10-05,701,gel pen,5,10,5,1,00489,India
527569,2023-10-05,709,notebook,30,60,30,1,00489,India
527569,2023-10-05,714,carbon paper,15,30,15,1,00489,India
527569,2023-10-05,706,sharpener,3,8,5,1,00489,India
945759,2023-10-05,701,gel pen,5,10,5,1,00341,India
945759,2023-10-05,710,geometry box,100,150,50,1,00341,India
945759,2023-10-05,706,sharpener,3,8,5,1,00341,India
945759,2023-10-05,703,eraser,1,3,2,1,00341,India
945759,2023-10-05,716,printing paper,200,400,200,1,00341,India
934598,2023-10-05,704,scale,5,10,5,1,00427,India
934598,2023-10-05,714,carbon paper,15,30,15,1,00427,India
681497,2023-10-05,715,folder,5,15,10,1,00484,India
681497,2023-10-05,716,printing paper,200,400,200,1,00484,India
461355,2023-10-05,709,notebook,30,60,30,1,00412,India
461355,2023-10-05,710,geometry box,100,150,50,1,00412,India
461355,2023-10-05,707,marker,20,40,20,1,00412,India
357576,2023-10-05,702,pencil,2,5,3,1,00086,India
357576,2023-10-05,710,geometry box,100,150,50,1,00086,India
847386,2023-10-05,709,notebook,30,60,30,1,00125,India
847386,2023-10-05,707,marker,20,40,20,1,00125,India
847386,2023-10-05,714,carbon paper,15,30,15,1,00125,India
816925,2023-10-05,706,sharpener,3,8,5,1,00093,India
816925,2023-10-05,708,sketchpen,15,40,25,1,00093,India
816925,2023-10-05,707,marker,20,40,20,1,00093,India
816925,2023-10-05,711,TD kit,150,300,150,1,00093,India
804454,2023-10-05,717,spiral bound book,50,100,50,1,00201,India
804454,2023-10-05,712,graph paper,20,40,20,1,00201,India
804454,2023-10-05,703,eraser,1,3,2,1,00201,India
185845,2023-10-05,708,sketchpen,15,40,25,1,00004,India
185845,2023-10-05,714,carbon paper,15,30,15,1,00004,India
185845,2023-10-05,709,notebook,30,60,30,1,00004,India
185845,2023-10-05,703,eraser,1,3,2,1,00004,India
757614,2023-10-05,701,gel pen,5,10,5,1,00476,India
757614,2023-10-05,712,graph paper,20,40,20,1,00476,India
757614,2023-10-05,703,eraser,1,3,2,1,00476,India
757614,2023-10-05,713,ball pen,5,10,5,1,00476,India
757614,2023-10-05,704,scale,5,10,5,1,00476,India
787914,2023-10-05,713,ball pen,5,10,5,1,00220,India
787914,2023-10-05,712,graph paper,20,40,20,1,00220,India
787914,2023-10-05,702,pencil,2,5,3,1,00220,India
787914,2023-10-05,701,gel pen,5,10,5,1,00220,India
233958,2023-10-05,703,eraser,1,3,2,1,00037,India
233958,2023-10-05,713,ball pen,5,10,5,1,00037,India
233958,2023-10-05,716,printing paper,200,400,200,1,00037,India
233958,2023-10-05,711,TD kit,150,300,150,1,00037,India
279604,2023-10-05,711,TD kit,150,300,150,1,00286,India
279604,2023-10-05,716,printing paper,200,400,200,1,00286,India
279604,2023-10-05,704,scale,5,10,5,1,00286,India
508159,2023-10-05,715,folder,5,15,10,1,00485,India
508159,2023-10-05,703,eraser,1,3,2,1,00485,India
822873,2023-10-05,716,printing paper,200,400,200,1,00092,India
822873,2023-10-05,711,TD kit,150,300,150,1,00092,India
822873,2023-10-05,713,ball pen,5,10,5,1,00092,India
822873,2023-10-05,709,notebook,30,60,30,1,00092,India
501676,2023-10-05,712,graph paper,20,40,20,1,00175,India
501676,2023-10-05,708,sketchpen,15,40,25,1,00175,India
501676,2023-10-05,711,TD kit,150,300,150,1,00175,India
496539,2023-10-05,703,eraser,1,3,2,1,00208,India
496539,2023-10-05,716,printing paper,200,400,200,1,00208,India
496539,2023-10-05,707,marker,20,40,20,1,00208,India
496539,2023-10-05,714,carbon paper,15,30,15,1,00208,India
796752,2023-10-05,701,gel pen,5,10,5,1,00163,India
796752,2023-10-05,707,marker,20,40,20,1,00163,India
796752,2023-10-05,712,graph paper,20,40,20,1,00163,India
575444,2023-10-05,702,pencil,2,5,3,1,00268,India
575444,2023-10-05,705,stencil,10,20,10,1,00268,India
300183,2023-10-05,715,folder,5,15,10,1,00105,India
300183,2023-10-05,702,pencil,2,5,3,1,00105,India
300183,2023-10-05,712,graph paper,20,40,20,1,00105,India
975683,2023-10-05,708,sketchpen,15,40,25,1,00106,India
975683,2023-10-05,703,eraser,1,3,2,1,00106,India
975683,2023-10-05,702,pencil,2,5,3,1,00106,India
103981,2023-10-05,716,printing paper,200,400,200,1,00160,India
103981,2023-10-05,715,folder,5,15,10,1,00160,India
103981,2023-10-05,709,notebook,30,60,30,1,00160,India
273227,2023-10-05,702,pencil,2,5,3,1,00233,India
273227,2023-10-05,716,printing paper,200,400,200,1,00233,India
466262,2023-10-06,714,carbon paper,15,30,15,1,00036,India
466262,2023-10-06,703,eraser,1,3,2,1,00036,India
466262,2023-10-06,706,sharpener,3,8,5,1,00036,India
664112,2023-10-06,701,gel pen,5,10,5,1,00250,India
664112,2023-10-06,715,folder,5,15,10,1,00250,India
664112,2023-10-06,711,TD kit,150,300,150,1,00250,India
693342,2023-10-06,715,folder,5,15,10,1,00161,India
693342,2023-10-06,713,ball pen,5,10,5,1,00161,India
156348,2023-10-06,717,spiral bound book,50,100,50,1,00086,India
156348,2023-10-06,716,printing paper,200,400,200,1,00086,India
156348,2023-10-06,715,folder,5,15,10,1,00086,India
156348,2023-10-06,711,TD kit,150,300,150,1,00086,India
156348,2023-10-06,709,notebook,30,60,30,1,00086,India
348669,2023-10-06,716,printing paper,200,400,200,1,00212,India
348669,2023-10-06,709,notebook,30,60,30,1,00212,India
348669,2023-10-06,710,geometry box,100,150,50,1,00212,India
348669,2023-10-06,705,stencil,10,20,10,1,00212,India
850087,2023-10-06,715,folder,5,15,10,1,00427,India
850087,2023-10-06,717,spiral bound book,50,100,50,1,00427,India
850087,2023-10-06,707,marker,20,40,20,1,00427,India
850087,2023-10-06,706,sharpener,3,8,5,1,00427,India
259464,2023-10-06,706,sharpener,3,8,5,1,00382,India
966353,2023-10-06,704,scale,5,10,5,1,00495,India
966353,2023-10-06,709,notebook,30,60,30,1,00495,India
518447,2023-10-06,710,geometry box,100,150,50,1,00435,India
518447,2023-10-06,707,marker,20,40,20,1,00435,India
412640,2023-10-06,716,printing paper,200,400,200,1,00076,India
412640,2023-10-06,702,pencil,2,5,3,1,00076,India
412640,2023-10-06,701,gel pen,5,10,5,1,00076,India
908253,2023-10-06,704,scale,5,10,5,1,00375,India
960994,2023-10-06,717,spiral bound book,50,100,50,1,00414,India
960994,2023-10-06,701,gel pen,5,10,5,1,00414,India
960994,2023-10-06,715,folder,5,15,10,1,00414,India
960994,2023-10-06,706,sharpener,3,8,5,1,00414,India
790768,2023-10-06,714,carbon paper,15,30,15,1,00253,India
790768,2023-10-06,703,eraser,1,3,2,1,00253,India
790768,2023-10-06,708,sketchpen,15,40,25,1,00253,India
790768,2023-10-06,702,pencil,2,5,3,1,00253,India
753556,2023-10-06,716,printing paper,200,400,200,1,00038,India
730480,2023-10-06,717,spiral bound book,50,100,50,1,00352,India
469002,2023-10-06,702,pencil,2,5,3,1,00244,India
862940,2023-10-06,702,pencil,2,5,3,1,00375,India
862940,2023-10-06,710,geometry box,100,150,50,1,00375,India
862940,2023-10-06,713,ball pen,5,10,5,1,00375,India
862940,2023-10-06,717,spiral bound book,50,100,50,1,00375,India
891861,2023-10-06,717,spiral bound book,50,100,50,1,00116,India
891861,2023-10-06,711,TD kit,150,300,150,1,00116,India
891861,2023-10-06,714,carbon paper,15,30,15,1,00116,India
891861,2023-10-06,710,geometry box,100,150,50,1,00116,India
619221,2023-10-06,709,notebook,30,60,30,1,00311,India
619221,2023-10-06,714,carbon paper,15,30,15,1,00311,India
619221,2023-10-06,701,gel pen,5,10,5,1,00311,India
619221,2023-10-06,715,folder,5,15,10,1,00311,India
373129,2023-10-06,714,carbon paper,15,30,15,1,00317,India
373129,2023-10-06,708,sketchpen,15,40,25,1,00317,India
373129,2023-10-06,716,printing paper,200,400,200,1,00317,India
242185,2023-10-06,711,TD kit,150,300,150,1,00179,India
526137,2023-10-06,713,ball pen,5,10,5,1,00071,India
526137,2023-10-06,704,scale,5,10,5,1,00071,India
526137,2023-10-06,705,stencil,10,20,10,1,00071,India
526137,2023-10-06,703,eraser,1,3,2,1,00071,India
526137,2023-10-06,702,pencil,2,5,3,1,00071,India
729889,2023-10-06,703,eraser,1,3,2,1,00449,India
729889,2023-10-06,717,spiral bound book,50,100,50,1,00449,India
640046,2023-10-06,707,marker,20,40,20,1,00487,India
640046,2023-10-06,708,sketchpen,15,40,25,1,00487,India
640046,2023-10-06,702,pencil,2,5,3,1,00487,India
505617,2023-10-06,706,sharpener,3,8,5,1,00453,India
505617,2023-10-06,703,eraser,1,3,2,1,00453,India
505617,2023-10-06,709,notebook,30,60,30,1,00453,India
505617,2023-10-06,702,pencil,2,5,3,1,00453,India
490794,2023-10-06,708,sketchpen,15,40,25,1,00118,India
490794,2023-10-06,715,folder,5,15,10,1,00118,India
490794,2023-10-06,705,stencil,10,20,10,1,00118,India
126371,2023-10-06,712,graph paper,20,40,20,1,00159,India
126371,2023-10-06,715,folder,5,15,10,1,00159,India
126371,2023-10-06,710,geometry box,100,150,50,1,00159,India
126371,2023-10-06,708,sketchpen,15,40,25,1,00159,India
126371,2023-10-06,706,sharpener,3,8,5,1,00159,India
888980,2023-10-06,714,carbon paper,15,30,15,1,00107,India
888980,2023-10-06,709,notebook,30,60,30,1,00107,India
888980,2023-10-06,710,geometry box,100,150,50,1,00107,India
888980,2023-10-06,701,gel pen,5,10,5,1,00107,India
645820,2023-10-06,713,ball pen,5,10,5,1,00061,India
255754,2023-10-06,715,folder,5,15,10,1,00427,India
255754,2023-10-06,703,eraser,1,3,2,1,00427,India
255754,2023-10-06,707,marker,20,40,20,1,00427,India
657912,2023-10-06,706,sharpener,3,8,5,1,00359,India
657912,2023-10-06,713,ball pen,5,10,5,1,00359,India
657912,2023-10-06,710,geometry box,100,150,50,1,00359,India
657912,2023-10-06,704,scale,5,10,5,1,00359,India
657912,2023-10-06,711,TD kit,150,300,150,1,00359,India
774915,2023-10-06,708,sketchpen,15,40,25,1,00049,India
774915,2023-10-06,705,stencil,10,20,10,1,00049,India
774915,2023-10-06,710,geometry box,100,150,50,1,00049,India
322744,2023-10-06,703,eraser,1,3,2,1,00179,India
322744,2023-10-06,716,printing paper,200,400,200,1,00179,India
322744,2023-10-06,701,gel pen,5,10,5,1,00179,India
322744,2023-10-06,712,graph paper,20,40,20,1,00179,India
996439,2023-10-06,714,carbon paper,15,30,15,1,00369,India
996439,2023-10-06,701,gel pen,5,10,5,1,00369,India
453541,2023-10-06,708,sketchpen,15,40,25,1,00281,India
453541,2023-10-06,704,scale,5,10,5,1,00281,India
453541,2023-10-06,712,graph paper,20,40,20,1,00281,India
269458,2023-10-06,710,geometry box,100,150,50,1,00360,India
269458,2023-10-06,705,stencil,10,20,10,1,00360,India
269458,2023-10-06,707,marker,20,40,20,1,00360,India
269458,2023-10-06,702,pencil,2,5,3,1,00360,India
269458,2023-10-06,712,graph paper,20,40,20,1,00360,India
900112,2023-10-06,710,geometry box,100,150,50,1,00170,India
900112,2023-10-06,714,carbon paper,15,30,15,1,00170,India
815172,2023-10-06,709,notebook,30,60,30,1,00161,India
815172,2023-10-06,701,gel pen,5,10,5,1,00161,India
815172,2023-10-06,717,spiral bound book,50,100,50,1,00161,India
815172,2023-10-06,711,TD kit,150,300,150,1,00161,India
378986,2023-10-06,709,notebook,30,60,30,1,00147,India
378986,2023-10-06,708,sketchpen,15,40,25,1,00147,India
595005,2023-10-06,711,TD kit,150,300,150,1,00345,India
541719,2023-10-06,702,pencil,2,5,3,1,00280,India
541719,2023-10-06,714,carbon paper,15,30,15,1,00280,India
541719,2023-10-06,703,eraser,1,3,2,1,00280,India
393687,2023-10-06,713,ball pen,5,10,5,1,00016,India
528404,2023-10-06,716,printing paper,200,400,200,1,00334,India
528404,2023-10-06,714,carbon paper,15,30,15,1,00334,India
923186,2023-10-06,705,stencil,10,20,10,1,00119,India
336475,2023-10-07,712,graph paper,20,40,20,1,00176,India
336475,2023-10-07,714,carbon paper,15,30,15,1,00176,India
552319,2023-10-07,706,sharpener,3,8,5,1,00237,India
552319,2023-10-07,701,gel pen,5,10,5,1,00237,India
552319,2023-10-07,707,marker,20,40,20,1,00237,India
932226,2023-10-07,713,ball pen,5,10,5,1,00167,India
106999,2023-10-07,703,eraser,1,3,2,1,00016,India
106999,2023-10-07,715,folder,5,15,10,1,00016,India
106999,2023-10-07,702,pencil,2,5,3,1,00016,India
106999,2023-10-07,708,sketchpen,15,40,25,1,00016,India
177570,2023-10-07,710,geometry box,100,150,50,1,00062,India
535282,2023-10-07,701,gel pen,5,10,5,1,00091,India
535282,2023-10-07,709,notebook,30,60,30,1,00091,India
480521,2023-10-07,708,sketchpen,15,40,25,1,00145,India
936973,2023-10-07,704,scale,5,10,5,1,00033,India
936973,2023-10-07,709,notebook,30,60,30,1,00033,India
936973,2023-10-07,714,carbon paper,15,30,15,1,00033,India
936973,2023-10-07,703,eraser,1,3,2,1,00033,India
936973,2023-10-07,702,pencil,2,5,3,1,00033,India
208168,2023-10-07,715,folder,5,15,10,1,00477,India
208168,2023-10-07,708,sketchpen,15,40,25,1,00477,India
779402,2023-10-07,708,sketchpen,15,40,25,1,00164,India
779402,2023-10-07,716,printing paper,200,400,200,1,00164,India
779402,2023-10-07,712,graph paper,20,40,20,1,00164,India
779402,2023-10-07,706,sharpener,3,8,5,1,00164,India
779402,2023-10-07,707,marker,20,40,20,1,00164,India
644093,2023-10-07,704,scale,5,10,5,1,00049,India
644093,2023-10-07,711,TD kit,150,300,150,1,00049,India
219927,2023-10-07,710,geometry box,100,150,50,1,00334,India
219927,2023-10-07,703,eraser,1,3,2,1,00334,India
219927,2023-10-07,709,notebook,30,60,30,1,00334,India
219927,2023-10-07,712,graph paper,20,40,20,1,00334,India
219927,2023-10-07,707,marker,20,40,20,1,00334,India
423183,2023-10-07,715,folder,5,15,10,1,00206,India
423183,2023-10-07,710,geometry box,100,150,50,1,00206,India
912128,2023-10-07,704,scale,5,10,5,1,00079,India
912128,2023-10-07,701,gel pen,5,10,5,1,00079,India
186095,2023-10-07,705,stencil,10,20,10,1,00384,India
186095,2023-10-07,704,scale,5,10,5,1,00384,India
186095,2023-10-07,717,spiral bound book,50,100,50,1,00384,India
121465,2023-10-07,710,geometry box,100,150,50,1,00001,India
121465,2023-10-07,715,folder,5,15,10,1,00001,India
121465,2023-10-07,706,sharpener,3,8,5,1,00001,India
120860,2023-10-07,714,carbon paper,15,30,15,1,00068,India
120860,2023-10-07,710,geometry box,100,150,50,1,00068,India
202793,2023-10-07,703,eraser,1,3,2,1,00291,India
202793,2023-10-07,717,spiral bound book,50,100,50,1,00291,India
202793,2023-10-07,708,sketchpen,15,40,25,1,00291,India
202793,2023-10-07,710,geometry box,100,150,50,1,00291,India
826718,2023-10-07,706,sharpener,3,8,5,1,00078,India
826718,2023-10-07,712,graph paper,20,40,20,1,00078,India
826718,2023-10-07,716,printing paper,200,400,200,1,00078,India
826718,2023-10-07,701,gel pen,5,10,5,1,00078,India
826718,2023-10-07,714,carbon paper,15,30,15,1,00078,India
249777,2023-10-07,707,marker,20,40,20,1,00139,India
249777,2023-10-07,716,printing paper,200,400,200,1,00139,India
249777,2023-10-07,703,eraser,1,3,2,1,00139,India
249777,2023-10-07,714,carbon paper,15,30,15,1,00139,India
782841,2023-10-07,711,TD kit,150,300,150,1,00106,India
782841,2023-10-07,716,printing paper,200,400,200,1,00106,India
757799,2023-10-07,713,ball pen,5,10,5,1,00341,India
546742,2023-10-07,707,marker,20,40,20,1,00043,India
546742,2023-10-07,717,spiral bound book,50,100,50,1,00043,India
546742,2023-10-07,710,geometry box,100,150,50,1,00043,India
882140,2023-10-07,703,eraser,1,3,2,1,00212,India
347538,2023-10-07,701,gel pen,5,10,5,1,00304,India
347538,2023-10-07,717,spiral bound book,50,100,50,1,00304,India
567172,2023-10-07,708,sketchpen,15,40,25,1,00332,India
490233,2023-10-07,710,geometry box,100,150,50,1,00108,India
490233,2023-10-07,713,ball pen,5,10,5,1,00108,India
490233,2023-10-07,709,notebook,30,60,30,1,00108,India
331647,2023-10-07,716,printing paper,200,400,200,1,00045,India
331647,2023-10-07,710,geometry box,100,150,50,1,00045,India
331647,2023-10-07,708,sketchpen,15,40,25,1,00045,India
331647,2023-10-07,709,notebook,30,60,30,1,00045,India
544526,2023-10-07,702,pencil,2,5,3,1,00107,India
544526,2023-10-07,717,spiral bound book,50,100,50,1,00107,India
544526,2023-10-07,709,notebook,30,60,30,1,00107,India
544526,2023-10-07,707,marker,20,40,20,1,00107,India
169510,2023-10-07,713,ball pen,5,10,5,1,00053,India
169510,2023-10-07,715,folder,5,15,10,1,00053,India
169510,2023-10-07,701,gel pen,5,10,5,1,00053,India
169510,2023-10-07,717,spiral bound book,50,100,50,1,00053,India
169510,2023-10-07,711,TD kit,150,300,150,1,00053,India
381941,2023-10-07,716,printing paper,200,400,200,1,00470,India
381941,2023-10-07,706,sharpener,3,8,5,1,00470,India
528821,2023-10-07,710,geometry box,100,150,50,1,00013,India
528821,2023-10-07,712,graph paper,20,40,20,1,00013,India
658839,2023-10-07,703,eraser,1,3,2,1,00199,India
658839,2023-10-07,709,notebook,30,60,30,1,00199,India
302461,2023-10-08,703,eraser,1,3,2,1,00111,India
640556,2023-10-08,705,stencil,10,20,10,1,00025,India
640556,2023-10-08,712,graph paper,20,40,20,1,00025,India
640556,2023-10-08,709,notebook,30,60,30,1,00025,India
455361,2023-10-08,705,stencil,10,20,10,1,00137,India
455361,2023-10-08,704,scale,5,10,5,1,00137,India
455361,2023-10-08,702,pencil,2,5,3,1,00137,India
262479,2023-10-08,702,pencil,2,5,3,1,00025,India
262479,2023-10-08,701,gel pen,5,10,5,1,00025,India
227009,2023-10-08,717,spiral bound book,50,100,50,1,00025,India
227009,2023-10-08,716,printing paper,200,400,200,1,00025,India
612629,2023-10-08,707,marker,20,40,20,1,00489,India
612629,2023-10-08,715,folder,5,15,10,1,00489,India
612629,2023-10-08,713,ball pen,5,10,5,1,00489,India
612629,2023-10-08,708,sketchpen,15,40,25,1,00489,India
612629,2023-10-08,710,geometry box,100,150,50,1,00489,India
708081,2023-10-08,703,eraser,1,3,2,1,00467,India
708081,2023-10-08,707,marker,20,40,20,1,00467,India
708081,2023-10-08,710,geometry box,100,150,50,1,00467,India
708081,2023-10-08,704,scale,5,10,5,1,00467,India
527275,2023-10-08,708,sketchpen,15,40,25,1,00019,India
527275,2023-10-08,707,marker,20,40,20,1,00019,India
547434,2023-10-08,710,geometry box,100,150,50,1,00075,India
547434,2023-10-08,705,stencil,10,20,10,1,00075,India
547434,2023-10-08,717,spiral bound book,50,100,50,1,00075,India
547434,2023-10-08,708,sketchpen,15,40,25,1,00075,India
433115,2023-10-08,716,printing paper,200,400,200,1,00324,India
433115,2023-10-08,706,sharpener,3,8,5,1,00324,India
433115,2023-10-08,714,carbon paper,15,30,15,1,00324,India
433115,2023-10-08,705,stencil,10,20,10,1,00324,India
433115,2023-10-08,702,pencil,2,5,3,1,00324,India
921552,2023-10-08,710,geometry box,100,150,50,1,00497,India
921552,2023-10-08,704,scale,5,10,5,1,00497,India
921552,2023-10-08,716,printing paper,200,400,200,1,00497,India
707973,2023-10-08,717,spiral bound book,50,100,50,1,00356,India
707973,2023-10-08,712,graph paper,20,40,20,1,00356,India
707973,2023-10-08,709,notebook,30,60,30,1,00356,India
378028,2023-10-08,714,carbon paper,15,30,15,1,00245,India
378028,2023-10-08,713,ball pen,5,10,5,1,00245,India
378028,2023-10-08,711,TD kit,150,300,150,1,00245,India
931488,2023-10-08,712,graph paper,20,40,20,1,00313,India
931488,2023-10-08,715,folder,5,15,10,1,00313,India
782268,2023-10-08,711,TD kit,150,300,150,1,00313,India
460967,2023-10-08,704,scale,5,10,5,1,00083,India
460967,2023-10-08,707,marker,20,40,20,1,00083,India
460967,2023-10-08,712,graph paper,20,40,20,1,00083,India
460967,2023-10-08,703,eraser,1,3,2,1,00083,India
460967,2023-10-08,708,sketchpen,15,40,25,1,00083,India
459916,2023-10-08,702,pencil,2,5,3,1,00022,India
502708,2023-10-08,711,TD kit,150,300,150,1,00179,India
502708,2023-10-08,704,scale,5,10,5,1,00179,India
502708,2023-10-08,713,ball pen,5,10,5,1,00179,India
502708,2023-10-08,712,graph paper,20,40,20,1,00179,India
502708,2023-10-08,705,stencil,10,20,10,1,00179,India
424849,2023-10-08,711,TD kit,150,300,150,1,00160,India
947866,2023-10-08,715,folder,5,15,10,1,00298,India
947866,2023-10-08,713,ball pen,5,10,5,1,00298,India
947866,2023-10-08,709,notebook,30,60,30,1,00298,India
422312,2023-10-08,717,spiral bound book,50,100,50,1,00272,India
422312,2023-10-08,710,geometry box,100,150,50,1,00272,India
659564,2023-10-08,707,marker,20,40,20,1,00295,India
659564,2023-10-08,710,geometry box,100,150,50,1,00295,India
659564,2023-10-08,701,gel pen,5,10,5,1,00295,India
659564,2023-10-08,703,eraser,1,3,2,1,00295,India
263047,2023-10-08,713,ball pen,5,10,5,1,00217,India
647150,2023-10-08,703,eraser,1,3,2,1,00460,India
647150,2023-10-08,710,geometry box,100,150,50,1,00460,India
647150,2023-10-08,708,sketchpen,15,40,25,1,00460,India
647150,2023-10-08,713,ball pen,5,10,5,1,00460,India
103002,2023-10-08,717,spiral bound book,50,100,50,1,00467,India
103002,2023-10-08,708,sketchpen,15,40,25,1,00467,India
103002,2023-10-08,714,carbon paper,15,30,15,1,00467,India
916554,2023-10-08,706,sharpener,3,8,5,1,00098,India
916554,2023-10-08,709,notebook,30,60,30,1,00098,India
977927,2023-10-08,711,TD kit,150,300,150,1,00454,India
977927,2023-10-08,709,notebook,30,60,30,1,00454,India
977927,2023-10-08,717,spiral bound book,50,100,50,1,00454,India
977927,2023-10-08,705,stencil,10,20,10,1,00454,India
529892,2023-10-08,706,sharpener,3,8,5,1,00498,India
529892,2023-10-08,713,ball pen,5,10,5,1,00498,India
529892,2023-10-08,711,TD kit,150,300,150,1,00498,India
658742,2023-10-08,703,eraser,1,3,2,1,00302,India
658742,2023-10-08,705,stencil,10,20,10,1,00302,India
658742,2023-10-08,711,TD kit,150,300,150,1,00302,India
658742,2023-10-08,712,graph paper,20,40,20,1,00302,India
508432,2023-10-08,717,spiral bound book,50,100,50,1,00312,India
980661,2023-10-08,716,printing paper,200,400,200,1,00193,India
980661,2023-10-08,710,geometry box,100,150,50,1,00193,India
980661,2023-10-08,707,marker,20,40,20,1,00193,India
980661,2023-10-08,705,stencil,10,20,10,1,00193,India
619418,2023-10-08,713,ball pen,5,10,5,1,00210,India
502706,2023-10-08,705,stencil,10,20,10,1,00402,India
502706,2023-10-08,708,sketchpen,15,40,25,1,00402,India
109763,2023-10-08,703,eraser,1,3,2,1,00308,India
109763,2023-10-08,702,pencil,2,5,3,1,00308,India
711513,2023-10-08,711,TD kit,150,300,150,1,00126,India
561023,2023-10-08,715,folder,5,15,10,1,00141,India
561023,2023-10-08,707,marker,20,40,20,1,00141,India
561023,2023-10-08,704,scale,5,10,5,1,00141,India
901421,2023-10-09,705,stencil,10,20,10,1,00413,India
901421,2023-10-09,701,gel pen,5,10,5,1,00413,India
901421,2023-10-09,711,TD kit,150,300,150,1,00413,India
901421,2023-10-09,710,geometry box,100,150,50,1,00413,India
182296,2023-10-09,701,gel pen,5,10,5,1,00235,India
182296,2023-10-09,715,folder,5,15,10,1,00235,India
182296,2023-10-09,704,scale,5,10,5,1,00235,India
760761,2023-10-09,706,sharpener,3,8,5,1,00154,India
760761,2023-10-09,712,graph paper,20,40,20,1,00154,India
760761,2023-10-09,708,sketchpen,15,40,25,1,00154,India
881479,2023-10-09,709,notebook,30,60,30,1,00324,India
881479,2023-10-09,714,carbon paper,15,30,15,1,00324,India
881479,2023-10-09,703,eraser,1,3,2,1,00324,India
881479,2023-10-09,717,spiral bound book,50,100,50,1,00324,India
943558,2023-10-09,709,notebook,30,60,30,1,00323,India
943558,2023-10-09,706,sharpener,3,8,5,1,00323,India
591761,2023-10-09,709,notebook,30,60,30,1,00226,India
591761,2023-10-09,707,marker,20,40,20,1,00226,India
113282,2023-10-09,717,spiral bound book,50,100,50,1,00136,India
113282,2023-10-09,702,pencil,2,5,3,1,00136,India
113282,2023-10-09,713,ball pen,5,10,5,1,00136,India
113282,2023-10-09,703,eraser,1,3,2,1,00136,India
826344,2023-10-09,715,folder,5,15,10,1,00374,India
826344,2023-10-09,710,geometry box,100,150,50,1,00374,India
215224,2023-10-09,710,geometry box,100,150,50,1,00339,India
230674,2023-10-09,703,eraser,1,3,2,1,00405,India
230674,2023-10-09,706,sharpener,3,8,5,1,00405,India
230674,2023-10-09,708,sketchpen,15,40,25,1,00405,India
500909,2023-10-09,704,scale,5,10,5,1,00193,India
185867,2023-10-09,702,pencil,2,5,3,1,00096,India
185867,2023-10-09,712,graph paper,20,40,20,1,00096,India
566518,2023-10-09,716,printing paper,200,400,200,1,00300,India
566518,2023-10-09,710,geometry box,100,150,50,1,00300,India
566518,2023-10-09,702,pencil,2,5,3,1,00300,India
566518,2023-10-09,714,carbon paper,15,30,15,1,00300,India
566518,2023-10-09,706,sharpener,3,8,5,1,00300,India
239396,2023-10-09,712,graph paper,20,40,20,1,00076,India
239396,2023-10-09,715,folder,5,15,10,1,00076,India
740597,2023-10-09,706,sharpener,3,8,5,1,00435,India
740597,2023-10-09,711,TD kit,150,300,150,1,00435,India
740597,2023-10-09,701,gel pen,5,10,5,1,00435,India
740597,2023-10-09,712,graph paper,20,40,20,1,00435,India
299687,2023-10-09,714,carbon paper,15,30,15,1,00204,India
982424,2023-10-09,713,ball pen,5,10,5,1,00389,India
982424,2023-10-09,702,pencil,2,5,3,1,00389,India
982424,2023-10-09,701,gel pen,5,10,5,1,00389,India
982424,2023-10-09,703,eraser,1,3,2,1,00389,India
982424,2023-10-09,716,printing paper,200,400,200,1,00389,India
503528,2023-10-09,717,spiral bound book,50,100,50,1,00332,India
503528,2023-10-09,709,notebook,30,60,30,1,00332,India
503528,2023-10-09,701,gel pen,5,10,5,1,00332,India
503528,2023-10-09,712,graph paper,20,40,20,1,00332,India
214184,2023-10-09,715,folder,5,15,10,1,00009,India
673911,2023-10-09,707,marker,20,40,20,1,00455,India
633255,2023-10-09,712,graph paper,20,40,20,1,00116,India
633255,2023-10-09,713,ball pen,5,10,5,1,00116,India
680041,2023-10-09,712,graph paper,20,40,20,1,00112,India
496947,2023-10-09,713,ball pen,5,10,5,1,00132,India
496947,2023-10-09,714,carbon paper,15,30,15,1,00132,India
524529,2023-10-09,716,printing paper,200,400,200,1,00489,India
524529,2023-10-09,704,scale,5,10,5,1,00489,India
578637,2023-10-09,704,scale,5,10,5,1,00045,India
578637,2023-10-09,708,sketchpen,15,40,25,1,00045,India
578637,2023-10-09,713,ball pen,5,10,5,1,00045,India
578637,2023-10-09,702,pencil,2,5,3,1,00045,India
578637,2023-10-09,710,geometry box,100,150,50,1,00045,India
194006,2023-10-09,712,graph paper,20,40,20,1,00284,India
194006,2023-10-09,707,marker,20,40,20,1,00284,India
194006,2023-10-09,716,printing paper,200,400,200,1,00284,India
194006,2023-10-09,711,TD kit,150,300,150,1,00284,India
479612,2023-10-09,712,graph paper,20,40,20,1,00453,India
479612,2023-10-09,706,sharpener,3,8,5,1,00453,India
479612,2023-10-09,703,eraser,1,3,2,1,00453,India
479612,2023-10-09,717,spiral bound book,50,100,50,1,00453,India
785455,2023-10-09,711,TD kit,150,300,150,1,00060,India
785455,2023-10-09,716,printing paper,200,400,200,1,00060,India
467817,2023-10-09,703,eraser,1,3,2,1,00332,India
467817,2023-10-09,706,sharpener,3,8,5,1,00332,India
467817,2023-10-09,710,geometry box,100,150,50,1,00332,India
467817,2023-10-09,701,gel pen,5,10,5,1,00332,India
866748,2023-10-09,711,TD kit,150,300,150,1,00050,India
866748,2023-10-09,703,eraser,1,3,2,1,00050,India
866748,2023-10-09,714,carbon paper,15,30,15,1,00050,India
866748,2023-10-09,713,ball pen,5,10,5,1,00050,India
875030,2023-10-09,702,pencil,2,5,3,1,00291,India
875030,2023-10-09,711,TD kit,150,300,150,1,00291,India
875030,2023-10-09,709,notebook,30,60,30,1,00291,India
875030,2023-10-09,706,sharpener,3,8,5,1,00291,India
894674,2023-10-09,715,folder,5,15,10,1,00346,India
894674,2023-10-09,711,TD kit,150,300,150,1,00346,India
894674,2023-10-09,713,ball pen,5,10,5,1,00346,India
894674,2023-10-09,703,eraser,1,3,2,1,00346,India
424304,2023-10-09,709,notebook,30,60,30,1,00282,India
424304,2023-10-09,716,printing paper,200,400,200,1,00282,India
217364,2023-10-09,713,ball pen,5,10,5,1,00014,India
217364,2023-10-09,716,printing paper,200,400,200,1,00014,India
217364,2023-10-09,707,marker,20,40,20,1,00014,India
217364,2023-10-09,717,spiral bound book,50,100,50,1,00014,India
383632,2023-10-09,715,folder,5,15,10,1,00069,India
383632,2023-10-09,706,sharpener,3,8,5,1,00069,India
383632,2023-10-09,705,stencil,10,20,10,1,00069,India
383632,2023-10-09,707,marker,20,40,20,1,00069,India
383632,2023-10-09,717,spiral bound book,50,100,50,1,00069,India
608400,2023-10-09,716,printing paper,200,400,200,1,00219,India
608400,2023-10-09,706,sharpener,3,8,5,1,00219,India
608400,2023-10-09,710,geometry box,100,150,50,1,00219,India
755313,2023-10-09,702,pencil,2,5,3,1,00431,India
755313,2023-10-09,710,geometry box,100,150,50,1,00431,India
755313,2023-10-09,709,notebook,30,60,30,1,00431,India
755313,2023-10-09,704,scale,5,10,5,1,00431,India
984303,2023-10-09,717,spiral bound book,50,100,50,1,00121,India
984303,2023-10-09,710,geometry box,100,150,50,1,00121,India
984303,2023-10-09,714,carbon paper,15,30,15,1,00121,India
984303,2023-10-09,701,gel pen,5,10,5,1,00121,India
984303,2023-10-09,706,sharpener,3,8,5,1,00121,India
822893,2023-10-09,714,carbon paper,15,30,15,1,00124,India
822893,2023-10-09,708,sketchpen,15,40,25,1,00124,India
822893,2023-10-09,705,stencil,10,20,10,1,00124,India
304796,2023-10-09,702,pencil,2,5,3,1,00112,India
304796,2023-10-09,715,folder,5,15,10,1,00112,India
304796,2023-10-09,710,geometry box,100,150,50,1,00112,India
923042,2023-10-09,709,notebook,30,60,30,1,00249,India
923042,2023-10-09,716,printing paper,200,400,200,1,00249,India
923042,2023-10-09,708,sketchpen,15,40,25,1,00249,India
734866,2023-10-09,710,geometry box,100,150,50,1,00356,India
734866,2023-10-09,715,folder,5,15,10,1,00356,India
828085,2023-10-09,703,eraser,1,3,2,1,00198,India
229294,2023-10-09,715,folder,5,15,10,1,00220,India
610852,2023-10-10,710,geometry box,100,150,50,1,00449,India
610852,2023-10-10,707,marker,20,40,20,1,00449,India
610852,2023-10-10,715,folder,5,15,10,1,00449,India
286460,2023-10-10,716,printing paper,200,400,200,1,00056,India
286460,2023-10-10,702,pencil,2,5,3,1,00056,India
999594,2023-10-10,715,folder,5,15,10,1,00045,India
724938,2023-10-10,717,spiral bound book,50,100,50,1,00338,India
724938,2023-10-10,712,graph paper,20,40,20,1,00338,India
967771,2023-10-10,701,gel pen,5,10,5,1,00447,India
967771,2023-10-10,708,sketchpen,15,40,25,1,00447,India
913715,2023-10-10,708,sketchpen,15,40,25,1,00169,India
913715,2023-10-10,702,pencil,2,5,3,1,00169,India
900921,2023-10-10,711,TD kit,150,300,150,1,00152,India
900921,2023-10-10,704,scale,5,10,5,1,00152,India
307788,2023-10-10,716,printing paper,200,400,200,1,00133,India
307788,2023-10-10,706,sharpener,3,8,5,1,00133,India
782736,2023-10-10,715,folder,5,15,10,1,00007,India
782736,2023-10-10,707,marker,20,40,20,1,00007,India
782736,2023-10-10,701,gel pen,5,10,5,1,00007,India
782736,2023-10-10,710,geometry box,100,150,50,1,00007,India
108648,2023-10-10,703,eraser,1,3,2,1,00231,India
539247,2023-10-10,704,scale,5,10,5,1,00197,India
808699,2023-10-10,712,graph paper,20,40,20,1,00358,India
808699,2023-10-10,710,geometry box,100,150,50,1,00358,India
808699,2023-10-10,702,pencil,2,5,3,1,00358,India
417561,2023-10-10,707,marker,20,40,20,1,00327,India
675129,2023-10-10,702,pencil,2,5,3,1,00076,India
675129,2023-10-10,707,marker,20,40,20,1,00076,India
348019,2023-10-10,702,pencil,2,5,3,1,00219,India
348019,2023-10-10,711,TD kit,150,300,150,1,00219,India
348019,2023-10-10,714,carbon paper,15,30,15,1,00219,India
348019,2023-10-10,706,sharpener,3,8,5,1,00219,India
795668,2023-10-10,706,sharpener,3,8,5,1,00125,India
795668,2023-10-10,714,carbon paper,15,30,15,1,00125,India
364673,2023-10-10,707,marker,20,40,20,1,00396,India
364673,2023-10-10,711,TD kit,150,300,150,1,00396,India
364673,2023-10-10,716,printing paper,200,400,200,1,00396,India
979516,2023-10-10,706,sharpener,3,8,5,1,00189,India
799897,2023-10-10,717,spiral bound book,50,100,50,1,00035,India
799897,2023-10-10,716,printing paper,200,400,200,1,00035,India
799897,2023-10-10,714,carbon paper,15,30,15,1,00035,India
799897,2023-10-10,703,eraser,1,3,2,1,00035,India
799897,2023-10-10,711,TD kit,150,300,150,1,00035,India
861105,2023-10-10,712,graph paper,20,40,20,1,00099,India
861105,2023-10-10,714,carbon paper,15,30,15,1,00099,India
861105,2023-10-10,715,folder,5,15,10,1,00099,India
861105,2023-10-10,702,pencil,2,5,3,1,00099,India
600174,2023-10-10,716,printing paper,200,400,200,1,00134,India
600174,2023-10-10,708,sketchpen,15,40,25,1,00134,India
657875,2023-10-10,711,TD kit,150,300,150,1,00020,India
676172,2023-10-10,710,geometry box,100,150,50,1,00053,India
676172,2023-10-10,704,scale,5,10,5,1,00053,India
519543,2023-10-10,715,folder,5,15,10,1,00320,India
519543,2023-10-10,710,geometry box,100,150,50,1,00320,India
519543,2023-10-10,713,ball pen,5,10,5,1,00320,India
519543,2023-10-10,716,printing paper,200,400,200,1,00320,India
921353,2023-10-10,714,carbon paper,15,30,15,1,00425,India
921353,2023-10-10,702,pencil,2,5,3,1,00425,India
921353,2023-10-10,713,ball pen,5,10,5,1,00425,India
921353,2023-10-10,709,notebook,30,60,30,1,00425,India
753158,2023-10-10,703,eraser,1,3,2,1,00151,India
753158,2023-10-10,701,gel pen,5,10,5,1,00151,India
371450,2023-10-10,711,TD kit,150,300,150,1,00370,India
371450,2023-10-10,706,sharpener,3,8,5,1,00370,India
371450,2023-10-10,708,sketchpen,15,40,25,1,00370,India
160573,2023-10-10,702,pencil,2,5,3,1,00060,India
478109,2023-10-10,704,scale,5,10,5,1,00423,India
478109,2023-10-10,707,marker,20,40,20,1,00423,India
478109,2023-10-10,712,graph paper,20,40,20,1,00423,India
886617,2023-10-10,716,printing paper,200,400,200,1,00470,India
933283,2023-10-10,702,pencil,2,5,3,1,00389,India
933283,2023-10-10,716,printing paper,200,400,200,1,00389,India
933283,2023-10-10,708,sketchpen,15,40,25,1,00389,India
933283,2023-10-10,717,spiral bound book,50,100,50,1,00389,India
477636,2023-10-10,707,marker,20,40,20,1,00008,India
477636,2023-10-10,713,ball pen,5,10,5,1,00008,India
477636,2023-10-10,711,TD kit,150,300,150,1,00008,India
477636,2023-10-10,717,spiral bound book,50,100,50,1,00008,India
477636,2023-10-10,709,notebook,30,60,30,1,00008,India
947314,2023-10-10,704,scale,5,10,5,1,00158,India
947314,2023-10-10,701,gel pen,5,10,5,1,00158,India
947314,2023-10-10,706,sharpener,3,8,5,1,00158,India
249485,2023-10-10,701,gel pen,5,10,5,1,00213,India
249485,2023-10-10,714,carbon paper,15,30,15,1,00213,India
914084,2023-10-10,703,eraser,1,3,2,1,00400,India
396061,2023-10-10,708,sketchpen,15,40,25,1,00375,India
396061,2023-10-10,701,gel pen,5,10,5,1,00375,India
597491,2023-10-10,713,ball pen,5,10,5,1,00134,India
597491,2023-10-10,709,notebook,30,60,30,1,00134,India
597491,2023-10-10,715,folder,5,15,10,1,00134,India
597491,2023-10-10,712,graph paper,20,40,20,1,00134,India
597491,2023-10-10,703,eraser,1,3,2,1,00134,India
411892,2023-10-10,709,notebook,30,60,30,1,00491,India
411892,2023-10-10,711,TD kit,150,300,150,1,00491,India
411892,2023-10-10,706,sharpener,3,8,5,1,00491,India
411892,2023-10-10,710,geometry box,100,150,50,1,00491,India
411892,2023-10-10,707,marker,20,40,20,1,00491,India
918203,2023-10-10,706,sharpener,3,8,5,1,00167,India
918203,2023-10-10,701,gel pen,5,10,5,1,00167,India
918203,2023-10-10,703,eraser,1,3,2,1,00167,India
918203,2023-10-10,709,notebook,30,60,30,1,00167,India
786071,2023-10-10,715,folder,5,15,10,1,00117,India
173309,2023-10-10,716,printing paper,200,400,200,1,00077,India
173309,2023-10-10,702,pencil,2,5,3,1,00077,India
173309,2023-10-10,707,marker,20,40,20,1,00077,India
239085,2023-10-10,701,gel pen,5,10,5,1,00318,India
239085,2023-10-10,709,notebook,30,60,30,1,00318,India
239085,2023-10-10,702,pencil,2,5,3,1,00318,India
239085,2023-10-10,712,graph paper,20,40,20,1,00318,India
239085,2023-10-10,705,stencil,10,20,10,1,00318,India
511268,2023-10-10,712,graph paper,20,40,20,1,00244,India
511268,2023-10-10,707,marker,20,40,20,1,00244,India
511268,2023-10-10,708,sketchpen,15,40,25,1,00244,India
511268,2023-10-10,706,sharpener,3,8,5,1,00244,India
940115,2023-10-10,713,ball pen,5,10,5,1,00139,India
940115,2023-10-10,706,sharpener,3,8,5,1,00139,India
940115,2023-10-10,717,spiral bound book,50,100,50,1,00139,India
338464,2023-10-10,707,marker,20,40,20,1,00118,India
338464,2023-10-10,702,pencil,2,5,3,1,00118,India
338464,2023-10-10,711,TD kit,150,300,150,1,00118,India
338464,2023-10-10,701,gel pen,5,10,5,1,00118,India
338464,2023-10-10,712,graph paper,20,40,20,1,00118,India
773758,2023-10-11,704,scale,5,10,5,1,00411,India
877684,2023-10-11,706,sharpener,3,8,5,1,00226,India
897273,2023-10-11,709,notebook,30,60,30,1,00390,India
897273,2023-10-11,706,sharpener,3,8,5,1,00390,India
897273,2023-10-11,711,TD kit,150,300,150,1,00390,India
897273,2023-10-11,705,stencil,10,20,10,1,00390,India
897273,2023-10-11,714,carbon paper,15,30,15,1,00390,India
106083,2023-10-11,708,sketchpen,15,40,25,1,00110,India
106083,2023-10-11,709,notebook,30,60,30,1,00110,India
106083,2023-10-11,707,marker,20,40,20,1,00110,India
106083,2023-10-11,706,sharpener,3,8,5,1,00110,India
780539,2023-10-11,715,folder,5,15,10,1,00450,India
780539,2023-10-11,709,notebook,30,60,30,1,00450,India
780539,2023-10-11,708,sketchpen,15,40,25,1,00450,India
780539,2023-10-11,716,printing paper,200,400,200,1,00450,India
682539,2023-10-11,704,scale,5,10,5,1,00170,India
682539,2023-10-11,708,sketchpen,15,40,25,1,00170,India
682539,2023-10-11,701,gel pen,5,10,5,1,00170,India
487683,2023-10-11,701,gel pen,5,10,5,1,00221,India
487683,2023-10-11,709,notebook,30,60,30,1,00221,India
487683,2023-10-11,714,carbon paper,15,30,15,1,00221,India
475065,2023-10-11,714,carbon paper,15,30,15,1,00293,India
475065,2023-10-11,715,folder,5,15,10,1,00293,India
475065,2023-10-11,702,pencil,2,5,3,1,00293,India
475065,2023-10-11,716,printing paper,200,400,200,1,00293,India
530766,2023-10-11,711,TD kit,150,300,150,1,00173,India
589332,2023-10-11,702,pencil,2,5,3,1,00340,India
589332,2023-10-11,705,stencil,10,20,10,1,00340,India
255110,2023-10-11,707,marker,20,40,20,1,00159,India
255110,2023-10-11,704,scale,5,10,5,1,00159,India
255110,2023-10-11,711,TD kit,150,300,150,1,00159,India
255110,2023-10-11,709,notebook,30,60,30,1,00159,India
255110,2023-10-11,714,carbon paper,15,30,15,1,00159,India
858841,2023-10-11,713,ball pen,5,10,5,1,00138,India
858841,2023-10-11,706,sharpener,3,8,5,1,00138,India
858841,2023-10-11,712,graph paper,20,40,20,1,00138,India
858841,2023-10-11,709,notebook,30,60,30,1,00138,India
858841,2023-10-11,708,sketchpen,15,40,25,1,00138,India
645540,2023-10-11,706,sharpener,3,8,5,1,00453,India
983792,2023-10-11,706,sharpener,3,8,5,1,00379,India
983792,2023-10-11,709,notebook,30,60,30,1,00379,India
983792,2023-10-11,715,folder,5,15,10,1,00379,India
189893,2023-10-11,707,marker,20,40,20,1,00500,India
760721,2023-10-11,714,carbon paper,15,30,15,1,00340,India
760721,2023-10-11,717,spiral bound book,50,100,50,1,00340,India
760721,2023-10-11,710,geometry box,100,150,50,1,00340,India
150097,2023-10-11,701,gel pen,5,10,5,1,00384,India
803832,2023-10-11,709,notebook,30,60,30,1,00121,India
803832,2023-10-11,713,ball pen,5,10,5,1,00121,India
726822,2023-10-11,707,marker,20,40,20,1,00422,India
368607,2023-10-11,714,carbon paper,15,30,15,1,00310,India
368607,2023-10-11,715,folder,5,15,10,1,00310,India
433026,2023-10-11,713,ball pen,5,10,5,1,00439,India
433026,2023-10-11,703,eraser,1,3,2,1,00439,India
433026,2023-10-11,706,sharpener,3,8,5,1,00439,India
433026,2023-10-11,705,stencil,10,20,10,1,00439,India
449933,2023-10-11,712,graph paper,20,40,20,1,00397,India
976429,2023-10-11,703,eraser,1,3,2,1,00067,India
910384,2023-10-11,707,marker,20,40,20,1,00434,India
910384,2023-10-11,714,carbon paper,15,30,15,1,00434,India
910384,2023-10-11,713,ball pen,5,10,5,1,00434,India
910384,2023-10-11,712,graph paper,20,40,20,1,00434,India
910384,2023-10-11,717,spiral bound book,50,100,50,1,00434,India
911643,2023-10-11,712,graph paper,20,40,20,1,00368,India
911643,2023-10-11,707,marker,20,40,20,1,00368,India
262144,2023-10-11,713,ball pen,5,10,5,1,00309,India
766212,2023-10-11,717,spiral bound book,50,100,50,1,00332,India
766212,2023-10-11,714,carbon paper,15,30,15,1,00332,India
766212,2023-10-11,703,eraser,1,3,2,1,00332,India
766212,2023-10-11,716,printing paper,200,400,200,1,00332,India
123179,2023-10-11,714,carbon paper,15,30,15,1,00192,India
870097,2023-10-11,704,scale,5,10,5,1,00454,India
870097,2023-10-11,706,sharpener,3,8,5,1,00454,India
870097,2023-10-11,713,ball pen,5,10,5,1,00454,India
562252,2023-10-11,703,eraser,1,3,2,1,00104,India
562252,2023-10-11,707,marker,20,40,20,1,00104,India
219162,2023-10-11,702,pencil,2,5,3,1,00257,India
219162,2023-10-11,707,marker,20,40,20,1,00257,India
219162,2023-10-11,713,ball pen,5,10,5,1,00257,India
219162,2023-10-11,703,eraser,1,3,2,1,00257,India
264710,2023-10-11,708,sketchpen,15,40,25,1,00007,India
264710,2023-10-11,710,geometry box,100,150,50,1,00007,India
264710,2023-10-11,716,printing paper,200,400,200,1,00007,India
264710,2023-10-11,715,folder,5,15,10,1,00007,India
848305,2023-10-11,713,ball pen,5,10,5,1,00276,India
848305,2023-10-11,710,geometry box,100,150,50,1,00276,India
673249,2023-10-11,703,eraser,1,3,2,1,00016,India
673249,2023-10-11,701,gel pen,5,10,5,1,00016,India
673249,2023-10-11,704,scale,5,10,5,1,00016,India
673249,2023-10-11,715,folder,5,15,10,1,00016,India
673249,2023-10-11,711,TD kit,150,300,150,1,00016,India
774822,2023-10-11,703,eraser,1,3,2,1,00367,India
774822,2023-10-11,712,graph paper,20,40,20,1,00367,India
774822,2023-10-11,706,sharpener,3,8,5,1,00367,India
209554,2023-10-11,701,gel pen,5,10,5,1,00419,India
209554,2023-10-11,707,marker,20,40,20,1,00419,India
209554,2023-10-11,706,sharpener,3,8,5,1,00419,India
652346,2023-10-11,712,graph paper,20,40,20,1,00179,India
652346,2023-10-11,701,gel pen,5,10,5,1,00179,India
652346,2023-10-11,703,eraser,1,3,2,1,00179,India
290481,2023-10-11,712,graph paper,20,40,20,1,00192,India
602188,2023-10-12,710,geometry box,100,150,50,1,00420,India
602188,2023-10-12,708,sketchpen,15,40,25,1,00420,India
602188,2023-10-12,707,marker,20,40,20,1,00420,India
602188,2023-10-12,704,scale,5,10,5,1,00420,India
326637,2023-10-12,715,folder,5,15,10,1,00312,India
326637,2023-10-12,708,sketchpen,15,40,25,1,00312,India
285086,2023-10-12,703,eraser,1,3,2,1,00221,India
285086,2023-10-12,705,stencil,10,20,10,1,00221,India
285086,2023-10-12,702,pencil,2,5,3,1,00221,India
285086,2023-10-12,701,gel pen,5,10,5,1,00221,India
883437,2023-10-12,709,notebook,30,60,30,1,00320,India
883437,2023-10-12,714,carbon paper,15,30,15,1,00320,India
883437,2023-10-12,707,marker,20,40,20,1,00320,India
883437,2023-10-12,713,ball pen,5,10,5,1,00320,India
626349,2023-10-12,714,carbon paper,15,30,15,1,00362,India
626349,2023-10-12,713,ball pen,5,10,5,1,00362,India
626349,2023-10-12,705,stencil,10,20,10,1,00362,India
626349,2023-10-12,702,pencil,2,5,3,1,00362,India
366608,2023-10-12,710,geometry box,100,150,50,1,00036,India
278138,2023-10-12,703,eraser,1,3,2,1,00474,India
278138,2023-10-12,705,stencil,10,20,10,1,00474,India
278138,2023-10-12,708,sketchpen,15,40,25,1,00474,India
278138,2023-10-12,702,pencil,2,5,3,1,00474,India
850035,2023-10-12,707,marker,20,40,20,1,00242,India
850035,2023-10-12,709,notebook,30,60,30,1,00242,India
850035,2023-10-12,706,sharpener,3,8,5,1,00242,India
722136,2023-10-12,714,carbon paper,15,30,15,1,00271,India
722136,2023-10-12,710,geometry box,100,150,50,1,00271,India
664544,2023-10-12,712,graph paper,20,40,20,1,00387,India
664544,2023-10-12,714,carbon paper,15,30,15,1,00387,India
664544,2023-10-12,717,spiral bound book,50,100,50,1,00387,India
103846,2023-10-12,704,scale,5,10,5,1,00395,India
103846,2023-10-12,712,graph paper,20,40,20,1,00395,India
103846,2023-10-12,714,carbon paper,15,30,15,1,00395,India
991217,2023-10-12,703,eraser,1,3,2,1,00027,India
991217,2023-10-12,709,notebook,30,60,30,1,00027,India
991217,2023-10-12,708,sketchpen,15,40,25,1,00027,India
991217,2023-10-12,706,sharpener,3,8,5,1,00027,India
262234,2023-10-12,717,spiral bound book,50,100,50,1,00204,India
262234,2023-10-12,707,marker,20,40,20,1,00204,India
262234,2023-10-12,704,scale,5,10,5,1,00204,India
592468,2023-10-12,712,graph paper,20,40,20,1,00219,India
951370,2023-10-12,704,scale,5,10,5,1,00072,India
320332,2023-10-12,707,marker,20,40,20,1,00201,India
320332,2023-10-12,705,stencil,10,20,10,1,00201,India
225832,2023-10-12,711,TD kit,150,300,150,1,00225,India
225832,2023-10-12,716,printing paper,200,400,200,1,00225,India
559926,2023-10-12,708,sketchpen,15,40,25,1,00289,India
559926,2023-10-12,716,printing paper,200,400,200,1,00289,India
559926,2023-10-12,711,TD kit,150,300,150,1,00289,India
560507,2023-10-12,712,graph paper,20,40,20,1,00443,India
560507,2023-10-12,715,folder,5,15,10,1,00443,India
560507,2023-10-12,709,notebook,30,60,30,1,00443,India
560507,2023-10-12,717,spiral bound book,50,100,50,1,00443,India
362083,2023-10-12,716,printing paper,200,400,200,1,00366,India
362083,2023-10-12,711,TD kit,150,300,150,1,00366,India
362083,2023-10-12,706,sharpener,3,8,5,1,00366,India
304149,2023-10-12,702,pencil,2,5,3,1,00263,India
304149,2023-10-12,711,TD kit,150,300,150,1,00263,India
304149,2023-10-12,706,sharpener,3,8,5,1,00263,India
304149,2023-10-12,709,notebook,30,60,30,1,00263,India
484324,2023-10-12,715,folder,5,15,10,1,00351,India
484324,2023-10-12,712,graph paper,20,40,20,1,00351,India
484324,2023-10-12,706,sharpener,3,8,5,1,00351,India
327409,2023-10-12,713,ball pen,5,10,5,1,00055,India
963267,2023-10-12,712,graph paper,20,40,20,1,00247,India
963267,2023-10-12,708,sketchpen,15,40,25,1,00247,India
791896,2023-10-12,713,ball pen,5,10,5,1,00226,India
408798,2023-10-12,716,printing paper,200,400,200,1,00194,India
408798,2023-10-12,713,ball pen,5,10,5,1,00194,India
948501,2023-10-12,704,scale,5,10,5,1,00119,India
948501,2023-10-12,706,sharpener,3,8,5,1,00119,India
948501,2023-10-12,716,printing paper,200,400,200,1,00119,India
692789,2023-10-12,717,spiral bound book,50,100,50,1,00008,India
692789,2023-10-12,715,folder,5,15,10,1,00008,India
692789,2023-10-12,702,pencil,2,5,3,1,00008,India
877994,2023-10-12,708,sketchpen,15,40,25,1,00442,India
877994,2023-10-12,705,stencil,10,20,10,1,00442,India
877994,2023-10-12,711,TD kit,150,300,150,1,00442,India
216273,2023-10-12,702,pencil,2,5,3,1,00118,India
572269,2023-10-12,708,sketchpen,15,40,25,1,00202,India
693398,2023-10-12,714,carbon paper,15,30,15,1,00370,India
911179,2023-10-13,701,gel pen,5,10,5,1,00441,India
303641,2023-10-13,711,TD kit,150,300,150,1,00225,India
303641,2023-10-13,704,scale,5,10,5,1,00225,India
303641,2023-10-13,712,graph paper,20,40,20,1,00225,India
303641,2023-10-13,716,printing paper,200,400,200,1,00225,India
926732,2023-10-13,713,ball pen,5,10,5,1,00383,India
926732,2023-10-13,711,TD kit,150,300,150,1,00383,India
926732,2023-10-13,716,printing paper,200,400,200,1,00383,India
926732,2023-10-13,717,spiral bound book,50,100,50,1,00383,India
991978,2023-10-13,715,folder,5,15,10,1,00073,India
991978,2023-10-13,716,printing paper,200,400,200,1,00073,India
926433,2023-10-13,711,TD kit,150,300,150,1,00238,India
926433,2023-10-13,714,carbon paper,15,30,15,1,00238,India
307641,2023-10-13,717,spiral bound book,50,100,50,1,00332,India
839057,2023-10-13,707,marker,20,40,20,1,00256,India
408904,2023-10-13,708,sketchpen,15,40,25,1,00201,India
408904,2023-10-13,701,gel pen,5,10,5,1,00201,India
408904,2023-10-13,706,sharpener,3,8,5,1,00201,India
408904,2023-10-13,704,scale,5,10,5,1,00201,India
408904,2023-10-13,713,ball pen,5,10,5,1,00201,India
671395,2023-10-13,712,graph paper,20,40,20,1,00149,India
671395,2023-10-13,702,pencil,2,5,3,1,00149,India
972868,2023-10-13,711,TD kit,150,300,150,1,00258,India
972868,2023-10-13,708,sketchpen,15,40,25,1,00258,India
914106,2023-10-13,705,stencil,10,20,10,1,00067,India
914106,2023-10-13,706,sharpener,3,8,5,1,00067,India
914106,2023-10-13,713,ball pen,5,10,5,1,00067,India
914106,2023-10-13,708,sketchpen,15,40,25,1,00067,India
540578,2023-10-13,713,ball pen,5,10,5,1,00189,India
174595,2023-10-13,705,stencil,10,20,10,1,00488,India
174595,2023-10-13,713,ball pen,5,10,5,1,00488,India
174595,2023-10-13,717,spiral bound book,50,100,50,1,00488,India
159558,2023-10-13,703,eraser,1,3,2,1,00347,India
176537,2023-10-13,702,pencil,2,5,3,1,00245,India
176537,2023-10-13,706,sharpener,3,8,5,1,00245,India
176537,2023-10-13,711,TD kit,150,300,150,1,00245,India
704681,2023-10-13,715,folder,5,15,10,1,00249,India
704681,2023-10-13,711,TD kit,150,300,150,1,00249,India
704681,2023-10-13,708,sketchpen,15,40,25,1,00249,India
704681,2023-10-13,713,ball pen,5,10,5,1,00249,India
862759,2023-10-13,704,scale,5,10,5,1,00158,India
542437,2023-10-13,715,folder,5,15,10,1,00049,India
542437,2023-10-13,716,printing paper,200,400,200,1,00049,India
509483,2023-10-13,712,graph paper,20,40,20,1,00360,India
509483,2023-10-13,710,geometry box,100,150,50,1,00360,India
547688,2023-10-13,717,spiral bound book,50,100,50,1,00367,India
547688,2023-10-13,713,ball pen,5,10,5,1,00367,India
547688,2023-10-13,711,TD kit,150,300,150,1,00367,India
696802,2023-10-13,704,scale,5,10,5,1,00153,India
696802,2023-10-13,712,graph paper,20,40,20,1,00153,India
696802,2023-10-13,708,sketchpen,15,40,25,1,00153,India
696802,2023-10-13,711,TD kit,150,300,150,1,00153,India
383990,2023-10-13,715,folder,5,15,10,1,00096,India
383990,2023-10-13,704,scale,5,10,5,1,00096,India
383990,2023-10-13,702,pencil,2,5,3,1,00096,India
849957,2023-10-13,717,spiral bound book,50,100,50,1,00187,India
375361,2023-10-13,714,carbon paper,15,30,15,1,00258,India
375361,2023-10-13,704,scale,5,10,5,1,00258,India
223962,2023-10-13,703,eraser,1,3,2,1,00202,India
223962,2023-10-13,708,sketchpen,15,40,25,1,00202,India
345187,2023-10-13,701,gel pen,5,10,5,1,00077,India
345187,2023-10-13,705,stencil,10,20,10,1,00077,India
345187,2023-10-13,714,carbon paper,15,30,15,1,00077,India
691230,2023-10-13,711,TD kit,150,300,150,1,00211,India
691230,2023-10-13,701,gel pen,5,10,5,1,00211,India
691230,2023-10-13,708,sketchpen,15,40,25,1,00211,India
691230,2023-10-13,710,geometry box,100,150,50,1,00211,India
965160,2023-10-13,709,notebook,30,60,30,1,00188,India
965160,2023-10-13,711,TD kit,150,300,150,1,00188,India
764981,2023-10-13,706,sharpener,3,8,5,1,00101,India
764981,2023-10-13,701,gel pen,5,10,5,1,00101,India
764981,2023-10-13,715,folder,5,15,10,1,00101,India
764981,2023-10-13,707,marker,20,40,20,1,00101,India
970966,2023-10-13,712,graph paper,20,40,20,1,00390,India
970966,2023-10-13,717,spiral bound book,50,100,50,1,00390,India
970966,2023-10-13,708,sketchpen,15,40,25,1,00390,India
858035,2023-10-13,710,geometry box,100,150,50,1,00149,India
858035,2023-10-13,717,spiral bound book,50,100,50,1,00149,India
858035,2023-10-13,716,printing paper,200,400,200,1,00149,India
807480,2023-10-13,704,scale,5,10,5,1,00076,India
807480,2023-10-13,711,TD kit,150,300,150,1,00076,India
807480,2023-10-13,710,geometry box,100,150,50,1,00076,India
421808,2023-10-13,701,gel pen,5,10,5,1,00197,India
524373,2023-10-13,705,stencil,10,20,10,1,00259,India
524373,2023-10-13,704,scale,5,10,5,1,00259,India
251128,2023-10-13,706,sharpener,3,8,5,1,00404,India
251128,2023-10-13,711,TD kit,150,300,150,1,00404,India
251128,2023-10-13,715,folder,5,15,10,1,00404,India
251128,2023-10-13,717,spiral bound book,50,100,50,1,00404,India
251128,2023-10-13,708,sketchpen,15,40,25,1,00404,India
422540,2023-10-13,702,pencil,2,5,3,1,00174,India
414335,2023-10-13,714,carbon paper,15,30,15,1,00054,India
414335,2023-10-13,717,spiral bound book,50,100,50,1,00054,India
414335,2023-10-13,708,sketchpen,15,40,25,1,00054,India
414335,2023-10-13,709,notebook,30,60,30,1,00054,India
727065,2023-10-13,714,carbon paper,15,30,15,1,00054,India
727065,2023-10-13,701,gel pen,5,10,5,1,00054,India
727065,2023-10-13,712,graph paper,20,40,20,1,00054,India
727065,2023-10-13,704,scale,5,10,5,1,00054,India
265883,2023-10-13,709,notebook,30,60,30,1,00313,India
265883,2023-10-13,711,TD kit,150,300,150,1,00313,India
265883,2023-10-13,702,pencil,2,5,3,1,00313,India
728765,2023-10-13,713,ball pen,5,10,5,1,00094,India
728765,2023-10-13,702,pencil,2,5,3,1,00094,India
728765,2023-10-13,707,marker,20,40,20,1,00094,India
134418,2023-10-13,702,pencil,2,5,3,1,00313,India
134418,2023-10-13,701,gel pen,5,10,5,1,00313,India
774963,2023-10-13,711,TD kit,150,300,150,1,00071,India
774963,2023-10-13,707,marker,20,40,20,1,00071,India
774963,2023-10-13,716,printing paper,200,400,200,1,00071,India
774963,2023-10-13,705,stencil,10,20,10,1,00071,India
592872,2023-10-13,702,pencil,2,5,3,1,00116,India
592872,2023-10-13,712,graph paper,20,40,20,1,00116,India
272765,2023-10-14,701,gel pen,5,10,5,1,00397,India
272765,2023-10-14,714,carbon paper,15,30,15,1,00397,India
272765,2023-10-14,708,sketchpen,15,40,25,1,00397,India
272765,2023-10-14,715,folder,5,15,10,1,00397,India
963176,2023-10-14,701,gel pen,5,10,5,1,00182,India
959836,2023-10-14,710,geometry box,100,150,50,1,00303,India
959836,2023-10-14,715,folder,5,15,10,1,00303,India
959836,2023-10-14,701,gel pen,5,10,5,1,00303,India
959836,2023-10-14,709,notebook,30,60,30,1,00303,India
888546,2023-10-14,712,graph paper,20,40,20,1,00100,India
526435,2023-10-14,708,sketchpen,15,40,25,1,00155,India
945381,2023-10-14,708,sketchpen,15,40,25,1,00292,India
945381,2023-10-14,715,folder,5,15,10,1,00292,India
945381,2023-10-14,707,marker,20,40,20,1,00292,India
945381,2023-10-14,701,gel pen,5,10,5,1,00292,India
945381,2023-10-14,716,printing paper,200,400,200,1,00292,India
491704,2023-10-14,708,sketchpen,15,40,25,1,00348,India
491704,2023-10-14,711,TD kit,150,300,150,1,00348,India
491704,2023-10-14,704,scale,5,10,5,1,00348,India
491704,2023-10-14,707,marker,20,40,20,1,00348,India
328522,2023-10-14,706,sharpener,3,8,5,1,00388,India
328522,2023-10-14,703,eraser,1,3,2,1,00388,India
638260,2023-10-14,714,carbon paper,15,30,15,1,00005,India
638260,2023-10-14,711,TD kit,150,300,150,1,00005,India
638260,2023-10-14,713,ball pen,5,10,5,1,00005,India
638260,2023-10-14,707,marker,20,40,20,1,00005,India
638260,2023-10-14,709,notebook,30,60,30,1,00005,India
326706,2023-10-14,709,notebook,30,60,30,1,00331,India
326706,2023-10-14,701,gel pen,5,10,5,1,00331,India
326706,2023-10-14,710,geometry box,100,150,50,1,00331,India
887728,2023-10-14,708,sketchpen,15,40,25,1,00231,India
887728,2023-10-14,710,geometry box,100,150,50,1,00231,India
887728,2023-10-14,707,marker,20,40,20,1,00231,India
769580,2023-10-14,701,gel pen,5,10,5,1,00327,India
769580,2023-10-14,712,graph paper,20,40,20,1,00327,India
769580,2023-10-14,711,TD kit,150,300,150,1,00327,India
404461,2023-10-14,710,geometry box,100,150,50,1,00320,India
404461,2023-10-14,706,sharpener,3,8,5,1,00320,India
413786,2023-10-14,717,spiral bound book,50,100,50,1,00203,India
413786,2023-10-14,712,graph paper,20,40,20,1,00203,India
948362,2023-10-14,711,TD kit,150,300,150,1,00222,India
948362,2023-10-14,704,scale,5,10,5,1,00222,India
948362,2023-10-14,708,sketchpen,15,40,25,1,00222,India
948362,2023-10-14,703,eraser,1,3,2,1,00222,India
948362,2023-10-14,706,sharpener,3,8,5,1,00222,India
483605,2023-10-14,705,stencil,10,20,10,1,00245,India
483605,2023-10-14,704,scale,5,10,5,1,00245,India
107566,2023-10-14,710,geometry box,100,150,50,1,00165,India
107566,2023-10-14,714,carbon paper,15,30,15,1,00165,India
107566,2023-10-14,707,marker,20,40,20,1,00165,India
107566,2023-10-14,708,sketchpen,15,40,25,1,00165,India
606205,2023-10-14,715,folder,5,15,10,1,00497,India
606205,2023-10-14,702,pencil,2,5,3,1,00497,India
939470,2023-10-14,706,sharpener,3,8,5,1,00266,India
939470,2023-10-14,709,notebook,30,60,30,1,00266,India
939470,2023-10-14,713,ball pen,5,10,5,1,00266,India
939470,2023-10-14,707,marker,20,40,20,1,00266,India
939470,2023-10-14,703,eraser,1,3,2,1,00266,India
373945,2023-10-14,706,sharpener,3,8,5,1,00198,India
373945,2023-10-14,709,notebook,30,60,30,1,00198,India
373945,2023-10-14,714,carbon paper,15,30,15,1,00198,India
373945,2023-10-14,712,graph paper,20,40,20,1,00198,India
179830,2023-10-14,701,gel pen,5,10,5,1,00359,India
179830,2023-10-14,707,marker,20,40,20,1,00359,India
325268,2023-10-14,711,TD kit,150,300,150,1,00452,India
325268,2023-10-14,709,notebook,30,60,30,1,00452,India
325268,2023-10-14,706,sharpener,3,8,5,1,00452,India
325268,2023-10-14,708,sketchpen,15,40,25,1,00452,India
722206,2023-10-14,706,sharpener,3,8,5,1,00476,India
581418,2023-10-14,705,stencil,10,20,10,1,00233,India
581418,2023-10-14,702,pencil,2,5,3,1,00233,India
581418,2023-10-14,706,sharpener,3,8,5,1,00233,India
581418,2023-10-14,715,folder,5,15,10,1,00233,India
581418,2023-10-14,713,ball pen,5,10,5,1,00233,India
500851,2023-10-14,707,marker,20,40,20,1,00390,India
440242,2023-10-14,708,sketchpen,15,40,25,1,00159,India
440242,2023-10-14,709,notebook,30,60,30,1,00159,India
440242,2023-10-14,701,gel pen,5,10,5,1,00159,India
440242,2023-10-14,715,folder,5,15,10,1,00159,India
440242,2023-10-14,702,pencil,2,5,3,1,00159,India
607419,2023-10-14,707,marker,20,40,20,1,00106,India
607419,2023-10-14,715,folder,5,15,10,1,00106,India
607419,2023-10-14,710,geometry box,100,150,50,1,00106,India
607419,2023-10-14,717,spiral bound book,50,100,50,1,00106,India
607419,2023-10-14,713,ball pen,5,10,5,1,00106,India
787028,2023-10-14,710,geometry box,100,150,50,1,00314,India
787028,2023-10-14,716,printing paper,200,400,200,1,00314,India
814122,2023-10-14,717,spiral bound book,50,100,50,1,00203,India
814122,2023-10-14,715,folder,5,15,10,1,00203,India
814122,2023-10-14,708,sketchpen,15,40,25,1,00203,India
814122,2023-10-14,716,printing paper,200,400,200,1,00203,India
802765,2023-10-14,704,scale,5,10,5,1,00126,India
802765,2023-10-14,703,eraser,1,3,2,1,00126,India
802765,2023-10-14,705,stencil,10,20,10,1,00126,India
665497,2023-10-14,711,TD kit,150,300,150,1,00106,India
665497,2023-10-14,706,sharpener,3,8,5,1,00106,India
665497,2023-10-14,713,ball pen,5,10,5,1,00106,India
665497,2023-10-14,702,pencil,2,5,3,1,00106,India
665497,2023-10-14,707,marker,20,40,20,1,00106,India
245056,2023-10-14,707,marker,20,40,20,1,00431,India
245056,2023-10-14,701,gel pen,5,10,5,1,00431,India
245056,2023-10-14,710,geometry box,100,150,50,1,00431,India
245056,2023-10-14,713,ball pen,5,10,5,1,00431,India
226249,2023-10-14,701,gel pen,5,10,5,1,00054,India
226249,2023-10-14,709,notebook,30,60,30,1,00054,India
226249,2023-10-14,710,geometry box,100,150,50,1,00054,India
226249,2023-10-14,715,folder,5,15,10,1,00054,India
111735,2023-10-14,704,scale,5,10,5,1,00252,India
111735,2023-10-14,715,folder,5,15,10,1,00252,India
111735,2023-10-14,716,printing paper,200,400,200,1,00252,India
111735,2023-10-14,707,marker,20,40,20,1,00252,India
240141,2023-10-14,706,sharpener,3,8,5,1,00090,India
880765,2023-10-14,701,gel pen,5,10,5,1,00405,India
194377,2023-10-14,706,sharpener,3,8,5,1,00495,India
194377,2023-10-14,707,marker,20,40,20,1,00495,India
194377,2023-10-14,709,notebook,30,60,30,1,00495,India
194377,2023-10-14,713,ball pen,5,10,5,1,00495,India
194377,2023-10-14,711,TD kit,150,300,150,1,00495,India
715592,2023-10-14,703,eraser,1,3,2,1,00021,India
715592,2023-10-14,709,notebook,30,60,30,1,00021,India
715592,2023-10-14,711,TD kit,150,300,150,1,00021,India
463136,2023-10-14,708,sketchpen,15,40,25,1,00015,India
558147,2023-10-14,703,eraser,1,3,2,1,00245,India
558147,2023-10-14,706,sharpener,3,8,5,1,00245,India
536195,2023-10-15,715,folder,5,15,10,1,00035,India
536195,2023-10-15,706,sharpener,3,8,5,1,00035,India
536195,2023-10-15,704,scale,5,10,5,1,00035,India
724098,2023-10-15,713,ball pen,5,10,5,1,00281,India
138885,2023-10-15,716,printing paper,200,400,200,1,00473,India
383411,2023-10-15,706,sharpener,3,8,5,1,00365,India
383411,2023-10-15,702,pencil,2,5,3,1,00365,India
464098,2023-10-15,713,ball pen,5,10,5,1,00222,India
553193,2023-10-15,709,notebook,30,60,30,1,00500,India
553193,2023-10-15,711,TD kit,150,300,150,1,00500,India
553193,2023-10-15,702,pencil,2,5,3,1,00500,India
578488,2023-10-15,707,marker,20,40,20,1,00385,India
578488,2023-10-15,705,stencil,10,20,10,1,00385,India
578488,2023-10-15,716,printing paper,200,400,200,1,00385,India
783626,2023-10-15,717,spiral bound book,50,100,50,1,00081,India
783626,2023-10-15,702,pencil,2,5,3,1,00081,India
833422,2023-10-15,715,folder,5,15,10,1,00026,India
833422,2023-10-15,714,carbon paper,15,30,15,1,00026,India
546952,2023-10-15,712,graph paper,20,40,20,1,00082,India
546952,2023-10-15,710,geometry box,100,150,50,1,00082,India
546952,2023-10-15,703,eraser,1,3,2,1,00082,India
756579,2023-10-15,707,marker,20,40,20,1,00431,India
756579,2023-10-15,703,eraser,1,3,2,1,00431,India
756579,2023-10-15,713,ball pen,5,10,5,1,00431,India
756579,2023-10-15,704,scale,5,10,5,1,00431,India
546530,2023-10-15,705,stencil,10,20,10,1,00093,India
546530,2023-10-15,702,pencil,2,5,3,1,00093,India
546530,2023-10-15,712,graph paper,20,40,20,1,00093,India
546530,2023-10-15,710,geometry box,100,150,50,1,00093,India
354964,2023-10-15,715,folder,5,15,10,1,00273,India
354964,2023-10-15,705,stencil,10,20,10,1,00273,India
354964,2023-10-15,712,graph paper,20,40,20,1,00273,India
354964,2023-10-15,708,sketchpen,15,40,25,1,00273,India
725025,2023-10-15,713,ball pen,5,10,5,1,00071,India
725025,2023-10-15,717,spiral bound book,50,100,50,1,00071,India
725025,2023-10-15,702,pencil,2,5,3,1,00071,India
102525,2023-10-15,713,ball pen,5,10,5,1,00392,India
102525,2023-10-15,715,folder,5,15,10,1,00392,India
102525,2023-10-15,708,sketchpen,15,40,25,1,00392,India
102525,2023-10-15,702,pencil,2,5,3,1,00392,India
598316,2023-10-15,713,ball pen,5,10,5,1,00361,India
598316,2023-10-15,703,eraser,1,3,2,1,00361,India
598316,2023-10-15,704,scale,5,10,5,1,00361,India
598316,2023-10-15,710,geometry box,100,150,50,1,00361,India
900196,2023-10-15,705,stencil,10,20,10,1,00273,India
900196,2023-10-15,715,folder,5,15,10,1,00273,India
917364,2023-10-15,703,eraser,1,3,2,1,00385,India
917364,2023-10-15,717,spiral bound book,50,100,50,1,00385,India
917364,2023-10-15,702,pencil,2,5,3,1,00385,India
177711,2023-10-15,711,TD kit,150,300,150,1,00004,India
177711,2023-10-15,710,geometry box,100,150,50,1,00004,India
351680,2023-10-15,706,sharpener,3,8,5,1,00452,India
351680,2023-10-15,703,eraser,1,3,2,1,00452,India
211498,2023-10-15,715,folder,5,15,10,1,00028,India
211498,2023-10-15,704,scale,5,10,5,1,00028,India
211498,2023-10-15,714,carbon paper,15,30,15,1,00028,India
211498,2023-10-15,711,TD kit,150,300,150,1,00028,India
981386,2023-10-15,704,scale,5,10,5,1,00251,India
981386,2023-10-15,701,gel pen,5,10,5,1,00251,India
981386,2023-10-15,708,sketchpen,15,40,25,1,00251,India
981386,2023-10-15,715,folder,5,15,10,1,00251,India
703327,2023-10-15,712,graph paper,20,40,20,1,00145,India
703327,2023-10-15,714,carbon paper,15,30,15,1,00145,India
703327,2023-10-15,706,sharpener,3,8,5,1,00145,India
703327,2023-10-15,708,sketchpen,15,40,25,1,00145,India
703327,2023-10-15,702,pencil,2,5,3,1,00145,India
731624,2023-10-15,709,notebook,30,60,30,1,00372,India
731624,2023-10-15,714,carbon paper,15,30,15,1,00372,India
105730,2023-10-15,701,gel pen,5,10,5,1,00423,India
105730,2023-10-15,705,stencil,10,20,10,1,00423,India
105730,2023-10-15,717,spiral bound book,50,100,50,1,00423,India
105730,2023-10-15,706,sharpener,3,8,5,1,00423,India
318505,2023-10-15,712,graph paper,20,40,20,1,00346,India
318505,2023-10-15,717,spiral bound book,50,100,50,1,00346,India
875541,2023-10-15,715,folder,5,15,10,1,00331,India
875541,2023-10-15,712,graph paper,20,40,20,1,00331,India
875541,2023-10-15,717,spiral bound book,50,100,50,1,00331,India
875541,2023-10-15,703,eraser,1,3,2,1,00331,India
875541,2023-10-15,709,notebook,30,60,30,1,00331,India
693129,2023-10-15,712,graph paper,20,40,20,1,00055,India
693129,2023-10-15,710,geometry box,100,150,50,1,00055,India
693129,2023-10-15,716,printing paper,200,400,200,1,00055,India
787797,2023-10-15,704,scale,5,10,5,1,00163,India
787797,2023-10-15,703,eraser,1,3,2,1,00163,India
787797,2023-10-15,713,ball pen,5,10,5,1,00163,India
549028,2023-10-15,717,spiral bound book,50,100,50,1,00456,India
549028,2023-10-15,704,scale,5,10,5,1,00456,India
549028,2023-10-15,703,eraser,1,3,2,1,00456,India
397969,2023-10-15,713,ball pen,5,10,5,1,00216,India
397969,2023-10-15,708,sketchpen,15,40,25,1,00216,India
397969,2023-10-15,707,marker,20,40,20,1,00216,India
397969,2023-10-15,701,gel pen,5,10,5,1,00216,India
397969,2023-10-15,716,printing paper,200,400,200,1,00216,India
946795,2023-10-15,707,marker,20,40,20,1,00178,India
946795,2023-10-15,710,geometry box,100,150,50,1,00178,India
501094,2023-10-16,702,pencil,2,5,3,1,00222,India
501094,2023-10-16,707,marker,20,40,20,1,00222,India
501094,2023-10-16,716,printing paper,200,400,200,1,00222,India
470248,2023-10-16,709,notebook,30,60,30,1,00038,India
470248,2023-10-16,704,scale,5,10,5,1,00038,India
470248,2023-10-16,715,folder,5,15,10,1,00038,India
470248,2023-10-16,711,TD kit,150,300,150,1,00038,India
793745,2023-10-16,701,gel pen,5,10,5,1,00424,India
793745,2023-10-16,712,graph paper,20,40,20,1,00424,India
793745,2023-10-16,705,stencil,10,20,10,1,00424,India
379300,2023-10-16,710,geometry box,100,150,50,1,00478,India
379300,2023-10-16,713,ball pen,5,10,5,1,00478,India
379300,2023-10-16,712,graph paper,20,40,20,1,00478,India
379300,2023-10-16,708,sketchpen,15,40,25,1,00478,India
379300,2023-10-16,714,carbon paper,15,30,15,1,00478,India
188020,2023-10-16,710,geometry box,100,150,50,1,00273,India
188020,2023-10-16,707,marker,20,40,20,1,00273,India
188020,2023-10-16,713,ball pen,5,10,5,1,00273,India
340604,2023-10-16,717,spiral bound book,50,100,50,1,00428,India
340604,2023-10-16,706,sharpener,3,8,5,1,00428,India
340604,2023-10-16,710,geometry box,100,150,50,1,00428,India
340604,2023-10-16,712,graph paper,20,40,20,1,00428,India
340604,2023-10-16,714,carbon paper,15,30,15,1,00428,India
659937,2023-10-16,710,geometry box,100,150,50,1,00448,India
659937,2023-10-16,703,eraser,1,3,2,1,00448,India
707717,2023-10-16,702,pencil,2,5,3,1,00229,India
707717,2023-10-16,713,ball pen,5,10,5,1,00229,India
707717,2023-10-16,714,carbon paper,15,30,15,1,00229,India
707717,2023-10-16,709,notebook,30,60,30,1,00229,India
707717,2023-10-16,704,scale,5,10,5,1,00229,India
979612,2023-10-16,707,marker,20,40,20,1,00268,India
979612,2023-10-16,712,graph paper,20,40,20,1,00268,India
979612,2023-10-16,703,eraser,1,3,2,1,00268,India
979612,2023-10-16,701,gel pen,5,10,5,1,00268,India
111873,2023-10-16,717,spiral bound book,50,100,50,1,00143,India
111873,2023-10-16,707,marker,20,40,20,1,00143,India
111873,2023-10-16,713,ball pen,5,10,5,1,00143,India
111873,2023-10-16,716,printing paper,200,400,200,1,00143,India
824540,2023-10-16,716,printing paper,200,400,200,1,00255,India
824540,2023-10-16,710,geometry box,100,150,50,1,00255,India
824540,2023-10-16,709,notebook,30,60,30,1,00255,India
824540,2023-10-16,701,gel pen,5,10,5,1,00255,India
824540,2023-10-16,715,folder,5,15,10,1,00255,India
533099,2023-10-16,701,gel pen,5,10,5,1,00419,India
533099,2023-10-16,710,geometry box,100,150,50,1,00419,India
533099,2023-10-16,713,ball pen,5,10,5,1,00419,India
412513,2023-10-16,707,marker,20,40,20,1,00343,India
412513,2023-10-16,701,gel pen,5,10,5,1,00343,India
278011,2023-10-16,705,stencil,10,20,10,1,00406,India
278011,2023-10-16,708,sketchpen,15,40,25,1,00406,India
278011,2023-10-16,712,graph paper,20,40,20,1,00406,India
851363,2023-10-16,705,stencil,10,20,10,1,00356,India
851363,2023-10-16,714,carbon paper,15,30,15,1,00356,India
680149,2023-10-16,704,scale,5,10,5,1,00336,India
680149,2023-10-16,705,stencil,10,20,10,1,00336,India
680149,2023-10-16,710,geometry box,100,150,50,1,00336,India
680149,2023-10-16,701,gel pen,5,10,5,1,00336,India
519340,2023-10-16,705,stencil,10,20,10,1,00270,India
519340,2023-10-16,701,gel pen,5,10,5,1,00270,India
519340,2023-10-16,710,geometry box,100,150,50,1,00270,India
519340,2023-10-16,703,eraser,1,3,2,1,00270,India
194776,2023-10-16,712,graph paper,20,40,20,1,00033,India
194776,2023-10-16,704,scale,5,10,5,1,00033,India
330928,2023-10-16,716,printing paper,200,400,200,1,00124,India
330928,2023-10-16,713,ball pen,5,10,5,1,00124,India
155843,2023-10-16,705,stencil,10,20,10,1,00020,India
155843,2023-10-16,714,carbon paper,15,30,15,1,00020,India
155843,2023-10-16,717,spiral bound book,50,100,50,1,00020,India
798859,2023-10-16,715,folder,5,15,10,1,00091,India
798859,2023-10-16,704,scale,5,10,5,1,00091,India
798859,2023-10-16,708,sketchpen,15,40,25,1,00091,India
798859,2023-10-16,712,graph paper,20,40,20,1,00091,India
938927,2023-10-16,712,graph paper,20,40,20,1,00071,India
938927,2023-10-16,715,folder,5,15,10,1,00071,India
625854,2023-10-16,712,graph paper,20,40,20,1,00186,India
625854,2023-10-16,703,eraser,1,3,2,1,00186,India
625854,2023-10-16,702,pencil,2,5,3,1,00186,India
625854,2023-10-16,715,folder,5,15,10,1,00186,India
492782,2023-10-16,710,geometry box,100,150,50,1,00163,India
243561,2023-10-16,707,marker,20,40,20,1,00332,India
243561,2023-10-16,705,stencil,10,20,10,1,00332,India
243561,2023-10-16,708,sketchpen,15,40,25,1,00332,India
243561,2023-10-16,713,ball pen,5,10,5,1,00332,India
504425,2023-10-16,714,carbon paper,15,30,15,1,00108,India
504425,2023-10-16,709,notebook,30,60,30,1,00108,India
504425,2023-10-16,708,sketchpen,15,40,25,1,00108,India
216681,2023-10-16,703,eraser,1,3,2,1,00137,India
954568,2023-10-16,709,notebook,30,60,30,1,00480,India
463559,2023-10-16,706,sharpener,3,8,5,1,00127,India
463559,2023-10-16,712,graph paper,20,40,20,1,00127,India
463559,2023-10-16,713,ball pen,5,10,5,1,00127,India
677440,2023-10-16,716,printing paper,200,400,200,1,00067,India
479435,2023-10-16,703,eraser,1,3,2,1,00104,India
707035,2023-10-17,701,gel pen,5,10,5,1,00428,India
707035,2023-10-17,706,sharpener,3,8,5,1,00428,India
707035,2023-10-17,716,printing paper,200,400,200,1,00428,India
841578,2023-10-17,713,ball pen,5,10,5,1,00232,India
841578,2023-10-17,703,eraser,1,3,2,1,00232,India
500816,2023-10-17,705,stencil,10,20,10,1,00018,India
500816,2023-10-17,704,scale,5,10,5,1,00018,India
500816,2023-10-17,702,pencil,2,5,3,1,00018,India
500816,2023-10-17,710,geometry box,100,150,50,1,00018,India
533166,2023-10-17,701,gel pen,5,10,5,1,00497,India
533166,2023-10-17,705,stencil,10,20,10,1,00497,India
533166,2023-10-17,715,folder,5,15,10,1,00497,India
148085,2023-10-17,711,TD kit,150,300,150,1,00414,India
521697,2023-10-17,704,scale,5,10,5,1,00346,India
521697,2023-10-17,712,graph paper,20,40,20,1,00346,India
521697,2023-10-17,715,folder,5,15,10,1,00346,India
520596,2023-10-17,706,sharpener,3,8,5,1,00485,India
520596,2023-10-17,704,scale,5,10,5,1,00485,India
520596,2023-10-17,716,printing paper,200,400,200,1,00485,India
520596,2023-10-17,708,sketchpen,15,40,25,1,00485,India
520596,2023-10-17,710,geometry box,100,150,50,1,00485,India
372276,2023-10-17,707,marker,20,40,20,1,00274,India
372276,2023-10-17,702,pencil,2,5,3,1,00274,India
372276,2023-10-17,709,notebook,30,60,30,1,00274,India
372276,2023-10-17,710,geometry box,100,150,50,1,00274,India
928594,2023-10-17,709,notebook,30,60,30,1,00280,India
928594,2023-10-17,701,gel pen,5,10,5,1,00280,India
928594,2023-10-17,711,TD kit,150,300,150,1,00280,India
928594,2023-10-17,715,folder,5,15,10,1,00280,India
439537,2023-10-17,704,scale,5,10,5,1,00187,India
824931,2023-10-17,715,folder,5,15,10,1,00445,India
824931,2023-10-17,713,ball pen,5,10,5,1,00445,India
824931,2023-10-17,716,printing paper,200,400,200,1,00445,India
824931,2023-10-17,706,sharpener,3,8,5,1,00445,India
213427,2023-10-17,702,pencil,2,5,3,1,00257,India
213427,2023-10-17,709,notebook,30,60,30,1,00257,India
213427,2023-10-17,710,geometry box,100,150,50,1,00257,India
554925,2023-10-17,717,spiral bound book,50,100,50,1,00067,India
554925,2023-10-17,716,printing paper,200,400,200,1,00067,India
127193,2023-10-17,706,sharpener,3,8,5,1,00142,India
930266,2023-10-17,711,TD kit,150,300,150,1,00177,India
460202,2023-10-17,701,gel pen,5,10,5,1,00417,India
460202,2023-10-17,708,sketchpen,15,40,25,1,00417,India
517070,2023-10-17,703,eraser,1,3,2,1,00243,India
517070,2023-10-17,715,folder,5,15,10,1,00243,India
517070,2023-10-17,709,notebook,30,60,30,1,00243,India
222933,2023-10-17,704,scale,5,10,5,1,00062,India
222933,2023-10-17,708,sketchpen,15,40,25,1,00062,India
140205,2023-10-17,707,marker,20,40,20,1,00013,India
140205,2023-10-17,704,scale,5,10,5,1,00013,India
140205,2023-10-17,701,gel pen,5,10,5,1,00013,India
140205,2023-10-17,702,pencil,2,5,3,1,00013,India
448253,2023-10-17,702,pencil,2,5,3,1,00356,India
448253,2023-10-17,710,geometry box,100,150,50,1,00356,India
909307,2023-10-17,701,gel pen,5,10,5,1,00122,India
909307,2023-10-17,708,sketchpen,15,40,25,1,00122,India
909307,2023-10-17,702,pencil,2,5,3,1,00122,India
909307,2023-10-17,709,notebook,30,60,30,1,00122,India
650987,2023-10-17,713,ball pen,5,10,5,1,00125,India
650987,2023-10-17,708,sketchpen,15,40,25,1,00125,India
650987,2023-10-17,717,spiral bound book,50,100,50,1,00125,India
650987,2023-10-17,716,printing paper,200,400,200,1,00125,India
650987,2023-10-17,712,graph paper,20,40,20,1,00125,India
328446,2023-10-17,713,ball pen,5,10,5,1,00248,India
123303,2023-10-17,714,carbon paper,15,30,15,1,00452,India
123303,2023-10-17,701,gel pen,5,10,5,1,00452,India
123303,2023-10-17,703,eraser,1,3,2,1,00452,India
173471,2023-10-17,708,sketchpen,15,40,25,1,00407,India
173471,2023-10-17,712,graph paper,20,40,20,1,00407,India
725462,2023-10-17,711,TD kit,150,300,150,1,00191,India
725462,2023-10-17,706,sharpener,3,8,5,1,00191,India
977997,2023-10-17,716,printing paper,200,400,200,1,00176,India
977997,2023-10-17,713,ball pen,5,10,5,1,00176,India
977997,2023-10-17,706,sharpener,3,8,5,1,00176,India
874020,2023-10-17,701,gel pen,5,10,5,1,00429,India
883020,2023-10-17,705,stencil,10,20,10,1,00271,India
883020,2023-10-17,715,folder,5,15,10,1,00271,India
883020,2023-10-17,703,eraser,1,3,2,1,00271,India
883020,2023-10-17,704,scale,5,10,5,1,00271,India
631947,2023-10-17,706,sharpener,3,8,5,1,00389,India
243517,2023-10-17,705,stencil,10,20,10,1,00273,India
243517,2023-10-17,709,notebook,30,60,30,1,00273,India
243517,2023-10-17,710,geometry box,100,150,50,1,00273,India
243517,2023-10-17,704,scale,5,10,5,1,00273,India
243517,2023-10-17,701,gel pen,5,10,5,1,00273,India
954828,2023-10-17,710,geometry box,100,150,50,1,00045,India
954828,2023-10-17,703,eraser,1,3,2,1,00045,India
954828,2023-10-17,708,sketchpen,15,40,25,1,00045,India
819718,2023-10-17,701,gel pen,5,10,5,1,00214,India
819718,2023-10-17,705,stencil,10,20,10,1,00214,India
917981,2023-10-17,703,eraser,1,3,2,1,00138,India
917981,2023-10-17,708,sketchpen,15,40,25,1,00138,India
917981,2023-10-17,706,sharpener,3,8,5,1,00138,India
782555,2023-10-17,712,graph paper,20,40,20,1,00081,India
782555,2023-10-17,717,spiral bound book,50,100,50,1,00081,India
133405,2023-10-17,712,graph paper,20,40,20,1,00111,India
133405,2023-10-17,702,pencil,2,5,3,1,00111,India
361704,2023-10-17,713,ball pen,5,10,5,1,00440,India
361704,2023-10-17,708,sketchpen,15,40,25,1,00440,India
361704,2023-10-17,717,spiral bound book,50,100,50,1,00440,India
361704,2023-10-17,705,stencil,10,20,10,1,00440,India
361704,2023-10-17,710,geometry box,100,150,50,1,00440,India
536333,2023-10-17,701,gel pen,5,10,5,1,00026,India
536333,2023-10-17,703,eraser,1,3,2,1,00026,India
542539,2023-10-17,703,eraser,1,3,2,1,00495,India
680875,2023-10-17,703,eraser,1,3,2,1,00091,India
680875,2023-10-17,704,scale,5,10,5,1,00091,India
291977,2023-10-17,715,folder,5,15,10,1,00440,India
291977,2023-10-17,708,sketchpen,15,40,25,1,00440,India
291977,2023-10-17,704,scale,5,10,5,1,00440,India
291977,2023-10-17,705,stencil,10,20,10,1,00440,India
910582,2023-10-17,701,gel pen,5,10,5,1,00211,India
910582,2023-10-17,714,carbon paper,15,30,15,1,00211,India
910582,2023-10-17,713,ball pen,5,10,5,1,00211,India
910582,2023-10-17,706,sharpener,3,8,5,1,00211,India
910582,2023-10-17,702,pencil,2,5,3,1,00211,India
695440,2023-10-17,716,printing paper,200,400,200,1,00152,India
695440,2023-10-17,712,graph paper,20,40,20,1,00152,India
695440,2023-10-17,707,marker,20,40,20,1,00152,India
628595,2023-10-17,713,ball pen,5,10,5,1,00363,India
628595,2023-10-17,711,TD kit,150,300,150,1,00363,India
628595,2023-10-17,717,spiral bound book,50,100,50,1,00363,India
324711,2023-10-18,703,eraser,1,3,2,1,00256,India
324711,2023-10-18,717,spiral bound book,50,100,50,1,00256,India
324711,2023-10-18,707,marker,20,40,20,1,00256,India
214145,2023-10-18,709,notebook,30,60,30,1,00146,India
214145,2023-10-18,707,marker,20,40,20,1,00146,India
223896,2023-10-18,708,sketchpen,15,40,25,1,00446,India
223896,2023-10-18,712,graph paper,20,40,20,1,00446,India
223896,2023-10-18,706,sharpener,3,8,5,1,00446,India
429919,2023-10-18,706,sharpener,3,8,5,1,00223,India
429919,2023-10-18,713,ball pen,5,10,5,1,00223,India
429919,2023-10-18,703,eraser,1,3,2,1,00223,India
429919,2023-10-18,716,printing paper,200,400,200,1,00223,India
429919,2023-10-18,702,pencil,2,5,3,1,00223,India
773106,2023-10-18,713,ball pen,5,10,5,1,00042,India
453949,2023-10-18,713,ball pen,5,10,5,1,00313,India
453949,2023-10-18,704,scale,5,10,5,1,00313,India
408449,2023-10-18,701,gel pen,5,10,5,1,00337,India
408449,2023-10-18,712,graph paper,20,40,20,1,00337,India
408449,2023-10-18,711,TD kit,150,300,150,1,00337,India
408449,2023-10-18,710,geometry box,100,150,50,1,00337,India
672143,2023-10-18,708,sketchpen,15,40,25,1,00116,India
858588,2023-10-18,705,stencil,10,20,10,1,00237,India
858588,2023-10-18,701,gel pen,5,10,5,1,00237,India
858588,2023-10-18,715,folder,5,15,10,1,00237,India
804917,2023-10-18,705,stencil,10,20,10,1,00034,India
618013,2023-10-18,717,spiral bound book,50,100,50,1,00433,India
558097,2023-10-18,711,TD kit,150,300,150,1,00127,India
558097,2023-10-18,713,ball pen,5,10,5,1,00127,India
558097,2023-10-18,712,graph paper,20,40,20,1,00127,India
558097,2023-10-18,706,sharpener,3,8,5,1,00127,India
770429,2023-10-18,704,scale,5,10,5,1,00013,India
770429,2023-10-18,710,geometry box,100,150,50,1,00013,India
770429,2023-10-18,705,stencil,10,20,10,1,00013,India
480632,2023-10-18,704,scale,5,10,5,1,00125,India
480632,2023-10-18,706,sharpener,3,8,5,1,00125,India
480632,2023-10-18,714,carbon paper,15,30,15,1,00125,India
480632,2023-10-18,712,graph paper,20,40,20,1,00125,India
153704,2023-10-18,715,folder,5,15,10,1,00199,India
153704,2023-10-18,716,printing paper,200,400,200,1,00199,India
153704,2023-10-18,713,ball pen,5,10,5,1,00199,India
153704,2023-10-18,711,TD kit,150,300,150,1,00199,India
244037,2023-10-18,711,TD kit,150,300,150,1,00474,India
931561,2023-10-18,703,eraser,1,3,2,1,00014,India
931561,2023-10-18,710,geometry box,100,150,50,1,00014,India
931561,2023-10-18,702,pencil,2,5,3,1,00014,India
944820,2023-10-18,707,marker,20,40,20,1,00252,India
754895,2023-10-18,701,gel pen,5,10,5,1,00324,India
754895,2023-10-18,702,pencil,2,5,3,1,00324,India
175811,2023-10-18,717,spiral bound book,50,100,50,1,00275,India
175811,2023-10-18,716,printing paper,200,400,200,1,00275,India
912969,2023-10-18,708,sketchpen,15,40,25,1,00217,India
340287,2023-10-18,714,carbon paper,15,30,15,1,00435,India
340287,2023-10-18,704,scale,5,10,5,1,00435,India
340287,2023-10-18,713,ball pen,5,10,5,1,00435,India
340287,2023-10-18,712,graph paper,20,40,20,1,00435,India
340287,2023-10-18,708,sketchpen,15,40,25,1,00435,India
156734,2023-10-18,711,TD kit,150,300,150,1,00088,India
156734,2023-10-18,709,notebook,30,60,30,1,00088,India
156734,2023-10-18,708,sketchpen,15,40,25,1,00088,India
156734,2023-10-18,710,geometry box,100,150,50,1,00088,India
890272,2023-10-18,705,stencil,10,20,10,1,00058,India
970687,2023-10-18,706,sharpener,3,8,5,1,00277,India
970687,2023-10-18,716,printing paper,200,400,200,1,00277,India
970687,2023-10-18,711,TD kit,150,300,150,1,00277,India
846679,2023-10-18,708,sketchpen,15,40,25,1,00130,India
846679,2023-10-18,711,TD kit,150,300,150,1,00130,India
618121,2023-10-18,708,sketchpen,15,40,25,1,00149,India
960051,2023-10-18,707,marker,20,40,20,1,00420,India
409459,2023-10-18,717,spiral bound book,50,100,50,1,00002,India
409459,2023-10-18,711,TD kit,150,300,150,1,00002,India
409459,2023-10-18,702,pencil,2,5,3,1,00002,India
296177,2023-10-18,713,ball pen,5,10,5,1,00415,India
296177,2023-10-18,705,stencil,10,20,10,1,00415,India
296177,2023-10-18,706,sharpener,3,8,5,1,00415,India
296177,2023-10-18,717,spiral bound book,50,100,50,1,00415,India
148336,2023-10-18,715,folder,5,15,10,1,00373,India
148336,2023-10-18,705,stencil,10,20,10,1,00373,India
148336,2023-10-18,712,graph paper,20,40,20,1,00373,India
260379,2023-10-18,708,sketchpen,15,40,25,1,00190,India
260379,2023-10-18,710,geometry box,100,150,50,1,00190,India
371478,2023-10-18,702,pencil,2,5,3,1,00382,India
371478,2023-10-18,705,stencil,10,20,10,1,00382,India
371478,2023-10-18,709,notebook,30,60,30,1,00382,India
371478,2023-10-18,717,spiral bound book,50,100,50,1,00382,India
769043,2023-10-18,714,carbon paper,15,30,15,1,00067,India
475969,2023-10-18,704,scale,5,10,5,1,00385,India
833991,2023-10-18,701,gel pen,5,10,5,1,00157,India
833991,2023-10-18,711,TD kit,150,300,150,1,00157,India
833991,2023-10-18,709,notebook,30,60,30,1,00157,India
833991,2023-10-18,702,pencil,2,5,3,1,00157,India
719986,2023-10-18,708,sketchpen,15,40,25,1,00330,India
719986,2023-10-18,716,printing paper,200,400,200,1,00330,India
246657,2023-10-18,701,gel pen,5,10,5,1,00197,India
246657,2023-10-18,717,spiral bound book,50,100,50,1,00197,India
246657,2023-10-18,706,sharpener,3,8,5,1,00197,India
138248,2023-10-18,703,eraser,1,3,2,1,00358,India
138248,2023-10-18,713,ball pen,5,10,5,1,00358,India
138248,2023-10-18,709,notebook,30,60,30,1,00358,India
138248,2023-10-18,717,spiral bound book,50,100,50,1,00358,India
926772,2023-10-18,709,notebook,30,60,30,1,00077,India
926772,2023-10-18,705,stencil,10,20,10,1,00077,India
926772,2023-10-18,713,ball pen,5,10,5,1,00077,India
926772,2023-10-18,704,scale,5,10,5,1,00077,India
123326,2023-10-18,705,stencil,10,20,10,1,00482,India
123326,2023-10-18,715,folder,5,15,10,1,00482,India
123326,2023-10-18,701,gel pen,5,10,5,1,00482,India
123326,2023-10-18,711,TD kit,150,300,150,1,00482,India
123326,2023-10-18,716,printing paper,200,400,200,1,00482,India
524660,2023-10-18,703,eraser,1,3,2,1,00176,India
650002,2023-10-18,713,ball pen,5,10,5,1,00468,India
650002,2023-10-18,708,sketchpen,15,40,25,1,00468,India
650002,2023-10-18,715,folder,5,15,10,1,00468,India
978096,2023-10-18,711,TD kit,150,300,150,1,00275,India
978096,2023-10-18,702,pencil,2,5,3,1,00275,India
978096,2023-10-18,709,notebook,30,60,30,1,00275,India
985246,2023-10-18,704,scale,5,10,5,1,00178,India
985246,2023-10-18,714,carbon paper,15,30,15,1,00178,India
985246,2023-10-18,703,eraser,1,3,2,1,00178,India
985246,2023-10-18,705,stencil,10,20,10,1,00178,India
985246,2023-10-18,711,TD kit,150,300,150,1,00178,India
741571,2023-10-18,703,eraser,1,3,2,1,00492,India
741571,2023-10-18,702,pencil,2,5,3,1,00492,India
741571,2023-10-18,707,marker,20,40,20,1,00492,India
167178,2023-10-18,706,sharpener,3,8,5,1,00262,India
167178,2023-10-18,712,graph paper,20,40,20,1,00262,India
167178,2023-10-18,713,ball pen,5,10,5,1,00262,India
167178,2023-10-18,708,sketchpen,15,40,25,1,00262,India
550172,2023-10-18,709,notebook,30,60,30,1,00010,India
652906,2023-10-18,705,stencil,10,20,10,1,00101,India
652906,2023-10-18,715,folder,5,15,10,1,00101,India
652906,2023-10-18,703,eraser,1,3,2,1,00101,India
652906,2023-10-18,709,notebook,30,60,30,1,00101,India
866545,2023-10-18,701,gel pen,5,10,5,1,00284,India
866545,2023-10-18,710,geometry box,100,150,50,1,00284,India
866545,2023-10-18,704,scale,5,10,5,1,00284,India
866545,2023-10-18,715,folder,5,15,10,1,00284,India
297209,2023-10-19,706,sharpener,3,8,5,1,00452,India
297209,2023-10-19,702,pencil,2,5,3,1,00452,India
152294,2023-10-19,702,pencil,2,5,3,1,00484,India
152294,2023-10-19,713,ball pen,5,10,5,1,00484,India
152294,2023-10-19,715,folder,5,15,10,1,00484,India
152294,2023-10-19,706,sharpener,3,8,5,1,00484,India
571292,2023-10-19,710,geometry box,100,150,50,1,00195,India
571292,2023-10-19,711,TD kit,150,300,150,1,00195,India
366256,2023-10-19,705,stencil,10,20,10,1,00196,India
366256,2023-10-19,702,pencil,2,5,3,1,00196,India
796446,2023-10-19,708,sketchpen,15,40,25,1,00358,India
715724,2023-10-19,714,carbon paper,15,30,15,1,00194,India
715724,2023-10-19,713,ball pen,5,10,5,1,00194,India
715724,2023-10-19,705,stencil,10,20,10,1,00194,India
560585,2023-10-19,716,printing paper,200,400,200,1,00155,India
368585,2023-10-19,711,TD kit,150,300,150,1,00471,India
683642,2023-10-19,711,TD kit,150,300,150,1,00295,India
683642,2023-10-19,709,notebook,30,60,30,1,00295,India
678282,2023-10-19,709,notebook,30,60,30,1,00452,India
514607,2023-10-19,708,sketchpen,15,40,25,1,00458,India
514607,2023-10-19,714,carbon paper,15,30,15,1,00458,India
514607,2023-10-19,711,TD kit,150,300,150,1,00458,India
514607,2023-10-19,713,ball pen,5,10,5,1,00458,India
309833,2023-10-19,705,stencil,10,20,10,1,00074,India
605021,2023-10-19,702,pencil,2,5,3,1,00458,India
605021,2023-10-19,707,marker,20,40,20,1,00458,India
605021,2023-10-19,711,TD kit,150,300,150,1,00458,India
605021,2023-10-19,717,spiral bound book,50,100,50,1,00458,India
719808,2023-10-19,706,sharpener,3,8,5,1,00278,India
719808,2023-10-19,704,scale,5,10,5,1,00278,India
719808,2023-10-19,714,carbon paper,15,30,15,1,00278,India
719808,2023-10-19,715,folder,5,15,10,1,00278,India
427240,2023-10-19,708,sketchpen,15,40,25,1,00210,India
427240,2023-10-19,714,carbon paper,15,30,15,1,00210,India
427240,2023-10-19,709,notebook,30,60,30,1,00210,India
427240,2023-10-19,710,geometry box,100,150,50,1,00210,India
622565,2023-10-19,709,notebook,30,60,30,1,00288,India
622565,2023-10-19,706,sharpener,3,8,5,1,00288,India
622565,2023-10-19,717,spiral bound book,50,100,50,1,00288,India
622565,2023-10-19,707,marker,20,40,20,1,00288,India
337348,2023-10-19,706,sharpener,3,8,5,1,00158,India
337348,2023-10-19,715,folder,5,15,10,1,00158,India
337348,2023-10-19,704,scale,5,10,5,1,00158,India
558990,2023-10-19,712,graph paper,20,40,20,1,00401,India
558990,2023-10-19,713,ball pen,5,10,5,1,00401,India
558990,2023-10-19,708,sketchpen,15,40,25,1,00401,India
975087,2023-10-19,716,printing paper,200,400,200,1,00308,India
975087,2023-10-19,706,sharpener,3,8,5,1,00308,India
975087,2023-10-19,704,scale,5,10,5,1,00308,India
847063,2023-10-19,704,scale,5,10,5,1,00240,India
847063,2023-10-19,706,sharpener,3,8,5,1,00240,India
627789,2023-10-19,710,geometry box,100,150,50,1,00097,India
456792,2023-10-19,704,scale,5,10,5,1,00196,India
456792,2023-10-19,715,folder,5,15,10,1,00196,India
456792,2023-10-19,713,ball pen,5,10,5,1,00196,India
456792,2023-10-19,710,geometry box,100,150,50,1,00196,India
808898,2023-10-19,716,printing paper,200,400,200,1,00235,India
808898,2023-10-19,713,ball pen,5,10,5,1,00235,India
808898,2023-10-19,706,sharpener,3,8,5,1,00235,India
808898,2023-10-19,715,folder,5,15,10,1,00235,India
808898,2023-10-19,714,carbon paper,15,30,15,1,00235,India
884779,2023-10-19,717,spiral bound book,50,100,50,1,00203,India
193456,2023-10-19,717,spiral bound book,50,100,50,1,00317,India
193456,2023-10-19,708,sketchpen,15,40,25,1,00317,India
193456,2023-10-19,713,ball pen,5,10,5,1,00317,India
949359,2023-10-19,712,graph paper,20,40,20,1,00058,India
568388,2023-10-19,714,carbon paper,15,30,15,1,00359,India
568388,2023-10-19,702,pencil,2,5,3,1,00359,India
476598,2023-10-19,715,folder,5,15,10,1,00193,India
476598,2023-10-19,701,gel pen,5,10,5,1,00193,India
476598,2023-10-19,716,printing paper,200,400,200,1,00193,India
373603,2023-10-19,717,spiral bound book,50,100,50,1,00334,India
373603,2023-10-19,708,sketchpen,15,40,25,1,00334,India
599992,2023-10-19,710,geometry box,100,150,50,1,00215,India
392884,2023-10-19,708,sketchpen,15,40,25,1,00177,India
392884,2023-10-19,705,stencil,10,20,10,1,00177,India
392884,2023-10-19,713,ball pen,5,10,5,1,00177,India
392884,2023-10-19,702,pencil,2,5,3,1,00177,India
568102,2023-10-19,708,sketchpen,15,40,25,1,00321,India
568102,2023-10-19,713,ball pen,5,10,5,1,00321,India
568102,2023-10-19,703,eraser,1,3,2,1,00321,India
568102,2023-10-19,712,graph paper,20,40,20,1,00321,India
568102,2023-10-19,707,marker,20,40,20,1,00321,India
885859,2023-10-19,717,spiral bound book,50,100,50,1,00082,India
885859,2023-10-19,704,scale,5,10,5,1,00082,India
885859,2023-10-19,707,marker,20,40,20,1,00082,India
320344,2023-10-19,708,sketchpen,15,40,25,1,00268,India
320344,2023-10-19,702,pencil,2,5,3,1,00268,India
268459,2023-10-19,705,stencil,10,20,10,1,00311,India
268459,2023-10-19,706,sharpener,3,8,5,1,00311,India
268459,2023-10-19,708,sketchpen,15,40,25,1,00311,India
268459,2023-10-19,701,gel pen,5,10,5,1,00311,India
268459,2023-10-19,709,notebook,30,60,30,1,00311,India
403821,2023-10-19,702,pencil,2,5,3,1,00388,India
297360,2023-10-19,716,printing paper,200,400,200,1,00106,India
297360,2023-10-19,714,carbon paper,15,30,15,1,00106,India
297360,2023-10-19,704,scale,5,10,5,1,00106,India
808186,2023-10-19,704,scale,5,10,5,1,00399,India
808186,2023-10-19,702,pencil,2,5,3,1,00399,India
808186,2023-10-19,703,eraser,1,3,2,1,00399,India
808186,2023-10-19,712,graph paper,20,40,20,1,00399,India
808186,2023-10-19,706,sharpener,3,8,5,1,00399,India
410305,2023-10-19,706,sharpener,3,8,5,1,00425,India
594134,2023-10-19,708,sketchpen,15,40,25,1,00252,India
594134,2023-10-19,712,graph paper,20,40,20,1,00252,India
594134,2023-10-19,704,scale,5,10,5,1,00252,India
299102,2023-10-19,705,stencil,10,20,10,1,00042,India
938025,2023-10-19,709,notebook,30,60,30,1,00154,India
504182,2023-10-19,707,marker,20,40,20,1,00074,India
504182,2023-10-19,717,spiral bound book,50,100,50,1,00074,India
259469,2023-10-19,712,graph paper,20,40,20,1,00028,India
259469,2023-10-19,702,pencil,2,5,3,1,00028,India
616758,2023-10-20,711,TD kit,150,300,150,1,00216,India
616758,2023-10-20,703,eraser,1,3,2,1,00216,India
616758,2023-10-20,705,stencil,10,20,10,1,00216,India
574760,2023-10-20,707,marker,20,40,20,1,00333,India
574760,2023-10-20,709,notebook,30,60,30,1,00333,India
574760,2023-10-20,712,graph paper,20,40,20,1,00333,India
370376,2023-10-20,715,folder,5,15,10,1,00252,India
370376,2023-10-20,711,TD kit,150,300,150,1,00252,India
370376,2023-10-20,704,scale,5,10,5,1,00252,India
309490,2023-10-20,702,pencil,2,5,3,1,00440,India
309490,2023-10-20,710,geometry box,100,150,50,1,00440,India
309490,2023-10-20,701,gel pen,5,10,5,1,00440,India
309490,2023-10-20,706,sharpener,3,8,5,1,00440,India
309490,2023-10-20,716,printing paper,200,400,200,1,00440,India
612864,2023-10-20,706,sharpener,3,8,5,1,00489,India
612864,2023-10-20,703,eraser,1,3,2,1,00489,India
612864,2023-10-20,710,geometry box,100,150,50,1,00489,India
612864,2023-10-20,709,notebook,30,60,30,1,00489,India
685675,2023-10-20,703,eraser,1,3,2,1,00487,India
702108,2023-10-20,712,graph paper,20,40,20,1,00001,India
973203,2023-10-20,716,printing paper,200,400,200,1,00160,India
973203,2023-10-20,707,marker,20,40,20,1,00160,India
472035,2023-10-20,716,printing paper,200,400,200,1,00164,India
366758,2023-10-20,712,graph paper,20,40,20,1,00105,India
366758,2023-10-20,711,TD kit,150,300,150,1,00105,India
366758,2023-10-20,710,geometry box,100,150,50,1,00105,India
323341,2023-10-20,716,printing paper,200,400,200,1,00106,India
323341,2023-10-20,715,folder,5,15,10,1,00106,India
323341,2023-10-20,709,notebook,30,60,30,1,00106,India
379382,2023-10-20,703,eraser,1,3,2,1,00366,India
379382,2023-10-20,704,scale,5,10,5,1,00366,India
379382,2023-10-20,709,notebook,30,60,30,1,00366,India
203669,2023-10-20,702,pencil,2,5,3,1,00332,India
203669,2023-10-20,707,marker,20,40,20,1,00332,India
203669,2023-10-20,711,TD kit,150,300,150,1,00332,India
203669,2023-10-20,706,sharpener,3,8,5,1,00332,India
516172,2023-10-20,704,scale,5,10,5,1,00273,India
723993,2023-10-20,715,folder,5,15,10,1,00198,India
723993,2023-10-20,717,spiral bound book,50,100,50,1,00198,India
723993,2023-10-20,703,eraser,1,3,2,1,00198,India
723993,2023-10-20,711,TD kit,150,300,150,1,00198,India
723993,2023-10-20,714,carbon paper,15,30,15,1,00198,India
410065,2023-10-20,712,graph paper,20,40,20,1,00334,India
410065,2023-10-20,716,printing paper,200,400,200,1,00334,India
410065,2023-10-20,707,marker,20,40,20,1,00334,India
410065,2023-10-20,701,gel pen,5,10,5,1,00334,India
606515,2023-10-20,712,graph paper,20,40,20,1,00344,India
606515,2023-10-20,710,geometry box,100,150,50,1,00344,India
606515,2023-10-20,717,spiral bound book,50,100,50,1,00344,India
153620,2023-10-20,712,graph paper,20,40,20,1,00142,India
153620,2023-10-20,713,ball pen,5,10,5,1,00142,India
153620,2023-10-20,709,notebook,30,60,30,1,00142,India
153620,2023-10-20,717,spiral bound book,50,100,50,1,00142,India
153620,2023-10-20,715,folder,5,15,10,1,00142,India
822912,2023-10-20,714,carbon paper,15,30,15,1,00088,India
822912,2023-10-20,717,spiral bound book,50,100,50,1,00088,India
822912,2023-10-20,715,folder,5,15,10,1,00088,India
822912,2023-10-20,706,sharpener,3,8,5,1,00088,India
822912,2023-10-20,702,pencil,2,5,3,1,00088,India
980107,2023-10-20,710,geometry box,100,150,50,1,00448,India
980107,2023-10-20,712,graph paper,20,40,20,1,00448,India
980107,2023-10-20,713,ball pen,5,10,5,1,00448,India
203055,2023-10-20,716,printing paper,200,400,200,1,00031,India
203055,2023-10-20,702,pencil,2,5,3,1,00031,India
203055,2023-10-20,712,graph paper,20,40,20,1,00031,India
459004,2023-10-20,717,spiral bound book,50,100,50,1,00351,India
459004,2023-10-20,708,sketchpen,15,40,25,1,00351,India
644089,2023-10-20,708,sketchpen,15,40,25,1,00020,India
644089,2023-10-20,713,ball pen,5,10,5,1,00020,India
794350,2023-10-20,704,scale,5,10,5,1,00460,India
794350,2023-10-20,716,printing paper,200,400,200,1,00460,India
463297,2023-10-20,705,stencil,10,20,10,1,00391,India
463297,2023-10-20,711,TD kit,150,300,150,1,00391,India
463297,2023-10-20,706,sharpener,3,8,5,1,00391,India
463297,2023-10-20,703,eraser,1,3,2,1,00391,India
730130,2023-10-20,716,printing paper,200,400,200,1,00232,India
730130,2023-10-20,704,scale,5,10,5,1,00232,India
411033,2023-10-20,708,sketchpen,15,40,25,1,00270,India
411033,2023-10-20,705,stencil,10,20,10,1,00270,India
411033,2023-10-20,707,marker,20,40,20,1,00270,India
411033,2023-10-20,711,TD kit,150,300,150,1,00270,India
812823,2023-10-20,704,scale,5,10,5,1,00177,India
812823,2023-10-20,714,carbon paper,15,30,15,1,00177,India
812823,2023-10-20,706,sharpener,3,8,5,1,00177,India
563809,2023-10-20,715,folder,5,15,10,1,00465,India
563809,2023-10-20,709,notebook,30,60,30,1,00465,India
563809,2023-10-20,713,ball pen,5,10,5,1,00465,India
409647,2023-10-20,701,gel pen,5,10,5,1,00401,India
282557,2023-10-20,710,geometry box,100,150,50,1,00460,India
282557,2023-10-20,702,pencil,2,5,3,1,00460,India
282557,2023-10-20,709,notebook,30,60,30,1,00460,India
282557,2023-10-20,712,graph paper,20,40,20,1,00460,India
628523,2023-10-20,704,scale,5,10,5,1,00433,India
907394,2023-10-20,708,sketchpen,15,40,25,1,00311,India
907394,2023-10-20,704,scale,5,10,5,1,00311,India
245654,2023-10-20,704,scale,5,10,5,1,00342,India
245654,2023-10-20,717,spiral bound book,50,100,50,1,00342,India
245654,2023-10-20,705,stencil,10,20,10,1,00342,India
245654,2023-10-20,713,ball pen,5,10,5,1,00342,India
245654,2023-10-20,709,notebook,30,60,30,1,00342,India
607481,2023-10-20,703,eraser,1,3,2,1,00332,India
607481,2023-10-20,706,sharpener,3,8,5,1,00332,India
607481,2023-10-20,710,geometry box,100,150,50,1,00332,India
607481,2023-10-20,711,TD kit,150,300,150,1,00332,India
607481,2023-10-20,713,ball pen,5,10,5,1,00332,India
516551,2023-10-20,704,scale,5,10,5,1,00247,India
516551,2023-10-20,710,geometry box,100,150,50,1,00247,India
516551,2023-10-20,711,TD kit,150,300,150,1,00247,India
400727,2023-10-20,707,marker,20,40,20,1,00186,India
390072,2023-10-20,710,geometry box,100,150,50,1,00086,India
390072,2023-10-20,705,stencil,10,20,10,1,00086,India
781918,2023-10-20,701,gel pen,5,10,5,1,00162,India
781918,2023-10-20,710,geometry box,100,150,50,1,00162,India
302572,2023-10-20,709,notebook,30,60,30,1,00474,India
302572,2023-10-20,701,gel pen,5,10,5,1,00474,India
616468,2023-10-20,705,stencil,10,20,10,1,00001,India
616468,2023-10-20,709,notebook,30,60,30,1,00001,India
616468,2023-10-20,707,marker,20,40,20,1,00001,India
536538,2023-10-20,713,ball pen,5,10,5,1,00362,India
536538,2023-10-20,715,folder,5,15,10,1,00362,India
536538,2023-10-20,708,sketchpen,15,40,25,1,00362,India
874826,2023-10-20,714,carbon paper,15,30,15,1,00311,India
874826,2023-10-20,701,gel pen,5,10,5,1,00311,India
697158,2023-10-20,712,graph paper,20,40,20,1,00378,India
697158,2023-10-20,705,stencil,10,20,10,1,00378,India
672664,2023-10-20,708,sketchpen,15,40,25,1,00117,India
672664,2023-10-20,706,sharpener,3,8,5,1,00117,India
864975,2023-10-20,717,spiral bound book,50,100,50,1,00286,India
864975,2023-10-20,714,carbon paper,15,30,15,1,00286,India
821085,2023-10-20,713,ball pen,5,10,5,1,00010,India
116841,2023-10-21,714,carbon paper,15,30,15,1,00482,India
116841,2023-10-21,716,printing paper,200,400,200,1,00482,India
116841,2023-10-21,708,sketchpen,15,40,25,1,00482,India
132147,2023-10-21,715,folder,5,15,10,1,00454,India
132147,2023-10-21,714,carbon paper,15,30,15,1,00454,India
132147,2023-10-21,703,eraser,1,3,2,1,00454,India
432056,2023-10-21,711,TD kit,150,300,150,1,00351,India
432056,2023-10-21,716,printing paper,200,400,200,1,00351,India
432056,2023-10-21,714,carbon paper,15,30,15,1,00351,India
111203,2023-10-21,708,sketchpen,15,40,25,1,00155,India
111203,2023-10-21,704,scale,5,10,5,1,00155,India
343754,2023-10-21,708,sketchpen,15,40,25,1,00361,India
343754,2023-10-21,701,gel pen,5,10,5,1,00361,India
343754,2023-10-21,715,folder,5,15,10,1,00361,India
343754,2023-10-21,705,stencil,10,20,10,1,00361,India
892100,2023-10-21,710,geometry box,100,150,50,1,00269,India
892100,2023-10-21,709,notebook,30,60,30,1,00269,India
892100,2023-10-21,702,pencil,2,5,3,1,00269,India
892100,2023-10-21,712,graph paper,20,40,20,1,00269,India
887327,2023-10-21,709,notebook,30,60,30,1,00499,India
887327,2023-10-21,705,stencil,10,20,10,1,00499,India
887327,2023-10-21,710,geometry box,100,150,50,1,00499,India
790449,2023-10-21,713,ball pen,5,10,5,1,00303,India
790449,2023-10-21,716,printing paper,200,400,200,1,00303,India
790449,2023-10-21,706,sharpener,3,8,5,1,00303,India
175987,2023-10-21,704,scale,5,10,5,1,00298,India
175987,2023-10-21,708,sketchpen,15,40,25,1,00298,India
175987,2023-10-21,706,sharpener,3,8,5,1,00298,India
274686,2023-10-21,715,folder,5,15,10,1,00297,India
274686,2023-10-21,709,notebook,30,60,30,1,00297,India
274686,2023-10-21,707,marker,20,40,20,1,00297,India
274686,2023-10-21,704,scale,5,10,5,1,00297,India
829195,2023-10-21,711,TD kit,150,300,150,1,00279,India
829195,2023-10-21,715,folder,5,15,10,1,00279,India
829195,2023-10-21,705,stencil,10,20,10,1,00279,India
829195,2023-10-21,702,pencil,2,5,3,1,00279,India
665284,2023-10-21,715,folder,5,15,10,1,00138,India
665284,2023-10-21,708,sketchpen,15,40,25,1,00138,India
665284,2023-10-21,716,printing paper,200,400,200,1,00138,India
665284,2023-10-21,703,eraser,1,3,2,1,00138,India
665284,2023-10-21,712,graph paper,20,40,20,1,00138,India
766272,2023-10-21,702,pencil,2,5,3,1,00198,India
648871,2023-10-21,710,geometry box,100,150,50,1,00223,India
648871,2023-10-21,712,graph paper,20,40,20,1,00223,India
648871,2023-10-21,705,stencil,10,20,10,1,00223,India
415956,2023-10-21,708,sketchpen,15,40,25,1,00022,India
114164,2023-10-21,701,gel pen,5,10,5,1,00219,India
120207,2023-10-21,712,graph paper,20,40,20,1,00217,India
863752,2023-10-21,703,eraser,1,3,2,1,00066,India
863752,2023-10-21,715,folder,5,15,10,1,00066,India
137290,2023-10-21,713,ball pen,5,10,5,1,00251,India
137290,2023-10-21,703,eraser,1,3,2,1,00251,India
137290,2023-10-21,701,gel pen,5,10,5,1,00251,India
137290,2023-10-21,707,marker,20,40,20,1,00251,India
267711,2023-10-21,706,sharpener,3,8,5,1,00495,India
267711,2023-10-21,707,marker,20,40,20,1,00495,India
267711,2023-10-21,708,sketchpen,15,40,25,1,00495,India
267711,2023-10-21,704,scale,5,10,5,1,00495,India
929836,2023-10-21,709,notebook,30,60,30,1,00157,India
929836,2023-10-21,702,pencil,2,5,3,1,00157,India
929836,2023-10-21,704,scale,5,10,5,1,00157,India
380387,2023-10-21,703,eraser,1,3,2,1,00146,India
380387,2023-10-21,717,spiral bound book,50,100,50,1,00146,India
380387,2023-10-21,709,notebook,30,60,30,1,00146,India
380387,2023-10-21,716,printing paper,200,400,200,1,00146,India
864966,2023-10-21,715,folder,5,15,10,1,00242,India
864966,2023-10-21,701,gel pen,5,10,5,1,00242,India
864966,2023-10-21,717,spiral bound book,50,100,50,1,00242,India
566008,2023-10-21,707,marker,20,40,20,1,00281,India
566008,2023-10-21,717,spiral bound book,50,100,50,1,00281,India
566008,2023-10-21,709,notebook,30,60,30,1,00281,India
219281,2023-10-21,714,carbon paper,15,30,15,1,00048,India
219281,2023-10-21,706,sharpener,3,8,5,1,00048,India
219281,2023-10-21,708,sketchpen,15,40,25,1,00048,India
138937,2023-10-21,708,sketchpen,15,40,25,1,00440,India
138937,2023-10-21,716,printing paper,200,400,200,1,00440,India
138937,2023-10-21,717,spiral bound book,50,100,50,1,00440,India
138937,2023-10-21,709,notebook,30,60,30,1,00440,India
178733,2023-10-21,712,graph paper,20,40,20,1,00039,India
178733,2023-10-21,713,ball pen,5,10,5,1,00039,India
991174,2023-10-21,710,geometry box,100,150,50,1,00161,India
991174,2023-10-21,711,TD kit,150,300,150,1,00161,India
349446,2023-10-21,711,TD kit,150,300,150,1,00029,India
737441,2023-10-21,711,TD kit,150,300,150,1,00363,India
304214,2023-10-21,706,sharpener,3,8,5,1,00208,India
811575,2023-10-21,713,ball pen,5,10,5,1,00151,India
811575,2023-10-21,717,spiral bound book,50,100,50,1,00151,India
811575,2023-10-21,706,sharpener,3,8,5,1,00151,India
616159,2023-10-21,709,notebook,30,60,30,1,00115,India
616159,2023-10-21,707,marker,20,40,20,1,00115,India
616159,2023-10-21,710,geometry box,100,150,50,1,00115,India
616159,2023-10-21,715,folder,5,15,10,1,00115,India
616159,2023-10-21,702,pencil,2,5,3,1,00115,India
710566,2023-10-21,703,eraser,1,3,2,1,00363,India
710566,2023-10-21,715,folder,5,15,10,1,00363,India
710566,2023-10-21,714,carbon paper,15,30,15,1,00363,India
257075,2023-10-22,701,gel pen,5,10,5,1,00016,India
257075,2023-10-22,706,sharpener,3,8,5,1,00016,India
257075,2023-10-22,705,stencil,10,20,10,1,00016,India
831528,2023-10-22,709,notebook,30,60,30,1,00063,India
245877,2023-10-22,713,ball pen,5,10,5,1,00126,India
245877,2023-10-22,702,pencil,2,5,3,1,00126,India
245877,2023-10-22,704,scale,5,10,5,1,00126,India
373086,2023-10-22,703,eraser,1,3,2,1,00271,India
373086,2023-10-22,712,graph paper,20,40,20,1,00271,India
373086,2023-10-22,716,printing paper,200,400,200,1,00271,India
373086,2023-10-22,710,geometry box,100,150,50,1,00271,India
373086,2023-10-22,706,sharpener,3,8,5,1,00271,India
900859,2023-10-22,715,folder,5,15,10,1,00068,India
781010,2023-10-22,707,marker,20,40,20,1,00252,India
781010,2023-10-22,705,stencil,10,20,10,1,00252,India
781010,2023-10-22,702,pencil,2,5,3,1,00252,India
754184,2023-10-22,710,geometry box,100,150,50,1,00338,India
754184,2023-10-22,709,notebook,30,60,30,1,00338,India
241401,2023-10-22,710,geometry box,100,150,50,1,00421,India
174295,2023-10-22,702,pencil,2,5,3,1,00477,India
454547,2023-10-22,709,notebook,30,60,30,1,00098,India
454547,2023-10-22,717,spiral bound book,50,100,50,1,00098,India
402049,2023-10-22,702,pencil,2,5,3,1,00345,India
402049,2023-10-22,714,carbon paper,15,30,15,1,00345,India
446723,2023-10-22,713,ball pen,5,10,5,1,00126,India
446723,2023-10-22,716,printing paper,200,400,200,1,00126,India
446723,2023-10-22,704,scale,5,10,5,1,00126,India
446723,2023-10-22,702,pencil,2,5,3,1,00126,India
336273,2023-10-22,711,TD kit,150,300,150,1,00356,India
336273,2023-10-22,709,notebook,30,60,30,1,00356,India
714037,2023-10-22,705,stencil,10,20,10,1,00165,India
501663,2023-10-22,710,geometry box,100,150,50,1,00472,India
982366,2023-10-22,712,graph paper,20,40,20,1,00342,India
982366,2023-10-22,704,scale,5,10,5,1,00342,India
660138,2023-10-22,709,notebook,30,60,30,1,00470,India
209932,2023-10-22,707,marker,20,40,20,1,00466,India
788831,2023-10-22,716,printing paper,200,400,200,1,00175,India
788831,2023-10-22,706,sharpener,3,8,5,1,00175,India
788831,2023-10-22,715,folder,5,15,10,1,00175,India
241339,2023-10-22,702,pencil,2,5,3,1,00156,India
640872,2023-10-22,703,eraser,1,3,2,1,00170,India
640872,2023-10-22,715,folder,5,15,10,1,00170,India
640872,2023-10-22,712,graph paper,20,40,20,1,00170,India
101621,2023-10-22,710,geometry box,100,150,50,1,00311,India
101621,2023-10-22,714,carbon paper,15,30,15,1,00311,India
250078,2023-10-22,710,geometry box,100,150,50,1,00116,India
862227,2023-10-22,704,scale,5,10,5,1,00286,India
585936,2023-10-22,707,marker,20,40,20,1,00272,India
585936,2023-10-22,717,spiral bound book,50,100,50,1,00272,India
585936,2023-10-22,713,ball pen,5,10,5,1,00272,India
585936,2023-10-22,715,folder,5,15,10,1,00272,India
585936,2023-10-22,714,carbon paper,15,30,15,1,00272,India
946801,2023-10-22,702,pencil,2,5,3,1,00105,India
125533,2023-10-22,703,eraser,1,3,2,1,00033,India
125533,2023-10-22,701,gel pen,5,10,5,1,00033,India
400155,2023-10-22,704,scale,5,10,5,1,00210,India
400155,2023-10-22,712,graph paper,20,40,20,1,00210,India
924667,2023-10-22,713,ball pen,5,10,5,1,00079,India
924667,2023-10-22,701,gel pen,5,10,5,1,00079,India
924667,2023-10-22,710,geometry box,100,150,50,1,00079,India
530761,2023-10-22,713,ball pen,5,10,5,1,00498,India
530761,2023-10-22,714,carbon paper,15,30,15,1,00498,India
285044,2023-10-22,705,stencil,10,20,10,1,00266,India
745469,2023-10-22,702,pencil,2,5,3,1,00268,India
745469,2023-10-22,706,sharpener,3,8,5,1,00268,India
292682,2023-10-22,704,scale,5,10,5,1,00197,India
292682,2023-10-22,710,geometry box,100,150,50,1,00197,India
259609,2023-10-22,706,sharpener,3,8,5,1,00267,India
754778,2023-10-22,708,sketchpen,15,40,25,1,00318,India
754778,2023-10-22,715,folder,5,15,10,1,00318,India
754778,2023-10-22,717,spiral bound book,50,100,50,1,00318,India
754778,2023-10-22,705,stencil,10,20,10,1,00318,India
754778,2023-10-22,714,carbon paper,15,30,15,1,00318,India
201703,2023-10-22,704,scale,5,10,5,1,00312,India
201703,2023-10-22,708,sketchpen,15,40,25,1,00312,India
201703,2023-10-22,701,gel pen,5,10,5,1,00312,India
201703,2023-10-22,717,spiral bound book,50,100,50,1,00312,India
135258,2023-10-22,707,marker,20,40,20,1,00013,India
135258,2023-10-22,704,scale,5,10,5,1,00013,India
191057,2023-10-22,701,gel pen,5,10,5,1,00333,India
191057,2023-10-22,714,carbon paper,15,30,15,1,00333,India
191057,2023-10-22,717,spiral bound book,50,100,50,1,00333,India
950981,2023-10-22,705,stencil,10,20,10,1,00479,India
202435,2023-10-22,707,marker,20,40,20,1,00129,India
202435,2023-10-22,712,graph paper,20,40,20,1,00129,India
202435,2023-10-22,705,stencil,10,20,10,1,00129,India
202435,2023-10-22,713,ball pen,5,10,5,1,00129,India
619992,2023-10-22,708,sketchpen,15,40,25,1,00300,India
475891,2023-10-22,711,TD kit,150,300,150,1,00187,India
475891,2023-10-22,705,stencil,10,20,10,1,00187,India
793661,2023-10-22,709,notebook,30,60,30,1,00265,India
793661,2023-10-22,708,sketchpen,15,40,25,1,00265,India
793661,2023-10-22,713,ball pen,5,10,5,1,00265,India
832148,2023-10-22,715,folder,5,15,10,1,00177,India
519360,2023-10-22,716,printing paper,200,400,200,1,00064,India
519360,2023-10-22,713,ball pen,5,10,5,1,00064,India
519360,2023-10-22,703,eraser,1,3,2,1,00064,India
519360,2023-10-22,707,marker,20,40,20,1,00064,India
228107,2023-10-23,708,sketchpen,15,40,25,1,00072,India
514362,2023-10-23,701,gel pen,5,10,5,1,00147,India
514362,2023-10-23,714,carbon paper,15,30,15,1,00147,India
514362,2023-10-23,702,pencil,2,5,3,1,00147,India
407054,2023-10-23,714,carbon paper,15,30,15,1,00243,India
407054,2023-10-23,713,ball pen,5,10,5,1,00243,India
407054,2023-10-23,710,geometry box,100,150,50,1,00243,India
407054,2023-10-23,707,marker,20,40,20,1,00243,India
392943,2023-10-23,709,notebook,30,60,30,1,00051,India
392943,2023-10-23,704,scale,5,10,5,1,00051,India
392943,2023-10-23,703,eraser,1,3,2,1,00051,India
392943,2023-10-23,706,sharpener,3,8,5,1,00051,India
392943,2023-10-23,716,printing paper,200,400,200,1,00051,India
779629,2023-10-23,710,geometry box,100,150,50,1,00339,India
779629,2023-10-23,715,folder,5,15,10,1,00339,India
779629,2023-10-23,714,carbon paper,15,30,15,1,00339,India
779629,2023-10-23,708,sketchpen,15,40,25,1,00339,India
779629,2023-10-23,717,spiral bound book,50,100,50,1,00339,India
826764,2023-10-23,710,geometry box,100,150,50,1,00171,India
826764,2023-10-23,701,gel pen,5,10,5,1,00171,India
826764,2023-10-23,704,scale,5,10,5,1,00171,India
762065,2023-10-23,708,sketchpen,15,40,25,1,00413,India
762065,2023-10-23,710,geometry box,100,150,50,1,00413,India
656892,2023-10-23,701,gel pen,5,10,5,1,00162,India
286111,2023-10-23,707,marker,20,40,20,1,00400,India
286111,2023-10-23,703,eraser,1,3,2,1,00400,India
286111,2023-10-23,712,graph paper,20,40,20,1,00400,India
286111,2023-10-23,706,sharpener,3,8,5,1,00400,India
447908,2023-10-23,711,TD kit,150,300,150,1,00119,India
447908,2023-10-23,707,marker,20,40,20,1,00119,India
447908,2023-10-23,701,gel pen,5,10,5,1,00119,India
208296,2023-10-23,717,spiral bound book,50,100,50,1,00454,India
208296,2023-10-23,713,ball pen,5,10,5,1,00454,India
208296,2023-10-23,715,folder,5,15,10,1,00454,India
208296,2023-10-23,702,pencil,2,5,3,1,00454,India
414673,2023-10-23,714,carbon paper,15,30,15,1,00326,India
414673,2023-10-23,712,graph paper,20,40,20,1,00326,India
414673,2023-10-23,706,sharpener,3,8,5,1,00326,India
414673,2023-10-23,708,sketchpen,15,40,25,1,00326,India
414673,2023-10-23,713,ball pen,5,10,5,1,00326,India
618566,2023-10-23,711,TD kit,150,300,150,1,00482,India
618566,2023-10-23,712,graph paper,20,40,20,1,00482,India
618566,2023-10-23,713,ball pen,5,10,5,1,00482,India
618566,2023-10-23,701,gel pen,5,10,5,1,00482,India
618566,2023-10-23,710,geometry box,100,150,50,1,00482,India
979227,2023-10-23,702,pencil,2,5,3,1,00110,India
330651,2023-10-23,701,gel pen,5,10,5,1,00447,India
330651,2023-10-23,716,printing paper,200,400,200,1,00447,India
330651,2023-10-23,715,folder,5,15,10,1,00447,India
330651,2023-10-23,707,marker,20,40,20,1,00447,India
975261,2023-10-23,709,notebook,30,60,30,1,00056,India
975261,2023-10-23,706,sharpener,3,8,5,1,00056,India
711729,2023-10-23,709,notebook,30,60,30,1,00092,India
711729,2023-10-23,705,stencil,10,20,10,1,00092,India
711729,2023-10-23,717,spiral bound book,50,100,50,1,00092,India
711729,2023-10-23,711,TD kit,150,300,150,1,00092,India
777421,2023-10-23,711,TD kit,150,300,150,1,00494,India
777421,2023-10-23,705,stencil,10,20,10,1,00494,India
777421,2023-10-23,701,gel pen,5,10,5,1,00494,India
285646,2023-10-23,715,folder,5,15,10,1,00168,India
285646,2023-10-23,705,stencil,10,20,10,1,00168,India
285646,2023-10-23,704,scale,5,10,5,1,00168,India
285646,2023-10-23,707,marker,20,40,20,1,00168,India
285646,2023-10-23,708,sketchpen,15,40,25,1,00168,India
164684,2023-10-23,711,TD kit,150,300,150,1,00112,India
164684,2023-10-23,709,notebook,30,60,30,1,00112,India
164684,2023-10-23,704,scale,5,10,5,1,00112,India
134256,2023-10-23,704,scale,5,10,5,1,00465,India
134256,2023-10-23,708,sketchpen,15,40,25,1,00465,India
726365,2023-10-23,713,ball pen,5,10,5,1,00121,India
726365,2023-10-23,707,marker,20,40,20,1,00121,India
726365,2023-10-23,717,spiral bound book,50,100,50,1,00121,India
726365,2023-10-23,704,scale,5,10,5,1,00121,India
726365,2023-10-23,705,stencil,10,20,10,1,00121,India
356822,2023-10-23,711,TD kit,150,300,150,1,00286,India
356822,2023-10-23,707,marker,20,40,20,1,00286,India
356822,2023-10-23,715,folder,5,15,10,1,00286,India
356822,2023-10-23,701,gel pen,5,10,5,1,00286,India
911048,2023-10-23,716,printing paper,200,400,200,1,00223,India
911048,2023-10-23,717,spiral bound book,50,100,50,1,00223,India
507045,2023-10-23,712,graph paper,20,40,20,1,00133,India
507045,2023-10-23,704,scale,5,10,5,1,00133,India
434032,2023-10-23,704,scale,5,10,5,1,00309,India
434032,2023-10-23,701,gel pen,5,10,5,1,00309,India
434032,2023-10-23,705,stencil,10,20,10,1,00309,India
434032,2023-10-23,714,carbon paper,15,30,15,1,00309,India
425480,2023-10-23,707,marker,20,40,20,1,00352,India
425480,2023-10-23,701,gel pen,5,10,5,1,00352,India
425480,2023-10-23,717,spiral bound book,50,100,50,1,00352,India
425480,2023-10-23,711,TD kit,150,300,150,1,00352,India
425480,2023-10-23,715,folder,5,15,10,1,00352,India
178432,2023-10-23,704,scale,5,10,5,1,00020,India
178432,2023-10-23,702,pencil,2,5,3,1,00020,India
178432,2023-10-23,717,spiral bound book,50,100,50,1,00020,India
445456,2023-10-23,713,ball pen,5,10,5,1,00428,India
445456,2023-10-23,710,geometry box,100,150,50,1,00428,India
445456,2023-10-23,706,sharpener,3,8,5,1,00428,India
445456,2023-10-23,715,folder,5,15,10,1,00428,India
152806,2023-10-23,702,pencil,2,5,3,1,00199,India
152806,2023-10-23,708,sketchpen,15,40,25,1,00199,India
766594,2023-10-23,713,ball pen,5,10,5,1,00136,India
766594,2023-10-23,714,carbon paper,15,30,15,1,00136,India
766594,2023-10-23,705,stencil,10,20,10,1,00136,India
766594,2023-10-23,707,marker,20,40,20,1,00136,India
719119,2023-10-23,713,ball pen,5,10,5,1,00216,India
719119,2023-10-23,706,sharpener,3,8,5,1,00216,India
719119,2023-10-23,712,graph paper,20,40,20,1,00216,India
719119,2023-10-23,705,stencil,10,20,10,1,00216,India
975834,2023-10-23,714,carbon paper,15,30,15,1,00059,India
975834,2023-10-23,704,scale,5,10,5,1,00059,India
975834,2023-10-23,701,gel pen,5,10,5,1,00059,India
718671,2023-10-23,714,carbon paper,15,30,15,1,00434,India
718671,2023-10-23,709,notebook,30,60,30,1,00434,India
718671,2023-10-23,710,geometry box,100,150,50,1,00434,India
718671,2023-10-23,702,pencil,2,5,3,1,00434,India
594813,2023-10-23,713,ball pen,5,10,5,1,00301,India
594813,2023-10-23,715,folder,5,15,10,1,00301,India
594813,2023-10-23,716,printing paper,200,400,200,1,00301,India
157239,2023-10-23,707,marker,20,40,20,1,00104,India
157239,2023-10-23,706,sharpener,3,8,5,1,00104,India
157239,2023-10-23,713,ball pen,5,10,5,1,00104,India
157239,2023-10-23,709,notebook,30,60,30,1,00104,India
216301,2023-10-23,701,gel pen,5,10,5,1,00443,India
216301,2023-10-23,702,pencil,2,5,3,1,00443,India
216301,2023-10-23,714,carbon paper,15,30,15,1,00443,India
216301,2023-10-23,717,spiral bound book,50,100,50,1,00443,India
672219,2023-10-23,708,sketchpen,15,40,25,1,00147,India
672219,2023-10-23,703,eraser,1,3,2,1,00147,India
672219,2023-10-23,715,folder,5,15,10,1,00147,India
196215,2023-10-23,714,carbon paper,15,30,15,1,00257,India
196215,2023-10-23,708,sketchpen,15,40,25,1,00257,India
196215,2023-10-23,703,eraser,1,3,2,1,00257,India
447680,2023-10-23,710,geometry box,100,150,50,1,00352,India
447680,2023-10-23,715,folder,5,15,10,1,00352,India
447680,2023-10-23,713,ball pen,5,10,5,1,00352,India
447680,2023-10-23,706,sharpener,3,8,5,1,00352,India
447680,2023-10-23,708,sketchpen,15,40,25,1,00352,India
999948,2023-10-23,712,graph paper,20,40,20,1,00263,India
999948,2023-10-23,716,printing paper,200,400,200,1,00263,India
999948,2023-10-23,704,scale,5,10,5,1,00263,India
109562,2023-10-23,707,marker,20,40,20,1,00255,India
109562,2023-10-23,711,TD kit,150,300,150,1,00255,India
301699,2023-10-23,715,folder,5,15,10,1,00023,India
301699,2023-10-23,705,stencil,10,20,10,1,00023,India
251482,2023-10-23,706,sharpener,3,8,5,1,00331,India
251482,2023-10-23,708,sketchpen,15,40,25,1,00331,India
251482,2023-10-23,703,eraser,1,3,2,1,00331,India
917197,2023-10-23,705,stencil,10,20,10,1,00281,India
750163,2023-10-23,709,notebook,30,60,30,1,00363,India
750163,2023-10-23,707,marker,20,40,20,1,00363,India
750163,2023-10-23,716,printing paper,200,400,200,1,00363,India
513722,2023-10-23,701,gel pen,5,10,5,1,00396,India
513722,2023-10-23,705,stencil,10,20,10,1,00396,India
513722,2023-10-23,703,eraser,1,3,2,1,00396,India
513722,2023-10-23,713,ball pen,5,10,5,1,00396,India
931014,2023-10-23,716,printing paper,200,400,200,1,00428,India
931014,2023-10-23,712,graph paper,20,40,20,1,00428,India
931014,2023-10-23,706,sharpener,3,8,5,1,00428,India
223253,2023-10-23,704,scale,5,10,5,1,00182,India
223253,2023-10-23,706,sharpener,3,8,5,1,00182,India
223253,2023-10-23,709,notebook,30,60,30,1,00182,India
223253,2023-10-23,707,marker,20,40,20,1,00182,India
223253,2023-10-23,715,folder,5,15,10,1,00182,India
799974,2023-10-23,709,notebook,30,60,30,1,00117,India
799974,2023-10-23,705,stencil,10,20,10,1,00117,India
799974,2023-10-23,704,scale,5,10,5,1,00117,India
454476,2023-10-24,710,geometry box,100,150,50,1,00485,India
454476,2023-10-24,715,folder,5,15,10,1,00485,India
454476,2023-10-24,711,TD kit,150,300,150,1,00485,India
600952,2023-10-24,705,stencil,10,20,10,1,00356,India
388496,2023-10-24,717,spiral bound book,50,100,50,1,00071,India
388496,2023-10-24,704,scale,5,10,5,1,00071,India
388496,2023-10-24,716,printing paper,200,400,200,1,00071,India
388496,2023-10-24,705,stencil,10,20,10,1,00071,India
388496,2023-10-24,709,notebook,30,60,30,1,00071,India
526097,2023-10-24,704,scale,5,10,5,1,00012,India
526097,2023-10-24,702,pencil,2,5,3,1,00012,India
473865,2023-10-24,715,folder,5,15,10,1,00227,India
473865,2023-10-24,702,pencil,2,5,3,1,00227,India
473865,2023-10-24,706,sharpener,3,8,5,1,00227,India
473865,2023-10-24,710,geometry box,100,150,50,1,00227,India
473865,2023-10-24,707,marker,20,40,20,1,00227,India
771974,2023-10-24,716,printing paper,200,400,200,1,00040,India
984846,2023-10-24,713,ball pen,5,10,5,1,00187,India
984846,2023-10-24,703,eraser,1,3,2,1,00187,India
984846,2023-10-24,715,folder,5,15,10,1,00187,India
325873,2023-10-24,713,ball pen,5,10,5,1,00269,India
182032,2023-10-24,712,graph paper,20,40,20,1,00292,India
286940,2023-10-24,714,carbon paper,15,30,15,1,00457,India
286940,2023-10-24,709,notebook,30,60,30,1,00457,India
286940,2023-10-24,703,eraser,1,3,2,1,00457,India
286940,2023-10-24,708,sketchpen,15,40,25,1,00457,India
718774,2023-10-24,705,stencil,10,20,10,1,00092,India
737086,2023-10-24,702,pencil,2,5,3,1,00475,India
737086,2023-10-24,717,spiral bound book,50,100,50,1,00475,India
737086,2023-10-24,701,gel pen,5,10,5,1,00475,India
737086,2023-10-24,705,stencil,10,20,10,1,00475,India
131041,2023-10-24,711,TD kit,150,300,150,1,00090,India
131041,2023-10-24,709,notebook,30,60,30,1,00090,India
131041,2023-10-24,708,sketchpen,15,40,25,1,00090,India
131041,2023-10-24,716,printing paper,200,400,200,1,00090,India
131041,2023-10-24,713,ball pen,5,10,5,1,00090,India
896303,2023-10-24,704,scale,5,10,5,1,00171,India
896303,2023-10-24,709,notebook,30,60,30,1,00171,India
896303,2023-10-24,710,geometry box,100,150,50,1,00171,India
896303,2023-10-24,713,ball pen,5,10,5,1,00171,India
896303,2023-10-24,715,folder,5,15,10,1,00171,India
284761,2023-10-24,713,ball pen,5,10,5,1,00049,India
284761,2023-10-24,711,TD kit,150,300,150,1,00049,India
284761,2023-10-24,704,scale,5,10,5,1,00049,India
284761,2023-10-24,705,stencil,10,20,10,1,00049,India
420264,2023-10-24,716,printing paper,200,400,200,1,00189,India
420264,2023-10-24,707,marker,20,40,20,1,00189,India
420264,2023-10-24,708,sketchpen,15,40,25,1,00189,India
420264,2023-10-24,709,notebook,30,60,30,1,00189,India
530930,2023-10-24,703,eraser,1,3,2,1,00324,India
530930,2023-10-24,713,ball pen,5,10,5,1,00324,India
820267,2023-10-24,711,TD kit,150,300,150,1,00300,India
820267,2023-10-24,704,scale,5,10,5,1,00300,India
820267,2023-10-24,715,folder,5,15,10,1,00300,India
820267,2023-10-24,702,pencil,2,5,3,1,00300,India
820267,2023-10-24,706,sharpener,3,8,5,1,00300,India
319170,2023-10-24,713,ball pen,5,10,5,1,00059,India
652323,2023-10-24,704,scale,5,10,5,1,00101,India
652323,2023-10-24,716,printing paper,200,400,200,1,00101,India
111852,2023-10-24,702,pencil,2,5,3,1,00335,India
111852,2023-10-24,710,geometry box,100,150,50,1,00335,India
111852,2023-10-24,701,gel pen,5,10,5,1,00335,India
841953,2023-10-24,717,spiral bound book,50,100,50,1,00193,India
132566,2023-10-24,715,folder,5,15,10,1,00419,India
132566,2023-10-24,712,graph paper,20,40,20,1,00419,India
132566,2023-10-24,704,scale,5,10,5,1,00419,India
944408,2023-10-24,714,carbon paper,15,30,15,1,00232,India
944408,2023-10-24,705,stencil,10,20,10,1,00232,India
944408,2023-10-24,706,sharpener,3,8,5,1,00232,India
943753,2023-10-24,709,notebook,30,60,30,1,00221,India
943753,2023-10-24,712,graph paper,20,40,20,1,00221,India
943753,2023-10-24,714,carbon paper,15,30,15,1,00221,India
943753,2023-10-24,703,eraser,1,3,2,1,00221,India
943753,2023-10-24,716,printing paper,200,400,200,1,00221,India
333130,2023-10-24,715,folder,5,15,10,1,00296,India
333130,2023-10-24,705,stencil,10,20,10,1,00296,India
333130,2023-10-24,710,geometry box,100,150,50,1,00296,India
333130,2023-10-24,709,notebook,30,60,30,1,00296,India
725015,2023-10-24,705,stencil,10,20,10,1,00370,India
725015,2023-10-24,713,ball pen,5,10,5,1,00370,India
725015,2023-10-24,716,printing paper,200,400,200,1,00370,India
725015,2023-10-24,710,geometry box,100,150,50,1,00370,India
524271,2023-10-24,705,stencil,10,20,10,1,00301,India
524271,2023-10-24,717,spiral bound book,50,100,50,1,00301,India
524271,2023-10-24,703,eraser,1,3,2,1,00301,India
524271,2023-10-24,706,sharpener,3,8,5,1,00301,India
618153,2023-10-24,716,printing paper,200,400,200,1,00374,India
618153,2023-10-24,705,stencil,10,20,10,1,00374,India
618153,2023-10-24,701,gel pen,5,10,5,1,00374,India
618153,2023-10-24,707,marker,20,40,20,1,00374,India
838655,2023-10-24,714,carbon paper,15,30,15,1,00294,India
838655,2023-10-24,707,marker,20,40,20,1,00294,India
838655,2023-10-24,701,gel pen,5,10,5,1,00294,India
838655,2023-10-24,710,geometry box,100,150,50,1,00294,India
564690,2023-10-24,708,sketchpen,15,40,25,1,00264,India
564690,2023-10-24,704,scale,5,10,5,1,00264,India
564690,2023-10-24,701,gel pen,5,10,5,1,00264,India
359193,2023-10-24,709,notebook,30,60,30,1,00142,India
359193,2023-10-24,713,ball pen,5,10,5,1,00142,India
359193,2023-10-24,705,stencil,10,20,10,1,00142,India
359193,2023-10-24,708,sketchpen,15,40,25,1,00142,India
533843,2023-10-24,707,marker,20,40,20,1,00130,India
533843,2023-10-24,708,sketchpen,15,40,25,1,00130,India
199011,2023-10-24,716,printing paper,200,400,200,1,00458,India
199011,2023-10-24,706,sharpener,3,8,5,1,00458,India
199011,2023-10-24,710,geometry box,100,150,50,1,00458,India
152523,2023-10-24,712,graph paper,20,40,20,1,00206,India
152523,2023-10-24,715,folder,5,15,10,1,00206,India
152523,2023-10-24,706,sharpener,3,8,5,1,00206,India
652199,2023-10-24,707,marker,20,40,20,1,00448,India
652199,2023-10-24,715,folder,5,15,10,1,00448,India
652199,2023-10-24,701,gel pen,5,10,5,1,00448,India
602286,2023-10-24,713,ball pen,5,10,5,1,00110,India
602286,2023-10-24,708,sketchpen,15,40,25,1,00110,India
602286,2023-10-24,709,notebook,30,60,30,1,00110,India
510542,2023-10-24,714,carbon paper,15,30,15,1,00374,India
510542,2023-10-24,712,graph paper,20,40,20,1,00374,India
510542,2023-10-24,708,sketchpen,15,40,25,1,00374,India
510542,2023-10-24,709,notebook,30,60,30,1,00374,India
934251,2023-10-24,703,eraser,1,3,2,1,00398,India
934251,2023-10-24,711,TD kit,150,300,150,1,00398,India
144640,2023-10-24,702,pencil,2,5,3,1,00474,India
144640,2023-10-24,701,gel pen,5,10,5,1,00474,India
144640,2023-10-24,716,printing paper,200,400,200,1,00474,India
144640,2023-10-24,709,notebook,30,60,30,1,00474,India
529284,2023-10-24,711,TD kit,150,300,150,1,00144,India
529284,2023-10-24,706,sharpener,3,8,5,1,00144,India
224988,2023-10-24,711,TD kit,150,300,150,1,00430,India
224988,2023-10-24,708,sketchpen,15,40,25,1,00430,India
224988,2023-10-24,716,printing paper,200,400,200,1,00430,India
515335,2023-10-24,707,marker,20,40,20,1,00141,India
515335,2023-10-24,715,folder,5,15,10,1,00141,India
515335,2023-10-24,714,carbon paper,15,30,15,1,00141,India
515335,2023-10-24,713,ball pen,5,10,5,1,00141,India
191378,2023-10-24,704,scale,5,10,5,1,00480,India
191378,2023-10-24,710,geometry box,100,150,50,1,00480,India
191378,2023-10-24,711,TD kit,150,300,150,1,00480,India
191378,2023-10-24,715,folder,5,15,10,1,00480,India
612618,2023-10-24,716,printing paper,200,400,200,1,00042,India
612618,2023-10-24,701,gel pen,5,10,5,1,00042,India
612618,2023-10-24,713,ball pen,5,10,5,1,00042,India
612618,2023-10-24,707,marker,20,40,20,1,00042,India
612618,2023-10-24,704,scale,5,10,5,1,00042,India
593906,2023-10-24,715,folder,5,15,10,1,00380,India
593906,2023-10-24,702,pencil,2,5,3,1,00380,India
593906,2023-10-24,701,gel pen,5,10,5,1,00380,India
593906,2023-10-24,711,TD kit,150,300,150,1,00380,India
762368,2023-10-24,707,marker,20,40,20,1,00123,India
762368,2023-10-24,712,graph paper,20,40,20,1,00123,India
941786,2023-10-24,716,printing paper,200,400,200,1,00418,India
941786,2023-10-24,704,scale,5,10,5,1,00418,India
627892,2023-10-24,705,stencil,10,20,10,1,00500,India
627892,2023-10-24,707,marker,20,40,20,1,00500,India
828708,2023-10-25,710,geometry box,100,150,50,1,00300,India
828708,2023-10-25,714,carbon paper,15,30,15,1,00300,India
828708,2023-10-25,702,pencil,2,5,3,1,00300,India
422156,2023-10-25,717,spiral bound book,50,100,50,1,00363,India
422156,2023-10-25,701,gel pen,5,10,5,1,00363,India
422156,2023-10-25,703,eraser,1,3,2,1,00363,India
508758,2023-10-25,716,printing paper,200,400,200,1,00345,India
508758,2023-10-25,711,TD kit,150,300,150,1,00345,India
149953,2023-10-25,701,gel pen,5,10,5,1,00124,India
149953,2023-10-25,713,ball pen,5,10,5,1,00124,India
426421,2023-10-25,705,stencil,10,20,10,1,00481,India
700165,2023-10-25,716,printing paper,200,400,200,1,00218,India
700165,2023-10-25,704,scale,5,10,5,1,00218,India
700165,2023-10-25,702,pencil,2,5,3,1,00218,India
680600,2023-10-25,709,notebook,30,60,30,1,00344,India
680600,2023-10-25,707,marker,20,40,20,1,00344,India
680600,2023-10-25,712,graph paper,20,40,20,1,00344,India
694103,2023-10-25,707,marker,20,40,20,1,00358,India
694103,2023-10-25,708,sketchpen,15,40,25,1,00358,India
694103,2023-10-25,717,spiral bound book,50,100,50,1,00358,India
694103,2023-10-25,702,pencil,2,5,3,1,00358,India
305419,2023-10-25,704,scale,5,10,5,1,00298,India
305419,2023-10-25,710,geometry box,100,150,50,1,00298,India
305419,2023-10-25,703,eraser,1,3,2,1,00298,India
960677,2023-10-25,706,sharpener,3,8,5,1,00086,India
960677,2023-10-25,703,eraser,1,3,2,1,00086,India
729325,2023-10-25,711,TD kit,150,300,150,1,00035,India
953130,2023-10-25,710,geometry box,100,150,50,1,00094,India
953130,2023-10-25,703,eraser,1,3,2,1,00094,India
515386,2023-10-25,701,gel pen,5,10,5,1,00372,India
988497,2023-10-25,717,spiral bound book,50,100,50,1,00484,India
988497,2023-10-25,709,notebook,30,60,30,1,00484,India
988497,2023-10-25,703,eraser,1,3,2,1,00484,India
988497,2023-10-25,712,graph paper,20,40,20,1,00484,India
988497,2023-10-25,701,gel pen,5,10,5,1,00484,India
807794,2023-10-25,701,gel pen,5,10,5,1,00052,India
749188,2023-10-25,701,gel pen,5,10,5,1,00327,India
749188,2023-10-25,705,stencil,10,20,10,1,00327,India
121711,2023-10-25,708,sketchpen,15,40,25,1,00194,India
688348,2023-10-25,711,TD kit,150,300,150,1,00360,India
688348,2023-10-25,702,pencil,2,5,3,1,00360,India
600212,2023-10-25,703,eraser,1,3,2,1,00104,India
600212,2023-10-25,704,scale,5,10,5,1,00104,India
600212,2023-10-25,707,marker,20,40,20,1,00104,India
155424,2023-10-25,710,geometry box,100,150,50,1,00303,India
155424,2023-10-25,716,printing paper,200,400,200,1,00303,India
466197,2023-10-25,705,stencil,10,20,10,1,00247,India
308976,2023-10-25,713,ball pen,5,10,5,1,00391,India
308976,2023-10-25,710,geometry box,100,150,50,1,00391,India
200279,2023-10-25,714,carbon paper,15,30,15,1,00026,India
200279,2023-10-25,710,geometry box,100,150,50,1,00026,India
200279,2023-10-25,708,sketchpen,15,40,25,1,00026,India
155827,2023-10-25,716,printing paper,200,400,200,1,00090,India
155827,2023-10-25,701,gel pen,5,10,5,1,00090,India
155827,2023-10-25,705,stencil,10,20,10,1,00090,India
155827,2023-10-25,717,spiral bound book,50,100,50,1,00090,India
871617,2023-10-25,715,folder,5,15,10,1,00140,India
871617,2023-10-25,703,eraser,1,3,2,1,00140,India
698017,2023-10-25,716,printing paper,200,400,200,1,00215,India
698017,2023-10-25,705,stencil,10,20,10,1,00215,India
239782,2023-10-25,717,spiral bound book,50,100,50,1,00199,India
239782,2023-10-25,715,folder,5,15,10,1,00199,India
239782,2023-10-25,706,sharpener,3,8,5,1,00199,India
644961,2023-10-25,704,scale,5,10,5,1,00236,India
644961,2023-10-25,701,gel pen,5,10,5,1,00236,India
644961,2023-10-25,711,TD kit,150,300,150,1,00236,India
846128,2023-10-25,714,carbon paper,15,30,15,1,00188,India
846128,2023-10-25,708,sketchpen,15,40,25,1,00188,India
846128,2023-10-25,709,notebook,30,60,30,1,00188,India
907942,2023-10-25,705,stencil,10,20,10,1,00331,India
454310,2023-10-25,717,spiral bound book,50,100,50,1,00278,India
454310,2023-10-25,707,marker,20,40,20,1,00278,India
595548,2023-10-26,702,pencil,2,5,3,1,00248,India
595548,2023-10-26,710,geometry box,100,150,50,1,00248,India
595548,2023-10-26,711,TD kit,150,300,150,1,00248,India
595548,2023-10-26,715,folder,5,15,10,1,00248,India
347560,2023-10-26,705,stencil,10,20,10,1,00384,India
325026,2023-10-26,717,spiral bound book,50,100,50,1,00136,India
325026,2023-10-26,704,scale,5,10,5,1,00136,India
431416,2023-10-26,716,printing paper,200,400,200,1,00237,India
431416,2023-10-26,714,carbon paper,15,30,15,1,00237,India
431416,2023-10-26,701,gel pen,5,10,5,1,00237,India
431416,2023-10-26,706,sharpener,3,8,5,1,00237,India
218278,2023-10-26,714,carbon paper,15,30,15,1,00301,India
218278,2023-10-26,703,eraser,1,3,2,1,00301,India
218278,2023-10-26,704,scale,5,10,5,1,00301,India
590691,2023-10-26,701,gel pen,5,10,5,1,00099,India
590691,2023-10-26,709,notebook,30,60,30,1,00099,India
590691,2023-10-26,706,sharpener,3,8,5,1,00099,India
258707,2023-10-26,714,carbon paper,15,30,15,1,00338,India
258707,2023-10-26,704,scale,5,10,5,1,00338,India
258707,2023-10-26,709,notebook,30,60,30,1,00338,India
852550,2023-10-26,705,stencil,10,20,10,1,00005,India
852550,2023-10-26,711,TD kit,150,300,150,1,00005,India
927329,2023-10-26,714,carbon paper,15,30,15,1,00003,India
927329,2023-10-26,711,TD kit,150,300,150,1,00003,India
278600,2023-10-26,713,ball pen,5,10,5,1,00473,India
119486,2023-10-26,711,TD kit,150,300,150,1,00122,India
305612,2023-10-26,712,graph paper,20,40,20,1,00335,India
305612,2023-10-26,706,sharpener,3,8,5,1,00335,India
305612,2023-10-26,703,eraser,1,3,2,1,00335,India
305612,2023-10-26,702,pencil,2,5,3,1,00335,India
359943,2023-10-26,708,sketchpen,15,40,25,1,00093,India
359943,2023-10-26,704,scale,5,10,5,1,00093,India
359943,2023-10-26,705,stencil,10,20,10,1,00093,India
692661,2023-10-26,706,sharpener,3,8,5,1,00428,India
692661,2023-10-26,716,printing paper,200,400,200,1,00428,India
692661,2023-10-26,707,marker,20,40,20,1,00428,India
692661,2023-10-26,705,stencil,10,20,10,1,00428,India
827356,2023-10-26,713,ball pen,5,10,5,1,00322,India
827356,2023-10-26,708,sketchpen,15,40,25,1,00322,India
827356,2023-10-26,712,graph paper,20,40,20,1,00322,India
657433,2023-10-26,706,sharpener,3,8,5,1,00081,India
850748,2023-10-26,712,graph paper,20,40,20,1,00068,India
850748,2023-10-26,714,carbon paper,15,30,15,1,00068,India
486325,2023-10-26,712,graph paper,20,40,20,1,00222,India
486325,2023-10-26,701,gel pen,5,10,5,1,00222,India
486325,2023-10-26,707,marker,20,40,20,1,00222,India
237969,2023-10-26,708,sketchpen,15,40,25,1,00331,India
237969,2023-10-26,703,eraser,1,3,2,1,00331,India
237969,2023-10-26,710,geometry box,100,150,50,1,00331,India
237969,2023-10-26,706,sharpener,3,8,5,1,00331,India
142646,2023-10-26,717,spiral bound book,50,100,50,1,00386,India
142646,2023-10-26,711,TD kit,150,300,150,1,00386,India
142646,2023-10-26,716,printing paper,200,400,200,1,00386,India
142646,2023-10-26,703,eraser,1,3,2,1,00386,India
714462,2023-10-26,711,TD kit,150,300,150,1,00348,India
714462,2023-10-26,704,scale,5,10,5,1,00348,India
714462,2023-10-26,716,printing paper,200,400,200,1,00348,India
709802,2023-10-26,716,printing paper,200,400,200,1,00201,India
709802,2023-10-26,715,folder,5,15,10,1,00201,India
709802,2023-10-26,712,graph paper,20,40,20,1,00201,India
709802,2023-10-26,703,eraser,1,3,2,1,00201,India
454413,2023-10-26,704,scale,5,10,5,1,00397,India
454413,2023-10-26,716,printing paper,200,400,200,1,00397,India
645399,2023-10-26,707,marker,20,40,20,1,00011,India
373683,2023-10-26,710,geometry box,100,150,50,1,00346,India
373683,2023-10-26,701,gel pen,5,10,5,1,00346,India
373683,2023-10-26,714,carbon paper,15,30,15,1,00346,India
565426,2023-10-26,717,spiral bound book,50,100,50,1,00298,India
565426,2023-10-26,716,printing paper,200,400,200,1,00298,India
871374,2023-10-26,717,spiral bound book,50,100,50,1,00312,India
871374,2023-10-26,702,pencil,2,5,3,1,00312,India
871374,2023-10-26,709,notebook,30,60,30,1,00312,India
966726,2023-10-26,714,carbon paper,15,30,15,1,00177,India
966726,2023-10-26,709,notebook,30,60,30,1,00177,India
966726,2023-10-26,708,sketchpen,15,40,25,1,00177,India
966726,2023-10-26,701,gel pen,5,10,5,1,00177,India
153495,2023-10-26,710,geometry box,100,150,50,1,00024,India
153495,2023-10-26,712,graph paper,20,40,20,1,00024,India
153495,2023-10-26,702,pencil,2,5,3,1,00024,India
334551,2023-10-26,702,pencil,2,5,3,1,00114,India
593709,2023-10-26,708,sketchpen,15,40,25,1,00067,India
593709,2023-10-26,711,TD kit,150,300,150,1,00067,India
593709,2023-10-26,709,notebook,30,60,30,1,00067,India
717575,2023-10-27,708,sketchpen,15,40,25,1,00400,India
717575,2023-10-27,712,graph paper,20,40,20,1,00400,India
717575,2023-10-27,701,gel pen,5,10,5,1,00400,India
717575,2023-10-27,715,folder,5,15,10,1,00400,India
657255,2023-10-27,709,notebook,30,60,30,1,00356,India
657255,2023-10-27,713,ball pen,5,10,5,1,00356,India
487226,2023-10-27,707,marker,20,40,20,1,00028,India
487226,2023-10-27,712,graph paper,20,40,20,1,00028,India
498254,2023-10-27,709,notebook,30,60,30,1,00129,India
498254,2023-10-27,707,marker,20,40,20,1,00129,India
535845,2023-10-27,703,eraser,1,3,2,1,00344,India
535845,2023-10-27,710,geometry box,100,150,50,1,00344,India
535845,2023-10-27,711,TD kit,150,300,150,1,00344,India
535845,2023-10-27,707,marker,20,40,20,1,00344,India
182498,2023-10-27,703,eraser,1,3,2,1,00292,India
182498,2023-10-27,705,stencil,10,20,10,1,00292,India
997690,2023-10-27,702,pencil,2,5,3,1,00147,India
997690,2023-10-27,716,printing paper,200,400,200,1,00147,India
997690,2023-10-27,704,scale,5,10,5,1,00147,India
997690,2023-10-27,703,eraser,1,3,2,1,00147,India
304186,2023-10-27,710,geometry box,100,150,50,1,00062,India
304186,2023-10-27,703,eraser,1,3,2,1,00062,India
304186,2023-10-27,709,notebook,30,60,30,1,00062,India
679926,2023-10-27,708,sketchpen,15,40,25,1,00173,India
679926,2023-10-27,701,gel pen,5,10,5,1,00173,India
679926,2023-10-27,717,spiral bound book,50,100,50,1,00173,India
679926,2023-10-27,704,scale,5,10,5,1,00173,India
426468,2023-10-27,711,TD kit,150,300,150,1,00042,India
968332,2023-10-27,711,TD kit,150,300,150,1,00323,India
968332,2023-10-27,715,folder,5,15,10,1,00323,India
968332,2023-10-27,704,scale,5,10,5,1,00323,India
357495,2023-10-27,704,scale,5,10,5,1,00097,India
357495,2023-10-27,713,ball pen,5,10,5,1,00097,India
357495,2023-10-27,703,eraser,1,3,2,1,00097,India
357495,2023-10-27,717,spiral bound book,50,100,50,1,00097,India
357495,2023-10-27,716,printing paper,200,400,200,1,00097,India
896358,2023-10-27,715,folder,5,15,10,1,00475,India
896358,2023-10-27,710,geometry box,100,150,50,1,00475,India
896358,2023-10-27,711,TD kit,150,300,150,1,00475,India
315418,2023-10-27,711,TD kit,150,300,150,1,00079,India
315418,2023-10-27,712,graph paper,20,40,20,1,00079,India
117826,2023-10-27,709,notebook,30,60,30,1,00198,India
117826,2023-10-27,701,gel pen,5,10,5,1,00198,India
219675,2023-10-27,715,folder,5,15,10,1,00043,India
219675,2023-10-27,704,scale,5,10,5,1,00043,India
219675,2023-10-27,713,ball pen,5,10,5,1,00043,India
980796,2023-10-27,706,sharpener,3,8,5,1,00468,India
980796,2023-10-27,715,folder,5,15,10,1,00468,India
980796,2023-10-27,711,TD kit,150,300,150,1,00468,India
980796,2023-10-27,717,spiral bound book,50,100,50,1,00468,India
987696,2023-10-27,713,ball pen,5,10,5,1,00425,India
987696,2023-10-27,717,spiral bound book,50,100,50,1,00425,India
987696,2023-10-27,703,eraser,1,3,2,1,00425,India
987696,2023-10-27,701,gel pen,5,10,5,1,00425,India
186119,2023-10-27,715,folder,5,15,10,1,00238,India
489034,2023-10-27,704,scale,5,10,5,1,00061,India
487149,2023-10-27,705,stencil,10,20,10,1,00446,India
752294,2023-10-27,704,scale,5,10,5,1,00312,India
752294,2023-10-27,706,sharpener,3,8,5,1,00312,India
752294,2023-10-27,705,stencil,10,20,10,1,00312,India
752294,2023-10-27,712,graph paper,20,40,20,1,00312,India
689085,2023-10-27,717,spiral bound book,50,100,50,1,00128,India
968999,2023-10-27,714,carbon paper,15,30,15,1,00284,India
822112,2023-10-27,707,marker,20,40,20,1,00158,India
822112,2023-10-27,703,eraser,1,3,2,1,00158,India
822112,2023-10-27,702,pencil,2,5,3,1,00158,India
822112,2023-10-27,705,stencil,10,20,10,1,00158,India
775855,2023-10-27,709,notebook,30,60,30,1,00250,India
775855,2023-10-27,706,sharpener,3,8,5,1,00250,India
155716,2023-10-27,716,printing paper,200,400,200,1,00065,India
155716,2023-10-27,703,eraser,1,3,2,1,00065,India
155716,2023-10-27,717,spiral bound book,50,100,50,1,00065,India
155716,2023-10-27,715,folder,5,15,10,1,00065,India
652827,2023-10-27,717,spiral bound book,50,100,50,1,00449,India
652827,2023-10-27,705,stencil,10,20,10,1,00449,India
487561,2023-10-27,715,folder,5,15,10,1,00191,India
487561,2023-10-27,708,sketchpen,15,40,25,1,00191,India
487561,2023-10-27,711,TD kit,150,300,150,1,00191,India
370315,2023-10-27,709,notebook,30,60,30,1,00312,India
370315,2023-10-27,717,spiral bound book,50,100,50,1,00312,India
370315,2023-10-27,713,ball pen,5,10,5,1,00312,India
370315,2023-10-27,711,TD kit,150,300,150,1,00312,India
113818,2023-10-27,712,graph paper,20,40,20,1,00195,India
113818,2023-10-27,707,marker,20,40,20,1,00195,India
415986,2023-10-27,710,geometry box,100,150,50,1,00472,India
415986,2023-10-27,707,marker,20,40,20,1,00472,India
760276,2023-10-27,712,graph paper,20,40,20,1,00091,India
760276,2023-10-27,703,eraser,1,3,2,1,00091,India
760276,2023-10-27,717,spiral bound book,50,100,50,1,00091,India
760276,2023-10-27,701,gel pen,5,10,5,1,00091,India
634899,2023-10-27,705,stencil,10,20,10,1,00023,India
634899,2023-10-27,713,ball pen,5,10,5,1,00023,India
634899,2023-10-27,709,notebook,30,60,30,1,00023,India
885821,2023-10-28,716,printing paper,200,400,200,1,00183,India
859837,2023-10-28,717,spiral bound book,50,100,50,1,00415,India
614626,2023-10-28,701,gel pen,5,10,5,1,00107,India
614626,2023-10-28,703,eraser,1,3,2,1,00107,India
614626,2023-10-28,710,geometry box,100,150,50,1,00107,India
655001,2023-10-28,713,ball pen,5,10,5,1,00126,India
332045,2023-10-28,701,gel pen,5,10,5,1,00013,India
332045,2023-10-28,703,eraser,1,3,2,1,00013,India
332045,2023-10-28,707,marker,20,40,20,1,00013,India
332045,2023-10-28,702,pencil,2,5,3,1,00013,India
908060,2023-10-28,710,geometry box,100,150,50,1,00290,India
908060,2023-10-28,703,eraser,1,3,2,1,00290,India
908060,2023-10-28,702,pencil,2,5,3,1,00290,India
377161,2023-10-28,705,stencil,10,20,10,1,00394,India
377161,2023-10-28,712,graph paper,20,40,20,1,00394,India
377161,2023-10-28,701,gel pen,5,10,5,1,00394,India
122275,2023-10-28,714,carbon paper,15,30,15,1,00134,India
122275,2023-10-28,701,gel pen,5,10,5,1,00134,India
122275,2023-10-28,717,spiral bound book,50,100,50,1,00134,India
122275,2023-10-28,713,ball pen,5,10,5,1,00134,India
145805,2023-10-28,713,ball pen,5,10,5,1,00205,India
145805,2023-10-28,701,gel pen,5,10,5,1,00205,India
145805,2023-10-28,709,notebook,30,60,30,1,00205,India
145805,2023-10-28,702,pencil,2,5,3,1,00205,India
145805,2023-10-28,715,folder,5,15,10,1,00205,India
565484,2023-10-28,712,graph paper,20,40,20,1,00178,India
642545,2023-10-28,709,notebook,30,60,30,1,00104,India
642545,2023-10-28,712,graph paper,20,40,20,1,00104,India
642545,2023-10-28,705,stencil,10,20,10,1,00104,India
508481,2023-10-28,703,eraser,1,3,2,1,00063,India
508481,2023-10-28,715,folder,5,15,10,1,00063,India
508481,2023-10-28,701,gel pen,5,10,5,1,00063,India
961243,2023-10-28,704,scale,5,10,5,1,00441,India
961243,2023-10-28,708,sketchpen,15,40,25,1,00441,India
961243,2023-10-28,706,sharpener,3,8,5,1,00441,India
961243,2023-10-28,702,pencil,2,5,3,1,00441,India
829223,2023-10-28,715,folder,5,15,10,1,00470,India
829223,2023-10-28,711,TD kit,150,300,150,1,00470,India
722306,2023-10-28,716,printing paper,200,400,200,1,00233,India
722306,2023-10-28,715,folder,5,15,10,1,00233,India
722306,2023-10-28,708,sketchpen,15,40,25,1,00233,India
722306,2023-10-28,706,sharpener,3,8,5,1,00233,India
722306,2023-10-28,702,pencil,2,5,3,1,00233,India
289150,2023-10-28,710,geometry box,100,150,50,1,00147,India
289150,2023-10-28,717,spiral bound book,50,100,50,1,00147,India
301641,2023-10-28,717,spiral bound book,50,100,50,1,00499,India
301641,2023-10-28,705,stencil,10,20,10,1,00499,India
618868,2023-10-28,707,marker,20,40,20,1,00258,India
618868,2023-10-28,710,geometry box,100,150,50,1,00258,India
618868,2023-10-28,708,sketchpen,15,40,25,1,00258,India
618868,2023-10-28,716,printing paper,200,400,200,1,00258,India
618868,2023-10-28,702,pencil,2,5,3,1,00258,India
187624,2023-10-28,713,ball pen,5,10,5,1,00239,India
187624,2023-10-28,708,sketchpen,15,40,25,1,00239,India
187624,2023-10-28,704,scale,5,10,5,1,00239,India
187624,2023-10-28,701,gel pen,5,10,5,1,00239,India
187624,2023-10-28,709,notebook,30,60,30,1,00239,India
727872,2023-10-28,709,notebook,30,60,30,1,00492,India
727872,2023-10-28,708,sketchpen,15,40,25,1,00492,India
727872,2023-10-28,714,carbon paper,15,30,15,1,00492,India
727872,2023-10-28,703,eraser,1,3,2,1,00492,India
619095,2023-10-28,701,gel pen,5,10,5,1,00009,India
619095,2023-10-28,710,geometry box,100,150,50,1,00009,India
619095,2023-10-28,705,stencil,10,20,10,1,00009,India
684805,2023-10-28,714,carbon paper,15,30,15,1,00220,India
684805,2023-10-28,715,folder,5,15,10,1,00220,India
684805,2023-10-28,716,printing paper,200,400,200,1,00220,India
889680,2023-10-28,710,geometry box,100,150,50,1,00119,India
889680,2023-10-28,713,ball pen,5,10,5,1,00119,India
889680,2023-10-28,715,folder,5,15,10,1,00119,India
853264,2023-10-28,710,geometry box,100,150,50,1,00454,India
853264,2023-10-28,702,pencil,2,5,3,1,00454,India
722853,2023-10-28,706,sharpener,3,8,5,1,00311,India
722853,2023-10-28,708,sketchpen,15,40,25,1,00311,India
256777,2023-10-28,713,ball pen,5,10,5,1,00305,India
256777,2023-10-28,714,carbon paper,15,30,15,1,00305,India
922979,2023-10-28,703,eraser,1,3,2,1,00165,India
991584,2023-10-28,716,printing paper,200,400,200,1,00311,India
991584,2023-10-28,703,eraser,1,3,2,1,00311,India
991584,2023-10-28,712,graph paper,20,40,20,1,00311,India
991584,2023-10-28,717,spiral bound book,50,100,50,1,00311,India
210474,2023-10-28,708,sketchpen,15,40,25,1,00281,India
210474,2023-10-28,705,stencil,10,20,10,1,00281,India
566954,2023-10-28,705,stencil,10,20,10,1,00356,India
566954,2023-10-28,715,folder,5,15,10,1,00356,India
112910,2023-10-28,709,notebook,30,60,30,1,00065,India
112910,2023-10-28,707,marker,20,40,20,1,00065,India
112910,2023-10-28,708,sketchpen,15,40,25,1,00065,India
112910,2023-10-28,704,scale,5,10,5,1,00065,India
366408,2023-10-28,702,pencil,2,5,3,1,00003,India
366408,2023-10-28,711,TD kit,150,300,150,1,00003,India
366408,2023-10-28,706,sharpener,3,8,5,1,00003,India
366408,2023-10-28,708,sketchpen,15,40,25,1,00003,India
199604,2023-10-28,702,pencil,2,5,3,1,00086,India
199604,2023-10-28,712,graph paper,20,40,20,1,00086,India
199604,2023-10-28,716,printing paper,200,400,200,1,00086,India
644728,2023-10-28,701,gel pen,5,10,5,1,00479,India
644728,2023-10-28,706,sharpener,3,8,5,1,00479,India
644728,2023-10-28,717,spiral bound book,50,100,50,1,00479,India
106048,2023-10-28,701,gel pen,5,10,5,1,00451,India
106048,2023-10-28,705,stencil,10,20,10,1,00451,India
106048,2023-10-28,703,eraser,1,3,2,1,00451,India
866841,2023-10-28,709,notebook,30,60,30,1,00498,India
234561,2023-10-28,709,notebook,30,60,30,1,00069,India
829016,2023-10-29,708,sketchpen,15,40,25,1,00263,India
829016,2023-10-29,709,notebook,30,60,30,1,00263,India
829016,2023-10-29,706,sharpener,3,8,5,1,00263,India
829016,2023-10-29,703,eraser,1,3,2,1,00263,India
829016,2023-10-29,712,graph paper,20,40,20,1,00263,India
542880,2023-10-29,712,graph paper,20,40,20,1,00394,India
542880,2023-10-29,703,eraser,1,3,2,1,00394,India
542880,2023-10-29,701,gel pen,5,10,5,1,00394,India
210893,2023-10-29,711,TD kit,150,300,150,1,00036,India
210893,2023-10-29,712,graph paper,20,40,20,1,00036,India
210893,2023-10-29,716,printing paper,200,400,200,1,00036,India
210893,2023-10-29,707,marker,20,40,20,1,00036,India
967041,2023-10-29,717,spiral bound book,50,100,50,1,00416,India
967041,2023-10-29,711,TD kit,150,300,150,1,00416,India
967041,2023-10-29,712,graph paper,20,40,20,1,00416,India
580836,2023-10-29,710,geometry box,100,150,50,1,00453,India
580836,2023-10-29,701,gel pen,5,10,5,1,00453,India
580836,2023-10-29,715,folder,5,15,10,1,00453,India
580836,2023-10-29,717,spiral bound book,50,100,50,1,00453,India
580836,2023-10-29,708,sketchpen,15,40,25,1,00453,India
701910,2023-10-29,712,graph paper,20,40,20,1,00333,India
701910,2023-10-29,709,notebook,30,60,30,1,00333,India
701910,2023-10-29,714,carbon paper,15,30,15,1,00333,India
627644,2023-10-29,709,notebook,30,60,30,1,00274,India
627644,2023-10-29,710,geometry box,100,150,50,1,00274,India
627644,2023-10-29,708,sketchpen,15,40,25,1,00274,India
627644,2023-10-29,711,TD kit,150,300,150,1,00274,India
784957,2023-10-29,712,graph paper,20,40,20,1,00243,India
784957,2023-10-29,706,sharpener,3,8,5,1,00243,India
784957,2023-10-29,705,stencil,10,20,10,1,00243,India
784957,2023-10-29,717,spiral bound book,50,100,50,1,00243,India
104301,2023-10-29,703,eraser,1,3,2,1,00239,India
104301,2023-10-29,717,spiral bound book,50,100,50,1,00239,India
104301,2023-10-29,714,carbon paper,15,30,15,1,00239,India
977232,2023-10-29,706,sharpener,3,8,5,1,00360,India
977232,2023-10-29,710,geometry box,100,150,50,1,00360,India
698016,2023-10-29,709,notebook,30,60,30,1,00485,India
401293,2023-10-29,707,marker,20,40,20,1,00187,India
401293,2023-10-29,703,eraser,1,3,2,1,00187,India
401293,2023-10-29,715,folder,5,15,10,1,00187,India
830263,2023-10-29,712,graph paper,20,40,20,1,00389,India
901989,2023-10-29,706,sharpener,3,8,5,1,00291,India
394989,2023-10-29,717,spiral bound book,50,100,50,1,00180,India
394989,2023-10-29,705,stencil,10,20,10,1,00180,India
497614,2023-10-29,716,printing paper,200,400,200,1,00006,India
497614,2023-10-29,714,carbon paper,15,30,15,1,00006,India
342266,2023-10-29,714,carbon paper,15,30,15,1,00112,India
342266,2023-10-29,701,gel pen,5,10,5,1,00112,India
342266,2023-10-29,717,spiral bound book,50,100,50,1,00112,India
342266,2023-10-29,716,printing paper,200,400,200,1,00112,India
342266,2023-10-29,710,geometry box,100,150,50,1,00112,India
362136,2023-10-29,706,sharpener,3,8,5,1,00024,India
362136,2023-10-29,713,ball pen,5,10,5,1,00024,India
362136,2023-10-29,703,eraser,1,3,2,1,00024,India
362136,2023-10-29,701,gel pen,5,10,5,1,00024,India
925258,2023-10-29,712,graph paper,20,40,20,1,00075,India
152009,2023-10-29,707,marker,20,40,20,1,00201,India
152009,2023-10-29,710,geometry box,100,150,50,1,00201,India
152009,2023-10-29,713,ball pen,5,10,5,1,00201,India
152009,2023-10-29,702,pencil,2,5,3,1,00201,India
235446,2023-10-29,708,sketchpen,15,40,25,1,00294,India
195172,2023-10-29,704,scale,5,10,5,1,00468,India
712726,2023-10-29,706,sharpener,3,8,5,1,00364,India
712726,2023-10-29,714,carbon paper,15,30,15,1,00364,India
712726,2023-10-29,703,eraser,1,3,2,1,00364,India
712726,2023-10-29,710,geometry box,100,150,50,1,00364,India
986094,2023-10-29,711,TD kit,150,300,150,1,00323,India
986094,2023-10-29,707,marker,20,40,20,1,00323,India
986094,2023-10-29,713,ball pen,5,10,5,1,00323,India
986094,2023-10-29,714,carbon paper,15,30,15,1,00323,India
392725,2023-10-29,712,graph paper,20,40,20,1,00178,India
392725,2023-10-29,703,eraser,1,3,2,1,00178,India
392725,2023-10-29,717,spiral bound book,50,100,50,1,00178,India
392725,2023-10-29,706,sharpener,3,8,5,1,00178,India
772907,2023-10-29,709,notebook,30,60,30,1,00500,India
772907,2023-10-29,716,printing paper,200,400,200,1,00500,India
897376,2023-10-29,707,marker,20,40,20,1,00172,India
145184,2023-10-29,711,TD kit,150,300,150,1,00043,India
145184,2023-10-29,702,pencil,2,5,3,1,00043,India
670921,2023-10-29,709,notebook,30,60,30,1,00175,India
681999,2023-10-29,714,carbon paper,15,30,15,1,00359,India
681999,2023-10-29,711,TD kit,150,300,150,1,00359,India
681999,2023-10-29,707,marker,20,40,20,1,00359,India
681999,2023-10-29,702,pencil,2,5,3,1,00359,India
459309,2023-10-29,708,sketchpen,15,40,25,1,00284,India
750929,2023-10-29,703,eraser,1,3,2,1,00422,India
750929,2023-10-29,710,geometry box,100,150,50,1,00422,India
750929,2023-10-29,708,sketchpen,15,40,25,1,00422,India
750929,2023-10-29,709,notebook,30,60,30,1,00422,India
371954,2023-10-29,702,pencil,2,5,3,1,00136,India
371954,2023-10-29,714,carbon paper,15,30,15,1,00136,India
371954,2023-10-29,706,sharpener,3,8,5,1,00136,India
371954,2023-10-29,708,sketchpen,15,40,25,1,00136,India
115546,2023-10-29,707,marker,20,40,20,1,00071,India
115546,2023-10-29,706,sharpener,3,8,5,1,00071,India
441313,2023-10-29,708,sketchpen,15,40,25,1,00088,India
441313,2023-10-29,706,sharpener,3,8,5,1,00088,India
441313,2023-10-29,717,spiral bound book,50,100,50,1,00088,India
441313,2023-10-29,712,graph paper,20,40,20,1,00088,India
340333,2023-10-29,717,spiral bound book,50,100,50,1,00215,India
340333,2023-10-29,710,geometry box,100,150,50,1,00215,India
340333,2023-10-29,706,sharpener,3,8,5,1,00215,India
340333,2023-10-29,704,scale,5,10,5,1,00215,India
340333,2023-10-29,713,ball pen,5,10,5,1,00215,India
420624,2023-10-29,705,stencil,10,20,10,1,00468,India
135934,2023-10-29,714,carbon paper,15,30,15,1,00060,India
756061,2023-10-29,708,sketchpen,15,40,25,1,00153,India
756061,2023-10-29,710,geometry box,100,150,50,1,00153,India
756061,2023-10-29,703,eraser,1,3,2,1,00153,India
756061,2023-10-29,714,carbon paper,15,30,15,1,00153,India
212697,2023-10-30,706,sharpener,3,8,5,1,00369,India
212697,2023-10-30,709,notebook,30,60,30,1,00369,India
475937,2023-10-30,706,sharpener,3,8,5,1,00302,India
475937,2023-10-30,714,carbon paper,15,30,15,1,00302,India
475937,2023-10-30,704,scale,5,10,5,1,00302,India
475937,2023-10-30,713,ball pen,5,10,5,1,00302,India
475937,2023-10-30,715,folder,5,15,10,1,00302,India
313830,2023-10-30,707,marker,20,40,20,1,00324,India
580436,2023-10-30,706,sharpener,3,8,5,1,00164,India
580436,2023-10-30,715,folder,5,15,10,1,00164,India
435166,2023-10-30,717,spiral bound book,50,100,50,1,00404,India
435166,2023-10-30,709,notebook,30,60,30,1,00404,India
672523,2023-10-30,708,sketchpen,15,40,25,1,00279,India
672523,2023-10-30,706,sharpener,3,8,5,1,00279,India
672523,2023-10-30,714,carbon paper,15,30,15,1,00279,India
672523,2023-10-30,713,ball pen,5,10,5,1,00279,India
894872,2023-10-30,716,printing paper,200,400,200,1,00097,India
894872,2023-10-30,706,sharpener,3,8,5,1,00097,India
894872,2023-10-30,710,geometry box,100,150,50,1,00097,India
894872,2023-10-30,714,carbon paper,15,30,15,1,00097,India
528901,2023-10-30,713,ball pen,5,10,5,1,00117,India
528901,2023-10-30,710,geometry box,100,150,50,1,00117,India
528901,2023-10-30,708,sketchpen,15,40,25,1,00117,India
218641,2023-10-30,715,folder,5,15,10,1,00459,India
218641,2023-10-30,713,ball pen,5,10,5,1,00459,India
218641,2023-10-30,714,carbon paper,15,30,15,1,00459,India
218641,2023-10-30,708,sketchpen,15,40,25,1,00459,India
342276,2023-10-30,717,spiral bound book,50,100,50,1,00010,India
342276,2023-10-30,709,notebook,30,60,30,1,00010,India
342276,2023-10-30,707,marker,20,40,20,1,00010,India
342276,2023-10-30,716,printing paper,200,400,200,1,00010,India
154620,2023-10-30,707,marker,20,40,20,1,00241,India
737027,2023-10-30,705,stencil,10,20,10,1,00042,India
737027,2023-10-30,708,sketchpen,15,40,25,1,00042,India
522341,2023-10-30,713,ball pen,5,10,5,1,00162,India
613745,2023-10-30,715,folder,5,15,10,1,00206,India
613745,2023-10-30,708,sketchpen,15,40,25,1,00206,India
613745,2023-10-30,704,scale,5,10,5,1,00206,India
613745,2023-10-30,706,sharpener,3,8,5,1,00206,India
961092,2023-10-30,712,graph paper,20,40,20,1,00076,India
185274,2023-10-30,709,notebook,30,60,30,1,00478,India
185274,2023-10-30,707,marker,20,40,20,1,00478,India
185274,2023-10-30,717,spiral bound book,50,100,50,1,00478,India
185274,2023-10-30,713,ball pen,5,10,5,1,00478,India
185274,2023-10-30,715,folder,5,15,10,1,00478,India
170249,2023-10-30,709,notebook,30,60,30,1,00020,India
170249,2023-10-30,717,spiral bound book,50,100,50,1,00020,India
170249,2023-10-30,715,folder,5,15,10,1,00020,India
224694,2023-10-30,707,marker,20,40,20,1,00213,India
224694,2023-10-30,717,spiral bound book,50,100,50,1,00213,India
224694,2023-10-30,716,printing paper,200,400,200,1,00213,India
813923,2023-10-30,713,ball pen,5,10,5,1,00150,India
937939,2023-10-30,705,stencil,10,20,10,1,00250,India
937939,2023-10-30,711,TD kit,150,300,150,1,00250,India
324875,2023-10-30,706,sharpener,3,8,5,1,00005,India
324875,2023-10-30,707,marker,20,40,20,1,00005,India
821381,2023-10-30,704,scale,5,10,5,1,00291,India
821381,2023-10-30,708,sketchpen,15,40,25,1,00291,India
649338,2023-10-30,707,marker,20,40,20,1,00302,India
649338,2023-10-30,702,pencil,2,5,3,1,00302,India
649338,2023-10-30,709,notebook,30,60,30,1,00302,India
649338,2023-10-30,711,TD kit,150,300,150,1,00302,India
714801,2023-10-30,716,printing paper,200,400,200,1,00036,India
714801,2023-10-30,701,gel pen,5,10,5,1,00036,India
689411,2023-10-30,715,folder,5,15,10,1,00325,India
885915,2023-10-30,707,marker,20,40,20,1,00247,India
885915,2023-10-30,714,carbon paper,15,30,15,1,00247,India
885915,2023-10-30,713,ball pen,5,10,5,1,00247,India
885915,2023-10-30,716,printing paper,200,400,200,1,00247,India
409902,2023-10-30,710,geometry box,100,150,50,1,00383,India
409902,2023-10-30,709,notebook,30,60,30,1,00383,India
409902,2023-10-30,707,marker,20,40,20,1,00383,India
409902,2023-10-30,712,graph paper,20,40,20,1,00383,India
861938,2023-10-30,707,marker,20,40,20,1,00082,India
861938,2023-10-30,715,folder,5,15,10,1,00082,India
861938,2023-10-30,708,sketchpen,15,40,25,1,00082,India
931659,2023-10-30,706,sharpener,3,8,5,1,00136,India
391433,2023-10-30,708,sketchpen,15,40,25,1,00284,India
101665,2023-10-30,705,stencil,10,20,10,1,00022,India
101665,2023-10-30,717,spiral bound book,50,100,50,1,00022,India
101665,2023-10-30,703,eraser,1,3,2,1,00022,India
101665,2023-10-30,715,folder,5,15,10,1,00022,India
654852,2023-10-30,704,scale,5,10,5,1,00075,India
654852,2023-10-30,703,eraser,1,3,2,1,00075,India
654852,2023-10-30,701,gel pen,5,10,5,1,00075,India
654852,2023-10-30,716,printing paper,200,400,200,1,00075,India
654852,2023-10-30,715,folder,5,15,10,1,00075,India
401763,2023-10-30,717,spiral bound book,50,100,50,1,00422,India
401763,2023-10-30,710,geometry box,100,150,50,1,00422,India
401763,2023-10-30,709,notebook,30,60,30,1,00422,India
607887,2023-10-30,712,graph paper,20,40,20,1,00208,India
607887,2023-10-30,707,marker,20,40,20,1,00208,India
607887,2023-10-30,706,sharpener,3,8,5,1,00208,India
607887,2023-10-30,702,pencil,2,5,3,1,00208,India
607887,2023-10-30,705,stencil,10,20,10,1,00208,India
707234,2023-10-30,701,gel pen,5,10,5,1,00460,India
707234,2023-10-30,716,printing paper,200,400,200,1,00460,India
707234,2023-10-30,702,pencil,2,5,3,1,00460,India
691255,2023-10-30,714,carbon paper,15,30,15,1,00102,India
691255,2023-10-30,707,marker,20,40,20,1,00102,India
691255,2023-10-30,711,TD kit,150,300,150,1,00102,India
691255,2023-10-30,705,stencil,10,20,10,1,00102,India
934997,2023-10-30,705,stencil,10,20,10,1,00421,India
934997,2023-10-30,711,TD kit,150,300,150,1,00421,India
810987,2023-10-30,711,TD kit,150,300,150,1,00430,India
180659,2023-10-30,712,graph paper,20,40,20,1,00243,India
180659,2023-10-30,701,gel pen,5,10,5,1,00243,India
180659,2023-10-30,715,folder,5,15,10,1,00243,India
563061,2023-10-30,701,gel pen,5,10,5,1,00262,India
563061,2023-10-30,706,sharpener,3,8,5,1,00262,India
563061,2023-10-30,716,printing paper,200,400,200,1,00262,India
625728,2023-10-30,708,sketchpen,15,40,25,1,00327,India
625728,2023-10-30,707,marker,20,40,20,1,00327,India
625728,2023-10-30,705,stencil,10,20,10,1,00327,India
177047,2023-10-30,715,folder,5,15,10,1,00395,India
654997,2023-10-30,715,folder,5,15,10,1,00458,India
654997,2023-10-30,709,notebook,30,60,30,1,00458,India
654997,2023-10-30,716,printing paper,200,400,200,1,00458,India
654997,2023-10-30,703,eraser,1,3,2,1,00458,India
567220,2023-10-30,709,notebook,30,60,30,1,00417,India
567220,2023-10-30,703,eraser,1,3,2,1,00417,India
567220,2023-10-30,705,stencil,10,20,10,1,00417,India
567220,2023-10-30,716,printing paper,200,400,200,1,00417,India
520954,2023-10-30,702,pencil,2,5,3,1,00304,India
384459,2023-10-30,707,marker,20,40,20,1,00410,India
384459,2023-10-30,701,gel pen,5,10,5,1,00410,India
384459,2023-10-30,706,sharpener,3,8,5,1,00410,India
384459,2023-10-30,710,geometry box,100,150,50,1,00410,India
384459,2023-10-30,709,notebook,30,60,30,1,00410,India
675537,2023-10-31,707,marker,20,40,20,1,00283,India
675537,2023-10-31,706,sharpener,3,8,5,1,00283,India
480200,2023-10-31,706,sharpener,3,8,5,1,00025,India
480200,2023-10-31,704,scale,5,10,5,1,00025,India
817419,2023-10-31,704,scale,5,10,5,1,00376,India
817419,2023-10-31,716,printing paper,200,400,200,1,00376,India
817419,2023-10-31,707,marker,20,40,20,1,00376,India
817419,2023-10-31,701,gel pen,5,10,5,1,00376,India
237533,2023-10-31,708,sketchpen,15,40,25,1,00119,India
237533,2023-10-31,703,eraser,1,3,2,1,00119,India
237533,2023-10-31,717,spiral bound book,50,100,50,1,00119,India
237533,2023-10-31,714,carbon paper,15,30,15,1,00119,India
278667,2023-10-31,711,TD kit,150,300,150,1,00439,India
278667,2023-10-31,704,scale,5,10,5,1,00439,India
278667,2023-10-31,703,eraser,1,3,2,1,00439,India
278667,2023-10-31,702,pencil,2,5,3,1,00439,India
375712,2023-10-31,705,stencil,10,20,10,1,00433,India
600481,2023-10-31,716,printing paper,200,400,200,1,00371,India
600481,2023-10-31,713,ball pen,5,10,5,1,00371,India
600481,2023-10-31,715,folder,5,15,10,1,00371,India
337028,2023-10-31,711,TD kit,150,300,150,1,00425,India
337028,2023-10-31,707,marker,20,40,20,1,00425,India
188326,2023-10-31,706,sharpener,3,8,5,1,00033,India
188326,2023-10-31,710,geometry box,100,150,50,1,00033,India
262669,2023-10-31,715,folder,5,15,10,1,00295,India
262669,2023-10-31,708,sketchpen,15,40,25,1,00295,India
262669,2023-10-31,710,geometry box,100,150,50,1,00295,India
113828,2023-10-31,706,sharpener,3,8,5,1,00018,India
113828,2023-10-31,710,geometry box,100,150,50,1,00018,India
535111,2023-10-31,716,printing paper,200,400,200,1,00210,India
535111,2023-10-31,701,gel pen,5,10,5,1,00210,India
535111,2023-10-31,714,carbon paper,15,30,15,1,00210,India
535111,2023-10-31,707,marker,20,40,20,1,00210,India
711524,2023-10-31,714,carbon paper,15,30,15,1,00038,India
711524,2023-10-31,713,ball pen,5,10,5,1,00038,India
359782,2023-10-31,703,eraser,1,3,2,1,00170,India
359782,2023-10-31,714,carbon paper,15,30,15,1,00170,India
359782,2023-10-31,709,notebook,30,60,30,1,00170,India
359782,2023-10-31,704,scale,5,10,5,1,00170,India
139382,2023-10-31,707,marker,20,40,20,1,00106,India
139382,2023-10-31,703,eraser,1,3,2,1,00106,India
574800,2023-10-31,705,stencil,10,20,10,1,00381,India
393711,2023-10-31,712,graph paper,20,40,20,1,00387,India
406221,2023-10-31,716,printing paper,200,400,200,1,00021,India
406221,2023-10-31,709,notebook,30,60,30,1,00021,India
406221,2023-10-31,707,marker,20,40,20,1,00021,India
109335,2023-10-31,717,spiral bound book,50,100,50,1,00259,India
109335,2023-10-31,703,eraser,1,3,2,1,00259,India
109335,2023-10-31,712,graph paper,20,40,20,1,00259,India
109335,2023-10-31,716,printing paper,200,400,200,1,00259,India
589640,2023-10-31,706,sharpener,3,8,5,1,00495,India
589640,2023-10-31,702,pencil,2,5,3,1,00495,India
589640,2023-10-31,712,graph paper,20,40,20,1,00495,India
542519,2023-10-31,708,sketchpen,15,40,25,1,00385,India
542519,2023-10-31,714,carbon paper,15,30,15,1,00385,India
327092,2023-10-31,715,folder,5,15,10,1,00443,India
327092,2023-10-31,711,TD kit,150,300,150,1,00443,India
327092,2023-10-31,705,stencil,10,20,10,1,00443,India
327092,2023-10-31,717,spiral bound book,50,100,50,1,00443,India
616130,2023-10-31,706,sharpener,3,8,5,1,00331,India
616130,2023-10-31,708,sketchpen,15,40,25,1,00331,India
616130,2023-10-31,703,eraser,1,3,2,1,00331,India
616130,2023-10-31,714,carbon paper,15,30,15,1,00331,India
936525,2023-10-31,710,geometry box,100,150,50,1,00198,India
936525,2023-10-31,706,sharpener,3,8,5,1,00198,India
324994,2023-10-31,716,printing paper,200,400,200,1,00176,India
324994,2023-10-31,707,marker,20,40,20,1,00176,India
324994,2023-10-31,714,carbon paper,15,30,15,1,00176,India
457303,2023-10-31,713,ball pen,5,10,5,1,00449,India
457303,2023-10-31,714,carbon paper,15,30,15,1,00449,India
289385,2023-10-31,706,sharpener,3,8,5,1,00395,India
289385,2023-10-31,704,scale,5,10,5,1,00395,India
289385,2023-10-31,716,printing paper,200,400,200,1,00395,India
289385,2023-10-31,705,stencil,10,20,10,1,00395,India
289385,2023-10-31,712,graph paper,20,40,20,1,00395,India
220379,2023-10-31,716,printing paper,200,400,200,1,00068,India
220379,2023-10-31,710,geometry box,100,150,50,1,00068,India
139910,2023-10-31,708,sketchpen,15,40,25,1,00126,India
139910,2023-10-31,714,carbon paper,15,30,15,1,00126,India
139910,2023-10-31,709,notebook,30,60,30,1,00126,India
139910,2023-10-31,701,gel pen,5,10,5,1,00126,India
139910,2023-10-31,704,scale,5,10,5,1,00126,India
168168,2023-10-31,702,pencil,2,5,3,1,00264,India
168168,2023-10-31,710,geometry box,100,150,50,1,00264,India
168168,2023-10-31,715,folder,5,15,10,1,00264,India
197296,2023-10-31,716,printing paper,200,400,200,1,00072,India
197296,2023-10-31,714,carbon paper,15,30,15,1,00072,India
189090,2023-10-31,714,carbon paper,15,30,15,1,00254,India
189090,2023-10-31,716,printing paper,200,400,200,1,00254,India
189090,2023-10-31,712,graph paper,20,40,20,1,00254,India
189090,2023-10-31,704,scale,5,10,5,1,00254,India
537769,2023-10-31,710,geometry box,100,150,50,1,00082,India
537769,2023-10-31,708,sketchpen,15,40,25,1,00082,India
333983,2023-10-31,713,ball pen,5,10,5,1,00122,India
333983,2023-10-31,703,eraser,1,3,2,1,00122,India
333983,2023-10-31,712,graph paper,20,40,20,1,00122,India
718239,2023-10-31,707,marker,20,40,20,1,00068,India
961572,2023-10-31,702,pencil,2,5,3,1,00486,India
961572,2023-10-31,713,ball pen,5,10,5,1,00486,India
961572,2023-10-31,712,graph paper,20,40,20,1,00486,India
961572,2023-10-31,709,notebook,30,60,30,1,00486,India
961572,2023-10-31,706,sharpener,3,8,5,1,00486,India
891549,2023-10-31,707,marker,20,40,20,1,00379,India
266951,2023-10-31,703,eraser,1,3,2,1,00175,India
317600,2023-10-31,705,stencil,10,20,10,1,00433,India
317600,2023-10-31,717,spiral bound book,50,100,50,1,00433,India
317600,2023-10-31,712,graph paper,20,40,20,1,00433,India
317600,2023-10-31,709,notebook,30,60,30,1,00433,India
317600,2023-10-31,714,carbon paper,15,30,15,1,00433,India
534643,2023-10-31,716,printing paper,200,400,200,1,00280,India
534643,2023-10-31,709,notebook,30,60,30,1,00280,India
488903,2023-10-31,702,pencil,2,5,3,1,00427,India
488903,2023-10-31,708,sketchpen,15,40,25,1,00427,India
488903,2023-10-31,707,marker,20,40,20,1,00427,India
531360,2023-10-31,713,ball pen,5,10,5,1,00359,India
531360,2023-10-31,707,marker,20,40,20,1,00359,India
535176,2023-11-01,708,sketchpen,15,40,25,1,00413,India
535176,2023-11-01,712,graph paper,20,40,20,1,00413,India
498306,2023-11-01,712,graph paper,20,40,20,1,00146,India
498306,2023-11-01,711,TD kit,150,300,150,1,00146,India
498306,2023-11-01,715,folder,5,15,10,1,00146,India
498306,2023-11-01,706,sharpener,3,8,5,2,00146,India
498306,2023-11-01,704,scale,5,10,5,2,00146,India
557087,2023-11-01,705,stencil,10,20,10,2,00254,India
557087,2023-11-01,715,folder,5,15,10,1,00254,India
927487,2023-11-01,712,graph paper,20,40,20,1,00189,India
971739,2023-11-01,710,geometry box,100,150,50,2,00065,India
971739,2023-11-01,712,graph paper,20,40,20,1,00065,India
971739,2023-11-01,703,eraser,1,3,2,2,00065,India
971739,2023-11-01,705,stencil,10,20,10,2,00065,India
667983,2023-11-01,714,carbon paper,15,30,15,1,00478,India
517566,2023-11-01,703,eraser,1,3,2,2,00128,India
517566,2023-11-01,711,TD kit,150,300,150,1,00128,India
517566,2023-11-01,708,sketchpen,15,40,25,1,00128,India
517566,2023-11-01,707,marker,20,40,20,1,00128,India
789246,2023-11-01,716,printing paper,200,400,200,1,00387,India
789246,2023-11-01,701,gel pen,5,10,5,2,00387,India
789246,2023-11-01,705,stencil,10,20,10,2,00387,India
789246,2023-11-01,711,TD kit,150,300,150,1,00387,India
250565,2023-11-01,701,gel pen,5,10,5,2,00211,India
250565,2023-11-01,717,spiral bound book,50,100,50,1,00211,India
129543,2023-11-01,703,eraser,1,3,2,2,00396,India
129543,2023-11-01,717,spiral bound book,50,100,50,1,00396,India
129543,2023-11-01,706,sharpener,3,8,5,2,00396,India
129543,2023-11-01,702,pencil,2,5,3,2,00396,India
468817,2023-11-01,712,graph paper,20,40,20,1,00460,India
468817,2023-11-01,710,geometry box,100,150,50,2,00460,India
468817,2023-11-01,703,eraser,1,3,2,2,00460,India
468817,2023-11-01,707,marker,20,40,20,1,00460,India
468817,2023-11-01,714,carbon paper,15,30,15,1,00460,India
670203,2023-11-01,717,spiral bound book,50,100,50,1,00461,India
589684,2023-11-01,710,geometry box,100,150,50,2,00069,India
514919,2023-11-01,712,graph paper,20,40,20,1,00252,India
514919,2023-11-01,704,scale,5,10,5,2,00252,India
988583,2023-11-01,703,eraser,1,3,2,2,00252,India
988583,2023-11-01,711,TD kit,150,300,150,1,00252,India
988583,2023-11-01,702,pencil,2,5,3,2,00252,India
836749,2023-11-01,701,gel pen,5,10,5,2,00153,India
919758,2023-11-01,701,gel pen,5,10,5,2,00095,India
919758,2023-11-01,706,sharpener,3,8,5,2,00095,India
597037,2023-11-01,717,spiral bound book,50,100,50,1,00226,India
993661,2023-11-01,717,spiral bound book,50,100,50,1,00242,India
993661,2023-11-01,716,printing paper,200,400,200,1,00242,India
189134,2023-11-01,714,carbon paper,15,30,15,1,00057,India
189134,2023-11-01,704,scale,5,10,5,2,00057,India
189134,2023-11-01,709,notebook,30,60,30,2,00057,India
189134,2023-11-01,715,folder,5,15,10,1,00057,India
178715,2023-11-01,717,spiral bound book,50,100,50,1,00486,India
178715,2023-11-01,714,carbon paper,15,30,15,1,00486,India
174121,2023-11-01,701,gel pen,5,10,5,2,00152,India
174121,2023-11-01,702,pencil,2,5,3,2,00152,India
213497,2023-11-01,713,ball pen,5,10,5,2,00303,India
541093,2023-11-01,710,geometry box,100,150,50,2,00296,India
541093,2023-11-01,709,notebook,30,60,30,2,00296,India
541093,2023-11-01,717,spiral bound book,50,100,50,1,00296,India
138454,2023-11-01,714,carbon paper,15,30,15,1,00164,India
138454,2023-11-01,702,pencil,2,5,3,2,00164,India
138454,2023-11-01,713,ball pen,5,10,5,2,00164,India
138454,2023-11-01,717,spiral bound book,50,100,50,1,00164,India
295403,2023-11-01,711,TD kit,150,300,150,1,00015,India
295403,2023-11-01,709,notebook,30,60,30,2,00015,India
813772,2023-11-01,708,sketchpen,15,40,25,1,00456,India
503315,2023-11-01,713,ball pen,5,10,5,2,00047,India
503315,2023-11-01,705,stencil,10,20,10,2,00047,India
503315,2023-11-01,706,sharpener,3,8,5,2,00047,India
553160,2023-11-01,703,eraser,1,3,2,2,00006,India
553160,2023-11-01,705,stencil,10,20,10,2,00006,India
788371,2023-11-01,706,sharpener,3,8,5,2,00276,India
788371,2023-11-01,711,TD kit,150,300,150,1,00276,India
557794,2023-11-01,705,stencil,10,20,10,2,00147,India
557794,2023-11-01,704,scale,5,10,5,2,00147,India
963595,2023-11-01,711,TD kit,150,300,150,1,00377,India
963595,2023-11-01,708,sketchpen,15,40,25,1,00377,India
963595,2023-11-01,703,eraser,1,3,2,2,00377,India
599981,2023-11-01,716,printing paper,200,400,200,1,00169,India
599981,2023-11-01,706,sharpener,3,8,5,2,00169,India
599981,2023-11-01,707,marker,20,40,20,1,00169,India
599981,2023-11-01,717,spiral bound book,50,100,50,1,00169,India
552020,2023-11-01,704,scale,5,10,5,2,00092,India
552020,2023-11-01,715,folder,5,15,10,1,00092,India
720473,2023-11-01,701,gel pen,5,10,5,2,00265,India
720473,2023-11-01,717,spiral bound book,50,100,50,1,00265,India
720473,2023-11-01,714,carbon paper,15,30,15,1,00265,India
720473,2023-11-01,709,notebook,30,60,30,2,00265,India
737339,2023-11-01,715,folder,5,15,10,1,00035,India
737339,2023-11-01,709,notebook,30,60,30,2,00035,India
737339,2023-11-01,703,eraser,1,3,2,2,00035,India
737339,2023-11-01,716,printing paper,200,400,200,1,00035,India
168201,2023-11-01,712,graph paper,20,40,20,1,00466,India
168201,2023-11-01,702,pencil,2,5,3,2,00466,India
918417,2023-11-01,704,scale,5,10,5,2,00212,India
918417,2023-11-01,714,carbon paper,15,30,15,1,00212,India
918417,2023-11-01,705,stencil,10,20,10,2,00212,India
918417,2023-11-01,708,sketchpen,15,40,25,1,00212,India
918417,2023-11-01,703,eraser,1,3,2,2,00212,India
730809,2023-11-01,717,spiral bound book,50,100,50,1,00092,India
730809,2023-11-01,704,scale,5,10,5,2,00092,India
730809,2023-11-01,706,sharpener,3,8,5,2,00092,India
867931,2023-11-01,709,notebook,30,60,30,2,00105,India
867931,2023-11-01,705,stencil,10,20,10,2,00105,India
867931,2023-11-01,702,pencil,2,5,3,2,00105,India
867931,2023-11-01,710,geometry box,100,150,50,2,00105,India
399881,2023-11-01,704,scale,5,10,5,2,00063,India
399881,2023-11-01,701,gel pen,5,10,5,2,00063,India
769454,2023-11-01,717,spiral bound book,50,100,50,1,00390,India
769454,2023-11-01,712,graph paper,20,40,20,1,00390,India
769454,2023-11-01,714,carbon paper,15,30,15,1,00390,India
769454,2023-11-01,706,sharpener,3,8,5,2,00390,India
883134,2023-11-01,707,marker,20,40,20,1,00373,India
883134,2023-11-01,715,folder,5,15,10,1,00373,India
883134,2023-11-01,714,carbon paper,15,30,15,1,00373,India
477254,2023-11-01,701,gel pen,5,10,5,2,00374,India
477254,2023-11-01,703,eraser,1,3,2,2,00374,India
477254,2023-11-01,704,scale,5,10,5,2,00374,India
477254,2023-11-01,708,sketchpen,15,40,25,1,00374,India
379006,2023-11-01,713,ball pen,5,10,5,2,00060,India
379006,2023-11-01,714,carbon paper,15,30,15,1,00060,India
379006,2023-11-01,712,graph paper,20,40,20,1,00060,India
379006,2023-11-01,701,gel pen,5,10,5,2,00060,India
379006,2023-11-01,715,folder,5,15,10,1,00060,India
189680,2023-11-01,714,carbon paper,15,30,15,1,00069,India
189680,2023-11-01,711,TD kit,150,300,150,1,00069,India
189680,2023-11-01,710,geometry box,100,150,50,2,00069,India
189680,2023-11-01,715,folder,5,15,10,1,00069,India
269337,2023-11-01,708,sketchpen,15,40,25,1,00222,India
269337,2023-11-01,705,stencil,10,20,10,2,00222,India
269337,2023-11-01,712,graph paper,20,40,20,1,00222,India
269337,2023-11-01,707,marker,20,40,20,1,00222,India
504008,2023-11-01,703,eraser,1,3,2,2,00059,India
504008,2023-11-01,710,geometry box,100,150,50,2,00059,India
474432,2023-11-01,710,geometry box,100,150,50,2,00435,India
474432,2023-11-01,708,sketchpen,15,40,25,1,00435,India
474432,2023-11-01,701,gel pen,5,10,5,2,00435,India
616453,2023-11-01,713,ball pen,5,10,5,2,00265,India
616453,2023-11-01,714,carbon paper,15,30,15,1,00265,India
616453,2023-11-01,706,sharpener,3,8,5,2,00265,India
616453,2023-11-01,709,notebook,30,60,30,2,00265,India
151329,2023-11-02,716,printing paper,200,400,200,1,00126,India
151329,2023-11-02,714,carbon paper,15,30,15,1,00126,India
151329,2023-11-02,711,TD kit,150,300,150,1,00126,India
995933,2023-11-02,703,eraser,1,3,2,2,00269,India
995933,2023-11-02,713,ball pen,5,10,5,2,00269,India
995933,2023-11-02,710,geometry box,100,150,50,2,00269,India
995933,2023-11-02,715,folder,5,15,10,1,00269,India
208470,2023-11-02,703,eraser,1,3,2,2,00179,India
208470,2023-11-02,706,sharpener,3,8,5,2,00179,India
208470,2023-11-02,702,pencil,2,5,3,2,00179,India
208470,2023-11-02,711,TD kit,150,300,150,1,00179,India
208470,2023-11-02,715,folder,5,15,10,1,00179,India
313801,2023-11-02,716,printing paper,200,400,200,1,00464,India
313801,2023-11-02,704,scale,5,10,5,2,00464,India
313801,2023-11-02,714,carbon paper,15,30,15,1,00464,India
313801,2023-11-02,717,spiral bound book,50,100,50,1,00464,India
313801,2023-11-02,707,marker,20,40,20,1,00464,India
817392,2023-11-02,717,spiral bound book,50,100,50,1,00178,India
592286,2023-11-02,708,sketchpen,15,40,25,1,00188,India
592286,2023-11-02,712,graph paper,20,40,20,1,00188,India
592286,2023-11-02,709,notebook,30,60,30,2,00188,India
592286,2023-11-02,703,eraser,1,3,2,2,00188,India
592286,2023-11-02,713,ball pen,5,10,5,2,00188,India
820010,2023-11-02,703,eraser,1,3,2,2,00328,India
166220,2023-11-02,708,sketchpen,15,40,25,1,00165,India
166220,2023-11-02,711,TD kit,150,300,150,1,00165,India
166220,2023-11-02,709,notebook,30,60,30,2,00165,India
182382,2023-11-02,711,TD kit,150,300,150,1,00342,India
182382,2023-11-02,712,graph paper,20,40,20,1,00342,India
182382,2023-11-02,707,marker,20,40,20,1,00342,India
219212,2023-11-02,716,printing paper,200,400,200,1,00382,India
219212,2023-11-02,709,notebook,30,60,30,2,00382,India
996593,2023-11-02,704,scale,5,10,5,2,00220,India
996593,2023-11-02,706,sharpener,3,8,5,2,00220,India
996593,2023-11-02,713,ball pen,5,10,5,2,00220,India
716772,2023-11-02,717,spiral bound book,50,100,50,1,00071,India
716772,2023-11-02,704,scale,5,10,5,2,00071,India
615917,2023-11-02,709,notebook,30,60,30,2,00148,India
615917,2023-11-02,711,TD kit,150,300,150,1,00148,India
543876,2023-11-02,701,gel pen,5,10,5,2,00395,India
543876,2023-11-02,717,spiral bound book,50,100,50,1,00395,India
543876,2023-11-02,705,stencil,10,20,10,2,00395,India
543876,2023-11-02,702,pencil,2,5,3,2,00395,India
797736,2023-11-02,703,eraser,1,3,2,2,00114,India
797736,2023-11-02,717,spiral bound book,50,100,50,1,00114,India
797736,2023-11-02,710,geometry box,100,150,50,2,00114,India
505680,2023-11-02,704,scale,5,10,5,2,00081,India
505680,2023-11-02,716,printing paper,200,400,200,1,00081,India
505680,2023-11-02,709,notebook,30,60,30,2,00081,India
505680,2023-11-02,705,stencil,10,20,10,2,00081,India
505680,2023-11-02,712,graph paper,20,40,20,1,00081,India
659908,2023-11-02,702,pencil,2,5,3,2,00089,India
659908,2023-11-02,701,gel pen,5,10,5,2,00089,India
659908,2023-11-02,716,printing paper,200,400,200,1,00089,India
659908,2023-11-02,708,sketchpen,15,40,25,1,00089,India
669479,2023-11-02,706,sharpener,3,8,5,2,00290,India
669479,2023-11-02,708,sketchpen,15,40,25,1,00290,India
669479,2023-11-02,707,marker,20,40,20,1,00290,India
669479,2023-11-02,715,folder,5,15,10,1,00290,India
678424,2023-11-02,713,ball pen,5,10,5,2,00425,India
678424,2023-11-02,716,printing paper,200,400,200,1,00425,India
678424,2023-11-02,706,sharpener,3,8,5,2,00425,India
678424,2023-11-02,710,geometry box,100,150,50,2,00425,India
513698,2023-11-02,711,TD kit,150,300,150,1,00226,India
836418,2023-11-02,702,pencil,2,5,3,2,00160,India
293446,2023-11-02,712,graph paper,20,40,20,1,00121,India
293446,2023-11-02,703,eraser,1,3,2,2,00121,India
293446,2023-11-02,701,gel pen,5,10,5,2,00121,India
293446,2023-11-02,716,printing paper,200,400,200,1,00121,India
293446,2023-11-02,702,pencil,2,5,3,2,00121,India
403578,2023-11-02,710,geometry box,100,150,50,2,00301,India
403578,2023-11-02,706,sharpener,3,8,5,2,00301,India
403578,2023-11-02,701,gel pen,5,10,5,2,00301,India
338942,2023-11-02,707,marker,20,40,20,1,00169,India
401024,2023-11-02,711,TD kit,150,300,150,1,00069,India
878197,2023-11-02,708,sketchpen,15,40,25,1,00248,India
749808,2023-11-02,705,stencil,10,20,10,2,00061,India
749808,2023-11-02,702,pencil,2,5,3,2,00061,India
893409,2023-11-02,704,scale,5,10,5,2,00299,India
899991,2023-11-02,703,eraser,1,3,2,2,00436,India
899991,2023-11-02,713,ball pen,5,10,5,2,00436,India
899991,2023-11-02,717,spiral bound book,50,100,50,1,00436,India
899991,2023-11-02,715,folder,5,15,10,1,00436,India
254138,2023-11-02,713,ball pen,5,10,5,2,00231,India
254138,2023-11-02,705,stencil,10,20,10,2,00231,India
318578,2023-11-02,713,ball pen,5,10,5,2,00319,India
616788,2023-11-02,703,eraser,1,3,2,2,00435,India
616788,2023-11-02,709,notebook,30,60,30,2,00435,India
982434,2023-11-02,717,spiral bound book,50,100,50,1,00227,India
982434,2023-11-02,708,sketchpen,15,40,25,1,00227,India
982434,2023-11-02,703,eraser,1,3,2,2,00227,India
534967,2023-11-02,706,sharpener,3,8,5,2,00329,India
534967,2023-11-02,711,TD kit,150,300,150,1,00329,India
534967,2023-11-02,705,stencil,10,20,10,2,00329,India
147859,2023-11-02,711,TD kit,150,300,150,1,00048,India
147859,2023-11-02,714,carbon paper,15,30,15,1,00048,India
147859,2023-11-02,704,scale,5,10,5,2,00048,India
136180,2023-11-02,712,graph paper,20,40,20,1,00306,India
136180,2023-11-02,713,ball pen,5,10,5,2,00306,India
136180,2023-11-02,711,TD kit,150,300,150,1,00306,India
136180,2023-11-02,710,geometry box,100,150,50,2,00306,India
136180,2023-11-02,708,sketchpen,15,40,25,1,00306,India
783102,2023-11-02,709,notebook,30,60,30,2,00159,India
783102,2023-11-02,708,sketchpen,15,40,25,1,00159,India
783102,2023-11-02,710,geometry box,100,150,50,2,00159,India
783102,2023-11-02,707,marker,20,40,20,1,00159,India
783102,2023-11-02,701,gel pen,5,10,5,2,00159,India
701248,2023-11-02,706,sharpener,3,8,5,2,00419,India
701248,2023-11-02,716,printing paper,200,400,200,1,00419,India
701248,2023-11-02,702,pencil,2,5,3,2,00419,India
701248,2023-11-02,705,stencil,10,20,10,2,00419,India
308396,2023-11-03,712,graph paper,20,40,20,1,00285,India
308396,2023-11-03,717,spiral bound book,50,100,50,1,00285,India
893533,2023-11-03,703,eraser,1,3,2,2,00227,India
893533,2023-11-03,707,marker,20,40,20,1,00227,India
240852,2023-11-03,709,notebook,30,60,30,2,00319,India
240852,2023-11-03,703,eraser,1,3,2,2,00319,India
104812,2023-11-03,709,notebook,30,60,30,2,00248,India
104812,2023-11-03,712,graph paper,20,40,20,1,00248,India
173716,2023-11-03,713,ball pen,5,10,5,2,00328,India
173716,2023-11-03,703,eraser,1,3,2,2,00328,India
173716,2023-11-03,707,marker,20,40,20,1,00328,India
173716,2023-11-03,709,notebook,30,60,30,2,00328,India
723819,2023-11-03,702,pencil,2,5,3,2,00316,India
723819,2023-11-03,714,carbon paper,15,30,15,1,00316,India
723819,2023-11-03,709,notebook,30,60,30,2,00316,India
505251,2023-11-03,701,gel pen,5,10,5,2,00225,India
505251,2023-11-03,715,folder,5,15,10,1,00225,India
214071,2023-11-03,709,notebook,30,60,30,2,00332,India
214071,2023-11-03,712,graph paper,20,40,20,1,00332,India
214071,2023-11-03,708,sketchpen,15,40,25,1,00332,India
874563,2023-11-03,709,notebook,30,60,30,2,00293,India
874563,2023-11-03,717,spiral bound book,50,100,50,1,00293,India
874563,2023-11-03,714,carbon paper,15,30,15,1,00293,India
881406,2023-11-03,702,pencil,2,5,3,2,00324,India
881406,2023-11-03,710,geometry box,100,150,50,2,00324,India
881406,2023-11-03,712,graph paper,20,40,20,1,00324,India
881406,2023-11-03,715,folder,5,15,10,1,00324,India
156170,2023-11-03,701,gel pen,5,10,5,2,00152,India
131434,2023-11-03,710,geometry box,100,150,50,2,00057,India
131434,2023-11-03,713,ball pen,5,10,5,2,00057,India
877155,2023-11-03,710,geometry box,100,150,50,2,00492,India
877155,2023-11-03,713,ball pen,5,10,5,2,00492,India
877155,2023-11-03,708,sketchpen,15,40,25,1,00492,India
138713,2023-11-03,713,ball pen,5,10,5,2,00347,India
138713,2023-11-03,704,scale,5,10,5,2,00347,India
138713,2023-11-03,710,geometry box,100,150,50,2,00347,India
138713,2023-11-03,708,sketchpen,15,40,25,1,00347,India
459435,2023-11-03,711,TD kit,150,300,150,1,00426,India
459435,2023-11-03,710,geometry box,100,150,50,2,00426,India
459435,2023-11-03,702,pencil,2,5,3,2,00426,India
835439,2023-11-03,715,folder,5,15,10,1,00097,India
835439,2023-11-03,702,pencil,2,5,3,2,00097,India
835439,2023-11-03,707,marker,20,40,20,1,00097,India
835439,2023-11-03,717,spiral bound book,50,100,50,1,00097,India
668237,2023-11-03,704,scale,5,10,5,2,00431,India
668237,2023-11-03,717,spiral bound book,50,100,50,1,00431,India
668237,2023-11-03,715,folder,5,15,10,1,00431,India
175959,2023-11-03,713,ball pen,5,10,5,2,00235,India
520284,2023-11-03,703,eraser,1,3,2,2,00271,India
520284,2023-11-03,712,graph paper,20,40,20,1,00271,India
520284,2023-11-03,701,gel pen,5,10,5,2,00271,India
520284,2023-11-03,702,pencil,2,5,3,2,00271,India
520284,2023-11-03,717,spiral bound book,50,100,50,1,00271,India
921125,2023-11-03,704,scale,5,10,5,2,00373,India
921125,2023-11-03,705,stencil,10,20,10,2,00373,India
921125,2023-11-03,709,notebook,30,60,30,2,00373,India
921125,2023-11-03,715,folder,5,15,10,1,00373,India
921125,2023-11-03,703,eraser,1,3,2,2,00373,India
988425,2023-11-03,709,notebook,30,60,30,2,00055,India
390505,2023-11-03,714,carbon paper,15,30,15,1,00061,India
390505,2023-11-03,703,eraser,1,3,2,2,00061,India
390505,2023-11-03,709,notebook,30,60,30,2,00061,India
220019,2023-11-03,715,folder,5,15,10,1,00193,India
220019,2023-11-03,702,pencil,2,5,3,2,00193,India
969732,2023-11-03,715,folder,5,15,10,1,00001,India
969732,2023-11-03,713,ball pen,5,10,5,2,00001,India
969732,2023-11-03,712,graph paper,20,40,20,1,00001,India
470769,2023-11-03,716,printing paper,200,400,200,1,00262,India
470769,2023-11-03,703,eraser,1,3,2,2,00262,India
470769,2023-11-03,711,TD kit,150,300,150,1,00262,India
274319,2023-11-03,717,spiral bound book,50,100,50,1,00013,India
274319,2023-11-03,712,graph paper,20,40,20,1,00013,India
274319,2023-11-03,715,folder,5,15,10,1,00013,India
274319,2023-11-03,705,stencil,10,20,10,2,00013,India
274319,2023-11-03,706,sharpener,3,8,5,2,00013,India
554620,2023-11-03,704,scale,5,10,5,2,00383,India
554620,2023-11-03,701,gel pen,5,10,5,2,00383,India
886901,2023-11-03,713,ball pen,5,10,5,2,00319,India
886901,2023-11-03,702,pencil,2,5,3,2,00319,India
779582,2023-11-03,702,pencil,2,5,3,2,00474,India
946848,2023-11-03,714,carbon paper,15,30,15,1,00187,India
946848,2023-11-03,701,gel pen,5,10,5,2,00187,India
374582,2023-11-03,710,geometry box,100,150,50,2,00043,India
374582,2023-11-03,712,graph paper,20,40,20,1,00043,India
374582,2023-11-03,701,gel pen,5,10,5,2,00043,India
374582,2023-11-03,708,sketchpen,15,40,25,1,00043,India
896759,2023-11-03,702,pencil,2,5,3,2,00215,India
896759,2023-11-03,701,gel pen,5,10,5,2,00215,India
896759,2023-11-03,711,TD kit,150,300,150,1,00215,India
237390,2023-11-03,705,stencil,10,20,10,2,00425,India
237390,2023-11-03,709,notebook,30,60,30,2,00425,India
237390,2023-11-03,703,eraser,1,3,2,2,00425,India
237390,2023-11-03,717,spiral bound book,50,100,50,1,00425,India
962195,2023-11-03,709,notebook,30,60,30,2,00105,India
762086,2023-11-03,701,gel pen,5,10,5,2,00002,India
447465,2023-11-03,711,TD kit,150,300,150,1,00269,India
447465,2023-11-03,710,geometry box,100,150,50,2,00269,India
369835,2023-11-03,701,gel pen,5,10,5,2,00488,India
369835,2023-11-03,707,marker,20,40,20,1,00488,India
369835,2023-11-03,708,sketchpen,15,40,25,1,00488,India
369835,2023-11-03,703,eraser,1,3,2,2,00488,India
315726,2023-11-03,715,folder,5,15,10,1,00280,India
315726,2023-11-03,701,gel pen,5,10,5,2,00280,India
744490,2023-11-03,716,printing paper,200,400,200,1,00257,India
621128,2023-11-03,717,spiral bound book,50,100,50,1,00382,India
621128,2023-11-03,708,sketchpen,15,40,25,1,00382,India
621128,2023-11-03,716,printing paper,200,400,200,1,00382,India
621128,2023-11-03,709,notebook,30,60,30,2,00382,India
279521,2023-11-03,705,stencil,10,20,10,2,00017,India
279521,2023-11-03,703,eraser,1,3,2,2,00017,India
279521,2023-11-03,712,graph paper,20,40,20,1,00017,India
279521,2023-11-03,710,geometry box,100,150,50,2,00017,India
268082,2023-11-03,702,pencil,2,5,3,2,00022,India
268082,2023-11-03,701,gel pen,5,10,5,2,00022,India
268082,2023-11-03,711,TD kit,150,300,150,1,00022,India
472619,2023-11-03,704,scale,5,10,5,2,00283,India
472619,2023-11-03,717,spiral bound book,50,100,50,1,00283,India
472619,2023-11-03,701,gel pen,5,10,5,2,00283,India
472619,2023-11-03,707,marker,20,40,20,1,00283,India
472619,2023-11-03,716,printing paper,200,400,200,1,00283,India
254166,2023-11-03,705,stencil,10,20,10,2,00387,India
254166,2023-11-03,712,graph paper,20,40,20,1,00387,India
254166,2023-11-03,709,notebook,30,60,30,2,00387,India
254166,2023-11-03,711,TD kit,150,300,150,1,00387,India
999620,2023-11-04,707,marker,20,40,20,1,00448,India
999620,2023-11-04,706,sharpener,3,8,5,2,00448,India
999620,2023-11-04,715,folder,5,15,10,1,00448,India
141973,2023-11-04,705,stencil,10,20,10,2,00482,India
190652,2023-11-04,711,TD kit,150,300,150,1,00279,India
190652,2023-11-04,708,sketchpen,15,40,25,1,00279,India
373461,2023-11-04,711,TD kit,150,300,150,1,00261,India
373461,2023-11-04,714,carbon paper,15,30,15,1,00261,India
373461,2023-11-04,709,notebook,30,60,30,2,00261,India
269318,2023-11-04,705,stencil,10,20,10,2,00382,India
269318,2023-11-04,711,TD kit,150,300,150,1,00382,India
269318,2023-11-04,707,marker,20,40,20,1,00382,India
461313,2023-11-04,704,scale,5,10,5,2,00105,India
461313,2023-11-04,717,spiral bound book,50,100,50,1,00105,India
909293,2023-11-04,705,stencil,10,20,10,2,00257,India
433740,2023-11-04,709,notebook,30,60,30,2,00485,India
570249,2023-11-04,713,ball pen,5,10,5,2,00417,India
570249,2023-11-04,701,gel pen,5,10,5,2,00417,India
272323,2023-11-04,712,graph paper,20,40,20,1,00026,India
272323,2023-11-04,710,geometry box,100,150,50,2,00026,India
272323,2023-11-04,701,gel pen,5,10,5,2,00026,India
840845,2023-11-04,717,spiral bound book,50,100,50,1,00026,India
840845,2023-11-04,701,gel pen,5,10,5,2,00026,India
840845,2023-11-04,714,carbon paper,15,30,15,1,00026,India
572570,2023-11-04,709,notebook,30,60,30,2,00232,India
572570,2023-11-04,708,sketchpen,15,40,25,1,00232,India
737194,2023-11-04,709,notebook,30,60,30,2,00245,India
737194,2023-11-04,702,pencil,2,5,3,2,00245,India
737194,2023-11-04,716,printing paper,200,400,200,1,00245,India
697784,2023-11-04,708,sketchpen,15,40,25,1,00401,India
697784,2023-11-04,702,pencil,2,5,3,2,00401,India
697784,2023-11-04,709,notebook,30,60,30,2,00401,India
384264,2023-11-04,717,spiral bound book,50,100,50,1,00291,India
384264,2023-11-04,710,geometry box,100,150,50,2,00291,India
959227,2023-11-04,710,geometry box,100,150,50,2,00267,India
959227,2023-11-04,717,spiral bound book,50,100,50,1,00267,India
959227,2023-11-04,701,gel pen,5,10,5,2,00267,India
959227,2023-11-04,713,ball pen,5,10,5,2,00267,India
817843,2023-11-04,701,gel pen,5,10,5,2,00417,India
817843,2023-11-04,709,notebook,30,60,30,2,00417,India
817843,2023-11-04,716,printing paper,200,400,200,1,00417,India
817843,2023-11-04,708,sketchpen,15,40,25,1,00417,India
273921,2023-11-04,707,marker,20,40,20,1,00291,India
715312,2023-11-04,714,carbon paper,15,30,15,1,00374,India
715312,2023-11-04,708,sketchpen,15,40,25,1,00374,India
715312,2023-11-04,707,marker,20,40,20,1,00374,India
715312,2023-11-04,705,stencil,10,20,10,2,00374,India
355893,2023-11-04,704,scale,5,10,5,2,00489,India
355893,2023-11-04,715,folder,5,15,10,1,00489,India
355893,2023-11-04,709,notebook,30,60,30,2,00489,India
355893,2023-11-04,716,printing paper,200,400,200,1,00489,India
781743,2023-11-04,711,TD kit,150,300,150,1,00312,India
781743,2023-11-04,706,sharpener,3,8,5,2,00312,India
781743,2023-11-04,702,pencil,2,5,3,2,00312,India
781743,2023-11-04,701,gel pen,5,10,5,2,00312,India
848230,2023-11-04,704,scale,5,10,5,2,00439,India
848230,2023-11-04,710,geometry box,100,150,50,2,00439,India
102787,2023-11-04,712,graph paper,20,40,20,1,00080,India
102787,2023-11-04,714,carbon paper,15,30,15,1,00080,India
102787,2023-11-04,708,sketchpen,15,40,25,1,00080,India
637918,2023-11-04,712,graph paper,20,40,20,1,00170,India
637918,2023-11-04,713,ball pen,5,10,5,2,00170,India
637918,2023-11-04,709,notebook,30,60,30,2,00170,India
370899,2023-11-04,716,printing paper,200,400,200,1,00073,India
370899,2023-11-04,701,gel pen,5,10,5,2,00073,India
370899,2023-11-04,704,scale,5,10,5,2,00073,India
370899,2023-11-04,715,folder,5,15,10,1,00073,India
370899,2023-11-04,707,marker,20,40,20,1,00073,India
300427,2023-11-04,714,carbon paper,15,30,15,1,00004,India
300427,2023-11-04,711,TD kit,150,300,150,1,00004,India
761622,2023-11-04,714,carbon paper,15,30,15,1,00222,India
431926,2023-11-04,710,geometry box,100,150,50,2,00183,India
431926,2023-11-04,706,sharpener,3,8,5,2,00183,India
138051,2023-11-04,713,ball pen,5,10,5,2,00093,India
138051,2023-11-04,702,pencil,2,5,3,2,00093,India
138051,2023-11-04,703,eraser,1,3,2,2,00093,India
138051,2023-11-04,701,gel pen,5,10,5,2,00093,India
162077,2023-11-04,713,ball pen,5,10,5,2,00466,India
162077,2023-11-04,717,spiral bound book,50,100,50,1,00466,India
162077,2023-11-04,703,eraser,1,3,2,2,00466,India
162077,2023-11-04,716,printing paper,200,400,200,1,00466,India
323189,2023-11-05,702,pencil,2,5,3,2,00251,India
323189,2023-11-05,708,sketchpen,15,40,25,1,00251,India
536647,2023-11-05,706,sharpener,3,8,5,2,00497,India
536647,2023-11-05,714,carbon paper,15,30,15,1,00497,India
536647,2023-11-05,713,ball pen,5,10,5,2,00497,India
536647,2023-11-05,708,sketchpen,15,40,25,1,00497,India
776652,2023-11-05,707,marker,20,40,20,1,00217,India
608692,2023-11-05,712,graph paper,20,40,20,1,00056,India
113574,2023-11-05,702,pencil,2,5,3,2,00054,India
113574,2023-11-05,716,printing paper,200,400,200,1,00054,India
113574,2023-11-05,713,ball pen,5,10,5,2,00054,India
113574,2023-11-05,701,gel pen,5,10,5,2,00054,India
174459,2023-11-05,703,eraser,1,3,2,2,00115,India
174459,2023-11-05,712,graph paper,20,40,20,1,00115,India
770985,2023-11-05,711,TD kit,150,300,150,1,00128,India
770985,2023-11-05,713,ball pen,5,10,5,2,00128,India
770985,2023-11-05,703,eraser,1,3,2,2,00128,India
770985,2023-11-05,701,gel pen,5,10,5,2,00128,India
179249,2023-11-05,709,notebook,30,60,30,2,00205,India
179249,2023-11-05,714,carbon paper,15,30,15,1,00205,India
179249,2023-11-05,708,sketchpen,15,40,25,1,00205,India
179249,2023-11-05,707,marker,20,40,20,1,00205,India
338572,2023-11-05,714,carbon paper,15,30,15,1,00215,India
338572,2023-11-05,715,folder,5,15,10,1,00215,India
338572,2023-11-05,705,stencil,10,20,10,2,00215,India
338572,2023-11-05,710,geometry box,100,150,50,2,00215,India
338572,2023-11-05,703,eraser,1,3,2,2,00215,India
687511,2023-11-05,705,stencil,10,20,10,2,00482,India
687511,2023-11-05,715,folder,5,15,10,1,00482,India
842882,2023-11-05,708,sketchpen,15,40,25,1,00254,India
842882,2023-11-05,706,sharpener,3,8,5,2,00254,India
842882,2023-11-05,701,gel pen,5,10,5,2,00254,India
842882,2023-11-05,717,spiral bound book,50,100,50,1,00254,India
842882,2023-11-05,709,notebook,30,60,30,2,00254,India
187103,2023-11-05,706,sharpener,3,8,5,2,00079,India
187103,2023-11-05,714,carbon paper,15,30,15,1,00079,India
187103,2023-11-05,713,ball pen,5,10,5,2,00079,India
187103,2023-11-05,709,notebook,30,60,30,2,00079,India
808332,2023-11-05,716,printing paper,200,400,200,1,00252,India
661772,2023-11-05,702,pencil,2,5,3,2,00115,India
661772,2023-11-05,708,sketchpen,15,40,25,1,00115,India
475036,2023-11-05,717,spiral bound book,50,100,50,1,00027,India
475036,2023-11-05,710,geometry box,100,150,50,2,00027,India
815280,2023-11-05,717,spiral bound book,50,100,50,1,00446,India
815280,2023-11-05,714,carbon paper,15,30,15,1,00446,India
585131,2023-11-05,711,TD kit,150,300,150,1,00483,India
650460,2023-11-05,711,TD kit,150,300,150,1,00478,India
650460,2023-11-05,702,pencil,2,5,3,2,00478,India
819672,2023-11-05,710,geometry box,100,150,50,2,00030,India
819672,2023-11-05,716,printing paper,200,400,200,1,00030,India
819672,2023-11-05,707,marker,20,40,20,1,00030,India
819672,2023-11-05,717,spiral bound book,50,100,50,1,00030,India
193689,2023-11-05,705,stencil,10,20,10,2,00138,India
193689,2023-11-05,704,scale,5,10,5,2,00138,India
193689,2023-11-05,712,graph paper,20,40,20,1,00138,India
193689,2023-11-05,713,ball pen,5,10,5,2,00138,India
951000,2023-11-05,708,sketchpen,15,40,25,1,00207,India
951000,2023-11-05,717,spiral bound book,50,100,50,1,00207,India
951000,2023-11-05,705,stencil,10,20,10,2,00207,India
951000,2023-11-05,707,marker,20,40,20,1,00207,India
924956,2023-11-05,710,geometry box,100,150,50,2,00247,India
924956,2023-11-05,703,eraser,1,3,2,2,00247,India
448238,2023-11-05,706,sharpener,3,8,5,2,00200,India
448238,2023-11-05,717,spiral bound book,50,100,50,1,00200,India
829809,2023-11-05,717,spiral bound book,50,100,50,1,00451,India
819776,2023-11-05,704,scale,5,10,5,2,00092,India
819776,2023-11-05,703,eraser,1,3,2,2,00092,India
819776,2023-11-05,710,geometry box,100,150,50,2,00092,India
819776,2023-11-05,708,sketchpen,15,40,25,1,00092,India
819776,2023-11-05,712,graph paper,20,40,20,1,00092,India
484897,2023-11-05,711,TD kit,150,300,150,1,00172,India
484897,2023-11-05,716,printing paper,200,400,200,1,00172,India
484897,2023-11-05,701,gel pen,5,10,5,2,00172,India
999433,2023-11-05,703,eraser,1,3,2,2,00400,India
999433,2023-11-05,713,ball pen,5,10,5,2,00400,India
999433,2023-11-05,709,notebook,30,60,30,2,00400,India
545948,2023-11-05,712,graph paper,20,40,20,1,00205,India
545948,2023-11-05,706,sharpener,3,8,5,2,00205,India
545948,2023-11-05,702,pencil,2,5,3,2,00205,India
209402,2023-11-05,714,carbon paper,15,30,15,1,00150,India
209402,2023-11-05,704,scale,5,10,5,2,00150,India
209402,2023-11-05,709,notebook,30,60,30,2,00150,India
209402,2023-11-05,713,ball pen,5,10,5,2,00150,India
421152,2023-11-05,706,sharpener,3,8,5,2,00085,India
421152,2023-11-05,707,marker,20,40,20,1,00085,India
421152,2023-11-05,708,sketchpen,15,40,25,1,00085,India
421152,2023-11-05,715,folder,5,15,10,1,00085,India
421152,2023-11-05,717,spiral bound book,50,100,50,1,00085,India
405792,2023-11-05,711,TD kit,150,300,150,1,00309,India
250605,2023-11-05,717,spiral bound book,50,100,50,1,00158,India
250605,2023-11-05,701,gel pen,5,10,5,2,00158,India
708269,2023-11-05,716,printing paper,200,400,200,1,00120,India
708269,2023-11-05,714,carbon paper,15,30,15,1,00120,India
708269,2023-11-05,706,sharpener,3,8,5,2,00120,India
442343,2023-11-05,714,carbon paper,15,30,15,1,00040,India
442343,2023-11-05,711,TD kit,150,300,150,1,00040,India
133437,2023-11-05,715,folder,5,15,10,1,00238,India
133437,2023-11-05,712,graph paper,20,40,20,1,00238,India
604875,2023-11-05,706,sharpener,3,8,5,2,00340,India
604875,2023-11-05,716,printing paper,200,400,200,1,00340,India
604875,2023-11-05,708,sketchpen,15,40,25,1,00340,India
442183,2023-11-05,711,TD kit,150,300,150,1,00064,India
442183,2023-11-05,712,graph paper,20,40,20,1,00064,India
442183,2023-11-05,708,sketchpen,15,40,25,1,00064,India
282604,2023-11-05,703,eraser,1,3,2,2,00048,India
419137,2023-11-06,707,marker,20,40,20,1,00332,India
419137,2023-11-06,714,carbon paper,15,30,15,1,00332,India
419137,2023-11-06,701,gel pen,5,10,5,2,00332,India
830583,2023-11-06,706,sharpener,3,8,5,2,00422,India
830583,2023-11-06,710,geometry box,100,150,50,2,00422,India
830583,2023-11-06,702,pencil,2,5,3,2,00422,India
830583,2023-11-06,713,ball pen,5,10,5,2,00422,India
240837,2023-11-06,702,pencil,2,5,3,2,00170,India
804573,2023-11-06,701,gel pen,5,10,5,2,00330,India
804573,2023-11-06,714,carbon paper,15,30,15,1,00330,India
804573,2023-11-06,713,ball pen,5,10,5,2,00330,India
804573,2023-11-06,716,printing paper,200,400,200,1,00330,India
804573,2023-11-06,709,notebook,30,60,30,2,00330,India
748190,2023-11-06,712,graph paper,20,40,20,1,00079,India
748190,2023-11-06,707,marker,20,40,20,1,00079,India
293879,2023-11-06,716,printing paper,200,400,200,1,00395,India
870296,2023-11-06,714,carbon paper,15,30,15,1,00199,India
870296,2023-11-06,715,folder,5,15,10,1,00199,India
870296,2023-11-06,707,marker,20,40,20,1,00199,India
645484,2023-11-06,717,spiral bound book,50,100,50,1,00216,India
645484,2023-11-06,706,sharpener,3,8,5,2,00216,India
645484,2023-11-06,701,gel pen,5,10,5,2,00216,India
645484,2023-11-06,704,scale,5,10,5,2,00216,India
669351,2023-11-06,705,stencil,10,20,10,2,00363,India
669351,2023-11-06,704,scale,5,10,5,2,00363,India
703567,2023-11-06,715,folder,5,15,10,1,00164,India
404871,2023-11-06,707,marker,20,40,20,1,00302,India
404871,2023-11-06,710,geometry box,100,150,50,2,00302,India
404871,2023-11-06,705,stencil,10,20,10,2,00302,India
736916,2023-11-06,713,ball pen,5,10,5,2,00070,India
736916,2023-11-06,706,sharpener,3,8,5,2,00070,India
736916,2023-11-06,702,pencil,2,5,3,2,00070,India
736916,2023-11-06,715,folder,5,15,10,1,00070,India
736916,2023-11-06,712,graph paper,20,40,20,1,00070,India
699085,2023-11-06,717,spiral bound book,50,100,50,1,00325,India
699085,2023-11-06,715,folder,5,15,10,1,00325,India
699085,2023-11-06,716,printing paper,200,400,200,1,00325,India
699085,2023-11-06,711,TD kit,150,300,150,1,00325,India
561959,2023-11-06,713,ball pen,5,10,5,2,00479,India
842065,2023-11-06,715,folder,5,15,10,1,00308,India
842065,2023-11-06,717,spiral bound book,50,100,50,1,00308,India
842065,2023-11-06,707,marker,20,40,20,1,00308,India
682575,2023-11-06,714,carbon paper,15,30,15,1,00316,India
682575,2023-11-06,711,TD kit,150,300,150,1,00316,India
561342,2023-11-06,704,scale,5,10,5,2,00094,India
561342,2023-11-06,706,sharpener,3,8,5,2,00094,India
561342,2023-11-06,701,gel pen,5,10,5,2,00094,India
561342,2023-11-06,715,folder,5,15,10,1,00094,India
561342,2023-11-06,705,stencil,10,20,10,2,00094,India
434471,2023-11-06,708,sketchpen,15,40,25,1,00373,India
434471,2023-11-06,713,ball pen,5,10,5,2,00373,India
746220,2023-11-06,703,eraser,1,3,2,2,00409,India
666141,2023-11-06,704,scale,5,10,5,2,00030,India
899771,2023-11-06,715,folder,5,15,10,1,00139,India
899771,2023-11-06,704,scale,5,10,5,2,00139,India
899771,2023-11-06,701,gel pen,5,10,5,2,00139,India
208079,2023-11-06,709,notebook,30,60,30,2,00091,India
924230,2023-11-06,709,notebook,30,60,30,2,00162,India
924230,2023-11-06,711,TD kit,150,300,150,1,00162,India
924230,2023-11-06,715,folder,5,15,10,1,00162,India
326336,2023-11-06,717,spiral bound book,50,100,50,1,00397,India
326336,2023-11-06,708,sketchpen,15,40,25,1,00397,India
326336,2023-11-06,707,marker,20,40,20,1,00397,India
326336,2023-11-06,713,ball pen,5,10,5,2,00397,India
326336,2023-11-06,716,printing paper,200,400,200,1,00397,India
489689,2023-11-06,707,marker,20,40,20,1,00027,India
489689,2023-11-06,702,pencil,2,5,3,2,00027,India
489689,2023-11-06,708,sketchpen,15,40,25,1,00027,India
489689,2023-11-06,710,geometry box,100,150,50,2,00027,India
890310,2023-11-06,714,carbon paper,15,30,15,1,00158,India
890310,2023-11-06,706,sharpener,3,8,5,2,00158,India
908817,2023-11-06,714,carbon paper,15,30,15,1,00271,India
908817,2023-11-06,710,geometry box,100,150,50,2,00271,India
222716,2023-11-06,708,sketchpen,15,40,25,1,00355,India
222716,2023-11-06,705,stencil,10,20,10,2,00355,India
222716,2023-11-06,716,printing paper,200,400,200,1,00355,India
222716,2023-11-06,715,folder,5,15,10,1,00355,India
222716,2023-11-06,709,notebook,30,60,30,2,00355,India
494359,2023-11-06,705,stencil,10,20,10,2,00209,India
494359,2023-11-06,711,TD kit,150,300,150,1,00209,India
685359,2023-11-06,715,folder,5,15,10,1,00338,India
685359,2023-11-06,714,carbon paper,15,30,15,1,00338,India
685359,2023-11-06,704,scale,5,10,5,2,00338,India
986030,2023-11-06,702,pencil,2,5,3,2,00499,India
986030,2023-11-06,715,folder,5,15,10,1,00499,India
986030,2023-11-06,706,sharpener,3,8,5,2,00499,India
630673,2023-11-06,713,ball pen,5,10,5,2,00182,India
630673,2023-11-06,711,TD kit,150,300,150,1,00182,India
607499,2023-11-06,709,notebook,30,60,30,2,00274,India
607499,2023-11-06,704,scale,5,10,5,2,00274,India
576850,2023-11-06,704,scale,5,10,5,2,00465,India
576850,2023-11-06,716,printing paper,200,400,200,1,00465,India
941439,2023-11-06,715,folder,5,15,10,1,00182,India
941439,2023-11-06,714,carbon paper,15,30,15,1,00182,India
941439,2023-11-06,702,pencil,2,5,3,2,00182,India
497120,2023-11-06,705,stencil,10,20,10,2,00202,India
497120,2023-11-06,709,notebook,30,60,30,2,00202,India
497120,2023-11-06,708,sketchpen,15,40,25,1,00202,India
497120,2023-11-06,702,pencil,2,5,3,2,00202,India
731807,2023-11-06,717,spiral bound book,50,100,50,1,00368,India
471156,2023-11-06,712,graph paper,20,40,20,1,00041,India
471156,2023-11-06,708,sketchpen,15,40,25,1,00041,India
673038,2023-11-06,708,sketchpen,15,40,25,1,00287,India
977017,2023-11-07,701,gel pen,5,10,5,2,00467,India
977017,2023-11-07,707,marker,20,40,20,1,00467,India
977017,2023-11-07,706,sharpener,3,8,5,2,00467,India
904867,2023-11-07,714,carbon paper,15,30,15,1,00245,India
904867,2023-11-07,713,ball pen,5,10,5,2,00245,India
334911,2023-11-07,702,pencil,2,5,3,2,00349,India
334911,2023-11-07,708,sketchpen,15,40,25,1,00349,India
398396,2023-11-07,710,geometry box,100,150,50,2,00237,India
398396,2023-11-07,704,scale,5,10,5,2,00237,India
338213,2023-11-07,715,folder,5,15,10,1,00052,India
968804,2023-11-07,714,carbon paper,15,30,15,1,00027,India
968804,2023-11-07,712,graph paper,20,40,20,1,00027,India
965263,2023-11-07,713,ball pen,5,10,5,2,00350,India
965263,2023-11-07,712,graph paper,20,40,20,1,00350,India
965263,2023-11-07,701,gel pen,5,10,5,2,00350,India
965263,2023-11-07,711,TD kit,150,300,150,1,00350,India
224016,2023-11-07,717,spiral bound book,50,100,50,1,00327,India
224016,2023-11-07,706,sharpener,3,8,5,2,00327,India
830082,2023-11-07,709,notebook,30,60,30,2,00355,India
830082,2023-11-07,707,marker,20,40,20,1,00355,India
997417,2023-11-07,706,sharpener,3,8,5,2,00270,India
997417,2023-11-07,705,stencil,10,20,10,2,00270,India
997417,2023-11-07,716,printing paper,200,400,200,1,00270,India
997417,2023-11-07,707,marker,20,40,20,1,00270,India
324942,2023-11-07,715,folder,5,15,10,1,00422,India
324942,2023-11-07,705,stencil,10,20,10,2,00422,India
324942,2023-11-07,708,sketchpen,15,40,25,1,00422,India
818406,2023-11-07,712,graph paper,20,40,20,1,00096,India
694039,2023-11-07,716,printing paper,200,400,200,1,00094,India
694039,2023-11-07,702,pencil,2,5,3,2,00094,India
694039,2023-11-07,707,marker,20,40,20,1,00094,India
845940,2023-11-07,714,carbon paper,15,30,15,1,00095,India
273492,2023-11-07,703,eraser,1,3,2,2,00437,India
762546,2023-11-07,713,ball pen,5,10,5,2,00436,India
762546,2023-11-07,712,graph paper,20,40,20,1,00436,India
741923,2023-11-07,716,printing paper,200,400,200,1,00098,India
741923,2023-11-07,714,carbon paper,15,30,15,1,00098,India
741923,2023-11-07,706,sharpener,3,8,5,2,00098,India
122542,2023-11-07,711,TD kit,150,300,150,1,00285,India
185958,2023-11-07,707,marker,20,40,20,1,00267,India
185958,2023-11-07,710,geometry box,100,150,50,2,00267,India
185958,2023-11-07,711,TD kit,150,300,150,1,00267,India
185958,2023-11-07,704,scale,5,10,5,2,00267,India
185958,2023-11-07,712,graph paper,20,40,20,1,00267,India
962366,2023-11-07,710,geometry box,100,150,50,2,00210,India
962366,2023-11-07,714,carbon paper,15,30,15,1,00210,India
962366,2023-11-07,704,scale,5,10,5,2,00210,India
938357,2023-11-07,715,folder,5,15,10,1,00403,India
938357,2023-11-07,711,TD kit,150,300,150,1,00403,India
859359,2023-11-07,713,ball pen,5,10,5,2,00411,India
859359,2023-11-07,710,geometry box,100,150,50,2,00411,India
859359,2023-11-07,715,folder,5,15,10,1,00411,India
859359,2023-11-07,703,eraser,1,3,2,2,00411,India
602749,2023-11-07,708,sketchpen,15,40,25,1,00457,India
602749,2023-11-07,712,graph paper,20,40,20,1,00457,India
602749,2023-11-07,713,ball pen,5,10,5,2,00457,India
602749,2023-11-07,710,geometry box,100,150,50,2,00457,India
128251,2023-11-07,709,notebook,30,60,30,2,00048,India
128251,2023-11-07,716,printing paper,200,400,200,1,00048,India
128251,2023-11-07,713,ball pen,5,10,5,2,00048,India
220359,2023-11-07,711,TD kit,150,300,150,1,00121,India
220359,2023-11-07,715,folder,5,15,10,1,00121,India
220359,2023-11-07,701,gel pen,5,10,5,2,00121,India
220359,2023-11-07,713,ball pen,5,10,5,2,00121,India
220359,2023-11-07,712,graph paper,20,40,20,1,00121,India
526375,2023-11-07,712,graph paper,20,40,20,1,00298,India
954774,2023-11-07,716,printing paper,200,400,200,1,00078,India
954774,2023-11-07,715,folder,5,15,10,1,00078,India
954774,2023-11-07,704,scale,5,10,5,2,00078,India
954774,2023-11-07,705,stencil,10,20,10,2,00078,India
712999,2023-11-07,709,notebook,30,60,30,2,00031,India
822391,2023-11-07,716,printing paper,200,400,200,1,00286,India
822391,2023-11-07,705,stencil,10,20,10,2,00286,India
822391,2023-11-07,710,geometry box,100,150,50,2,00286,India
822391,2023-11-07,702,pencil,2,5,3,2,00286,India
626922,2023-11-07,717,spiral bound book,50,100,50,1,00331,India
626922,2023-11-07,711,TD kit,150,300,150,1,00331,India
626922,2023-11-07,705,stencil,10,20,10,2,00331,India
435542,2023-11-07,704,scale,5,10,5,2,00222,India
435542,2023-11-07,715,folder,5,15,10,1,00222,India
435542,2023-11-07,703,eraser,1,3,2,2,00222,India
435542,2023-11-07,713,ball pen,5,10,5,2,00222,India
435542,2023-11-07,712,graph paper,20,40,20,1,00222,India
505931,2023-11-07,717,spiral bound book,50,100,50,1,00189,India
505931,2023-11-07,705,stencil,10,20,10,2,00189,India
107602,2023-11-07,701,gel pen,5,10,5,2,00128,India
814862,2023-11-07,705,stencil,10,20,10,2,00051,India
814862,2023-11-07,710,geometry box,100,150,50,2,00051,India
226635,2023-11-07,707,marker,20,40,20,1,00011,India
226635,2023-11-07,704,scale,5,10,5,2,00011,India
226635,2023-11-07,717,spiral bound book,50,100,50,1,00011,India
603958,2023-11-07,709,notebook,30,60,30,2,00273,India
603958,2023-11-07,710,geometry box,100,150,50,2,00273,India
603958,2023-11-07,713,ball pen,5,10,5,2,00273,India
603958,2023-11-07,716,printing paper,200,400,200,1,00273,India
742467,2023-11-07,715,folder,5,15,10,1,00379,India
742467,2023-11-07,709,notebook,30,60,30,2,00379,India
884587,2023-11-07,715,folder,5,15,10,1,00492,India
884587,2023-11-07,703,eraser,1,3,2,2,00492,India
194336,2023-11-07,715,folder,5,15,10,1,00348,India
194336,2023-11-07,707,marker,20,40,20,1,00348,India
194336,2023-11-07,709,notebook,30,60,30,2,00348,India
194336,2023-11-07,711,TD kit,150,300,150,1,00348,India
855645,2023-11-07,711,TD kit,150,300,150,1,00390,India
855645,2023-11-07,702,pencil,2,5,3,2,00390,India
855645,2023-11-07,707,marker,20,40,20,1,00390,India
774936,2023-11-07,709,notebook,30,60,30,2,00158,India
774936,2023-11-07,716,printing paper,200,400,200,1,00158,India
774936,2023-11-07,701,gel pen,5,10,5,2,00158,India
516783,2023-11-07,715,folder,5,15,10,1,00052,India
516783,2023-11-07,714,carbon paper,15,30,15,1,00052,India
516783,2023-11-07,705,stencil,10,20,10,2,00052,India
725109,2023-11-07,709,notebook,30,60,30,2,00366,India
725109,2023-11-07,706,sharpener,3,8,5,2,00366,India
725109,2023-11-07,716,printing paper,200,400,200,1,00366,India
704989,2023-11-07,706,sharpener,3,8,5,2,00174,India
237167,2023-11-07,712,graph paper,20,40,20,1,00411,India
237167,2023-11-07,701,gel pen,5,10,5,2,00411,India
644597,2023-11-07,712,graph paper,20,40,20,1,00188,India
644597,2023-11-07,701,gel pen,5,10,5,2,00188,India
876262,2023-11-07,716,printing paper,200,400,200,1,00169,India
876262,2023-11-07,709,notebook,30,60,30,2,00169,India
876262,2023-11-07,713,ball pen,5,10,5,2,00169,India
665238,2023-11-07,703,eraser,1,3,2,2,00284,India
821217,2023-11-08,708,sketchpen,15,40,25,1,00371,India
821217,2023-11-08,717,spiral bound book,50,100,50,1,00371,India
821217,2023-11-08,709,notebook,30,60,30,2,00371,India
821217,2023-11-08,711,TD kit,150,300,150,1,00371,India
821217,2023-11-08,716,printing paper,200,400,200,1,00371,India
111313,2023-11-08,716,printing paper,200,400,200,1,00409,India
111313,2023-11-08,709,notebook,30,60,30,2,00409,India
111313,2023-11-08,705,stencil,10,20,10,2,00409,India
425803,2023-11-08,705,stencil,10,20,10,2,00110,India
425803,2023-11-08,704,scale,5,10,5,2,00110,India
669759,2023-11-08,712,graph paper,20,40,20,1,00359,India
669759,2023-11-08,709,notebook,30,60,30,2,00359,India
669759,2023-11-08,714,carbon paper,15,30,15,1,00359,India
281035,2023-11-08,712,graph paper,20,40,20,1,00367,India
281035,2023-11-08,715,folder,5,15,10,1,00367,India
281035,2023-11-08,701,gel pen,5,10,5,2,00367,India
796178,2023-11-08,713,ball pen,5,10,5,2,00296,India
796178,2023-11-08,714,carbon paper,15,30,15,1,00296,India
796178,2023-11-08,706,sharpener,3,8,5,2,00296,India
730038,2023-11-08,710,geometry box,100,150,50,2,00248,India
710458,2023-11-08,711,TD kit,150,300,150,1,00081,India
710458,2023-11-08,701,gel pen,5,10,5,2,00081,India
710458,2023-11-08,703,eraser,1,3,2,2,00081,India
710458,2023-11-08,709,notebook,30,60,30,2,00081,India
587296,2023-11-08,713,ball pen,5,10,5,2,00015,India
725434,2023-11-08,705,stencil,10,20,10,2,00237,India
725434,2023-11-08,702,pencil,2,5,3,2,00237,India
725434,2023-11-08,706,sharpener,3,8,5,2,00237,India
725434,2023-11-08,701,gel pen,5,10,5,2,00237,India
936195,2023-11-08,714,carbon paper,15,30,15,1,00340,India
936195,2023-11-08,712,graph paper,20,40,20,1,00340,India
935498,2023-11-08,707,marker,20,40,20,1,00258,India
935498,2023-11-08,703,eraser,1,3,2,2,00258,India
935498,2023-11-08,713,ball pen,5,10,5,2,00258,India
713770,2023-11-08,716,printing paper,200,400,200,1,00182,India
528514,2023-11-08,709,notebook,30,60,30,2,00356,India
528514,2023-11-08,705,stencil,10,20,10,2,00356,India
528514,2023-11-08,701,gel pen,5,10,5,2,00356,India
219702,2023-11-08,711,TD kit,150,300,150,1,00278,India
219702,2023-11-08,717,spiral bound book,50,100,50,1,00278,India
219702,2023-11-08,708,sketchpen,15,40,25,1,00278,India
633645,2023-11-08,711,TD kit,150,300,150,1,00443,India
633645,2023-11-08,712,graph paper,20,40,20,1,00443,India
633645,2023-11-08,708,sketchpen,15,40,25,1,00443,India
508254,2023-11-08,704,scale,5,10,5,2,00210,India
508254,2023-11-08,709,notebook,30,60,30,2,00210,India
508254,2023-11-08,711,TD kit,150,300,150,1,00210,India
350961,2023-11-08,712,graph paper,20,40,20,1,00416,India
549750,2023-11-08,709,notebook,30,60,30,2,00113,India
686848,2023-11-08,709,notebook,30,60,30,2,00107,India
686848,2023-11-08,710,geometry box,100,150,50,2,00107,India
440003,2023-11-08,712,graph paper,20,40,20,1,00351,India
440003,2023-11-08,709,notebook,30,60,30,2,00351,India
227690,2023-11-08,709,notebook,30,60,30,2,00318,India
227690,2023-11-08,715,folder,5,15,10,1,00318,India
122551,2023-11-08,717,spiral bound book,50,100,50,1,00282,India
122551,2023-11-08,707,marker,20,40,20,1,00282,India
122551,2023-11-08,702,pencil,2,5,3,2,00282,India
294867,2023-11-08,707,marker,20,40,20,1,00126,India
294867,2023-11-08,704,scale,5,10,5,2,00126,India
294867,2023-11-08,709,notebook,30,60,30,2,00126,India
294867,2023-11-08,710,geometry box,100,150,50,2,00126,India
294867,2023-11-08,713,ball pen,5,10,5,2,00126,India
747004,2023-11-08,706,sharpener,3,8,5,2,00301,India
747004,2023-11-08,703,eraser,1,3,2,2,00301,India
605235,2023-11-08,701,gel pen,5,10,5,2,00392,India
605235,2023-11-08,708,sketchpen,15,40,25,1,00392,India
605235,2023-11-08,712,graph paper,20,40,20,1,00392,India
605235,2023-11-08,711,TD kit,150,300,150,1,00392,India
994944,2023-11-08,705,stencil,10,20,10,2,00072,India
994944,2023-11-08,706,sharpener,3,8,5,2,00072,India
994944,2023-11-08,703,eraser,1,3,2,2,00072,India
368172,2023-11-08,711,TD kit,150,300,150,1,00111,India
368172,2023-11-08,708,sketchpen,15,40,25,1,00111,India
368172,2023-11-08,702,pencil,2,5,3,2,00111,India
374313,2023-11-08,702,pencil,2,5,3,2,00233,India
374313,2023-11-08,705,stencil,10,20,10,2,00233,India
374313,2023-11-08,714,carbon paper,15,30,15,1,00233,India
440622,2023-11-08,706,sharpener,3,8,5,2,00189,India
440622,2023-11-08,703,eraser,1,3,2,2,00189,India
440622,2023-11-08,704,scale,5,10,5,2,00189,India
620301,2023-11-08,717,spiral bound book,50,100,50,1,00103,India
442012,2023-11-08,717,spiral bound book,50,100,50,1,00211,India
442012,2023-11-08,713,ball pen,5,10,5,2,00211,India
442012,2023-11-08,711,TD kit,150,300,150,1,00211,India
442012,2023-11-08,706,sharpener,3,8,5,2,00211,India
442012,2023-11-08,708,sketchpen,15,40,25,1,00211,India
985347,2023-11-08,710,geometry box,100,150,50,2,00449,India
985347,2023-11-08,705,stencil,10,20,10,2,00449,India
128005,2023-11-08,717,spiral bound book,50,100,50,1,00489,India
128005,2023-11-08,706,sharpener,3,8,5,2,00489,India
128005,2023-11-08,712,graph paper,20,40,20,1,00489,India
128005,2023-11-08,711,TD kit,150,300,150,1,00489,India
128005,2023-11-08,707,marker,20,40,20,1,00489,India
978798,2023-11-08,712,graph paper,20,40,20,1,00491,India
703192,2023-11-08,701,gel pen,5,10,5,2,00144,India
703192,2023-11-08,705,stencil,10,20,10,2,00144,India
703192,2023-11-08,714,carbon paper,15,30,15,1,00144,India
703192,2023-11-08,709,notebook,30,60,30,2,00144,India
527111,2023-11-08,708,sketchpen,15,40,25,1,00275,India
527111,2023-11-08,713,ball pen,5,10,5,2,00275,India
527111,2023-11-08,709,notebook,30,60,30,2,00275,India
157640,2023-11-08,701,gel pen,5,10,5,2,00145,India
157640,2023-11-08,714,carbon paper,15,30,15,1,00145,India
157640,2023-11-08,712,graph paper,20,40,20,1,00145,India
157640,2023-11-08,710,geometry box,100,150,50,2,00145,India
729484,2023-11-08,704,scale,5,10,5,2,00218,India
729484,2023-11-08,701,gel pen,5,10,5,2,00218,India
871043,2023-11-08,701,gel pen,5,10,5,2,00500,India
895436,2023-11-08,713,ball pen,5,10,5,2,00022,India
895436,2023-11-08,706,sharpener,3,8,5,2,00022,India
162540,2023-11-08,713,ball pen,5,10,5,2,00393,India
477837,2023-11-08,704,scale,5,10,5,2,00310,India
477837,2023-11-08,711,TD kit,150,300,150,1,00310,India
477837,2023-11-08,706,sharpener,3,8,5,2,00310,India
477837,2023-11-08,705,stencil,10,20,10,2,00310,India
592722,2023-11-08,702,pencil,2,5,3,2,00203,India
592722,2023-11-08,701,gel pen,5,10,5,2,00203,India
592722,2023-11-08,716,printing paper,200,400,200,1,00203,India
592722,2023-11-08,711,TD kit,150,300,150,1,00203,India
592722,2023-11-08,709,notebook,30,60,30,2,00203,India
138608,2023-11-08,713,ball pen,5,10,5,2,00086,India
138608,2023-11-08,704,scale,5,10,5,2,00086,India
138608,2023-11-08,705,stencil,10,20,10,2,00086,India
138608,2023-11-08,707,marker,20,40,20,1,00086,India
142199,2023-11-08,707,marker,20,40,20,1,00288,India
265308,2023-11-08,705,stencil,10,20,10,2,00494,India
265308,2023-11-08,702,pencil,2,5,3,2,00494,India
242172,2023-11-08,704,scale,5,10,5,2,00333,India
242172,2023-11-08,711,TD kit,150,300,150,1,00333,India
242172,2023-11-08,709,notebook,30,60,30,2,00333,India
242172,2023-11-08,714,carbon paper,15,30,15,1,00333,India
242172,2023-11-08,701,gel pen,5,10,5,2,00333,India
344425,2023-11-09,712,graph paper,20,40,20,1,00115,India
344425,2023-11-09,714,carbon paper,15,30,15,1,00115,India
499083,2023-11-09,710,geometry box,100,150,50,2,00095,India
499083,2023-11-09,711,TD kit,150,300,150,1,00095,India
499083,2023-11-09,715,folder,5,15,10,1,00095,India
499083,2023-11-09,708,sketchpen,15,40,25,1,00095,India
622852,2023-11-09,701,gel pen,5,10,5,2,00311,India
622852,2023-11-09,708,sketchpen,15,40,25,1,00311,India
622852,2023-11-09,714,carbon paper,15,30,15,1,00311,India
622852,2023-11-09,715,folder,5,15,10,1,00311,India
622852,2023-11-09,702,pencil,2,5,3,2,00311,India
443659,2023-11-09,706,sharpener,3,8,5,2,00429,India
443659,2023-11-09,705,stencil,10,20,10,2,00429,India
487252,2023-11-09,710,geometry box,100,150,50,2,00397,India
487252,2023-11-09,707,marker,20,40,20,1,00397,India
487252,2023-11-09,704,scale,5,10,5,2,00397,India
487252,2023-11-09,715,folder,5,15,10,1,00397,India
487252,2023-11-09,708,sketchpen,15,40,25,1,00397,India
712027,2023-11-09,714,carbon paper,15,30,15,1,00335,India
712027,2023-11-09,717,spiral bound book,50,100,50,1,00335,India
712027,2023-11-09,701,gel pen,5,10,5,2,00335,India
645210,2023-11-09,706,sharpener,3,8,5,2,00209,India
645210,2023-11-09,710,geometry box,100,150,50,2,00209,India
645210,2023-11-09,716,printing paper,200,400,200,1,00209,India
645210,2023-11-09,704,scale,5,10,5,2,00209,India
645210,2023-11-09,702,pencil,2,5,3,2,00209,India
668052,2023-11-09,704,scale,5,10,5,2,00441,India
668052,2023-11-09,710,geometry box,100,150,50,2,00441,India
972166,2023-11-09,715,folder,5,15,10,1,00478,India
972166,2023-11-09,706,sharpener,3,8,5,2,00478,India
712166,2023-11-09,701,gel pen,5,10,5,2,00323,India
712166,2023-11-09,715,folder,5,15,10,1,00323,India
712166,2023-11-09,711,TD kit,150,300,150,1,00323,India
712166,2023-11-09,714,carbon paper,15,30,15,1,00323,India
523845,2023-11-09,705,stencil,10,20,10,2,00349,India
523845,2023-11-09,711,TD kit,150,300,150,1,00349,India
523845,2023-11-09,716,printing paper,200,400,200,1,00349,India
523845,2023-11-09,708,sketchpen,15,40,25,1,00349,India
161236,2023-11-09,709,notebook,30,60,30,2,00161,India
161236,2023-11-09,704,scale,5,10,5,2,00161,India
804512,2023-11-09,710,geometry box,100,150,50,2,00250,India
804512,2023-11-09,702,pencil,2,5,3,2,00250,India
804512,2023-11-09,705,stencil,10,20,10,2,00250,India
804512,2023-11-09,709,notebook,30,60,30,2,00250,India
804512,2023-11-09,708,sketchpen,15,40,25,1,00250,India
927274,2023-11-09,713,ball pen,5,10,5,2,00256,India
927274,2023-11-09,708,sketchpen,15,40,25,1,00256,India
927274,2023-11-09,717,spiral bound book,50,100,50,1,00256,India
167066,2023-11-09,708,sketchpen,15,40,25,1,00054,India
167066,2023-11-09,705,stencil,10,20,10,2,00054,India
167066,2023-11-09,714,carbon paper,15,30,15,1,00054,India
167066,2023-11-09,702,pencil,2,5,3,2,00054,India
260962,2023-11-09,709,notebook,30,60,30,2,00161,India
260962,2023-11-09,704,scale,5,10,5,2,00161,India
260962,2023-11-09,712,graph paper,20,40,20,1,00161,India
103857,2023-11-09,710,geometry box,100,150,50,2,00450,India
103857,2023-11-09,716,printing paper,200,400,200,1,00450,India
103857,2023-11-09,703,eraser,1,3,2,2,00450,India
103857,2023-11-09,704,scale,5,10,5,2,00450,India
103857,2023-11-09,713,ball pen,5,10,5,2,00450,India
341422,2023-11-09,710,geometry box,100,150,50,2,00233,India
341422,2023-11-09,701,gel pen,5,10,5,2,00233,India
190664,2023-11-09,701,gel pen,5,10,5,2,00300,India
190664,2023-11-09,715,folder,5,15,10,1,00300,India
718771,2023-11-09,715,folder,5,15,10,1,00354,India
718771,2023-11-09,705,stencil,10,20,10,2,00354,India
718771,2023-11-09,710,geometry box,100,150,50,2,00354,India
718771,2023-11-09,701,gel pen,5,10,5,2,00354,India
583460,2023-11-09,704,scale,5,10,5,2,00053,India
583460,2023-11-09,705,stencil,10,20,10,2,00053,India
711371,2023-11-09,709,notebook,30,60,30,2,00182,India
711371,2023-11-09,715,folder,5,15,10,1,00182,India
139919,2023-11-09,714,carbon paper,15,30,15,1,00371,India
139919,2023-11-09,713,ball pen,5,10,5,2,00371,India
139919,2023-11-09,702,pencil,2,5,3,2,00371,India
629606,2023-11-09,710,geometry box,100,150,50,2,00220,India
629606,2023-11-09,713,ball pen,5,10,5,2,00220,India
629606,2023-11-09,701,gel pen,5,10,5,2,00220,India
629606,2023-11-09,706,sharpener,3,8,5,2,00220,India
354742,2023-11-09,705,stencil,10,20,10,2,00352,India
354742,2023-11-09,717,spiral bound book,50,100,50,1,00352,India
526142,2023-11-09,710,geometry box,100,150,50,2,00051,India
526142,2023-11-09,709,notebook,30,60,30,2,00051,India
526142,2023-11-09,711,TD kit,150,300,150,1,00051,India
526142,2023-11-09,705,stencil,10,20,10,2,00051,India
983830,2023-11-09,715,folder,5,15,10,1,00260,India
983830,2023-11-09,705,stencil,10,20,10,2,00260,India
786155,2023-11-09,705,stencil,10,20,10,2,00182,India
781097,2023-11-09,705,stencil,10,20,10,2,00278,India
781097,2023-11-09,707,marker,20,40,20,1,00278,India
194598,2023-11-09,712,graph paper,20,40,20,1,00167,India
194598,2023-11-09,717,spiral bound book,50,100,50,1,00167,India
774602,2023-11-09,709,notebook,30,60,30,2,00261,India
358209,2023-11-09,712,graph paper,20,40,20,1,00332,India
358209,2023-11-09,709,notebook,30,60,30,2,00332,India
358209,2023-11-09,713,ball pen,5,10,5,2,00332,India
358209,2023-11-09,703,eraser,1,3,2,2,00332,India
399959,2023-11-09,701,gel pen,5,10,5,2,00005,India
399959,2023-11-09,713,ball pen,5,10,5,2,00005,India
399959,2023-11-09,710,geometry box,100,150,50,2,00005,India
698435,2023-11-09,702,pencil,2,5,3,2,00091,India
698435,2023-11-09,703,eraser,1,3,2,2,00091,India
698435,2023-11-09,709,notebook,30,60,30,2,00091,India
698435,2023-11-09,714,carbon paper,15,30,15,1,00091,India
735270,2023-11-09,716,printing paper,200,400,200,1,00252,India
963849,2023-11-09,715,folder,5,15,10,1,00458,India
963849,2023-11-09,704,scale,5,10,5,2,00458,India
963849,2023-11-09,703,eraser,1,3,2,2,00458,India
963849,2023-11-09,711,TD kit,150,300,150,1,00458,India
418449,2023-11-09,701,gel pen,5,10,5,2,00074,India
418449,2023-11-09,717,spiral bound book,50,100,50,1,00074,India
192217,2023-11-10,717,spiral bound book,50,100,50,1,00087,India
192217,2023-11-10,716,printing paper,200,400,200,1,00087,India
192217,2023-11-10,707,marker,20,40,20,1,00087,India
192217,2023-11-10,715,folder,5,15,10,1,00087,India
146470,2023-11-10,708,sketchpen,15,40,25,1,00441,India
146470,2023-11-10,704,scale,5,10,5,2,00441,India
416074,2023-11-10,716,printing paper,200,400,200,1,00239,India
416074,2023-11-10,701,gel pen,5,10,5,2,00239,India
416074,2023-11-10,706,sharpener,3,8,5,2,00239,India
416074,2023-11-10,702,pencil,2,5,3,2,00239,India
416074,2023-11-10,712,graph paper,20,40,20,1,00239,India
562408,2023-11-10,702,pencil,2,5,3,2,00243,India
562408,2023-11-10,714,carbon paper,15,30,15,1,00243,India
120903,2023-11-10,714,carbon paper,15,30,15,1,00007,India
120903,2023-11-10,703,eraser,1,3,2,2,00007,India
120903,2023-11-10,708,sketchpen,15,40,25,1,00007,India
554299,2023-11-10,703,eraser,1,3,2,2,00418,India
554299,2023-11-10,702,pencil,2,5,3,2,00418,India
554299,2023-11-10,713,ball pen,5,10,5,2,00418,India
494338,2023-11-10,705,stencil,10,20,10,2,00337,India
494338,2023-11-10,717,spiral bound book,50,100,50,1,00337,India
494338,2023-11-10,701,gel pen,5,10,5,2,00337,India
576996,2023-11-10,705,stencil,10,20,10,2,00462,India
283551,2023-11-10,710,geometry box,100,150,50,2,00479,India
283551,2023-11-10,705,stencil,10,20,10,2,00479,India
283551,2023-11-10,702,pencil,2,5,3,2,00479,India
283551,2023-11-10,701,gel pen,5,10,5,2,00479,India
283551,2023-11-10,704,scale,5,10,5,2,00479,India
661294,2023-11-10,716,printing paper,200,400,200,1,00297,India
661294,2023-11-10,711,TD kit,150,300,150,1,00297,India
661294,2023-11-10,701,gel pen,5,10,5,2,00297,India
661294,2023-11-10,713,ball pen,5,10,5,2,00297,India
322618,2023-11-10,704,scale,5,10,5,2,00393,India
322618,2023-11-10,711,TD kit,150,300,150,1,00393,India
377024,2023-11-10,711,TD kit,150,300,150,1,00122,India
377024,2023-11-10,716,printing paper,200,400,200,1,00122,India
377024,2023-11-10,708,sketchpen,15,40,25,1,00122,India
377024,2023-11-10,705,stencil,10,20,10,2,00122,India
503888,2023-11-10,715,folder,5,15,10,1,00275,India
503888,2023-11-10,704,scale,5,10,5,2,00275,India
503888,2023-11-10,714,carbon paper,15,30,15,1,00275,India
742163,2023-11-10,717,spiral bound book,50,100,50,1,00172,India
742163,2023-11-10,707,marker,20,40,20,1,00172,India
742163,2023-11-10,714,carbon paper,15,30,15,1,00172,India
521531,2023-11-10,703,eraser,1,3,2,2,00411,India
521531,2023-11-10,707,marker,20,40,20,1,00411,India
343471,2023-11-10,704,scale,5,10,5,2,00053,India
343471,2023-11-10,711,TD kit,150,300,150,1,00053,India
343471,2023-11-10,713,ball pen,5,10,5,2,00053,India
343471,2023-11-10,709,notebook,30,60,30,2,00053,India
343471,2023-11-10,715,folder,5,15,10,1,00053,India
667378,2023-11-10,716,printing paper,200,400,200,1,00085,India
667378,2023-11-10,717,spiral bound book,50,100,50,1,00085,India
667378,2023-11-10,715,folder,5,15,10,1,00085,India
118645,2023-11-10,713,ball pen,5,10,5,2,00192,India
118645,2023-11-10,708,sketchpen,15,40,25,1,00192,India
352573,2023-11-10,701,gel pen,5,10,5,2,00430,India
352573,2023-11-10,717,spiral bound book,50,100,50,1,00430,India
352573,2023-11-10,710,geometry box,100,150,50,2,00430,India
352573,2023-11-10,703,eraser,1,3,2,2,00430,India
353066,2023-11-10,704,scale,5,10,5,2,00150,India
353066,2023-11-10,707,marker,20,40,20,1,00150,India
353066,2023-11-10,709,notebook,30,60,30,2,00150,India
164926,2023-11-10,710,geometry box,100,150,50,2,00205,India
164926,2023-11-10,711,TD kit,150,300,150,1,00205,India
164926,2023-11-10,707,marker,20,40,20,1,00205,India
969678,2023-11-10,705,stencil,10,20,10,2,00396,India
420233,2023-11-10,711,TD kit,150,300,150,1,00322,India
420233,2023-11-10,715,folder,5,15,10,1,00322,India
460840,2023-11-10,704,scale,5,10,5,2,00406,India
460840,2023-11-10,705,stencil,10,20,10,2,00406,India
460840,2023-11-10,715,folder,5,15,10,1,00406,India
460840,2023-11-10,713,ball pen,5,10,5,2,00406,India
771246,2023-11-10,714,carbon paper,15,30,15,1,00133,India
771246,2023-11-10,701,gel pen,5,10,5,2,00133,India
771246,2023-11-10,707,marker,20,40,20,1,00133,India
104974,2023-11-10,717,spiral bound book,50,100,50,1,00184,India
697616,2023-11-10,712,graph paper,20,40,20,1,00211,India
697616,2023-11-10,704,scale,5,10,5,2,00211,India
697616,2023-11-10,701,gel pen,5,10,5,2,00211,India
697616,2023-11-10,705,stencil,10,20,10,2,00211,India
347169,2023-11-10,705,stencil,10,20,10,2,00433,India
212010,2023-11-10,712,graph paper,20,40,20,1,00123,India
212010,2023-11-10,710,geometry box,100,150,50,2,00123,India
271027,2023-11-10,716,printing paper,200,400,200,1,00273,India
271027,2023-11-10,714,carbon paper,15,30,15,1,00273,India
271027,2023-11-10,701,gel pen,5,10,5,2,00273,India
903050,2023-11-10,711,TD kit,150,300,150,1,00108,India
903050,2023-11-10,717,spiral bound book,50,100,50,1,00108,India
930450,2023-11-11,710,geometry box,100,150,50,2,00154,India
930450,2023-11-11,717,spiral bound book,50,100,50,1,00154,India
494437,2023-11-11,710,geometry box,100,150,50,2,00360,India
494437,2023-11-11,701,gel pen,5,10,5,2,00360,India
494437,2023-11-11,711,TD kit,150,300,150,1,00360,India
494437,2023-11-11,708,sketchpen,15,40,25,1,00360,India
494437,2023-11-11,715,folder,5,15,10,1,00360,India
405337,2023-11-11,715,folder,5,15,10,1,00321,India
405337,2023-11-11,710,geometry box,100,150,50,2,00321,India
405337,2023-11-11,705,stencil,10,20,10,2,00321,India
685844,2023-11-11,712,graph paper,20,40,20,1,00402,India
685844,2023-11-11,705,stencil,10,20,10,2,00402,India
463848,2023-11-11,706,sharpener,3,8,5,2,00273,India
463848,2023-11-11,703,eraser,1,3,2,2,00273,India
463848,2023-11-11,712,graph paper,20,40,20,1,00273,India
442397,2023-11-11,715,folder,5,15,10,1,00441,India
442397,2023-11-11,705,stencil,10,20,10,2,00441,India
548240,2023-11-11,704,scale,5,10,5,2,00329,India
548240,2023-11-11,702,pencil,2,5,3,2,00329,India
919874,2023-11-11,703,eraser,1,3,2,2,00120,India
919874,2023-11-11,701,gel pen,5,10,5,2,00120,India
919874,2023-11-11,715,folder,5,15,10,1,00120,India
919874,2023-11-11,702,pencil,2,5,3,2,00120,India
268698,2023-11-11,701,gel pen,5,10,5,2,00219,India
268698,2023-11-11,714,carbon paper,15,30,15,1,00219,India
268698,2023-11-11,708,sketchpen,15,40,25,1,00219,India
415497,2023-11-11,713,ball pen,5,10,5,2,00372,India
415497,2023-11-11,716,printing paper,200,400,200,1,00372,India
415497,2023-11-11,701,gel pen,5,10,5,2,00372,India
415497,2023-11-11,707,marker,20,40,20,1,00372,India
412585,2023-11-11,713,ball pen,5,10,5,2,00251,India
412585,2023-11-11,710,geometry box,100,150,50,2,00251,India
412585,2023-11-11,716,printing paper,200,400,200,1,00251,India
982944,2023-11-11,710,geometry box,100,150,50,2,00031,India
982944,2023-11-11,709,notebook,30,60,30,2,00031,India
630660,2023-11-11,712,graph paper,20,40,20,1,00285,India
630660,2023-11-11,708,sketchpen,15,40,25,1,00285,India
630660,2023-11-11,707,marker,20,40,20,1,00285,India
231139,2023-11-11,711,TD kit,150,300,150,1,00248,India
231139,2023-11-11,707,marker,20,40,20,1,00248,India
231139,2023-11-11,709,notebook,30,60,30,2,00248,India
444753,2023-11-11,703,eraser,1,3,2,2,00087,India
444753,2023-11-11,701,gel pen,5,10,5,2,00087,India
633911,2023-11-11,712,graph paper,20,40,20,1,00270,India
633911,2023-11-11,701,gel pen,5,10,5,2,00270,India
590586,2023-11-11,708,sketchpen,15,40,25,1,00367,India
348952,2023-11-11,704,scale,5,10,5,2,00160,India
348952,2023-11-11,708,sketchpen,15,40,25,1,00160,India
348952,2023-11-11,710,geometry box,100,150,50,2,00160,India
348952,2023-11-11,701,gel pen,5,10,5,2,00160,India
771670,2023-11-11,701,gel pen,5,10,5,2,00406,India
771670,2023-11-11,707,marker,20,40,20,1,00406,India
354382,2023-11-11,715,folder,5,15,10,1,00235,India
354382,2023-11-11,711,TD kit,150,300,150,1,00235,India
354382,2023-11-11,709,notebook,30,60,30,2,00235,India
429634,2023-11-11,708,sketchpen,15,40,25,1,00193,India
429634,2023-11-11,715,folder,5,15,10,1,00193,India
429634,2023-11-11,713,ball pen,5,10,5,2,00193,India
429634,2023-11-11,706,sharpener,3,8,5,2,00193,India
712098,2023-11-11,713,ball pen,5,10,5,2,00037,India
712098,2023-11-11,714,carbon paper,15,30,15,1,00037,India
712098,2023-11-11,708,sketchpen,15,40,25,1,00037,India
175657,2023-11-11,711,TD kit,150,300,150,1,00131,India
175657,2023-11-11,713,ball pen,5,10,5,2,00131,India
175657,2023-11-11,701,gel pen,5,10,5,2,00131,India
175657,2023-11-11,705,stencil,10,20,10,2,00131,India
820596,2023-11-11,705,stencil,10,20,10,2,00239,India
374452,2023-11-11,713,ball pen,5,10,5,2,00480,India
374452,2023-11-11,707,marker,20,40,20,1,00480,India
374452,2023-11-11,704,scale,5,10,5,2,00480,India
470576,2023-11-11,713,ball pen,5,10,5,2,00364,India
470576,2023-11-11,711,TD kit,150,300,150,1,00364,India
254335,2023-11-11,702,pencil,2,5,3,2,00471,India
254335,2023-11-11,713,ball pen,5,10,5,2,00471,India
254335,2023-11-11,706,sharpener,3,8,5,2,00471,India
734735,2023-11-11,701,gel pen,5,10,5,2,00172,India
850259,2023-11-11,706,sharpener,3,8,5,2,00160,India
850259,2023-11-11,705,stencil,10,20,10,2,00160,India
850259,2023-11-11,707,marker,20,40,20,1,00160,India
929139,2023-11-11,707,marker,20,40,20,1,00311,India
929139,2023-11-11,713,ball pen,5,10,5,2,00311,India
561316,2023-11-11,706,sharpener,3,8,5,2,00210,India
561316,2023-11-11,702,pencil,2,5,3,2,00210,India
249836,2023-11-11,713,ball pen,5,10,5,2,00254,India
968620,2023-11-11,703,eraser,1,3,2,2,00061,India
523638,2023-11-11,703,eraser,1,3,2,2,00008,India
523638,2023-11-11,704,scale,5,10,5,2,00008,India
523638,2023-11-11,714,carbon paper,15,30,15,1,00008,India
622689,2023-11-11,715,folder,5,15,10,1,00007,India
622689,2023-11-11,704,scale,5,10,5,2,00007,India
364491,2023-11-11,712,graph paper,20,40,20,1,00219,India
364491,2023-11-11,716,printing paper,200,400,200,1,00219,India
364491,2023-11-11,706,sharpener,3,8,5,2,00219,India
912686,2023-11-11,702,pencil,2,5,3,2,00425,India
455433,2023-11-11,708,sketchpen,15,40,25,1,00160,India
810861,2023-11-11,707,marker,20,40,20,1,00090,India
810861,2023-11-11,716,printing paper,200,400,200,1,00090,India
810861,2023-11-11,708,sketchpen,15,40,25,1,00090,India
810861,2023-11-11,710,geometry box,100,150,50,2,00090,India
810861,2023-11-11,714,carbon paper,15,30,15,1,00090,India
342884,2023-11-11,717,spiral bound book,50,100,50,1,00071,India
342884,2023-11-11,713,ball pen,5,10,5,2,00071,India
342884,2023-11-11,702,pencil,2,5,3,2,00071,India
342884,2023-11-11,712,graph paper,20,40,20,1,00071,India
342884,2023-11-11,704,scale,5,10,5,2,00071,India
110914,2023-11-11,716,printing paper,200,400,200,1,00133,India
110914,2023-11-11,703,eraser,1,3,2,2,00133,India
110914,2023-11-11,705,stencil,10,20,10,2,00133,India
672318,2023-11-11,703,eraser,1,3,2,2,00141,India
903348,2023-11-11,706,sharpener,3,8,5,2,00373,India
819661,2023-11-11,706,sharpener,3,8,5,2,00334,India
819661,2023-11-11,712,graph paper,20,40,20,1,00334,India
819661,2023-11-11,710,geometry box,100,150,50,2,00334,India
819661,2023-11-11,714,carbon paper,15,30,15,1,00334,India
819661,2023-11-11,703,eraser,1,3,2,2,00334,India
406218,2023-11-11,714,carbon paper,15,30,15,1,00219,India
406218,2023-11-11,702,pencil,2,5,3,2,00219,India
875587,2023-11-11,704,scale,5,10,5,2,00257,India
875587,2023-11-11,701,gel pen,5,10,5,2,00257,India
875587,2023-11-11,708,sketchpen,15,40,25,1,00257,India
614918,2023-11-12,717,spiral bound book,50,100,50,1,00269,India
892405,2023-11-12,712,graph paper,20,40,20,1,00245,India
892405,2023-11-12,714,carbon paper,15,30,15,1,00245,India
892405,2023-11-12,701,gel pen,5,10,5,2,00245,India
892405,2023-11-12,716,printing paper,200,400,200,1,00245,India
892405,2023-11-12,706,sharpener,3,8,5,2,00245,India
280871,2023-11-12,703,eraser,1,3,2,2,00212,India
280871,2023-11-12,701,gel pen,5,10,5,2,00212,India
280871,2023-11-12,711,TD kit,150,300,150,1,00212,India
280871,2023-11-12,702,pencil,2,5,3,2,00212,India
251608,2023-11-12,707,marker,20,40,20,1,00021,India
251608,2023-11-12,703,eraser,1,3,2,2,00021,India
793562,2023-11-12,716,printing paper,200,400,200,1,00381,India
793562,2023-11-12,706,sharpener,3,8,5,2,00381,India
793562,2023-11-12,714,carbon paper,15,30,15,1,00381,India
793562,2023-11-12,712,graph paper,20,40,20,1,00381,India
793562,2023-11-12,717,spiral bound book,50,100,50,1,00381,India
126032,2023-11-12,709,notebook,30,60,30,2,00112,India
268924,2023-11-12,708,sketchpen,15,40,25,1,00404,India
268924,2023-11-12,717,spiral bound book,50,100,50,1,00404,India
118879,2023-11-12,705,stencil,10,20,10,2,00447,India
118879,2023-11-12,715,folder,5,15,10,1,00447,India
118879,2023-11-12,714,carbon paper,15,30,15,1,00447,India
927803,2023-11-12,704,scale,5,10,5,2,00162,India
927803,2023-11-12,710,geometry box,100,150,50,2,00162,India
927803,2023-11-12,709,notebook,30,60,30,2,00162,India
940628,2023-11-12,711,TD kit,150,300,150,1,00497,India
940628,2023-11-12,705,stencil,10,20,10,2,00497,India
817125,2023-11-12,713,ball pen,5,10,5,2,00486,India
817125,2023-11-12,707,marker,20,40,20,1,00486,India
817125,2023-11-12,706,sharpener,3,8,5,2,00486,India
817125,2023-11-12,702,pencil,2,5,3,2,00486,India
434831,2023-11-12,714,carbon paper,15,30,15,1,00022,India
434831,2023-11-12,704,scale,5,10,5,2,00022,India
434831,2023-11-12,710,geometry box,100,150,50,2,00022,India
478652,2023-11-12,701,gel pen,5,10,5,2,00329,India
478652,2023-11-12,705,stencil,10,20,10,2,00329,India
478652,2023-11-12,702,pencil,2,5,3,2,00329,India
478652,2023-11-12,716,printing paper,200,400,200,1,00329,India
177970,2023-11-12,707,marker,20,40,20,1,00468,India
177970,2023-11-12,705,stencil,10,20,10,2,00468,India
177970,2023-11-12,704,scale,5,10,5,2,00468,India
921834,2023-11-12,712,graph paper,20,40,20,1,00049,India
921834,2023-11-12,717,spiral bound book,50,100,50,1,00049,India
223509,2023-11-12,703,eraser,1,3,2,2,00024,India
223509,2023-11-12,715,folder,5,15,10,1,00024,India
680658,2023-11-12,703,eraser,1,3,2,2,00482,India
680658,2023-11-12,707,marker,20,40,20,1,00482,India
680658,2023-11-12,708,sketchpen,15,40,25,1,00482,India
680658,2023-11-12,705,stencil,10,20,10,2,00482,India
184514,2023-11-12,705,stencil,10,20,10,2,00378,India
184514,2023-11-12,701,gel pen,5,10,5,2,00378,India
184514,2023-11-12,715,folder,5,15,10,1,00378,India
980366,2023-11-12,707,marker,20,40,20,1,00231,India
980366,2023-11-12,710,geometry box,100,150,50,2,00231,India
807612,2023-11-12,715,folder,5,15,10,1,00484,India
807612,2023-11-12,716,printing paper,200,400,200,1,00484,India
807612,2023-11-12,709,notebook,30,60,30,2,00484,India
807612,2023-11-12,701,gel pen,5,10,5,2,00484,India
166433,2023-11-12,714,carbon paper,15,30,15,1,00112,India
867221,2023-11-12,701,gel pen,5,10,5,2,00209,India
867221,2023-11-12,705,stencil,10,20,10,2,00209,India
919573,2023-11-12,708,sketchpen,15,40,25,1,00106,India
495203,2023-11-12,710,geometry box,100,150,50,2,00377,India
206343,2023-11-12,714,carbon paper,15,30,15,1,00241,India
206343,2023-11-12,708,sketchpen,15,40,25,1,00241,India
206343,2023-11-12,710,geometry box,100,150,50,2,00241,India
278727,2023-11-12,714,carbon paper,15,30,15,1,00453,India
278727,2023-11-12,713,ball pen,5,10,5,2,00453,India
278727,2023-11-12,716,printing paper,200,400,200,1,00453,India
278727,2023-11-12,709,notebook,30,60,30,2,00453,India
278727,2023-11-12,706,sharpener,3,8,5,2,00453,India
197094,2023-11-12,704,scale,5,10,5,2,00493,India
358980,2023-11-12,708,sketchpen,15,40,25,1,00454,India
661407,2023-11-12,710,geometry box,100,150,50,2,00336,India
877227,2023-11-12,707,marker,20,40,20,1,00470,India
877227,2023-11-12,712,graph paper,20,40,20,1,00470,India
734294,2023-11-12,713,ball pen,5,10,5,2,00413,India
157625,2023-11-12,711,TD kit,150,300,150,1,00281,India
853869,2023-11-12,710,geometry box,100,150,50,2,00431,India
853869,2023-11-12,712,graph paper,20,40,20,1,00431,India
825873,2023-11-12,708,sketchpen,15,40,25,1,00351,India
133244,2023-11-13,716,printing paper,200,400,200,1,00354,India
133244,2023-11-13,704,scale,5,10,5,2,00354,India
771332,2023-11-13,711,TD kit,150,300,150,1,00392,India
771332,2023-11-13,709,notebook,30,60,30,2,00392,India
771332,2023-11-13,714,carbon paper,15,30,15,1,00392,India
771332,2023-11-13,702,pencil,2,5,3,2,00392,India
342816,2023-11-13,702,pencil,2,5,3,2,00085,India
768606,2023-11-13,712,graph paper,20,40,20,1,00360,India
768606,2023-11-13,709,notebook,30,60,30,2,00360,India
144841,2023-11-13,712,graph paper,20,40,20,1,00152,India
144841,2023-11-13,701,gel pen,5,10,5,2,00152,India
811892,2023-11-13,704,scale,5,10,5,2,00021,India
811892,2023-11-13,701,gel pen,5,10,5,2,00021,India
811892,2023-11-13,709,notebook,30,60,30,2,00021,India
876150,2023-11-13,710,geometry box,100,150,50,2,00218,India
876150,2023-11-13,705,stencil,10,20,10,2,00218,India
146472,2023-11-13,708,sketchpen,15,40,25,1,00340,India
146472,2023-11-13,717,spiral bound book,50,100,50,1,00340,India
308360,2023-11-13,707,marker,20,40,20,1,00343,India
308360,2023-11-13,710,geometry box,100,150,50,2,00343,India
243227,2023-11-13,708,sketchpen,15,40,25,1,00095,India
243227,2023-11-13,714,carbon paper,15,30,15,1,00095,India
243227,2023-11-13,705,stencil,10,20,10,2,00095,India
243227,2023-11-13,709,notebook,30,60,30,2,00095,India
512973,2023-11-13,710,geometry box,100,150,50,2,00028,India
770050,2023-11-13,717,spiral bound book,50,100,50,1,00298,India
770050,2023-11-13,713,ball pen,5,10,5,2,00298,India
770050,2023-11-13,712,graph paper,20,40,20,1,00298,India
770050,2023-11-13,709,notebook,30,60,30,2,00298,India
190909,2023-11-13,701,gel pen,5,10,5,2,00085,India
190909,2023-11-13,705,stencil,10,20,10,2,00085,India
190909,2023-11-13,716,printing paper,200,400,200,1,00085,India
103429,2023-11-13,708,sketchpen,15,40,25,1,00484,India
103429,2023-11-13,705,stencil,10,20,10,2,00484,India
103429,2023-11-13,709,notebook,30,60,30,2,00484,India
457364,2023-11-13,702,pencil,2,5,3,2,00402,India
457364,2023-11-13,713,ball pen,5,10,5,2,00402,India
457364,2023-11-13,707,marker,20,40,20,1,00402,India
457364,2023-11-13,714,carbon paper,15,30,15,1,00402,India
463843,2023-11-13,716,printing paper,200,400,200,1,00480,India
463843,2023-11-13,714,carbon paper,15,30,15,1,00480,India
463843,2023-11-13,711,TD kit,150,300,150,1,00480,India
463843,2023-11-13,708,sketchpen,15,40,25,1,00480,India
463843,2023-11-13,703,eraser,1,3,2,2,00480,India
242695,2023-11-13,702,pencil,2,5,3,2,00028,India
242695,2023-11-13,716,printing paper,200,400,200,1,00028,India
242695,2023-11-13,715,folder,5,15,10,1,00028,India
941089,2023-11-13,707,marker,20,40,20,1,00033,India
941089,2023-11-13,717,spiral bound book,50,100,50,1,00033,India
433924,2023-11-13,701,gel pen,5,10,5,2,00436,India
509483,2023-11-13,715,folder,5,15,10,1,00360,India
509483,2023-11-13,712,graph paper,20,40,20,1,00360,India
509483,2023-11-13,709,notebook,30,60,30,2,00360,India
572993,2023-11-13,713,ball pen,5,10,5,2,00138,India
989278,2023-11-13,715,folder,5,15,10,1,00325,India
567002,2023-11-13,703,eraser,1,3,2,2,00399,India
567002,2023-11-13,715,folder,5,15,10,1,00399,India
907502,2023-11-13,714,carbon paper,15,30,15,1,00070,India
907502,2023-11-13,716,printing paper,200,400,200,1,00070,India
907502,2023-11-13,707,marker,20,40,20,1,00070,India
971957,2023-11-13,703,eraser,1,3,2,2,00148,India
971957,2023-11-13,708,sketchpen,15,40,25,1,00148,India
971957,2023-11-13,706,sharpener,3,8,5,2,00148,India
971957,2023-11-13,702,pencil,2,5,3,2,00148,India
861771,2023-11-13,710,geometry box,100,150,50,2,00068,India
861771,2023-11-13,711,TD kit,150,300,150,1,00068,India
861771,2023-11-13,701,gel pen,5,10,5,2,00068,India
861771,2023-11-13,715,folder,5,15,10,1,00068,India
960487,2023-11-13,711,TD kit,150,300,150,1,00023,India
960487,2023-11-13,717,spiral bound book,50,100,50,1,00023,India
960487,2023-11-13,708,sketchpen,15,40,25,1,00023,India
960487,2023-11-13,705,stencil,10,20,10,2,00023,India
960487,2023-11-13,716,printing paper,200,400,200,1,00023,India
509787,2023-11-13,716,printing paper,200,400,200,1,00036,India
509787,2023-11-13,701,gel pen,5,10,5,2,00036,India
509787,2023-11-13,709,notebook,30,60,30,2,00036,India
656680,2023-11-13,703,eraser,1,3,2,2,00098,India
656680,2023-11-13,712,graph paper,20,40,20,1,00098,India
656680,2023-11-13,717,spiral bound book,50,100,50,1,00098,India
581371,2023-11-13,704,scale,5,10,5,2,00096,India
916604,2023-11-13,712,graph paper,20,40,20,1,00216,India
496184,2023-11-13,715,folder,5,15,10,1,00075,India
480112,2023-11-13,707,marker,20,40,20,1,00051,India
480112,2023-11-13,708,sketchpen,15,40,25,1,00051,India
480112,2023-11-13,715,folder,5,15,10,1,00051,India
829281,2023-11-13,703,eraser,1,3,2,2,00378,India
429033,2023-11-14,705,stencil,10,20,10,2,00256,India
429033,2023-11-14,702,pencil,2,5,3,2,00256,India
709754,2023-11-14,702,pencil,2,5,3,2,00186,India
523650,2023-11-14,702,pencil,2,5,3,2,00470,India
159664,2023-11-14,711,TD kit,150,300,150,1,00383,India
159664,2023-11-14,704,scale,5,10,5,2,00383,India
159664,2023-11-14,707,marker,20,40,20,1,00383,India
159664,2023-11-14,710,geometry box,100,150,50,2,00383,India
159664,2023-11-14,708,sketchpen,15,40,25,1,00383,India
133967,2023-11-14,716,printing paper,200,400,200,1,00413,India
960896,2023-11-14,705,stencil,10,20,10,2,00148,India
960896,2023-11-14,704,scale,5,10,5,2,00148,India
960896,2023-11-14,701,gel pen,5,10,5,2,00148,India
151262,2023-11-14,710,geometry box,100,150,50,2,00200,India
151262,2023-11-14,714,carbon paper,15,30,15,1,00200,India
151262,2023-11-14,715,folder,5,15,10,1,00200,India
151262,2023-11-14,716,printing paper,200,400,200,1,00200,India
327747,2023-11-14,710,geometry box,100,150,50,2,00302,India
976237,2023-11-14,702,pencil,2,5,3,2,00372,India
976237,2023-11-14,711,TD kit,150,300,150,1,00372,India
976237,2023-11-14,701,gel pen,5,10,5,2,00372,India
926477,2023-11-14,706,sharpener,3,8,5,2,00171,India
472604,2023-11-14,717,spiral bound book,50,100,50,1,00490,India
121953,2023-11-14,707,marker,20,40,20,1,00419,India
121953,2023-11-14,714,carbon paper,15,30,15,1,00419,India
121953,2023-11-14,703,eraser,1,3,2,2,00419,India
121953,2023-11-14,717,spiral bound book,50,100,50,1,00419,India
462176,2023-11-14,711,TD kit,150,300,150,1,00349,India
462176,2023-11-14,712,graph paper,20,40,20,1,00349,India
462176,2023-11-14,705,stencil,10,20,10,2,00349,India
462176,2023-11-14,706,sharpener,3,8,5,2,00349,India
462176,2023-11-14,715,folder,5,15,10,1,00349,India
871666,2023-11-14,709,notebook,30,60,30,2,00044,India
871666,2023-11-14,710,geometry box,100,150,50,2,00044,India
871666,2023-11-14,706,sharpener,3,8,5,2,00044,India
165036,2023-11-14,702,pencil,2,5,3,2,00208,India
165036,2023-11-14,703,eraser,1,3,2,2,00208,India
165036,2023-11-14,716,printing paper,200,400,200,1,00208,India
165036,2023-11-14,717,spiral bound book,50,100,50,1,00208,India
588941,2023-11-14,705,stencil,10,20,10,2,00405,India
588941,2023-11-14,701,gel pen,5,10,5,2,00405,India
588941,2023-11-14,704,scale,5,10,5,2,00405,India
588941,2023-11-14,710,geometry box,100,150,50,2,00405,India
625521,2023-11-14,710,geometry box,100,150,50,2,00050,India
625521,2023-11-14,717,spiral bound book,50,100,50,1,00050,India
625521,2023-11-14,716,printing paper,200,400,200,1,00050,India
625521,2023-11-14,701,gel pen,5,10,5,2,00050,India
625521,2023-11-14,713,ball pen,5,10,5,2,00050,India
247850,2023-11-14,701,gel pen,5,10,5,2,00022,India
247850,2023-11-14,708,sketchpen,15,40,25,1,00022,India
467868,2023-11-14,716,printing paper,200,400,200,1,00230,India
467868,2023-11-14,717,spiral bound book,50,100,50,1,00230,India
467868,2023-11-14,705,stencil,10,20,10,2,00230,India
727895,2023-11-14,711,TD kit,150,300,150,1,00265,India
750590,2023-11-14,714,carbon paper,15,30,15,1,00288,India
835793,2023-11-14,701,gel pen,5,10,5,2,00086,India
835793,2023-11-14,705,stencil,10,20,10,2,00086,India
835793,2023-11-14,712,graph paper,20,40,20,1,00086,India
835793,2023-11-14,704,scale,5,10,5,2,00086,India
817516,2023-11-14,701,gel pen,5,10,5,2,00119,India
817516,2023-11-14,714,carbon paper,15,30,15,1,00119,India
817516,2023-11-14,717,spiral bound book,50,100,50,1,00119,India
817516,2023-11-14,705,stencil,10,20,10,2,00119,India
371740,2023-11-14,717,spiral bound book,50,100,50,1,00454,India
903952,2023-11-14,701,gel pen,5,10,5,2,00022,India
903952,2023-11-14,714,carbon paper,15,30,15,1,00022,India
890548,2023-11-14,701,gel pen,5,10,5,2,00366,India
890548,2023-11-14,714,carbon paper,15,30,15,1,00366,India
890548,2023-11-14,704,scale,5,10,5,2,00366,India
478843,2023-11-14,711,TD kit,150,300,150,1,00135,India
478843,2023-11-14,710,geometry box,100,150,50,2,00135,India
478843,2023-11-14,707,marker,20,40,20,1,00135,India
392116,2023-11-14,704,scale,5,10,5,2,00328,India
721163,2023-11-14,714,carbon paper,15,30,15,1,00293,India
721163,2023-11-14,701,gel pen,5,10,5,2,00293,India
295318,2023-11-14,704,scale,5,10,5,2,00016,India
295318,2023-11-14,711,TD kit,150,300,150,1,00016,India
860199,2023-11-14,712,graph paper,20,40,20,1,00380,India
860199,2023-11-14,709,notebook,30,60,30,2,00380,India
860199,2023-11-14,715,folder,5,15,10,1,00380,India
860199,2023-11-14,714,carbon paper,15,30,15,1,00380,India
860199,2023-11-14,711,TD kit,150,300,150,1,00380,India
884388,2023-11-14,709,notebook,30,60,30,2,00358,India
884388,2023-11-14,705,stencil,10,20,10,2,00358,India
884388,2023-11-14,702,pencil,2,5,3,2,00358,India
884388,2023-11-14,708,sketchpen,15,40,25,1,00358,India
884388,2023-11-14,712,graph paper,20,40,20,1,00358,India
919395,2023-11-14,705,stencil,10,20,10,2,00050,India
919395,2023-11-14,710,geometry box,100,150,50,2,00050,India
919395,2023-11-14,701,gel pen,5,10,5,2,00050,India
963799,2023-11-14,701,gel pen,5,10,5,2,00107,India
963799,2023-11-14,710,geometry box,100,150,50,2,00107,India
963799,2023-11-14,707,marker,20,40,20,1,00107,India
830747,2023-11-14,702,pencil,2,5,3,2,00069,India
830747,2023-11-14,711,TD kit,150,300,150,1,00069,India
830747,2023-11-14,704,scale,5,10,5,2,00069,India
830747,2023-11-14,716,printing paper,200,400,200,1,00069,India
318119,2023-11-15,712,graph paper,20,40,20,1,00314,India
318119,2023-11-15,708,sketchpen,15,40,25,1,00314,India
318119,2023-11-15,702,pencil,2,5,3,2,00314,India
533530,2023-11-15,711,TD kit,150,300,150,1,00441,India
317529,2023-11-15,710,geometry box,100,150,50,2,00428,India
317529,2023-11-15,712,graph paper,20,40,20,1,00428,India
317529,2023-11-15,703,eraser,1,3,2,2,00428,India
480569,2023-11-15,706,sharpener,3,8,5,2,00344,India
480569,2023-11-15,708,sketchpen,15,40,25,1,00344,India
480569,2023-11-15,716,printing paper,200,400,200,1,00344,India
480569,2023-11-15,712,graph paper,20,40,20,1,00344,India
602973,2023-11-15,702,pencil,2,5,3,2,00498,India
602973,2023-11-15,716,printing paper,200,400,200,1,00498,India
602973,2023-11-15,708,sketchpen,15,40,25,1,00498,India
602973,2023-11-15,705,stencil,10,20,10,2,00498,India
602973,2023-11-15,712,graph paper,20,40,20,1,00498,India
766736,2023-11-15,703,eraser,1,3,2,2,00410,India
766736,2023-11-15,706,sharpener,3,8,5,2,00410,India
766736,2023-11-15,701,gel pen,5,10,5,2,00410,India
116892,2023-11-15,703,eraser,1,3,2,2,00185,India
116892,2023-11-15,712,graph paper,20,40,20,1,00185,India
116892,2023-11-15,707,marker,20,40,20,1,00185,India
116892,2023-11-15,716,printing paper,200,400,200,1,00185,India
485003,2023-11-15,706,sharpener,3,8,5,2,00420,India
485003,2023-11-15,717,spiral bound book,50,100,50,1,00420,India
485003,2023-11-15,715,folder,5,15,10,1,00420,India
527607,2023-11-15,714,carbon paper,15,30,15,1,00176,India
220247,2023-11-15,717,spiral bound book,50,100,50,1,00055,India
217896,2023-11-15,704,scale,5,10,5,2,00360,India
217896,2023-11-15,702,pencil,2,5,3,2,00360,India
217896,2023-11-15,707,marker,20,40,20,1,00360,India
799513,2023-11-15,716,printing paper,200,400,200,1,00467,India
799513,2023-11-15,709,notebook,30,60,30,2,00467,India
799513,2023-11-15,713,ball pen,5,10,5,2,00467,India
799513,2023-11-15,714,carbon paper,15,30,15,1,00467,India
985665,2023-11-15,704,scale,5,10,5,2,00489,India
985665,2023-11-15,712,graph paper,20,40,20,1,00489,India
985665,2023-11-15,702,pencil,2,5,3,2,00489,India
985665,2023-11-15,717,spiral bound book,50,100,50,1,00489,India
294693,2023-11-15,714,carbon paper,15,30,15,1,00222,India
294693,2023-11-15,709,notebook,30,60,30,2,00222,India
294693,2023-11-15,702,pencil,2,5,3,2,00222,India
294693,2023-11-15,701,gel pen,5,10,5,2,00222,India
711011,2023-11-15,712,graph paper,20,40,20,1,00145,India
711011,2023-11-15,702,pencil,2,5,3,2,00145,India
711011,2023-11-15,714,carbon paper,15,30,15,1,00145,India
711011,2023-11-15,701,gel pen,5,10,5,2,00145,India
711011,2023-11-15,706,sharpener,3,8,5,2,00145,India
530910,2023-11-15,716,printing paper,200,400,200,1,00467,India
116449,2023-11-15,712,graph paper,20,40,20,1,00143,India
116449,2023-11-15,701,gel pen,5,10,5,2,00143,India
116449,2023-11-15,716,printing paper,200,400,200,1,00143,India
116449,2023-11-15,711,TD kit,150,300,150,1,00143,India
116449,2023-11-15,703,eraser,1,3,2,2,00143,India
957409,2023-11-15,703,eraser,1,3,2,2,00393,India
957409,2023-11-15,706,sharpener,3,8,5,2,00393,India
957409,2023-11-15,713,ball pen,5,10,5,2,00393,India
915102,2023-11-15,711,TD kit,150,300,150,1,00244,India
613208,2023-11-15,713,ball pen,5,10,5,2,00493,India
488208,2023-11-15,714,carbon paper,15,30,15,1,00028,India
418975,2023-11-15,714,carbon paper,15,30,15,1,00047,India
418975,2023-11-15,705,stencil,10,20,10,2,00047,India
418975,2023-11-15,706,sharpener,3,8,5,2,00047,India
317127,2023-11-15,709,notebook,30,60,30,2,00369,India
317127,2023-11-15,704,scale,5,10,5,2,00369,India
317127,2023-11-15,708,sketchpen,15,40,25,1,00369,India
368432,2023-11-15,706,sharpener,3,8,5,2,00317,India
368432,2023-11-15,712,graph paper,20,40,20,1,00317,India
368432,2023-11-15,703,eraser,1,3,2,2,00317,India
368432,2023-11-15,713,ball pen,5,10,5,2,00317,India
733139,2023-11-15,710,geometry box,100,150,50,2,00172,India
733139,2023-11-15,709,notebook,30,60,30,2,00172,India
543146,2023-11-15,717,spiral bound book,50,100,50,1,00269,India
914695,2023-11-15,715,folder,5,15,10,1,00222,India
914695,2023-11-15,717,spiral bound book,50,100,50,1,00222,India
914695,2023-11-15,705,stencil,10,20,10,2,00222,India
359740,2023-11-15,717,spiral bound book,50,100,50,1,00447,India
193572,2023-11-15,704,scale,5,10,5,2,00460,India
461977,2023-11-15,716,printing paper,200,400,200,1,00481,India
754404,2023-11-15,705,stencil,10,20,10,2,00119,India
627069,2023-11-15,717,spiral bound book,50,100,50,1,00049,India
627069,2023-11-15,705,stencil,10,20,10,2,00049,India
627069,2023-11-15,711,TD kit,150,300,150,1,00049,India
627069,2023-11-15,706,sharpener,3,8,5,2,00049,India
987226,2023-11-15,710,geometry box,100,150,50,2,00445,India
987226,2023-11-15,717,spiral bound book,50,100,50,1,00445,India
987226,2023-11-15,702,pencil,2,5,3,2,00445,India
296581,2023-11-15,714,carbon paper,15,30,15,1,00332,India
296581,2023-11-15,705,stencil,10,20,10,2,00332,India
296581,2023-11-15,702,pencil,2,5,3,2,00332,India
296581,2023-11-15,704,scale,5,10,5,2,00332,India
382854,2023-11-15,701,gel pen,5,10,5,2,00381,India
382854,2023-11-15,715,folder,5,15,10,1,00381,India
699388,2023-11-15,709,notebook,30,60,30,2,00399,India
699388,2023-11-15,703,eraser,1,3,2,2,00399,India
699388,2023-11-15,706,sharpener,3,8,5,2,00399,India
699388,2023-11-15,708,sketchpen,15,40,25,1,00399,India
252217,2023-11-15,708,sketchpen,15,40,25,1,00400,India
252217,2023-11-15,716,printing paper,200,400,200,1,00400,India
252217,2023-11-15,706,sharpener,3,8,5,2,00400,India
252217,2023-11-15,717,spiral bound book,50,100,50,1,00400,India
311323,2023-11-15,708,sketchpen,15,40,25,1,00251,India
311323,2023-11-15,709,notebook,30,60,30,2,00251,India
218837,2023-11-15,715,folder,5,15,10,1,00002,India
218837,2023-11-15,705,stencil,10,20,10,2,00002,India
265678,2023-11-15,705,stencil,10,20,10,2,00292,India
265678,2023-11-15,702,pencil,2,5,3,2,00292,India
265678,2023-11-15,706,sharpener,3,8,5,2,00292,India
799008,2023-11-16,712,graph paper,20,40,20,1,00458,India
799008,2023-11-16,704,scale,5,10,5,2,00458,India
989748,2023-11-16,705,stencil,10,20,10,2,00231,India
989748,2023-11-16,711,TD kit,150,300,150,1,00231,India
989748,2023-11-16,706,sharpener,3,8,5,2,00231,India
989748,2023-11-16,717,spiral bound book,50,100,50,1,00231,India
146069,2023-11-16,709,notebook,30,60,30,2,00366,India
146069,2023-11-16,710,geometry box,100,150,50,2,00366,India
146069,2023-11-16,713,ball pen,5,10,5,2,00366,India
146069,2023-11-16,701,gel pen,5,10,5,2,00366,India
404041,2023-11-16,709,notebook,30,60,30,2,00340,India
404041,2023-11-16,717,spiral bound book,50,100,50,1,00340,India
404041,2023-11-16,705,stencil,10,20,10,2,00340,India
634926,2023-11-16,712,graph paper,20,40,20,1,00349,India
634926,2023-11-16,715,folder,5,15,10,1,00349,India
634926,2023-11-16,709,notebook,30,60,30,2,00349,India
918763,2023-11-16,704,scale,5,10,5,2,00039,India
505809,2023-11-16,708,sketchpen,15,40,25,1,00081,India
505809,2023-11-16,710,geometry box,100,150,50,2,00081,India
505809,2023-11-16,704,scale,5,10,5,2,00081,India
176334,2023-11-16,715,folder,5,15,10,1,00111,India
176334,2023-11-16,711,TD kit,150,300,150,1,00111,India
176334,2023-11-16,710,geometry box,100,150,50,2,00111,India
176334,2023-11-16,709,notebook,30,60,30,2,00111,India
957882,2023-11-16,701,gel pen,5,10,5,2,00331,India
957882,2023-11-16,708,sketchpen,15,40,25,1,00331,India
957882,2023-11-16,702,pencil,2,5,3,2,00331,India
478015,2023-11-16,705,stencil,10,20,10,2,00050,India
478015,2023-11-16,715,folder,5,15,10,1,00050,India
509793,2023-11-16,708,sketchpen,15,40,25,1,00042,India
509793,2023-11-16,714,carbon paper,15,30,15,1,00042,India
509793,2023-11-16,703,eraser,1,3,2,2,00042,India
509793,2023-11-16,715,folder,5,15,10,1,00042,India
680811,2023-11-16,702,pencil,2,5,3,2,00446,India
680811,2023-11-16,710,geometry box,100,150,50,2,00446,India
680811,2023-11-16,717,spiral bound book,50,100,50,1,00446,India
504878,2023-11-16,708,sketchpen,15,40,25,1,00341,India
504878,2023-11-16,713,ball pen,5,10,5,2,00341,India
187053,2023-11-16,711,TD kit,150,300,150,1,00223,India
187053,2023-11-16,709,notebook,30,60,30,2,00223,India
187053,2023-11-16,707,marker,20,40,20,1,00223,India
192907,2023-11-16,708,sketchpen,15,40,25,1,00026,India
256521,2023-11-16,701,gel pen,5,10,5,2,00464,India
129950,2023-11-16,710,geometry box,100,150,50,2,00304,India
129950,2023-11-16,712,graph paper,20,40,20,1,00304,India
249453,2023-11-16,716,printing paper,200,400,200,1,00247,India
665057,2023-11-16,710,geometry box,100,150,50,2,00423,India
665057,2023-11-16,717,spiral bound book,50,100,50,1,00423,India
371085,2023-11-16,703,eraser,1,3,2,2,00326,India
123329,2023-11-16,717,spiral bound book,50,100,50,1,00138,India
123329,2023-11-16,706,sharpener,3,8,5,2,00138,India
123329,2023-11-16,705,stencil,10,20,10,2,00138,India
670852,2023-11-16,709,notebook,30,60,30,2,00127,India
670852,2023-11-16,704,scale,5,10,5,2,00127,India
982357,2023-11-16,706,sharpener,3,8,5,2,00082,India
982357,2023-11-16,709,notebook,30,60,30,2,00082,India
365611,2023-11-16,702,pencil,2,5,3,2,00317,India
365611,2023-11-16,707,marker,20,40,20,1,00317,India
365611,2023-11-16,710,geometry box,100,150,50,2,00317,India
365611,2023-11-16,708,sketchpen,15,40,25,1,00317,India
497889,2023-11-16,704,scale,5,10,5,2,00361,India
556714,2023-11-16,711,TD kit,150,300,150,1,00193,India
556714,2023-11-16,702,pencil,2,5,3,2,00193,India
556714,2023-11-16,713,ball pen,5,10,5,2,00193,India
268896,2023-11-16,705,stencil,10,20,10,2,00178,India
268896,2023-11-16,708,sketchpen,15,40,25,1,00178,India
268896,2023-11-16,709,notebook,30,60,30,2,00178,India
268896,2023-11-16,716,printing paper,200,400,200,1,00178,India
268896,2023-11-16,701,gel pen,5,10,5,2,00178,India
156712,2023-11-16,702,pencil,2,5,3,2,00325,India
156712,2023-11-16,704,scale,5,10,5,2,00325,India
428265,2023-11-16,703,eraser,1,3,2,2,00447,India
428265,2023-11-16,714,carbon paper,15,30,15,1,00447,India
428265,2023-11-16,701,gel pen,5,10,5,2,00447,India
428265,2023-11-16,713,ball pen,5,10,5,2,00447,India
591083,2023-11-16,706,sharpener,3,8,5,2,00080,India
591083,2023-11-16,713,ball pen,5,10,5,2,00080,India
591083,2023-11-16,709,notebook,30,60,30,2,00080,India
591083,2023-11-16,710,geometry box,100,150,50,2,00080,India
710392,2023-11-16,702,pencil,2,5,3,2,00117,India
710392,2023-11-16,706,sharpener,3,8,5,2,00117,India
710392,2023-11-16,713,ball pen,5,10,5,2,00117,India
710392,2023-11-16,711,TD kit,150,300,150,1,00117,India
461080,2023-11-16,702,pencil,2,5,3,2,00110,India
461080,2023-11-16,709,notebook,30,60,30,2,00110,India
461080,2023-11-16,716,printing paper,200,400,200,1,00110,India
593165,2023-11-16,716,printing paper,200,400,200,1,00167,India
593165,2023-11-16,710,geometry box,100,150,50,2,00167,India
593165,2023-11-16,706,sharpener,3,8,5,2,00167,India
834822,2023-11-16,708,sketchpen,15,40,25,1,00067,India
834822,2023-11-16,714,carbon paper,15,30,15,1,00067,India
791660,2023-11-16,704,scale,5,10,5,2,00144,India
791660,2023-11-16,701,gel pen,5,10,5,2,00144,India
256983,2023-11-16,716,printing paper,200,400,200,1,00217,India
256983,2023-11-16,703,eraser,1,3,2,2,00217,India
256983,2023-11-16,705,stencil,10,20,10,2,00217,India
256983,2023-11-16,707,marker,20,40,20,1,00217,India
913094,2023-11-16,702,pencil,2,5,3,2,00315,India
913094,2023-11-16,710,geometry box,100,150,50,2,00315,India
648354,2023-11-16,706,sharpener,3,8,5,2,00258,India
648354,2023-11-16,711,TD kit,150,300,150,1,00258,India
648354,2023-11-16,705,stencil,10,20,10,2,00258,India
648354,2023-11-16,710,geometry box,100,150,50,2,00258,India
720147,2023-11-16,706,sharpener,3,8,5,2,00069,India
720147,2023-11-16,713,ball pen,5,10,5,2,00069,India
491143,2023-11-16,705,stencil,10,20,10,2,00309,India
491143,2023-11-16,707,marker,20,40,20,1,00309,India
975562,2023-11-16,705,stencil,10,20,10,2,00162,India
975562,2023-11-16,709,notebook,30,60,30,2,00162,India
204702,2023-11-16,712,graph paper,20,40,20,1,00468,India
923748,2023-11-16,711,TD kit,150,300,150,1,00135,India
923748,2023-11-16,716,printing paper,200,400,200,1,00135,India
923748,2023-11-16,709,notebook,30,60,30,2,00135,India
971808,2023-11-17,709,notebook,30,60,30,2,00392,India
971808,2023-11-17,705,stencil,10,20,10,2,00392,India
971808,2023-11-17,712,graph paper,20,40,20,1,00392,India
224556,2023-11-17,708,sketchpen,15,40,25,1,00196,India
224556,2023-11-17,703,eraser,1,3,2,2,00196,India
224556,2023-11-17,705,stencil,10,20,10,2,00196,India
224556,2023-11-17,712,graph paper,20,40,20,1,00196,India
109052,2023-11-17,709,notebook,30,60,30,2,00019,India
109052,2023-11-17,712,graph paper,20,40,20,1,00019,India
109052,2023-11-17,704,scale,5,10,5,2,00019,India
109052,2023-11-17,708,sketchpen,15,40,25,1,00019,India
105637,2023-11-17,703,eraser,1,3,2,2,00276,India
105637,2023-11-17,712,graph paper,20,40,20,1,00276,India
105637,2023-11-17,705,stencil,10,20,10,2,00276,India
105637,2023-11-17,711,TD kit,150,300,150,1,00276,India
370944,2023-11-17,708,sketchpen,15,40,25,1,00352,India
370944,2023-11-17,701,gel pen,5,10,5,2,00352,India
336927,2023-11-17,710,geometry box,100,150,50,2,00066,India
336927,2023-11-17,717,spiral bound book,50,100,50,1,00066,India
336927,2023-11-17,715,folder,5,15,10,1,00066,India
801418,2023-11-17,715,folder,5,15,10,1,00186,India
679800,2023-11-17,708,sketchpen,15,40,25,1,00285,India
679800,2023-11-17,703,eraser,1,3,2,2,00285,India
222106,2023-11-17,711,TD kit,150,300,150,1,00227,India
222106,2023-11-17,717,spiral bound book,50,100,50,1,00227,India
222106,2023-11-17,703,eraser,1,3,2,2,00227,India
222106,2023-11-17,705,stencil,10,20,10,2,00227,India
222106,2023-11-17,710,geometry box,100,150,50,2,00227,India
870024,2023-11-17,717,spiral bound book,50,100,50,1,00322,India
870024,2023-11-17,704,scale,5,10,5,2,00322,India
141565,2023-11-17,707,marker,20,40,20,1,00218,India
141565,2023-11-17,717,spiral bound book,50,100,50,1,00218,India
141565,2023-11-17,715,folder,5,15,10,1,00218,India
141565,2023-11-17,712,graph paper,20,40,20,1,00218,India
724941,2023-11-17,703,eraser,1,3,2,2,00171,India
211617,2023-11-17,711,TD kit,150,300,150,1,00045,India
211617,2023-11-17,716,printing paper,200,400,200,1,00045,India
211617,2023-11-17,707,marker,20,40,20,1,00045,India
674492,2023-11-17,713,ball pen,5,10,5,2,00236,India
674492,2023-11-17,715,folder,5,15,10,1,00236,India
674492,2023-11-17,717,spiral bound book,50,100,50,1,00236,India
754868,2023-11-17,716,printing paper,200,400,200,1,00189,India
754868,2023-11-17,703,eraser,1,3,2,2,00189,India
373801,2023-11-17,703,eraser,1,3,2,2,00339,India
373801,2023-11-17,708,sketchpen,15,40,25,1,00339,India
703405,2023-11-17,717,spiral bound book,50,100,50,1,00355,India
703405,2023-11-17,706,sharpener,3,8,5,2,00355,India
703405,2023-11-17,703,eraser,1,3,2,2,00355,India
703405,2023-11-17,705,stencil,10,20,10,2,00355,India
703405,2023-11-17,714,carbon paper,15,30,15,1,00355,India
580763,2023-11-17,707,marker,20,40,20,1,00134,India
580763,2023-11-17,704,scale,5,10,5,2,00134,India
580763,2023-11-17,702,pencil,2,5,3,2,00134,India
580763,2023-11-17,708,sketchpen,15,40,25,1,00134,India
580763,2023-11-17,710,geometry box,100,150,50,2,00134,India
366598,2023-11-17,714,carbon paper,15,30,15,1,00066,India
366598,2023-11-17,704,scale,5,10,5,2,00066,India
921972,2023-11-17,701,gel pen,5,10,5,2,00467,India
921972,2023-11-17,706,sharpener,3,8,5,2,00467,India
921972,2023-11-17,707,marker,20,40,20,1,00467,India
176076,2023-11-17,701,gel pen,5,10,5,2,00456,India
176076,2023-11-17,709,notebook,30,60,30,2,00456,India
176076,2023-11-17,711,TD kit,150,300,150,1,00456,India
155376,2023-11-17,711,TD kit,150,300,150,1,00219,India
212076,2023-11-17,706,sharpener,3,8,5,2,00493,India
212076,2023-11-17,705,stencil,10,20,10,2,00493,India
886783,2023-11-17,715,folder,5,15,10,1,00481,India
886783,2023-11-17,708,sketchpen,15,40,25,1,00481,India
155562,2023-11-17,708,sketchpen,15,40,25,1,00164,India
155562,2023-11-17,715,folder,5,15,10,1,00164,India
155562,2023-11-17,703,eraser,1,3,2,2,00164,India
737273,2023-11-17,706,sharpener,3,8,5,2,00109,India
737273,2023-11-17,707,marker,20,40,20,1,00109,India
737273,2023-11-17,713,ball pen,5,10,5,2,00109,India
853626,2023-11-17,703,eraser,1,3,2,2,00424,India
211072,2023-11-17,716,printing paper,200,400,200,1,00479,India
211072,2023-11-17,715,folder,5,15,10,1,00479,India
211072,2023-11-17,714,carbon paper,15,30,15,1,00479,India
211072,2023-11-17,706,sharpener,3,8,5,2,00479,India
870424,2023-11-17,703,eraser,1,3,2,2,00164,India
870424,2023-11-17,704,scale,5,10,5,2,00164,India
870424,2023-11-17,709,notebook,30,60,30,2,00164,India
870424,2023-11-17,711,TD kit,150,300,150,1,00164,India
870424,2023-11-17,701,gel pen,5,10,5,2,00164,India
622062,2023-11-17,707,marker,20,40,20,1,00474,India
296641,2023-11-17,711,TD kit,150,300,150,1,00084,India
296641,2023-11-17,705,stencil,10,20,10,2,00084,India
296641,2023-11-17,702,pencil,2,5,3,2,00084,India
989308,2023-11-17,713,ball pen,5,10,5,2,00396,India
989308,2023-11-17,709,notebook,30,60,30,2,00396,India
795252,2023-11-17,703,eraser,1,3,2,2,00412,India
954578,2023-11-17,715,folder,5,15,10,1,00070,India
147356,2023-11-17,716,printing paper,200,400,200,1,00234,India
147356,2023-11-17,701,gel pen,5,10,5,2,00234,India
147356,2023-11-17,705,stencil,10,20,10,2,00234,India
578177,2023-11-17,702,pencil,2,5,3,2,00422,India
578177,2023-11-17,708,sketchpen,15,40,25,1,00422,India
578177,2023-11-17,711,TD kit,150,300,150,1,00422,India
578177,2023-11-17,706,sharpener,3,8,5,2,00422,India
296977,2023-11-17,714,carbon paper,15,30,15,1,00038,India
296977,2023-11-17,716,printing paper,200,400,200,1,00038,India
296977,2023-11-17,702,pencil,2,5,3,2,00038,India
777126,2023-11-17,703,eraser,1,3,2,2,00277,India
777126,2023-11-17,717,spiral bound book,50,100,50,1,00277,India
777126,2023-11-17,710,geometry box,100,150,50,2,00277,India
777126,2023-11-17,711,TD kit,150,300,150,1,00277,India
561779,2023-11-17,716,printing paper,200,400,200,1,00249,India
561779,2023-11-17,711,TD kit,150,300,150,1,00249,India
561779,2023-11-17,713,ball pen,5,10,5,2,00249,India
258322,2023-11-17,705,stencil,10,20,10,2,00215,India
258322,2023-11-17,704,scale,5,10,5,2,00215,India
258322,2023-11-17,703,eraser,1,3,2,2,00215,India
258322,2023-11-17,712,graph paper,20,40,20,1,00215,India
816729,2023-11-17,706,sharpener,3,8,5,2,00273,India
816729,2023-11-17,707,marker,20,40,20,1,00273,India
816729,2023-11-17,708,sketchpen,15,40,25,1,00273,India
816729,2023-11-17,712,graph paper,20,40,20,1,00273,India
816729,2023-11-17,701,gel pen,5,10,5,2,00273,India
371545,2023-11-17,717,spiral bound book,50,100,50,1,00345,India
371545,2023-11-17,707,marker,20,40,20,1,00345,India
371545,2023-11-17,708,sketchpen,15,40,25,1,00345,India
371545,2023-11-17,711,TD kit,150,300,150,1,00345,India
190251,2023-11-18,704,scale,5,10,5,2,00496,India
190251,2023-11-18,706,sharpener,3,8,5,2,00496,India
809613,2023-11-18,702,pencil,2,5,3,2,00467,India
203819,2023-11-18,708,sketchpen,15,40,25,1,00233,India
203819,2023-11-18,706,sharpener,3,8,5,2,00233,India
341504,2023-11-18,715,folder,5,15,10,1,00191,India
231566,2023-11-18,701,gel pen,5,10,5,2,00417,India
114716,2023-11-18,712,graph paper,20,40,20,1,00077,India
114716,2023-11-18,710,geometry box,100,150,50,2,00077,India
114716,2023-11-18,714,carbon paper,15,30,15,1,00077,India
849763,2023-11-18,707,marker,20,40,20,1,00095,India
849763,2023-11-18,703,eraser,1,3,2,2,00095,India
281780,2023-11-18,708,sketchpen,15,40,25,1,00170,India
281780,2023-11-18,706,sharpener,3,8,5,2,00170,India
281780,2023-11-18,712,graph paper,20,40,20,1,00170,India
636801,2023-11-18,712,graph paper,20,40,20,1,00262,India
636801,2023-11-18,716,printing paper,200,400,200,1,00262,India
636801,2023-11-18,706,sharpener,3,8,5,2,00262,India
636801,2023-11-18,707,marker,20,40,20,1,00262,India
636801,2023-11-18,708,sketchpen,15,40,25,1,00262,India
479243,2023-11-18,716,printing paper,200,400,200,1,00336,India
479243,2023-11-18,709,notebook,30,60,30,2,00336,India
479243,2023-11-18,713,ball pen,5,10,5,2,00336,India
479243,2023-11-18,710,geometry box,100,150,50,2,00336,India
643790,2023-11-18,712,graph paper,20,40,20,1,00009,India
643790,2023-11-18,714,carbon paper,15,30,15,1,00009,India
643790,2023-11-18,717,spiral bound book,50,100,50,1,00009,India
643790,2023-11-18,711,TD kit,150,300,150,1,00009,India
553957,2023-11-18,711,TD kit,150,300,150,1,00031,India
553957,2023-11-18,712,graph paper,20,40,20,1,00031,India
553957,2023-11-18,708,sketchpen,15,40,25,1,00031,India
325337,2023-11-18,703,eraser,1,3,2,2,00053,India
325337,2023-11-18,711,TD kit,150,300,150,1,00053,India
325337,2023-11-18,704,scale,5,10,5,2,00053,India
325337,2023-11-18,713,ball pen,5,10,5,2,00053,India
990076,2023-11-18,714,carbon paper,15,30,15,1,00007,India
990076,2023-11-18,717,spiral bound book,50,100,50,1,00007,India
285282,2023-11-18,715,folder,5,15,10,1,00047,India
936361,2023-11-18,701,gel pen,5,10,5,2,00158,India
936361,2023-11-18,713,ball pen,5,10,5,2,00158,India
936361,2023-11-18,705,stencil,10,20,10,2,00158,India
631677,2023-11-18,715,folder,5,15,10,1,00182,India
631677,2023-11-18,714,carbon paper,15,30,15,1,00182,India
631677,2023-11-18,701,gel pen,5,10,5,2,00182,India
631677,2023-11-18,707,marker,20,40,20,1,00182,India
631677,2023-11-18,712,graph paper,20,40,20,1,00182,India
644409,2023-11-18,705,stencil,10,20,10,2,00321,India
644409,2023-11-18,702,pencil,2,5,3,2,00321,India
644409,2023-11-18,709,notebook,30,60,30,2,00321,India
644409,2023-11-18,716,printing paper,200,400,200,1,00321,India
644409,2023-11-18,717,spiral bound book,50,100,50,1,00321,India
870266,2023-11-18,705,stencil,10,20,10,2,00475,India
870266,2023-11-18,706,sharpener,3,8,5,2,00475,India
870266,2023-11-18,701,gel pen,5,10,5,2,00475,India
409436,2023-11-18,703,eraser,1,3,2,2,00071,India
409436,2023-11-18,701,gel pen,5,10,5,2,00071,India
409436,2023-11-18,705,stencil,10,20,10,2,00071,India
644489,2023-11-18,709,notebook,30,60,30,2,00052,India
644489,2023-11-18,716,printing paper,200,400,200,1,00052,India
644489,2023-11-18,714,carbon paper,15,30,15,1,00052,India
644489,2023-11-18,712,graph paper,20,40,20,1,00052,India
937630,2023-11-18,706,sharpener,3,8,5,2,00260,India
937630,2023-11-18,713,ball pen,5,10,5,2,00260,India
937630,2023-11-18,705,stencil,10,20,10,2,00260,India
272565,2023-11-18,707,marker,20,40,20,1,00066,India
272565,2023-11-18,703,eraser,1,3,2,2,00066,India
272565,2023-11-18,712,graph paper,20,40,20,1,00066,India
402564,2023-11-18,715,folder,5,15,10,1,00145,India
642858,2023-11-18,708,sketchpen,15,40,25,1,00392,India
159384,2023-11-18,703,eraser,1,3,2,2,00413,India
159384,2023-11-18,710,geometry box,100,150,50,2,00413,India
159384,2023-11-18,706,sharpener,3,8,5,2,00413,India
514016,2023-11-18,710,geometry box,100,150,50,2,00039,India
514016,2023-11-18,707,marker,20,40,20,1,00039,India
514016,2023-11-18,705,stencil,10,20,10,2,00039,India
445339,2023-11-18,705,stencil,10,20,10,2,00234,India
445339,2023-11-18,709,notebook,30,60,30,2,00234,India
445339,2023-11-18,710,geometry box,100,150,50,2,00234,India
275044,2023-11-18,713,ball pen,5,10,5,2,00154,India
275044,2023-11-18,706,sharpener,3,8,5,2,00154,India
750419,2023-11-18,701,gel pen,5,10,5,2,00491,India
750419,2023-11-18,709,notebook,30,60,30,2,00491,India
952736,2023-11-18,701,gel pen,5,10,5,2,00361,India
952736,2023-11-18,717,spiral bound book,50,100,50,1,00361,India
957523,2023-11-18,703,eraser,1,3,2,2,00001,India
957523,2023-11-18,716,printing paper,200,400,200,1,00001,India
555866,2023-11-18,716,printing paper,200,400,200,1,00161,India
555866,2023-11-18,713,ball pen,5,10,5,2,00161,India
555866,2023-11-18,711,TD kit,150,300,150,1,00161,India
847407,2023-11-18,710,geometry box,100,150,50,2,00284,India
847407,2023-11-18,707,marker,20,40,20,1,00284,India
847407,2023-11-18,703,eraser,1,3,2,2,00284,India
847407,2023-11-18,713,ball pen,5,10,5,2,00284,India
972455,2023-11-18,715,folder,5,15,10,1,00206,India
972455,2023-11-18,703,eraser,1,3,2,2,00206,India
972455,2023-11-18,707,marker,20,40,20,1,00206,India
972455,2023-11-18,702,pencil,2,5,3,2,00206,India
761290,2023-11-18,710,geometry box,100,150,50,2,00269,India
761290,2023-11-18,715,folder,5,15,10,1,00269,India
761290,2023-11-18,707,marker,20,40,20,1,00269,India
761290,2023-11-18,709,notebook,30,60,30,2,00269,India
761290,2023-11-18,706,sharpener,3,8,5,2,00269,India
616487,2023-11-18,707,marker,20,40,20,1,00237,India
616487,2023-11-18,702,pencil,2,5,3,2,00237,India
616487,2023-11-18,716,printing paper,200,400,200,1,00237,India
616487,2023-11-18,710,geometry box,100,150,50,2,00237,India
275443,2023-11-18,704,scale,5,10,5,2,00384,India
275443,2023-11-18,713,ball pen,5,10,5,2,00384,India
346908,2023-11-18,703,eraser,1,3,2,2,00076,India
346908,2023-11-18,714,carbon paper,15,30,15,1,00076,India
346908,2023-11-18,713,ball pen,5,10,5,2,00076,India
796861,2023-11-18,715,folder,5,15,10,1,00290,India
796861,2023-11-18,711,TD kit,150,300,150,1,00290,India
796861,2023-11-18,716,printing paper,200,400,200,1,00290,India
796861,2023-11-18,703,eraser,1,3,2,2,00290,India
653698,2023-11-18,709,notebook,30,60,30,2,00101,India
653698,2023-11-18,710,geometry box,100,150,50,2,00101,India
100191,2023-11-18,714,carbon paper,15,30,15,1,00028,India
100191,2023-11-18,710,geometry box,100,150,50,2,00028,India
100191,2023-11-18,711,TD kit,150,300,150,1,00028,India
775943,2023-11-18,706,sharpener,3,8,5,2,00380,India
775943,2023-11-18,714,carbon paper,15,30,15,1,00380,India
775943,2023-11-18,708,sketchpen,15,40,25,1,00380,India
775943,2023-11-18,717,spiral bound book,50,100,50,1,00380,India
775943,2023-11-18,704,scale,5,10,5,2,00380,India
232041,2023-11-18,703,eraser,1,3,2,2,00185,India
232041,2023-11-18,712,graph paper,20,40,20,1,00185,India
356207,2023-11-19,710,geometry box,100,150,50,2,00035,India
356207,2023-11-19,713,ball pen,5,10,5,2,00035,India
356207,2023-11-19,707,marker,20,40,20,1,00035,India
356207,2023-11-19,714,carbon paper,15,30,15,1,00035,India
594364,2023-11-19,708,sketchpen,15,40,25,1,00357,India
871015,2023-11-19,703,eraser,1,3,2,2,00413,India
871015,2023-11-19,702,pencil,2,5,3,2,00413,India
871015,2023-11-19,706,sharpener,3,8,5,2,00413,India
871015,2023-11-19,707,marker,20,40,20,1,00413,India
434922,2023-11-19,713,ball pen,5,10,5,2,00408,India
434922,2023-11-19,714,carbon paper,15,30,15,1,00408,India
434922,2023-11-19,711,TD kit,150,300,150,1,00408,India
130153,2023-11-19,703,eraser,1,3,2,2,00309,India
998722,2023-11-19,703,eraser,1,3,2,2,00176,India
998722,2023-11-19,712,graph paper,20,40,20,1,00176,India
998722,2023-11-19,713,ball pen,5,10,5,2,00176,India
439696,2023-11-19,706,sharpener,3,8,5,2,00329,India
439696,2023-11-19,705,stencil,10,20,10,2,00329,India
439696,2023-11-19,704,scale,5,10,5,2,00329,India
825063,2023-11-19,716,printing paper,200,400,200,1,00360,India
825063,2023-11-19,707,marker,20,40,20,1,00360,India
546961,2023-11-19,716,printing paper,200,400,200,1,00005,India
546961,2023-11-19,708,sketchpen,15,40,25,1,00005,India
546961,2023-11-19,713,ball pen,5,10,5,2,00005,India
546961,2023-11-19,701,gel pen,5,10,5,2,00005,India
546961,2023-11-19,702,pencil,2,5,3,2,00005,India
524961,2023-11-19,712,graph paper,20,40,20,1,00054,India
524961,2023-11-19,702,pencil,2,5,3,2,00054,India
524961,2023-11-19,707,marker,20,40,20,1,00054,India
524961,2023-11-19,717,spiral bound book,50,100,50,1,00054,India
627112,2023-11-19,712,graph paper,20,40,20,1,00007,India
627112,2023-11-19,701,gel pen,5,10,5,2,00007,India
627112,2023-11-19,702,pencil,2,5,3,2,00007,India
486174,2023-11-19,705,stencil,10,20,10,2,00283,India
486174,2023-11-19,712,graph paper,20,40,20,1,00283,India
486174,2023-11-19,702,pencil,2,5,3,2,00283,India
486174,2023-11-19,701,gel pen,5,10,5,2,00283,India
973637,2023-11-19,714,carbon paper,15,30,15,1,00287,India
973637,2023-11-19,708,sketchpen,15,40,25,1,00287,India
973637,2023-11-19,717,spiral bound book,50,100,50,1,00287,India
973637,2023-11-19,704,scale,5,10,5,2,00287,India
159763,2023-11-19,704,scale,5,10,5,2,00223,India
159763,2023-11-19,711,TD kit,150,300,150,1,00223,India
159763,2023-11-19,706,sharpener,3,8,5,2,00223,India
159763,2023-11-19,717,spiral bound book,50,100,50,1,00223,India
902670,2023-11-19,706,sharpener,3,8,5,2,00411,India
902670,2023-11-19,714,carbon paper,15,30,15,1,00411,India
844693,2023-11-19,714,carbon paper,15,30,15,1,00432,India
352409,2023-11-19,707,marker,20,40,20,1,00179,India
523481,2023-11-19,701,gel pen,5,10,5,2,00294,India
523481,2023-11-19,713,ball pen,5,10,5,2,00294,India
523481,2023-11-19,706,sharpener,3,8,5,2,00294,India
928346,2023-11-19,712,graph paper,20,40,20,1,00047,India
665882,2023-11-19,703,eraser,1,3,2,2,00111,India
665882,2023-11-19,713,ball pen,5,10,5,2,00111,India
880987,2023-11-19,703,eraser,1,3,2,2,00085,India
880987,2023-11-19,716,printing paper,200,400,200,1,00085,India
880987,2023-11-19,706,sharpener,3,8,5,2,00085,India
880987,2023-11-19,707,marker,20,40,20,1,00085,India
278481,2023-11-19,710,geometry box,100,150,50,2,00437,India
278481,2023-11-19,706,sharpener,3,8,5,2,00437,India
278481,2023-11-19,714,carbon paper,15,30,15,1,00437,India
190730,2023-11-19,705,stencil,10,20,10,2,00152,India
190730,2023-11-19,701,gel pen,5,10,5,2,00152,India
190730,2023-11-19,702,pencil,2,5,3,2,00152,India
703434,2023-11-19,703,eraser,1,3,2,2,00243,India
703434,2023-11-19,710,geometry box,100,150,50,2,00243,India
703434,2023-11-19,717,spiral bound book,50,100,50,1,00243,India
196021,2023-11-19,704,scale,5,10,5,2,00383,India
196021,2023-11-19,713,ball pen,5,10,5,2,00383,India
196021,2023-11-19,715,folder,5,15,10,1,00383,India
704059,2023-11-19,711,TD kit,150,300,150,1,00439,India
471313,2023-11-19,703,eraser,1,3,2,2,00189,India
471313,2023-11-19,717,spiral bound book,50,100,50,1,00189,India
471313,2023-11-19,706,sharpener,3,8,5,2,00189,India
430907,2023-11-19,712,graph paper,20,40,20,1,00258,India
430907,2023-11-19,704,scale,5,10,5,2,00258,India
430907,2023-11-19,710,geometry box,100,150,50,2,00258,India
402447,2023-11-19,711,TD kit,150,300,150,1,00130,India
402447,2023-11-19,709,notebook,30,60,30,2,00130,India
402447,2023-11-19,707,marker,20,40,20,1,00130,India
870947,2023-11-19,706,sharpener,3,8,5,2,00339,India
870947,2023-11-19,716,printing paper,200,400,200,1,00339,India
870947,2023-11-19,704,scale,5,10,5,2,00339,India
519845,2023-11-19,709,notebook,30,60,30,2,00107,India
689594,2023-11-20,708,sketchpen,15,40,25,1,00165,India
689594,2023-11-20,713,ball pen,5,10,5,2,00165,India
689594,2023-11-20,714,carbon paper,15,30,15,1,00165,India
625488,2023-11-20,715,folder,5,15,10,1,00171,India
820921,2023-11-20,702,pencil,2,5,3,2,00149,India
820921,2023-11-20,708,sketchpen,15,40,25,1,00149,India
820921,2023-11-20,714,carbon paper,15,30,15,1,00149,India
966557,2023-11-20,706,sharpener,3,8,5,2,00443,India
966557,2023-11-20,717,spiral bound book,50,100,50,1,00443,India
966557,2023-11-20,707,marker,20,40,20,1,00443,India
966557,2023-11-20,704,scale,5,10,5,2,00443,India
596386,2023-11-20,716,printing paper,200,400,200,1,00315,India
451445,2023-11-20,709,notebook,30,60,30,2,00318,India
451445,2023-11-20,701,gel pen,5,10,5,2,00318,India
451445,2023-11-20,705,stencil,10,20,10,2,00318,India
775470,2023-11-20,707,marker,20,40,20,1,00128,India
775470,2023-11-20,708,sketchpen,15,40,25,1,00128,India
775470,2023-11-20,713,ball pen,5,10,5,2,00128,India
414470,2023-11-20,707,marker,20,40,20,1,00267,India
414470,2023-11-20,709,notebook,30,60,30,2,00267,India
414470,2023-11-20,713,ball pen,5,10,5,2,00267,India
741051,2023-11-20,704,scale,5,10,5,2,00412,India
688406,2023-11-20,713,ball pen,5,10,5,2,00074,India
547572,2023-11-20,705,stencil,10,20,10,2,00151,India
547572,2023-11-20,701,gel pen,5,10,5,2,00151,India
377918,2023-11-20,706,sharpener,3,8,5,2,00486,India
377918,2023-11-20,702,pencil,2,5,3,2,00486,India
227968,2023-11-20,708,sketchpen,15,40,25,1,00384,India
227968,2023-11-20,707,marker,20,40,20,1,00384,India
227968,2023-11-20,710,geometry box,100,150,50,2,00384,India
151117,2023-11-20,706,sharpener,3,8,5,2,00321,India
151117,2023-11-20,704,scale,5,10,5,2,00321,India
429271,2023-11-20,713,ball pen,5,10,5,2,00139,India
575570,2023-11-20,707,marker,20,40,20,1,00458,India
575570,2023-11-20,717,spiral bound book,50,100,50,1,00458,India
298529,2023-11-20,710,geometry box,100,150,50,2,00067,India
298529,2023-11-20,705,stencil,10,20,10,2,00067,India
298529,2023-11-20,709,notebook,30,60,30,2,00067,India
298529,2023-11-20,706,sharpener,3,8,5,2,00067,India
839809,2023-11-20,703,eraser,1,3,2,2,00397,India
839809,2023-11-20,713,ball pen,5,10,5,2,00397,India
610760,2023-11-20,702,pencil,2,5,3,2,00441,India
610760,2023-11-20,709,notebook,30,60,30,2,00441,India
443435,2023-11-20,713,ball pen,5,10,5,2,00481,India
443435,2023-11-20,704,scale,5,10,5,2,00481,India
443435,2023-11-20,703,eraser,1,3,2,2,00481,India
540803,2023-11-20,702,pencil,2,5,3,2,00295,India
540803,2023-11-20,713,ball pen,5,10,5,2,00295,India
540803,2023-11-20,711,TD kit,150,300,150,1,00295,India
540803,2023-11-20,716,printing paper,200,400,200,1,00295,India
560934,2023-11-20,708,sketchpen,15,40,25,1,00075,India
560934,2023-11-20,707,marker,20,40,20,1,00075,India
560934,2023-11-20,706,sharpener,3,8,5,2,00075,India
467918,2023-11-20,713,ball pen,5,10,5,2,00240,India
467918,2023-11-20,714,carbon paper,15,30,15,1,00240,India
467918,2023-11-20,701,gel pen,5,10,5,2,00240,India
467918,2023-11-20,712,graph paper,20,40,20,1,00240,India
729516,2023-11-20,709,notebook,30,60,30,2,00155,India
729516,2023-11-20,714,carbon paper,15,30,15,1,00155,India
729516,2023-11-20,712,graph paper,20,40,20,1,00155,India
729516,2023-11-20,701,gel pen,5,10,5,2,00155,India
729516,2023-11-20,706,sharpener,3,8,5,2,00155,India
238913,2023-11-20,712,graph paper,20,40,20,1,00062,India
238913,2023-11-20,706,sharpener,3,8,5,2,00062,India
238913,2023-11-20,715,folder,5,15,10,1,00062,India
324165,2023-11-20,705,stencil,10,20,10,2,00265,India
270760,2023-11-20,701,gel pen,5,10,5,2,00284,India
270760,2023-11-20,708,sketchpen,15,40,25,1,00284,India
270760,2023-11-20,706,sharpener,3,8,5,2,00284,India
270760,2023-11-20,704,scale,5,10,5,2,00284,India
270760,2023-11-20,711,TD kit,150,300,150,1,00284,India
763192,2023-11-20,702,pencil,2,5,3,2,00351,India
763192,2023-11-20,716,printing paper,200,400,200,1,00351,India
384738,2023-11-20,716,printing paper,200,400,200,1,00133,India
384738,2023-11-20,705,stencil,10,20,10,2,00133,India
384738,2023-11-20,707,marker,20,40,20,1,00133,India
673447,2023-11-20,708,sketchpen,15,40,25,1,00073,India
673447,2023-11-20,709,notebook,30,60,30,2,00073,India
226956,2023-11-20,717,spiral bound book,50,100,50,1,00146,India
226956,2023-11-20,704,scale,5,10,5,2,00146,India
226956,2023-11-20,703,eraser,1,3,2,2,00146,India
413945,2023-11-20,717,spiral bound book,50,100,50,1,00439,India
413945,2023-11-20,708,sketchpen,15,40,25,1,00439,India
413945,2023-11-20,701,gel pen,5,10,5,2,00439,India
413945,2023-11-20,709,notebook,30,60,30,2,00439,India
413945,2023-11-20,713,ball pen,5,10,5,2,00439,India
629175,2023-11-20,714,carbon paper,15,30,15,1,00127,India
629175,2023-11-20,704,scale,5,10,5,2,00127,India
629175,2023-11-20,712,graph paper,20,40,20,1,00127,India
629175,2023-11-20,707,marker,20,40,20,1,00127,India
399323,2023-11-20,702,pencil,2,5,3,2,00238,India
399323,2023-11-20,705,stencil,10,20,10,2,00238,India
399323,2023-11-20,710,geometry box,100,150,50,2,00238,India
399323,2023-11-20,711,TD kit,150,300,150,1,00238,India
399323,2023-11-20,713,ball pen,5,10,5,2,00238,India
743578,2023-11-20,705,stencil,10,20,10,2,00199,India
743578,2023-11-20,703,eraser,1,3,2,2,00199,India
743578,2023-11-20,709,notebook,30,60,30,2,00199,India
711873,2023-11-20,710,geometry box,100,150,50,2,00250,India
711873,2023-11-20,704,scale,5,10,5,2,00250,India
711873,2023-11-20,716,printing paper,200,400,200,1,00250,India
909810,2023-11-20,703,eraser,1,3,2,2,00020,India
909810,2023-11-20,712,graph paper,20,40,20,1,00020,India
245717,2023-11-21,708,sketchpen,15,40,25,1,00302,India
245717,2023-11-21,715,folder,5,15,10,1,00302,India
245717,2023-11-21,714,carbon paper,15,30,15,1,00302,India
691812,2023-11-21,716,printing paper,200,400,200,1,00010,India
691812,2023-11-21,709,notebook,30,60,30,2,00010,India
691812,2023-11-21,715,folder,5,15,10,1,00010,India
332707,2023-11-21,715,folder,5,15,10,1,00339,India
332707,2023-11-21,707,marker,20,40,20,1,00339,India
332707,2023-11-21,701,gel pen,5,10,5,2,00339,India
332707,2023-11-21,704,scale,5,10,5,2,00339,India
332707,2023-11-21,713,ball pen,5,10,5,2,00339,India
830213,2023-11-21,704,scale,5,10,5,2,00496,India
830213,2023-11-21,701,gel pen,5,10,5,2,00496,India
830213,2023-11-21,703,eraser,1,3,2,2,00496,India
539806,2023-11-21,709,notebook,30,60,30,2,00041,India
539806,2023-11-21,714,carbon paper,15,30,15,1,00041,India
380963,2023-11-21,712,graph paper,20,40,20,1,00499,India
380963,2023-11-21,707,marker,20,40,20,1,00499,India
380963,2023-11-21,705,stencil,10,20,10,2,00499,India
660846,2023-11-21,705,stencil,10,20,10,2,00013,India
660846,2023-11-21,703,eraser,1,3,2,2,00013,India
660846,2023-11-21,706,sharpener,3,8,5,2,00013,India
660846,2023-11-21,707,marker,20,40,20,1,00013,India
484842,2023-11-21,709,notebook,30,60,30,2,00196,India
484842,2023-11-21,712,graph paper,20,40,20,1,00196,India
914800,2023-11-21,714,carbon paper,15,30,15,1,00491,India
914800,2023-11-21,710,geometry box,100,150,50,2,00491,India
914800,2023-11-21,704,scale,5,10,5,2,00491,India
914800,2023-11-21,701,gel pen,5,10,5,2,00491,India
260733,2023-11-21,714,carbon paper,15,30,15,1,00187,India
172697,2023-11-21,716,printing paper,200,400,200,1,00443,India
179932,2023-11-21,701,gel pen,5,10,5,2,00448,India
179932,2023-11-21,704,scale,5,10,5,2,00448,India
179932,2023-11-21,715,folder,5,15,10,1,00448,India
179932,2023-11-21,709,notebook,30,60,30,2,00448,India
634708,2023-11-21,705,stencil,10,20,10,2,00345,India
634708,2023-11-21,706,sharpener,3,8,5,2,00345,India
634708,2023-11-21,704,scale,5,10,5,2,00345,India
451638,2023-11-21,709,notebook,30,60,30,2,00119,India
351112,2023-11-21,711,TD kit,150,300,150,1,00100,India
351112,2023-11-21,716,printing paper,200,400,200,1,00100,India
906465,2023-11-21,717,spiral bound book,50,100,50,1,00213,India
906465,2023-11-21,714,carbon paper,15,30,15,1,00213,India
906465,2023-11-21,712,graph paper,20,40,20,1,00213,India
906465,2023-11-21,716,printing paper,200,400,200,1,00213,India
906465,2023-11-21,711,TD kit,150,300,150,1,00213,India
372686,2023-11-21,704,scale,5,10,5,2,00103,India
372686,2023-11-21,711,TD kit,150,300,150,1,00103,India
677504,2023-11-21,704,scale,5,10,5,2,00119,India
677504,2023-11-21,706,sharpener,3,8,5,2,00119,India
281496,2023-11-21,704,scale,5,10,5,2,00326,India
308906,2023-11-21,715,folder,5,15,10,1,00019,India
529472,2023-11-21,708,sketchpen,15,40,25,1,00155,India
529472,2023-11-21,715,folder,5,15,10,1,00155,India
529472,2023-11-21,716,printing paper,200,400,200,1,00155,India
529472,2023-11-21,705,stencil,10,20,10,2,00155,India
529472,2023-11-21,706,sharpener,3,8,5,2,00155,India
372961,2023-11-21,715,folder,5,15,10,1,00186,India
220612,2023-11-21,715,folder,5,15,10,1,00439,India
220612,2023-11-21,708,sketchpen,15,40,25,1,00439,India
220612,2023-11-21,702,pencil,2,5,3,2,00439,India
220612,2023-11-21,703,eraser,1,3,2,2,00439,India
495494,2023-11-21,716,printing paper,200,400,200,1,00059,India
495494,2023-11-21,709,notebook,30,60,30,2,00059,India
495494,2023-11-21,714,carbon paper,15,30,15,1,00059,India
674209,2023-11-21,715,folder,5,15,10,1,00302,India
674209,2023-11-21,702,pencil,2,5,3,2,00302,India
674209,2023-11-21,706,sharpener,3,8,5,2,00302,India
674209,2023-11-21,714,carbon paper,15,30,15,1,00302,India
927956,2023-11-21,717,spiral bound book,50,100,50,1,00031,India
927956,2023-11-21,710,geometry box,100,150,50,2,00031,India
973507,2023-11-21,706,sharpener,3,8,5,2,00072,India
973507,2023-11-21,702,pencil,2,5,3,2,00072,India
973507,2023-11-21,705,stencil,10,20,10,2,00072,India
973507,2023-11-21,715,folder,5,15,10,1,00072,India
397407,2023-11-21,717,spiral bound book,50,100,50,1,00314,India
397407,2023-11-21,709,notebook,30,60,30,2,00314,India
397407,2023-11-21,715,folder,5,15,10,1,00314,India
126718,2023-11-21,701,gel pen,5,10,5,2,00075,India
126718,2023-11-21,710,geometry box,100,150,50,2,00075,India
126718,2023-11-21,706,sharpener,3,8,5,2,00075,India
126718,2023-11-21,703,eraser,1,3,2,2,00075,India
411830,2023-11-21,716,printing paper,200,400,200,1,00262,India
411830,2023-11-21,713,ball pen,5,10,5,2,00262,India
910923,2023-11-22,708,sketchpen,15,40,25,1,00217,India
468721,2023-11-22,703,eraser,1,3,2,2,00050,India
468721,2023-11-22,712,graph paper,20,40,20,1,00050,India
468721,2023-11-22,707,marker,20,40,20,1,00050,India
468721,2023-11-22,714,carbon paper,15,30,15,1,00050,India
701614,2023-11-22,710,geometry box,100,150,50,2,00268,India
701614,2023-11-22,704,scale,5,10,5,2,00268,India
701614,2023-11-22,707,marker,20,40,20,1,00268,India
701614,2023-11-22,717,spiral bound book,50,100,50,1,00268,India
701614,2023-11-22,715,folder,5,15,10,1,00268,India
302830,2023-11-22,701,gel pen,5,10,5,2,00064,India
302830,2023-11-22,704,scale,5,10,5,2,00064,India
302830,2023-11-22,717,spiral bound book,50,100,50,1,00064,India
599703,2023-11-22,714,carbon paper,15,30,15,1,00356,India
599703,2023-11-22,709,notebook,30,60,30,2,00356,India
247099,2023-11-22,714,carbon paper,15,30,15,1,00209,India
247099,2023-11-22,707,marker,20,40,20,1,00209,India
247099,2023-11-22,713,ball pen,5,10,5,2,00209,India
247099,2023-11-22,709,notebook,30,60,30,2,00209,India
843900,2023-11-22,701,gel pen,5,10,5,2,00059,India
843900,2023-11-22,702,pencil,2,5,3,2,00059,India
843900,2023-11-22,716,printing paper,200,400,200,1,00059,India
172575,2023-11-22,706,sharpener,3,8,5,2,00454,India
172575,2023-11-22,705,stencil,10,20,10,2,00454,India
400260,2023-11-22,715,folder,5,15,10,1,00237,India
400260,2023-11-22,703,eraser,1,3,2,2,00237,India
400260,2023-11-22,709,notebook,30,60,30,2,00237,India
400260,2023-11-22,704,scale,5,10,5,2,00237,India
232472,2023-11-22,706,sharpener,3,8,5,2,00343,India
232472,2023-11-22,710,geometry box,100,150,50,2,00343,India
232472,2023-11-22,715,folder,5,15,10,1,00343,India
232472,2023-11-22,705,stencil,10,20,10,2,00343,India
923613,2023-11-22,709,notebook,30,60,30,2,00079,India
923613,2023-11-22,713,ball pen,5,10,5,2,00079,India
923613,2023-11-22,717,spiral bound book,50,100,50,1,00079,India
923613,2023-11-22,708,sketchpen,15,40,25,1,00079,India
551355,2023-11-22,715,folder,5,15,10,1,00215,India
551355,2023-11-22,709,notebook,30,60,30,2,00215,India
551355,2023-11-22,714,carbon paper,15,30,15,1,00215,India
912829,2023-11-22,708,sketchpen,15,40,25,1,00233,India
788616,2023-11-22,712,graph paper,20,40,20,1,00376,India
788616,2023-11-22,717,spiral bound book,50,100,50,1,00376,India
788616,2023-11-22,703,eraser,1,3,2,2,00376,India
788616,2023-11-22,707,marker,20,40,20,1,00376,India
460042,2023-11-22,717,spiral bound book,50,100,50,1,00012,India
827336,2023-11-22,716,printing paper,200,400,200,1,00343,India
827336,2023-11-22,713,ball pen,5,10,5,2,00343,India
682722,2023-11-22,701,gel pen,5,10,5,2,00141,India
914810,2023-11-22,704,scale,5,10,5,2,00168,India
311460,2023-11-22,710,geometry box,100,150,50,2,00343,India
859941,2023-11-22,717,spiral bound book,50,100,50,1,00427,India
859941,2023-11-22,703,eraser,1,3,2,2,00427,India
632878,2023-11-22,706,sharpener,3,8,5,2,00044,India
632878,2023-11-22,707,marker,20,40,20,1,00044,India
890345,2023-11-22,715,folder,5,15,10,1,00122,India
890345,2023-11-22,705,stencil,10,20,10,2,00122,India
595658,2023-11-22,709,notebook,30,60,30,2,00217,India
595658,2023-11-22,702,pencil,2,5,3,2,00217,India
595658,2023-11-22,706,sharpener,3,8,5,2,00217,India
315355,2023-11-22,709,notebook,30,60,30,2,00468,India
315355,2023-11-22,714,carbon paper,15,30,15,1,00468,India
514016,2023-11-22,712,graph paper,20,40,20,1,00039,India
154118,2023-11-22,710,geometry box,100,150,50,2,00217,India
154118,2023-11-22,711,TD kit,150,300,150,1,00217,India
154118,2023-11-22,703,eraser,1,3,2,2,00217,India
154118,2023-11-22,707,marker,20,40,20,1,00217,India
154118,2023-11-22,708,sketchpen,15,40,25,1,00217,India
591701,2023-11-22,706,sharpener,3,8,5,2,00493,India
591701,2023-11-22,711,TD kit,150,300,150,1,00493,India
412253,2023-11-22,701,gel pen,5,10,5,2,00385,India
412253,2023-11-22,704,scale,5,10,5,2,00385,India
412253,2023-11-22,715,folder,5,15,10,1,00385,India
412253,2023-11-22,713,ball pen,5,10,5,2,00385,India
412253,2023-11-22,714,carbon paper,15,30,15,1,00385,India
457977,2023-11-22,701,gel pen,5,10,5,2,00380,India
457977,2023-11-22,712,graph paper,20,40,20,1,00380,India
457977,2023-11-22,708,sketchpen,15,40,25,1,00380,India
146111,2023-11-22,701,gel pen,5,10,5,2,00069,India
146111,2023-11-22,709,notebook,30,60,30,2,00069,India
146111,2023-11-22,704,scale,5,10,5,2,00069,India
691253,2023-11-22,708,sketchpen,15,40,25,1,00289,India
691253,2023-11-22,705,stencil,10,20,10,2,00289,India
691253,2023-11-22,709,notebook,30,60,30,2,00289,India
691253,2023-11-22,713,ball pen,5,10,5,2,00289,India
199611,2023-11-22,714,carbon paper,15,30,15,1,00188,India
199611,2023-11-22,713,ball pen,5,10,5,2,00188,India
199611,2023-11-22,707,marker,20,40,20,1,00188,India
364730,2023-11-23,709,notebook,30,60,30,2,00364,India
364730,2023-11-23,713,ball pen,5,10,5,2,00364,India
364730,2023-11-23,708,sketchpen,15,40,25,1,00364,India
364730,2023-11-23,710,geometry box,100,150,50,2,00364,India
364730,2023-11-23,715,folder,5,15,10,1,00364,India
445278,2023-11-23,715,folder,5,15,10,1,00330,India
445278,2023-11-23,710,geometry box,100,150,50,2,00330,India
965097,2023-11-23,708,sketchpen,15,40,25,1,00265,India
809408,2023-11-23,714,carbon paper,15,30,15,1,00186,India
809408,2023-11-23,713,ball pen,5,10,5,2,00186,India
809408,2023-11-23,701,gel pen,5,10,5,2,00186,India
226610,2023-11-23,701,gel pen,5,10,5,2,00430,India
587859,2023-11-23,705,stencil,10,20,10,2,00102,India
587859,2023-11-23,711,TD kit,150,300,150,1,00102,India
587859,2023-11-23,716,printing paper,200,400,200,1,00102,India
587859,2023-11-23,710,geometry box,100,150,50,2,00102,India
372048,2023-11-23,701,gel pen,5,10,5,2,00476,India
850920,2023-11-23,706,sharpener,3,8,5,2,00037,India
850920,2023-11-23,705,stencil,10,20,10,2,00037,India
850920,2023-11-23,712,graph paper,20,40,20,1,00037,India
904920,2023-11-23,710,geometry box,100,150,50,2,00145,India
904920,2023-11-23,714,carbon paper,15,30,15,1,00145,India
904920,2023-11-23,706,sharpener,3,8,5,2,00145,India
658102,2023-11-23,710,geometry box,100,150,50,2,00408,India
658102,2023-11-23,709,notebook,30,60,30,2,00408,India
658102,2023-11-23,713,ball pen,5,10,5,2,00408,India
658102,2023-11-23,703,eraser,1,3,2,2,00408,India
658102,2023-11-23,715,folder,5,15,10,1,00408,India
519564,2023-11-23,702,pencil,2,5,3,2,00461,India
519564,2023-11-23,705,stencil,10,20,10,2,00461,India
815613,2023-11-23,714,carbon paper,15,30,15,1,00230,India
815613,2023-11-23,707,marker,20,40,20,1,00230,India
546153,2023-11-23,711,TD kit,150,300,150,1,00470,India
615610,2023-11-23,713,ball pen,5,10,5,2,00117,India
615610,2023-11-23,706,sharpener,3,8,5,2,00117,India
615610,2023-11-23,702,pencil,2,5,3,2,00117,India
423727,2023-11-23,707,marker,20,40,20,1,00016,India
423727,2023-11-23,715,folder,5,15,10,1,00016,India
423727,2023-11-23,716,printing paper,200,400,200,1,00016,India
315934,2023-11-23,717,spiral bound book,50,100,50,1,00493,India
908742,2023-11-23,712,graph paper,20,40,20,1,00248,India
908742,2023-11-23,701,gel pen,5,10,5,2,00248,India
908742,2023-11-23,708,sketchpen,15,40,25,1,00248,India
305582,2023-11-23,712,graph paper,20,40,20,1,00248,India
663230,2023-11-23,713,ball pen,5,10,5,2,00387,India
184084,2023-11-23,714,carbon paper,15,30,15,1,00090,India
472030,2023-11-23,716,printing paper,200,400,200,1,00276,India
472030,2023-11-23,712,graph paper,20,40,20,1,00276,India
472030,2023-11-23,708,sketchpen,15,40,25,1,00276,India
858208,2023-11-23,701,gel pen,5,10,5,2,00028,India
858208,2023-11-23,703,eraser,1,3,2,2,00028,India
858208,2023-11-23,717,spiral bound book,50,100,50,1,00028,India
858208,2023-11-23,710,geometry box,100,150,50,2,00028,India
858208,2023-11-23,708,sketchpen,15,40,25,1,00028,India
659992,2023-11-23,709,notebook,30,60,30,2,00116,India
659992,2023-11-23,706,sharpener,3,8,5,2,00116,India
513644,2023-11-23,710,geometry box,100,150,50,2,00077,India
513644,2023-11-23,703,eraser,1,3,2,2,00077,India
513644,2023-11-23,706,sharpener,3,8,5,2,00077,India
967793,2023-11-23,712,graph paper,20,40,20,1,00455,India
967793,2023-11-23,713,ball pen,5,10,5,2,00455,India
321082,2023-11-23,715,folder,5,15,10,1,00140,India
321082,2023-11-23,706,sharpener,3,8,5,2,00140,India
321082,2023-11-23,704,scale,5,10,5,2,00140,India
187802,2023-11-23,717,spiral bound book,50,100,50,1,00141,India
187802,2023-11-23,709,notebook,30,60,30,2,00141,India
187802,2023-11-23,710,geometry box,100,150,50,2,00141,India
673709,2023-11-23,710,geometry box,100,150,50,2,00170,India
244770,2023-11-23,703,eraser,1,3,2,2,00387,India
244770,2023-11-23,713,ball pen,5,10,5,2,00387,India
651158,2023-11-23,715,folder,5,15,10,1,00399,India
651158,2023-11-23,717,spiral bound book,50,100,50,1,00399,India
398478,2023-11-23,704,scale,5,10,5,2,00264,India
398478,2023-11-23,712,graph paper,20,40,20,1,00264,India
338928,2023-11-23,715,folder,5,15,10,1,00134,India
338928,2023-11-23,712,graph paper,20,40,20,1,00134,India
338928,2023-11-23,706,sharpener,3,8,5,2,00134,India
338928,2023-11-23,708,sketchpen,15,40,25,1,00134,India
432855,2023-11-23,703,eraser,1,3,2,2,00271,India
432855,2023-11-23,712,graph paper,20,40,20,1,00271,India
432855,2023-11-23,714,carbon paper,15,30,15,1,00271,India
432855,2023-11-23,709,notebook,30,60,30,2,00271,India
432855,2023-11-23,706,sharpener,3,8,5,2,00271,India
684660,2023-11-23,710,geometry box,100,150,50,2,00464,India
684660,2023-11-23,715,folder,5,15,10,1,00464,India
684660,2023-11-23,712,graph paper,20,40,20,1,00464,India
684660,2023-11-23,708,sketchpen,15,40,25,1,00464,India
626476,2023-11-23,707,marker,20,40,20,1,00050,India
626476,2023-11-23,709,notebook,30,60,30,2,00050,India
626476,2023-11-23,710,geometry box,100,150,50,2,00050,India
626476,2023-11-23,715,folder,5,15,10,1,00050,India
626476,2023-11-23,701,gel pen,5,10,5,2,00050,India
445654,2023-11-23,704,scale,5,10,5,2,00101,India
445654,2023-11-23,709,notebook,30,60,30,2,00101,India
445654,2023-11-23,711,TD kit,150,300,150,1,00101,India
634790,2023-11-23,713,ball pen,5,10,5,2,00154,India
634790,2023-11-23,710,geometry box,100,150,50,2,00154,India
974722,2023-11-23,706,sharpener,3,8,5,2,00243,India
974722,2023-11-23,717,spiral bound book,50,100,50,1,00243,India
974722,2023-11-23,708,sketchpen,15,40,25,1,00243,India
974722,2023-11-23,716,printing paper,200,400,200,1,00243,India
275347,2023-11-23,712,graph paper,20,40,20,1,00396,India
275347,2023-11-23,714,carbon paper,15,30,15,1,00396,India
275347,2023-11-23,717,spiral bound book,50,100,50,1,00396,India
275347,2023-11-23,702,pencil,2,5,3,2,00396,India
648183,2023-11-23,710,geometry box,100,150,50,2,00199,India
648183,2023-11-23,709,notebook,30,60,30,2,00199,India
648183,2023-11-23,701,gel pen,5,10,5,2,00199,India
648183,2023-11-23,703,eraser,1,3,2,2,00199,India
648183,2023-11-23,712,graph paper,20,40,20,1,00199,India
346518,2023-11-23,707,marker,20,40,20,1,00083,India
346518,2023-11-23,702,pencil,2,5,3,2,00083,India
346518,2023-11-23,710,geometry box,100,150,50,2,00083,India
407717,2023-11-23,708,sketchpen,15,40,25,1,00115,India
407717,2023-11-23,709,notebook,30,60,30,2,00115,India
407717,2023-11-23,714,carbon paper,15,30,15,1,00115,India
407717,2023-11-23,707,marker,20,40,20,1,00115,India
407717,2023-11-23,716,printing paper,200,400,200,1,00115,India
869412,2023-11-23,702,pencil,2,5,3,2,00144,India
869412,2023-11-23,711,TD kit,150,300,150,1,00144,India
869412,2023-11-23,714,carbon paper,15,30,15,1,00144,India
295100,2023-11-23,701,gel pen,5,10,5,2,00179,India
295100,2023-11-23,702,pencil,2,5,3,2,00179,India
295100,2023-11-23,714,carbon paper,15,30,15,1,00179,India
821611,2023-11-23,702,pencil,2,5,3,2,00076,India
821611,2023-11-23,704,scale,5,10,5,2,00076,India
329157,2023-11-23,715,folder,5,15,10,1,00443,India
961662,2023-11-23,716,printing paper,200,400,200,1,00479,India
961662,2023-11-23,706,sharpener,3,8,5,2,00479,India
961662,2023-11-23,711,TD kit,150,300,150,1,00479,India
129047,2023-11-23,710,geometry box,100,150,50,2,00142,India
129047,2023-11-23,712,graph paper,20,40,20,1,00142,India
129047,2023-11-23,714,carbon paper,15,30,15,1,00142,India
359597,2023-11-24,716,printing paper,200,400,200,1,00098,India
359597,2023-11-24,703,eraser,1,3,2,2,00098,India
359597,2023-11-24,710,geometry box,100,150,50,2,00098,India
359597,2023-11-24,704,scale,5,10,5,2,00098,India
551924,2023-11-24,708,sketchpen,15,40,25,1,00474,India
551924,2023-11-24,714,carbon paper,15,30,15,1,00474,India
909502,2023-11-24,712,graph paper,20,40,20,1,00470,India
262971,2023-11-24,711,TD kit,150,300,150,1,00159,India
262971,2023-11-24,702,pencil,2,5,3,2,00159,India
262971,2023-11-24,712,graph paper,20,40,20,1,00159,India
262971,2023-11-24,704,scale,5,10,5,2,00159,India
517440,2023-11-24,704,scale,5,10,5,2,00443,India
517440,2023-11-24,716,printing paper,200,400,200,1,00443,India
517440,2023-11-24,701,gel pen,5,10,5,2,00443,India
517440,2023-11-24,703,eraser,1,3,2,2,00443,India
565791,2023-11-24,709,notebook,30,60,30,2,00109,India
305820,2023-11-24,710,geometry box,100,150,50,2,00098,India
305820,2023-11-24,704,scale,5,10,5,2,00098,India
305820,2023-11-24,703,eraser,1,3,2,2,00098,India
222177,2023-11-24,703,eraser,1,3,2,2,00116,India
222177,2023-11-24,705,stencil,10,20,10,2,00116,India
222177,2023-11-24,702,pencil,2,5,3,2,00116,India
222177,2023-11-24,709,notebook,30,60,30,2,00116,India
799697,2023-11-24,705,stencil,10,20,10,2,00248,India
799697,2023-11-24,703,eraser,1,3,2,2,00248,India
270600,2023-11-24,709,notebook,30,60,30,2,00343,India
270600,2023-11-24,705,stencil,10,20,10,2,00343,India
270600,2023-11-24,702,pencil,2,5,3,2,00343,India
270600,2023-11-24,706,sharpener,3,8,5,2,00343,India
735507,2023-11-24,705,stencil,10,20,10,2,00315,India
735507,2023-11-24,706,sharpener,3,8,5,2,00315,India
956037,2023-11-24,707,marker,20,40,20,1,00074,India
956037,2023-11-24,705,stencil,10,20,10,2,00074,India
956037,2023-11-24,710,geometry box,100,150,50,2,00074,India
956037,2023-11-24,709,notebook,30,60,30,2,00074,India
638929,2023-11-24,703,eraser,1,3,2,2,00289,India
164599,2023-11-24,717,spiral bound book,50,100,50,1,00388,India
164599,2023-11-24,702,pencil,2,5,3,2,00388,India
164599,2023-11-24,713,ball pen,5,10,5,2,00388,India
164599,2023-11-24,715,folder,5,15,10,1,00388,India
164599,2023-11-24,710,geometry box,100,150,50,2,00388,India
722037,2023-11-24,702,pencil,2,5,3,2,00478,India
722037,2023-11-24,704,scale,5,10,5,2,00478,India
359693,2023-11-24,712,graph paper,20,40,20,1,00324,India
359693,2023-11-24,703,eraser,1,3,2,2,00324,India
580408,2023-11-24,714,carbon paper,15,30,15,1,00238,India
580408,2023-11-24,709,notebook,30,60,30,2,00238,India
580408,2023-11-24,702,pencil,2,5,3,2,00238,India
379317,2023-11-24,709,notebook,30,60,30,2,00484,India
379317,2023-11-24,714,carbon paper,15,30,15,1,00484,India
379317,2023-11-24,703,eraser,1,3,2,2,00484,India
379317,2023-11-24,702,pencil,2,5,3,2,00484,India
344297,2023-11-24,703,eraser,1,3,2,2,00113,India
980319,2023-11-24,709,notebook,30,60,30,2,00150,India
947490,2023-11-24,702,pencil,2,5,3,2,00311,India
947490,2023-11-24,713,ball pen,5,10,5,2,00311,India
223751,2023-11-24,711,TD kit,150,300,150,1,00458,India
223751,2023-11-24,712,graph paper,20,40,20,1,00458,India
223751,2023-11-24,708,sketchpen,15,40,25,1,00458,India
223751,2023-11-24,709,notebook,30,60,30,2,00458,India
518333,2023-11-24,702,pencil,2,5,3,2,00366,India
518333,2023-11-24,706,sharpener,3,8,5,2,00366,India
518333,2023-11-24,701,gel pen,5,10,5,2,00366,India
222603,2023-11-24,717,spiral bound book,50,100,50,1,00483,India
222603,2023-11-24,706,sharpener,3,8,5,2,00483,India
451594,2023-11-24,703,eraser,1,3,2,2,00268,India
451594,2023-11-24,705,stencil,10,20,10,2,00268,India
938869,2023-11-24,709,notebook,30,60,30,2,00402,India
938869,2023-11-24,705,stencil,10,20,10,2,00402,India
938869,2023-11-24,704,scale,5,10,5,2,00402,India
938869,2023-11-24,710,geometry box,100,150,50,2,00402,India
615826,2023-11-24,717,spiral bound book,50,100,50,1,00198,India
615826,2023-11-24,705,stencil,10,20,10,2,00198,India
613638,2023-11-24,702,pencil,2,5,3,2,00287,India
321243,2023-11-24,704,scale,5,10,5,2,00031,India
907469,2023-11-24,710,geometry box,100,150,50,2,00043,India
907469,2023-11-24,713,ball pen,5,10,5,2,00043,India
907469,2023-11-24,705,stencil,10,20,10,2,00043,India
907469,2023-11-24,709,notebook,30,60,30,2,00043,India
907469,2023-11-24,703,eraser,1,3,2,2,00043,India
287971,2023-11-24,709,notebook,30,60,30,2,00062,India
125973,2023-11-24,712,graph paper,20,40,20,1,00307,India
125973,2023-11-24,704,scale,5,10,5,2,00307,India
125973,2023-11-24,708,sketchpen,15,40,25,1,00307,India
125973,2023-11-24,710,geometry box,100,150,50,2,00307,India
760963,2023-11-24,716,printing paper,200,400,200,1,00183,India
974368,2023-11-24,708,sketchpen,15,40,25,1,00486,India
464914,2023-11-24,702,pencil,2,5,3,2,00008,India
464914,2023-11-24,716,printing paper,200,400,200,1,00008,India
464914,2023-11-24,710,geometry box,100,150,50,2,00008,India
464914,2023-11-24,714,carbon paper,15,30,15,1,00008,India
678494,2023-11-24,705,stencil,10,20,10,2,00003,India
553451,2023-11-24,712,graph paper,20,40,20,1,00121,India
553451,2023-11-24,711,TD kit,150,300,150,1,00121,India
546467,2023-11-24,711,TD kit,150,300,150,1,00162,India
546467,2023-11-24,709,notebook,30,60,30,2,00162,India
546467,2023-11-24,712,graph paper,20,40,20,1,00162,India
546467,2023-11-24,717,spiral bound book,50,100,50,1,00162,India
255981,2023-11-24,702,pencil,2,5,3,2,00433,India
105264,2023-11-24,712,graph paper,20,40,20,1,00284,India
582365,2023-11-24,708,sketchpen,15,40,25,1,00232,India
582365,2023-11-24,709,notebook,30,60,30,2,00232,India
582365,2023-11-24,711,TD kit,150,300,150,1,00232,India
582365,2023-11-24,715,folder,5,15,10,1,00232,India
582365,2023-11-24,704,scale,5,10,5,2,00232,India
452370,2023-11-24,706,sharpener,3,8,5,2,00418,India
452370,2023-11-24,712,graph paper,20,40,20,1,00418,India
452370,2023-11-24,710,geometry box,100,150,50,2,00418,India
632469,2023-11-24,710,geometry box,100,150,50,2,00030,India
632469,2023-11-24,709,notebook,30,60,30,2,00030,India
632469,2023-11-24,711,TD kit,150,300,150,1,00030,India
632469,2023-11-24,703,eraser,1,3,2,2,00030,India
791002,2023-11-24,712,graph paper,20,40,20,1,00474,India
791002,2023-11-24,713,ball pen,5,10,5,2,00474,India
616810,2023-11-24,715,folder,5,15,10,1,00260,India
616810,2023-11-24,705,stencil,10,20,10,2,00260,India
616810,2023-11-24,703,eraser,1,3,2,2,00260,India
790529,2023-11-24,711,TD kit,150,300,150,1,00155,India
790529,2023-11-24,702,pencil,2,5,3,2,00155,India
686382,2023-11-24,706,sharpener,3,8,5,2,00163,India
686382,2023-11-24,701,gel pen,5,10,5,2,00163,India
365272,2023-11-24,712,graph paper,20,40,20,1,00106,India
365272,2023-11-24,703,eraser,1,3,2,2,00106,India
582357,2023-11-24,712,graph paper,20,40,20,1,00005,India
582357,2023-11-24,717,spiral bound book,50,100,50,1,00005,India
582357,2023-11-24,713,ball pen,5,10,5,2,00005,India
582357,2023-11-24,702,pencil,2,5,3,2,00005,India
274167,2023-11-24,705,stencil,10,20,10,2,00394,India
368660,2023-11-25,714,carbon paper,15,30,15,1,00026,India
790400,2023-11-25,706,sharpener,3,8,5,2,00008,India
790400,2023-11-25,705,stencil,10,20,10,2,00008,India
790400,2023-11-25,711,TD kit,150,300,150,1,00008,India
790400,2023-11-25,716,printing paper,200,400,200,1,00008,India
502459,2023-11-25,702,pencil,2,5,3,2,00268,India
502459,2023-11-25,707,marker,20,40,20,1,00268,India
502459,2023-11-25,712,graph paper,20,40,20,1,00268,India
815231,2023-11-25,711,TD kit,150,300,150,1,00197,India
815231,2023-11-25,703,eraser,1,3,2,2,00197,India
612411,2023-11-25,711,TD kit,150,300,150,1,00211,India
612411,2023-11-25,706,sharpener,3,8,5,2,00211,India
612411,2023-11-25,705,stencil,10,20,10,2,00211,India
612411,2023-11-25,710,geometry box,100,150,50,2,00211,India
834036,2023-11-25,713,ball pen,5,10,5,2,00210,India
834036,2023-11-25,708,sketchpen,15,40,25,1,00210,India
834036,2023-11-25,710,geometry box,100,150,50,2,00210,India
276809,2023-11-25,716,printing paper,200,400,200,1,00151,India
449240,2023-11-25,717,spiral bound book,50,100,50,1,00028,India
449240,2023-11-25,711,TD kit,150,300,150,1,00028,India
786891,2023-11-25,702,pencil,2,5,3,2,00468,India
689264,2023-11-25,715,folder,5,15,10,1,00113,India
689264,2023-11-25,712,graph paper,20,40,20,1,00113,India
689264,2023-11-25,703,eraser,1,3,2,2,00113,India
689264,2023-11-25,716,printing paper,200,400,200,1,00113,India
689264,2023-11-25,708,sketchpen,15,40,25,1,00113,India
439012,2023-11-25,704,scale,5,10,5,2,00220,India
439012,2023-11-25,705,stencil,10,20,10,2,00220,India
439012,2023-11-25,712,graph paper,20,40,20,1,00220,India
439012,2023-11-25,707,marker,20,40,20,1,00220,India
439012,2023-11-25,703,eraser,1,3,2,2,00220,India
930361,2023-11-25,705,stencil,10,20,10,2,00354,India
930361,2023-11-25,715,folder,5,15,10,1,00354,India
930361,2023-11-25,706,sharpener,3,8,5,2,00354,India
930361,2023-11-25,707,marker,20,40,20,1,00354,India
466580,2023-11-25,708,sketchpen,15,40,25,1,00206,India
466580,2023-11-25,702,pencil,2,5,3,2,00206,India
466580,2023-11-25,701,gel pen,5,10,5,2,00206,India
466580,2023-11-25,707,marker,20,40,20,1,00206,India
167980,2023-11-25,706,sharpener,3,8,5,2,00093,India
950623,2023-11-25,705,stencil,10,20,10,2,00024,India
950623,2023-11-25,703,eraser,1,3,2,2,00024,India
950623,2023-11-25,714,carbon paper,15,30,15,1,00024,India
950623,2023-11-25,706,sharpener,3,8,5,2,00024,India
188129,2023-11-25,709,notebook,30,60,30,2,00045,India
188129,2023-11-25,706,sharpener,3,8,5,2,00045,India
188129,2023-11-25,702,pencil,2,5,3,2,00045,India
188129,2023-11-25,701,gel pen,5,10,5,2,00045,India
188129,2023-11-25,711,TD kit,150,300,150,1,00045,India
914641,2023-11-25,702,pencil,2,5,3,2,00107,India
357468,2023-11-25,703,eraser,1,3,2,2,00464,India
357468,2023-11-25,708,sketchpen,15,40,25,1,00464,India
357468,2023-11-25,707,marker,20,40,20,1,00464,India
442209,2023-11-25,705,stencil,10,20,10,2,00181,India
442209,2023-11-25,713,ball pen,5,10,5,2,00181,India
442209,2023-11-25,706,sharpener,3,8,5,2,00181,India
442209,2023-11-25,714,carbon paper,15,30,15,1,00181,India
442209,2023-11-25,707,marker,20,40,20,1,00181,India
229554,2023-11-25,711,TD kit,150,300,150,1,00312,India
229554,2023-11-25,716,printing paper,200,400,200,1,00312,India
110975,2023-11-25,702,pencil,2,5,3,2,00462,India
110975,2023-11-25,703,eraser,1,3,2,2,00462,India
110975,2023-11-25,704,scale,5,10,5,2,00462,India
435435,2023-11-25,709,notebook,30,60,30,2,00210,India
435435,2023-11-25,702,pencil,2,5,3,2,00210,India
435435,2023-11-25,717,spiral bound book,50,100,50,1,00210,India
435435,2023-11-25,716,printing paper,200,400,200,1,00210,India
435435,2023-11-25,713,ball pen,5,10,5,2,00210,India
644284,2023-11-25,705,stencil,10,20,10,2,00293,India
816837,2023-11-25,702,pencil,2,5,3,2,00478,India
816837,2023-11-25,705,stencil,10,20,10,2,00478,India
816837,2023-11-25,701,gel pen,5,10,5,2,00478,India
447157,2023-11-25,701,gel pen,5,10,5,2,00353,India
447157,2023-11-25,715,folder,5,15,10,1,00353,India
447157,2023-11-25,717,spiral bound book,50,100,50,1,00353,India
974448,2023-11-25,702,pencil,2,5,3,2,00498,India
974448,2023-11-25,701,gel pen,5,10,5,2,00498,India
974448,2023-11-25,706,sharpener,3,8,5,2,00498,India
456174,2023-11-25,701,gel pen,5,10,5,2,00449,India
456174,2023-11-25,703,eraser,1,3,2,2,00449,India
456174,2023-11-25,706,sharpener,3,8,5,2,00449,India
456174,2023-11-25,716,printing paper,200,400,200,1,00449,India
430330,2023-11-25,711,TD kit,150,300,150,1,00407,India
671382,2023-11-25,702,pencil,2,5,3,2,00395,India
613821,2023-11-25,710,geometry box,100,150,50,2,00181,India
493900,2023-11-25,711,TD kit,150,300,150,1,00156,India
493900,2023-11-25,717,spiral bound book,50,100,50,1,00156,India
403600,2023-11-26,708,sketchpen,15,40,25,1,00273,India
166471,2023-11-26,707,marker,20,40,20,1,00122,India
203179,2023-11-26,708,sketchpen,15,40,25,1,00290,India
203179,2023-11-26,706,sharpener,3,8,5,2,00290,India
909648,2023-11-26,705,stencil,10,20,10,2,00032,India
745049,2023-11-26,701,gel pen,5,10,5,2,00404,India
745049,2023-11-26,709,notebook,30,60,30,2,00404,India
609564,2023-11-26,705,stencil,10,20,10,2,00290,India
609564,2023-11-26,712,graph paper,20,40,20,1,00290,India
677898,2023-11-26,712,graph paper,20,40,20,1,00018,India
695221,2023-11-26,704,scale,5,10,5,2,00284,India
506921,2023-11-26,711,TD kit,150,300,150,1,00480,India
506921,2023-11-26,715,folder,5,15,10,1,00480,India
506921,2023-11-26,701,gel pen,5,10,5,2,00480,India
506921,2023-11-26,703,eraser,1,3,2,2,00480,India
925319,2023-11-26,708,sketchpen,15,40,25,1,00451,India
553007,2023-11-26,709,notebook,30,60,30,2,00012,India
788890,2023-11-26,704,scale,5,10,5,2,00470,India
788890,2023-11-26,707,marker,20,40,20,1,00470,India
788890,2023-11-26,709,notebook,30,60,30,2,00470,India
788890,2023-11-26,716,printing paper,200,400,200,1,00470,India
529638,2023-11-26,707,marker,20,40,20,1,00199,India
529638,2023-11-26,701,gel pen,5,10,5,2,00199,India
210363,2023-11-26,715,folder,5,15,10,1,00104,India
210363,2023-11-26,705,stencil,10,20,10,2,00104,India
210363,2023-11-26,714,carbon paper,15,30,15,1,00104,India
210363,2023-11-26,717,spiral bound book,50,100,50,1,00104,India
210363,2023-11-26,709,notebook,30,60,30,2,00104,India
245797,2023-11-26,701,gel pen,5,10,5,2,00096,India
300677,2023-11-26,717,spiral bound book,50,100,50,1,00246,India
300677,2023-11-26,709,notebook,30,60,30,2,00246,India
300677,2023-11-26,710,geometry box,100,150,50,2,00246,India
142778,2023-11-26,713,ball pen,5,10,5,2,00109,India
142778,2023-11-26,711,TD kit,150,300,150,1,00109,India
142778,2023-11-26,716,printing paper,200,400,200,1,00109,India
142778,2023-11-26,701,gel pen,5,10,5,2,00109,India
467596,2023-11-26,713,ball pen,5,10,5,2,00292,India
467596,2023-11-26,715,folder,5,15,10,1,00292,India
415163,2023-11-26,703,eraser,1,3,2,2,00415,India
415163,2023-11-26,708,sketchpen,15,40,25,1,00415,India
415163,2023-11-26,712,graph paper,20,40,20,1,00415,India
734810,2023-11-26,709,notebook,30,60,30,2,00055,India
734810,2023-11-26,716,printing paper,200,400,200,1,00055,India
757578,2023-11-26,712,graph paper,20,40,20,1,00144,India
448488,2023-11-26,716,printing paper,200,400,200,1,00278,India
418608,2023-11-26,703,eraser,1,3,2,2,00216,India
418608,2023-11-26,709,notebook,30,60,30,2,00216,India
734176,2023-11-26,701,gel pen,5,10,5,2,00230,India
734176,2023-11-26,707,marker,20,40,20,1,00230,India
978506,2023-11-26,709,notebook,30,60,30,2,00273,India
639981,2023-11-26,712,graph paper,20,40,20,1,00044,India
639981,2023-11-26,713,ball pen,5,10,5,2,00044,India
901280,2023-11-26,713,ball pen,5,10,5,2,00326,India
758313,2023-11-26,707,marker,20,40,20,1,00058,India
758313,2023-11-26,716,printing paper,200,400,200,1,00058,India
758313,2023-11-26,703,eraser,1,3,2,2,00058,India
248982,2023-11-26,707,marker,20,40,20,1,00276,India
248982,2023-11-26,705,stencil,10,20,10,2,00276,India
248982,2023-11-26,713,ball pen,5,10,5,2,00276,India
544801,2023-11-26,711,TD kit,150,300,150,1,00418,India
544801,2023-11-26,716,printing paper,200,400,200,1,00418,India
544801,2023-11-26,712,graph paper,20,40,20,1,00418,India
544801,2023-11-26,706,sharpener,3,8,5,2,00418,India
544801,2023-11-26,709,notebook,30,60,30,2,00418,India
250151,2023-11-26,706,sharpener,3,8,5,2,00450,India
250151,2023-11-26,716,printing paper,200,400,200,1,00450,India
414146,2023-11-26,713,ball pen,5,10,5,2,00392,India
414146,2023-11-26,717,spiral bound book,50,100,50,1,00392,India
414146,2023-11-26,710,geometry box,100,150,50,2,00392,India
414146,2023-11-26,705,stencil,10,20,10,2,00392,India
626021,2023-11-26,705,stencil,10,20,10,2,00323,India
626021,2023-11-26,713,ball pen,5,10,5,2,00323,India
626021,2023-11-26,708,sketchpen,15,40,25,1,00323,India
967518,2023-11-26,705,stencil,10,20,10,2,00464,India
967518,2023-11-26,701,gel pen,5,10,5,2,00464,India
967518,2023-11-26,713,ball pen,5,10,5,2,00464,India
967518,2023-11-26,706,sharpener,3,8,5,2,00464,India
264224,2023-11-26,701,gel pen,5,10,5,2,00343,India
264224,2023-11-26,711,TD kit,150,300,150,1,00343,India
264224,2023-11-26,709,notebook,30,60,30,2,00343,India
264224,2023-11-26,703,eraser,1,3,2,2,00343,India
264224,2023-11-26,708,sketchpen,15,40,25,1,00343,India
293513,2023-11-26,712,graph paper,20,40,20,1,00415,India
293513,2023-11-26,711,TD kit,150,300,150,1,00415,India
293513,2023-11-26,704,scale,5,10,5,2,00415,India
293513,2023-11-26,717,spiral bound book,50,100,50,1,00415,India
293513,2023-11-26,705,stencil,10,20,10,2,00415,India
615558,2023-11-26,714,carbon paper,15,30,15,1,00148,India
615558,2023-11-26,709,notebook,30,60,30,2,00148,India
615558,2023-11-26,706,sharpener,3,8,5,2,00148,India
615558,2023-11-26,702,pencil,2,5,3,2,00148,India
673695,2023-11-27,701,gel pen,5,10,5,2,00202,India
247813,2023-11-27,715,folder,5,15,10,1,00173,India
247813,2023-11-27,713,ball pen,5,10,5,2,00173,India
247813,2023-11-27,714,carbon paper,15,30,15,1,00173,India
247813,2023-11-27,706,sharpener,3,8,5,2,00173,India
121064,2023-11-27,703,eraser,1,3,2,2,00132,India
121064,2023-11-27,702,pencil,2,5,3,2,00132,India
121064,2023-11-27,716,printing paper,200,400,200,1,00132,India
234485,2023-11-27,710,geometry box,100,150,50,2,00285,India
234485,2023-11-27,709,notebook,30,60,30,2,00285,India
965786,2023-11-27,703,eraser,1,3,2,2,00160,India
133166,2023-11-27,701,gel pen,5,10,5,2,00196,India
133166,2023-11-27,703,eraser,1,3,2,2,00196,India
133166,2023-11-27,708,sketchpen,15,40,25,1,00196,India
133166,2023-11-27,704,scale,5,10,5,2,00196,India
133166,2023-11-27,711,TD kit,150,300,150,1,00196,India
706481,2023-11-27,707,marker,20,40,20,1,00139,India
706481,2023-11-27,712,graph paper,20,40,20,1,00139,India
758765,2023-11-27,707,marker,20,40,20,1,00134,India
981365,2023-11-27,702,pencil,2,5,3,2,00298,India
452856,2023-11-27,704,scale,5,10,5,2,00194,India
452856,2023-11-27,711,TD kit,150,300,150,1,00194,India
192240,2023-11-27,712,graph paper,20,40,20,1,00036,India
192240,2023-11-27,714,carbon paper,15,30,15,1,00036,India
192240,2023-11-27,701,gel pen,5,10,5,2,00036,India
192240,2023-11-27,703,eraser,1,3,2,2,00036,India
502708,2023-11-27,710,geometry box,100,150,50,2,00179,India
638997,2023-11-27,715,folder,5,15,10,1,00355,India
638997,2023-11-27,704,scale,5,10,5,2,00355,India
661421,2023-11-27,714,carbon paper,15,30,15,1,00388,India
661421,2023-11-27,715,folder,5,15,10,1,00388,India
661421,2023-11-27,711,TD kit,150,300,150,1,00388,India
661421,2023-11-27,708,sketchpen,15,40,25,1,00388,India
661421,2023-11-27,706,sharpener,3,8,5,2,00388,India
493658,2023-11-27,717,spiral bound book,50,100,50,1,00271,India
493658,2023-11-27,716,printing paper,200,400,200,1,00271,India
995218,2023-11-27,711,TD kit,150,300,150,1,00167,India
319719,2023-11-27,709,notebook,30,60,30,2,00327,India
319719,2023-11-27,704,scale,5,10,5,2,00327,India
563432,2023-11-27,709,notebook,30,60,30,2,00248,India
563432,2023-11-27,704,scale,5,10,5,2,00248,India
563432,2023-11-27,716,printing paper,200,400,200,1,00248,India
563432,2023-11-27,703,eraser,1,3,2,2,00248,India
115341,2023-11-27,708,sketchpen,15,40,25,1,00202,India
115341,2023-11-27,701,gel pen,5,10,5,2,00202,India
115341,2023-11-27,716,printing paper,200,400,200,1,00202,India
115341,2023-11-27,707,marker,20,40,20,1,00202,India
115341,2023-11-27,713,ball pen,5,10,5,2,00202,India
496353,2023-11-27,703,eraser,1,3,2,2,00280,India
797568,2023-11-27,701,gel pen,5,10,5,2,00456,India
797568,2023-11-27,705,stencil,10,20,10,2,00456,India
797568,2023-11-27,703,eraser,1,3,2,2,00456,India
185639,2023-11-27,717,spiral bound book,50,100,50,1,00238,India
185639,2023-11-27,713,ball pen,5,10,5,2,00238,India
205932,2023-11-27,708,sketchpen,15,40,25,1,00190,India
766352,2023-11-27,715,folder,5,15,10,1,00357,India
766352,2023-11-27,717,spiral bound book,50,100,50,1,00357,India
766352,2023-11-27,708,sketchpen,15,40,25,1,00357,India
541508,2023-11-27,715,folder,5,15,10,1,00475,India
541508,2023-11-27,714,carbon paper,15,30,15,1,00475,India
541508,2023-11-27,708,sketchpen,15,40,25,1,00475,India
354761,2023-11-27,702,pencil,2,5,3,2,00313,India
647468,2023-11-27,716,printing paper,200,400,200,1,00416,India
852197,2023-11-27,714,carbon paper,15,30,15,1,00020,India
852197,2023-11-27,716,printing paper,200,400,200,1,00020,India
852197,2023-11-27,701,gel pen,5,10,5,2,00020,India
892688,2023-11-27,705,stencil,10,20,10,2,00236,India
892688,2023-11-27,702,pencil,2,5,3,2,00236,India
892688,2023-11-27,712,graph paper,20,40,20,1,00236,India
665054,2023-11-27,706,sharpener,3,8,5,2,00068,India
665054,2023-11-27,707,marker,20,40,20,1,00068,India
665054,2023-11-27,717,spiral bound book,50,100,50,1,00068,India
638776,2023-11-27,701,gel pen,5,10,5,2,00364,India
266170,2023-11-27,709,notebook,30,60,30,2,00205,India
266170,2023-11-27,716,printing paper,200,400,200,1,00205,India
223811,2023-11-27,701,gel pen,5,10,5,2,00232,India
223811,2023-11-27,705,stencil,10,20,10,2,00232,India
223811,2023-11-27,715,folder,5,15,10,1,00232,India
673286,2023-11-27,707,marker,20,40,20,1,00491,India
673286,2023-11-27,706,sharpener,3,8,5,2,00491,India
673286,2023-11-27,714,carbon paper,15,30,15,1,00491,India
673286,2023-11-27,701,gel pen,5,10,5,2,00491,India
640251,2023-11-27,707,marker,20,40,20,1,00272,India
640251,2023-11-27,709,notebook,30,60,30,2,00272,India
640251,2023-11-27,708,sketchpen,15,40,25,1,00272,India
640251,2023-11-27,703,eraser,1,3,2,2,00272,India
640251,2023-11-27,704,scale,5,10,5,2,00272,India
450061,2023-11-27,713,ball pen,5,10,5,2,00111,India
450061,2023-11-27,711,TD kit,150,300,150,1,00111,India
612201,2023-11-27,703,eraser,1,3,2,2,00141,India
113675,2023-11-27,715,folder,5,15,10,1,00305,India
113675,2023-11-27,707,marker,20,40,20,1,00305,India
113675,2023-11-27,705,stencil,10,20,10,2,00305,India
113675,2023-11-27,710,geometry box,100,150,50,2,00305,India
113675,2023-11-27,702,pencil,2,5,3,2,00305,India
455289,2023-11-27,712,graph paper,20,40,20,1,00108,India
455289,2023-11-27,709,notebook,30,60,30,2,00108,India
788812,2023-11-28,711,TD kit,150,300,150,1,00321,India
788812,2023-11-28,707,marker,20,40,20,1,00321,India
788812,2023-11-28,703,eraser,1,3,2,2,00321,India
116418,2023-11-28,710,geometry box,100,150,50,2,00174,India
116418,2023-11-28,713,ball pen,5,10,5,2,00174,India
585292,2023-11-28,716,printing paper,200,400,200,1,00140,India
585292,2023-11-28,708,sketchpen,15,40,25,1,00140,India
585292,2023-11-28,704,scale,5,10,5,2,00140,India
585292,2023-11-28,705,stencil,10,20,10,2,00140,India
730398,2023-11-28,702,pencil,2,5,3,2,00134,India
730398,2023-11-28,711,TD kit,150,300,150,1,00134,India
730398,2023-11-28,703,eraser,1,3,2,2,00134,India
228143,2023-11-28,704,scale,5,10,5,2,00470,India
228143,2023-11-28,714,carbon paper,15,30,15,1,00470,India
228143,2023-11-28,717,spiral bound book,50,100,50,1,00470,India
228143,2023-11-28,708,sketchpen,15,40,25,1,00470,India
811881,2023-11-28,716,printing paper,200,400,200,1,00040,India
811881,2023-11-28,704,scale,5,10,5,2,00040,India
811881,2023-11-28,713,ball pen,5,10,5,2,00040,India
157759,2023-11-28,714,carbon paper,15,30,15,1,00314,India
402553,2023-11-28,706,sharpener,3,8,5,2,00394,India
867577,2023-11-28,717,spiral bound book,50,100,50,1,00240,India
867577,2023-11-28,707,marker,20,40,20,1,00240,India
867577,2023-11-28,713,ball pen,5,10,5,2,00240,India
508719,2023-11-28,705,stencil,10,20,10,2,00491,India
508719,2023-11-28,714,carbon paper,15,30,15,1,00491,India
508719,2023-11-28,703,eraser,1,3,2,2,00491,India
508719,2023-11-28,708,sketchpen,15,40,25,1,00491,India
508719,2023-11-28,701,gel pen,5,10,5,2,00491,India
187177,2023-11-28,714,carbon paper,15,30,15,1,00364,India
637181,2023-11-28,711,TD kit,150,300,150,1,00384,India
687922,2023-11-28,713,ball pen,5,10,5,2,00279,India
687922,2023-11-28,701,gel pen,5,10,5,2,00279,India
687922,2023-11-28,712,graph paper,20,40,20,1,00279,India
687922,2023-11-28,707,marker,20,40,20,1,00279,India
183133,2023-11-28,705,stencil,10,20,10,2,00311,India
350807,2023-11-28,713,ball pen,5,10,5,2,00358,India
790204,2023-11-28,708,sketchpen,15,40,25,1,00319,India
790204,2023-11-28,706,sharpener,3,8,5,2,00319,India
790204,2023-11-28,714,carbon paper,15,30,15,1,00319,India
790204,2023-11-28,703,eraser,1,3,2,2,00319,India
790204,2023-11-28,702,pencil,2,5,3,2,00319,India
394321,2023-11-28,716,printing paper,200,400,200,1,00170,India
636052,2023-11-28,703,eraser,1,3,2,2,00091,India
636052,2023-11-28,709,notebook,30,60,30,2,00091,India
636052,2023-11-28,710,geometry box,100,150,50,2,00091,India
636052,2023-11-28,708,sketchpen,15,40,25,1,00091,India
949634,2023-11-28,703,eraser,1,3,2,2,00065,India
949634,2023-11-28,705,stencil,10,20,10,2,00065,India
949634,2023-11-28,713,ball pen,5,10,5,2,00065,India
101335,2023-11-28,710,geometry box,100,150,50,2,00141,India
101335,2023-11-28,714,carbon paper,15,30,15,1,00141,India
101335,2023-11-28,705,stencil,10,20,10,2,00141,India
101335,2023-11-28,703,eraser,1,3,2,2,00141,India
805033,2023-11-28,707,marker,20,40,20,1,00122,India
805033,2023-11-28,714,carbon paper,15,30,15,1,00122,India
556792,2023-11-28,714,carbon paper,15,30,15,1,00089,India
556792,2023-11-28,706,sharpener,3,8,5,2,00089,India
715852,2023-11-28,717,spiral bound book,50,100,50,1,00066,India
715852,2023-11-28,714,carbon paper,15,30,15,1,00066,India
715852,2023-11-28,702,pencil,2,5,3,2,00066,India
715852,2023-11-28,705,stencil,10,20,10,2,00066,India
223714,2023-11-28,706,sharpener,3,8,5,2,00003,India
223714,2023-11-28,712,graph paper,20,40,20,1,00003,India
223714,2023-11-28,715,folder,5,15,10,1,00003,India
223714,2023-11-28,701,gel pen,5,10,5,2,00003,India
382750,2023-11-28,713,ball pen,5,10,5,2,00100,India
382750,2023-11-28,709,notebook,30,60,30,2,00100,India
382750,2023-11-28,706,sharpener,3,8,5,2,00100,India
420676,2023-11-28,704,scale,5,10,5,2,00016,India
420676,2023-11-28,701,gel pen,5,10,5,2,00016,India
420676,2023-11-28,715,folder,5,15,10,1,00016,India
420676,2023-11-28,712,graph paper,20,40,20,1,00016,India
304951,2023-11-28,712,graph paper,20,40,20,1,00138,India
304951,2023-11-28,717,spiral bound book,50,100,50,1,00138,India
304951,2023-11-28,705,stencil,10,20,10,2,00138,India
920213,2023-11-28,703,eraser,1,3,2,2,00054,India
920213,2023-11-28,717,spiral bound book,50,100,50,1,00054,India
920213,2023-11-28,707,marker,20,40,20,1,00054,India
488603,2023-11-28,711,TD kit,150,300,150,1,00141,India
488603,2023-11-28,713,ball pen,5,10,5,2,00141,India
260187,2023-11-28,704,scale,5,10,5,2,00050,India
260187,2023-11-28,703,eraser,1,3,2,2,00050,India
260187,2023-11-28,716,printing paper,200,400,200,1,00050,India
886681,2023-11-28,702,pencil,2,5,3,2,00382,India
420958,2023-11-28,701,gel pen,5,10,5,2,00466,India
420958,2023-11-28,713,ball pen,5,10,5,2,00466,India
835289,2023-11-28,711,TD kit,150,300,150,1,00386,India
973641,2023-11-28,701,gel pen,5,10,5,2,00413,India
973641,2023-11-28,714,carbon paper,15,30,15,1,00413,India
973641,2023-11-28,705,stencil,10,20,10,2,00413,India
973641,2023-11-28,709,notebook,30,60,30,2,00413,India
846174,2023-11-28,713,ball pen,5,10,5,2,00232,India
846174,2023-11-28,704,scale,5,10,5,2,00232,India
363865,2023-11-28,705,stencil,10,20,10,2,00128,India
363865,2023-11-28,701,gel pen,5,10,5,2,00128,India
363865,2023-11-28,713,ball pen,5,10,5,2,00128,India
363865,2023-11-28,715,folder,5,15,10,1,00128,India
250920,2023-11-28,712,graph paper,20,40,20,1,00484,India
854224,2023-11-28,717,spiral bound book,50,100,50,1,00366,India
714099,2023-11-28,710,geometry box,100,150,50,2,00329,India
650833,2023-11-28,710,geometry box,100,150,50,2,00365,India
650833,2023-11-28,712,graph paper,20,40,20,1,00365,India
715909,2023-11-28,715,folder,5,15,10,1,00161,India
715909,2023-11-28,712,graph paper,20,40,20,1,00161,India
951717,2023-11-28,716,printing paper,200,400,200,1,00466,India
951717,2023-11-28,713,ball pen,5,10,5,2,00466,India
951717,2023-11-28,704,scale,5,10,5,2,00466,India
769696,2023-11-28,708,sketchpen,15,40,25,1,00080,India
769696,2023-11-28,706,sharpener,3,8,5,2,00080,India
769696,2023-11-28,710,geometry box,100,150,50,2,00080,India
481114,2023-11-29,713,ball pen,5,10,5,2,00099,India
481114,2023-11-29,717,spiral bound book,50,100,50,1,00099,India
481114,2023-11-29,703,eraser,1,3,2,2,00099,India
587078,2023-11-29,710,geometry box,100,150,50,2,00418,India
397231,2023-11-29,711,TD kit,150,300,150,1,00323,India
397231,2023-11-29,712,graph paper,20,40,20,1,00323,India
397231,2023-11-29,708,sketchpen,15,40,25,1,00323,India
889807,2023-11-29,709,notebook,30,60,30,2,00090,India
798292,2023-11-29,702,pencil,2,5,3,2,00141,India
798292,2023-11-29,704,scale,5,10,5,2,00141,India
993414,2023-11-29,705,stencil,10,20,10,2,00459,India
993414,2023-11-29,714,carbon paper,15,30,15,1,00459,India
993414,2023-11-29,707,marker,20,40,20,1,00459,India
857079,2023-11-29,715,folder,5,15,10,1,00043,India
442936,2023-11-29,708,sketchpen,15,40,25,1,00258,India
926623,2023-11-29,702,pencil,2,5,3,2,00266,India
926623,2023-11-29,705,stencil,10,20,10,2,00266,India
926623,2023-11-29,703,eraser,1,3,2,2,00266,India
926623,2023-11-29,712,graph paper,20,40,20,1,00266,India
926623,2023-11-29,710,geometry box,100,150,50,2,00266,India
355591,2023-11-29,708,sketchpen,15,40,25,1,00101,India
355591,2023-11-29,701,gel pen,5,10,5,2,00101,India
355591,2023-11-29,703,eraser,1,3,2,2,00101,India
211678,2023-11-29,715,folder,5,15,10,1,00022,India
211678,2023-11-29,706,sharpener,3,8,5,2,00022,India
211678,2023-11-29,702,pencil,2,5,3,2,00022,India
211678,2023-11-29,717,spiral bound book,50,100,50,1,00022,India
211678,2023-11-29,713,ball pen,5,10,5,2,00022,India
934401,2023-11-29,706,sharpener,3,8,5,2,00125,India
934401,2023-11-29,709,notebook,30,60,30,2,00125,India
934401,2023-11-29,711,TD kit,150,300,150,1,00125,India
914371,2023-11-29,707,marker,20,40,20,1,00062,India
914371,2023-11-29,713,ball pen,5,10,5,2,00062,India
914371,2023-11-29,716,printing paper,200,400,200,1,00062,India
914371,2023-11-29,709,notebook,30,60,30,2,00062,India
696731,2023-11-29,708,sketchpen,15,40,25,1,00227,India
696731,2023-11-29,715,folder,5,15,10,1,00227,India
696731,2023-11-29,714,carbon paper,15,30,15,1,00227,India
696731,2023-11-29,706,sharpener,3,8,5,2,00227,India
103113,2023-11-29,713,ball pen,5,10,5,2,00300,India
103113,2023-11-29,707,marker,20,40,20,1,00300,India
103113,2023-11-29,710,geometry box,100,150,50,2,00300,India
103113,2023-11-29,716,printing paper,200,400,200,1,00300,India
506424,2023-11-29,708,sketchpen,15,40,25,1,00303,India
506424,2023-11-29,715,folder,5,15,10,1,00303,India
506424,2023-11-29,702,pencil,2,5,3,2,00303,India
506424,2023-11-29,701,gel pen,5,10,5,2,00303,India
506424,2023-11-29,707,marker,20,40,20,1,00303,India
313241,2023-11-29,703,eraser,1,3,2,2,00280,India
313241,2023-11-29,708,sketchpen,15,40,25,1,00280,India
286607,2023-11-29,709,notebook,30,60,30,2,00484,India
286607,2023-11-29,702,pencil,2,5,3,2,00484,India
286607,2023-11-29,710,geometry box,100,150,50,2,00484,India
655127,2023-11-29,713,ball pen,5,10,5,2,00302,India
655127,2023-11-29,702,pencil,2,5,3,2,00302,India
655127,2023-11-29,711,TD kit,150,300,150,1,00302,India
209349,2023-11-29,711,TD kit,150,300,150,1,00120,India
209349,2023-11-29,701,gel pen,5,10,5,2,00120,India
209349,2023-11-29,709,notebook,30,60,30,2,00120,India
209349,2023-11-29,717,spiral bound book,50,100,50,1,00120,India
209349,2023-11-29,714,carbon paper,15,30,15,1,00120,India
546147,2023-11-29,717,spiral bound book,50,100,50,1,00130,India
546147,2023-11-29,714,carbon paper,15,30,15,1,00130,India
546147,2023-11-29,706,sharpener,3,8,5,2,00130,India
546147,2023-11-29,707,marker,20,40,20,1,00130,India
549841,2023-11-29,701,gel pen,5,10,5,2,00332,India
549841,2023-11-29,710,geometry box,100,150,50,2,00332,India
549841,2023-11-29,709,notebook,30,60,30,2,00332,India
549841,2023-11-29,702,pencil,2,5,3,2,00332,India
549841,2023-11-29,706,sharpener,3,8,5,2,00332,India
232297,2023-11-29,705,stencil,10,20,10,2,00103,India
232297,2023-11-29,711,TD kit,150,300,150,1,00103,India
232297,2023-11-29,702,pencil,2,5,3,2,00103,India
232297,2023-11-29,713,ball pen,5,10,5,2,00103,India
480084,2023-11-29,710,geometry box,100,150,50,2,00090,India
480084,2023-11-29,706,sharpener,3,8,5,2,00090,India
480084,2023-11-29,704,scale,5,10,5,2,00090,India
398160,2023-11-29,717,spiral bound book,50,100,50,1,00013,India
398160,2023-11-29,715,folder,5,15,10,1,00013,India
398160,2023-11-29,714,carbon paper,15,30,15,1,00013,India
194281,2023-11-29,704,scale,5,10,5,2,00358,India
439825,2023-11-29,705,stencil,10,20,10,2,00089,India
439825,2023-11-29,710,geometry box,100,150,50,2,00089,India
439825,2023-11-29,706,sharpener,3,8,5,2,00089,India
778794,2023-11-29,701,gel pen,5,10,5,2,00293,India
778794,2023-11-29,707,marker,20,40,20,1,00293,India
778794,2023-11-29,712,graph paper,20,40,20,1,00293,India
973260,2023-11-29,708,sketchpen,15,40,25,1,00360,India
973260,2023-11-29,711,TD kit,150,300,150,1,00360,India
973260,2023-11-29,701,gel pen,5,10,5,2,00360,India
418756,2023-11-29,711,TD kit,150,300,150,1,00426,India
418756,2023-11-29,703,eraser,1,3,2,2,00426,India
418756,2023-11-29,714,carbon paper,15,30,15,1,00426,India
749258,2023-11-29,703,eraser,1,3,2,2,00372,India
749258,2023-11-29,715,folder,5,15,10,1,00372,India
749258,2023-11-29,707,marker,20,40,20,1,00372,India
749258,2023-11-29,709,notebook,30,60,30,2,00372,India
882788,2023-11-29,709,notebook,30,60,30,2,00186,India
288334,2023-11-29,714,carbon paper,15,30,15,1,00283,India
288334,2023-11-29,715,folder,5,15,10,1,00283,India
288334,2023-11-29,705,stencil,10,20,10,2,00283,India
288334,2023-11-29,716,printing paper,200,400,200,1,00283,India
481407,2023-11-29,715,folder,5,15,10,1,00160,India
481407,2023-11-29,707,marker,20,40,20,1,00160,India
344726,2023-11-29,713,ball pen,5,10,5,2,00459,India
344726,2023-11-29,717,spiral bound book,50,100,50,1,00459,India
344726,2023-11-29,710,geometry box,100,150,50,2,00459,India
344726,2023-11-29,714,carbon paper,15,30,15,1,00459,India
227280,2023-11-29,715,folder,5,15,10,1,00114,India
265966,2023-11-29,707,marker,20,40,20,1,00460,India
265966,2023-11-29,710,geometry box,100,150,50,2,00460,India
265966,2023-11-29,711,TD kit,150,300,150,1,00460,India
181191,2023-11-29,709,notebook,30,60,30,2,00320,India
181191,2023-11-29,712,graph paper,20,40,20,1,00320,India
809453,2023-11-29,709,notebook,30,60,30,2,00431,India
809453,2023-11-29,707,marker,20,40,20,1,00431,India
800235,2023-11-29,707,marker,20,40,20,1,00452,India
800235,2023-11-29,701,gel pen,5,10,5,2,00452,India
800235,2023-11-29,706,sharpener,3,8,5,2,00452,India
800235,2023-11-29,709,notebook,30,60,30,2,00452,India
234033,2023-11-29,714,carbon paper,15,30,15,1,00454,India
234033,2023-11-29,717,spiral bound book,50,100,50,1,00454,India
234033,2023-11-29,703,eraser,1,3,2,2,00454,India
234033,2023-11-29,715,folder,5,15,10,1,00454,India
646214,2023-11-29,708,sketchpen,15,40,25,1,00189,India
646214,2023-11-29,713,ball pen,5,10,5,2,00189,India
716788,2023-11-29,703,eraser,1,3,2,2,00037,India
279750,2023-11-29,705,stencil,10,20,10,2,00378,India
279750,2023-11-29,709,notebook,30,60,30,2,00378,India
279750,2023-11-29,712,graph paper,20,40,20,1,00378,India
279750,2023-11-29,702,pencil,2,5,3,2,00378,India
279750,2023-11-29,714,carbon paper,15,30,15,1,00378,India
808025,2023-11-29,710,geometry box,100,150,50,2,00440,India
808025,2023-11-29,703,eraser,1,3,2,2,00440,India
808025,2023-11-29,716,printing paper,200,400,200,1,00440,India
619949,2023-11-29,709,notebook,30,60,30,2,00262,India
619949,2023-11-29,707,marker,20,40,20,1,00262,India
619949,2023-11-29,706,sharpener,3,8,5,2,00262,India
619949,2023-11-29,714,carbon paper,15,30,15,1,00262,India
958493,2023-11-29,705,stencil,10,20,10,2,00488,India
958493,2023-11-29,703,eraser,1,3,2,2,00488,India
958493,2023-11-29,715,folder,5,15,10,1,00488,India
569842,2023-11-30,701,gel pen,5,10,5,2,00178,India
995670,2023-11-30,702,pencil,2,5,3,2,00160,India
995670,2023-11-30,711,TD kit,150,300,150,1,00160,India
995670,2023-11-30,707,marker,20,40,20,1,00160,India
995670,2023-11-30,708,sketchpen,15,40,25,1,00160,India
646047,2023-11-30,715,folder,5,15,10,1,00141,India
646047,2023-11-30,702,pencil,2,5,3,2,00141,India
646047,2023-11-30,714,carbon paper,15,30,15,1,00141,India
646047,2023-11-30,712,graph paper,20,40,20,1,00141,India
818550,2023-11-30,707,marker,20,40,20,1,00067,India
818550,2023-11-30,713,ball pen,5,10,5,2,00067,India
109556,2023-11-30,714,carbon paper,15,30,15,1,00201,India
109556,2023-11-30,712,graph paper,20,40,20,1,00201,India
109556,2023-11-30,717,spiral bound book,50,100,50,1,00201,India
109556,2023-11-30,707,marker,20,40,20,1,00201,India
241555,2023-11-30,711,TD kit,150,300,150,1,00408,India
241555,2023-11-30,716,printing paper,200,400,200,1,00408,India
241555,2023-11-30,713,ball pen,5,10,5,2,00408,India
431995,2023-11-30,712,graph paper,20,40,20,1,00495,India
431995,2023-11-30,715,folder,5,15,10,1,00495,India
431995,2023-11-30,711,TD kit,150,300,150,1,00495,India
431995,2023-11-30,701,gel pen,5,10,5,2,00495,India
205214,2023-11-30,711,TD kit,150,300,150,1,00175,India
205214,2023-11-30,713,ball pen,5,10,5,2,00175,India
774404,2023-11-30,711,TD kit,150,300,150,1,00403,India
774404,2023-11-30,710,geometry box,100,150,50,2,00403,India
774404,2023-11-30,707,marker,20,40,20,1,00403,India
188058,2023-11-30,714,carbon paper,15,30,15,1,00149,India
188058,2023-11-30,716,printing paper,200,400,200,1,00149,India
188058,2023-11-30,708,sketchpen,15,40,25,1,00149,India
630512,2023-11-30,710,geometry box,100,150,50,2,00169,India
630512,2023-11-30,712,graph paper,20,40,20,1,00169,India
630512,2023-11-30,702,pencil,2,5,3,2,00169,India
630512,2023-11-30,701,gel pen,5,10,5,2,00169,India
213142,2023-11-30,715,folder,5,15,10,1,00407,India
109149,2023-11-30,707,marker,20,40,20,1,00210,India
109149,2023-11-30,704,scale,5,10,5,2,00210,India
109149,2023-11-30,715,folder,5,15,10,1,00210,India
801820,2023-11-30,708,sketchpen,15,40,25,1,00360,India
801820,2023-11-30,715,folder,5,15,10,1,00360,India
801820,2023-11-30,707,marker,20,40,20,1,00360,India
136469,2023-11-30,710,geometry box,100,150,50,2,00124,India
136469,2023-11-30,712,graph paper,20,40,20,1,00124,India
136469,2023-11-30,701,gel pen,5,10,5,2,00124,India
586881,2023-11-30,715,folder,5,15,10,1,00230,India
404071,2023-11-30,717,spiral bound book,50,100,50,1,00354,India
404071,2023-11-30,702,pencil,2,5,3,2,00354,India
404071,2023-11-30,705,stencil,10,20,10,2,00354,India
219538,2023-11-30,702,pencil,2,5,3,2,00293,India
219538,2023-11-30,717,spiral bound book,50,100,50,1,00293,India
219538,2023-11-30,713,ball pen,5,10,5,2,00293,India
219538,2023-11-30,705,stencil,10,20,10,2,00293,India
356327,2023-11-30,708,sketchpen,15,40,25,1,00088,India
356327,2023-11-30,701,gel pen,5,10,5,2,00088,India
525337,2023-11-30,713,ball pen,5,10,5,2,00445,India
525337,2023-11-30,715,folder,5,15,10,1,00445,India
447673,2023-11-30,712,graph paper,20,40,20,1,00183,India
447673,2023-11-30,713,ball pen,5,10,5,2,00183,India
447673,2023-11-30,701,gel pen,5,10,5,2,00183,India
447673,2023-11-30,702,pencil,2,5,3,2,00183,India
447673,2023-11-30,706,sharpener,3,8,5,2,00183,India
748056,2023-11-30,704,scale,5,10,5,2,00231,India
973213,2023-11-30,706,sharpener,3,8,5,2,00198,India
973213,2023-11-30,716,printing paper,200,400,200,1,00198,India
973213,2023-11-30,715,folder,5,15,10,1,00198,India
973213,2023-11-30,702,pencil,2,5,3,2,00198,India
785789,2023-11-30,702,pencil,2,5,3,2,00091,India
785789,2023-11-30,717,spiral bound book,50,100,50,1,00091,India
941767,2023-11-30,717,spiral bound book,50,100,50,1,00007,India
941767,2023-11-30,705,stencil,10,20,10,2,00007,India
279919,2023-11-30,710,geometry box,100,150,50,2,00002,India
896265,2023-11-30,703,eraser,1,3,2,2,00003,India
513456,2023-11-30,711,TD kit,150,300,150,1,00113,India
513456,2023-11-30,706,sharpener,3,8,5,2,00113,India
651575,2023-11-30,707,marker,20,40,20,1,00339,India
651575,2023-11-30,706,sharpener,3,8,5,2,00339,India
830472,2023-11-30,716,printing paper,200,400,200,1,00026,India
830472,2023-11-30,713,ball pen,5,10,5,2,00026,India
830472,2023-11-30,702,pencil,2,5,3,2,00026,India
848092,2023-11-30,701,gel pen,5,10,5,2,00496,India
848092,2023-11-30,702,pencil,2,5,3,2,00496,India
795866,2023-11-30,716,printing paper,200,400,200,1,00104,India
795866,2023-11-30,701,gel pen,5,10,5,2,00104,India
505160,2023-11-30,712,graph paper,20,40,20,1,00281,India
272706,2023-11-30,708,sketchpen,15,40,25,1,00201,India
272706,2023-11-30,706,sharpener,3,8,5,2,00201,India
772820,2023-11-30,708,sketchpen,15,40,25,1,00226,India
772820,2023-11-30,716,printing paper,200,400,200,1,00226,India
772820,2023-11-30,703,eraser,1,3,2,2,00226,India
744342,2023-12-01,704,scale,5,10,5,1,00122,India
744342,2023-12-01,712,graph paper,20,40,20,1,00122,India
744342,2023-12-01,706,sharpener,3,8,5,1,00122,India
166816,2023-12-01,714,carbon paper,15,30,15,1,00056,India
166816,2023-12-01,715,folder,5,15,10,1,00056,India
768891,2023-12-01,714,carbon paper,15,30,15,1,00484,India
372220,2023-12-01,702,pencil,2,5,3,1,00183,India
372220,2023-12-01,710,geometry box,100,150,50,1,00183,India
967320,2023-12-01,703,eraser,1,3,2,1,00285,India
811780,2023-12-01,701,gel pen,5,10,5,1,00064,India
811780,2023-12-01,715,folder,5,15,10,1,00064,India
811780,2023-12-01,709,notebook,30,60,30,1,00064,India
730913,2023-12-01,712,graph paper,20,40,20,1,00020,India
238137,2023-12-01,703,eraser,1,3,2,1,00134,India
238137,2023-12-01,704,scale,5,10,5,1,00134,India
238137,2023-12-01,716,printing paper,200,400,200,1,00134,India
364781,2023-12-01,711,TD kit,150,300,150,1,00334,India
364781,2023-12-01,713,ball pen,5,10,5,1,00334,India
364781,2023-12-01,715,folder,5,15,10,1,00334,India
364781,2023-12-01,707,marker,20,40,20,1,00334,India
105508,2023-12-01,704,scale,5,10,5,1,00228,India
105508,2023-12-01,712,graph paper,20,40,20,1,00228,India
105508,2023-12-01,705,stencil,10,20,10,1,00228,India
376546,2023-12-01,710,geometry box,100,150,50,1,00220,India
376546,2023-12-01,705,stencil,10,20,10,1,00220,India
376546,2023-12-01,712,graph paper,20,40,20,1,00220,India
654510,2023-12-01,710,geometry box,100,150,50,1,00326,India
654510,2023-12-01,708,sketchpen,15,40,25,1,00326,India
654510,2023-12-01,709,notebook,30,60,30,1,00326,India
654510,2023-12-01,701,gel pen,5,10,5,1,00326,India
647214,2023-12-01,701,gel pen,5,10,5,1,00278,India
647214,2023-12-01,707,marker,20,40,20,1,00278,India
671660,2023-12-01,709,notebook,30,60,30,1,00014,India
671660,2023-12-01,714,carbon paper,15,30,15,1,00014,India
906709,2023-12-01,701,gel pen,5,10,5,1,00253,India
911745,2023-12-01,709,notebook,30,60,30,1,00002,India
951773,2023-12-01,701,gel pen,5,10,5,1,00182,India
951773,2023-12-01,707,marker,20,40,20,1,00182,India
265088,2023-12-01,710,geometry box,100,150,50,1,00474,India
265088,2023-12-01,711,TD kit,150,300,150,1,00474,India
265088,2023-12-01,712,graph paper,20,40,20,1,00474,India
272188,2023-12-01,706,sharpener,3,8,5,1,00193,India
272188,2023-12-01,714,carbon paper,15,30,15,1,00193,India
272188,2023-12-01,704,scale,5,10,5,1,00193,India
272188,2023-12-01,701,gel pen,5,10,5,1,00193,India
919318,2023-12-01,706,sharpener,3,8,5,1,00030,India
629739,2023-12-01,702,pencil,2,5,3,1,00215,India
485142,2023-12-01,713,ball pen,5,10,5,1,00427,India
485142,2023-12-01,705,stencil,10,20,10,1,00427,India
947951,2023-12-01,708,sketchpen,15,40,25,1,00213,India
947951,2023-12-01,717,spiral bound book,50,100,50,1,00213,India
255070,2023-12-01,712,graph paper,20,40,20,1,00411,India
255070,2023-12-01,717,spiral bound book,50,100,50,1,00411,India
730395,2023-12-01,708,sketchpen,15,40,25,1,00436,India
730395,2023-12-01,706,sharpener,3,8,5,1,00436,India
730395,2023-12-01,701,gel pen,5,10,5,1,00436,India
817480,2023-12-01,704,scale,5,10,5,1,00122,India
817480,2023-12-01,709,notebook,30,60,30,1,00122,India
979956,2023-12-01,711,TD kit,150,300,150,1,00347,India
979956,2023-12-01,713,ball pen,5,10,5,1,00347,India
979956,2023-12-01,709,notebook,30,60,30,1,00347,India
979956,2023-12-01,706,sharpener,3,8,5,1,00347,India
735068,2023-12-01,703,eraser,1,3,2,1,00408,India
735068,2023-12-01,716,printing paper,200,400,200,1,00408,India
603265,2023-12-01,703,eraser,1,3,2,1,00358,India
425871,2023-12-01,710,geometry box,100,150,50,1,00106,India
425871,2023-12-01,703,eraser,1,3,2,1,00106,India
845315,2023-12-01,707,marker,20,40,20,1,00137,India
845315,2023-12-01,706,sharpener,3,8,5,1,00137,India
845315,2023-12-01,713,ball pen,5,10,5,1,00137,India
845315,2023-12-01,705,stencil,10,20,10,1,00137,India
487211,2023-12-01,708,sketchpen,15,40,25,1,00018,India
213184,2023-12-01,710,geometry box,100,150,50,1,00136,India
213184,2023-12-01,709,notebook,30,60,30,1,00136,India
187699,2023-12-01,714,carbon paper,15,30,15,1,00054,India
742205,2023-12-01,710,geometry box,100,150,50,1,00471,India
742205,2023-12-01,715,folder,5,15,10,1,00471,India
308681,2023-12-01,716,printing paper,200,400,200,1,00322,India
308681,2023-12-01,703,eraser,1,3,2,1,00322,India
308681,2023-12-01,710,geometry box,100,150,50,1,00322,India
308681,2023-12-01,709,notebook,30,60,30,1,00322,India
460343,2023-12-01,716,printing paper,200,400,200,1,00265,India
460343,2023-12-01,713,ball pen,5,10,5,1,00265,India
315418,2023-12-01,716,printing paper,200,400,200,1,00079,India
285332,2023-12-02,710,geometry box,100,150,50,1,00287,India
285332,2023-12-02,711,TD kit,150,300,150,1,00287,India
176938,2023-12-02,702,pencil,2,5,3,1,00265,India
176938,2023-12-02,709,notebook,30,60,30,1,00265,India
176938,2023-12-02,704,scale,5,10,5,1,00265,India
176938,2023-12-02,717,spiral bound book,50,100,50,1,00265,India
176938,2023-12-02,705,stencil,10,20,10,1,00265,India
531202,2023-12-02,707,marker,20,40,20,1,00268,India
531202,2023-12-02,704,scale,5,10,5,1,00268,India
794659,2023-12-02,712,graph paper,20,40,20,1,00408,India
794659,2023-12-02,707,marker,20,40,20,1,00408,India
768699,2023-12-02,701,gel pen,5,10,5,1,00441,India
242521,2023-12-02,705,stencil,10,20,10,1,00330,India
242521,2023-12-02,704,scale,5,10,5,1,00330,India
242521,2023-12-02,711,TD kit,150,300,150,1,00330,India
242521,2023-12-02,717,spiral bound book,50,100,50,1,00330,India
551994,2023-12-02,711,TD kit,150,300,150,1,00138,India
551994,2023-12-02,702,pencil,2,5,3,1,00138,India
551994,2023-12-02,706,sharpener,3,8,5,1,00138,India
551994,2023-12-02,709,notebook,30,60,30,1,00138,India
530149,2023-12-02,712,graph paper,20,40,20,1,00475,India
338739,2023-12-02,702,pencil,2,5,3,1,00496,India
338739,2023-12-02,701,gel pen,5,10,5,1,00496,India
890118,2023-12-02,713,ball pen,5,10,5,1,00262,India
218262,2023-12-02,707,marker,20,40,20,1,00208,India
218262,2023-12-02,704,scale,5,10,5,1,00208,India
357765,2023-12-02,705,stencil,10,20,10,1,00422,India
357765,2023-12-02,707,marker,20,40,20,1,00422,India
357765,2023-12-02,715,folder,5,15,10,1,00422,India
345423,2023-12-02,704,scale,5,10,5,1,00423,India
345423,2023-12-02,708,sketchpen,15,40,25,1,00423,India
369269,2023-12-02,708,sketchpen,15,40,25,1,00081,India
369269,2023-12-02,716,printing paper,200,400,200,1,00081,India
369269,2023-12-02,706,sharpener,3,8,5,1,00081,India
369269,2023-12-02,702,pencil,2,5,3,1,00081,India
581910,2023-12-02,701,gel pen,5,10,5,1,00371,India
695438,2023-12-02,709,notebook,30,60,30,1,00326,India
695438,2023-12-02,717,spiral bound book,50,100,50,1,00326,India
695438,2023-12-02,701,gel pen,5,10,5,1,00326,India
738911,2023-12-02,710,geometry box,100,150,50,1,00051,India
894473,2023-12-02,707,marker,20,40,20,1,00387,India
894473,2023-12-02,711,TD kit,150,300,150,1,00387,India
846851,2023-12-02,714,carbon paper,15,30,15,1,00332,India
846851,2023-12-02,709,notebook,30,60,30,1,00332,India
678327,2023-12-02,703,eraser,1,3,2,1,00394,India
678327,2023-12-02,702,pencil,2,5,3,1,00394,India
678327,2023-12-02,701,gel pen,5,10,5,1,00394,India
919809,2023-12-02,715,folder,5,15,10,1,00059,India
919809,2023-12-02,712,graph paper,20,40,20,1,00059,India
919809,2023-12-02,710,geometry box,100,150,50,1,00059,India
311279,2023-12-02,706,sharpener,3,8,5,1,00230,India
311279,2023-12-02,708,sketchpen,15,40,25,1,00230,India
406294,2023-12-02,713,ball pen,5,10,5,1,00255,India
425110,2023-12-02,712,graph paper,20,40,20,1,00130,India
425110,2023-12-02,717,spiral bound book,50,100,50,1,00130,India
425110,2023-12-02,710,geometry box,100,150,50,1,00130,India
879971,2023-12-02,716,printing paper,200,400,200,1,00145,India
879971,2023-12-02,711,TD kit,150,300,150,1,00145,India
879971,2023-12-02,708,sketchpen,15,40,25,1,00145,India
473173,2023-12-02,714,carbon paper,15,30,15,1,00401,India
473173,2023-12-02,706,sharpener,3,8,5,1,00401,India
473173,2023-12-02,704,scale,5,10,5,1,00401,India
473173,2023-12-02,712,graph paper,20,40,20,1,00401,India
696584,2023-12-02,716,printing paper,200,400,200,1,00350,India
696584,2023-12-02,704,scale,5,10,5,1,00350,India
696584,2023-12-02,713,ball pen,5,10,5,1,00350,India
696584,2023-12-02,707,marker,20,40,20,1,00350,India
696584,2023-12-02,709,notebook,30,60,30,1,00350,India
447933,2023-12-02,714,carbon paper,15,30,15,1,00171,India
447933,2023-12-02,707,marker,20,40,20,1,00171,India
447933,2023-12-02,715,folder,5,15,10,1,00171,India
226966,2023-12-02,710,geometry box,100,150,50,1,00372,India
226966,2023-12-02,707,marker,20,40,20,1,00372,India
226966,2023-12-02,711,TD kit,150,300,150,1,00372,India
283653,2023-12-02,702,pencil,2,5,3,1,00305,India
283653,2023-12-02,710,geometry box,100,150,50,1,00305,India
430240,2023-12-02,704,scale,5,10,5,1,00181,India
430240,2023-12-02,701,gel pen,5,10,5,1,00181,India
430240,2023-12-02,707,marker,20,40,20,1,00181,India
314209,2023-12-02,713,ball pen,5,10,5,1,00206,India
314209,2023-12-02,715,folder,5,15,10,1,00206,India
314209,2023-12-02,714,carbon paper,15,30,15,1,00206,India
314209,2023-12-02,706,sharpener,3,8,5,1,00206,India
955673,2023-12-02,709,notebook,30,60,30,1,00352,India
955673,2023-12-02,707,marker,20,40,20,1,00352,India
955673,2023-12-02,708,sketchpen,15,40,25,1,00352,India
488610,2023-12-02,708,sketchpen,15,40,25,1,00055,India
488610,2023-12-02,709,notebook,30,60,30,1,00055,India
488610,2023-12-02,707,marker,20,40,20,1,00055,India
147099,2023-12-02,704,scale,5,10,5,1,00041,India
147099,2023-12-02,707,marker,20,40,20,1,00041,India
147099,2023-12-02,715,folder,5,15,10,1,00041,India
538911,2023-12-02,717,spiral bound book,50,100,50,1,00475,India
538911,2023-12-02,710,geometry box,100,150,50,1,00475,India
204440,2023-12-02,713,ball pen,5,10,5,1,00147,India
204440,2023-12-02,710,geometry box,100,150,50,1,00147,India
204440,2023-12-02,715,folder,5,15,10,1,00147,India
204440,2023-12-02,705,stencil,10,20,10,1,00147,India
968074,2023-12-02,705,stencil,10,20,10,1,00360,India
869566,2023-12-02,713,ball pen,5,10,5,1,00381,India
869566,2023-12-02,708,sketchpen,15,40,25,1,00381,India
869566,2023-12-02,704,scale,5,10,5,1,00381,India
869566,2023-12-02,711,TD kit,150,300,150,1,00381,India
264481,2023-12-02,714,carbon paper,15,30,15,1,00482,India
264481,2023-12-02,709,notebook,30,60,30,1,00482,India
801155,2023-12-02,701,gel pen,5,10,5,1,00393,India
801155,2023-12-02,712,graph paper,20,40,20,1,00393,India
801155,2023-12-02,714,carbon paper,15,30,15,1,00393,India
580784,2023-12-03,701,gel pen,5,10,5,1,00469,India
580784,2023-12-03,712,graph paper,20,40,20,1,00469,India
150563,2023-12-03,711,TD kit,150,300,150,1,00455,India
150563,2023-12-03,715,folder,5,15,10,1,00455,India
504156,2023-12-03,705,stencil,10,20,10,1,00236,India
504156,2023-12-03,714,carbon paper,15,30,15,1,00236,India
504156,2023-12-03,707,marker,20,40,20,1,00236,India
504156,2023-12-03,712,graph paper,20,40,20,1,00236,India
122870,2023-12-03,704,scale,5,10,5,1,00011,India
122870,2023-12-03,702,pencil,2,5,3,1,00011,India
122870,2023-12-03,717,spiral bound book,50,100,50,1,00011,India
122870,2023-12-03,714,carbon paper,15,30,15,1,00011,India
874705,2023-12-03,704,scale,5,10,5,1,00140,India
874705,2023-12-03,710,geometry box,100,150,50,1,00140,India
874705,2023-12-03,715,folder,5,15,10,1,00140,India
874705,2023-12-03,701,gel pen,5,10,5,1,00140,India
874705,2023-12-03,708,sketchpen,15,40,25,1,00140,India
787840,2023-12-03,705,stencil,10,20,10,1,00282,India
787840,2023-12-03,714,carbon paper,15,30,15,1,00282,India
787840,2023-12-03,706,sharpener,3,8,5,1,00282,India
787840,2023-12-03,712,graph paper,20,40,20,1,00282,India
109369,2023-12-03,714,carbon paper,15,30,15,1,00212,India
951106,2023-12-03,704,scale,5,10,5,1,00155,India
951106,2023-12-03,716,printing paper,200,400,200,1,00155,India
119561,2023-12-03,709,notebook,30,60,30,1,00295,India
119561,2023-12-03,715,folder,5,15,10,1,00295,India
119561,2023-12-03,704,scale,5,10,5,1,00295,India
644733,2023-12-03,709,notebook,30,60,30,1,00011,India
644733,2023-12-03,713,ball pen,5,10,5,1,00011,India
878380,2023-12-03,715,folder,5,15,10,1,00454,India
878380,2023-12-03,703,eraser,1,3,2,1,00454,India
878380,2023-12-03,714,carbon paper,15,30,15,1,00454,India
878380,2023-12-03,710,geometry box,100,150,50,1,00454,India
494963,2023-12-03,709,notebook,30,60,30,1,00307,India
494963,2023-12-03,705,stencil,10,20,10,1,00307,India
494963,2023-12-03,704,scale,5,10,5,1,00307,India
494963,2023-12-03,712,graph paper,20,40,20,1,00307,India
494963,2023-12-03,706,sharpener,3,8,5,1,00307,India
276652,2023-12-03,713,ball pen,5,10,5,1,00398,India
276652,2023-12-03,709,notebook,30,60,30,1,00398,India
276652,2023-12-03,712,graph paper,20,40,20,1,00398,India
504922,2023-12-03,716,printing paper,200,400,200,1,00045,India
504922,2023-12-03,709,notebook,30,60,30,1,00045,India
813503,2023-12-03,702,pencil,2,5,3,1,00241,India
813503,2023-12-03,703,eraser,1,3,2,1,00241,India
813503,2023-12-03,707,marker,20,40,20,1,00241,India
643095,2023-12-03,714,carbon paper,15,30,15,1,00236,India
643095,2023-12-03,716,printing paper,200,400,200,1,00236,India
643095,2023-12-03,708,sketchpen,15,40,25,1,00236,India
749472,2023-12-03,713,ball pen,5,10,5,1,00421,India
749472,2023-12-03,703,eraser,1,3,2,1,00421,India
749472,2023-12-03,704,scale,5,10,5,1,00421,India
749472,2023-12-03,701,gel pen,5,10,5,1,00421,India
513615,2023-12-03,715,folder,5,15,10,1,00243,India
104374,2023-12-03,708,sketchpen,15,40,25,1,00272,India
948071,2023-12-03,705,stencil,10,20,10,1,00193,India
948071,2023-12-03,717,spiral bound book,50,100,50,1,00193,India
449612,2023-12-03,712,graph paper,20,40,20,1,00028,India
449612,2023-12-03,717,spiral bound book,50,100,50,1,00028,India
738587,2023-12-03,702,pencil,2,5,3,1,00418,India
738587,2023-12-03,707,marker,20,40,20,1,00418,India
719674,2023-12-03,706,sharpener,3,8,5,1,00176,India
719674,2023-12-03,712,graph paper,20,40,20,1,00176,India
719674,2023-12-03,708,sketchpen,15,40,25,1,00176,India
676477,2023-12-03,717,spiral bound book,50,100,50,1,00184,India
719305,2023-12-03,706,sharpener,3,8,5,1,00125,India
368760,2023-12-03,712,graph paper,20,40,20,1,00351,India
368760,2023-12-03,704,scale,5,10,5,1,00351,India
368760,2023-12-03,707,marker,20,40,20,1,00351,India
914500,2023-12-03,705,stencil,10,20,10,1,00311,India
914500,2023-12-03,716,printing paper,200,400,200,1,00311,India
914500,2023-12-03,709,notebook,30,60,30,1,00311,India
914500,2023-12-03,717,spiral bound book,50,100,50,1,00311,India
717037,2023-12-03,702,pencil,2,5,3,1,00245,India
266874,2023-12-03,710,geometry box,100,150,50,1,00210,India
266874,2023-12-03,701,gel pen,5,10,5,1,00210,India
465299,2023-12-03,703,eraser,1,3,2,1,00187,India
465299,2023-12-03,717,spiral bound book,50,100,50,1,00187,India
465299,2023-12-03,716,printing paper,200,400,200,1,00187,India
465299,2023-12-03,714,carbon paper,15,30,15,1,00187,India
465299,2023-12-03,706,sharpener,3,8,5,1,00187,India
903902,2023-12-03,714,carbon paper,15,30,15,1,00306,India
903902,2023-12-03,711,TD kit,150,300,150,1,00306,India
903902,2023-12-03,701,gel pen,5,10,5,1,00306,India
903902,2023-12-03,715,folder,5,15,10,1,00306,India
306665,2023-12-03,704,scale,5,10,5,1,00205,India
306665,2023-12-03,716,printing paper,200,400,200,1,00205,India
306665,2023-12-03,708,sketchpen,15,40,25,1,00205,India
383362,2023-12-03,712,graph paper,20,40,20,1,00445,India
383362,2023-12-03,706,sharpener,3,8,5,1,00445,India
383362,2023-12-03,705,stencil,10,20,10,1,00445,India
656175,2023-12-03,716,printing paper,200,400,200,1,00460,India
656175,2023-12-03,712,graph paper,20,40,20,1,00460,India
551372,2023-12-03,711,TD kit,150,300,150,1,00122,India
551372,2023-12-03,717,spiral bound book,50,100,50,1,00122,India
551372,2023-12-03,716,printing paper,200,400,200,1,00122,India
551372,2023-12-03,710,geometry box,100,150,50,1,00122,India
972143,2023-12-03,702,pencil,2,5,3,1,00130,India
972143,2023-12-03,712,graph paper,20,40,20,1,00130,India
972143,2023-12-03,707,marker,20,40,20,1,00130,India
972143,2023-12-03,710,geometry box,100,150,50,1,00130,India
757729,2023-12-03,714,carbon paper,15,30,15,1,00352,India
757729,2023-12-03,711,TD kit,150,300,150,1,00352,India
757729,2023-12-03,713,ball pen,5,10,5,1,00352,India
757729,2023-12-03,705,stencil,10,20,10,1,00352,India
958630,2023-12-03,711,TD kit,150,300,150,1,00020,India
958630,2023-12-03,705,stencil,10,20,10,1,00020,India
958630,2023-12-03,706,sharpener,3,8,5,1,00020,India
228934,2023-12-03,711,TD kit,150,300,150,1,00119,India
228934,2023-12-03,710,geometry box,100,150,50,1,00119,India
663693,2023-12-03,717,spiral bound book,50,100,50,1,00263,India
663693,2023-12-03,708,sketchpen,15,40,25,1,00263,India
663693,2023-12-03,707,marker,20,40,20,1,00263,India
663693,2023-12-03,706,sharpener,3,8,5,1,00263,India
663693,2023-12-03,705,stencil,10,20,10,1,00263,India
144648,2023-12-03,702,pencil,2,5,3,1,00262,India
144648,2023-12-03,711,TD kit,150,300,150,1,00262,India
144648,2023-12-03,703,eraser,1,3,2,1,00262,India
492364,2023-12-03,707,marker,20,40,20,1,00261,India
492364,2023-12-03,703,eraser,1,3,2,1,00261,India
492364,2023-12-03,705,stencil,10,20,10,1,00261,India
492364,2023-12-03,701,gel pen,5,10,5,1,00261,India
492364,2023-12-03,708,sketchpen,15,40,25,1,00261,India
659662,2023-12-03,704,scale,5,10,5,1,00174,India
659662,2023-12-03,710,geometry box,100,150,50,1,00174,India
659662,2023-12-03,709,notebook,30,60,30,1,00174,India
659662,2023-12-03,705,stencil,10,20,10,1,00174,India
659662,2023-12-03,703,eraser,1,3,2,1,00174,India
895974,2023-12-03,704,scale,5,10,5,1,00266,India
149382,2023-12-03,702,pencil,2,5,3,1,00208,India
149382,2023-12-03,715,folder,5,15,10,1,00208,India
149382,2023-12-03,703,eraser,1,3,2,1,00208,India
989407,2023-12-03,704,scale,5,10,5,1,00175,India
989407,2023-12-03,701,gel pen,5,10,5,1,00175,India
171469,2023-12-03,712,graph paper,20,40,20,1,00326,India
171469,2023-12-03,701,gel pen,5,10,5,1,00326,India
171469,2023-12-03,707,marker,20,40,20,1,00326,India
200890,2023-12-03,709,notebook,30,60,30,1,00149,India
200890,2023-12-03,712,graph paper,20,40,20,1,00149,India
526539,2023-12-03,706,sharpener,3,8,5,1,00111,India
496655,2023-12-04,701,gel pen,5,10,5,1,00381,India
496655,2023-12-04,714,carbon paper,15,30,15,1,00381,India
357308,2023-12-04,710,geometry box,100,150,50,1,00471,India
357308,2023-12-04,717,spiral bound book,50,100,50,1,00471,India
756253,2023-12-04,708,sketchpen,15,40,25,1,00033,India
756253,2023-12-04,710,geometry box,100,150,50,1,00033,India
240146,2023-12-04,714,carbon paper,15,30,15,1,00333,India
240146,2023-12-04,707,marker,20,40,20,1,00333,India
240146,2023-12-04,702,pencil,2,5,3,1,00333,India
691867,2023-12-04,704,scale,5,10,5,1,00029,India
691867,2023-12-04,707,marker,20,40,20,1,00029,India
691867,2023-12-04,715,folder,5,15,10,1,00029,India
691867,2023-12-04,703,eraser,1,3,2,1,00029,India
691867,2023-12-04,717,spiral bound book,50,100,50,1,00029,India
468685,2023-12-04,704,scale,5,10,5,1,00278,India
468685,2023-12-04,715,folder,5,15,10,1,00278,India
468685,2023-12-04,711,TD kit,150,300,150,1,00278,India
935789,2023-12-04,701,gel pen,5,10,5,1,00111,India
935789,2023-12-04,715,folder,5,15,10,1,00111,India
935789,2023-12-04,712,graph paper,20,40,20,1,00111,India
935789,2023-12-04,704,scale,5,10,5,1,00111,India
216295,2023-12-04,710,geometry box,100,150,50,1,00233,India
216295,2023-12-04,707,marker,20,40,20,1,00233,India
216295,2023-12-04,715,folder,5,15,10,1,00233,India
216295,2023-12-04,702,pencil,2,5,3,1,00233,India
969434,2023-12-04,702,pencil,2,5,3,1,00437,India
969434,2023-12-04,717,spiral bound book,50,100,50,1,00437,India
967009,2023-12-04,701,gel pen,5,10,5,1,00087,India
967009,2023-12-04,708,sketchpen,15,40,25,1,00087,India
967009,2023-12-04,715,folder,5,15,10,1,00087,India
967009,2023-12-04,704,scale,5,10,5,1,00087,India
152775,2023-12-04,702,pencil,2,5,3,1,00453,India
830043,2023-12-04,716,printing paper,200,400,200,1,00478,India
830043,2023-12-04,713,ball pen,5,10,5,1,00478,India
830043,2023-12-04,701,gel pen,5,10,5,1,00478,India
566157,2023-12-04,704,scale,5,10,5,1,00018,India
299917,2023-12-04,706,sharpener,3,8,5,1,00228,India
299917,2023-12-04,708,sketchpen,15,40,25,1,00228,India
241707,2023-12-04,716,printing paper,200,400,200,1,00141,India
241707,2023-12-04,710,geometry box,100,150,50,1,00141,India
241707,2023-12-04,711,TD kit,150,300,150,1,00141,India
241707,2023-12-04,704,scale,5,10,5,1,00141,India
470105,2023-12-04,717,spiral bound book,50,100,50,1,00441,India
191841,2023-12-04,714,carbon paper,15,30,15,1,00146,India
191841,2023-12-04,701,gel pen,5,10,5,1,00146,India
191841,2023-12-04,706,sharpener,3,8,5,1,00146,India
792244,2023-12-04,712,graph paper,20,40,20,1,00497,India
792244,2023-12-04,709,notebook,30,60,30,1,00497,India
792244,2023-12-04,706,sharpener,3,8,5,1,00497,India
792244,2023-12-04,714,carbon paper,15,30,15,1,00497,India
792244,2023-12-04,715,folder,5,15,10,1,00497,India
306580,2023-12-04,715,folder,5,15,10,1,00419,India
306580,2023-12-04,713,ball pen,5,10,5,1,00419,India
306580,2023-12-04,702,pencil,2,5,3,1,00419,India
306580,2023-12-04,717,spiral bound book,50,100,50,1,00419,India
309901,2023-12-04,715,folder,5,15,10,1,00172,India
309901,2023-12-04,705,stencil,10,20,10,1,00172,India
309901,2023-12-04,706,sharpener,3,8,5,1,00172,India
309901,2023-12-04,714,carbon paper,15,30,15,1,00172,India
309901,2023-12-04,709,notebook,30,60,30,1,00172,India
235300,2023-12-04,716,printing paper,200,400,200,1,00376,India
235300,2023-12-04,717,spiral bound book,50,100,50,1,00376,India
235300,2023-12-04,712,graph paper,20,40,20,1,00376,India
235300,2023-12-04,708,sketchpen,15,40,25,1,00376,India
693803,2023-12-04,717,spiral bound book,50,100,50,1,00241,India
693803,2023-12-04,708,sketchpen,15,40,25,1,00241,India
693803,2023-12-04,711,TD kit,150,300,150,1,00241,India
693803,2023-12-04,715,folder,5,15,10,1,00241,India
661478,2023-12-04,715,folder,5,15,10,1,00162,India
661478,2023-12-04,711,TD kit,150,300,150,1,00162,India
661478,2023-12-04,701,gel pen,5,10,5,1,00162,India
661478,2023-12-04,704,scale,5,10,5,1,00162,India
661478,2023-12-04,703,eraser,1,3,2,1,00162,India
337843,2023-12-04,716,printing paper,200,400,200,1,00378,India
337843,2023-12-04,711,TD kit,150,300,150,1,00378,India
337843,2023-12-04,702,pencil,2,5,3,1,00378,India
337843,2023-12-04,712,graph paper,20,40,20,1,00378,India
337843,2023-12-04,709,notebook,30,60,30,1,00378,India
815183,2023-12-04,711,TD kit,150,300,150,1,00198,India
712435,2023-12-04,709,notebook,30,60,30,1,00093,India
712435,2023-12-04,717,spiral bound book,50,100,50,1,00093,India
712435,2023-12-04,713,ball pen,5,10,5,1,00093,India
712435,2023-12-04,701,gel pen,5,10,5,1,00093,India
712435,2023-12-04,715,folder,5,15,10,1,00093,India
796201,2023-12-04,703,eraser,1,3,2,1,00303,India
796201,2023-12-04,712,graph paper,20,40,20,1,00303,India
796201,2023-12-04,711,TD kit,150,300,150,1,00303,India
796201,2023-12-04,710,geometry box,100,150,50,1,00303,India
732472,2023-12-04,714,carbon paper,15,30,15,1,00218,India
732472,2023-12-04,702,pencil,2,5,3,1,00218,India
732472,2023-12-04,711,TD kit,150,300,150,1,00218,India
727717,2023-12-04,705,stencil,10,20,10,1,00400,India
727717,2023-12-04,717,spiral bound book,50,100,50,1,00400,India
198552,2023-12-04,704,scale,5,10,5,1,00176,India
198552,2023-12-04,707,marker,20,40,20,1,00176,India
198552,2023-12-04,705,stencil,10,20,10,1,00176,India
956846,2023-12-04,708,sketchpen,15,40,25,1,00296,India
912658,2023-12-04,717,spiral bound book,50,100,50,1,00158,India
912658,2023-12-04,707,marker,20,40,20,1,00158,India
912658,2023-12-04,701,gel pen,5,10,5,1,00158,India
912658,2023-12-04,705,stencil,10,20,10,1,00158,India
776756,2023-12-04,709,notebook,30,60,30,1,00135,India
272513,2023-12-04,707,marker,20,40,20,1,00148,India
272513,2023-12-04,704,scale,5,10,5,1,00148,India
272513,2023-12-04,714,carbon paper,15,30,15,1,00148,India
835808,2023-12-04,717,spiral bound book,50,100,50,1,00400,India
549955,2023-12-04,713,ball pen,5,10,5,1,00375,India
549955,2023-12-04,714,carbon paper,15,30,15,1,00375,India
549955,2023-12-04,701,gel pen,5,10,5,1,00375,India
549955,2023-12-04,716,printing paper,200,400,200,1,00375,India
549955,2023-12-04,708,sketchpen,15,40,25,1,00375,India
274845,2023-12-04,706,sharpener,3,8,5,1,00347,India
274845,2023-12-04,707,marker,20,40,20,1,00347,India
274845,2023-12-04,713,ball pen,5,10,5,1,00347,India
327583,2023-12-04,712,graph paper,20,40,20,1,00081,India
327583,2023-12-04,716,printing paper,200,400,200,1,00081,India
327583,2023-12-04,707,marker,20,40,20,1,00081,India
327583,2023-12-04,705,stencil,10,20,10,1,00081,India
327583,2023-12-04,706,sharpener,3,8,5,1,00081,India
754091,2023-12-04,705,stencil,10,20,10,1,00358,India
754091,2023-12-04,702,pencil,2,5,3,1,00358,India
604356,2023-12-04,711,TD kit,150,300,150,1,00328,India
604356,2023-12-04,709,notebook,30,60,30,1,00328,India
604356,2023-12-04,714,carbon paper,15,30,15,1,00328,India
464562,2023-12-04,703,eraser,1,3,2,1,00480,India
569858,2023-12-04,702,pencil,2,5,3,1,00361,India
569858,2023-12-04,717,spiral bound book,50,100,50,1,00361,India
569858,2023-12-04,713,ball pen,5,10,5,1,00361,India
569858,2023-12-04,712,graph paper,20,40,20,1,00361,India
569858,2023-12-04,709,notebook,30,60,30,1,00361,India
582384,2023-12-04,702,pencil,2,5,3,1,00420,India
582384,2023-12-04,710,geometry box,100,150,50,1,00420,India
582384,2023-12-04,709,notebook,30,60,30,1,00420,India
455327,2023-12-04,706,sharpener,3,8,5,1,00247,India
455327,2023-12-04,714,carbon paper,15,30,15,1,00247,India
455327,2023-12-04,716,printing paper,200,400,200,1,00247,India
873674,2023-12-04,706,sharpener,3,8,5,1,00422,India
873674,2023-12-04,702,pencil,2,5,3,1,00422,India
873674,2023-12-04,704,scale,5,10,5,1,00422,India
873674,2023-12-04,714,carbon paper,15,30,15,1,00422,India
477770,2023-12-04,701,gel pen,5,10,5,1,00212,India
477770,2023-12-04,710,geometry box,100,150,50,1,00212,India
643087,2023-12-05,716,printing paper,200,400,200,1,00447,India
181899,2023-12-05,706,sharpener,3,8,5,1,00180,India
801981,2023-12-05,708,sketchpen,15,40,25,1,00131,India
801981,2023-12-05,710,geometry box,100,150,50,1,00131,India
801981,2023-12-05,705,stencil,10,20,10,1,00131,India
801981,2023-12-05,703,eraser,1,3,2,1,00131,India
999528,2023-12-05,715,folder,5,15,10,1,00400,India
688326,2023-12-05,712,graph paper,20,40,20,1,00364,India
688326,2023-12-05,707,marker,20,40,20,1,00364,India
688326,2023-12-05,717,spiral bound book,50,100,50,1,00364,India
688326,2023-12-05,710,geometry box,100,150,50,1,00364,India
954968,2023-12-05,713,ball pen,5,10,5,1,00083,India
402004,2023-12-05,704,scale,5,10,5,1,00020,India
402004,2023-12-05,716,printing paper,200,400,200,1,00020,India
412393,2023-12-05,712,graph paper,20,40,20,1,00291,India
670276,2023-12-05,702,pencil,2,5,3,1,00242,India
670276,2023-12-05,703,eraser,1,3,2,1,00242,India
670276,2023-12-05,705,stencil,10,20,10,1,00242,India
670276,2023-12-05,701,gel pen,5,10,5,1,00242,India
559043,2023-12-05,708,sketchpen,15,40,25,1,00367,India
951090,2023-12-05,703,eraser,1,3,2,1,00249,India
951090,2023-12-05,708,sketchpen,15,40,25,1,00249,India
951090,2023-12-05,717,spiral bound book,50,100,50,1,00249,India
464426,2023-12-05,714,carbon paper,15,30,15,1,00314,India
464426,2023-12-05,713,ball pen,5,10,5,1,00314,India
464426,2023-12-05,701,gel pen,5,10,5,1,00314,India
464426,2023-12-05,708,sketchpen,15,40,25,1,00314,India
464426,2023-12-05,711,TD kit,150,300,150,1,00314,India
706344,2023-12-05,708,sketchpen,15,40,25,1,00016,India
706344,2023-12-05,703,eraser,1,3,2,1,00016,India
706344,2023-12-05,704,scale,5,10,5,1,00016,India
706344,2023-12-05,701,gel pen,5,10,5,1,00016,India
249128,2023-12-05,716,printing paper,200,400,200,1,00176,India
249128,2023-12-05,705,stencil,10,20,10,1,00176,India
249128,2023-12-05,715,folder,5,15,10,1,00176,India
479089,2023-12-05,710,geometry box,100,150,50,1,00407,India
479089,2023-12-05,715,folder,5,15,10,1,00407,India
479089,2023-12-05,703,eraser,1,3,2,1,00407,India
479089,2023-12-05,705,stencil,10,20,10,1,00407,India
160177,2023-12-05,712,graph paper,20,40,20,1,00269,India
160177,2023-12-05,701,gel pen,5,10,5,1,00269,India
160177,2023-12-05,705,stencil,10,20,10,1,00269,India
160177,2023-12-05,711,TD kit,150,300,150,1,00269,India
613045,2023-12-05,712,graph paper,20,40,20,1,00467,India
613045,2023-12-05,704,scale,5,10,5,1,00467,India
456573,2023-12-05,703,eraser,1,3,2,1,00208,India
456573,2023-12-05,705,stencil,10,20,10,1,00208,India
456573,2023-12-05,715,folder,5,15,10,1,00208,India
456573,2023-12-05,708,sketchpen,15,40,25,1,00208,India
437670,2023-12-05,704,scale,5,10,5,1,00197,India
586336,2023-12-05,714,carbon paper,15,30,15,1,00181,India
238161,2023-12-05,706,sharpener,3,8,5,1,00301,India
238161,2023-12-05,703,eraser,1,3,2,1,00301,India
238161,2023-12-05,704,scale,5,10,5,1,00301,India
238161,2023-12-05,709,notebook,30,60,30,1,00301,India
936304,2023-12-05,710,geometry box,100,150,50,1,00179,India
936304,2023-12-05,704,scale,5,10,5,1,00179,India
936304,2023-12-05,708,sketchpen,15,40,25,1,00179,India
430719,2023-12-05,708,sketchpen,15,40,25,1,00405,India
430719,2023-12-05,705,stencil,10,20,10,1,00405,India
430719,2023-12-05,702,pencil,2,5,3,1,00405,India
430719,2023-12-05,717,spiral bound book,50,100,50,1,00405,India
446355,2023-12-05,705,stencil,10,20,10,1,00338,India
446355,2023-12-05,716,printing paper,200,400,200,1,00338,India
446355,2023-12-05,712,graph paper,20,40,20,1,00338,India
446355,2023-12-05,711,TD kit,150,300,150,1,00338,India
215460,2023-12-05,705,stencil,10,20,10,1,00310,India
215460,2023-12-05,708,sketchpen,15,40,25,1,00310,India
215460,2023-12-05,706,sharpener,3,8,5,1,00310,India
215460,2023-12-05,703,eraser,1,3,2,1,00310,India
409619,2023-12-05,703,eraser,1,3,2,1,00446,India
409619,2023-12-05,714,carbon paper,15,30,15,1,00446,India
409619,2023-12-05,709,notebook,30,60,30,1,00446,India
409619,2023-12-05,716,printing paper,200,400,200,1,00446,India
400502,2023-12-05,701,gel pen,5,10,5,1,00165,India
262545,2023-12-05,702,pencil,2,5,3,1,00006,India
262545,2023-12-05,701,gel pen,5,10,5,1,00006,India
626353,2023-12-05,708,sketchpen,15,40,25,1,00232,India
626353,2023-12-05,703,eraser,1,3,2,1,00232,India
626353,2023-12-05,706,sharpener,3,8,5,1,00232,India
626353,2023-12-05,714,carbon paper,15,30,15,1,00232,India
486860,2023-12-05,708,sketchpen,15,40,25,1,00080,India
486860,2023-12-05,706,sharpener,3,8,5,1,00080,India
486860,2023-12-05,707,marker,20,40,20,1,00080,India
486860,2023-12-05,704,scale,5,10,5,1,00080,India
607228,2023-12-05,713,ball pen,5,10,5,1,00031,India
607228,2023-12-05,710,geometry box,100,150,50,1,00031,India
607228,2023-12-05,707,marker,20,40,20,1,00031,India
962751,2023-12-05,717,spiral bound book,50,100,50,1,00427,India
962751,2023-12-05,716,printing paper,200,400,200,1,00427,India
962751,2023-12-05,714,carbon paper,15,30,15,1,00427,India
962751,2023-12-05,706,sharpener,3,8,5,1,00427,India
463443,2023-12-05,717,spiral bound book,50,100,50,1,00381,India
463443,2023-12-05,707,marker,20,40,20,1,00381,India
495927,2023-12-05,710,geometry box,100,150,50,1,00015,India
495927,2023-12-05,714,carbon paper,15,30,15,1,00015,India
642571,2023-12-05,714,carbon paper,15,30,15,1,00419,India
642571,2023-12-05,715,folder,5,15,10,1,00419,India
642571,2023-12-05,701,gel pen,5,10,5,1,00419,India
642571,2023-12-05,711,TD kit,150,300,150,1,00419,India
524415,2023-12-05,709,notebook,30,60,30,1,00060,India
524415,2023-12-05,714,carbon paper,15,30,15,1,00060,India
524415,2023-12-05,711,TD kit,150,300,150,1,00060,India
524415,2023-12-05,701,gel pen,5,10,5,1,00060,India
524415,2023-12-05,710,geometry box,100,150,50,1,00060,India
756041,2023-12-05,709,notebook,30,60,30,1,00243,India
756041,2023-12-05,710,geometry box,100,150,50,1,00243,India
756041,2023-12-05,705,stencil,10,20,10,1,00243,India
756041,2023-12-05,713,ball pen,5,10,5,1,00243,India
756041,2023-12-05,707,marker,20,40,20,1,00243,India
601049,2023-12-05,705,stencil,10,20,10,1,00496,India
601049,2023-12-05,704,scale,5,10,5,1,00496,India
601049,2023-12-05,702,pencil,2,5,3,1,00496,India
601049,2023-12-05,715,folder,5,15,10,1,00496,India
601049,2023-12-05,711,TD kit,150,300,150,1,00496,India
341360,2023-12-05,714,carbon paper,15,30,15,1,00479,India
341360,2023-12-05,710,geometry box,100,150,50,1,00479,India
891673,2023-12-05,708,sketchpen,15,40,25,1,00175,India
891673,2023-12-05,717,spiral bound book,50,100,50,1,00175,India
891673,2023-12-05,716,printing paper,200,400,200,1,00175,India
294238,2023-12-05,705,stencil,10,20,10,1,00259,India
457103,2023-12-05,704,scale,5,10,5,1,00461,India
457103,2023-12-05,717,spiral bound book,50,100,50,1,00461,India
457103,2023-12-05,711,TD kit,150,300,150,1,00461,India
457103,2023-12-05,714,carbon paper,15,30,15,1,00461,India
188166,2023-12-05,702,pencil,2,5,3,1,00188,India
188166,2023-12-05,708,sketchpen,15,40,25,1,00188,India
188166,2023-12-05,704,scale,5,10,5,1,00188,India
996738,2023-12-05,717,spiral bound book,50,100,50,1,00079,India
996738,2023-12-05,708,sketchpen,15,40,25,1,00079,India
455596,2023-12-06,705,stencil,10,20,10,1,00447,India
455596,2023-12-06,706,sharpener,3,8,5,1,00447,India
954547,2023-12-06,714,carbon paper,15,30,15,1,00293,India
954547,2023-12-06,712,graph paper,20,40,20,1,00293,India
954547,2023-12-06,713,ball pen,5,10,5,1,00293,India
954547,2023-12-06,705,stencil,10,20,10,1,00293,India
292995,2023-12-06,701,gel pen,5,10,5,1,00407,India
292995,2023-12-06,709,notebook,30,60,30,1,00407,India
292995,2023-12-06,703,eraser,1,3,2,1,00407,India
687994,2023-12-06,706,sharpener,3,8,5,1,00356,India
746513,2023-12-06,701,gel pen,5,10,5,1,00236,India
746513,2023-12-06,717,spiral bound book,50,100,50,1,00236,India
746513,2023-12-06,715,folder,5,15,10,1,00236,India
275741,2023-12-06,701,gel pen,5,10,5,1,00089,India
275741,2023-12-06,708,sketchpen,15,40,25,1,00089,India
564322,2023-12-06,707,marker,20,40,20,1,00281,India
564322,2023-12-06,714,carbon paper,15,30,15,1,00281,India
564322,2023-12-06,716,printing paper,200,400,200,1,00281,India
754095,2023-12-06,713,ball pen,5,10,5,1,00274,India
754095,2023-12-06,708,sketchpen,15,40,25,1,00274,India
754095,2023-12-06,701,gel pen,5,10,5,1,00274,India
612387,2023-12-06,705,stencil,10,20,10,1,00169,India
292958,2023-12-06,709,notebook,30,60,30,1,00452,India
351811,2023-12-06,713,ball pen,5,10,5,1,00252,India
351811,2023-12-06,715,folder,5,15,10,1,00252,India
351811,2023-12-06,708,sketchpen,15,40,25,1,00252,India
410248,2023-12-06,711,TD kit,150,300,150,1,00348,India
410248,2023-12-06,707,marker,20,40,20,1,00348,India
410248,2023-12-06,705,stencil,10,20,10,1,00348,India
410248,2023-12-06,708,sketchpen,15,40,25,1,00348,India
794291,2023-12-06,705,stencil,10,20,10,1,00027,India
794291,2023-12-06,701,gel pen,5,10,5,1,00027,India
794291,2023-12-06,716,printing paper,200,400,200,1,00027,India
794291,2023-12-06,710,geometry box,100,150,50,1,00027,India
131558,2023-12-06,713,ball pen,5,10,5,1,00389,India
131558,2023-12-06,701,gel pen,5,10,5,1,00389,India
353242,2023-12-06,711,TD kit,150,300,150,1,00002,India
734502,2023-12-06,709,notebook,30,60,30,1,00251,India
387883,2023-12-06,713,ball pen,5,10,5,1,00136,India
387883,2023-12-06,703,eraser,1,3,2,1,00136,India
256590,2023-12-06,714,carbon paper,15,30,15,1,00126,India
256590,2023-12-06,706,sharpener,3,8,5,1,00126,India
666198,2023-12-06,709,notebook,30,60,30,1,00329,India
666198,2023-12-06,706,sharpener,3,8,5,1,00329,India
666198,2023-12-06,701,gel pen,5,10,5,1,00329,India
666198,2023-12-06,705,stencil,10,20,10,1,00329,India
245832,2023-12-06,701,gel pen,5,10,5,1,00364,India
245832,2023-12-06,714,carbon paper,15,30,15,1,00364,India
765350,2023-12-06,704,scale,5,10,5,1,00089,India
765350,2023-12-06,702,pencil,2,5,3,1,00089,India
225206,2023-12-06,711,TD kit,150,300,150,1,00127,India
225206,2023-12-06,710,geometry box,100,150,50,1,00127,India
225206,2023-12-06,708,sketchpen,15,40,25,1,00127,India
990014,2023-12-06,717,spiral bound book,50,100,50,1,00394,India
755580,2023-12-06,702,pencil,2,5,3,1,00468,India
755580,2023-12-06,707,marker,20,40,20,1,00468,India
434183,2023-12-06,709,notebook,30,60,30,1,00317,India
434183,2023-12-06,714,carbon paper,15,30,15,1,00317,India
434183,2023-12-06,707,marker,20,40,20,1,00317,India
434183,2023-12-06,702,pencil,2,5,3,1,00317,India
434183,2023-12-06,705,stencil,10,20,10,1,00317,India
159857,2023-12-06,709,notebook,30,60,30,1,00442,India
898550,2023-12-06,707,marker,20,40,20,1,00122,India
898550,2023-12-06,711,TD kit,150,300,150,1,00122,India
633203,2023-12-06,714,carbon paper,15,30,15,1,00278,India
633203,2023-12-06,713,ball pen,5,10,5,1,00278,India
812293,2023-12-06,712,graph paper,20,40,20,1,00485,India
812293,2023-12-06,708,sketchpen,15,40,25,1,00485,India
812293,2023-12-06,714,carbon paper,15,30,15,1,00485,India
812293,2023-12-06,713,ball pen,5,10,5,1,00485,India
478762,2023-12-06,702,pencil,2,5,3,1,00237,India
478762,2023-12-06,709,notebook,30,60,30,1,00237,India
614792,2023-12-06,715,folder,5,15,10,1,00200,India
614792,2023-12-06,706,sharpener,3,8,5,1,00200,India
784944,2023-12-06,704,scale,5,10,5,1,00414,India
784944,2023-12-06,701,gel pen,5,10,5,1,00414,India
784944,2023-12-06,711,TD kit,150,300,150,1,00414,India
784944,2023-12-06,714,carbon paper,15,30,15,1,00414,India
304956,2023-12-06,706,sharpener,3,8,5,1,00125,India
304956,2023-12-06,713,ball pen,5,10,5,1,00125,India
304956,2023-12-06,704,scale,5,10,5,1,00125,India
304956,2023-12-06,711,TD kit,150,300,150,1,00125,India
287114,2023-12-06,715,folder,5,15,10,1,00412,India
287114,2023-12-06,706,sharpener,3,8,5,1,00412,India
287114,2023-12-06,717,spiral bound book,50,100,50,1,00412,India
238338,2023-12-06,713,ball pen,5,10,5,1,00207,India
276076,2023-12-06,709,notebook,30,60,30,1,00234,India
138177,2023-12-07,716,printing paper,200,400,200,1,00414,India
488203,2023-12-07,712,graph paper,20,40,20,1,00483,India
488203,2023-12-07,705,stencil,10,20,10,1,00483,India
488203,2023-12-07,714,carbon paper,15,30,15,1,00483,India
488203,2023-12-07,717,spiral bound book,50,100,50,1,00483,India
392476,2023-12-07,709,notebook,30,60,30,1,00327,India
392476,2023-12-07,707,marker,20,40,20,1,00327,India
392476,2023-12-07,715,folder,5,15,10,1,00327,India
392476,2023-12-07,716,printing paper,200,400,200,1,00327,India
392476,2023-12-07,706,sharpener,3,8,5,1,00327,India
657291,2023-12-07,713,ball pen,5,10,5,1,00182,India
644667,2023-12-07,707,marker,20,40,20,1,00217,India
612414,2023-12-07,706,sharpener,3,8,5,1,00338,India
612414,2023-12-07,717,spiral bound book,50,100,50,1,00338,India
612414,2023-12-07,701,gel pen,5,10,5,1,00338,India
612414,2023-12-07,705,stencil,10,20,10,1,00338,India
612414,2023-12-07,715,folder,5,15,10,1,00338,India
284879,2023-12-07,716,printing paper,200,400,200,1,00164,India
323243,2023-12-07,715,folder,5,15,10,1,00391,India
323243,2023-12-07,713,ball pen,5,10,5,1,00391,India
323243,2023-12-07,712,graph paper,20,40,20,1,00391,India
323243,2023-12-07,707,marker,20,40,20,1,00391,India
870636,2023-12-07,714,carbon paper,15,30,15,1,00275,India
870636,2023-12-07,716,printing paper,200,400,200,1,00275,India
870636,2023-12-07,715,folder,5,15,10,1,00275,India
400202,2023-12-07,707,marker,20,40,20,1,00391,India
400202,2023-12-07,709,notebook,30,60,30,1,00391,India
400202,2023-12-07,716,printing paper,200,400,200,1,00391,India
979048,2023-12-07,717,spiral bound book,50,100,50,1,00405,India
979048,2023-12-07,704,scale,5,10,5,1,00405,India
979048,2023-12-07,711,TD kit,150,300,150,1,00405,India
979048,2023-12-07,715,folder,5,15,10,1,00405,India
979048,2023-12-07,712,graph paper,20,40,20,1,00405,India
580239,2023-12-07,714,carbon paper,15,30,15,1,00003,India
580239,2023-12-07,706,sharpener,3,8,5,1,00003,India
207720,2023-12-07,706,sharpener,3,8,5,1,00385,India
207720,2023-12-07,717,spiral bound book,50,100,50,1,00385,India
612547,2023-12-07,704,scale,5,10,5,1,00148,India
612547,2023-12-07,701,gel pen,5,10,5,1,00148,India
564132,2023-12-07,703,eraser,1,3,2,1,00415,India
564132,2023-12-07,717,spiral bound book,50,100,50,1,00415,India
564132,2023-12-07,712,graph paper,20,40,20,1,00415,India
564132,2023-12-07,715,folder,5,15,10,1,00415,India
564132,2023-12-07,711,TD kit,150,300,150,1,00415,India
875795,2023-12-07,716,printing paper,200,400,200,1,00059,India
943140,2023-12-07,707,marker,20,40,20,1,00243,India
943140,2023-12-07,702,pencil,2,5,3,1,00243,India
943140,2023-12-07,711,TD kit,150,300,150,1,00243,India
251712,2023-12-07,710,geometry box,100,150,50,1,00108,India
251712,2023-12-07,706,sharpener,3,8,5,1,00108,India
251712,2023-12-07,708,sketchpen,15,40,25,1,00108,India
251712,2023-12-07,704,scale,5,10,5,1,00108,India
451985,2023-12-07,708,sketchpen,15,40,25,1,00096,India
451985,2023-12-07,709,notebook,30,60,30,1,00096,India
451985,2023-12-07,713,ball pen,5,10,5,1,00096,India
451985,2023-12-07,706,sharpener,3,8,5,1,00096,India
972972,2023-12-07,704,scale,5,10,5,1,00497,India
972972,2023-12-07,711,TD kit,150,300,150,1,00497,India
972972,2023-12-07,713,ball pen,5,10,5,1,00497,India
972972,2023-12-07,716,printing paper,200,400,200,1,00497,India
249092,2023-12-07,717,spiral bound book,50,100,50,1,00389,India
249092,2023-12-07,704,scale,5,10,5,1,00389,India
895761,2023-12-07,715,folder,5,15,10,1,00048,India
895761,2023-12-07,703,eraser,1,3,2,1,00048,India
584279,2023-12-07,710,geometry box,100,150,50,1,00247,India
584279,2023-12-07,707,marker,20,40,20,1,00247,India
284040,2023-12-07,704,scale,5,10,5,1,00033,India
408668,2023-12-07,702,pencil,2,5,3,1,00077,India
408668,2023-12-07,704,scale,5,10,5,1,00077,India
434789,2023-12-07,706,sharpener,3,8,5,1,00255,India
434789,2023-12-07,715,folder,5,15,10,1,00255,India
434789,2023-12-07,702,pencil,2,5,3,1,00255,India
921098,2023-12-07,707,marker,20,40,20,1,00193,India
921098,2023-12-07,715,folder,5,15,10,1,00193,India
907490,2023-12-07,705,stencil,10,20,10,1,00103,India
907490,2023-12-07,717,spiral bound book,50,100,50,1,00103,India
833864,2023-12-07,704,scale,5,10,5,1,00228,India
833864,2023-12-07,711,TD kit,150,300,150,1,00228,India
833864,2023-12-07,701,gel pen,5,10,5,1,00228,India
833864,2023-12-07,715,folder,5,15,10,1,00228,India
102117,2023-12-07,704,scale,5,10,5,1,00452,India
102117,2023-12-07,703,eraser,1,3,2,1,00452,India
102117,2023-12-07,708,sketchpen,15,40,25,1,00452,India
252856,2023-12-07,713,ball pen,5,10,5,1,00019,India
930523,2023-12-07,706,sharpener,3,8,5,1,00257,India
930523,2023-12-07,701,gel pen,5,10,5,1,00257,India
135927,2023-12-07,707,marker,20,40,20,1,00497,India
135927,2023-12-07,705,stencil,10,20,10,1,00497,India
135927,2023-12-07,704,scale,5,10,5,1,00497,India
135927,2023-12-07,710,geometry box,100,150,50,1,00497,India
868104,2023-12-07,704,scale,5,10,5,1,00163,India
868104,2023-12-07,715,folder,5,15,10,1,00163,India
868104,2023-12-07,713,ball pen,5,10,5,1,00163,India
474732,2023-12-07,708,sketchpen,15,40,25,1,00363,India
468051,2023-12-07,709,notebook,30,60,30,1,00437,India
793051,2023-12-07,706,sharpener,3,8,5,1,00294,India
793051,2023-12-07,713,ball pen,5,10,5,1,00294,India
496194,2023-12-08,710,geometry box,100,150,50,1,00485,India
496194,2023-12-08,717,spiral bound book,50,100,50,1,00485,India
496194,2023-12-08,716,printing paper,200,400,200,1,00485,India
713942,2023-12-08,707,marker,20,40,20,1,00382,India
713942,2023-12-08,709,notebook,30,60,30,1,00382,India
713942,2023-12-08,702,pencil,2,5,3,1,00382,India
713942,2023-12-08,711,TD kit,150,300,150,1,00382,India
713942,2023-12-08,703,eraser,1,3,2,1,00382,India
746881,2023-12-08,714,carbon paper,15,30,15,1,00340,India
746881,2023-12-08,709,notebook,30,60,30,1,00340,India
746881,2023-12-08,715,folder,5,15,10,1,00340,India
234789,2023-12-08,706,sharpener,3,8,5,1,00447,India
234789,2023-12-08,711,TD kit,150,300,150,1,00447,India
487748,2023-12-08,717,spiral bound book,50,100,50,1,00366,India
487748,2023-12-08,704,scale,5,10,5,1,00366,India
752595,2023-12-08,713,ball pen,5,10,5,1,00370,India
584604,2023-12-08,710,geometry box,100,150,50,1,00246,India
584604,2023-12-08,707,marker,20,40,20,1,00246,India
584604,2023-12-08,713,ball pen,5,10,5,1,00246,India
689422,2023-12-08,717,spiral bound book,50,100,50,1,00146,India
831194,2023-12-08,717,spiral bound book,50,100,50,1,00251,India
831194,2023-12-08,712,graph paper,20,40,20,1,00251,India
831194,2023-12-08,711,TD kit,150,300,150,1,00251,India
831194,2023-12-08,713,ball pen,5,10,5,1,00251,India
737984,2023-12-08,713,ball pen,5,10,5,1,00270,India
737984,2023-12-08,716,printing paper,200,400,200,1,00270,India
397110,2023-12-08,714,carbon paper,15,30,15,1,00412,India
693013,2023-12-08,709,notebook,30,60,30,1,00477,India
693013,2023-12-08,711,TD kit,150,300,150,1,00477,India
952905,2023-12-08,714,carbon paper,15,30,15,1,00442,India
186843,2023-12-08,716,printing paper,200,400,200,1,00046,India
186843,2023-12-08,712,graph paper,20,40,20,1,00046,India
186843,2023-12-08,702,pencil,2,5,3,1,00046,India
142694,2023-12-08,710,geometry box,100,150,50,1,00481,India
142694,2023-12-08,703,eraser,1,3,2,1,00481,India
427483,2023-12-08,704,scale,5,10,5,1,00311,India
427483,2023-12-08,703,eraser,1,3,2,1,00311,India
427483,2023-12-08,716,printing paper,200,400,200,1,00311,India
230712,2023-12-08,715,folder,5,15,10,1,00226,India
371675,2023-12-08,711,TD kit,150,300,150,1,00225,India
371675,2023-12-08,714,carbon paper,15,30,15,1,00225,India
147125,2023-12-08,716,printing paper,200,400,200,1,00323,India
147125,2023-12-08,715,folder,5,15,10,1,00323,India
147125,2023-12-08,714,carbon paper,15,30,15,1,00323,India
796663,2023-12-08,706,sharpener,3,8,5,1,00295,India
796663,2023-12-08,712,graph paper,20,40,20,1,00295,India
796663,2023-12-08,701,gel pen,5,10,5,1,00295,India
796663,2023-12-08,704,scale,5,10,5,1,00295,India
683355,2023-12-08,706,sharpener,3,8,5,1,00264,India
683355,2023-12-08,704,scale,5,10,5,1,00264,India
683355,2023-12-08,705,stencil,10,20,10,1,00264,India
466489,2023-12-08,717,spiral bound book,50,100,50,1,00434,India
466489,2023-12-08,704,scale,5,10,5,1,00434,India
466489,2023-12-08,711,TD kit,150,300,150,1,00434,India
814953,2023-12-08,707,marker,20,40,20,1,00211,India
814953,2023-12-08,709,notebook,30,60,30,1,00211,India
814953,2023-12-08,703,eraser,1,3,2,1,00211,India
322389,2023-12-08,708,sketchpen,15,40,25,1,00463,India
273536,2023-12-08,703,eraser,1,3,2,1,00361,India
273536,2023-12-08,702,pencil,2,5,3,1,00361,India
783506,2023-12-08,714,carbon paper,15,30,15,1,00014,India
783506,2023-12-08,701,gel pen,5,10,5,1,00014,India
783506,2023-12-08,713,ball pen,5,10,5,1,00014,India
783506,2023-12-08,705,stencil,10,20,10,1,00014,India
246598,2023-12-08,716,printing paper,200,400,200,1,00445,India
246598,2023-12-08,711,TD kit,150,300,150,1,00445,India
246598,2023-12-08,712,graph paper,20,40,20,1,00445,India
246598,2023-12-08,715,folder,5,15,10,1,00445,India
246598,2023-12-08,713,ball pen,5,10,5,1,00445,India
617870,2023-12-08,703,eraser,1,3,2,1,00154,India
177924,2023-12-08,716,printing paper,200,400,200,1,00020,India
904858,2023-12-08,716,printing paper,200,400,200,1,00001,India
904858,2023-12-08,717,spiral bound book,50,100,50,1,00001,India
904858,2023-12-08,704,scale,5,10,5,1,00001,India
904858,2023-12-08,707,marker,20,40,20,1,00001,India
879003,2023-12-09,716,printing paper,200,400,200,1,00461,India
879003,2023-12-09,702,pencil,2,5,3,1,00461,India
879003,2023-12-09,706,sharpener,3,8,5,1,00461,India
781907,2023-12-09,710,geometry box,100,150,50,1,00106,India
781907,2023-12-09,701,gel pen,5,10,5,1,00106,India
781907,2023-12-09,711,TD kit,150,300,150,1,00106,India
307356,2023-12-09,716,printing paper,200,400,200,1,00412,India
307356,2023-12-09,708,sketchpen,15,40,25,1,00412,India
307356,2023-12-09,717,spiral bound book,50,100,50,1,00412,India
307356,2023-12-09,713,ball pen,5,10,5,1,00412,India
515252,2023-12-09,706,sharpener,3,8,5,1,00151,India
515252,2023-12-09,708,sketchpen,15,40,25,1,00151,India
641719,2023-12-09,704,scale,5,10,5,1,00208,India
641719,2023-12-09,717,spiral bound book,50,100,50,1,00208,India
641719,2023-12-09,703,eraser,1,3,2,1,00208,India
641719,2023-12-09,715,folder,5,15,10,1,00208,India
641719,2023-12-09,706,sharpener,3,8,5,1,00208,India
774249,2023-12-09,712,graph paper,20,40,20,1,00101,India
774249,2023-12-09,711,TD kit,150,300,150,1,00101,India
774249,2023-12-09,708,sketchpen,15,40,25,1,00101,India
301824,2023-12-09,713,ball pen,5,10,5,1,00480,India
301824,2023-12-09,717,spiral bound book,50,100,50,1,00480,India
301824,2023-12-09,708,sketchpen,15,40,25,1,00480,India
774626,2023-12-09,702,pencil,2,5,3,1,00065,India
491337,2023-12-09,707,marker,20,40,20,1,00492,India
491337,2023-12-09,708,sketchpen,15,40,25,1,00492,India
491337,2023-12-09,701,gel pen,5,10,5,1,00492,India
587652,2023-12-09,707,marker,20,40,20,1,00424,India
587652,2023-12-09,710,geometry box,100,150,50,1,00424,India
587652,2023-12-09,716,printing paper,200,400,200,1,00424,India
845218,2023-12-09,706,sharpener,3,8,5,1,00397,India
845218,2023-12-09,711,TD kit,150,300,150,1,00397,India
845218,2023-12-09,714,carbon paper,15,30,15,1,00397,India
845218,2023-12-09,703,eraser,1,3,2,1,00397,India
845218,2023-12-09,702,pencil,2,5,3,1,00397,India
139196,2023-12-09,701,gel pen,5,10,5,1,00269,India
139196,2023-12-09,707,marker,20,40,20,1,00269,India
139196,2023-12-09,713,ball pen,5,10,5,1,00269,India
147983,2023-12-09,704,scale,5,10,5,1,00178,India
119115,2023-12-09,715,folder,5,15,10,1,00059,India
362327,2023-12-09,712,graph paper,20,40,20,1,00079,India
362327,2023-12-09,709,notebook,30,60,30,1,00079,India
536528,2023-12-09,708,sketchpen,15,40,25,1,00421,India
536528,2023-12-09,713,ball pen,5,10,5,1,00421,India
435399,2023-12-09,714,carbon paper,15,30,15,1,00308,India
127839,2023-12-09,714,carbon paper,15,30,15,1,00280,India
127839,2023-12-09,710,geometry box,100,150,50,1,00280,India
127839,2023-12-09,708,sketchpen,15,40,25,1,00280,India
127839,2023-12-09,703,eraser,1,3,2,1,00280,India
127839,2023-12-09,705,stencil,10,20,10,1,00280,India
202686,2023-12-09,704,scale,5,10,5,1,00268,India
202686,2023-12-09,709,notebook,30,60,30,1,00268,India
402895,2023-12-09,705,stencil,10,20,10,1,00081,India
402895,2023-12-09,701,gel pen,5,10,5,1,00081,India
402895,2023-12-09,706,sharpener,3,8,5,1,00081,India
889397,2023-12-09,703,eraser,1,3,2,1,00222,India
889397,2023-12-09,708,sketchpen,15,40,25,1,00222,India
889397,2023-12-09,713,ball pen,5,10,5,1,00222,India
889397,2023-12-09,706,sharpener,3,8,5,1,00222,India
889397,2023-12-09,707,marker,20,40,20,1,00222,India
417267,2023-12-09,715,folder,5,15,10,1,00031,India
417267,2023-12-09,706,sharpener,3,8,5,1,00031,India
417267,2023-12-09,702,pencil,2,5,3,1,00031,India
618136,2023-12-09,703,eraser,1,3,2,1,00466,India
618136,2023-12-09,717,spiral bound book,50,100,50,1,00466,India
618136,2023-12-09,713,ball pen,5,10,5,1,00466,India
618136,2023-12-09,705,stencil,10,20,10,1,00466,India
496991,2023-12-09,712,graph paper,20,40,20,1,00465,India
496991,2023-12-09,707,marker,20,40,20,1,00465,India
496991,2023-12-09,703,eraser,1,3,2,1,00465,India
496991,2023-12-09,714,carbon paper,15,30,15,1,00465,India
162465,2023-12-09,716,printing paper,200,400,200,1,00312,India
162465,2023-12-09,713,ball pen,5,10,5,1,00312,India
162465,2023-12-09,708,sketchpen,15,40,25,1,00312,India
162465,2023-12-09,701,gel pen,5,10,5,1,00312,India
594883,2023-12-09,717,spiral bound book,50,100,50,1,00340,India
594883,2023-12-09,715,folder,5,15,10,1,00340,India
594883,2023-12-09,704,scale,5,10,5,1,00340,India
376119,2023-12-09,703,eraser,1,3,2,1,00339,India
376119,2023-12-09,717,spiral bound book,50,100,50,1,00339,India
376119,2023-12-09,716,printing paper,200,400,200,1,00339,India
376119,2023-12-09,704,scale,5,10,5,1,00339,India
842500,2023-12-09,704,scale,5,10,5,1,00224,India
842500,2023-12-09,715,folder,5,15,10,1,00224,India
313663,2023-12-09,708,sketchpen,15,40,25,1,00499,India
816012,2023-12-09,702,pencil,2,5,3,1,00147,India
816012,2023-12-09,716,printing paper,200,400,200,1,00147,India
816012,2023-12-09,708,sketchpen,15,40,25,1,00147,India
395759,2023-12-09,704,scale,5,10,5,1,00003,India
651311,2023-12-09,713,ball pen,5,10,5,1,00064,India
651311,2023-12-09,715,folder,5,15,10,1,00064,India
651311,2023-12-09,711,TD kit,150,300,150,1,00064,India
224078,2023-12-09,713,ball pen,5,10,5,1,00160,India
224078,2023-12-09,708,sketchpen,15,40,25,1,00160,India
224078,2023-12-09,707,marker,20,40,20,1,00160,India
224078,2023-12-09,711,TD kit,150,300,150,1,00160,India
429372,2023-12-09,715,folder,5,15,10,1,00266,India
830036,2023-12-09,701,gel pen,5,10,5,1,00301,India
830036,2023-12-09,708,sketchpen,15,40,25,1,00301,India
830036,2023-12-09,702,pencil,2,5,3,1,00301,India
822872,2023-12-09,707,marker,20,40,20,1,00381,India
822872,2023-12-09,716,printing paper,200,400,200,1,00381,India
822872,2023-12-09,701,gel pen,5,10,5,1,00381,India
822872,2023-12-09,714,carbon paper,15,30,15,1,00381,India
279093,2023-12-09,713,ball pen,5,10,5,1,00469,India
279093,2023-12-09,714,carbon paper,15,30,15,1,00469,India
279093,2023-12-09,717,spiral bound book,50,100,50,1,00469,India
279093,2023-12-09,716,printing paper,200,400,200,1,00469,India
173819,2023-12-09,716,printing paper,200,400,200,1,00040,India
173819,2023-12-09,715,folder,5,15,10,1,00040,India
849073,2023-12-09,710,geometry box,100,150,50,1,00413,India
849073,2023-12-09,709,notebook,30,60,30,1,00413,India
545500,2023-12-10,704,scale,5,10,5,1,00434,India
545500,2023-12-10,711,TD kit,150,300,150,1,00434,India
545500,2023-12-10,701,gel pen,5,10,5,1,00434,India
472809,2023-12-10,707,marker,20,40,20,1,00448,India
472809,2023-12-10,709,notebook,30,60,30,1,00448,India
472809,2023-12-10,708,sketchpen,15,40,25,1,00448,India
472809,2023-12-10,704,scale,5,10,5,1,00448,India
104089,2023-12-10,708,sketchpen,15,40,25,1,00066,India
104089,2023-12-10,713,ball pen,5,10,5,1,00066,India
104089,2023-12-10,717,spiral bound book,50,100,50,1,00066,India
901484,2023-12-10,713,ball pen,5,10,5,1,00047,India
247657,2023-12-10,701,gel pen,5,10,5,1,00163,India
247657,2023-12-10,714,carbon paper,15,30,15,1,00163,India
247657,2023-12-10,710,geometry box,100,150,50,1,00163,India
498285,2023-12-10,710,geometry box,100,150,50,1,00212,India
498285,2023-12-10,711,TD kit,150,300,150,1,00212,India
498285,2023-12-10,713,ball pen,5,10,5,1,00212,India
498285,2023-12-10,701,gel pen,5,10,5,1,00212,India
520569,2023-12-10,717,spiral bound book,50,100,50,1,00351,India
520569,2023-12-10,709,notebook,30,60,30,1,00351,India
520569,2023-12-10,714,carbon paper,15,30,15,1,00351,India
520569,2023-12-10,705,stencil,10,20,10,1,00351,India
212147,2023-12-10,711,TD kit,150,300,150,1,00287,India
212147,2023-12-10,707,marker,20,40,20,1,00287,India
248051,2023-12-10,701,gel pen,5,10,5,1,00436,India
306001,2023-12-10,702,pencil,2,5,3,1,00030,India
306001,2023-12-10,713,ball pen,5,10,5,1,00030,India
967650,2023-12-10,704,scale,5,10,5,1,00302,India
967650,2023-12-10,705,stencil,10,20,10,1,00302,India
967650,2023-12-10,703,eraser,1,3,2,1,00302,India
967650,2023-12-10,706,sharpener,3,8,5,1,00302,India
812583,2023-12-10,712,graph paper,20,40,20,1,00129,India
812583,2023-12-10,701,gel pen,5,10,5,1,00129,India
812583,2023-12-10,706,sharpener,3,8,5,1,00129,India
470572,2023-12-10,701,gel pen,5,10,5,1,00337,India
250009,2023-12-10,710,geometry box,100,150,50,1,00269,India
250009,2023-12-10,716,printing paper,200,400,200,1,00269,India
250009,2023-12-10,711,TD kit,150,300,150,1,00269,India
250009,2023-12-10,715,folder,5,15,10,1,00269,India
431291,2023-12-10,702,pencil,2,5,3,1,00162,India
431291,2023-12-10,711,TD kit,150,300,150,1,00162,India
249283,2023-12-10,704,scale,5,10,5,1,00431,India
249283,2023-12-10,713,ball pen,5,10,5,1,00431,India
249283,2023-12-10,706,sharpener,3,8,5,1,00431,India
539217,2023-12-10,711,TD kit,150,300,150,1,00373,India
539217,2023-12-10,702,pencil,2,5,3,1,00373,India
862534,2023-12-10,713,ball pen,5,10,5,1,00374,India
862534,2023-12-10,715,folder,5,15,10,1,00374,India
962724,2023-12-10,707,marker,20,40,20,1,00460,India
962724,2023-12-10,712,graph paper,20,40,20,1,00460,India
962724,2023-12-10,711,TD kit,150,300,150,1,00460,India
532858,2023-12-10,709,notebook,30,60,30,1,00156,India
532858,2023-12-10,705,stencil,10,20,10,1,00156,India
361666,2023-12-10,712,graph paper,20,40,20,1,00290,India
361666,2023-12-10,716,printing paper,200,400,200,1,00290,India
792591,2023-12-10,710,geometry box,100,150,50,1,00002,India
792591,2023-12-10,701,gel pen,5,10,5,1,00002,India
680477,2023-12-10,710,geometry box,100,150,50,1,00384,India
471597,2023-12-10,716,printing paper,200,400,200,1,00405,India
471597,2023-12-10,717,spiral bound book,50,100,50,1,00405,India
471597,2023-12-10,714,carbon paper,15,30,15,1,00405,India
471597,2023-12-10,707,marker,20,40,20,1,00405,India
916832,2023-12-10,714,carbon paper,15,30,15,1,00182,India
916832,2023-12-10,710,geometry box,100,150,50,1,00182,India
916832,2023-12-10,701,gel pen,5,10,5,1,00182,India
489364,2023-12-10,710,geometry box,100,150,50,1,00444,India
942204,2023-12-10,713,ball pen,5,10,5,1,00484,India
849192,2023-12-10,703,eraser,1,3,2,1,00224,India
849192,2023-12-10,716,printing paper,200,400,200,1,00224,India
849192,2023-12-10,702,pencil,2,5,3,1,00224,India
245014,2023-12-10,717,spiral bound book,50,100,50,1,00145,India
808150,2023-12-10,702,pencil,2,5,3,1,00420,India
808150,2023-12-10,710,geometry box,100,150,50,1,00420,India
808150,2023-12-10,707,marker,20,40,20,1,00420,India
512465,2023-12-10,713,ball pen,5,10,5,1,00299,India
512465,2023-12-10,716,printing paper,200,400,200,1,00299,India
512465,2023-12-10,711,TD kit,150,300,150,1,00299,India
183440,2023-12-10,713,ball pen,5,10,5,1,00060,India
295757,2023-12-10,706,sharpener,3,8,5,1,00066,India
295757,2023-12-10,702,pencil,2,5,3,1,00066,India
295757,2023-12-10,704,scale,5,10,5,1,00066,India
159724,2023-12-10,701,gel pen,5,10,5,1,00014,India
159724,2023-12-10,702,pencil,2,5,3,1,00014,India
159724,2023-12-10,707,marker,20,40,20,1,00014,India
603292,2023-12-10,712,graph paper,20,40,20,1,00242,India
947762,2023-12-10,703,eraser,1,3,2,1,00151,India
947762,2023-12-10,717,spiral bound book,50,100,50,1,00151,India
947762,2023-12-10,709,notebook,30,60,30,1,00151,India
947762,2023-12-10,715,folder,5,15,10,1,00151,India
985859,2023-12-10,704,scale,5,10,5,1,00460,India
309200,2023-12-11,704,scale,5,10,5,1,00181,India
309200,2023-12-11,711,TD kit,150,300,150,1,00181,India
309200,2023-12-11,714,carbon paper,15,30,15,1,00181,India
188324,2023-12-11,703,eraser,1,3,2,1,00097,India
188324,2023-12-11,706,sharpener,3,8,5,1,00097,India
188324,2023-12-11,704,scale,5,10,5,1,00097,India
188324,2023-12-11,714,carbon paper,15,30,15,1,00097,India
700710,2023-12-11,704,scale,5,10,5,1,00314,India
437509,2023-12-11,704,scale,5,10,5,1,00154,India
437509,2023-12-11,709,notebook,30,60,30,1,00154,India
437509,2023-12-11,712,graph paper,20,40,20,1,00154,India
437509,2023-12-11,703,eraser,1,3,2,1,00154,India
806234,2023-12-11,709,notebook,30,60,30,1,00108,India
806234,2023-12-11,713,ball pen,5,10,5,1,00108,India
806234,2023-12-11,711,TD kit,150,300,150,1,00108,India
806234,2023-12-11,717,spiral bound book,50,100,50,1,00108,India
806234,2023-12-11,714,carbon paper,15,30,15,1,00108,India
328819,2023-12-11,715,folder,5,15,10,1,00020,India
712315,2023-12-11,701,gel pen,5,10,5,1,00394,India
375869,2023-12-11,703,eraser,1,3,2,1,00036,India
375869,2023-12-11,712,graph paper,20,40,20,1,00036,India
259744,2023-12-11,713,ball pen,5,10,5,1,00199,India
869463,2023-12-11,707,marker,20,40,20,1,00139,India
869463,2023-12-11,716,printing paper,200,400,200,1,00139,India
869463,2023-12-11,703,eraser,1,3,2,1,00139,India
869463,2023-12-11,712,graph paper,20,40,20,1,00139,India
158949,2023-12-11,706,sharpener,3,8,5,1,00230,India
158949,2023-12-11,703,eraser,1,3,2,1,00230,India
158949,2023-12-11,705,stencil,10,20,10,1,00230,India
158949,2023-12-11,717,spiral bound book,50,100,50,1,00230,India
158949,2023-12-11,713,ball pen,5,10,5,1,00230,India
469988,2023-12-11,713,ball pen,5,10,5,1,00465,India
469988,2023-12-11,714,carbon paper,15,30,15,1,00465,India
469988,2023-12-11,703,eraser,1,3,2,1,00465,India
469988,2023-12-11,704,scale,5,10,5,1,00465,India
469988,2023-12-11,710,geometry box,100,150,50,1,00465,India
754047,2023-12-11,706,sharpener,3,8,5,1,00440,India
754047,2023-12-11,708,sketchpen,15,40,25,1,00440,India
754047,2023-12-11,703,eraser,1,3,2,1,00440,India
329777,2023-12-11,707,marker,20,40,20,1,00308,India
329777,2023-12-11,706,sharpener,3,8,5,1,00308,India
329777,2023-12-11,713,ball pen,5,10,5,1,00308,India
329777,2023-12-11,715,folder,5,15,10,1,00308,India
329777,2023-12-11,709,notebook,30,60,30,1,00308,India
107252,2023-12-11,717,spiral bound book,50,100,50,1,00414,India
107252,2023-12-11,713,ball pen,5,10,5,1,00414,India
107252,2023-12-11,701,gel pen,5,10,5,1,00414,India
107252,2023-12-11,714,carbon paper,15,30,15,1,00414,India
861073,2023-12-11,702,pencil,2,5,3,1,00027,India
508935,2023-12-11,709,notebook,30,60,30,1,00238,India
930412,2023-12-11,715,folder,5,15,10,1,00216,India
540825,2023-12-11,708,sketchpen,15,40,25,1,00301,India
540825,2023-12-11,705,stencil,10,20,10,1,00301,India
250407,2023-12-11,708,sketchpen,15,40,25,1,00283,India
250407,2023-12-11,702,pencil,2,5,3,1,00283,India
160591,2023-12-11,704,scale,5,10,5,1,00247,India
160591,2023-12-11,706,sharpener,3,8,5,1,00247,India
160591,2023-12-11,716,printing paper,200,400,200,1,00247,India
160591,2023-12-11,701,gel pen,5,10,5,1,00247,India
160591,2023-12-11,711,TD kit,150,300,150,1,00247,India
891070,2023-12-11,709,notebook,30,60,30,1,00482,India
891070,2023-12-11,704,scale,5,10,5,1,00482,India
891070,2023-12-11,711,TD kit,150,300,150,1,00482,India
891070,2023-12-11,710,geometry box,100,150,50,1,00482,India
596084,2023-12-11,715,folder,5,15,10,1,00271,India
596084,2023-12-11,716,printing paper,200,400,200,1,00271,India
596084,2023-12-11,714,carbon paper,15,30,15,1,00271,India
676325,2023-12-11,715,folder,5,15,10,1,00270,India
676325,2023-12-11,701,gel pen,5,10,5,1,00270,India
676325,2023-12-11,705,stencil,10,20,10,1,00270,India
676325,2023-12-11,709,notebook,30,60,30,1,00270,India
676325,2023-12-11,716,printing paper,200,400,200,1,00270,India
126714,2023-12-11,711,TD kit,150,300,150,1,00310,India
445121,2023-12-11,713,ball pen,5,10,5,1,00471,India
445121,2023-12-11,716,printing paper,200,400,200,1,00471,India
500645,2023-12-11,712,graph paper,20,40,20,1,00013,India
500645,2023-12-11,710,geometry box,100,150,50,1,00013,India
619109,2023-12-11,716,printing paper,200,400,200,1,00469,India
547760,2023-12-11,702,pencil,2,5,3,1,00099,India
547760,2023-12-11,713,ball pen,5,10,5,1,00099,India
547760,2023-12-11,705,stencil,10,20,10,1,00099,India
547760,2023-12-11,711,TD kit,150,300,150,1,00099,India
180510,2023-12-11,701,gel pen,5,10,5,1,00380,India
180510,2023-12-11,709,notebook,30,60,30,1,00380,India
977201,2023-12-11,712,graph paper,20,40,20,1,00076,India
977201,2023-12-11,703,eraser,1,3,2,1,00076,India
213979,2023-12-11,713,ball pen,5,10,5,1,00232,India
213979,2023-12-11,715,folder,5,15,10,1,00232,India
213979,2023-12-11,703,eraser,1,3,2,1,00232,India
213979,2023-12-11,707,marker,20,40,20,1,00232,India
213979,2023-12-11,716,printing paper,200,400,200,1,00232,India
396109,2023-12-11,707,marker,20,40,20,1,00278,India
396109,2023-12-11,709,notebook,30,60,30,1,00278,India
350003,2023-12-11,702,pencil,2,5,3,1,00461,India
350003,2023-12-11,710,geometry box,100,150,50,1,00461,India
350003,2023-12-11,709,notebook,30,60,30,1,00461,India
350003,2023-12-11,707,marker,20,40,20,1,00461,India
620248,2023-12-11,715,folder,5,15,10,1,00067,India
109904,2023-12-11,712,graph paper,20,40,20,1,00455,India
109904,2023-12-11,711,TD kit,150,300,150,1,00455,India
109904,2023-12-11,706,sharpener,3,8,5,1,00455,India
203474,2023-12-11,712,graph paper,20,40,20,1,00360,India
203474,2023-12-11,702,pencil,2,5,3,1,00360,India
203474,2023-12-11,716,printing paper,200,400,200,1,00360,India
203474,2023-12-11,706,sharpener,3,8,5,1,00360,India
924539,2023-12-11,713,ball pen,5,10,5,1,00284,India
924539,2023-12-11,707,marker,20,40,20,1,00284,India
924539,2023-12-11,703,eraser,1,3,2,1,00284,India
924539,2023-12-11,710,geometry box,100,150,50,1,00284,India
442467,2023-12-11,716,printing paper,200,400,200,1,00036,India
124265,2023-12-11,701,gel pen,5,10,5,1,00374,India
124265,2023-12-11,704,scale,5,10,5,1,00374,India
124265,2023-12-11,711,TD kit,150,300,150,1,00374,India
382199,2023-12-11,709,notebook,30,60,30,1,00448,India
382199,2023-12-11,703,eraser,1,3,2,1,00448,India
382199,2023-12-11,717,spiral bound book,50,100,50,1,00448,India
118161,2023-12-11,712,graph paper,20,40,20,1,00257,India
118161,2023-12-11,714,carbon paper,15,30,15,1,00257,India
118161,2023-12-11,701,gel pen,5,10,5,1,00257,India
157264,2023-12-11,701,gel pen,5,10,5,1,00012,India
157264,2023-12-11,714,carbon paper,15,30,15,1,00012,India
157264,2023-12-11,708,sketchpen,15,40,25,1,00012,India
157264,2023-12-11,712,graph paper,20,40,20,1,00012,India
180754,2023-12-11,716,printing paper,200,400,200,1,00492,India
180754,2023-12-11,708,sketchpen,15,40,25,1,00492,India
180754,2023-12-11,712,graph paper,20,40,20,1,00492,India
474270,2023-12-11,705,stencil,10,20,10,1,00367,India
408990,2023-12-11,702,pencil,2,5,3,1,00274,India
408990,2023-12-11,706,sharpener,3,8,5,1,00274,India
408990,2023-12-11,710,geometry box,100,150,50,1,00274,India
332079,2023-12-11,708,sketchpen,15,40,25,1,00043,India
332079,2023-12-11,709,notebook,30,60,30,1,00043,India
332079,2023-12-11,705,stencil,10,20,10,1,00043,India
315036,2023-12-11,713,ball pen,5,10,5,1,00280,India
315036,2023-12-11,715,folder,5,15,10,1,00280,India
315036,2023-12-11,711,TD kit,150,300,150,1,00280,India
315036,2023-12-11,717,spiral bound book,50,100,50,1,00280,India
522843,2023-12-12,714,carbon paper,15,30,15,1,00267,India
522843,2023-12-12,701,gel pen,5,10,5,1,00267,India
522843,2023-12-12,711,TD kit,150,300,150,1,00267,India
522843,2023-12-12,713,ball pen,5,10,5,1,00267,India
836032,2023-12-12,705,stencil,10,20,10,1,00172,India
836032,2023-12-12,715,folder,5,15,10,1,00172,India
836032,2023-12-12,716,printing paper,200,400,200,1,00172,India
792552,2023-12-12,714,carbon paper,15,30,15,1,00154,India
792552,2023-12-12,713,ball pen,5,10,5,1,00154,India
792552,2023-12-12,705,stencil,10,20,10,1,00154,India
220083,2023-12-12,705,stencil,10,20,10,1,00216,India
220083,2023-12-12,706,sharpener,3,8,5,1,00216,India
341797,2023-12-12,717,spiral bound book,50,100,50,1,00177,India
341797,2023-12-12,708,sketchpen,15,40,25,1,00177,India
341797,2023-12-12,707,marker,20,40,20,1,00177,India
682529,2023-12-12,705,stencil,10,20,10,1,00210,India
744491,2023-12-12,716,printing paper,200,400,200,1,00396,India
744491,2023-12-12,715,folder,5,15,10,1,00396,India
144568,2023-12-12,705,stencil,10,20,10,1,00065,India
144568,2023-12-12,711,TD kit,150,300,150,1,00065,India
135437,2023-12-12,716,printing paper,200,400,200,1,00361,India
135437,2023-12-12,710,geometry box,100,150,50,1,00361,India
135437,2023-12-12,709,notebook,30,60,30,1,00361,India
768868,2023-12-12,710,geometry box,100,150,50,1,00135,India
828645,2023-12-12,704,scale,5,10,5,1,00271,India
828645,2023-12-12,713,ball pen,5,10,5,1,00271,India
856641,2023-12-12,705,stencil,10,20,10,1,00079,India
856641,2023-12-12,714,carbon paper,15,30,15,1,00079,India
856641,2023-12-12,715,folder,5,15,10,1,00079,India
444662,2023-12-12,710,geometry box,100,150,50,1,00263,India
444662,2023-12-12,705,stencil,10,20,10,1,00263,India
179651,2023-12-12,710,geometry box,100,150,50,1,00391,India
179651,2023-12-12,701,gel pen,5,10,5,1,00391,India
179651,2023-12-12,709,notebook,30,60,30,1,00391,India
318636,2023-12-12,715,folder,5,15,10,1,00249,India
318636,2023-12-12,714,carbon paper,15,30,15,1,00249,India
318636,2023-12-12,707,marker,20,40,20,1,00249,India
431079,2023-12-12,715,folder,5,15,10,1,00378,India
431079,2023-12-12,702,pencil,2,5,3,1,00378,India
431079,2023-12-12,712,graph paper,20,40,20,1,00378,India
431079,2023-12-12,717,spiral bound book,50,100,50,1,00378,India
836136,2023-12-12,716,printing paper,200,400,200,1,00351,India
836136,2023-12-12,706,sharpener,3,8,5,1,00351,India
761827,2023-12-12,714,carbon paper,15,30,15,1,00446,India
799293,2023-12-12,717,spiral bound book,50,100,50,1,00441,India
799293,2023-12-12,713,ball pen,5,10,5,1,00441,India
398000,2023-12-12,710,geometry box,100,150,50,1,00089,India
398000,2023-12-12,712,graph paper,20,40,20,1,00089,India
954706,2023-12-12,716,printing paper,200,400,200,1,00231,India
954706,2023-12-12,712,graph paper,20,40,20,1,00231,India
954706,2023-12-12,711,TD kit,150,300,150,1,00231,India
383315,2023-12-12,712,graph paper,20,40,20,1,00135,India
383315,2023-12-12,713,ball pen,5,10,5,1,00135,India
383315,2023-12-12,711,TD kit,150,300,150,1,00135,India
383315,2023-12-12,708,sketchpen,15,40,25,1,00135,India
706411,2023-12-12,702,pencil,2,5,3,1,00292,India
706411,2023-12-12,703,eraser,1,3,2,1,00292,India
706411,2023-12-12,706,sharpener,3,8,5,1,00292,India
706411,2023-12-12,716,printing paper,200,400,200,1,00292,India
706411,2023-12-12,717,spiral bound book,50,100,50,1,00292,India
609745,2023-12-12,712,graph paper,20,40,20,1,00409,India
993333,2023-12-12,701,gel pen,5,10,5,1,00497,India
993333,2023-12-12,706,sharpener,3,8,5,1,00497,India
993333,2023-12-12,702,pencil,2,5,3,1,00497,India
993333,2023-12-12,705,stencil,10,20,10,1,00497,India
980501,2023-12-12,701,gel pen,5,10,5,1,00178,India
980501,2023-12-12,716,printing paper,200,400,200,1,00178,India
738762,2023-12-12,702,pencil,2,5,3,1,00419,India
738762,2023-12-12,715,folder,5,15,10,1,00419,India
590057,2023-12-12,702,pencil,2,5,3,1,00302,India
590057,2023-12-12,712,graph paper,20,40,20,1,00302,India
590057,2023-12-12,701,gel pen,5,10,5,1,00302,India
590057,2023-12-12,713,ball pen,5,10,5,1,00302,India
590057,2023-12-12,704,scale,5,10,5,1,00302,India
798023,2023-12-12,702,pencil,2,5,3,1,00246,India
828806,2023-12-12,707,marker,20,40,20,1,00185,India
828806,2023-12-12,711,TD kit,150,300,150,1,00185,India
828806,2023-12-12,717,spiral bound book,50,100,50,1,00185,India
828806,2023-12-12,712,graph paper,20,40,20,1,00185,India
812084,2023-12-12,708,sketchpen,15,40,25,1,00398,India
812084,2023-12-12,713,ball pen,5,10,5,1,00398,India
812084,2023-12-12,709,notebook,30,60,30,1,00398,India
326218,2023-12-12,715,folder,5,15,10,1,00029,India
228620,2023-12-12,711,TD kit,150,300,150,1,00244,India
228620,2023-12-12,714,carbon paper,15,30,15,1,00244,India
228620,2023-12-12,708,sketchpen,15,40,25,1,00244,India
228620,2023-12-12,709,notebook,30,60,30,1,00244,India
228620,2023-12-12,705,stencil,10,20,10,1,00244,India
827061,2023-12-12,714,carbon paper,15,30,15,1,00296,India
827061,2023-12-12,705,stencil,10,20,10,1,00296,India
882529,2023-12-12,707,marker,20,40,20,1,00003,India
882529,2023-12-12,709,notebook,30,60,30,1,00003,India
422594,2023-12-12,710,geometry box,100,150,50,1,00266,India
422594,2023-12-12,702,pencil,2,5,3,1,00266,India
422594,2023-12-12,717,spiral bound book,50,100,50,1,00266,India
148159,2023-12-12,712,graph paper,20,40,20,1,00068,India
148159,2023-12-12,716,printing paper,200,400,200,1,00068,India
804173,2023-12-12,706,sharpener,3,8,5,1,00063,India
804173,2023-12-12,707,marker,20,40,20,1,00063,India
804173,2023-12-12,708,sketchpen,15,40,25,1,00063,India
804173,2023-12-12,704,scale,5,10,5,1,00063,India
804173,2023-12-12,716,printing paper,200,400,200,1,00063,India
186764,2023-12-12,711,TD kit,150,300,150,1,00316,India
186764,2023-12-12,714,carbon paper,15,30,15,1,00316,India
827949,2023-12-12,703,eraser,1,3,2,1,00490,India
231955,2023-12-12,717,spiral bound book,50,100,50,1,00176,India
541786,2023-12-13,710,geometry box,100,150,50,1,00124,India
541786,2023-12-13,701,gel pen,5,10,5,1,00124,India
541786,2023-12-13,716,printing paper,200,400,200,1,00124,India
466663,2023-12-13,714,carbon paper,15,30,15,1,00435,India
466663,2023-12-13,705,stencil,10,20,10,1,00435,India
221679,2023-12-13,713,ball pen,5,10,5,1,00259,India
221679,2023-12-13,706,sharpener,3,8,5,1,00259,India
221679,2023-12-13,707,marker,20,40,20,1,00259,India
600653,2023-12-13,709,notebook,30,60,30,1,00355,India
669689,2023-12-13,713,ball pen,5,10,5,1,00268,India
139684,2023-12-13,711,TD kit,150,300,150,1,00256,India
139684,2023-12-13,717,spiral bound book,50,100,50,1,00256,India
139684,2023-12-13,701,gel pen,5,10,5,1,00256,India
159792,2023-12-13,701,gel pen,5,10,5,1,00177,India
724275,2023-12-13,705,stencil,10,20,10,1,00257,India
462605,2023-12-13,717,spiral bound book,50,100,50,1,00075,India
462605,2023-12-13,703,eraser,1,3,2,1,00075,India
462605,2023-12-13,709,notebook,30,60,30,1,00075,India
473275,2023-12-13,714,carbon paper,15,30,15,1,00347,India
840568,2023-12-13,715,folder,5,15,10,1,00426,India
840568,2023-12-13,705,stencil,10,20,10,1,00426,India
840568,2023-12-13,706,sharpener,3,8,5,1,00426,India
840568,2023-12-13,704,scale,5,10,5,1,00426,India
776633,2023-12-13,702,pencil,2,5,3,1,00202,India
776633,2023-12-13,714,carbon paper,15,30,15,1,00202,India
859878,2023-12-13,713,ball pen,5,10,5,1,00235,India
859878,2023-12-13,701,gel pen,5,10,5,1,00235,India
859878,2023-12-13,702,pencil,2,5,3,1,00235,India
744240,2023-12-13,716,printing paper,200,400,200,1,00112,India
744240,2023-12-13,715,folder,5,15,10,1,00112,India
744240,2023-12-13,707,marker,20,40,20,1,00112,India
786811,2023-12-13,709,notebook,30,60,30,1,00204,India
786811,2023-12-13,710,geometry box,100,150,50,1,00204,India
786811,2023-12-13,713,ball pen,5,10,5,1,00204,India
786811,2023-12-13,707,marker,20,40,20,1,00204,India
674263,2023-12-13,710,geometry box,100,150,50,1,00080,India
674263,2023-12-13,702,pencil,2,5,3,1,00080,India
674263,2023-12-13,705,stencil,10,20,10,1,00080,India
674263,2023-12-13,708,sketchpen,15,40,25,1,00080,India
830011,2023-12-13,705,stencil,10,20,10,1,00232,India
830011,2023-12-13,716,printing paper,200,400,200,1,00232,India
830011,2023-12-13,717,spiral bound book,50,100,50,1,00232,India
638139,2023-12-13,717,spiral bound book,50,100,50,1,00444,India
638139,2023-12-13,711,TD kit,150,300,150,1,00444,India
638139,2023-12-13,715,folder,5,15,10,1,00444,India
638139,2023-12-13,712,graph paper,20,40,20,1,00444,India
638139,2023-12-13,701,gel pen,5,10,5,1,00444,India
889279,2023-12-13,706,sharpener,3,8,5,1,00104,India
889279,2023-12-13,712,graph paper,20,40,20,1,00104,India
889279,2023-12-13,717,spiral bound book,50,100,50,1,00104,India
316275,2023-12-13,715,folder,5,15,10,1,00472,India
316275,2023-12-13,709,notebook,30,60,30,1,00472,India
316275,2023-12-13,716,printing paper,200,400,200,1,00472,India
316275,2023-12-13,701,gel pen,5,10,5,1,00472,India
316275,2023-12-13,704,scale,5,10,5,1,00472,India
830169,2023-12-13,715,folder,5,15,10,1,00327,India
616027,2023-12-13,701,gel pen,5,10,5,1,00378,India
529140,2023-12-13,712,graph paper,20,40,20,1,00110,India
529140,2023-12-13,702,pencil,2,5,3,1,00110,India
360952,2023-12-13,706,sharpener,3,8,5,1,00169,India
360952,2023-12-13,716,printing paper,200,400,200,1,00169,India
116740,2023-12-13,714,carbon paper,15,30,15,1,00020,India
116740,2023-12-13,701,gel pen,5,10,5,1,00020,India
116740,2023-12-13,717,spiral bound book,50,100,50,1,00020,India
116740,2023-12-13,704,scale,5,10,5,1,00020,India
116740,2023-12-13,710,geometry box,100,150,50,1,00020,India
461042,2023-12-13,714,carbon paper,15,30,15,1,00067,India
827019,2023-12-13,705,stencil,10,20,10,1,00146,India
827019,2023-12-13,708,sketchpen,15,40,25,1,00146,India
827019,2023-12-13,716,printing paper,200,400,200,1,00146,India
827019,2023-12-13,704,scale,5,10,5,1,00146,India
827019,2023-12-13,714,carbon paper,15,30,15,1,00146,India
429661,2023-12-13,716,printing paper,200,400,200,1,00396,India
429661,2023-12-13,705,stencil,10,20,10,1,00396,India
429661,2023-12-13,712,graph paper,20,40,20,1,00396,India
429661,2023-12-13,717,spiral bound book,50,100,50,1,00396,India
810410,2023-12-13,708,sketchpen,15,40,25,1,00461,India
810410,2023-12-13,703,eraser,1,3,2,1,00461,India
810410,2023-12-13,717,spiral bound book,50,100,50,1,00461,India
284644,2023-12-13,705,stencil,10,20,10,1,00168,India
284644,2023-12-13,710,geometry box,100,150,50,1,00168,India
845741,2023-12-13,705,stencil,10,20,10,1,00310,India
845741,2023-12-13,710,geometry box,100,150,50,1,00310,India
120933,2023-12-13,708,sketchpen,15,40,25,1,00157,India
120933,2023-12-13,703,eraser,1,3,2,1,00157,India
120933,2023-12-13,706,sharpener,3,8,5,1,00157,India
833615,2023-12-13,714,carbon paper,15,30,15,1,00179,India
833615,2023-12-13,717,spiral bound book,50,100,50,1,00179,India
833615,2023-12-13,710,geometry box,100,150,50,1,00179,India
833615,2023-12-13,715,folder,5,15,10,1,00179,India
289027,2023-12-13,717,spiral bound book,50,100,50,1,00070,India
289027,2023-12-13,712,graph paper,20,40,20,1,00070,India
289027,2023-12-13,716,printing paper,200,400,200,1,00070,India
289027,2023-12-13,701,gel pen,5,10,5,1,00070,India
289027,2023-12-13,708,sketchpen,15,40,25,1,00070,India
642192,2023-12-13,713,ball pen,5,10,5,1,00297,India
365015,2023-12-13,716,printing paper,200,400,200,1,00045,India
365015,2023-12-13,706,sharpener,3,8,5,1,00045,India
365015,2023-12-13,717,spiral bound book,50,100,50,1,00045,India
365015,2023-12-13,711,TD kit,150,300,150,1,00045,India
272306,2023-12-13,704,scale,5,10,5,1,00488,India
272306,2023-12-13,703,eraser,1,3,2,1,00488,India
272306,2023-12-13,702,pencil,2,5,3,1,00488,India
413351,2023-12-13,701,gel pen,5,10,5,1,00094,India
413351,2023-12-13,705,stencil,10,20,10,1,00094,India
389044,2023-12-13,703,eraser,1,3,2,1,00410,India
389044,2023-12-13,705,stencil,10,20,10,1,00410,India
389044,2023-12-13,712,graph paper,20,40,20,1,00410,India
389044,2023-12-13,714,carbon paper,15,30,15,1,00410,India
684090,2023-12-13,715,folder,5,15,10,1,00270,India
684090,2023-12-13,711,TD kit,150,300,150,1,00270,India
684090,2023-12-13,707,marker,20,40,20,1,00270,India
684090,2023-12-13,710,geometry box,100,150,50,1,00270,India
555243,2023-12-13,712,graph paper,20,40,20,1,00111,India
555243,2023-12-13,715,folder,5,15,10,1,00111,India
771832,2023-12-13,709,notebook,30,60,30,1,00104,India
771832,2023-12-13,710,geometry box,100,150,50,1,00104,India
771832,2023-12-13,705,stencil,10,20,10,1,00104,India
771832,2023-12-13,704,scale,5,10,5,1,00104,India
876972,2023-12-13,717,spiral bound book,50,100,50,1,00120,India
876972,2023-12-13,713,ball pen,5,10,5,1,00120,India
266109,2023-12-13,707,marker,20,40,20,1,00149,India
266109,2023-12-13,717,spiral bound book,50,100,50,1,00149,India
266109,2023-12-13,704,scale,5,10,5,1,00149,India
896011,2023-12-13,714,carbon paper,15,30,15,1,00244,India
896011,2023-12-13,710,geometry box,100,150,50,1,00244,India
896011,2023-12-13,709,notebook,30,60,30,1,00244,India
896011,2023-12-13,711,TD kit,150,300,150,1,00244,India
830485,2023-12-14,714,carbon paper,15,30,15,1,00248,India
830485,2023-12-14,701,gel pen,5,10,5,1,00248,India
958052,2023-12-14,709,notebook,30,60,30,1,00067,India
958052,2023-12-14,710,geometry box,100,150,50,1,00067,India
958052,2023-12-14,707,marker,20,40,20,1,00067,India
958052,2023-12-14,717,spiral bound book,50,100,50,1,00067,India
958052,2023-12-14,712,graph paper,20,40,20,1,00067,India
892571,2023-12-14,705,stencil,10,20,10,1,00022,India
892571,2023-12-14,711,TD kit,150,300,150,1,00022,India
892571,2023-12-14,706,sharpener,3,8,5,1,00022,India
892571,2023-12-14,715,folder,5,15,10,1,00022,India
722558,2023-12-14,713,ball pen,5,10,5,1,00253,India
722558,2023-12-14,702,pencil,2,5,3,1,00253,India
408987,2023-12-14,706,sharpener,3,8,5,1,00220,India
408987,2023-12-14,717,spiral bound book,50,100,50,1,00220,India
408987,2023-12-14,716,printing paper,200,400,200,1,00220,India
472941,2023-12-14,709,notebook,30,60,30,1,00230,India
472941,2023-12-14,714,carbon paper,15,30,15,1,00230,India
472941,2023-12-14,712,graph paper,20,40,20,1,00230,India
472941,2023-12-14,707,marker,20,40,20,1,00230,India
472941,2023-12-14,708,sketchpen,15,40,25,1,00230,India
539369,2023-12-14,701,gel pen,5,10,5,1,00402,India
539369,2023-12-14,708,sketchpen,15,40,25,1,00402,India
539369,2023-12-14,710,geometry box,100,150,50,1,00402,India
539369,2023-12-14,704,scale,5,10,5,1,00402,India
539369,2023-12-14,705,stencil,10,20,10,1,00402,India
154080,2023-12-14,713,ball pen,5,10,5,1,00361,India
154080,2023-12-14,709,notebook,30,60,30,1,00361,India
154080,2023-12-14,708,sketchpen,15,40,25,1,00361,India
154080,2023-12-14,714,carbon paper,15,30,15,1,00361,India
455518,2023-12-14,713,ball pen,5,10,5,1,00384,India
455518,2023-12-14,712,graph paper,20,40,20,1,00384,India
455518,2023-12-14,711,TD kit,150,300,150,1,00384,India
455518,2023-12-14,715,folder,5,15,10,1,00384,India
455518,2023-12-14,703,eraser,1,3,2,1,00384,India
147178,2023-12-14,717,spiral bound book,50,100,50,1,00197,India
147178,2023-12-14,703,eraser,1,3,2,1,00197,India
147178,2023-12-14,708,sketchpen,15,40,25,1,00197,India
204176,2023-12-14,703,eraser,1,3,2,1,00103,India
204176,2023-12-14,707,marker,20,40,20,1,00103,India
204176,2023-12-14,712,graph paper,20,40,20,1,00103,India
204176,2023-12-14,714,carbon paper,15,30,15,1,00103,India
353305,2023-12-14,706,sharpener,3,8,5,1,00176,India
353305,2023-12-14,716,printing paper,200,400,200,1,00176,India
353305,2023-12-14,713,ball pen,5,10,5,1,00176,India
353305,2023-12-14,711,TD kit,150,300,150,1,00176,India
459560,2023-12-14,707,marker,20,40,20,1,00495,India
459560,2023-12-14,706,sharpener,3,8,5,1,00495,India
459560,2023-12-14,717,spiral bound book,50,100,50,1,00495,India
459560,2023-12-14,703,eraser,1,3,2,1,00495,India
459560,2023-12-14,711,TD kit,150,300,150,1,00495,India
637739,2023-12-14,717,spiral bound book,50,100,50,1,00035,India
637739,2023-12-14,714,carbon paper,15,30,15,1,00035,India
637739,2023-12-14,706,sharpener,3,8,5,1,00035,India
637739,2023-12-14,709,notebook,30,60,30,1,00035,India
674196,2023-12-14,706,sharpener,3,8,5,1,00229,India
674196,2023-12-14,705,stencil,10,20,10,1,00229,India
674196,2023-12-14,717,spiral bound book,50,100,50,1,00229,India
674196,2023-12-14,701,gel pen,5,10,5,1,00229,India
932897,2023-12-14,705,stencil,10,20,10,1,00232,India
932897,2023-12-14,701,gel pen,5,10,5,1,00232,India
932897,2023-12-14,706,sharpener,3,8,5,1,00232,India
932897,2023-12-14,711,TD kit,150,300,150,1,00232,India
387167,2023-12-14,710,geometry box,100,150,50,1,00460,India
228627,2023-12-14,701,gel pen,5,10,5,1,00080,India
228627,2023-12-14,708,sketchpen,15,40,25,1,00080,India
144429,2023-12-14,701,gel pen,5,10,5,1,00397,India
144429,2023-12-14,710,geometry box,100,150,50,1,00397,India
144429,2023-12-14,716,printing paper,200,400,200,1,00397,India
144429,2023-12-14,707,marker,20,40,20,1,00397,India
144429,2023-12-14,711,TD kit,150,300,150,1,00397,India
965990,2023-12-14,708,sketchpen,15,40,25,1,00438,India
161150,2023-12-14,708,sketchpen,15,40,25,1,00392,India
161150,2023-12-14,706,sharpener,3,8,5,1,00392,India
357400,2023-12-14,711,TD kit,150,300,150,1,00403,India
357400,2023-12-14,702,pencil,2,5,3,1,00403,India
357400,2023-12-14,716,printing paper,200,400,200,1,00403,India
584197,2023-12-14,711,TD kit,150,300,150,1,00087,India
444026,2023-12-14,716,printing paper,200,400,200,1,00456,India
444026,2023-12-14,710,geometry box,100,150,50,1,00456,India
444026,2023-12-14,706,sharpener,3,8,5,1,00456,India
444026,2023-12-14,715,folder,5,15,10,1,00456,India
748674,2023-12-14,707,marker,20,40,20,1,00181,India
748674,2023-12-14,701,gel pen,5,10,5,1,00181,India
748674,2023-12-14,710,geometry box,100,150,50,1,00181,India
748674,2023-12-14,702,pencil,2,5,3,1,00181,India
951274,2023-12-14,715,folder,5,15,10,1,00131,India
951274,2023-12-14,716,printing paper,200,400,200,1,00131,India
151126,2023-12-14,716,printing paper,200,400,200,1,00241,India
151126,2023-12-14,710,geometry box,100,150,50,1,00241,India
953073,2023-12-14,714,carbon paper,15,30,15,1,00205,India
953073,2023-12-14,702,pencil,2,5,3,1,00205,India
953073,2023-12-14,711,TD kit,150,300,150,1,00205,India
953073,2023-12-14,705,stencil,10,20,10,1,00205,India
527884,2023-12-14,702,pencil,2,5,3,1,00354,India
527884,2023-12-14,703,eraser,1,3,2,1,00354,India
527884,2023-12-14,707,marker,20,40,20,1,00354,India
527884,2023-12-14,713,ball pen,5,10,5,1,00354,India
762517,2023-12-14,711,TD kit,150,300,150,1,00374,India
427485,2023-12-14,705,stencil,10,20,10,1,00212,India
427485,2023-12-14,707,marker,20,40,20,1,00212,India
427485,2023-12-14,711,TD kit,150,300,150,1,00212,India
178102,2023-12-14,706,sharpener,3,8,5,1,00173,India
178102,2023-12-14,715,folder,5,15,10,1,00173,India
178102,2023-12-14,704,scale,5,10,5,1,00173,India
285000,2023-12-15,708,sketchpen,15,40,25,1,00145,India
285000,2023-12-15,703,eraser,1,3,2,1,00145,India
285000,2023-12-15,707,marker,20,40,20,1,00145,India
350244,2023-12-15,704,scale,5,10,5,1,00406,India
485487,2023-12-15,703,eraser,1,3,2,1,00219,India
485487,2023-12-15,711,TD kit,150,300,150,1,00219,India
485487,2023-12-15,713,ball pen,5,10,5,1,00219,India
485487,2023-12-15,707,marker,20,40,20,1,00219,India
341371,2023-12-15,708,sketchpen,15,40,25,1,00050,India
341371,2023-12-15,714,carbon paper,15,30,15,1,00050,India
837662,2023-12-15,705,stencil,10,20,10,1,00292,India
837662,2023-12-15,707,marker,20,40,20,1,00292,India
837662,2023-12-15,711,TD kit,150,300,150,1,00292,India
837662,2023-12-15,704,scale,5,10,5,1,00292,India
837662,2023-12-15,712,graph paper,20,40,20,1,00292,India
116128,2023-12-15,715,folder,5,15,10,1,00261,India
912642,2023-12-15,709,notebook,30,60,30,1,00461,India
635817,2023-12-15,706,sharpener,3,8,5,1,00132,India
635817,2023-12-15,710,geometry box,100,150,50,1,00132,India
548167,2023-12-15,705,stencil,10,20,10,1,00474,India
548167,2023-12-15,713,ball pen,5,10,5,1,00474,India
548167,2023-12-15,717,spiral bound book,50,100,50,1,00474,India
548167,2023-12-15,703,eraser,1,3,2,1,00474,India
548167,2023-12-15,706,sharpener,3,8,5,1,00474,India
117787,2023-12-15,702,pencil,2,5,3,1,00299,India
117787,2023-12-15,705,stencil,10,20,10,1,00299,India
117787,2023-12-15,707,marker,20,40,20,1,00299,India
117787,2023-12-15,715,folder,5,15,10,1,00299,India
117787,2023-12-15,706,sharpener,3,8,5,1,00299,India
351319,2023-12-15,710,geometry box,100,150,50,1,00483,India
351319,2023-12-15,703,eraser,1,3,2,1,00483,India
837116,2023-12-15,714,carbon paper,15,30,15,1,00025,India
837116,2023-12-15,709,notebook,30,60,30,1,00025,India
307277,2023-12-15,703,eraser,1,3,2,1,00136,India
307277,2023-12-15,714,carbon paper,15,30,15,1,00136,India
322605,2023-12-15,702,pencil,2,5,3,1,00074,India
322605,2023-12-15,703,eraser,1,3,2,1,00074,India
322605,2023-12-15,711,TD kit,150,300,150,1,00074,India
322605,2023-12-15,706,sharpener,3,8,5,1,00074,India
837371,2023-12-15,705,stencil,10,20,10,1,00039,India
837371,2023-12-15,704,scale,5,10,5,1,00039,India
837371,2023-12-15,702,pencil,2,5,3,1,00039,India
837371,2023-12-15,708,sketchpen,15,40,25,1,00039,India
492267,2023-12-15,713,ball pen,5,10,5,1,00135,India
492267,2023-12-15,716,printing paper,200,400,200,1,00135,India
492267,2023-12-15,704,scale,5,10,5,1,00135,India
492267,2023-12-15,703,eraser,1,3,2,1,00135,India
199763,2023-12-15,701,gel pen,5,10,5,1,00408,India
199763,2023-12-15,716,printing paper,200,400,200,1,00408,India
110064,2023-12-15,706,sharpener,3,8,5,1,00085,India
709023,2023-12-15,707,marker,20,40,20,1,00225,India
709023,2023-12-15,712,graph paper,20,40,20,1,00225,India
709023,2023-12-15,708,sketchpen,15,40,25,1,00225,India
188062,2023-12-15,714,carbon paper,15,30,15,1,00343,India
188062,2023-12-15,706,sharpener,3,8,5,1,00343,India
188062,2023-12-15,709,notebook,30,60,30,1,00343,India
729903,2023-12-15,703,eraser,1,3,2,1,00338,India
251633,2023-12-15,705,stencil,10,20,10,1,00396,India
251633,2023-12-15,716,printing paper,200,400,200,1,00396,India
251633,2023-12-15,707,marker,20,40,20,1,00396,India
830422,2023-12-15,708,sketchpen,15,40,25,1,00351,India
925172,2023-12-15,713,ball pen,5,10,5,1,00306,India
925172,2023-12-15,710,geometry box,100,150,50,1,00306,India
335431,2023-12-15,708,sketchpen,15,40,25,1,00456,India
930565,2023-12-15,708,sketchpen,15,40,25,1,00491,India
101561,2023-12-15,708,sketchpen,15,40,25,1,00327,India
596404,2023-12-15,707,marker,20,40,20,1,00141,India
596404,2023-12-15,704,scale,5,10,5,1,00141,India
596404,2023-12-15,711,TD kit,150,300,150,1,00141,India
596404,2023-12-15,714,carbon paper,15,30,15,1,00141,India
596404,2023-12-15,717,spiral bound book,50,100,50,1,00141,India
429985,2023-12-15,703,eraser,1,3,2,1,00199,India
429985,2023-12-15,715,folder,5,15,10,1,00199,India
676276,2023-12-15,710,geometry box,100,150,50,1,00081,India
676276,2023-12-15,704,scale,5,10,5,1,00081,India
224258,2023-12-15,703,eraser,1,3,2,1,00372,India
224258,2023-12-15,701,gel pen,5,10,5,1,00372,India
224258,2023-12-15,704,scale,5,10,5,1,00372,India
517925,2023-12-15,705,stencil,10,20,10,1,00188,India
517925,2023-12-15,701,gel pen,5,10,5,1,00188,India
517925,2023-12-15,713,ball pen,5,10,5,1,00188,India
906992,2023-12-15,702,pencil,2,5,3,1,00230,India
553551,2023-12-15,703,eraser,1,3,2,1,00400,India
553551,2023-12-15,702,pencil,2,5,3,1,00400,India
553551,2023-12-15,701,gel pen,5,10,5,1,00400,India
502995,2023-12-15,711,TD kit,150,300,150,1,00347,India
502995,2023-12-15,710,geometry box,100,150,50,1,00347,India
502995,2023-12-15,713,ball pen,5,10,5,1,00347,India
502995,2023-12-15,703,eraser,1,3,2,1,00347,India
506828,2023-12-15,710,geometry box,100,150,50,1,00084,India
506828,2023-12-15,715,folder,5,15,10,1,00084,India
506828,2023-12-15,702,pencil,2,5,3,1,00084,India
726241,2023-12-16,714,carbon paper,15,30,15,1,00291,India
726241,2023-12-16,710,geometry box,100,150,50,1,00291,India
726241,2023-12-16,716,printing paper,200,400,200,1,00291,India
505531,2023-12-16,709,notebook,30,60,30,1,00117,India
505531,2023-12-16,701,gel pen,5,10,5,1,00117,India
505531,2023-12-16,713,ball pen,5,10,5,1,00117,India
951455,2023-12-16,710,geometry box,100,150,50,1,00036,India
951455,2023-12-16,707,marker,20,40,20,1,00036,India
951455,2023-12-16,715,folder,5,15,10,1,00036,India
309188,2023-12-16,701,gel pen,5,10,5,1,00092,India
309188,2023-12-16,706,sharpener,3,8,5,1,00092,India
788354,2023-12-16,708,sketchpen,15,40,25,1,00180,India
788354,2023-12-16,711,TD kit,150,300,150,1,00180,India
788354,2023-12-16,702,pencil,2,5,3,1,00180,India
788354,2023-12-16,706,sharpener,3,8,5,1,00180,India
989412,2023-12-16,714,carbon paper,15,30,15,1,00222,India
989412,2023-12-16,701,gel pen,5,10,5,1,00222,India
251456,2023-12-16,709,notebook,30,60,30,1,00321,India
457663,2023-12-16,712,graph paper,20,40,20,1,00422,India
457663,2023-12-16,710,geometry box,100,150,50,1,00422,India
457663,2023-12-16,703,eraser,1,3,2,1,00422,India
808976,2023-12-16,704,scale,5,10,5,1,00097,India
808976,2023-12-16,708,sketchpen,15,40,25,1,00097,India
808976,2023-12-16,705,stencil,10,20,10,1,00097,India
808976,2023-12-16,716,printing paper,200,400,200,1,00097,India
410781,2023-12-16,710,geometry box,100,150,50,1,00092,India
410781,2023-12-16,715,folder,5,15,10,1,00092,India
871604,2023-12-16,708,sketchpen,15,40,25,1,00235,India
871604,2023-12-16,712,graph paper,20,40,20,1,00235,India
581120,2023-12-16,704,scale,5,10,5,1,00382,India
581120,2023-12-16,701,gel pen,5,10,5,1,00382,India
581120,2023-12-16,708,sketchpen,15,40,25,1,00382,India
581120,2023-12-16,702,pencil,2,5,3,1,00382,India
846556,2023-12-16,709,notebook,30,60,30,1,00044,India
935840,2023-12-16,708,sketchpen,15,40,25,1,00070,India
935840,2023-12-16,711,TD kit,150,300,150,1,00070,India
935840,2023-12-16,717,spiral bound book,50,100,50,1,00070,India
935840,2023-12-16,716,printing paper,200,400,200,1,00070,India
935840,2023-12-16,705,stencil,10,20,10,1,00070,India
888269,2023-12-16,701,gel pen,5,10,5,1,00073,India
569763,2023-12-16,710,geometry box,100,150,50,1,00162,India
569763,2023-12-16,713,ball pen,5,10,5,1,00162,India
569763,2023-12-16,704,scale,5,10,5,1,00162,India
480400,2023-12-16,709,notebook,30,60,30,1,00404,India
412112,2023-12-16,701,gel pen,5,10,5,1,00071,India
412112,2023-12-16,717,spiral bound book,50,100,50,1,00071,India
412112,2023-12-16,710,geometry box,100,150,50,1,00071,India
801125,2023-12-16,703,eraser,1,3,2,1,00418,India
801125,2023-12-16,714,carbon paper,15,30,15,1,00418,India
398889,2023-12-16,711,TD kit,150,300,150,1,00385,India
398889,2023-12-16,703,eraser,1,3,2,1,00385,India
398889,2023-12-16,717,spiral bound book,50,100,50,1,00385,India
728220,2023-12-16,711,TD kit,150,300,150,1,00228,India
728220,2023-12-16,717,spiral bound book,50,100,50,1,00228,India
728220,2023-12-16,708,sketchpen,15,40,25,1,00228,India
619394,2023-12-16,710,geometry box,100,150,50,1,00318,India
619394,2023-12-16,716,printing paper,200,400,200,1,00318,India
619394,2023-12-16,708,sketchpen,15,40,25,1,00318,India
619394,2023-12-16,707,marker,20,40,20,1,00318,India
307732,2023-12-16,711,TD kit,150,300,150,1,00387,India
307732,2023-12-16,705,stencil,10,20,10,1,00387,India
307732,2023-12-16,710,geometry box,100,150,50,1,00387,India
307732,2023-12-16,707,marker,20,40,20,1,00387,India
250778,2023-12-16,714,carbon paper,15,30,15,1,00277,India
250778,2023-12-16,710,geometry box,100,150,50,1,00277,India
481992,2023-12-16,709,notebook,30,60,30,1,00096,India
481992,2023-12-16,708,sketchpen,15,40,25,1,00096,India
481992,2023-12-16,705,stencil,10,20,10,1,00096,India
481992,2023-12-16,704,scale,5,10,5,1,00096,India
481992,2023-12-16,713,ball pen,5,10,5,1,00096,India
184807,2023-12-16,701,gel pen,5,10,5,1,00315,India
184807,2023-12-16,715,folder,5,15,10,1,00315,India
417735,2023-12-16,713,ball pen,5,10,5,1,00473,India
417735,2023-12-16,706,sharpener,3,8,5,1,00473,India
417735,2023-12-16,712,graph paper,20,40,20,1,00473,India
165205,2023-12-16,705,stencil,10,20,10,1,00212,India
165205,2023-12-16,708,sketchpen,15,40,25,1,00212,India
816260,2023-12-16,713,ball pen,5,10,5,1,00486,India
816260,2023-12-16,717,spiral bound book,50,100,50,1,00486,India
816260,2023-12-16,707,marker,20,40,20,1,00486,India
740460,2023-12-16,704,scale,5,10,5,1,00295,India
740460,2023-12-16,701,gel pen,5,10,5,1,00295,India
740460,2023-12-16,706,sharpener,3,8,5,1,00295,India
379139,2023-12-16,703,eraser,1,3,2,1,00375,India
379139,2023-12-16,715,folder,5,15,10,1,00375,India
379139,2023-12-16,716,printing paper,200,400,200,1,00375,India
379139,2023-12-16,709,notebook,30,60,30,1,00375,India
678569,2023-12-16,704,scale,5,10,5,1,00307,India
678569,2023-12-16,715,folder,5,15,10,1,00307,India
678569,2023-12-16,710,geometry box,100,150,50,1,00307,India
678569,2023-12-16,711,TD kit,150,300,150,1,00307,India
959126,2023-12-16,713,ball pen,5,10,5,1,00213,India
959126,2023-12-16,702,pencil,2,5,3,1,00213,India
959126,2023-12-16,704,scale,5,10,5,1,00213,India
689504,2023-12-16,706,sharpener,3,8,5,1,00404,India
689504,2023-12-16,701,gel pen,5,10,5,1,00404,India
689504,2023-12-16,705,stencil,10,20,10,1,00404,India
689504,2023-12-16,716,printing paper,200,400,200,1,00404,India
992856,2023-12-16,707,marker,20,40,20,1,00026,India
326608,2023-12-16,703,eraser,1,3,2,1,00035,India
326608,2023-12-16,714,carbon paper,15,30,15,1,00035,India
326608,2023-12-16,717,spiral bound book,50,100,50,1,00035,India
891906,2023-12-16,713,ball pen,5,10,5,1,00240,India
891906,2023-12-16,715,folder,5,15,10,1,00240,India
504945,2023-12-16,708,sketchpen,15,40,25,1,00012,India
285406,2023-12-16,704,scale,5,10,5,1,00105,India
285406,2023-12-16,712,graph paper,20,40,20,1,00105,India
410051,2023-12-16,706,sharpener,3,8,5,1,00483,India
208045,2023-12-16,716,printing paper,200,400,200,1,00138,India
208045,2023-12-16,711,TD kit,150,300,150,1,00138,India
208045,2023-12-16,702,pencil,2,5,3,1,00138,India
979881,2023-12-16,709,notebook,30,60,30,1,00071,India
116344,2023-12-16,701,gel pen,5,10,5,1,00151,India
116344,2023-12-16,711,TD kit,150,300,150,1,00151,India
116344,2023-12-16,705,stencil,10,20,10,1,00151,India
116344,2023-12-16,708,sketchpen,15,40,25,1,00151,India
715640,2023-12-16,704,scale,5,10,5,1,00209,India
220341,2023-12-16,714,carbon paper,15,30,15,1,00010,India
220341,2023-12-16,712,graph paper,20,40,20,1,00010,India
220341,2023-12-16,702,pencil,2,5,3,1,00010,India
983216,2023-12-16,704,scale,5,10,5,1,00297,India
983216,2023-12-16,712,graph paper,20,40,20,1,00297,India
983216,2023-12-16,709,notebook,30,60,30,1,00297,India
983216,2023-12-16,711,TD kit,150,300,150,1,00297,India
146151,2023-12-16,701,gel pen,5,10,5,1,00282,India
146151,2023-12-16,716,printing paper,200,400,200,1,00282,India
530165,2023-12-17,704,scale,5,10,5,1,00137,India
530165,2023-12-17,702,pencil,2,5,3,1,00137,India
530165,2023-12-17,707,marker,20,40,20,1,00137,India
342849,2023-12-17,714,carbon paper,15,30,15,1,00362,India
342849,2023-12-17,705,stencil,10,20,10,1,00362,India
342849,2023-12-17,708,sketchpen,15,40,25,1,00362,India
342849,2023-12-17,712,graph paper,20,40,20,1,00362,India
231313,2023-12-17,717,spiral bound book,50,100,50,1,00207,India
231313,2023-12-17,702,pencil,2,5,3,1,00207,India
579176,2023-12-17,701,gel pen,5,10,5,1,00127,India
579176,2023-12-17,707,marker,20,40,20,1,00127,India
579176,2023-12-17,709,notebook,30,60,30,1,00127,India
579176,2023-12-17,715,folder,5,15,10,1,00127,India
610444,2023-12-17,707,marker,20,40,20,1,00442,India
610444,2023-12-17,711,TD kit,150,300,150,1,00442,India
610444,2023-12-17,709,notebook,30,60,30,1,00442,India
610444,2023-12-17,710,geometry box,100,150,50,1,00442,India
610444,2023-12-17,703,eraser,1,3,2,1,00442,India
806586,2023-12-17,703,eraser,1,3,2,1,00447,India
806586,2023-12-17,709,notebook,30,60,30,1,00447,India
736074,2023-12-17,703,eraser,1,3,2,1,00047,India
736074,2023-12-17,715,folder,5,15,10,1,00047,India
736074,2023-12-17,711,TD kit,150,300,150,1,00047,India
213739,2023-12-17,708,sketchpen,15,40,25,1,00282,India
213739,2023-12-17,711,TD kit,150,300,150,1,00282,India
213739,2023-12-17,717,spiral bound book,50,100,50,1,00282,India
213739,2023-12-17,707,marker,20,40,20,1,00282,India
716141,2023-12-17,705,stencil,10,20,10,1,00234,India
716141,2023-12-17,701,gel pen,5,10,5,1,00234,India
716141,2023-12-17,707,marker,20,40,20,1,00234,India
716141,2023-12-17,710,geometry box,100,150,50,1,00234,India
844654,2023-12-17,717,spiral bound book,50,100,50,1,00246,India
786340,2023-12-17,717,spiral bound book,50,100,50,1,00268,India
786340,2023-12-17,716,printing paper,200,400,200,1,00268,India
786340,2023-12-17,704,scale,5,10,5,1,00268,India
566173,2023-12-17,701,gel pen,5,10,5,1,00437,India
566173,2023-12-17,708,sketchpen,15,40,25,1,00437,India
453512,2023-12-17,705,stencil,10,20,10,1,00388,India
453512,2023-12-17,715,folder,5,15,10,1,00388,India
453512,2023-12-17,710,geometry box,100,150,50,1,00388,India
453512,2023-12-17,702,pencil,2,5,3,1,00388,India
471388,2023-12-17,714,carbon paper,15,30,15,1,00075,India
471388,2023-12-17,712,graph paper,20,40,20,1,00075,India
471388,2023-12-17,704,scale,5,10,5,1,00075,India
471388,2023-12-17,709,notebook,30,60,30,1,00075,India
344385,2023-12-17,709,notebook,30,60,30,1,00095,India
979851,2023-12-17,701,gel pen,5,10,5,1,00037,India
979851,2023-12-17,717,spiral bound book,50,100,50,1,00037,India
202973,2023-12-17,707,marker,20,40,20,1,00406,India
202973,2023-12-17,716,printing paper,200,400,200,1,00406,India
555894,2023-12-17,713,ball pen,5,10,5,1,00196,India
555894,2023-12-17,701,gel pen,5,10,5,1,00196,India
465465,2023-12-17,703,eraser,1,3,2,1,00169,India
906123,2023-12-17,709,notebook,30,60,30,1,00207,India
906123,2023-12-17,710,geometry box,100,150,50,1,00207,India
858835,2023-12-17,717,spiral bound book,50,100,50,1,00268,India
858835,2023-12-17,712,graph paper,20,40,20,1,00268,India
862890,2023-12-17,710,geometry box,100,150,50,1,00234,India
775065,2023-12-17,708,sketchpen,15,40,25,1,00424,India
775065,2023-12-17,702,pencil,2,5,3,1,00424,India
775065,2023-12-17,701,gel pen,5,10,5,1,00424,India
775065,2023-12-17,706,sharpener,3,8,5,1,00424,India
161091,2023-12-17,712,graph paper,20,40,20,1,00066,India
706206,2023-12-17,713,ball pen,5,10,5,1,00128,India
706206,2023-12-17,704,scale,5,10,5,1,00128,India
706206,2023-12-17,710,geometry box,100,150,50,1,00128,India
706206,2023-12-17,701,gel pen,5,10,5,1,00128,India
706206,2023-12-17,706,sharpener,3,8,5,1,00128,India
616940,2023-12-17,705,stencil,10,20,10,1,00325,India
616940,2023-12-17,708,sketchpen,15,40,25,1,00325,India
616940,2023-12-17,714,carbon paper,15,30,15,1,00325,India
520622,2023-12-17,710,geometry box,100,150,50,1,00281,India
520622,2023-12-17,713,ball pen,5,10,5,1,00281,India
520622,2023-12-17,702,pencil,2,5,3,1,00281,India
520622,2023-12-17,703,eraser,1,3,2,1,00281,India
429201,2023-12-17,706,sharpener,3,8,5,1,00136,India
429201,2023-12-17,701,gel pen,5,10,5,1,00136,India
429201,2023-12-17,708,sketchpen,15,40,25,1,00136,India
429201,2023-12-17,705,stencil,10,20,10,1,00136,India
288991,2023-12-17,710,geometry box,100,150,50,1,00009,India
288991,2023-12-17,715,folder,5,15,10,1,00009,India
971472,2023-12-17,712,graph paper,20,40,20,1,00487,India
755026,2023-12-17,714,carbon paper,15,30,15,1,00269,India
660070,2023-12-17,703,eraser,1,3,2,1,00281,India
711574,2023-12-17,706,sharpener,3,8,5,1,00350,India
711574,2023-12-17,711,TD kit,150,300,150,1,00350,India
711574,2023-12-17,708,sketchpen,15,40,25,1,00350,India
711574,2023-12-17,709,notebook,30,60,30,1,00350,India
711574,2023-12-17,717,spiral bound book,50,100,50,1,00350,India
413894,2023-12-17,710,geometry box,100,150,50,1,00486,India
152969,2023-12-17,709,notebook,30,60,30,1,00080,India
637016,2023-12-17,710,geometry box,100,150,50,1,00307,India
637016,2023-12-17,709,notebook,30,60,30,1,00307,India
193897,2023-12-17,712,graph paper,20,40,20,1,00141,India
193897,2023-12-17,716,printing paper,200,400,200,1,00141,India
193897,2023-12-17,710,geometry box,100,150,50,1,00141,India
193897,2023-12-17,707,marker,20,40,20,1,00141,India
733442,2023-12-18,714,carbon paper,15,30,15,1,00469,India
733442,2023-12-18,713,ball pen,5,10,5,1,00469,India
733442,2023-12-18,711,TD kit,150,300,150,1,00469,India
733442,2023-12-18,706,sharpener,3,8,5,1,00469,India
733442,2023-12-18,705,stencil,10,20,10,1,00469,India
332702,2023-12-18,710,geometry box,100,150,50,1,00409,India
332702,2023-12-18,715,folder,5,15,10,1,00409,India
322203,2023-12-18,702,pencil,2,5,3,1,00136,India
322203,2023-12-18,709,notebook,30,60,30,1,00136,India
150436,2023-12-18,701,gel pen,5,10,5,1,00032,India
150436,2023-12-18,714,carbon paper,15,30,15,1,00032,India
150436,2023-12-18,717,spiral bound book,50,100,50,1,00032,India
150436,2023-12-18,705,stencil,10,20,10,1,00032,India
606115,2023-12-18,705,stencil,10,20,10,1,00185,India
606115,2023-12-18,716,printing paper,200,400,200,1,00185,India
606115,2023-12-18,710,geometry box,100,150,50,1,00185,India
421014,2023-12-18,715,folder,5,15,10,1,00384,India
421014,2023-12-18,708,sketchpen,15,40,25,1,00384,India
421014,2023-12-18,701,gel pen,5,10,5,1,00384,India
421014,2023-12-18,712,graph paper,20,40,20,1,00384,India
898594,2023-12-18,705,stencil,10,20,10,1,00185,India
299742,2023-12-18,703,eraser,1,3,2,1,00351,India
299742,2023-12-18,701,gel pen,5,10,5,1,00351,India
299742,2023-12-18,708,sketchpen,15,40,25,1,00351,India
299742,2023-12-18,702,pencil,2,5,3,1,00351,India
791830,2023-12-18,712,graph paper,20,40,20,1,00307,India
791830,2023-12-18,704,scale,5,10,5,1,00307,India
975641,2023-12-18,715,folder,5,15,10,1,00364,India
975641,2023-12-18,708,sketchpen,15,40,25,1,00364,India
805846,2023-12-18,713,ball pen,5,10,5,1,00122,India
805846,2023-12-18,705,stencil,10,20,10,1,00122,India
805846,2023-12-18,709,notebook,30,60,30,1,00122,India
805846,2023-12-18,717,spiral bound book,50,100,50,1,00122,India
201259,2023-12-18,705,stencil,10,20,10,1,00081,India
201259,2023-12-18,707,marker,20,40,20,1,00081,India
976256,2023-12-18,706,sharpener,3,8,5,1,00183,India
976256,2023-12-18,708,sketchpen,15,40,25,1,00183,India
976256,2023-12-18,717,spiral bound book,50,100,50,1,00183,India
976256,2023-12-18,711,TD kit,150,300,150,1,00183,India
833903,2023-12-18,715,folder,5,15,10,1,00136,India
833903,2023-12-18,706,sharpener,3,8,5,1,00136,India
319181,2023-12-18,707,marker,20,40,20,1,00290,India
319181,2023-12-18,703,eraser,1,3,2,1,00290,India
319181,2023-12-18,711,TD kit,150,300,150,1,00290,India
524734,2023-12-18,711,TD kit,150,300,150,1,00455,India
767666,2023-12-18,711,TD kit,150,300,150,1,00079,India
767666,2023-12-18,707,marker,20,40,20,1,00079,India
767666,2023-12-18,705,stencil,10,20,10,1,00079,India
767666,2023-12-18,713,ball pen,5,10,5,1,00079,India
529584,2023-12-18,716,printing paper,200,400,200,1,00316,India
529584,2023-12-18,708,sketchpen,15,40,25,1,00316,India
529584,2023-12-18,710,geometry box,100,150,50,1,00316,India
529584,2023-12-18,712,graph paper,20,40,20,1,00316,India
649325,2023-12-18,702,pencil,2,5,3,1,00418,India
649325,2023-12-18,706,sharpener,3,8,5,1,00418,India
649325,2023-12-18,712,graph paper,20,40,20,1,00418,India
996651,2023-12-18,713,ball pen,5,10,5,1,00326,India
996651,2023-12-18,710,geometry box,100,150,50,1,00326,India
996651,2023-12-18,717,spiral bound book,50,100,50,1,00326,India
292958,2023-12-18,707,marker,20,40,20,1,00452,India
292958,2023-12-18,708,sketchpen,15,40,25,1,00452,India
292958,2023-12-18,717,spiral bound book,50,100,50,1,00452,India
956189,2023-12-18,716,printing paper,200,400,200,1,00472,India
956189,2023-12-18,707,marker,20,40,20,1,00472,India
956189,2023-12-18,705,stencil,10,20,10,1,00472,India
306285,2023-12-18,716,printing paper,200,400,200,1,00153,India
306285,2023-12-18,715,folder,5,15,10,1,00153,India
306285,2023-12-18,701,gel pen,5,10,5,1,00153,India
137628,2023-12-18,703,eraser,1,3,2,1,00055,India
137628,2023-12-18,709,notebook,30,60,30,1,00055,India
137628,2023-12-18,707,marker,20,40,20,1,00055,India
813029,2023-12-18,709,notebook,30,60,30,1,00352,India
862843,2023-12-18,708,sketchpen,15,40,25,1,00148,India
862843,2023-12-18,716,printing paper,200,400,200,1,00148,India
862843,2023-12-18,712,graph paper,20,40,20,1,00148,India
335432,2023-12-18,713,ball pen,5,10,5,1,00465,India
531337,2023-12-18,706,sharpener,3,8,5,1,00432,India
531337,2023-12-18,710,geometry box,100,150,50,1,00432,India
531337,2023-12-18,717,spiral bound book,50,100,50,1,00432,India
531337,2023-12-18,709,notebook,30,60,30,1,00432,India
384187,2023-12-18,709,notebook,30,60,30,1,00049,India
996249,2023-12-18,705,stencil,10,20,10,1,00318,India
456847,2023-12-18,704,scale,5,10,5,1,00359,India
256591,2023-12-18,702,pencil,2,5,3,1,00096,India
256591,2023-12-18,713,ball pen,5,10,5,1,00096,India
325869,2023-12-18,703,eraser,1,3,2,1,00447,India
325869,2023-12-18,714,carbon paper,15,30,15,1,00447,India
325869,2023-12-18,716,printing paper,200,400,200,1,00447,India
418043,2023-12-18,701,gel pen,5,10,5,1,00440,India
418043,2023-12-18,702,pencil,2,5,3,1,00440,India
418043,2023-12-18,715,folder,5,15,10,1,00440,India
418043,2023-12-18,703,eraser,1,3,2,1,00440,India
589265,2023-12-18,709,notebook,30,60,30,1,00212,India
589265,2023-12-18,710,geometry box,100,150,50,1,00212,India
381419,2023-12-18,709,notebook,30,60,30,1,00092,India
110660,2023-12-18,709,notebook,30,60,30,1,00340,India
110660,2023-12-18,708,sketchpen,15,40,25,1,00340,India
110660,2023-12-18,707,marker,20,40,20,1,00340,India
110660,2023-12-18,717,spiral bound book,50,100,50,1,00340,India
898157,2023-12-18,701,gel pen,5,10,5,1,00308,India
898157,2023-12-18,712,graph paper,20,40,20,1,00308,India
689274,2023-12-18,716,printing paper,200,400,200,1,00065,India
689274,2023-12-18,702,pencil,2,5,3,1,00065,India
689274,2023-12-18,701,gel pen,5,10,5,1,00065,India
689274,2023-12-18,709,notebook,30,60,30,1,00065,India
568602,2023-12-18,711,TD kit,150,300,150,1,00372,India
568602,2023-12-18,708,sketchpen,15,40,25,1,00372,India
568602,2023-12-18,717,spiral bound book,50,100,50,1,00372,India
568602,2023-12-18,707,marker,20,40,20,1,00372,India
568602,2023-12-18,706,sharpener,3,8,5,1,00372,India
174017,2023-12-18,702,pencil,2,5,3,1,00067,India
174017,2023-12-18,705,stencil,10,20,10,1,00067,India
174017,2023-12-18,706,sharpener,3,8,5,1,00067,India
174017,2023-12-18,703,eraser,1,3,2,1,00067,India
174017,2023-12-18,717,spiral bound book,50,100,50,1,00067,India
468414,2023-12-18,707,marker,20,40,20,1,00415,India
468414,2023-12-18,704,scale,5,10,5,1,00415,India
468414,2023-12-18,715,folder,5,15,10,1,00415,India
468414,2023-12-18,705,stencil,10,20,10,1,00415,India
219587,2023-12-18,710,geometry box,100,150,50,1,00168,India
219587,2023-12-18,704,scale,5,10,5,1,00168,India
664113,2023-12-18,707,marker,20,40,20,1,00090,India
664113,2023-12-18,711,TD kit,150,300,150,1,00090,India
664113,2023-12-18,708,sketchpen,15,40,25,1,00090,India
664113,2023-12-18,717,spiral bound book,50,100,50,1,00090,India
312251,2023-12-18,704,scale,5,10,5,1,00071,India
312251,2023-12-18,711,TD kit,150,300,150,1,00071,India
628599,2023-12-18,715,folder,5,15,10,1,00170,India
445714,2023-12-18,710,geometry box,100,150,50,1,00010,India
283158,2023-12-19,706,sharpener,3,8,5,1,00490,India
283158,2023-12-19,715,folder,5,15,10,1,00490,India
584962,2023-12-19,711,TD kit,150,300,150,1,00473,India
584962,2023-12-19,703,eraser,1,3,2,1,00473,India
584962,2023-12-19,710,geometry box,100,150,50,1,00473,India
206391,2023-12-19,704,scale,5,10,5,1,00386,India
206391,2023-12-19,716,printing paper,200,400,200,1,00386,India
101976,2023-12-19,712,graph paper,20,40,20,1,00317,India
101976,2023-12-19,713,ball pen,5,10,5,1,00317,India
101976,2023-12-19,711,TD kit,150,300,150,1,00317,India
101976,2023-12-19,708,sketchpen,15,40,25,1,00317,India
578863,2023-12-19,708,sketchpen,15,40,25,1,00245,India
578863,2023-12-19,710,geometry box,100,150,50,1,00245,India
578863,2023-12-19,717,spiral bound book,50,100,50,1,00245,India
777970,2023-12-19,704,scale,5,10,5,1,00139,India
923788,2023-12-19,711,TD kit,150,300,150,1,00041,India
317622,2023-12-19,706,sharpener,3,8,5,1,00345,India
317622,2023-12-19,703,eraser,1,3,2,1,00345,India
317622,2023-12-19,716,printing paper,200,400,200,1,00345,India
317622,2023-12-19,710,geometry box,100,150,50,1,00345,India
317622,2023-12-19,711,TD kit,150,300,150,1,00345,India
495727,2023-12-19,701,gel pen,5,10,5,1,00079,India
495727,2023-12-19,707,marker,20,40,20,1,00079,India
495727,2023-12-19,705,stencil,10,20,10,1,00079,India
495727,2023-12-19,703,eraser,1,3,2,1,00079,India
646395,2023-12-19,706,sharpener,3,8,5,1,00439,India
646395,2023-12-19,703,eraser,1,3,2,1,00439,India
646395,2023-12-19,708,sketchpen,15,40,25,1,00439,India
646395,2023-12-19,717,spiral bound book,50,100,50,1,00439,India
646395,2023-12-19,713,ball pen,5,10,5,1,00439,India
477000,2023-12-19,705,stencil,10,20,10,1,00174,India
477000,2023-12-19,711,TD kit,150,300,150,1,00174,India
621845,2023-12-19,704,scale,5,10,5,1,00485,India
621845,2023-12-19,709,notebook,30,60,30,1,00485,India
621845,2023-12-19,703,eraser,1,3,2,1,00485,India
621845,2023-12-19,714,carbon paper,15,30,15,1,00485,India
569038,2023-12-19,702,pencil,2,5,3,1,00291,India
569038,2023-12-19,709,notebook,30,60,30,1,00291,India
905827,2023-12-19,713,ball pen,5,10,5,1,00003,India
905827,2023-12-19,703,eraser,1,3,2,1,00003,India
905827,2023-12-19,709,notebook,30,60,30,1,00003,India
910282,2023-12-19,713,ball pen,5,10,5,1,00158,India
623759,2023-12-19,710,geometry box,100,150,50,1,00411,India
623759,2023-12-19,705,stencil,10,20,10,1,00411,India
623759,2023-12-19,715,folder,5,15,10,1,00411,India
623759,2023-12-19,713,ball pen,5,10,5,1,00411,India
623759,2023-12-19,711,TD kit,150,300,150,1,00411,India
136947,2023-12-19,713,ball pen,5,10,5,1,00485,India
136947,2023-12-19,717,spiral bound book,50,100,50,1,00485,India
136947,2023-12-19,711,TD kit,150,300,150,1,00485,India
154312,2023-12-19,701,gel pen,5,10,5,1,00378,India
154312,2023-12-19,704,scale,5,10,5,1,00378,India
404790,2023-12-19,714,carbon paper,15,30,15,1,00325,India
404790,2023-12-19,716,printing paper,200,400,200,1,00325,India
283482,2023-12-19,706,sharpener,3,8,5,1,00474,India
283482,2023-12-19,715,folder,5,15,10,1,00474,India
283482,2023-12-19,709,notebook,30,60,30,1,00474,India
283482,2023-12-19,701,gel pen,5,10,5,1,00474,India
801851,2023-12-19,706,sharpener,3,8,5,1,00348,India
801851,2023-12-19,717,spiral bound book,50,100,50,1,00348,India
801851,2023-12-19,708,sketchpen,15,40,25,1,00348,India
443671,2023-12-19,706,sharpener,3,8,5,1,00216,India
443671,2023-12-19,713,ball pen,5,10,5,1,00216,India
443671,2023-12-19,703,eraser,1,3,2,1,00216,India
443671,2023-12-19,712,graph paper,20,40,20,1,00216,India
212293,2023-12-19,701,gel pen,5,10,5,1,00176,India
212293,2023-12-19,707,marker,20,40,20,1,00176,India
212293,2023-12-19,709,notebook,30,60,30,1,00176,India
141333,2023-12-19,708,sketchpen,15,40,25,1,00020,India
702445,2023-12-19,705,stencil,10,20,10,1,00058,India
702445,2023-12-19,704,scale,5,10,5,1,00058,India
702445,2023-12-19,711,TD kit,150,300,150,1,00058,India
702445,2023-12-19,708,sketchpen,15,40,25,1,00058,India
598735,2023-12-19,702,pencil,2,5,3,1,00433,India
598735,2023-12-19,701,gel pen,5,10,5,1,00433,India
598735,2023-12-19,715,folder,5,15,10,1,00433,India
598735,2023-12-19,708,sketchpen,15,40,25,1,00433,India
598735,2023-12-19,705,stencil,10,20,10,1,00433,India
521349,2023-12-19,704,scale,5,10,5,1,00294,India
521349,2023-12-19,716,printing paper,200,400,200,1,00294,India
521349,2023-12-19,714,carbon paper,15,30,15,1,00294,India
521349,2023-12-19,712,graph paper,20,40,20,1,00294,India
835510,2023-12-19,712,graph paper,20,40,20,1,00442,India
835510,2023-12-19,703,eraser,1,3,2,1,00442,India
835510,2023-12-19,702,pencil,2,5,3,1,00442,India
835510,2023-12-19,701,gel pen,5,10,5,1,00442,India
835510,2023-12-19,706,sharpener,3,8,5,1,00442,India
988396,2023-12-19,709,notebook,30,60,30,1,00245,India
988396,2023-12-19,716,printing paper,200,400,200,1,00245,India
150281,2023-12-19,709,notebook,30,60,30,1,00406,India
150281,2023-12-19,714,carbon paper,15,30,15,1,00406,India
303889,2023-12-19,703,eraser,1,3,2,1,00428,India
303889,2023-12-19,704,scale,5,10,5,1,00428,India
303889,2023-12-19,701,gel pen,5,10,5,1,00428,India
303889,2023-12-19,715,folder,5,15,10,1,00428,India
446050,2023-12-19,717,spiral bound book,50,100,50,1,00452,India
841283,2023-12-19,712,graph paper,20,40,20,1,00218,India
276692,2023-12-19,701,gel pen,5,10,5,1,00427,India
276692,2023-12-19,707,marker,20,40,20,1,00427,India
276692,2023-12-19,705,stencil,10,20,10,1,00427,India
276692,2023-12-19,714,carbon paper,15,30,15,1,00427,India
179483,2023-12-19,711,TD kit,150,300,150,1,00367,India
179483,2023-12-19,710,geometry box,100,150,50,1,00367,India
179483,2023-12-19,708,sketchpen,15,40,25,1,00367,India
179483,2023-12-19,716,printing paper,200,400,200,1,00367,India
561688,2023-12-19,712,graph paper,20,40,20,1,00241,India
561688,2023-12-19,713,ball pen,5,10,5,1,00241,India
561688,2023-12-19,704,scale,5,10,5,1,00241,India
182664,2023-12-19,704,scale,5,10,5,1,00369,India
182664,2023-12-19,716,printing paper,200,400,200,1,00369,India
182664,2023-12-19,701,gel pen,5,10,5,1,00369,India
182664,2023-12-19,707,marker,20,40,20,1,00369,India
467720,2023-12-20,708,sketchpen,15,40,25,1,00496,India
467720,2023-12-20,707,marker,20,40,20,1,00496,India
467720,2023-12-20,716,printing paper,200,400,200,1,00496,India
467720,2023-12-20,711,TD kit,150,300,150,1,00496,India
323667,2023-12-20,710,geometry box,100,150,50,1,00028,India
323667,2023-12-20,703,eraser,1,3,2,1,00028,India
323667,2023-12-20,709,notebook,30,60,30,1,00028,India
323667,2023-12-20,714,carbon paper,15,30,15,1,00028,India
739001,2023-12-20,715,folder,5,15,10,1,00004,India
739001,2023-12-20,707,marker,20,40,20,1,00004,India
739001,2023-12-20,712,graph paper,20,40,20,1,00004,India
739001,2023-12-20,711,TD kit,150,300,150,1,00004,India
209369,2023-12-20,716,printing paper,200,400,200,1,00295,India
659540,2023-12-20,716,printing paper,200,400,200,1,00334,India
659540,2023-12-20,706,sharpener,3,8,5,1,00334,India
659540,2023-12-20,710,geometry box,100,150,50,1,00334,India
659540,2023-12-20,714,carbon paper,15,30,15,1,00334,India
515394,2023-12-20,709,notebook,30,60,30,1,00326,India
515394,2023-12-20,716,printing paper,200,400,200,1,00326,India
523659,2023-12-20,701,gel pen,5,10,5,1,00417,India
523659,2023-12-20,705,stencil,10,20,10,1,00417,India
261160,2023-12-20,712,graph paper,20,40,20,1,00075,India
261160,2023-12-20,709,notebook,30,60,30,1,00075,India
121177,2023-12-20,704,scale,5,10,5,1,00481,India
121177,2023-12-20,713,ball pen,5,10,5,1,00481,India
121177,2023-12-20,703,eraser,1,3,2,1,00481,India
121177,2023-12-20,716,printing paper,200,400,200,1,00481,India
263441,2023-12-20,715,folder,5,15,10,1,00275,India
263441,2023-12-20,717,spiral bound book,50,100,50,1,00275,India
932681,2023-12-20,707,marker,20,40,20,1,00403,India
932681,2023-12-20,701,gel pen,5,10,5,1,00403,India
144064,2023-12-20,701,gel pen,5,10,5,1,00292,India
144064,2023-12-20,715,folder,5,15,10,1,00292,India
144064,2023-12-20,704,scale,5,10,5,1,00292,India
144064,2023-12-20,711,TD kit,150,300,150,1,00292,India
144064,2023-12-20,713,ball pen,5,10,5,1,00292,India
626096,2023-12-20,708,sketchpen,15,40,25,1,00332,India
626096,2023-12-20,704,scale,5,10,5,1,00332,India
968927,2023-12-20,709,notebook,30,60,30,1,00300,India
968927,2023-12-20,713,ball pen,5,10,5,1,00300,India
899672,2023-12-20,713,ball pen,5,10,5,1,00460,India
899672,2023-12-20,710,geometry box,100,150,50,1,00460,India
899672,2023-12-20,702,pencil,2,5,3,1,00460,India
899672,2023-12-20,717,spiral bound book,50,100,50,1,00460,India
726709,2023-12-20,702,pencil,2,5,3,1,00274,India
726709,2023-12-20,711,TD kit,150,300,150,1,00274,India
726709,2023-12-20,713,ball pen,5,10,5,1,00274,India
726709,2023-12-20,705,stencil,10,20,10,1,00274,India
116242,2023-12-20,706,sharpener,3,8,5,1,00075,India
116242,2023-12-20,708,sketchpen,15,40,25,1,00075,India
814985,2023-12-20,709,notebook,30,60,30,1,00054,India
814985,2023-12-20,706,sharpener,3,8,5,1,00054,India
814985,2023-12-20,702,pencil,2,5,3,1,00054,India
814985,2023-12-20,703,eraser,1,3,2,1,00054,India
814985,2023-12-20,714,carbon paper,15,30,15,1,00054,India
834786,2023-12-20,703,eraser,1,3,2,1,00273,India
834786,2023-12-20,712,graph paper,20,40,20,1,00273,India
834786,2023-12-20,716,printing paper,200,400,200,1,00273,India
834786,2023-12-20,717,spiral bound book,50,100,50,1,00273,India
834786,2023-12-20,702,pencil,2,5,3,1,00273,India
473777,2023-12-20,717,spiral bound book,50,100,50,1,00122,India
473777,2023-12-20,703,eraser,1,3,2,1,00122,India
473777,2023-12-20,713,ball pen,5,10,5,1,00122,India
473777,2023-12-20,715,folder,5,15,10,1,00122,India
473777,2023-12-20,716,printing paper,200,400,200,1,00122,India
791075,2023-12-20,701,gel pen,5,10,5,1,00233,India
791075,2023-12-20,716,printing paper,200,400,200,1,00233,India
791075,2023-12-20,705,stencil,10,20,10,1,00233,India
791075,2023-12-20,709,notebook,30,60,30,1,00233,India
369123,2023-12-20,716,printing paper,200,400,200,1,00488,India
369123,2023-12-20,709,notebook,30,60,30,1,00488,India
369123,2023-12-20,713,ball pen,5,10,5,1,00488,India
369123,2023-12-20,711,TD kit,150,300,150,1,00488,India
442446,2023-12-20,711,TD kit,150,300,150,1,00276,India
442446,2023-12-20,710,geometry box,100,150,50,1,00276,India
442446,2023-12-20,717,spiral bound book,50,100,50,1,00276,India
442446,2023-12-20,705,stencil,10,20,10,1,00276,India
947352,2023-12-20,716,printing paper,200,400,200,1,00130,India
947352,2023-12-20,706,sharpener,3,8,5,1,00130,India
947352,2023-12-20,717,spiral bound book,50,100,50,1,00130,India
884655,2023-12-20,716,printing paper,200,400,200,1,00236,India
884655,2023-12-20,715,folder,5,15,10,1,00236,India
884655,2023-12-20,717,spiral bound book,50,100,50,1,00236,India
884655,2023-12-20,707,marker,20,40,20,1,00236,India
575551,2023-12-20,710,geometry box,100,150,50,1,00450,India
575551,2023-12-20,703,eraser,1,3,2,1,00450,India
575551,2023-12-20,702,pencil,2,5,3,1,00450,India
554084,2023-12-20,708,sketchpen,15,40,25,1,00196,India
554084,2023-12-20,706,sharpener,3,8,5,1,00196,India
577139,2023-12-20,705,stencil,10,20,10,1,00055,India
571863,2023-12-20,701,gel pen,5,10,5,1,00256,India
571863,2023-12-20,713,ball pen,5,10,5,1,00256,India
571863,2023-12-20,717,spiral bound book,50,100,50,1,00256,India
571863,2023-12-20,716,printing paper,200,400,200,1,00256,India
571863,2023-12-20,708,sketchpen,15,40,25,1,00256,India
339125,2023-12-20,716,printing paper,200,400,200,1,00256,India
339125,2023-12-20,713,ball pen,5,10,5,1,00256,India
339125,2023-12-20,703,eraser,1,3,2,1,00256,India
173353,2023-12-20,709,notebook,30,60,30,1,00050,India
417863,2023-12-20,709,notebook,30,60,30,1,00241,India
417863,2023-12-20,703,eraser,1,3,2,1,00241,India
417863,2023-12-20,716,printing paper,200,400,200,1,00241,India
417863,2023-12-20,714,carbon paper,15,30,15,1,00241,India
435235,2023-12-20,716,printing paper,200,400,200,1,00438,India
435235,2023-12-20,712,graph paper,20,40,20,1,00438,India
654415,2023-12-20,711,TD kit,150,300,150,1,00477,India
654415,2023-12-20,715,folder,5,15,10,1,00477,India
654415,2023-12-20,703,eraser,1,3,2,1,00477,India
654415,2023-12-20,710,geometry box,100,150,50,1,00477,India
654415,2023-12-20,712,graph paper,20,40,20,1,00477,India
999731,2023-12-20,714,carbon paper,15,30,15,1,00013,India
999731,2023-12-20,715,folder,5,15,10,1,00013,India
999731,2023-12-20,712,graph paper,20,40,20,1,00013,India
999731,2023-12-20,711,TD kit,150,300,150,1,00013,India
999731,2023-12-20,713,ball pen,5,10,5,1,00013,India
595827,2023-12-21,709,notebook,30,60,30,1,00479,India
301729,2023-12-21,717,spiral bound book,50,100,50,1,00118,India
301729,2023-12-21,715,folder,5,15,10,1,00118,India
842300,2023-12-21,710,geometry box,100,150,50,1,00323,India
236138,2023-12-21,704,scale,5,10,5,1,00059,India
236138,2023-12-21,707,marker,20,40,20,1,00059,India
773378,2023-12-21,711,TD kit,150,300,150,1,00091,India
530177,2023-12-21,715,folder,5,15,10,1,00010,India
530177,2023-12-21,701,gel pen,5,10,5,1,00010,India
636401,2023-12-21,713,ball pen,5,10,5,1,00498,India
636401,2023-12-21,709,notebook,30,60,30,1,00498,India
636401,2023-12-21,704,scale,5,10,5,1,00498,India
636401,2023-12-21,705,stencil,10,20,10,1,00498,India
636401,2023-12-21,717,spiral bound book,50,100,50,1,00498,India
295660,2023-12-21,705,stencil,10,20,10,1,00451,India
196576,2023-12-21,707,marker,20,40,20,1,00075,India
196576,2023-12-21,717,spiral bound book,50,100,50,1,00075,India
249043,2023-12-21,702,pencil,2,5,3,1,00212,India
249043,2023-12-21,714,carbon paper,15,30,15,1,00212,India
987431,2023-12-21,706,sharpener,3,8,5,1,00121,India
987431,2023-12-21,715,folder,5,15,10,1,00121,India
987431,2023-12-21,714,carbon paper,15,30,15,1,00121,India
987431,2023-12-21,717,spiral bound book,50,100,50,1,00121,India
187637,2023-12-21,711,TD kit,150,300,150,1,00251,India
187637,2023-12-21,707,marker,20,40,20,1,00251,India
925270,2023-12-21,709,notebook,30,60,30,1,00349,India
925270,2023-12-21,716,printing paper,200,400,200,1,00349,India
925270,2023-12-21,705,stencil,10,20,10,1,00349,India
281694,2023-12-21,706,sharpener,3,8,5,1,00249,India
281694,2023-12-21,715,folder,5,15,10,1,00249,India
834264,2023-12-21,716,printing paper,200,400,200,1,00115,India
834264,2023-12-21,708,sketchpen,15,40,25,1,00115,India
834264,2023-12-21,703,eraser,1,3,2,1,00115,India
506891,2023-12-21,710,geometry box,100,150,50,1,00337,India
506891,2023-12-21,711,TD kit,150,300,150,1,00337,India
506891,2023-12-21,705,stencil,10,20,10,1,00337,India
506891,2023-12-21,707,marker,20,40,20,1,00337,India
406666,2023-12-21,711,TD kit,150,300,150,1,00011,India
406666,2023-12-21,702,pencil,2,5,3,1,00011,India
406666,2023-12-21,712,graph paper,20,40,20,1,00011,India
406666,2023-12-21,701,gel pen,5,10,5,1,00011,India
406666,2023-12-21,717,spiral bound book,50,100,50,1,00011,India
239758,2023-12-21,715,folder,5,15,10,1,00368,India
239758,2023-12-21,716,printing paper,200,400,200,1,00368,India
429304,2023-12-21,701,gel pen,5,10,5,1,00406,India
429304,2023-12-21,712,graph paper,20,40,20,1,00406,India
429304,2023-12-21,702,pencil,2,5,3,1,00406,India
429304,2023-12-21,710,geometry box,100,150,50,1,00406,India
429304,2023-12-21,705,stencil,10,20,10,1,00406,India
326222,2023-12-21,704,scale,5,10,5,1,00498,India
326222,2023-12-21,707,marker,20,40,20,1,00498,India
326222,2023-12-21,715,folder,5,15,10,1,00498,India
326222,2023-12-21,703,eraser,1,3,2,1,00498,India
962661,2023-12-21,712,graph paper,20,40,20,1,00188,India
962661,2023-12-21,715,folder,5,15,10,1,00188,India
962661,2023-12-21,717,spiral bound book,50,100,50,1,00188,India
833963,2023-12-21,705,stencil,10,20,10,1,00050,India
833963,2023-12-21,712,graph paper,20,40,20,1,00050,India
833963,2023-12-21,702,pencil,2,5,3,1,00050,India
975111,2023-12-21,701,gel pen,5,10,5,1,00268,India
975111,2023-12-21,711,TD kit,150,300,150,1,00268,India
598571,2023-12-21,715,folder,5,15,10,1,00311,India
598571,2023-12-21,703,eraser,1,3,2,1,00311,India
598571,2023-12-21,704,scale,5,10,5,1,00311,India
254509,2023-12-21,712,graph paper,20,40,20,1,00227,India
670637,2023-12-21,708,sketchpen,15,40,25,1,00051,India
670637,2023-12-21,715,folder,5,15,10,1,00051,India
465321,2023-12-21,715,folder,5,15,10,1,00218,India
465321,2023-12-21,702,pencil,2,5,3,1,00218,India
465321,2023-12-21,712,graph paper,20,40,20,1,00218,India
671648,2023-12-21,714,carbon paper,15,30,15,1,00266,India
671648,2023-12-21,717,spiral bound book,50,100,50,1,00266,India
671648,2023-12-21,713,ball pen,5,10,5,1,00266,India
671648,2023-12-21,709,notebook,30,60,30,1,00266,India
671648,2023-12-21,712,graph paper,20,40,20,1,00266,India
554745,2023-12-21,706,sharpener,3,8,5,1,00187,India
554745,2023-12-21,716,printing paper,200,400,200,1,00187,India
554745,2023-12-21,713,ball pen,5,10,5,1,00187,India
105499,2023-12-21,711,TD kit,150,300,150,1,00359,India
105499,2023-12-21,705,stencil,10,20,10,1,00359,India
105499,2023-12-21,703,eraser,1,3,2,1,00359,India
948959,2023-12-21,716,printing paper,200,400,200,1,00360,India
948959,2023-12-21,705,stencil,10,20,10,1,00360,India
948959,2023-12-21,703,eraser,1,3,2,1,00360,India
742099,2023-12-21,716,printing paper,200,400,200,1,00072,India
742099,2023-12-21,712,graph paper,20,40,20,1,00072,India
888676,2023-12-21,704,scale,5,10,5,1,00321,India
213212,2023-12-21,716,printing paper,200,400,200,1,00001,India
213212,2023-12-21,717,spiral bound book,50,100,50,1,00001,India
213212,2023-12-21,701,gel pen,5,10,5,1,00001,India
570051,2023-12-21,707,marker,20,40,20,1,00160,India
570051,2023-12-21,715,folder,5,15,10,1,00160,India
570051,2023-12-21,709,notebook,30,60,30,1,00160,India
570051,2023-12-21,704,scale,5,10,5,1,00160,India
715203,2023-12-21,710,geometry box,100,150,50,1,00323,India
715203,2023-12-21,703,eraser,1,3,2,1,00323,India
715203,2023-12-21,716,printing paper,200,400,200,1,00323,India
778903,2023-12-21,713,ball pen,5,10,5,1,00082,India
778903,2023-12-21,717,spiral bound book,50,100,50,1,00082,India
556480,2023-12-21,705,stencil,10,20,10,1,00297,India
111613,2023-12-21,714,carbon paper,15,30,15,1,00027,India
111613,2023-12-21,715,folder,5,15,10,1,00027,India
204135,2023-12-22,701,gel pen,5,10,5,1,00288,India
204135,2023-12-22,711,TD kit,150,300,150,1,00288,India
248577,2023-12-22,715,folder,5,15,10,1,00237,India
248577,2023-12-22,704,scale,5,10,5,1,00237,India
636125,2023-12-22,716,printing paper,200,400,200,1,00397,India
636125,2023-12-22,714,carbon paper,15,30,15,1,00397,India
636125,2023-12-22,715,folder,5,15,10,1,00397,India
932045,2023-12-22,705,stencil,10,20,10,1,00417,India
932045,2023-12-22,710,geometry box,100,150,50,1,00417,India
932045,2023-12-22,717,spiral bound book,50,100,50,1,00417,India
424693,2023-12-22,714,carbon paper,15,30,15,1,00182,India
424693,2023-12-22,702,pencil,2,5,3,1,00182,India
551541,2023-12-22,715,folder,5,15,10,1,00029,India
551541,2023-12-22,712,graph paper,20,40,20,1,00029,India
551541,2023-12-22,707,marker,20,40,20,1,00029,India
551541,2023-12-22,704,scale,5,10,5,1,00029,India
263862,2023-12-22,711,TD kit,150,300,150,1,00328,India
263862,2023-12-22,704,scale,5,10,5,1,00328,India
954172,2023-12-22,716,printing paper,200,400,200,1,00313,India
954172,2023-12-22,704,scale,5,10,5,1,00313,India
954172,2023-12-22,711,TD kit,150,300,150,1,00313,India
954172,2023-12-22,710,geometry box,100,150,50,1,00313,India
331269,2023-12-22,705,stencil,10,20,10,1,00249,India
898210,2023-12-22,706,sharpener,3,8,5,1,00076,India
898210,2023-12-22,701,gel pen,5,10,5,1,00076,India
898210,2023-12-22,713,ball pen,5,10,5,1,00076,India
898210,2023-12-22,717,spiral bound book,50,100,50,1,00076,India
898210,2023-12-22,707,marker,20,40,20,1,00076,India
587131,2023-12-22,706,sharpener,3,8,5,1,00484,India
587131,2023-12-22,703,eraser,1,3,2,1,00484,India
135303,2023-12-22,706,sharpener,3,8,5,1,00116,India
135303,2023-12-22,716,printing paper,200,400,200,1,00116,India
421534,2023-12-22,716,printing paper,200,400,200,1,00479,India
421534,2023-12-22,707,marker,20,40,20,1,00479,India
421534,2023-12-22,713,ball pen,5,10,5,1,00479,India
421534,2023-12-22,714,carbon paper,15,30,15,1,00479,India
421534,2023-12-22,711,TD kit,150,300,150,1,00479,India
279856,2023-12-22,701,gel pen,5,10,5,1,00426,India
909568,2023-12-22,712,graph paper,20,40,20,1,00071,India
909568,2023-12-22,710,geometry box,100,150,50,1,00071,India
909568,2023-12-22,716,printing paper,200,400,200,1,00071,India
909568,2023-12-22,703,eraser,1,3,2,1,00071,India
771685,2023-12-22,704,scale,5,10,5,1,00091,India
373540,2023-12-22,703,eraser,1,3,2,1,00452,India
373540,2023-12-22,714,carbon paper,15,30,15,1,00452,India
373540,2023-12-22,717,spiral bound book,50,100,50,1,00452,India
373540,2023-12-22,715,folder,5,15,10,1,00452,India
294219,2023-12-22,713,ball pen,5,10,5,1,00100,India
294219,2023-12-22,704,scale,5,10,5,1,00100,India
294219,2023-12-22,708,sketchpen,15,40,25,1,00100,India
294219,2023-12-22,706,sharpener,3,8,5,1,00100,India
672904,2023-12-22,710,geometry box,100,150,50,1,00267,India
672904,2023-12-22,701,gel pen,5,10,5,1,00267,India
672904,2023-12-22,707,marker,20,40,20,1,00267,India
672904,2023-12-22,709,notebook,30,60,30,1,00267,India
154739,2023-12-22,708,sketchpen,15,40,25,1,00426,India
154739,2023-12-22,705,stencil,10,20,10,1,00426,India
154739,2023-12-22,703,eraser,1,3,2,1,00426,India
154739,2023-12-22,709,notebook,30,60,30,1,00426,India
866245,2023-12-22,717,spiral bound book,50,100,50,1,00066,India
866245,2023-12-22,712,graph paper,20,40,20,1,00066,India
866245,2023-12-22,713,ball pen,5,10,5,1,00066,India
872044,2023-12-22,714,carbon paper,15,30,15,1,00472,India
872044,2023-12-22,716,printing paper,200,400,200,1,00472,India
872044,2023-12-22,705,stencil,10,20,10,1,00472,India
582093,2023-12-22,707,marker,20,40,20,1,00083,India
582093,2023-12-22,709,notebook,30,60,30,1,00083,India
582093,2023-12-22,705,stencil,10,20,10,1,00083,India
582093,2023-12-22,717,spiral bound book,50,100,50,1,00083,India
582093,2023-12-22,706,sharpener,3,8,5,1,00083,India
109641,2023-12-22,707,marker,20,40,20,1,00048,India
109641,2023-12-22,708,sketchpen,15,40,25,1,00048,India
109641,2023-12-22,702,pencil,2,5,3,1,00048,India
782122,2023-12-22,717,spiral bound book,50,100,50,1,00257,India
782122,2023-12-22,713,ball pen,5,10,5,1,00257,India
660283,2023-12-22,709,notebook,30,60,30,1,00055,India
660283,2023-12-22,711,TD kit,150,300,150,1,00055,India
660283,2023-12-22,705,stencil,10,20,10,1,00055,India
880962,2023-12-22,706,sharpener,3,8,5,1,00164,India
994539,2023-12-22,704,scale,5,10,5,1,00336,India
428510,2023-12-22,710,geometry box,100,150,50,1,00427,India
428510,2023-12-22,705,stencil,10,20,10,1,00427,India
428510,2023-12-22,711,TD kit,150,300,150,1,00427,India
173965,2023-12-22,702,pencil,2,5,3,1,00356,India
594270,2023-12-22,701,gel pen,5,10,5,1,00473,India
594270,2023-12-22,714,carbon paper,15,30,15,1,00473,India
594270,2023-12-22,708,sketchpen,15,40,25,1,00473,India
594270,2023-12-22,704,scale,5,10,5,1,00473,India
858585,2023-12-22,716,printing paper,200,400,200,1,00397,India
858585,2023-12-22,706,sharpener,3,8,5,1,00397,India
883833,2023-12-22,711,TD kit,150,300,150,1,00229,India
883833,2023-12-22,716,printing paper,200,400,200,1,00229,India
883833,2023-12-22,709,notebook,30,60,30,1,00229,India
883833,2023-12-22,706,sharpener,3,8,5,1,00229,India
883833,2023-12-22,703,eraser,1,3,2,1,00229,India
318094,2023-12-22,708,sketchpen,15,40,25,1,00312,India
318094,2023-12-22,706,sharpener,3,8,5,1,00312,India
318094,2023-12-22,703,eraser,1,3,2,1,00312,India
318094,2023-12-22,716,printing paper,200,400,200,1,00312,India
318094,2023-12-22,707,marker,20,40,20,1,00312,India
775505,2023-12-22,710,geometry box,100,150,50,1,00357,India
775505,2023-12-22,701,gel pen,5,10,5,1,00357,India
775505,2023-12-22,715,folder,5,15,10,1,00357,India
775505,2023-12-22,707,marker,20,40,20,1,00357,India
537496,2023-12-23,702,pencil,2,5,3,1,00264,India
537496,2023-12-23,717,spiral bound book,50,100,50,1,00264,India
813766,2023-12-23,714,carbon paper,15,30,15,1,00113,India
813766,2023-12-23,709,notebook,30,60,30,1,00113,India
711663,2023-12-23,707,marker,20,40,20,1,00148,India
711663,2023-12-23,712,graph paper,20,40,20,1,00148,India
711663,2023-12-23,715,folder,5,15,10,1,00148,India
496183,2023-12-23,707,marker,20,40,20,1,00464,India
496183,2023-12-23,702,pencil,2,5,3,1,00464,India
375514,2023-12-23,702,pencil,2,5,3,1,00500,India
375514,2023-12-23,714,carbon paper,15,30,15,1,00500,India
375514,2023-12-23,701,gel pen,5,10,5,1,00500,India
375514,2023-12-23,713,ball pen,5,10,5,1,00500,India
376986,2023-12-23,713,ball pen,5,10,5,1,00118,India
376986,2023-12-23,702,pencil,2,5,3,1,00118,India
376986,2023-12-23,714,carbon paper,15,30,15,1,00118,India
376986,2023-12-23,701,gel pen,5,10,5,1,00118,India
115589,2023-12-23,706,sharpener,3,8,5,1,00122,India
115589,2023-12-23,709,notebook,30,60,30,1,00122,India
115589,2023-12-23,712,graph paper,20,40,20,1,00122,India
565833,2023-12-23,714,carbon paper,15,30,15,1,00210,India
565833,2023-12-23,715,folder,5,15,10,1,00210,India
565833,2023-12-23,711,TD kit,150,300,150,1,00210,India
350263,2023-12-23,702,pencil,2,5,3,1,00029,India
350263,2023-12-23,703,eraser,1,3,2,1,00029,India
861657,2023-12-23,717,spiral bound book,50,100,50,1,00286,India
861657,2023-12-23,707,marker,20,40,20,1,00286,India
769653,2023-12-23,717,spiral bound book,50,100,50,1,00424,India
769653,2023-12-23,703,eraser,1,3,2,1,00424,India
769653,2023-12-23,710,geometry box,100,150,50,1,00424,India
769653,2023-12-23,713,ball pen,5,10,5,1,00424,India
769653,2023-12-23,707,marker,20,40,20,1,00424,India
523289,2023-12-23,709,notebook,30,60,30,1,00091,India
523289,2023-12-23,704,scale,5,10,5,1,00091,India
523289,2023-12-23,701,gel pen,5,10,5,1,00091,India
892851,2023-12-23,702,pencil,2,5,3,1,00482,India
892851,2023-12-23,711,TD kit,150,300,150,1,00482,India
892851,2023-12-23,709,notebook,30,60,30,1,00482,India
267146,2023-12-23,715,folder,5,15,10,1,00022,India
267146,2023-12-23,701,gel pen,5,10,5,1,00022,India
267146,2023-12-23,711,TD kit,150,300,150,1,00022,India
267146,2023-12-23,712,graph paper,20,40,20,1,00022,India
267146,2023-12-23,706,sharpener,3,8,5,1,00022,India
751823,2023-12-23,708,sketchpen,15,40,25,1,00240,India
751823,2023-12-23,704,scale,5,10,5,1,00240,India
751823,2023-12-23,706,sharpener,3,8,5,1,00240,India
751823,2023-12-23,709,notebook,30,60,30,1,00240,India
751823,2023-12-23,712,graph paper,20,40,20,1,00240,India
212702,2023-12-23,712,graph paper,20,40,20,1,00499,India
212702,2023-12-23,701,gel pen,5,10,5,1,00499,India
212702,2023-12-23,710,geometry box,100,150,50,1,00499,India
767780,2023-12-23,712,graph paper,20,40,20,1,00135,India
767780,2023-12-23,705,stencil,10,20,10,1,00135,India
148985,2023-12-23,713,ball pen,5,10,5,1,00128,India
148985,2023-12-23,709,notebook,30,60,30,1,00128,India
542337,2023-12-23,704,scale,5,10,5,1,00210,India
542337,2023-12-23,715,folder,5,15,10,1,00210,India
542337,2023-12-23,705,stencil,10,20,10,1,00210,India
123454,2023-12-23,708,sketchpen,15,40,25,1,00122,India
738664,2023-12-23,706,sharpener,3,8,5,1,00275,India
738664,2023-12-23,709,notebook,30,60,30,1,00275,India
738664,2023-12-23,713,ball pen,5,10,5,1,00275,India
738664,2023-12-23,701,gel pen,5,10,5,1,00275,India
793165,2023-12-23,711,TD kit,150,300,150,1,00476,India
512022,2023-12-23,713,ball pen,5,10,5,1,00211,India
512022,2023-12-23,706,sharpener,3,8,5,1,00211,India
928532,2023-12-23,713,ball pen,5,10,5,1,00056,India
928532,2023-12-23,707,marker,20,40,20,1,00056,India
928532,2023-12-23,709,notebook,30,60,30,1,00056,India
794663,2023-12-23,708,sketchpen,15,40,25,1,00439,India
456965,2023-12-23,702,pencil,2,5,3,1,00324,India
456965,2023-12-23,703,eraser,1,3,2,1,00324,India
456965,2023-12-23,704,scale,5,10,5,1,00324,India
456965,2023-12-23,714,carbon paper,15,30,15,1,00324,India
574831,2023-12-23,705,stencil,10,20,10,1,00461,India
564691,2023-12-23,704,scale,5,10,5,1,00353,India
564691,2023-12-23,712,graph paper,20,40,20,1,00353,India
564691,2023-12-23,716,printing paper,200,400,200,1,00353,India
564691,2023-12-23,715,folder,5,15,10,1,00353,India
886764,2023-12-23,714,carbon paper,15,30,15,1,00368,India
886764,2023-12-23,709,notebook,30,60,30,1,00368,India
615812,2023-12-23,701,gel pen,5,10,5,1,00128,India
615812,2023-12-23,717,spiral bound book,50,100,50,1,00128,India
615812,2023-12-23,714,carbon paper,15,30,15,1,00128,India
615812,2023-12-23,703,eraser,1,3,2,1,00128,India
615812,2023-12-23,707,marker,20,40,20,1,00128,India
350175,2023-12-23,705,stencil,10,20,10,1,00135,India
350175,2023-12-23,715,folder,5,15,10,1,00135,India
350175,2023-12-23,704,scale,5,10,5,1,00135,India
350175,2023-12-23,707,marker,20,40,20,1,00135,India
350175,2023-12-23,716,printing paper,200,400,200,1,00135,India
749876,2023-12-23,717,spiral bound book,50,100,50,1,00322,India
749876,2023-12-23,706,sharpener,3,8,5,1,00322,India
749876,2023-12-23,701,gel pen,5,10,5,1,00322,India
192140,2023-12-23,711,TD kit,150,300,150,1,00226,India
192140,2023-12-23,704,scale,5,10,5,1,00226,India
548449,2023-12-23,717,spiral bound book,50,100,50,1,00277,India
548449,2023-12-23,703,eraser,1,3,2,1,00277,India
548449,2023-12-23,702,pencil,2,5,3,1,00277,India
548449,2023-12-23,714,carbon paper,15,30,15,1,00277,India
532794,2023-12-23,715,folder,5,15,10,1,00153,India
532794,2023-12-23,709,notebook,30,60,30,1,00153,India
532794,2023-12-23,711,TD kit,150,300,150,1,00153,India
341571,2023-12-23,714,carbon paper,15,30,15,1,00126,India
341571,2023-12-23,711,TD kit,150,300,150,1,00126,India
341571,2023-12-23,702,pencil,2,5,3,1,00126,India
939784,2023-12-23,704,scale,5,10,5,1,00069,India
939784,2023-12-23,712,graph paper,20,40,20,1,00069,India
939784,2023-12-23,703,eraser,1,3,2,1,00069,India
939784,2023-12-23,707,marker,20,40,20,1,00069,India
715869,2023-12-23,704,scale,5,10,5,1,00386,India
715869,2023-12-23,709,notebook,30,60,30,1,00386,India
715869,2023-12-23,716,printing paper,200,400,200,1,00386,India
553868,2023-12-23,701,gel pen,5,10,5,1,00457,India
553868,2023-12-23,704,scale,5,10,5,1,00457,India
553868,2023-12-23,706,sharpener,3,8,5,1,00457,India
553868,2023-12-23,714,carbon paper,15,30,15,1,00457,India
553868,2023-12-23,712,graph paper,20,40,20,1,00457,India
792802,2023-12-23,717,spiral bound book,50,100,50,1,00450,India
792802,2023-12-23,704,scale,5,10,5,1,00450,India
792802,2023-12-23,701,gel pen,5,10,5,1,00450,India
792802,2023-12-23,711,TD kit,150,300,150,1,00450,India
763004,2023-12-24,711,TD kit,150,300,150,1,00184,India
763004,2023-12-24,702,pencil,2,5,3,1,00184,India
763004,2023-12-24,715,folder,5,15,10,1,00184,India
616602,2023-12-24,711,TD kit,150,300,150,1,00468,India
616602,2023-12-24,715,folder,5,15,10,1,00468,India
616602,2023-12-24,709,notebook,30,60,30,1,00468,India
616602,2023-12-24,716,printing paper,200,400,200,1,00468,India
558404,2023-12-24,706,sharpener,3,8,5,1,00051,India
558404,2023-12-24,702,pencil,2,5,3,1,00051,India
558404,2023-12-24,714,carbon paper,15,30,15,1,00051,India
413131,2023-12-24,715,folder,5,15,10,1,00445,India
413131,2023-12-24,708,sketchpen,15,40,25,1,00445,India
413131,2023-12-24,706,sharpener,3,8,5,1,00445,India
413131,2023-12-24,704,scale,5,10,5,1,00445,India
808135,2023-12-24,716,printing paper,200,400,200,1,00137,India
808135,2023-12-24,705,stencil,10,20,10,1,00137,India
808135,2023-12-24,706,sharpener,3,8,5,1,00137,India
808135,2023-12-24,715,folder,5,15,10,1,00137,India
808135,2023-12-24,702,pencil,2,5,3,1,00137,India
662484,2023-12-24,709,notebook,30,60,30,1,00493,India
662484,2023-12-24,716,printing paper,200,400,200,1,00493,India
662484,2023-12-24,710,geometry box,100,150,50,1,00493,India
662484,2023-12-24,702,pencil,2,5,3,1,00493,India
286550,2023-12-24,701,gel pen,5,10,5,1,00131,India
613438,2023-12-24,716,printing paper,200,400,200,1,00043,India
613438,2023-12-24,702,pencil,2,5,3,1,00043,India
613438,2023-12-24,705,stencil,10,20,10,1,00043,India
613438,2023-12-24,712,graph paper,20,40,20,1,00043,India
396005,2023-12-24,712,graph paper,20,40,20,1,00100,India
396005,2023-12-24,711,TD kit,150,300,150,1,00100,India
396005,2023-12-24,710,geometry box,100,150,50,1,00100,India
738823,2023-12-24,711,TD kit,150,300,150,1,00395,India
919557,2023-12-24,704,scale,5,10,5,1,00115,India
411981,2023-12-24,709,notebook,30,60,30,1,00088,India
411981,2023-12-24,708,sketchpen,15,40,25,1,00088,India
411981,2023-12-24,702,pencil,2,5,3,1,00088,India
905395,2023-12-24,704,scale,5,10,5,1,00279,India
905395,2023-12-24,710,geometry box,100,150,50,1,00279,India
905395,2023-12-24,705,stencil,10,20,10,1,00279,India
905395,2023-12-24,712,graph paper,20,40,20,1,00279,India
741621,2023-12-24,713,ball pen,5,10,5,1,00228,India
832902,2023-12-24,704,scale,5,10,5,1,00062,India
832902,2023-12-24,705,stencil,10,20,10,1,00062,India
832902,2023-12-24,701,gel pen,5,10,5,1,00062,India
977536,2023-12-24,713,ball pen,5,10,5,1,00353,India
977536,2023-12-24,717,spiral bound book,50,100,50,1,00353,India
977536,2023-12-24,705,stencil,10,20,10,1,00353,India
977536,2023-12-24,714,carbon paper,15,30,15,1,00353,India
977536,2023-12-24,703,eraser,1,3,2,1,00353,India
731301,2023-12-24,712,graph paper,20,40,20,1,00371,India
731301,2023-12-24,715,folder,5,15,10,1,00371,India
989902,2023-12-24,716,printing paper,200,400,200,1,00489,India
989902,2023-12-24,705,stencil,10,20,10,1,00489,India
989902,2023-12-24,717,spiral bound book,50,100,50,1,00489,India
989902,2023-12-24,709,notebook,30,60,30,1,00489,India
989902,2023-12-24,707,marker,20,40,20,1,00489,India
480830,2023-12-24,706,sharpener,3,8,5,1,00447,India
480830,2023-12-24,709,notebook,30,60,30,1,00447,India
150307,2023-12-24,716,printing paper,200,400,200,1,00069,India
150307,2023-12-24,708,sketchpen,15,40,25,1,00069,India
848287,2023-12-24,701,gel pen,5,10,5,1,00126,India
848287,2023-12-24,704,scale,5,10,5,1,00126,India
848287,2023-12-24,710,geometry box,100,150,50,1,00126,India
918515,2023-12-24,711,TD kit,150,300,150,1,00266,India
918515,2023-12-24,701,gel pen,5,10,5,1,00266,India
918515,2023-12-24,713,ball pen,5,10,5,1,00266,India
453310,2023-12-24,714,carbon paper,15,30,15,1,00038,India
453310,2023-12-24,713,ball pen,5,10,5,1,00038,India
453310,2023-12-24,701,gel pen,5,10,5,1,00038,India
363453,2023-12-24,708,sketchpen,15,40,25,1,00033,India
363453,2023-12-24,709,notebook,30,60,30,1,00033,India
977257,2023-12-24,703,eraser,1,3,2,1,00383,India
977257,2023-12-24,702,pencil,2,5,3,1,00383,India
720489,2023-12-24,701,gel pen,5,10,5,1,00488,India
720489,2023-12-24,706,sharpener,3,8,5,1,00488,India
720489,2023-12-24,712,graph paper,20,40,20,1,00488,India
720489,2023-12-24,703,eraser,1,3,2,1,00488,India
122619,2023-12-24,706,sharpener,3,8,5,1,00142,India
122619,2023-12-24,712,graph paper,20,40,20,1,00142,India
122619,2023-12-24,713,ball pen,5,10,5,1,00142,India
122619,2023-12-24,710,geometry box,100,150,50,1,00142,India
122619,2023-12-24,711,TD kit,150,300,150,1,00142,India
471352,2023-12-24,712,graph paper,20,40,20,1,00337,India
471352,2023-12-24,713,ball pen,5,10,5,1,00337,India
471352,2023-12-24,702,pencil,2,5,3,1,00337,India
471352,2023-12-24,704,scale,5,10,5,1,00337,India
515728,2023-12-24,713,ball pen,5,10,5,1,00358,India
515728,2023-12-24,717,spiral bound book,50,100,50,1,00358,India
515728,2023-12-24,702,pencil,2,5,3,1,00358,India
312800,2023-12-24,711,TD kit,150,300,150,1,00277,India
312800,2023-12-24,705,stencil,10,20,10,1,00277,India
352350,2023-12-24,712,graph paper,20,40,20,1,00385,India
352350,2023-12-24,713,ball pen,5,10,5,1,00385,India
352350,2023-12-24,706,sharpener,3,8,5,1,00385,India
352350,2023-12-24,716,printing paper,200,400,200,1,00385,India
352350,2023-12-24,708,sketchpen,15,40,25,1,00385,India
513263,2023-12-24,707,marker,20,40,20,1,00025,India
513263,2023-12-24,715,folder,5,15,10,1,00025,India
528947,2023-12-24,709,notebook,30,60,30,1,00201,India
528947,2023-12-24,714,carbon paper,15,30,15,1,00201,India
528947,2023-12-24,713,ball pen,5,10,5,1,00201,India
528947,2023-12-24,701,gel pen,5,10,5,1,00201,India
573197,2023-12-24,701,gel pen,5,10,5,1,00461,India
573197,2023-12-24,705,stencil,10,20,10,1,00461,India
653760,2023-12-24,715,folder,5,15,10,1,00360,India
653760,2023-12-24,703,eraser,1,3,2,1,00360,India
653760,2023-12-24,707,marker,20,40,20,1,00360,India
653760,2023-12-24,705,stencil,10,20,10,1,00360,India
653760,2023-12-24,702,pencil,2,5,3,1,00360,India
149892,2023-12-24,701,gel pen,5,10,5,1,00321,India
149892,2023-12-24,712,graph paper,20,40,20,1,00321,India
149892,2023-12-24,714,carbon paper,15,30,15,1,00321,India
149892,2023-12-24,713,ball pen,5,10,5,1,00321,India
623435,2023-12-24,702,pencil,2,5,3,1,00461,India
623435,2023-12-24,708,sketchpen,15,40,25,1,00461,India
202830,2023-12-24,713,ball pen,5,10,5,1,00024,India
459088,2023-12-24,710,geometry box,100,150,50,1,00090,India
459088,2023-12-24,715,folder,5,15,10,1,00090,India
459088,2023-12-24,712,graph paper,20,40,20,1,00090,India
459088,2023-12-24,701,gel pen,5,10,5,1,00090,India
574653,2023-12-24,702,pencil,2,5,3,1,00461,India
574653,2023-12-24,703,eraser,1,3,2,1,00461,India
574653,2023-12-24,715,folder,5,15,10,1,00461,India
978643,2023-12-24,704,scale,5,10,5,1,00493,India
978643,2023-12-24,710,geometry box,100,150,50,1,00493,India
978643,2023-12-24,716,printing paper,200,400,200,1,00493,India
661447,2023-12-24,717,spiral bound book,50,100,50,1,00155,India
661447,2023-12-24,710,geometry box,100,150,50,1,00155,India
661447,2023-12-24,703,eraser,1,3,2,1,00155,India
661447,2023-12-24,711,TD kit,150,300,150,1,00155,India
705648,2023-12-24,713,ball pen,5,10,5,1,00411,India
705648,2023-12-24,716,printing paper,200,400,200,1,00411,India
705648,2023-12-24,714,carbon paper,15,30,15,1,00411,India
710194,2023-12-24,706,sharpener,3,8,5,1,00121,India
710194,2023-12-24,709,notebook,30,60,30,1,00121,India
710194,2023-12-24,707,marker,20,40,20,1,00121,India
710194,2023-12-24,715,folder,5,15,10,1,00121,India
353507,2023-12-24,703,eraser,1,3,2,1,00019,India
555439,2023-12-25,703,eraser,1,3,2,1,00495,India
555439,2023-12-25,707,marker,20,40,20,1,00495,India
555439,2023-12-25,715,folder,5,15,10,1,00495,India
555439,2023-12-25,710,geometry box,100,150,50,1,00495,India
992970,2023-12-25,705,stencil,10,20,10,1,00025,India
992970,2023-12-25,710,geometry box,100,150,50,1,00025,India
992970,2023-12-25,713,ball pen,5,10,5,1,00025,India
992970,2023-12-25,706,sharpener,3,8,5,1,00025,India
992970,2023-12-25,716,printing paper,200,400,200,1,00025,India
611345,2023-12-25,701,gel pen,5,10,5,1,00159,India
611345,2023-12-25,704,scale,5,10,5,1,00159,India
611345,2023-12-25,715,folder,5,15,10,1,00159,India
611345,2023-12-25,717,spiral bound book,50,100,50,1,00159,India
764355,2023-12-25,701,gel pen,5,10,5,1,00382,India
764355,2023-12-25,702,pencil,2,5,3,1,00382,India
764355,2023-12-25,711,TD kit,150,300,150,1,00382,India
764355,2023-12-25,713,ball pen,5,10,5,1,00382,India
410110,2023-12-25,707,marker,20,40,20,1,00466,India
125410,2023-12-25,711,TD kit,150,300,150,1,00032,India
125410,2023-12-25,702,pencil,2,5,3,1,00032,India
125410,2023-12-25,706,sharpener,3,8,5,1,00032,India
125410,2023-12-25,703,eraser,1,3,2,1,00032,India
357090,2023-12-25,717,spiral bound book,50,100,50,1,00349,India
516789,2023-12-25,712,graph paper,20,40,20,1,00455,India
516789,2023-12-25,717,spiral bound book,50,100,50,1,00455,India
516789,2023-12-25,710,geometry box,100,150,50,1,00455,India
516789,2023-12-25,711,TD kit,150,300,150,1,00455,India
516789,2023-12-25,714,carbon paper,15,30,15,1,00455,India
689255,2023-12-25,717,spiral bound book,50,100,50,1,00311,India
689255,2023-12-25,716,printing paper,200,400,200,1,00311,India
689255,2023-12-25,711,TD kit,150,300,150,1,00311,India
191334,2023-12-25,708,sketchpen,15,40,25,1,00229,India
191334,2023-12-25,714,carbon paper,15,30,15,1,00229,India
191334,2023-12-25,715,folder,5,15,10,1,00229,India
191334,2023-12-25,709,notebook,30,60,30,1,00229,India
402076,2023-12-25,711,TD kit,150,300,150,1,00181,India
402076,2023-12-25,713,ball pen,5,10,5,1,00181,India
402076,2023-12-25,710,geometry box,100,150,50,1,00181,India
471327,2023-12-25,712,graph paper,20,40,20,1,00067,India
471327,2023-12-25,709,notebook,30,60,30,1,00067,India
541051,2023-12-25,717,spiral bound book,50,100,50,1,00074,India
541051,2023-12-25,705,stencil,10,20,10,1,00074,India
541051,2023-12-25,708,sketchpen,15,40,25,1,00074,India
648917,2023-12-25,707,marker,20,40,20,1,00435,India
290141,2023-12-25,716,printing paper,200,400,200,1,00120,India
372903,2023-12-25,712,graph paper,20,40,20,1,00499,India
372903,2023-12-25,706,sharpener,3,8,5,1,00499,India
372903,2023-12-25,703,eraser,1,3,2,1,00499,India
372903,2023-12-25,713,ball pen,5,10,5,1,00499,India
213696,2023-12-25,706,sharpener,3,8,5,1,00348,India
213696,2023-12-25,705,stencil,10,20,10,1,00348,India
722434,2023-12-25,702,pencil,2,5,3,1,00460,India
722434,2023-12-25,703,eraser,1,3,2,1,00460,India
722434,2023-12-25,716,printing paper,200,400,200,1,00460,India
722434,2023-12-25,713,ball pen,5,10,5,1,00460,India
826195,2023-12-25,713,ball pen,5,10,5,1,00248,India
826195,2023-12-25,714,carbon paper,15,30,15,1,00248,India
683666,2023-12-25,713,ball pen,5,10,5,1,00260,India
581889,2023-12-25,716,printing paper,200,400,200,1,00284,India
581889,2023-12-25,712,graph paper,20,40,20,1,00284,India
855121,2023-12-25,707,marker,20,40,20,1,00026,India
855121,2023-12-25,702,pencil,2,5,3,1,00026,India
855121,2023-12-25,716,printing paper,200,400,200,1,00026,India
855121,2023-12-25,705,stencil,10,20,10,1,00026,India
672154,2023-12-25,706,sharpener,3,8,5,1,00020,India
672154,2023-12-25,707,marker,20,40,20,1,00020,India
738554,2023-12-25,707,marker,20,40,20,1,00350,India
738554,2023-12-25,715,folder,5,15,10,1,00350,India
738554,2023-12-25,712,graph paper,20,40,20,1,00350,India
906131,2023-12-25,713,ball pen,5,10,5,1,00226,India
906131,2023-12-25,706,sharpener,3,8,5,1,00226,India
341834,2023-12-25,709,notebook,30,60,30,1,00130,India
341834,2023-12-25,701,gel pen,5,10,5,1,00130,India
341834,2023-12-25,710,geometry box,100,150,50,1,00130,India
196277,2023-12-25,703,eraser,1,3,2,1,00038,India
196277,2023-12-25,715,folder,5,15,10,1,00038,India
196277,2023-12-25,713,ball pen,5,10,5,1,00038,India
196277,2023-12-25,709,notebook,30,60,30,1,00038,India
158068,2023-12-25,706,sharpener,3,8,5,1,00324,India
152256,2023-12-25,710,geometry box,100,150,50,1,00428,India
152256,2023-12-25,716,printing paper,200,400,200,1,00428,India
731759,2023-12-25,704,scale,5,10,5,1,00234,India
731759,2023-12-25,711,TD kit,150,300,150,1,00234,India
547155,2023-12-25,703,eraser,1,3,2,1,00059,India
547155,2023-12-25,701,gel pen,5,10,5,1,00059,India
944119,2023-12-26,717,spiral bound book,50,100,50,1,00144,India
944119,2023-12-26,708,sketchpen,15,40,25,1,00144,India
944119,2023-12-26,704,scale,5,10,5,1,00144,India
944119,2023-12-26,706,sharpener,3,8,5,1,00144,India
432101,2023-12-26,705,stencil,10,20,10,1,00439,India
432101,2023-12-26,702,pencil,2,5,3,1,00439,India
612999,2023-12-26,713,ball pen,5,10,5,1,00374,India
612999,2023-12-26,704,scale,5,10,5,1,00374,India
612999,2023-12-26,716,printing paper,200,400,200,1,00374,India
455918,2023-12-26,714,carbon paper,15,30,15,1,00204,India
455918,2023-12-26,716,printing paper,200,400,200,1,00204,India
455918,2023-12-26,717,spiral bound book,50,100,50,1,00204,India
215585,2023-12-26,707,marker,20,40,20,1,00472,India
215585,2023-12-26,703,eraser,1,3,2,1,00472,India
215585,2023-12-26,709,notebook,30,60,30,1,00472,India
215585,2023-12-26,710,geometry box,100,150,50,1,00472,India
215585,2023-12-26,717,spiral bound book,50,100,50,1,00472,India
801400,2023-12-26,715,folder,5,15,10,1,00331,India
536843,2023-12-26,712,graph paper,20,40,20,1,00342,India
536843,2023-12-26,707,marker,20,40,20,1,00342,India
536843,2023-12-26,705,stencil,10,20,10,1,00342,India
767732,2023-12-26,709,notebook,30,60,30,1,00115,India
767732,2023-12-26,712,graph paper,20,40,20,1,00115,India
767732,2023-12-26,717,spiral bound book,50,100,50,1,00115,India
767732,2023-12-26,701,gel pen,5,10,5,1,00115,India
308440,2023-12-26,704,scale,5,10,5,1,00329,India
308440,2023-12-26,710,geometry box,100,150,50,1,00329,India
308440,2023-12-26,717,spiral bound book,50,100,50,1,00329,India
308440,2023-12-26,702,pencil,2,5,3,1,00329,India
400667,2023-12-26,709,notebook,30,60,30,1,00145,India
400667,2023-12-26,714,carbon paper,15,30,15,1,00145,India
400667,2023-12-26,716,printing paper,200,400,200,1,00145,India
400667,2023-12-26,707,marker,20,40,20,1,00145,India
400667,2023-12-26,706,sharpener,3,8,5,1,00145,India
953700,2023-12-26,714,carbon paper,15,30,15,1,00304,India
953700,2023-12-26,710,geometry box,100,150,50,1,00304,India
135774,2023-12-26,715,folder,5,15,10,1,00491,India
135774,2023-12-26,703,eraser,1,3,2,1,00491,India
135774,2023-12-26,706,sharpener,3,8,5,1,00491,India
135774,2023-12-26,709,notebook,30,60,30,1,00491,India
782739,2023-12-26,716,printing paper,200,400,200,1,00209,India
336016,2023-12-26,709,notebook,30,60,30,1,00036,India
336016,2023-12-26,706,sharpener,3,8,5,1,00036,India
336016,2023-12-26,713,ball pen,5,10,5,1,00036,India
336016,2023-12-26,701,gel pen,5,10,5,1,00036,India
336016,2023-12-26,714,carbon paper,15,30,15,1,00036,India
799940,2023-12-26,704,scale,5,10,5,1,00190,India
839854,2023-12-26,704,scale,5,10,5,1,00286,India
839854,2023-12-26,702,pencil,2,5,3,1,00286,India
839854,2023-12-26,715,folder,5,15,10,1,00286,India
934285,2023-12-26,717,spiral bound book,50,100,50,1,00155,India
934285,2023-12-26,706,sharpener,3,8,5,1,00155,India
934285,2023-12-26,714,carbon paper,15,30,15,1,00155,India
368699,2023-12-26,715,folder,5,15,10,1,00144,India
368699,2023-12-26,708,sketchpen,15,40,25,1,00144,India
368699,2023-12-26,711,TD kit,150,300,150,1,00144,India
368699,2023-12-26,705,stencil,10,20,10,1,00144,India
368699,2023-12-26,716,printing paper,200,400,200,1,00144,India
344681,2023-12-26,716,printing paper,200,400,200,1,00211,India
344681,2023-12-26,701,gel pen,5,10,5,1,00211,India
627712,2023-12-26,707,marker,20,40,20,1,00078,India
627712,2023-12-26,717,spiral bound book,50,100,50,1,00078,India
627712,2023-12-26,711,TD kit,150,300,150,1,00078,India
627712,2023-12-26,710,geometry box,100,150,50,1,00078,India
715895,2023-12-26,701,gel pen,5,10,5,1,00495,India
715895,2023-12-26,702,pencil,2,5,3,1,00495,India
767351,2023-12-26,717,spiral bound book,50,100,50,1,00283,India
767351,2023-12-26,713,ball pen,5,10,5,1,00283,India
767351,2023-12-26,710,geometry box,100,150,50,1,00283,India
807836,2023-12-26,711,TD kit,150,300,150,1,00024,India
807836,2023-12-26,708,sketchpen,15,40,25,1,00024,India
807836,2023-12-26,709,notebook,30,60,30,1,00024,India
807836,2023-12-26,713,ball pen,5,10,5,1,00024,India
475084,2023-12-26,704,scale,5,10,5,1,00089,India
475084,2023-12-26,705,stencil,10,20,10,1,00089,India
475084,2023-12-26,712,graph paper,20,40,20,1,00089,India
475084,2023-12-26,716,printing paper,200,400,200,1,00089,India
993411,2023-12-26,709,notebook,30,60,30,1,00218,India
993411,2023-12-26,701,gel pen,5,10,5,1,00218,India
993411,2023-12-26,710,geometry box,100,150,50,1,00218,India
509877,2023-12-26,716,printing paper,200,400,200,1,00024,India
140822,2023-12-26,710,geometry box,100,150,50,1,00075,India
140822,2023-12-26,711,TD kit,150,300,150,1,00075,India
140822,2023-12-26,703,eraser,1,3,2,1,00075,India
140822,2023-12-26,714,carbon paper,15,30,15,1,00075,India
884459,2023-12-26,706,sharpener,3,8,5,1,00160,India
884459,2023-12-26,711,TD kit,150,300,150,1,00160,India
884459,2023-12-26,712,graph paper,20,40,20,1,00160,India
904521,2023-12-26,701,gel pen,5,10,5,1,00019,India
904521,2023-12-26,717,spiral bound book,50,100,50,1,00019,India
680292,2023-12-26,710,geometry box,100,150,50,1,00269,India
680292,2023-12-26,717,spiral bound book,50,100,50,1,00269,India
680292,2023-12-26,702,pencil,2,5,3,1,00269,India
680292,2023-12-26,714,carbon paper,15,30,15,1,00269,India
360465,2023-12-26,701,gel pen,5,10,5,1,00247,India
360465,2023-12-26,713,ball pen,5,10,5,1,00247,India
360465,2023-12-26,702,pencil,2,5,3,1,00247,India
428751,2023-12-26,702,pencil,2,5,3,1,00265,India
428751,2023-12-26,715,folder,5,15,10,1,00265,India
428751,2023-12-26,703,eraser,1,3,2,1,00265,India
428751,2023-12-26,706,sharpener,3,8,5,1,00265,India
891275,2023-12-26,704,scale,5,10,5,1,00255,India
891275,2023-12-26,705,stencil,10,20,10,1,00255,India
743761,2023-12-26,711,TD kit,150,300,150,1,00394,India
743761,2023-12-26,712,graph paper,20,40,20,1,00394,India
659667,2023-12-26,706,sharpener,3,8,5,1,00173,India
659667,2023-12-26,705,stencil,10,20,10,1,00173,India
659667,2023-12-26,717,spiral bound book,50,100,50,1,00173,India
601884,2023-12-26,703,eraser,1,3,2,1,00208,India
601884,2023-12-26,713,ball pen,5,10,5,1,00208,India
601884,2023-12-26,715,folder,5,15,10,1,00208,India
309712,2023-12-26,703,eraser,1,3,2,1,00019,India
309712,2023-12-26,710,geometry box,100,150,50,1,00019,India
344074,2023-12-26,715,folder,5,15,10,1,00152,India
793988,2023-12-26,707,marker,20,40,20,1,00443,India
793988,2023-12-26,716,printing paper,200,400,200,1,00443,India
473142,2023-12-26,710,geometry box,100,150,50,1,00021,India
662088,2023-12-26,710,geometry box,100,150,50,1,00263,India
662088,2023-12-26,715,folder,5,15,10,1,00263,India
662088,2023-12-26,709,notebook,30,60,30,1,00263,India
662088,2023-12-26,717,spiral bound book,50,100,50,1,00263,India
522726,2023-12-26,706,sharpener,3,8,5,1,00128,India
522726,2023-12-26,707,marker,20,40,20,1,00128,India
522726,2023-12-26,701,gel pen,5,10,5,1,00128,India
637562,2023-12-26,705,stencil,10,20,10,1,00371,India
637562,2023-12-26,717,spiral bound book,50,100,50,1,00371,India
637562,2023-12-26,712,graph paper,20,40,20,1,00371,India
637562,2023-12-26,706,sharpener,3,8,5,1,00371,India
208439,2023-12-26,714,carbon paper,15,30,15,1,00247,India
296905,2023-12-26,704,scale,5,10,5,1,00067,India
296905,2023-12-26,708,sketchpen,15,40,25,1,00067,India
296905,2023-12-26,705,stencil,10,20,10,1,00067,India
296905,2023-12-26,702,pencil,2,5,3,1,00067,India
296905,2023-12-26,713,ball pen,5,10,5,1,00067,India
129861,2023-12-26,706,sharpener,3,8,5,1,00118,India
129861,2023-12-26,710,geometry box,100,150,50,1,00118,India
129861,2023-12-26,716,printing paper,200,400,200,1,00118,India
129861,2023-12-26,701,gel pen,5,10,5,1,00118,India
209209,2023-12-26,716,printing paper,200,400,200,1,00124,India
209209,2023-12-26,713,ball pen,5,10,5,1,00124,India
209209,2023-12-26,714,carbon paper,15,30,15,1,00124,India
209209,2023-12-26,703,eraser,1,3,2,1,00124,India
557614,2023-12-27,713,ball pen,5,10,5,1,00373,India
557614,2023-12-27,708,sketchpen,15,40,25,1,00373,India
720173,2023-12-27,713,ball pen,5,10,5,1,00240,India
720173,2023-12-27,710,geometry box,100,150,50,1,00240,India
720173,2023-12-27,714,carbon paper,15,30,15,1,00240,India
117673,2023-12-27,709,notebook,30,60,30,1,00122,India
117673,2023-12-27,706,sharpener,3,8,5,1,00122,India
614464,2023-12-27,704,scale,5,10,5,1,00207,India
614464,2023-12-27,706,sharpener,3,8,5,1,00207,India
614464,2023-12-27,701,gel pen,5,10,5,1,00207,India
670095,2023-12-27,709,notebook,30,60,30,1,00208,India
670095,2023-12-27,715,folder,5,15,10,1,00208,India
670095,2023-12-27,717,spiral bound book,50,100,50,1,00208,India
670095,2023-12-27,707,marker,20,40,20,1,00208,India
884568,2023-12-27,711,TD kit,150,300,150,1,00391,India
884568,2023-12-27,715,folder,5,15,10,1,00391,India
884568,2023-12-27,712,graph paper,20,40,20,1,00391,India
884568,2023-12-27,717,spiral bound book,50,100,50,1,00391,India
884568,2023-12-27,713,ball pen,5,10,5,1,00391,India
248168,2023-12-27,701,gel pen,5,10,5,1,00020,India
248168,2023-12-27,713,ball pen,5,10,5,1,00020,India
248168,2023-12-27,717,spiral bound book,50,100,50,1,00020,India
248168,2023-12-27,706,sharpener,3,8,5,1,00020,India
340780,2023-12-27,714,carbon paper,15,30,15,1,00491,India
340780,2023-12-27,715,folder,5,15,10,1,00491,India
227528,2023-12-27,709,notebook,30,60,30,1,00009,India
227528,2023-12-27,705,stencil,10,20,10,1,00009,India
806781,2023-12-27,711,TD kit,150,300,150,1,00153,India
806781,2023-12-27,709,notebook,30,60,30,1,00153,India
806781,2023-12-27,702,pencil,2,5,3,1,00153,India
179991,2023-12-27,703,eraser,1,3,2,1,00450,India
238199,2023-12-27,705,stencil,10,20,10,1,00299,India
238199,2023-12-27,711,TD kit,150,300,150,1,00299,India
238199,2023-12-27,702,pencil,2,5,3,1,00299,India
595559,2023-12-27,702,pencil,2,5,3,1,00368,India
595559,2023-12-27,717,spiral bound book,50,100,50,1,00368,India
595559,2023-12-27,710,geometry box,100,150,50,1,00368,India
595559,2023-12-27,701,gel pen,5,10,5,1,00368,India
914272,2023-12-27,709,notebook,30,60,30,1,00188,India
914272,2023-12-27,712,graph paper,20,40,20,1,00188,India
914272,2023-12-27,716,printing paper,200,400,200,1,00188,India
369485,2023-12-27,711,TD kit,150,300,150,1,00068,India
329681,2023-12-27,705,stencil,10,20,10,1,00337,India
329681,2023-12-27,707,marker,20,40,20,1,00337,India
329681,2023-12-27,710,geometry box,100,150,50,1,00337,India
329681,2023-12-27,712,graph paper,20,40,20,1,00337,India
938945,2023-12-27,709,notebook,30,60,30,1,00279,India
938945,2023-12-27,710,geometry box,100,150,50,1,00279,India
115864,2023-12-27,701,gel pen,5,10,5,1,00316,India
115864,2023-12-27,711,TD kit,150,300,150,1,00316,India
115864,2023-12-27,704,scale,5,10,5,1,00316,India
115864,2023-12-27,707,marker,20,40,20,1,00316,India
115864,2023-12-27,713,ball pen,5,10,5,1,00316,India
822706,2023-12-27,706,sharpener,3,8,5,1,00316,India
828849,2023-12-27,716,printing paper,200,400,200,1,00433,India
743622,2023-12-27,701,gel pen,5,10,5,1,00228,India
743622,2023-12-27,712,graph paper,20,40,20,1,00228,India
160207,2023-12-27,713,ball pen,5,10,5,1,00014,India
160207,2023-12-27,714,carbon paper,15,30,15,1,00014,India
160207,2023-12-27,701,gel pen,5,10,5,1,00014,India
533309,2023-12-27,707,marker,20,40,20,1,00377,India
333940,2023-12-27,713,ball pen,5,10,5,1,00109,India
333940,2023-12-27,707,marker,20,40,20,1,00109,India
333940,2023-12-27,714,carbon paper,15,30,15,1,00109,India
333940,2023-12-27,703,eraser,1,3,2,1,00109,India
461348,2023-12-27,708,sketchpen,15,40,25,1,00363,India
461348,2023-12-27,701,gel pen,5,10,5,1,00363,India
461348,2023-12-27,712,graph paper,20,40,20,1,00363,India
461348,2023-12-27,716,printing paper,200,400,200,1,00363,India
331309,2023-12-27,710,geometry box,100,150,50,1,00082,India
331309,2023-12-27,705,stencil,10,20,10,1,00082,India
331309,2023-12-27,709,notebook,30,60,30,1,00082,India
331309,2023-12-27,715,folder,5,15,10,1,00082,India
971265,2023-12-27,704,scale,5,10,5,1,00001,India
971265,2023-12-27,705,stencil,10,20,10,1,00001,India
627741,2023-12-27,702,pencil,2,5,3,1,00022,India
627741,2023-12-27,705,stencil,10,20,10,1,00022,India
453879,2023-12-27,707,marker,20,40,20,1,00378,India
453879,2023-12-27,714,carbon paper,15,30,15,1,00378,India
557656,2023-12-27,705,stencil,10,20,10,1,00039,India
557656,2023-12-27,703,eraser,1,3,2,1,00039,India
557656,2023-12-27,710,geometry box,100,150,50,1,00039,India
557656,2023-12-27,706,sharpener,3,8,5,1,00039,India
108113,2023-12-27,713,ball pen,5,10,5,1,00107,India
108113,2023-12-27,717,spiral bound book,50,100,50,1,00107,India
108113,2023-12-27,711,TD kit,150,300,150,1,00107,India
108113,2023-12-27,706,sharpener,3,8,5,1,00107,India
834284,2023-12-27,709,notebook,30,60,30,1,00487,India
834284,2023-12-27,717,spiral bound book,50,100,50,1,00487,India
211707,2023-12-27,708,sketchpen,15,40,25,1,00375,India
199988,2023-12-27,706,sharpener,3,8,5,1,00015,India
149154,2023-12-27,714,carbon paper,15,30,15,1,00099,India
149154,2023-12-27,702,pencil,2,5,3,1,00099,India
861797,2023-12-27,709,notebook,30,60,30,1,00275,India
861797,2023-12-27,714,carbon paper,15,30,15,1,00275,India
632314,2023-12-27,704,scale,5,10,5,1,00425,India
632314,2023-12-27,711,TD kit,150,300,150,1,00425,India
486210,2023-12-27,707,marker,20,40,20,1,00032,India
486210,2023-12-27,712,graph paper,20,40,20,1,00032,India
486210,2023-12-27,703,eraser,1,3,2,1,00032,India
486210,2023-12-27,705,stencil,10,20,10,1,00032,India
256324,2023-12-27,701,gel pen,5,10,5,1,00024,India
969334,2023-12-27,717,spiral bound book,50,100,50,1,00009,India
969334,2023-12-27,714,carbon paper,15,30,15,1,00009,India
969334,2023-12-27,702,pencil,2,5,3,1,00009,India
831903,2023-12-27,710,geometry box,100,150,50,1,00028,India
831903,2023-12-27,717,spiral bound book,50,100,50,1,00028,India
251525,2023-12-27,709,notebook,30,60,30,1,00343,India
251525,2023-12-27,715,folder,5,15,10,1,00343,India
267333,2023-12-27,702,pencil,2,5,3,1,00014,India
267333,2023-12-27,708,sketchpen,15,40,25,1,00014,India
267333,2023-12-27,704,scale,5,10,5,1,00014,India
267333,2023-12-27,716,printing paper,200,400,200,1,00014,India
334920,2023-12-27,717,spiral bound book,50,100,50,1,00467,India
334920,2023-12-27,716,printing paper,200,400,200,1,00467,India
334920,2023-12-27,710,geometry box,100,150,50,1,00467,India
476448,2023-12-27,713,ball pen,5,10,5,1,00193,India
476448,2023-12-27,705,stencil,10,20,10,1,00193,India
476448,2023-12-27,716,printing paper,200,400,200,1,00193,India
307955,2023-12-27,714,carbon paper,15,30,15,1,00379,India
307955,2023-12-27,707,marker,20,40,20,1,00379,India
307955,2023-12-27,706,sharpener,3,8,5,1,00379,India
307955,2023-12-27,701,gel pen,5,10,5,1,00379,India
307955,2023-12-27,712,graph paper,20,40,20,1,00379,India
262667,2023-12-28,713,ball pen,5,10,5,1,00308,India
256871,2023-12-28,713,ball pen,5,10,5,1,00031,India
256871,2023-12-28,716,printing paper,200,400,200,1,00031,India
256871,2023-12-28,701,gel pen,5,10,5,1,00031,India
179475,2023-12-28,706,sharpener,3,8,5,1,00491,India
179475,2023-12-28,710,geometry box,100,150,50,1,00491,India
179475,2023-12-28,709,notebook,30,60,30,1,00491,India
179475,2023-12-28,707,marker,20,40,20,1,00491,India
227604,2023-12-28,712,graph paper,20,40,20,1,00205,India
227604,2023-12-28,703,eraser,1,3,2,1,00205,India
227604,2023-12-28,706,sharpener,3,8,5,1,00205,India
227604,2023-12-28,708,sketchpen,15,40,25,1,00205,India
902398,2023-12-28,716,printing paper,200,400,200,1,00030,India
902398,2023-12-28,717,spiral bound book,50,100,50,1,00030,India
976342,2023-12-28,711,TD kit,150,300,150,1,00081,India
976342,2023-12-28,701,gel pen,5,10,5,1,00081,India
118247,2023-12-28,704,scale,5,10,5,1,00189,India
118247,2023-12-28,713,ball pen,5,10,5,1,00189,India
118247,2023-12-28,703,eraser,1,3,2,1,00189,India
118247,2023-12-28,712,graph paper,20,40,20,1,00189,India
443539,2023-12-28,710,geometry box,100,150,50,1,00242,India
443539,2023-12-28,716,printing paper,200,400,200,1,00242,India
660238,2023-12-28,701,gel pen,5,10,5,1,00134,India
169148,2023-12-28,709,notebook,30,60,30,1,00264,India
169148,2023-12-28,701,gel pen,5,10,5,1,00264,India
169148,2023-12-28,714,carbon paper,15,30,15,1,00264,India
169148,2023-12-28,704,scale,5,10,5,1,00264,India
169148,2023-12-28,702,pencil,2,5,3,1,00264,India
205989,2023-12-28,714,carbon paper,15,30,15,1,00055,India
205989,2023-12-28,716,printing paper,200,400,200,1,00055,India
205989,2023-12-28,702,pencil,2,5,3,1,00055,India
783790,2023-12-28,716,printing paper,200,400,200,1,00409,India
783790,2023-12-28,704,scale,5,10,5,1,00409,India
783790,2023-12-28,701,gel pen,5,10,5,1,00409,India
783790,2023-12-28,702,pencil,2,5,3,1,00409,India
608171,2023-12-28,701,gel pen,5,10,5,1,00459,India
608171,2023-12-28,714,carbon paper,15,30,15,1,00459,India
503100,2023-12-28,708,sketchpen,15,40,25,1,00353,India
503100,2023-12-28,707,marker,20,40,20,1,00353,India
503100,2023-12-28,706,sharpener,3,8,5,1,00353,India
503100,2023-12-28,712,graph paper,20,40,20,1,00353,India
503100,2023-12-28,703,eraser,1,3,2,1,00353,India
382438,2023-12-28,701,gel pen,5,10,5,1,00032,India
382438,2023-12-28,708,sketchpen,15,40,25,1,00032,India
382438,2023-12-28,703,eraser,1,3,2,1,00032,India
954673,2023-12-28,709,notebook,30,60,30,1,00459,India
954673,2023-12-28,705,stencil,10,20,10,1,00459,India
954673,2023-12-28,702,pencil,2,5,3,1,00459,India
749557,2023-12-28,715,folder,5,15,10,1,00060,India
212538,2023-12-28,715,folder,5,15,10,1,00313,India
212538,2023-12-28,704,scale,5,10,5,1,00313,India
212538,2023-12-28,706,sharpener,3,8,5,1,00313,India
212538,2023-12-28,712,graph paper,20,40,20,1,00313,India
468131,2023-12-28,705,stencil,10,20,10,1,00068,India
913676,2023-12-28,711,TD kit,150,300,150,1,00137,India
913676,2023-12-28,706,sharpener,3,8,5,1,00137,India
913676,2023-12-28,703,eraser,1,3,2,1,00137,India
913676,2023-12-28,712,graph paper,20,40,20,1,00137,India
736799,2023-12-28,705,stencil,10,20,10,1,00327,India
736799,2023-12-28,704,scale,5,10,5,1,00327,India
736799,2023-12-28,701,gel pen,5,10,5,1,00327,India
736799,2023-12-28,702,pencil,2,5,3,1,00327,India
736799,2023-12-28,708,sketchpen,15,40,25,1,00327,India
593933,2023-12-28,707,marker,20,40,20,1,00368,India
593933,2023-12-28,716,printing paper,200,400,200,1,00368,India
593933,2023-12-28,711,TD kit,150,300,150,1,00368,India
593933,2023-12-28,713,ball pen,5,10,5,1,00368,India
593933,2023-12-28,712,graph paper,20,40,20,1,00368,India
753519,2023-12-28,711,TD kit,150,300,150,1,00066,India
892716,2023-12-28,708,sketchpen,15,40,25,1,00091,India
892716,2023-12-28,707,marker,20,40,20,1,00091,India
892716,2023-12-28,703,eraser,1,3,2,1,00091,India
892716,2023-12-28,711,TD kit,150,300,150,1,00091,India
415355,2023-12-28,704,scale,5,10,5,1,00195,India
415355,2023-12-28,716,printing paper,200,400,200,1,00195,India
415355,2023-12-28,709,notebook,30,60,30,1,00195,India
415355,2023-12-28,711,TD kit,150,300,150,1,00195,India
769215,2023-12-28,708,sketchpen,15,40,25,1,00067,India
769215,2023-12-28,709,notebook,30,60,30,1,00067,India
769215,2023-12-28,704,scale,5,10,5,1,00067,India
136506,2023-12-28,708,sketchpen,15,40,25,1,00053,India
136506,2023-12-28,706,sharpener,3,8,5,1,00053,India
136506,2023-12-28,713,ball pen,5,10,5,1,00053,India
136506,2023-12-28,701,gel pen,5,10,5,1,00053,India
991271,2023-12-28,704,scale,5,10,5,1,00138,India
991271,2023-12-28,708,sketchpen,15,40,25,1,00138,India
619937,2023-12-28,702,pencil,2,5,3,1,00060,India
507620,2023-12-28,705,stencil,10,20,10,1,00189,India
507620,2023-12-28,706,sharpener,3,8,5,1,00189,India
507620,2023-12-28,704,scale,5,10,5,1,00189,India
507620,2023-12-28,708,sketchpen,15,40,25,1,00189,India
977939,2023-12-28,702,pencil,2,5,3,1,00198,India
502023,2023-12-28,704,scale,5,10,5,1,00381,India
502023,2023-12-28,713,ball pen,5,10,5,1,00381,India
502023,2023-12-28,702,pencil,2,5,3,1,00381,India
453654,2023-12-29,711,TD kit,150,300,150,1,00324,India
453654,2023-12-29,710,geometry box,100,150,50,1,00324,India
453654,2023-12-29,716,printing paper,200,400,200,1,00324,India
453654,2023-12-29,713,ball pen,5,10,5,1,00324,India
453654,2023-12-29,708,sketchpen,15,40,25,1,00324,India
304945,2023-12-29,706,sharpener,3,8,5,1,00096,India
304945,2023-12-29,715,folder,5,15,10,1,00096,India
304945,2023-12-29,717,spiral bound book,50,100,50,1,00096,India
304945,2023-12-29,711,TD kit,150,300,150,1,00096,India
692499,2023-12-29,715,folder,5,15,10,1,00449,India
692499,2023-12-29,710,geometry box,100,150,50,1,00449,India
692499,2023-12-29,712,graph paper,20,40,20,1,00449,India
182227,2023-12-29,703,eraser,1,3,2,1,00478,India
182227,2023-12-29,715,folder,5,15,10,1,00478,India
182227,2023-12-29,707,marker,20,40,20,1,00478,India
182227,2023-12-29,713,ball pen,5,10,5,1,00478,India
187478,2023-12-29,706,sharpener,3,8,5,1,00103,India
187478,2023-12-29,712,graph paper,20,40,20,1,00103,India
187478,2023-12-29,707,marker,20,40,20,1,00103,India
838474,2023-12-29,714,carbon paper,15,30,15,1,00429,India
838474,2023-12-29,716,printing paper,200,400,200,1,00429,India
838474,2023-12-29,712,graph paper,20,40,20,1,00429,India
838474,2023-12-29,701,gel pen,5,10,5,1,00429,India
115888,2023-12-29,701,gel pen,5,10,5,1,00445,India
115888,2023-12-29,712,graph paper,20,40,20,1,00445,India
115888,2023-12-29,703,eraser,1,3,2,1,00445,India
115888,2023-12-29,717,spiral bound book,50,100,50,1,00445,India
115888,2023-12-29,704,scale,5,10,5,1,00445,India
697731,2023-12-29,712,graph paper,20,40,20,1,00211,India
697731,2023-12-29,707,marker,20,40,20,1,00211,India
697731,2023-12-29,710,geometry box,100,150,50,1,00211,India
697731,2023-12-29,711,TD kit,150,300,150,1,00211,India
672607,2023-12-29,714,carbon paper,15,30,15,1,00386,India
448991,2023-12-29,706,sharpener,3,8,5,1,00371,India
448991,2023-12-29,701,gel pen,5,10,5,1,00371,India
335711,2023-12-29,714,carbon paper,15,30,15,1,00353,India
335711,2023-12-29,713,ball pen,5,10,5,1,00353,India
335711,2023-12-29,709,notebook,30,60,30,1,00353,India
658695,2023-12-29,712,graph paper,20,40,20,1,00418,India
658695,2023-12-29,716,printing paper,200,400,200,1,00418,India
658695,2023-12-29,709,notebook,30,60,30,1,00418,India
115100,2023-12-29,716,printing paper,200,400,200,1,00372,India
115100,2023-12-29,713,ball pen,5,10,5,1,00372,India
115100,2023-12-29,702,pencil,2,5,3,1,00372,India
491416,2023-12-29,717,spiral bound book,50,100,50,1,00071,India
563908,2023-12-29,701,gel pen,5,10,5,1,00213,India
563908,2023-12-29,710,geometry box,100,150,50,1,00213,India
129323,2023-12-29,702,pencil,2,5,3,1,00063,India
129323,2023-12-29,705,stencil,10,20,10,1,00063,India
803320,2023-12-29,703,eraser,1,3,2,1,00082,India
803320,2023-12-29,711,TD kit,150,300,150,1,00082,India
803320,2023-12-29,702,pencil,2,5,3,1,00082,India
803320,2023-12-29,709,notebook,30,60,30,1,00082,India
803320,2023-12-29,717,spiral bound book,50,100,50,1,00082,India
741154,2023-12-29,705,stencil,10,20,10,1,00259,India
111027,2023-12-29,712,graph paper,20,40,20,1,00053,India
111027,2023-12-29,705,stencil,10,20,10,1,00053,India
111027,2023-12-29,704,scale,5,10,5,1,00053,India
111027,2023-12-29,710,geometry box,100,150,50,1,00053,India
111027,2023-12-29,713,ball pen,5,10,5,1,00053,India
917211,2023-12-29,712,graph paper,20,40,20,1,00483,India
917211,2023-12-29,708,sketchpen,15,40,25,1,00483,India
917211,2023-12-29,716,printing paper,200,400,200,1,00483,India
917211,2023-12-29,714,carbon paper,15,30,15,1,00483,India
719866,2023-12-29,717,spiral bound book,50,100,50,1,00494,India
719866,2023-12-29,716,printing paper,200,400,200,1,00494,India
946761,2023-12-29,703,eraser,1,3,2,1,00361,India
946761,2023-12-29,707,marker,20,40,20,1,00361,India
946761,2023-12-29,714,carbon paper,15,30,15,1,00361,India
913185,2023-12-29,707,marker,20,40,20,1,00432,India
913185,2023-12-29,705,stencil,10,20,10,1,00432,India
913185,2023-12-29,704,scale,5,10,5,1,00432,India
913185,2023-12-29,714,carbon paper,15,30,15,1,00432,India
826188,2023-12-29,705,stencil,10,20,10,1,00425,India
826188,2023-12-29,702,pencil,2,5,3,1,00425,India
826188,2023-12-29,713,ball pen,5,10,5,1,00425,India
325720,2023-12-29,716,printing paper,200,400,200,1,00106,India
618872,2023-12-29,717,spiral bound book,50,100,50,1,00076,India
618872,2023-12-29,709,notebook,30,60,30,1,00076,India
618872,2023-12-29,701,gel pen,5,10,5,1,00076,India
618872,2023-12-29,714,carbon paper,15,30,15,1,00076,India
464139,2023-12-29,703,eraser,1,3,2,1,00408,India
464139,2023-12-29,715,folder,5,15,10,1,00408,India
464139,2023-12-29,716,printing paper,200,400,200,1,00408,India
464139,2023-12-29,712,graph paper,20,40,20,1,00408,India
724193,2023-12-29,715,folder,5,15,10,1,00149,India
724193,2023-12-29,712,graph paper,20,40,20,1,00149,India
724193,2023-12-29,702,pencil,2,5,3,1,00149,India
724193,2023-12-29,704,scale,5,10,5,1,00149,India
797797,2023-12-29,709,notebook,30,60,30,1,00233,India
797797,2023-12-29,712,graph paper,20,40,20,1,00233,India
652168,2023-12-29,712,graph paper,20,40,20,1,00005,India
652168,2023-12-29,715,folder,5,15,10,1,00005,India
652168,2023-12-29,716,printing paper,200,400,200,1,00005,India
652168,2023-12-29,703,eraser,1,3,2,1,00005,India
741462,2023-12-29,712,graph paper,20,40,20,1,00080,India
741462,2023-12-29,711,TD kit,150,300,150,1,00080,India
791809,2023-12-29,703,eraser,1,3,2,1,00246,India
791809,2023-12-29,705,stencil,10,20,10,1,00246,India
963259,2023-12-29,710,geometry box,100,150,50,1,00307,India
963259,2023-12-29,706,sharpener,3,8,5,1,00307,India
380550,2023-12-29,714,carbon paper,15,30,15,1,00033,India
289689,2023-12-29,711,TD kit,150,300,150,1,00377,India
289689,2023-12-29,709,notebook,30,60,30,1,00377,India
289689,2023-12-29,713,ball pen,5,10,5,1,00377,India
289689,2023-12-29,705,stencil,10,20,10,1,00377,India
289689,2023-12-29,701,gel pen,5,10,5,1,00377,India
607993,2023-12-29,713,ball pen,5,10,5,1,00129,India
607993,2023-12-29,709,notebook,30,60,30,1,00129,India
607993,2023-12-29,705,stencil,10,20,10,1,00129,India
607993,2023-12-29,703,eraser,1,3,2,1,00129,India
204023,2023-12-29,701,gel pen,5,10,5,1,00460,India
204023,2023-12-29,709,notebook,30,60,30,1,00460,India
204023,2023-12-29,713,ball pen,5,10,5,1,00460,India
204023,2023-12-29,708,sketchpen,15,40,25,1,00460,India
997738,2023-12-29,715,folder,5,15,10,1,00432,India
997738,2023-12-29,707,marker,20,40,20,1,00432,India
997738,2023-12-29,716,printing paper,200,400,200,1,00432,India
982623,2023-12-29,701,gel pen,5,10,5,1,00158,India
982623,2023-12-29,708,sketchpen,15,40,25,1,00158,India
585138,2023-12-29,712,graph paper,20,40,20,1,00385,India
335949,2023-12-30,705,stencil,10,20,10,1,00007,India
335949,2023-12-30,709,notebook,30,60,30,1,00007,India
335949,2023-12-30,702,pencil,2,5,3,1,00007,India
453287,2023-12-30,716,printing paper,200,400,200,1,00358,India
453287,2023-12-30,712,graph paper,20,40,20,1,00358,India
453287,2023-12-30,705,stencil,10,20,10,1,00358,India
453287,2023-12-30,708,sketchpen,15,40,25,1,00358,India
227402,2023-12-30,709,notebook,30,60,30,1,00422,India
503069,2023-12-30,717,spiral bound book,50,100,50,1,00101,India
503069,2023-12-30,709,notebook,30,60,30,1,00101,India
503069,2023-12-30,713,ball pen,5,10,5,1,00101,India
503069,2023-12-30,714,carbon paper,15,30,15,1,00101,India
224911,2023-12-30,717,spiral bound book,50,100,50,1,00149,India
224911,2023-12-30,702,pencil,2,5,3,1,00149,India
224911,2023-12-30,716,printing paper,200,400,200,1,00149,India
531516,2023-12-30,717,spiral bound book,50,100,50,1,00383,India
531516,2023-12-30,701,gel pen,5,10,5,1,00383,India
531516,2023-12-30,710,geometry box,100,150,50,1,00383,India
372699,2023-12-30,711,TD kit,150,300,150,1,00146,India
372699,2023-12-30,715,folder,5,15,10,1,00146,India
795716,2023-12-30,713,ball pen,5,10,5,1,00114,India
795716,2023-12-30,705,stencil,10,20,10,1,00114,India
206985,2023-12-30,714,carbon paper,15,30,15,1,00252,India
524677,2023-12-30,716,printing paper,200,400,200,1,00031,India
524677,2023-12-30,710,geometry box,100,150,50,1,00031,India
660204,2023-12-30,704,scale,5,10,5,1,00139,India
660204,2023-12-30,710,geometry box,100,150,50,1,00139,India
660204,2023-12-30,703,eraser,1,3,2,1,00139,India
660204,2023-12-30,705,stencil,10,20,10,1,00139,India
159374,2023-12-30,709,notebook,30,60,30,1,00173,India
159374,2023-12-30,710,geometry box,100,150,50,1,00173,India
159374,2023-12-30,705,stencil,10,20,10,1,00173,India
159374,2023-12-30,703,eraser,1,3,2,1,00173,India
103762,2023-12-30,715,folder,5,15,10,1,00221,India
103762,2023-12-30,713,ball pen,5,10,5,1,00221,India
103762,2023-12-30,716,printing paper,200,400,200,1,00221,India
103762,2023-12-30,702,pencil,2,5,3,1,00221,India
103762,2023-12-30,706,sharpener,3,8,5,1,00221,India
924830,2023-12-30,715,folder,5,15,10,1,00170,India
924830,2023-12-30,713,ball pen,5,10,5,1,00170,India
924830,2023-12-30,701,gel pen,5,10,5,1,00170,India
924830,2023-12-30,705,stencil,10,20,10,1,00170,India
487952,2023-12-30,702,pencil,2,5,3,1,00390,India
487952,2023-12-30,713,ball pen,5,10,5,1,00390,India
578469,2023-12-30,711,TD kit,150,300,150,1,00377,India
578469,2023-12-30,701,gel pen,5,10,5,1,00377,India
578469,2023-12-30,714,carbon paper,15,30,15,1,00377,India
922828,2023-12-30,711,TD kit,150,300,150,1,00086,India
922828,2023-12-30,707,marker,20,40,20,1,00086,India
922828,2023-12-30,704,scale,5,10,5,1,00086,India
695421,2023-12-30,716,printing paper,200,400,200,1,00306,India
350022,2023-12-30,705,stencil,10,20,10,1,00173,India
350022,2023-12-30,704,scale,5,10,5,1,00173,India
350022,2023-12-30,716,printing paper,200,400,200,1,00173,India
350022,2023-12-30,709,notebook,30,60,30,1,00173,India
522083,2023-12-30,710,geometry box,100,150,50,1,00033,India
522083,2023-12-30,707,marker,20,40,20,1,00033,India
522083,2023-12-30,706,sharpener,3,8,5,1,00033,India
522083,2023-12-30,704,scale,5,10,5,1,00033,India
529297,2023-12-30,705,stencil,10,20,10,1,00284,India
338234,2023-12-30,713,ball pen,5,10,5,1,00258,India
338234,2023-12-30,701,gel pen,5,10,5,1,00258,India
913105,2023-12-30,707,marker,20,40,20,1,00167,India
913105,2023-12-30,716,printing paper,200,400,200,1,00167,India
913105,2023-12-30,717,spiral bound book,50,100,50,1,00167,India
717368,2023-12-30,713,ball pen,5,10,5,1,00238,India
717368,2023-12-30,706,sharpener,3,8,5,1,00238,India
177182,2023-12-30,712,graph paper,20,40,20,1,00424,India
177182,2023-12-30,704,scale,5,10,5,1,00424,India
177182,2023-12-30,715,folder,5,15,10,1,00424,India
177182,2023-12-30,703,eraser,1,3,2,1,00424,India
549772,2023-12-30,703,eraser,1,3,2,1,00229,India
289199,2023-12-30,711,TD kit,150,300,150,1,00110,India
566495,2023-12-30,714,carbon paper,15,30,15,1,00067,India
566495,2023-12-30,701,gel pen,5,10,5,1,00067,India
732602,2023-12-30,713,ball pen,5,10,5,1,00442,India
732602,2023-12-30,701,gel pen,5,10,5,1,00442,India
732602,2023-12-30,711,TD kit,150,300,150,1,00442,India
108439,2023-12-30,715,folder,5,15,10,1,00262,India
663001,2023-12-30,701,gel pen,5,10,5,1,00437,India
663001,2023-12-30,711,TD kit,150,300,150,1,00437,India
388309,2023-12-30,710,geometry box,100,150,50,1,00106,India
388309,2023-12-30,708,sketchpen,15,40,25,1,00106,India
388309,2023-12-30,711,TD kit,150,300,150,1,00106,India
388309,2023-12-30,716,printing paper,200,400,200,1,00106,India
590733,2023-12-30,702,pencil,2,5,3,1,00348,India
590733,2023-12-30,711,TD kit,150,300,150,1,00348,India
565547,2023-12-30,715,folder,5,15,10,1,00014,India
565547,2023-12-30,709,notebook,30,60,30,1,00014,India
315778,2023-12-30,717,spiral bound book,50,100,50,1,00444,India
315778,2023-12-30,704,scale,5,10,5,1,00444,India
315778,2023-12-30,708,sketchpen,15,40,25,1,00444,India
315778,2023-12-30,709,notebook,30,60,30,1,00444,India
737601,2023-12-30,704,scale,5,10,5,1,00394,India
737601,2023-12-30,717,spiral bound book,50,100,50,1,00394,India
523053,2023-12-30,709,notebook,30,60,30,1,00148,India
523053,2023-12-30,710,geometry box,100,150,50,1,00148,India
523053,2023-12-30,703,eraser,1,3,2,1,00148,India
941933,2023-12-30,712,graph paper,20,40,20,1,00160,India
941933,2023-12-30,713,ball pen,5,10,5,1,00160,India
941933,2023-12-30,704,scale,5,10,5,1,00160,India
941933,2023-12-30,705,stencil,10,20,10,1,00160,India
206865,2023-12-30,705,stencil,10,20,10,1,00018,India
206865,2023-12-30,709,notebook,30,60,30,1,00018,India
206865,2023-12-30,707,marker,20,40,20,1,00018,India
206865,2023-12-30,715,folder,5,15,10,1,00018,India
206865,2023-12-30,711,TD kit,150,300,150,1,00018,India
481716,2023-12-30,715,folder,5,15,10,1,00401,India
481716,2023-12-30,712,graph paper,20,40,20,1,00401,India
481716,2023-12-30,705,stencil,10,20,10,1,00401,India
481716,2023-12-30,711,TD kit,150,300,150,1,00401,India
782610,2023-12-30,714,carbon paper,15,30,15,1,00033,India
782610,2023-12-30,703,eraser,1,3,2,1,00033,India
782610,2023-12-30,717,spiral bound book,50,100,50,1,00033,India
782610,2023-12-30,713,ball pen,5,10,5,1,00033,India
782610,2023-12-30,716,printing paper,200,400,200,1,00033,India
185610,2023-12-30,707,marker,20,40,20,1,00262,India
749976,2023-12-30,717,spiral bound book,50,100,50,1,00279,India
749976,2023-12-30,704,scale,5,10,5,1,00279,India
749976,2023-12-30,711,TD kit,150,300,150,1,00279,India
749976,2023-12-30,701,gel pen,5,10,5,1,00279,India
968033,2023-12-31,706,sharpener,3,8,5,1,00465,India
968033,2023-12-31,710,geometry box,100,150,50,1,00465,India
968033,2023-12-31,711,TD kit,150,300,150,1,00465,India
169673,2023-12-31,710,geometry box,100,150,50,1,00335,India
169673,2023-12-31,705,stencil,10,20,10,1,00335,India
169673,2023-12-31,703,eraser,1,3,2,1,00335,India
169673,2023-12-31,713,ball pen,5,10,5,1,00335,India
152771,2023-12-31,714,carbon paper,15,30,15,1,00037,India
152771,2023-12-31,708,sketchpen,15,40,25,1,00037,India
152771,2023-12-31,709,notebook,30,60,30,1,00037,India
152771,2023-12-31,707,marker,20,40,20,1,00037,India
152771,2023-12-31,706,sharpener,3,8,5,1,00037,India
269994,2023-12-31,708,sketchpen,15,40,25,1,00103,India
269994,2023-12-31,706,sharpener,3,8,5,1,00103,India
269994,2023-12-31,703,eraser,1,3,2,1,00103,India
269994,2023-12-31,701,gel pen,5,10,5,1,00103,India
367199,2023-12-31,709,notebook,30,60,30,1,00368,India
367199,2023-12-31,715,folder,5,15,10,1,00368,India
367199,2023-12-31,716,printing paper,200,400,200,1,00368,India
675480,2023-12-31,713,ball pen,5,10,5,1,00274,India
675480,2023-12-31,709,notebook,30,60,30,1,00274,India
675480,2023-12-31,712,graph paper,20,40,20,1,00274,India
683162,2023-12-31,712,graph paper,20,40,20,1,00137,India
683162,2023-12-31,701,gel pen,5,10,5,1,00137,India
954796,2023-12-31,706,sharpener,3,8,5,1,00278,India
954796,2023-12-31,717,spiral bound book,50,100,50,1,00278,India
954796,2023-12-31,702,pencil,2,5,3,1,00278,India
954796,2023-12-31,708,sketchpen,15,40,25,1,00278,India
926565,2023-12-31,709,notebook,30,60,30,1,00082,India
699017,2023-12-31,714,carbon paper,15,30,15,1,00165,India
699017,2023-12-31,707,marker,20,40,20,1,00165,India
699017,2023-12-31,705,stencil,10,20,10,1,00165,India
152156,2023-12-31,706,sharpener,3,8,5,1,00016,India
152156,2023-12-31,717,spiral bound book,50,100,50,1,00016,India
992489,2023-12-31,709,notebook,30,60,30,1,00305,India
992489,2023-12-31,714,carbon paper,15,30,15,1,00305,India
992489,2023-12-31,703,eraser,1,3,2,1,00305,India
611789,2023-12-31,717,spiral bound book,50,100,50,1,00497,India
611789,2023-12-31,706,sharpener,3,8,5,1,00497,India
611789,2023-12-31,707,marker,20,40,20,1,00497,India
263997,2023-12-31,716,printing paper,200,400,200,1,00111,India
263997,2023-12-31,711,TD kit,150,300,150,1,00111,India
263997,2023-12-31,703,eraser,1,3,2,1,00111,India
263997,2023-12-31,707,marker,20,40,20,1,00111,India
432657,2023-12-31,704,scale,5,10,5,1,00212,India
432657,2023-12-31,708,sketchpen,15,40,25,1,00212,India
900476,2023-12-31,713,ball pen,5,10,5,1,00389,India
900476,2023-12-31,717,spiral bound book,50,100,50,1,00389,India
221150,2023-12-31,705,stencil,10,20,10,1,00324,India
221150,2023-12-31,703,eraser,1,3,2,1,00324,India
221150,2023-12-31,710,geometry box,100,150,50,1,00324,India
221150,2023-12-31,701,gel pen,5,10,5,1,00324,India
457632,2023-12-31,712,graph paper,20,40,20,1,00227,India
259214,2023-12-31,708,sketchpen,15,40,25,1,00327,India
259214,2023-12-31,701,gel pen,5,10,5,1,00327,India
427707,2023-12-31,713,ball pen,5,10,5,1,00348,India
427707,2023-12-31,712,graph paper,20,40,20,1,00348,India
427707,2023-12-31,707,marker,20,40,20,1,00348,India
427707,2023-12-31,706,sharpener,3,8,5,1,00348,India
619460,2023-12-31,704,scale,5,10,5,1,00240,India
619460,2023-12-31,701,gel pen,5,10,5,1,00240,India
619460,2023-12-31,714,carbon paper,15,30,15,1,00240,India
810927,2023-12-31,713,ball pen,5,10,5,1,00459,India
810927,2023-12-31,708,sketchpen,15,40,25,1,00459,India
810927,2023-12-31,710,geometry box,100,150,50,1,00459,India
563162,2023-12-31,707,marker,20,40,20,1,00210,India
563162,2023-12-31,701,gel pen,5,10,5,1,00210,India
563162,2023-12-31,702,pencil,2,5,3,1,00210,India
563162,2023-12-31,713,ball pen,5,10,5,1,00210,India
927481,2023-12-31,705,stencil,10,20,10,1,00146,India
927481,2023-12-31,704,scale,5,10,5,1,00146,India
927481,2023-12-31,702,pencil,2,5,3,1,00146,India
927481,2023-12-31,708,sketchpen,15,40,25,1,00146,India
927481,2023-12-31,716,printing paper,200,400,200,1,00146,India
362617,2023-12-31,717,spiral bound book,50,100,50,1,00186,India
362617,2023-12-31,705,stencil,10,20,10,1,00186,India
362617,2023-12-31,714,carbon paper,15,30,15,1,00186,India
253983,2023-12-31,711,TD kit,150,300,150,1,00467,India
253983,2023-12-31,708,sketchpen,15,40,25,1,00467,India
253983,2023-12-31,710,geometry box,100,150,50,1,00467,India
686933,2023-12-31,703,eraser,1,3,2,1,00090,India
686933,2023-12-31,708,sketchpen,15,40,25,1,00090,India
686933,2023-12-31,705,stencil,10,20,10,1,00090,India
686933,2023-12-31,707,marker,20,40,20,1,00090,India
324059,2023-12-31,717,spiral bound book,50,100,50,1,00452,India
324059,2023-12-31,716,printing paper,200,400,200,1,00452,India
589182,2023-12-31,709,notebook,30,60,30,1,00219,India
589182,2023-12-31,706,sharpener,3,8,5,1,00219,India
589182,2023-12-31,703,eraser,1,3,2,1,00219,India
814058,2023-12-31,706,sharpener,3,8,5,1,00379,India
814058,2023-12-31,704,scale,5,10,5,1,00379,India
814058,2023-12-31,710,geometry box,100,150,50,1,00379,India
814058,2023-12-31,714,carbon paper,15,30,15,1,00379,India
814058,2023-12-31,709,notebook,30,60,30,1,00379,India
659143,2023-12-31,715,folder,5,15,10,1,00274,India
659143,2023-12-31,708,sketchpen,15,40,25,1,00274,India
659143,2023-12-31,702,pencil,2,5,3,1,00274,India
641559,2023-12-31,701,gel pen,5,10,5,1,00395,India
289113,2023-12-31,715,folder,5,15,10,1,00394,India
289113,2023-12-31,702,pencil,2,5,3,1,00394,India
930554,2024-01-01,710,geometry box,100,150,50,1,00412,India
194785,2024-01-01,706,sharpener,3,8,5,1,00054,India
194785,2024-01-01,701,gel pen,5,10,5,1,00054,India
194785,2024-01-01,703,eraser,1,3,2,1,00054,India
629436,2024-01-01,706,sharpener,3,8,5,1,00198,India
629436,2024-01-01,704,scale,5,10,5,1,00198,India
629436,2024-01-01,715,folder,5,15,10,1,00198,India
629436,2024-01-01,716,printing paper,200,400,200,1,00198,India
629436,2024-01-01,713,ball pen,5,10,5,1,00198,India
417169,2024-01-01,711,TD kit,150,300,150,1,00345,India
471139,2024-01-01,712,graph paper,20,40,20,1,00456,India
471139,2024-01-01,715,folder,5,15,10,1,00456,India
471139,2024-01-01,717,spiral bound book,50,100,50,1,00456,India
749900,2024-01-01,706,sharpener,3,8,5,1,00248,India
378762,2024-01-01,706,sharpener,3,8,5,1,00210,India
667599,2024-01-01,707,marker,20,40,20,1,00350,India
531335,2024-01-01,712,graph paper,20,40,20,1,00486,India
531335,2024-01-01,714,carbon paper,15,30,15,1,00486,India
162876,2024-01-01,703,eraser,1,3,2,1,00303,India
162876,2024-01-01,704,scale,5,10,5,1,00303,India
162876,2024-01-01,707,marker,20,40,20,1,00303,India
162876,2024-01-01,709,notebook,30,60,30,1,00303,India
162876,2024-01-01,701,gel pen,5,10,5,1,00303,India
133629,2024-01-01,704,scale,5,10,5,1,00197,India
133629,2024-01-01,703,eraser,1,3,2,1,00197,India
133629,2024-01-01,701,gel pen,5,10,5,1,00197,India
133629,2024-01-01,713,ball pen,5,10,5,1,00197,India
112116,2024-01-01,704,scale,5,10,5,1,00093,India
112116,2024-01-01,710,geometry box,100,150,50,1,00093,India
426288,2024-01-01,710,geometry box,100,150,50,1,00235,India
513616,2024-01-01,710,geometry box,100,150,50,1,00243,India
513616,2024-01-01,714,carbon paper,15,30,15,1,00243,India
185986,2024-01-01,707,marker,20,40,20,1,00314,India
185986,2024-01-01,703,eraser,1,3,2,1,00314,India
185986,2024-01-01,705,stencil,10,20,10,1,00314,India
182705,2024-01-01,702,pencil,2,5,3,1,00345,India
182705,2024-01-01,715,folder,5,15,10,1,00345,India
182705,2024-01-01,714,carbon paper,15,30,15,1,00345,India
182705,2024-01-01,717,spiral bound book,50,100,50,1,00345,India
182705,2024-01-01,705,stencil,10,20,10,1,00345,India
826685,2024-01-01,712,graph paper,20,40,20,1,00159,India
826685,2024-01-01,705,stencil,10,20,10,1,00159,India
826685,2024-01-01,708,sketchpen,15,40,25,1,00159,India
174598,2024-01-01,715,folder,5,15,10,1,00064,India
174598,2024-01-01,705,stencil,10,20,10,1,00064,India
174598,2024-01-01,716,printing paper,200,400,200,1,00064,India
263622,2024-01-01,711,TD kit,150,300,150,1,00049,India
242515,2024-01-01,707,marker,20,40,20,1,00091,India
242515,2024-01-01,706,sharpener,3,8,5,1,00091,India
242515,2024-01-01,711,TD kit,150,300,150,1,00091,India
242515,2024-01-01,701,gel pen,5,10,5,1,00091,India
242515,2024-01-01,712,graph paper,20,40,20,1,00091,India
302587,2024-01-01,703,eraser,1,3,2,1,00278,India
302587,2024-01-01,713,ball pen,5,10,5,1,00278,India
183160,2024-01-01,710,geometry box,100,150,50,1,00278,India
183160,2024-01-01,703,eraser,1,3,2,1,00278,India
183160,2024-01-01,713,ball pen,5,10,5,1,00278,India
183160,2024-01-01,702,pencil,2,5,3,1,00278,India
183160,2024-01-01,705,stencil,10,20,10,1,00278,India
889740,2024-01-01,705,stencil,10,20,10,1,00458,India
889740,2024-01-01,701,gel pen,5,10,5,1,00458,India
889740,2024-01-01,707,marker,20,40,20,1,00458,India
220456,2024-01-01,716,printing paper,200,400,200,1,00240,India
220456,2024-01-01,711,TD kit,150,300,150,1,00240,India
220456,2024-01-01,705,stencil,10,20,10,1,00240,India
220456,2024-01-01,717,spiral bound book,50,100,50,1,00240,India
790247,2024-01-01,701,gel pen,5,10,5,1,00267,India
790247,2024-01-01,711,TD kit,150,300,150,1,00267,India
790247,2024-01-01,716,printing paper,200,400,200,1,00267,India
790247,2024-01-01,710,geometry box,100,150,50,1,00267,India
992140,2024-01-01,708,sketchpen,15,40,25,1,00250,India
992140,2024-01-01,701,gel pen,5,10,5,1,00250,India
992140,2024-01-01,707,marker,20,40,20,1,00250,India
133711,2024-01-01,705,stencil,10,20,10,1,00030,India
225646,2024-01-01,707,marker,20,40,20,1,00027,India
225646,2024-01-01,702,pencil,2,5,3,1,00027,India
225646,2024-01-01,708,sketchpen,15,40,25,1,00027,India
225646,2024-01-01,701,gel pen,5,10,5,1,00027,India
964645,2024-01-01,701,gel pen,5,10,5,1,00142,India
964645,2024-01-01,705,stencil,10,20,10,1,00142,India
964645,2024-01-01,712,graph paper,20,40,20,1,00142,India
188000,2024-01-01,707,marker,20,40,20,1,00043,India
188000,2024-01-01,706,sharpener,3,8,5,1,00043,India
188000,2024-01-01,716,printing paper,200,400,200,1,00043,India
568914,2024-01-01,706,sharpener,3,8,5,1,00420,India
647188,2024-01-01,712,graph paper,20,40,20,1,00078,India
647188,2024-01-01,714,carbon paper,15,30,15,1,00078,India
647188,2024-01-01,709,notebook,30,60,30,1,00078,India
647188,2024-01-01,715,folder,5,15,10,1,00078,India
376065,2024-01-01,706,sharpener,3,8,5,1,00302,India
376065,2024-01-01,715,folder,5,15,10,1,00302,India
376065,2024-01-01,707,marker,20,40,20,1,00302,India
288013,2024-01-01,705,stencil,10,20,10,1,00225,India
288013,2024-01-01,702,pencil,2,5,3,1,00225,India
288013,2024-01-01,701,gel pen,5,10,5,1,00225,India
288013,2024-01-01,715,folder,5,15,10,1,00225,India
358288,2024-01-02,710,geometry box,100,150,50,1,00499,India
358288,2024-01-02,711,TD kit,150,300,150,1,00499,India
358288,2024-01-02,712,graph paper,20,40,20,1,00499,India
358288,2024-01-02,714,carbon paper,15,30,15,1,00499,India
382186,2024-01-02,709,notebook,30,60,30,1,00445,India
382186,2024-01-02,714,carbon paper,15,30,15,1,00445,India
382186,2024-01-02,705,stencil,10,20,10,1,00445,India
382186,2024-01-02,712,graph paper,20,40,20,1,00445,India
283709,2024-01-02,717,spiral bound book,50,100,50,1,00226,India
283709,2024-01-02,708,sketchpen,15,40,25,1,00226,India
283709,2024-01-02,713,ball pen,5,10,5,1,00226,India
335993,2024-01-02,710,geometry box,100,150,50,1,00406,India
335993,2024-01-02,711,TD kit,150,300,150,1,00406,India
335993,2024-01-02,702,pencil,2,5,3,1,00406,India
750234,2024-01-02,715,folder,5,15,10,1,00240,India
750234,2024-01-02,711,TD kit,150,300,150,1,00240,India
750234,2024-01-02,717,spiral bound book,50,100,50,1,00240,India
750234,2024-01-02,706,sharpener,3,8,5,1,00240,India
750234,2024-01-02,714,carbon paper,15,30,15,1,00240,India
966476,2024-01-02,702,pencil,2,5,3,1,00368,India
966476,2024-01-02,710,geometry box,100,150,50,1,00368,India
966476,2024-01-02,703,eraser,1,3,2,1,00368,India
778839,2024-01-02,710,geometry box,100,150,50,1,00096,India
778839,2024-01-02,715,folder,5,15,10,1,00096,India
778839,2024-01-02,703,eraser,1,3,2,1,00096,India
778839,2024-01-02,709,notebook,30,60,30,1,00096,India
778839,2024-01-02,712,graph paper,20,40,20,1,00096,India
341395,2024-01-02,706,sharpener,3,8,5,1,00068,India
341395,2024-01-02,712,graph paper,20,40,20,1,00068,India
341395,2024-01-02,702,pencil,2,5,3,1,00068,India
796214,2024-01-02,706,sharpener,3,8,5,1,00159,India
892278,2024-01-02,714,carbon paper,15,30,15,1,00198,India
892278,2024-01-02,713,ball pen,5,10,5,1,00198,India
892278,2024-01-02,715,folder,5,15,10,1,00198,India
892278,2024-01-02,703,eraser,1,3,2,1,00198,India
814677,2024-01-02,707,marker,20,40,20,1,00035,India
814677,2024-01-02,706,sharpener,3,8,5,1,00035,India
814677,2024-01-02,701,gel pen,5,10,5,1,00035,India
622666,2024-01-02,702,pencil,2,5,3,1,00325,India
622666,2024-01-02,712,graph paper,20,40,20,1,00325,India
622666,2024-01-02,717,spiral bound book,50,100,50,1,00325,India
622666,2024-01-02,715,folder,5,15,10,1,00325,India
265092,2024-01-02,705,stencil,10,20,10,1,00182,India
564587,2024-01-02,717,spiral bound book,50,100,50,1,00372,India
992741,2024-01-02,708,sketchpen,15,40,25,1,00401,India
992741,2024-01-02,706,sharpener,3,8,5,1,00401,India
992741,2024-01-02,711,TD kit,150,300,150,1,00401,India
992741,2024-01-02,704,scale,5,10,5,1,00401,India
992741,2024-01-02,709,notebook,30,60,30,1,00401,India
266112,2024-01-02,704,scale,5,10,5,1,00485,India
266112,2024-01-02,701,gel pen,5,10,5,1,00485,India
266112,2024-01-02,712,graph paper,20,40,20,1,00485,India
218756,2024-01-02,709,notebook,30,60,30,1,00238,India
218756,2024-01-02,717,spiral bound book,50,100,50,1,00238,India
218756,2024-01-02,710,geometry box,100,150,50,1,00238,India
218756,2024-01-02,716,printing paper,200,400,200,1,00238,India
218756,2024-01-02,714,carbon paper,15,30,15,1,00238,India
782735,2024-01-02,706,sharpener,3,8,5,1,00437,India
266027,2024-01-02,710,geometry box,100,150,50,1,00025,India
905126,2024-01-02,715,folder,5,15,10,1,00459,India
905126,2024-01-02,713,ball pen,5,10,5,1,00459,India
905126,2024-01-02,708,sketchpen,15,40,25,1,00459,India
806966,2024-01-02,712,graph paper,20,40,20,1,00381,India
806966,2024-01-02,708,sketchpen,15,40,25,1,00381,India
806966,2024-01-02,707,marker,20,40,20,1,00381,India
806966,2024-01-02,711,TD kit,150,300,150,1,00381,India
806966,2024-01-02,701,gel pen,5,10,5,1,00381,India
334879,2024-01-02,707,marker,20,40,20,1,00430,India
334879,2024-01-02,701,gel pen,5,10,5,1,00430,India
668973,2024-01-02,702,pencil,2,5,3,1,00413,India
285158,2024-01-02,714,carbon paper,15,30,15,1,00166,India
674150,2024-01-02,707,marker,20,40,20,1,00368,India
674150,2024-01-02,703,eraser,1,3,2,1,00368,India
320451,2024-01-02,709,notebook,30,60,30,1,00071,India
676453,2024-01-02,712,graph paper,20,40,20,1,00025,India
676453,2024-01-02,715,folder,5,15,10,1,00025,India
676453,2024-01-02,706,sharpener,3,8,5,1,00025,India
676453,2024-01-02,701,gel pen,5,10,5,1,00025,India
921880,2024-01-02,716,printing paper,200,400,200,1,00388,India
921880,2024-01-02,706,sharpener,3,8,5,1,00388,India
325841,2024-01-02,715,folder,5,15,10,1,00418,India
325841,2024-01-02,709,notebook,30,60,30,1,00418,India
325841,2024-01-02,704,scale,5,10,5,1,00418,India
592700,2024-01-02,705,stencil,10,20,10,1,00074,India
592700,2024-01-02,710,geometry box,100,150,50,1,00074,India
592700,2024-01-02,716,printing paper,200,400,200,1,00074,India
598286,2024-01-02,717,spiral bound book,50,100,50,1,00125,India
598286,2024-01-02,712,graph paper,20,40,20,1,00125,India
598286,2024-01-02,708,sketchpen,15,40,25,1,00125,India
598286,2024-01-02,716,printing paper,200,400,200,1,00125,India
435252,2024-01-02,710,geometry box,100,150,50,1,00108,India
435252,2024-01-02,706,sharpener,3,8,5,1,00108,India
435252,2024-01-02,712,graph paper,20,40,20,1,00108,India
435252,2024-01-02,715,folder,5,15,10,1,00108,India
435252,2024-01-02,711,TD kit,150,300,150,1,00108,India
902736,2024-01-02,708,sketchpen,15,40,25,1,00153,India
685353,2024-01-02,710,geometry box,100,150,50,1,00427,India
685353,2024-01-02,717,spiral bound book,50,100,50,1,00427,India
685353,2024-01-02,715,folder,5,15,10,1,00427,India
685353,2024-01-02,709,notebook,30,60,30,1,00427,India
362744,2024-01-02,704,scale,5,10,5,1,00469,India
362744,2024-01-02,705,stencil,10,20,10,1,00469,India
362744,2024-01-02,715,folder,5,15,10,1,00469,India
945511,2024-01-02,703,eraser,1,3,2,1,00116,India
945511,2024-01-02,708,sketchpen,15,40,25,1,00116,India
582732,2024-01-02,711,TD kit,150,300,150,1,00281,India
582732,2024-01-02,707,marker,20,40,20,1,00281,India
431804,2024-01-02,710,geometry box,100,150,50,1,00416,India
431804,2024-01-02,716,printing paper,200,400,200,1,00416,India
609418,2024-01-03,703,eraser,1,3,2,1,00337,India
131876,2024-01-03,707,marker,20,40,20,1,00364,India
131876,2024-01-03,714,carbon paper,15,30,15,1,00364,India
131876,2024-01-03,710,geometry box,100,150,50,1,00364,India
279245,2024-01-03,706,sharpener,3,8,5,1,00373,India
279245,2024-01-03,705,stencil,10,20,10,1,00373,India
279245,2024-01-03,703,eraser,1,3,2,1,00373,India
279245,2024-01-03,717,spiral bound book,50,100,50,1,00373,India
884415,2024-01-03,711,TD kit,150,300,150,1,00214,India
884415,2024-01-03,710,geometry box,100,150,50,1,00214,India
884415,2024-01-03,714,carbon paper,15,30,15,1,00214,India
884415,2024-01-03,705,stencil,10,20,10,1,00214,India
552226,2024-01-03,701,gel pen,5,10,5,1,00076,India
552226,2024-01-03,708,sketchpen,15,40,25,1,00076,India
552226,2024-01-03,709,notebook,30,60,30,1,00076,India
498125,2024-01-03,707,marker,20,40,20,1,00493,India
835552,2024-01-03,706,sharpener,3,8,5,1,00304,India
835552,2024-01-03,717,spiral bound book,50,100,50,1,00304,India
307355,2024-01-03,703,eraser,1,3,2,1,00312,India
307355,2024-01-03,711,TD kit,150,300,150,1,00312,India
307355,2024-01-03,713,ball pen,5,10,5,1,00312,India
307355,2024-01-03,707,marker,20,40,20,1,00312,India
154947,2024-01-03,713,ball pen,5,10,5,1,00082,India
154947,2024-01-03,708,sketchpen,15,40,25,1,00082,India
381939,2024-01-03,708,sketchpen,15,40,25,1,00468,India
381939,2024-01-03,706,sharpener,3,8,5,1,00468,India
381939,2024-01-03,710,geometry box,100,150,50,1,00468,India
381939,2024-01-03,715,folder,5,15,10,1,00468,India
939784,2024-01-03,715,folder,5,15,10,1,00069,India
939784,2024-01-03,701,gel pen,5,10,5,1,00069,India
939784,2024-01-03,713,ball pen,5,10,5,1,00069,India
729413,2024-01-03,708,sketchpen,15,40,25,1,00454,India
729413,2024-01-03,706,sharpener,3,8,5,1,00454,India
729413,2024-01-03,715,folder,5,15,10,1,00454,India
729413,2024-01-03,711,TD kit,150,300,150,1,00454,India
915835,2024-01-03,705,stencil,10,20,10,1,00138,India
915835,2024-01-03,710,geometry box,100,150,50,1,00138,India
697783,2024-01-03,711,TD kit,150,300,150,1,00017,India
697783,2024-01-03,713,ball pen,5,10,5,1,00017,India
697783,2024-01-03,714,carbon paper,15,30,15,1,00017,India
697783,2024-01-03,705,stencil,10,20,10,1,00017,India
697783,2024-01-03,703,eraser,1,3,2,1,00017,India
995026,2024-01-03,709,notebook,30,60,30,1,00184,India
995026,2024-01-03,717,spiral bound book,50,100,50,1,00184,India
995026,2024-01-03,705,stencil,10,20,10,1,00184,India
995026,2024-01-03,714,carbon paper,15,30,15,1,00184,India
337102,2024-01-03,711,TD kit,150,300,150,1,00275,India
663725,2024-01-03,710,geometry box,100,150,50,1,00020,India
663725,2024-01-03,705,stencil,10,20,10,1,00020,India
475347,2024-01-03,714,carbon paper,15,30,15,1,00137,India
475347,2024-01-03,707,marker,20,40,20,1,00137,India
475347,2024-01-03,708,sketchpen,15,40,25,1,00137,India
943389,2024-01-03,704,scale,5,10,5,1,00149,India
462516,2024-01-03,710,geometry box,100,150,50,1,00491,India
462516,2024-01-03,716,printing paper,200,400,200,1,00491,India
983679,2024-01-03,701,gel pen,5,10,5,1,00024,India
983679,2024-01-03,710,geometry box,100,150,50,1,00024,India
862555,2024-01-03,707,marker,20,40,20,1,00055,India
926199,2024-01-03,713,ball pen,5,10,5,1,00078,India
276674,2024-01-03,711,TD kit,150,300,150,1,00264,India
276674,2024-01-03,704,scale,5,10,5,1,00264,India
909750,2024-01-03,708,sketchpen,15,40,25,1,00109,India
909750,2024-01-03,714,carbon paper,15,30,15,1,00109,India
909750,2024-01-03,707,marker,20,40,20,1,00109,India
201855,2024-01-03,715,folder,5,15,10,1,00432,India
201855,2024-01-03,708,sketchpen,15,40,25,1,00432,India
201855,2024-01-03,710,geometry box,100,150,50,1,00432,India
944358,2024-01-03,709,notebook,30,60,30,1,00147,India
944358,2024-01-03,702,pencil,2,5,3,1,00147,India
944358,2024-01-03,712,graph paper,20,40,20,1,00147,India
944358,2024-01-03,711,TD kit,150,300,150,1,00147,India
944358,2024-01-03,716,printing paper,200,400,200,1,00147,India
417318,2024-01-03,712,graph paper,20,40,20,1,00125,India
417318,2024-01-03,701,gel pen,5,10,5,1,00125,India
857309,2024-01-03,708,sketchpen,15,40,25,1,00487,India
857309,2024-01-03,713,ball pen,5,10,5,1,00487,India
857309,2024-01-03,717,spiral bound book,50,100,50,1,00487,India
857309,2024-01-03,715,folder,5,15,10,1,00487,India
521326,2024-01-03,705,stencil,10,20,10,1,00125,India
521326,2024-01-03,709,notebook,30,60,30,1,00125,India
521326,2024-01-03,703,eraser,1,3,2,1,00125,India
521326,2024-01-03,707,marker,20,40,20,1,00125,India
968508,2024-01-03,716,printing paper,200,400,200,1,00093,India
968508,2024-01-03,701,gel pen,5,10,5,1,00093,India
968508,2024-01-03,710,geometry box,100,150,50,1,00093,India
968508,2024-01-03,704,scale,5,10,5,1,00093,India
968508,2024-01-03,715,folder,5,15,10,1,00093,India
866100,2024-01-03,712,graph paper,20,40,20,1,00202,India
866100,2024-01-03,708,sketchpen,15,40,25,1,00202,India
866100,2024-01-03,711,TD kit,150,300,150,1,00202,India
866100,2024-01-03,709,notebook,30,60,30,1,00202,India
866100,2024-01-03,716,printing paper,200,400,200,1,00202,India
869884,2024-01-03,704,scale,5,10,5,1,00235,India
869884,2024-01-03,710,geometry box,100,150,50,1,00235,India
869884,2024-01-03,706,sharpener,3,8,5,1,00235,India
869884,2024-01-03,707,marker,20,40,20,1,00235,India
617851,2024-01-03,702,pencil,2,5,3,1,00328,India
617851,2024-01-03,712,graph paper,20,40,20,1,00328,India
617851,2024-01-03,714,carbon paper,15,30,15,1,00328,India
617851,2024-01-03,709,notebook,30,60,30,1,00328,India
541791,2024-01-03,711,TD kit,150,300,150,1,00332,India
541791,2024-01-03,716,printing paper,200,400,200,1,00332,India
541791,2024-01-03,712,graph paper,20,40,20,1,00332,India
973033,2024-01-03,713,ball pen,5,10,5,1,00381,India
973033,2024-01-03,702,pencil,2,5,3,1,00381,India
973033,2024-01-03,707,marker,20,40,20,1,00381,India
922607,2024-01-04,716,printing paper,200,400,200,1,00262,India
922607,2024-01-04,715,folder,5,15,10,1,00262,India
922607,2024-01-04,714,carbon paper,15,30,15,1,00262,India
922607,2024-01-04,705,stencil,10,20,10,1,00262,India
922607,2024-01-04,704,scale,5,10,5,1,00262,India
395836,2024-01-04,702,pencil,2,5,3,1,00455,India
395836,2024-01-04,715,folder,5,15,10,1,00455,India
395836,2024-01-04,706,sharpener,3,8,5,1,00455,India
395836,2024-01-04,707,marker,20,40,20,1,00455,India
395836,2024-01-04,716,printing paper,200,400,200,1,00455,India
444585,2024-01-04,707,marker,20,40,20,1,00117,India
444585,2024-01-04,713,ball pen,5,10,5,1,00117,India
444585,2024-01-04,708,sketchpen,15,40,25,1,00117,India
611289,2024-01-04,716,printing paper,200,400,200,1,00401,India
905378,2024-01-04,701,gel pen,5,10,5,1,00009,India
883187,2024-01-04,708,sketchpen,15,40,25,1,00153,India
883187,2024-01-04,717,spiral bound book,50,100,50,1,00153,India
883187,2024-01-04,711,TD kit,150,300,150,1,00153,India
224944,2024-01-04,717,spiral bound book,50,100,50,1,00361,India
224944,2024-01-04,712,graph paper,20,40,20,1,00361,India
224944,2024-01-04,702,pencil,2,5,3,1,00361,India
704953,2024-01-04,707,marker,20,40,20,1,00254,India
704953,2024-01-04,705,stencil,10,20,10,1,00254,India
950820,2024-01-04,716,printing paper,200,400,200,1,00227,India
950820,2024-01-04,701,gel pen,5,10,5,1,00227,India
950820,2024-01-04,704,scale,5,10,5,1,00227,India
557119,2024-01-04,713,ball pen,5,10,5,1,00372,India
557119,2024-01-04,712,graph paper,20,40,20,1,00372,India
252451,2024-01-04,707,marker,20,40,20,1,00204,India
252451,2024-01-04,704,scale,5,10,5,1,00204,India
252451,2024-01-04,703,eraser,1,3,2,1,00204,India
252451,2024-01-04,716,printing paper,200,400,200,1,00204,India
761706,2024-01-04,712,graph paper,20,40,20,1,00452,India
761706,2024-01-04,706,sharpener,3,8,5,1,00452,India
638365,2024-01-04,710,geometry box,100,150,50,1,00444,India
638365,2024-01-04,713,ball pen,5,10,5,1,00444,India
638365,2024-01-04,714,carbon paper,15,30,15,1,00444,India
638365,2024-01-04,705,stencil,10,20,10,1,00444,India
638365,2024-01-04,701,gel pen,5,10,5,1,00444,India
247443,2024-01-04,711,TD kit,150,300,150,1,00068,India
247443,2024-01-04,715,folder,5,15,10,1,00068,India
247443,2024-01-04,701,gel pen,5,10,5,1,00068,India
593852,2024-01-04,701,gel pen,5,10,5,1,00473,India
593852,2024-01-04,712,graph paper,20,40,20,1,00473,India
593852,2024-01-04,707,marker,20,40,20,1,00473,India
593852,2024-01-04,716,printing paper,200,400,200,1,00473,India
457262,2024-01-04,716,printing paper,200,400,200,1,00453,India
457262,2024-01-04,701,gel pen,5,10,5,1,00453,India
457262,2024-01-04,709,notebook,30,60,30,1,00453,India
457262,2024-01-04,711,TD kit,150,300,150,1,00453,India
984884,2024-01-04,711,TD kit,150,300,150,1,00162,India
984884,2024-01-04,714,carbon paper,15,30,15,1,00162,India
477004,2024-01-04,703,eraser,1,3,2,1,00060,India
477004,2024-01-04,701,gel pen,5,10,5,1,00060,India
477004,2024-01-04,709,notebook,30,60,30,1,00060,India
477004,2024-01-04,710,geometry box,100,150,50,1,00060,India
665011,2024-01-04,709,notebook,30,60,30,1,00193,India
665011,2024-01-04,715,folder,5,15,10,1,00193,India
665011,2024-01-04,710,geometry box,100,150,50,1,00193,India
665011,2024-01-04,702,pencil,2,5,3,1,00193,India
129922,2024-01-04,716,printing paper,200,400,200,1,00365,India
474479,2024-01-04,701,gel pen,5,10,5,1,00377,India
474479,2024-01-04,703,eraser,1,3,2,1,00377,India
474479,2024-01-04,716,printing paper,200,400,200,1,00377,India
474479,2024-01-04,715,folder,5,15,10,1,00377,India
724791,2024-01-04,708,sketchpen,15,40,25,1,00056,India
724791,2024-01-04,706,sharpener,3,8,5,1,00056,India
749028,2024-01-04,708,sketchpen,15,40,25,1,00431,India
749028,2024-01-04,701,gel pen,5,10,5,1,00431,India
130704,2024-01-04,702,pencil,2,5,3,1,00130,India
554449,2024-01-04,707,marker,20,40,20,1,00475,India
395397,2024-01-04,702,pencil,2,5,3,1,00358,India
395397,2024-01-04,717,spiral bound book,50,100,50,1,00358,India
395397,2024-01-04,711,TD kit,150,300,150,1,00358,India
395397,2024-01-04,709,notebook,30,60,30,1,00358,India
395397,2024-01-04,714,carbon paper,15,30,15,1,00358,India
143223,2024-01-04,717,spiral bound book,50,100,50,1,00066,India
143223,2024-01-04,707,marker,20,40,20,1,00066,India
578087,2024-01-04,714,carbon paper,15,30,15,1,00119,India
578087,2024-01-04,703,eraser,1,3,2,1,00119,India
578087,2024-01-04,717,spiral bound book,50,100,50,1,00119,India
172172,2024-01-04,702,pencil,2,5,3,1,00420,India
172172,2024-01-04,714,carbon paper,15,30,15,1,00420,India
172172,2024-01-04,704,scale,5,10,5,1,00420,India
172172,2024-01-04,707,marker,20,40,20,1,00420,India
172172,2024-01-04,710,geometry box,100,150,50,1,00420,India
203078,2024-01-04,704,scale,5,10,5,1,00189,India
203078,2024-01-04,713,ball pen,5,10,5,1,00189,India
203078,2024-01-04,710,geometry box,100,150,50,1,00189,India
717578,2024-01-04,714,carbon paper,15,30,15,1,00238,India
717578,2024-01-04,713,ball pen,5,10,5,1,00238,India
717578,2024-01-04,711,TD kit,150,300,150,1,00238,India
717578,2024-01-04,710,geometry box,100,150,50,1,00238,India
230477,2024-01-04,716,printing paper,200,400,200,1,00398,India
743742,2024-01-04,713,ball pen,5,10,5,1,00229,India
743742,2024-01-04,707,marker,20,40,20,1,00229,India
743742,2024-01-04,701,gel pen,5,10,5,1,00229,India
940984,2024-01-05,713,ball pen,5,10,5,1,00280,India
940984,2024-01-05,702,pencil,2,5,3,1,00280,India
940984,2024-01-05,703,eraser,1,3,2,1,00280,India
711440,2024-01-05,713,ball pen,5,10,5,1,00091,India
711440,2024-01-05,704,scale,5,10,5,1,00091,India
711440,2024-01-05,703,eraser,1,3,2,1,00091,India
140733,2024-01-05,716,printing paper,200,400,200,1,00497,India
140733,2024-01-05,709,notebook,30,60,30,1,00497,India
140733,2024-01-05,715,folder,5,15,10,1,00497,India
140733,2024-01-05,706,sharpener,3,8,5,1,00497,India
140733,2024-01-05,703,eraser,1,3,2,1,00497,India
463497,2024-01-05,709,notebook,30,60,30,1,00246,India
463497,2024-01-05,711,TD kit,150,300,150,1,00246,India
463497,2024-01-05,715,folder,5,15,10,1,00246,India
463497,2024-01-05,717,spiral bound book,50,100,50,1,00246,India
444446,2024-01-05,703,eraser,1,3,2,1,00096,India
444446,2024-01-05,702,pencil,2,5,3,1,00096,India
929277,2024-01-05,716,printing paper,200,400,200,1,00132,India
929277,2024-01-05,712,graph paper,20,40,20,1,00132,India
929277,2024-01-05,715,folder,5,15,10,1,00132,India
718651,2024-01-05,703,eraser,1,3,2,1,00455,India
718651,2024-01-05,708,sketchpen,15,40,25,1,00455,India
903736,2024-01-05,704,scale,5,10,5,1,00051,India
903736,2024-01-05,702,pencil,2,5,3,1,00051,India
903736,2024-01-05,712,graph paper,20,40,20,1,00051,India
903736,2024-01-05,709,notebook,30,60,30,1,00051,India
579857,2024-01-05,708,sketchpen,15,40,25,1,00340,India
579857,2024-01-05,715,folder,5,15,10,1,00340,India
579857,2024-01-05,706,sharpener,3,8,5,1,00340,India
579857,2024-01-05,707,marker,20,40,20,1,00340,India
604014,2024-01-05,716,printing paper,200,400,200,1,00307,India
604014,2024-01-05,711,TD kit,150,300,150,1,00307,India
604014,2024-01-05,701,gel pen,5,10,5,1,00307,India
604014,2024-01-05,703,eraser,1,3,2,1,00307,India
604014,2024-01-05,706,sharpener,3,8,5,1,00307,India
490225,2024-01-05,702,pencil,2,5,3,1,00340,India
490225,2024-01-05,709,notebook,30,60,30,1,00340,India
490225,2024-01-05,710,geometry box,100,150,50,1,00340,India
490225,2024-01-05,703,eraser,1,3,2,1,00340,India
490225,2024-01-05,704,scale,5,10,5,1,00340,India
653666,2024-01-05,708,sketchpen,15,40,25,1,00166,India
653666,2024-01-05,710,geometry box,100,150,50,1,00166,India
653666,2024-01-05,707,marker,20,40,20,1,00166,India
653666,2024-01-05,716,printing paper,200,400,200,1,00166,India
653666,2024-01-05,713,ball pen,5,10,5,1,00166,India
415490,2024-01-05,713,ball pen,5,10,5,1,00480,India
415490,2024-01-05,712,graph paper,20,40,20,1,00480,India
602665,2024-01-05,707,marker,20,40,20,1,00486,India
772554,2024-01-05,711,TD kit,150,300,150,1,00269,India
772554,2024-01-05,701,gel pen,5,10,5,1,00269,India
772554,2024-01-05,710,geometry box,100,150,50,1,00269,India
772554,2024-01-05,714,carbon paper,15,30,15,1,00269,India
612746,2024-01-05,707,marker,20,40,20,1,00060,India
203512,2024-01-05,712,graph paper,20,40,20,1,00443,India
203512,2024-01-05,716,printing paper,200,400,200,1,00443,India
853566,2024-01-05,706,sharpener,3,8,5,1,00442,India
853566,2024-01-05,716,printing paper,200,400,200,1,00442,India
853566,2024-01-05,712,graph paper,20,40,20,1,00442,India
853566,2024-01-05,708,sketchpen,15,40,25,1,00442,India
856492,2024-01-05,702,pencil,2,5,3,1,00373,India
856492,2024-01-05,706,sharpener,3,8,5,1,00373,India
856492,2024-01-05,701,gel pen,5,10,5,1,00373,India
856492,2024-01-05,714,carbon paper,15,30,15,1,00373,India
772246,2024-01-05,711,TD kit,150,300,150,1,00199,India
772246,2024-01-05,702,pencil,2,5,3,1,00199,India
772246,2024-01-05,712,graph paper,20,40,20,1,00199,India
772246,2024-01-05,714,carbon paper,15,30,15,1,00199,India
772246,2024-01-05,713,ball pen,5,10,5,1,00199,India
236575,2024-01-05,715,folder,5,15,10,1,00167,India
236575,2024-01-05,707,marker,20,40,20,1,00167,India
386631,2024-01-05,715,folder,5,15,10,1,00392,India
386631,2024-01-05,703,eraser,1,3,2,1,00392,India
386631,2024-01-05,707,marker,20,40,20,1,00392,India
895223,2024-01-05,702,pencil,2,5,3,1,00378,India
467198,2024-01-05,712,graph paper,20,40,20,1,00326,India
467198,2024-01-05,702,pencil,2,5,3,1,00326,India
467198,2024-01-05,707,marker,20,40,20,1,00326,India
936556,2024-01-05,705,stencil,10,20,10,1,00163,India
936556,2024-01-05,706,sharpener,3,8,5,1,00163,India
936556,2024-01-05,711,TD kit,150,300,150,1,00163,India
936556,2024-01-05,704,scale,5,10,5,1,00163,India
933660,2024-01-05,716,printing paper,200,400,200,1,00442,India
933660,2024-01-05,704,scale,5,10,5,1,00442,India
933660,2024-01-05,701,gel pen,5,10,5,1,00442,India
933660,2024-01-05,711,TD kit,150,300,150,1,00442,India
699279,2024-01-05,709,notebook,30,60,30,1,00169,India
699279,2024-01-05,713,ball pen,5,10,5,1,00169,India
699279,2024-01-05,703,eraser,1,3,2,1,00169,India
455334,2024-01-05,715,folder,5,15,10,1,00079,India
455334,2024-01-05,707,marker,20,40,20,1,00079,India
455334,2024-01-05,706,sharpener,3,8,5,1,00079,India
942397,2024-01-05,713,ball pen,5,10,5,1,00123,India
942397,2024-01-05,710,geometry box,100,150,50,1,00123,India
942397,2024-01-05,706,sharpener,3,8,5,1,00123,India
942397,2024-01-05,716,printing paper,200,400,200,1,00123,India
624250,2024-01-05,705,stencil,10,20,10,1,00130,India
624250,2024-01-05,714,carbon paper,15,30,15,1,00130,India
624250,2024-01-05,707,marker,20,40,20,1,00130,India
276958,2024-01-05,710,geometry box,100,150,50,1,00248,India
276958,2024-01-05,705,stencil,10,20,10,1,00248,India
992402,2024-01-05,702,pencil,2,5,3,1,00265,India
992402,2024-01-05,706,sharpener,3,8,5,1,00265,India
992402,2024-01-05,715,folder,5,15,10,1,00265,India
617040,2024-01-05,705,stencil,10,20,10,1,00284,India
617040,2024-01-05,709,notebook,30,60,30,1,00284,India
617040,2024-01-05,710,geometry box,100,150,50,1,00284,India
886847,2024-01-05,706,sharpener,3,8,5,1,00465,India
886847,2024-01-05,713,ball pen,5,10,5,1,00465,India
886847,2024-01-05,703,eraser,1,3,2,1,00465,India
128612,2024-01-05,710,geometry box,100,150,50,1,00176,India
636943,2024-01-05,716,printing paper,200,400,200,1,00157,India
636943,2024-01-05,710,geometry box,100,150,50,1,00157,India
636943,2024-01-05,709,notebook,30,60,30,1,00157,India
904126,2024-01-05,704,scale,5,10,5,1,00094,India
904126,2024-01-05,716,printing paper,200,400,200,1,00094,India
199907,2024-01-05,703,eraser,1,3,2,1,00437,India
199907,2024-01-05,701,gel pen,5,10,5,1,00437,India
199907,2024-01-05,708,sketchpen,15,40,25,1,00437,India
199907,2024-01-05,716,printing paper,200,400,200,1,00437,India
199907,2024-01-05,714,carbon paper,15,30,15,1,00437,India
711381,2024-01-06,702,pencil,2,5,3,1,00145,India
711381,2024-01-06,717,spiral bound book,50,100,50,1,00145,India
711381,2024-01-06,715,folder,5,15,10,1,00145,India
711381,2024-01-06,704,scale,5,10,5,1,00145,India
711381,2024-01-06,706,sharpener,3,8,5,1,00145,India
949840,2024-01-06,703,eraser,1,3,2,1,00118,India
949840,2024-01-06,712,graph paper,20,40,20,1,00118,India
949840,2024-01-06,706,sharpener,3,8,5,1,00118,India
949840,2024-01-06,710,geometry box,100,150,50,1,00118,India
445643,2024-01-06,715,folder,5,15,10,1,00449,India
874057,2024-01-06,714,carbon paper,15,30,15,1,00051,India
874057,2024-01-06,704,scale,5,10,5,1,00051,India
874057,2024-01-06,707,marker,20,40,20,1,00051,India
874057,2024-01-06,701,gel pen,5,10,5,1,00051,India
532091,2024-01-06,717,spiral bound book,50,100,50,1,00187,India
532091,2024-01-06,710,geometry box,100,150,50,1,00187,India
912502,2024-01-06,708,sketchpen,15,40,25,1,00184,India
912502,2024-01-06,709,notebook,30,60,30,1,00184,India
243509,2024-01-06,701,gel pen,5,10,5,1,00115,India
497988,2024-01-06,712,graph paper,20,40,20,1,00241,India
497988,2024-01-06,707,marker,20,40,20,1,00241,India
497988,2024-01-06,709,notebook,30,60,30,1,00241,India
497988,2024-01-06,713,ball pen,5,10,5,1,00241,India
253225,2024-01-06,704,scale,5,10,5,1,00194,India
253225,2024-01-06,711,TD kit,150,300,150,1,00194,India
253225,2024-01-06,707,marker,20,40,20,1,00194,India
789652,2024-01-06,704,scale,5,10,5,1,00193,India
789652,2024-01-06,708,sketchpen,15,40,25,1,00193,India
789652,2024-01-06,703,eraser,1,3,2,1,00193,India
434832,2024-01-06,705,stencil,10,20,10,1,00454,India
250188,2024-01-06,709,notebook,30,60,30,1,00401,India
367950,2024-01-06,701,gel pen,5,10,5,1,00362,India
367950,2024-01-06,708,sketchpen,15,40,25,1,00362,India
930748,2024-01-06,703,eraser,1,3,2,1,00219,India
930748,2024-01-06,702,pencil,2,5,3,1,00219,India
930748,2024-01-06,713,ball pen,5,10,5,1,00219,India
930748,2024-01-06,710,geometry box,100,150,50,1,00219,India
978571,2024-01-06,708,sketchpen,15,40,25,1,00273,India
978571,2024-01-06,702,pencil,2,5,3,1,00273,India
534949,2024-01-06,701,gel pen,5,10,5,1,00373,India
534949,2024-01-06,702,pencil,2,5,3,1,00373,India
343842,2024-01-06,703,eraser,1,3,2,1,00039,India
343842,2024-01-06,710,geometry box,100,150,50,1,00039,India
343842,2024-01-06,706,sharpener,3,8,5,1,00039,India
343842,2024-01-06,714,carbon paper,15,30,15,1,00039,India
498738,2024-01-06,716,printing paper,200,400,200,1,00307,India
498738,2024-01-06,703,eraser,1,3,2,1,00307,India
498738,2024-01-06,714,carbon paper,15,30,15,1,00307,India
498738,2024-01-06,717,spiral bound book,50,100,50,1,00307,India
498738,2024-01-06,707,marker,20,40,20,1,00307,India
197151,2024-01-06,707,marker,20,40,20,1,00145,India
197151,2024-01-06,705,stencil,10,20,10,1,00145,India
197151,2024-01-06,709,notebook,30,60,30,1,00145,India
960288,2024-01-06,715,folder,5,15,10,1,00049,India
960288,2024-01-06,708,sketchpen,15,40,25,1,00049,India
960288,2024-01-06,703,eraser,1,3,2,1,00049,India
719593,2024-01-06,710,geometry box,100,150,50,1,00454,India
719593,2024-01-06,707,marker,20,40,20,1,00454,India
719593,2024-01-06,705,stencil,10,20,10,1,00454,India
719593,2024-01-06,702,pencil,2,5,3,1,00454,India
266791,2024-01-06,716,printing paper,200,400,200,1,00224,India
266791,2024-01-06,708,sketchpen,15,40,25,1,00224,India
266791,2024-01-06,714,carbon paper,15,30,15,1,00224,India
839592,2024-01-06,702,pencil,2,5,3,1,00071,India
839592,2024-01-06,711,TD kit,150,300,150,1,00071,India
839592,2024-01-06,716,printing paper,200,400,200,1,00071,India
839592,2024-01-06,714,carbon paper,15,30,15,1,00071,India
839592,2024-01-06,705,stencil,10,20,10,1,00071,India
384534,2024-01-06,707,marker,20,40,20,1,00064,India
384534,2024-01-06,706,sharpener,3,8,5,1,00064,India
642097,2024-01-06,712,graph paper,20,40,20,1,00237,India
642097,2024-01-06,709,notebook,30,60,30,1,00237,India
642097,2024-01-06,705,stencil,10,20,10,1,00237,India
427342,2024-01-06,713,ball pen,5,10,5,1,00194,India
427342,2024-01-06,712,graph paper,20,40,20,1,00194,India
101902,2024-01-06,714,carbon paper,15,30,15,1,00465,India
876119,2024-01-06,709,notebook,30,60,30,1,00180,India
876119,2024-01-06,712,graph paper,20,40,20,1,00180,India
876119,2024-01-06,701,gel pen,5,10,5,1,00180,India
284791,2024-01-06,705,stencil,10,20,10,1,00115,India
906665,2024-01-06,709,notebook,30,60,30,1,00112,India
869631,2024-01-06,714,carbon paper,15,30,15,1,00332,India
735078,2024-01-06,712,graph paper,20,40,20,1,00468,India
267106,2024-01-06,714,carbon paper,15,30,15,1,00212,India
267106,2024-01-06,713,ball pen,5,10,5,1,00212,India
267106,2024-01-06,704,scale,5,10,5,1,00212,India
309910,2024-01-06,705,stencil,10,20,10,1,00242,India
236772,2024-01-06,710,geometry box,100,150,50,1,00431,India
719997,2024-01-06,715,folder,5,15,10,1,00312,India
719997,2024-01-06,710,geometry box,100,150,50,1,00312,India
719997,2024-01-06,704,scale,5,10,5,1,00312,India
856434,2024-01-06,709,notebook,30,60,30,1,00259,India
944413,2024-01-06,706,sharpener,3,8,5,1,00312,India
944413,2024-01-06,705,stencil,10,20,10,1,00312,India
944413,2024-01-06,707,marker,20,40,20,1,00312,India
944413,2024-01-06,703,eraser,1,3,2,1,00312,India
573651,2024-01-06,711,TD kit,150,300,150,1,00104,India
573651,2024-01-06,713,ball pen,5,10,5,1,00104,India
573651,2024-01-06,714,carbon paper,15,30,15,1,00104,India
555659,2024-01-06,707,marker,20,40,20,1,00119,India
555659,2024-01-06,717,spiral bound book,50,100,50,1,00119,India
555659,2024-01-06,704,scale,5,10,5,1,00119,India
555659,2024-01-06,708,sketchpen,15,40,25,1,00119,India
160345,2024-01-06,714,carbon paper,15,30,15,1,00041,India
160345,2024-01-06,708,sketchpen,15,40,25,1,00041,India
160345,2024-01-06,701,gel pen,5,10,5,1,00041,India
160345,2024-01-06,702,pencil,2,5,3,1,00041,India
136808,2024-01-06,708,sketchpen,15,40,25,1,00155,India
136808,2024-01-06,705,stencil,10,20,10,1,00155,India
136808,2024-01-06,717,spiral bound book,50,100,50,1,00155,India
136808,2024-01-06,711,TD kit,150,300,150,1,00155,India
664166,2024-01-06,714,carbon paper,15,30,15,1,00203,India
664166,2024-01-06,701,gel pen,5,10,5,1,00203,India
428324,2024-01-06,702,pencil,2,5,3,1,00463,India
428324,2024-01-06,712,graph paper,20,40,20,1,00463,India
727633,2024-01-06,716,printing paper,200,400,200,1,00070,India
727633,2024-01-06,715,folder,5,15,10,1,00070,India
727633,2024-01-06,706,sharpener,3,8,5,1,00070,India
404638,2024-01-06,706,sharpener,3,8,5,1,00199,India
404638,2024-01-06,717,spiral bound book,50,100,50,1,00199,India
404638,2024-01-06,709,notebook,30,60,30,1,00199,India
265788,2024-01-06,713,ball pen,5,10,5,1,00482,India
265788,2024-01-06,717,spiral bound book,50,100,50,1,00482,India
265788,2024-01-06,714,carbon paper,15,30,15,1,00482,India
740749,2024-01-06,711,TD kit,150,300,150,1,00193,India
862003,2024-01-06,706,sharpener,3,8,5,1,00341,India
862003,2024-01-06,702,pencil,2,5,3,1,00341,India
862003,2024-01-06,716,printing paper,200,400,200,1,00341,India
982835,2024-01-06,704,scale,5,10,5,1,00295,India
783019,2024-01-07,714,carbon paper,15,30,15,1,00366,India
554769,2024-01-07,717,spiral bound book,50,100,50,1,00269,India
554769,2024-01-07,709,notebook,30,60,30,1,00269,India
422146,2024-01-07,715,folder,5,15,10,1,00244,India
422146,2024-01-07,709,notebook,30,60,30,1,00244,India
685952,2024-01-07,717,spiral bound book,50,100,50,1,00127,India
298826,2024-01-07,702,pencil,2,5,3,1,00310,India
298826,2024-01-07,708,sketchpen,15,40,25,1,00310,India
298826,2024-01-07,713,ball pen,5,10,5,1,00310,India
725611,2024-01-07,714,carbon paper,15,30,15,1,00095,India
725611,2024-01-07,704,scale,5,10,5,1,00095,India
725611,2024-01-07,717,spiral bound book,50,100,50,1,00095,India
725611,2024-01-07,702,pencil,2,5,3,1,00095,India
342414,2024-01-07,716,printing paper,200,400,200,1,00205,India
342414,2024-01-07,709,notebook,30,60,30,1,00205,India
342414,2024-01-07,702,pencil,2,5,3,1,00205,India
226983,2024-01-07,714,carbon paper,15,30,15,1,00298,India
226983,2024-01-07,711,TD kit,150,300,150,1,00298,India
989965,2024-01-07,702,pencil,2,5,3,1,00446,India
426991,2024-01-07,717,spiral bound book,50,100,50,1,00135,India
426991,2024-01-07,709,notebook,30,60,30,1,00135,India
426991,2024-01-07,704,scale,5,10,5,1,00135,India
426991,2024-01-07,711,TD kit,150,300,150,1,00135,India
279061,2024-01-07,710,geometry box,100,150,50,1,00003,India
279061,2024-01-07,709,notebook,30,60,30,1,00003,India
279061,2024-01-07,717,spiral bound book,50,100,50,1,00003,India
231021,2024-01-07,715,folder,5,15,10,1,00323,India
231021,2024-01-07,710,geometry box,100,150,50,1,00323,India
231021,2024-01-07,702,pencil,2,5,3,1,00323,India
231021,2024-01-07,707,marker,20,40,20,1,00323,India
231021,2024-01-07,701,gel pen,5,10,5,1,00323,India
887646,2024-01-07,705,stencil,10,20,10,1,00434,India
887646,2024-01-07,706,sharpener,3,8,5,1,00434,India
887646,2024-01-07,709,notebook,30,60,30,1,00434,India
887646,2024-01-07,712,graph paper,20,40,20,1,00434,India
887646,2024-01-07,703,eraser,1,3,2,1,00434,India
794769,2024-01-07,711,TD kit,150,300,150,1,00432,India
462665,2024-01-07,705,stencil,10,20,10,1,00429,India
462665,2024-01-07,706,sharpener,3,8,5,1,00429,India
462665,2024-01-07,701,gel pen,5,10,5,1,00429,India
462665,2024-01-07,714,carbon paper,15,30,15,1,00429,India
462665,2024-01-07,709,notebook,30,60,30,1,00429,India
599177,2024-01-07,711,TD kit,150,300,150,1,00417,India
599177,2024-01-07,713,ball pen,5,10,5,1,00417,India
773546,2024-01-07,717,spiral bound book,50,100,50,1,00302,India
773546,2024-01-07,713,ball pen,5,10,5,1,00302,India
773546,2024-01-07,706,sharpener,3,8,5,1,00302,India
773546,2024-01-07,705,stencil,10,20,10,1,00302,India
952034,2024-01-07,715,folder,5,15,10,1,00010,India
952034,2024-01-07,705,stencil,10,20,10,1,00010,India
952034,2024-01-07,702,pencil,2,5,3,1,00010,India
952034,2024-01-07,701,gel pen,5,10,5,1,00010,India
578334,2024-01-07,704,scale,5,10,5,1,00174,India
578334,2024-01-07,715,folder,5,15,10,1,00174,India
578334,2024-01-07,709,notebook,30,60,30,1,00174,India
578334,2024-01-07,714,carbon paper,15,30,15,1,00174,India
578334,2024-01-07,706,sharpener,3,8,5,1,00174,India
411113,2024-01-07,706,sharpener,3,8,5,1,00397,India
411113,2024-01-07,717,spiral bound book,50,100,50,1,00397,India
411113,2024-01-07,708,sketchpen,15,40,25,1,00397,India
411113,2024-01-07,707,marker,20,40,20,1,00397,India
432174,2024-01-07,714,carbon paper,15,30,15,1,00341,India
432174,2024-01-07,715,folder,5,15,10,1,00341,India
432174,2024-01-07,703,eraser,1,3,2,1,00341,India
432174,2024-01-07,706,sharpener,3,8,5,1,00341,India
432174,2024-01-07,701,gel pen,5,10,5,1,00341,India
202876,2024-01-07,710,geometry box,100,150,50,1,00300,India
202876,2024-01-07,705,stencil,10,20,10,1,00300,India
202876,2024-01-07,714,carbon paper,15,30,15,1,00300,India
872200,2024-01-07,707,marker,20,40,20,1,00181,India
872200,2024-01-07,710,geometry box,100,150,50,1,00181,India
805718,2024-01-07,703,eraser,1,3,2,1,00430,India
591935,2024-01-07,703,eraser,1,3,2,1,00469,India
591935,2024-01-07,706,sharpener,3,8,5,1,00469,India
983264,2024-01-07,709,notebook,30,60,30,1,00303,India
983264,2024-01-07,714,carbon paper,15,30,15,1,00303,India
983264,2024-01-07,706,sharpener,3,8,5,1,00303,India
983264,2024-01-07,703,eraser,1,3,2,1,00303,India
983264,2024-01-07,702,pencil,2,5,3,1,00303,India
193574,2024-01-07,702,pencil,2,5,3,1,00319,India
574186,2024-01-07,707,marker,20,40,20,1,00145,India
574186,2024-01-07,701,gel pen,5,10,5,1,00145,India
574186,2024-01-07,703,eraser,1,3,2,1,00145,India
574186,2024-01-07,711,TD kit,150,300,150,1,00145,India
925870,2024-01-07,717,spiral bound book,50,100,50,1,00147,India
304086,2024-01-07,716,printing paper,200,400,200,1,00132,India
304086,2024-01-07,709,notebook,30,60,30,1,00132,India
304086,2024-01-07,703,eraser,1,3,2,1,00132,India
326224,2024-01-07,717,spiral bound book,50,100,50,1,00422,India
326224,2024-01-07,704,scale,5,10,5,1,00422,India
326224,2024-01-07,716,printing paper,200,400,200,1,00422,India
326224,2024-01-07,712,graph paper,20,40,20,1,00422,India
412982,2024-01-07,712,graph paper,20,40,20,1,00249,India
412982,2024-01-07,711,TD kit,150,300,150,1,00249,India
412982,2024-01-07,714,carbon paper,15,30,15,1,00249,India
661678,2024-01-07,717,spiral bound book,50,100,50,1,00141,India
661678,2024-01-07,709,notebook,30,60,30,1,00141,India
661678,2024-01-07,711,TD kit,150,300,150,1,00141,India
661678,2024-01-07,702,pencil,2,5,3,1,00141,India
837788,2024-01-07,711,TD kit,150,300,150,1,00216,India
837788,2024-01-07,707,marker,20,40,20,1,00216,India
286124,2024-01-07,701,gel pen,5,10,5,1,00460,India
286124,2024-01-07,702,pencil,2,5,3,1,00460,India
286124,2024-01-07,714,carbon paper,15,30,15,1,00460,India
286124,2024-01-07,707,marker,20,40,20,1,00460,India
286124,2024-01-07,708,sketchpen,15,40,25,1,00460,India
652990,2024-01-07,712,graph paper,20,40,20,1,00035,India
652990,2024-01-07,713,ball pen,5,10,5,1,00035,India
652990,2024-01-07,717,spiral bound book,50,100,50,1,00035,India
652990,2024-01-07,705,stencil,10,20,10,1,00035,India
841320,2024-01-07,704,scale,5,10,5,1,00057,India
841320,2024-01-07,715,folder,5,15,10,1,00057,India
841320,2024-01-07,701,gel pen,5,10,5,1,00057,India
841320,2024-01-07,703,eraser,1,3,2,1,00057,India
111648,2024-01-07,704,scale,5,10,5,1,00176,India
824558,2024-01-08,709,notebook,30,60,30,1,00261,India
824558,2024-01-08,702,pencil,2,5,3,1,00261,India
403897,2024-01-08,705,stencil,10,20,10,1,00349,India
403897,2024-01-08,713,ball pen,5,10,5,1,00349,India
699831,2024-01-08,715,folder,5,15,10,1,00197,India
699831,2024-01-08,709,notebook,30,60,30,1,00197,India
699831,2024-01-08,706,sharpener,3,8,5,1,00197,India
699831,2024-01-08,702,pencil,2,5,3,1,00197,India
810268,2024-01-08,714,carbon paper,15,30,15,1,00186,India
810268,2024-01-08,715,folder,5,15,10,1,00186,India
810268,2024-01-08,717,spiral bound book,50,100,50,1,00186,India
810268,2024-01-08,706,sharpener,3,8,5,1,00186,India
690493,2024-01-08,708,sketchpen,15,40,25,1,00053,India
690493,2024-01-08,711,TD kit,150,300,150,1,00053,India
690493,2024-01-08,714,carbon paper,15,30,15,1,00053,India
690493,2024-01-08,710,geometry box,100,150,50,1,00053,India
690493,2024-01-08,716,printing paper,200,400,200,1,00053,India
203071,2024-01-08,716,printing paper,200,400,200,1,00074,India
436630,2024-01-08,712,graph paper,20,40,20,1,00322,India
436630,2024-01-08,714,carbon paper,15,30,15,1,00322,India
436630,2024-01-08,715,folder,5,15,10,1,00322,India
436630,2024-01-08,716,printing paper,200,400,200,1,00322,India
436630,2024-01-08,705,stencil,10,20,10,1,00322,India
969257,2024-01-08,711,TD kit,150,300,150,1,00122,India
969257,2024-01-08,704,scale,5,10,5,1,00122,India
524983,2024-01-08,705,stencil,10,20,10,1,00006,India
524983,2024-01-08,707,marker,20,40,20,1,00006,India
662629,2024-01-08,709,notebook,30,60,30,1,00066,India
662629,2024-01-08,708,sketchpen,15,40,25,1,00066,India
930637,2024-01-08,706,sharpener,3,8,5,1,00203,India
930637,2024-01-08,717,spiral bound book,50,100,50,1,00203,India
930637,2024-01-08,713,ball pen,5,10,5,1,00203,India
932793,2024-01-08,707,marker,20,40,20,1,00389,India
452653,2024-01-08,705,stencil,10,20,10,1,00259,India
452653,2024-01-08,702,pencil,2,5,3,1,00259,India
452653,2024-01-08,707,marker,20,40,20,1,00259,India
452653,2024-01-08,712,graph paper,20,40,20,1,00259,India
452653,2024-01-08,713,ball pen,5,10,5,1,00259,India
532547,2024-01-08,715,folder,5,15,10,1,00271,India
532547,2024-01-08,705,stencil,10,20,10,1,00271,India
532547,2024-01-08,717,spiral bound book,50,100,50,1,00271,India
452121,2024-01-08,701,gel pen,5,10,5,1,00011,India
452121,2024-01-08,702,pencil,2,5,3,1,00011,India
724439,2024-01-08,708,sketchpen,15,40,25,1,00314,India
724439,2024-01-08,716,printing paper,200,400,200,1,00314,India
724439,2024-01-08,704,scale,5,10,5,1,00314,India
724439,2024-01-08,703,eraser,1,3,2,1,00314,India
724439,2024-01-08,709,notebook,30,60,30,1,00314,India
889254,2024-01-08,713,ball pen,5,10,5,1,00246,India
889254,2024-01-08,711,TD kit,150,300,150,1,00246,India
889254,2024-01-08,710,geometry box,100,150,50,1,00246,India
868532,2024-01-08,714,carbon paper,15,30,15,1,00203,India
868532,2024-01-08,710,geometry box,100,150,50,1,00203,India
868532,2024-01-08,713,ball pen,5,10,5,1,00203,India
868532,2024-01-08,709,notebook,30,60,30,1,00203,India
483060,2024-01-08,705,stencil,10,20,10,1,00356,India
483060,2024-01-08,702,pencil,2,5,3,1,00356,India
483060,2024-01-08,717,spiral bound book,50,100,50,1,00356,India
483060,2024-01-08,712,graph paper,20,40,20,1,00356,India
730761,2024-01-08,713,ball pen,5,10,5,1,00032,India
667045,2024-01-08,704,scale,5,10,5,1,00212,India
667045,2024-01-08,705,stencil,10,20,10,1,00212,India
667045,2024-01-08,702,pencil,2,5,3,1,00212,India
667045,2024-01-08,713,ball pen,5,10,5,1,00212,India
247695,2024-01-08,715,folder,5,15,10,1,00232,India
729647,2024-01-08,709,notebook,30,60,30,1,00300,India
729647,2024-01-08,711,TD kit,150,300,150,1,00300,India
718673,2024-01-08,704,scale,5,10,5,1,00439,India
718673,2024-01-08,714,carbon paper,15,30,15,1,00439,India
718673,2024-01-08,715,folder,5,15,10,1,00439,India
828454,2024-01-08,704,scale,5,10,5,1,00091,India
431272,2024-01-08,717,spiral bound book,50,100,50,1,00356,India
431272,2024-01-08,709,notebook,30,60,30,1,00356,India
431272,2024-01-08,707,marker,20,40,20,1,00356,India
431272,2024-01-08,703,eraser,1,3,2,1,00356,India
431272,2024-01-08,708,sketchpen,15,40,25,1,00356,India
956240,2024-01-08,706,sharpener,3,8,5,1,00174,India
956240,2024-01-08,716,printing paper,200,400,200,1,00174,India
448021,2024-01-08,702,pencil,2,5,3,1,00039,India
448021,2024-01-08,709,notebook,30,60,30,1,00039,India
448021,2024-01-08,705,stencil,10,20,10,1,00039,India
308160,2024-01-08,711,TD kit,150,300,150,1,00141,India
856169,2024-01-08,708,sketchpen,15,40,25,1,00445,India
802609,2024-01-08,704,scale,5,10,5,1,00099,India
866563,2024-01-08,706,sharpener,3,8,5,1,00318,India
866563,2024-01-08,703,eraser,1,3,2,1,00318,India
866563,2024-01-08,712,graph paper,20,40,20,1,00318,India
866563,2024-01-08,711,TD kit,150,300,150,1,00318,India
115893,2024-01-08,711,TD kit,150,300,150,1,00486,India
115893,2024-01-08,708,sketchpen,15,40,25,1,00486,India
311848,2024-01-08,702,pencil,2,5,3,1,00079,India
311848,2024-01-08,711,TD kit,150,300,150,1,00079,India
311848,2024-01-08,701,gel pen,5,10,5,1,00079,India
311848,2024-01-08,708,sketchpen,15,40,25,1,00079,India
651501,2024-01-08,704,scale,5,10,5,1,00062,India
651501,2024-01-08,705,stencil,10,20,10,1,00062,India
651501,2024-01-08,713,ball pen,5,10,5,1,00062,India
651501,2024-01-08,714,carbon paper,15,30,15,1,00062,India
950377,2024-01-08,715,folder,5,15,10,1,00040,India
936368,2024-01-08,712,graph paper,20,40,20,1,00029,India
936368,2024-01-08,701,gel pen,5,10,5,1,00029,India
107398,2024-01-08,702,pencil,2,5,3,1,00431,India
107398,2024-01-08,705,stencil,10,20,10,1,00431,India
107398,2024-01-08,717,spiral bound book,50,100,50,1,00431,India
384819,2024-01-08,701,gel pen,5,10,5,1,00217,India
384819,2024-01-08,717,spiral bound book,50,100,50,1,00217,India
384819,2024-01-08,705,stencil,10,20,10,1,00217,India
384819,2024-01-08,708,sketchpen,15,40,25,1,00217,India
562131,2024-01-08,703,eraser,1,3,2,1,00170,India
471469,2024-01-08,705,stencil,10,20,10,1,00385,India
471469,2024-01-08,701,gel pen,5,10,5,1,00385,India
471469,2024-01-08,704,scale,5,10,5,1,00385,India
471469,2024-01-08,710,geometry box,100,150,50,1,00385,India
471469,2024-01-08,708,sketchpen,15,40,25,1,00385,India
524989,2024-01-08,715,folder,5,15,10,1,00263,India
524989,2024-01-08,705,stencil,10,20,10,1,00263,India
524989,2024-01-08,710,geometry box,100,150,50,1,00263,India
529509,2024-01-08,701,gel pen,5,10,5,1,00038,India
529509,2024-01-08,715,folder,5,15,10,1,00038,India
529509,2024-01-08,704,scale,5,10,5,1,00038,India
874309,2024-01-08,705,stencil,10,20,10,1,00401,India
874309,2024-01-08,708,sketchpen,15,40,25,1,00401,India
874309,2024-01-08,716,printing paper,200,400,200,1,00401,India
874309,2024-01-08,707,marker,20,40,20,1,00401,India
489758,2024-01-08,714,carbon paper,15,30,15,1,00381,India
489758,2024-01-08,711,TD kit,150,300,150,1,00381,India
489758,2024-01-08,712,graph paper,20,40,20,1,00381,India
489758,2024-01-08,701,gel pen,5,10,5,1,00381,India
489758,2024-01-08,705,stencil,10,20,10,1,00381,India
924841,2024-01-09,714,carbon paper,15,30,15,1,00391,India
924841,2024-01-09,716,printing paper,200,400,200,1,00391,India
924841,2024-01-09,705,stencil,10,20,10,1,00391,India
924841,2024-01-09,704,scale,5,10,5,1,00391,India
696161,2024-01-09,704,scale,5,10,5,1,00136,India
696161,2024-01-09,711,TD kit,150,300,150,1,00136,India
513309,2024-01-09,714,carbon paper,15,30,15,1,00060,India
513309,2024-01-09,712,graph paper,20,40,20,1,00060,India
513309,2024-01-09,715,folder,5,15,10,1,00060,India
513309,2024-01-09,703,eraser,1,3,2,1,00060,India
322901,2024-01-09,707,marker,20,40,20,1,00094,India
322901,2024-01-09,712,graph paper,20,40,20,1,00094,India
252617,2024-01-09,712,graph paper,20,40,20,1,00336,India
252617,2024-01-09,704,scale,5,10,5,1,00336,India
198343,2024-01-09,709,notebook,30,60,30,1,00177,India
198343,2024-01-09,707,marker,20,40,20,1,00177,India
161542,2024-01-09,709,notebook,30,60,30,1,00216,India
161542,2024-01-09,715,folder,5,15,10,1,00216,India
161542,2024-01-09,716,printing paper,200,400,200,1,00216,India
783008,2024-01-09,704,scale,5,10,5,1,00008,India
783008,2024-01-09,708,sketchpen,15,40,25,1,00008,India
783008,2024-01-09,714,carbon paper,15,30,15,1,00008,India
668650,2024-01-09,703,eraser,1,3,2,1,00157,India
668650,2024-01-09,710,geometry box,100,150,50,1,00157,India
668650,2024-01-09,715,folder,5,15,10,1,00157,India
159157,2024-01-09,701,gel pen,5,10,5,1,00345,India
159157,2024-01-09,715,folder,5,15,10,1,00345,India
159157,2024-01-09,706,sharpener,3,8,5,1,00345,India
159157,2024-01-09,708,sketchpen,15,40,25,1,00345,India
460890,2024-01-09,710,geometry box,100,150,50,1,00014,India
460890,2024-01-09,709,notebook,30,60,30,1,00014,India
460890,2024-01-09,713,ball pen,5,10,5,1,00014,India
460890,2024-01-09,702,pencil,2,5,3,1,00014,India
460890,2024-01-09,705,stencil,10,20,10,1,00014,India
412235,2024-01-09,711,TD kit,150,300,150,1,00150,India
801320,2024-01-09,713,ball pen,5,10,5,1,00445,India
801320,2024-01-09,711,TD kit,150,300,150,1,00445,India
801320,2024-01-09,704,scale,5,10,5,1,00445,India
801320,2024-01-09,708,sketchpen,15,40,25,1,00445,India
801320,2024-01-09,712,graph paper,20,40,20,1,00445,India
466075,2024-01-09,705,stencil,10,20,10,1,00019,India
466075,2024-01-09,711,TD kit,150,300,150,1,00019,India
466075,2024-01-09,708,sketchpen,15,40,25,1,00019,India
466075,2024-01-09,717,spiral bound book,50,100,50,1,00019,India
466075,2024-01-09,710,geometry box,100,150,50,1,00019,India
725453,2024-01-09,703,eraser,1,3,2,1,00284,India
944231,2024-01-09,709,notebook,30,60,30,1,00215,India
944231,2024-01-09,701,gel pen,5,10,5,1,00215,India
944231,2024-01-09,704,scale,5,10,5,1,00215,India
944231,2024-01-09,715,folder,5,15,10,1,00215,India
648781,2024-01-09,708,sketchpen,15,40,25,1,00150,India
393446,2024-01-09,714,carbon paper,15,30,15,1,00180,India
393446,2024-01-09,705,stencil,10,20,10,1,00180,India
393446,2024-01-09,702,pencil,2,5,3,1,00180,India
938620,2024-01-09,710,geometry box,100,150,50,1,00079,India
938620,2024-01-09,703,eraser,1,3,2,1,00079,India
908411,2024-01-09,706,sharpener,3,8,5,1,00071,India
908411,2024-01-09,707,marker,20,40,20,1,00071,India
908411,2024-01-09,709,notebook,30,60,30,1,00071,India
908411,2024-01-09,714,carbon paper,15,30,15,1,00071,India
908411,2024-01-09,702,pencil,2,5,3,1,00071,India
492159,2024-01-09,709,notebook,30,60,30,1,00498,India
492159,2024-01-09,717,spiral bound book,50,100,50,1,00498,India
492159,2024-01-09,704,scale,5,10,5,1,00498,India
792862,2024-01-09,708,sketchpen,15,40,25,1,00294,India
792862,2024-01-09,706,sharpener,3,8,5,1,00294,India
792862,2024-01-09,703,eraser,1,3,2,1,00294,India
424532,2024-01-09,703,eraser,1,3,2,1,00282,India
424532,2024-01-09,702,pencil,2,5,3,1,00282,India
576126,2024-01-09,716,printing paper,200,400,200,1,00078,India
576126,2024-01-09,708,sketchpen,15,40,25,1,00078,India
576126,2024-01-09,701,gel pen,5,10,5,1,00078,India
632984,2024-01-09,704,scale,5,10,5,1,00424,India
632984,2024-01-09,717,spiral bound book,50,100,50,1,00424,India
632984,2024-01-09,712,graph paper,20,40,20,1,00424,India
837084,2024-01-09,710,geometry box,100,150,50,1,00191,India
837084,2024-01-09,708,sketchpen,15,40,25,1,00191,India
837084,2024-01-09,701,gel pen,5,10,5,1,00191,India
837084,2024-01-09,705,stencil,10,20,10,1,00191,India
837084,2024-01-09,715,folder,5,15,10,1,00191,India
838330,2024-01-09,716,printing paper,200,400,200,1,00102,India
838330,2024-01-09,717,spiral bound book,50,100,50,1,00102,India
838330,2024-01-09,701,gel pen,5,10,5,1,00102,India
316105,2024-01-09,717,spiral bound book,50,100,50,1,00098,India
316105,2024-01-09,709,notebook,30,60,30,1,00098,India
316105,2024-01-09,713,ball pen,5,10,5,1,00098,India
375135,2024-01-09,703,eraser,1,3,2,1,00311,India
375135,2024-01-09,711,TD kit,150,300,150,1,00311,India
375135,2024-01-09,717,spiral bound book,50,100,50,1,00311,India
712139,2024-01-09,714,carbon paper,15,30,15,1,00077,India
712139,2024-01-09,706,sharpener,3,8,5,1,00077,India
712139,2024-01-09,708,sketchpen,15,40,25,1,00077,India
492132,2024-01-09,712,graph paper,20,40,20,1,00161,India
492132,2024-01-09,709,notebook,30,60,30,1,00161,India
450934,2024-01-09,708,sketchpen,15,40,25,1,00195,India
450934,2024-01-09,701,gel pen,5,10,5,1,00195,India
450934,2024-01-09,707,marker,20,40,20,1,00195,India
597276,2024-01-09,715,folder,5,15,10,1,00351,India
597276,2024-01-09,702,pencil,2,5,3,1,00351,India
597276,2024-01-09,701,gel pen,5,10,5,1,00351,India
597276,2024-01-09,716,printing paper,200,400,200,1,00351,India
240848,2024-01-09,706,sharpener,3,8,5,1,00099,India
240848,2024-01-09,716,printing paper,200,400,200,1,00099,India
240848,2024-01-09,712,graph paper,20,40,20,1,00099,India
505254,2024-01-09,710,geometry box,100,150,50,1,00277,India
505254,2024-01-09,715,folder,5,15,10,1,00277,India
505254,2024-01-09,711,TD kit,150,300,150,1,00277,India
194808,2024-01-09,706,sharpener,3,8,5,1,00443,India
728436,2024-01-09,717,spiral bound book,50,100,50,1,00442,India
320805,2024-01-09,701,gel pen,5,10,5,1,00362,India
320805,2024-01-09,709,notebook,30,60,30,1,00362,India
320805,2024-01-09,704,scale,5,10,5,1,00362,India
121774,2024-01-09,702,pencil,2,5,3,1,00277,India
121774,2024-01-09,701,gel pen,5,10,5,1,00277,India
121774,2024-01-09,712,graph paper,20,40,20,1,00277,India
823845,2024-01-09,710,geometry box,100,150,50,1,00399,India
823845,2024-01-09,708,sketchpen,15,40,25,1,00399,India
823845,2024-01-09,711,TD kit,150,300,150,1,00399,India
823845,2024-01-09,717,spiral bound book,50,100,50,1,00399,India
512378,2024-01-09,709,notebook,30,60,30,1,00244,India
512378,2024-01-09,705,stencil,10,20,10,1,00244,India
512378,2024-01-09,703,eraser,1,3,2,1,00244,India
512378,2024-01-09,704,scale,5,10,5,1,00244,India
460914,2024-01-09,703,eraser,1,3,2,1,00140,India
460914,2024-01-09,716,printing paper,200,400,200,1,00140,India
460914,2024-01-09,706,sharpener,3,8,5,1,00140,India
460914,2024-01-09,717,spiral bound book,50,100,50,1,00140,India
485694,2024-01-09,717,spiral bound book,50,100,50,1,00092,India
485694,2024-01-09,708,sketchpen,15,40,25,1,00092,India
485694,2024-01-09,702,pencil,2,5,3,1,00092,India
485694,2024-01-09,711,TD kit,150,300,150,1,00092,India
975805,2024-01-09,716,printing paper,200,400,200,1,00154,India
975805,2024-01-09,710,geometry box,100,150,50,1,00154,India
975805,2024-01-09,714,carbon paper,15,30,15,1,00154,India
128069,2024-01-09,712,graph paper,20,40,20,1,00170,India
128069,2024-01-09,714,carbon paper,15,30,15,1,00170,India
128069,2024-01-09,703,eraser,1,3,2,1,00170,India
128069,2024-01-09,701,gel pen,5,10,5,1,00170,India
473907,2024-01-09,709,notebook,30,60,30,1,00369,India
473907,2024-01-09,703,eraser,1,3,2,1,00369,India
473907,2024-01-09,705,stencil,10,20,10,1,00369,India
342778,2024-01-09,715,folder,5,15,10,1,00413,India
342778,2024-01-09,701,gel pen,5,10,5,1,00413,India
342778,2024-01-09,706,sharpener,3,8,5,1,00413,India
342778,2024-01-09,709,notebook,30,60,30,1,00413,India
335906,2024-01-10,713,ball pen,5,10,5,1,00433,India
883291,2024-01-10,711,TD kit,150,300,150,1,00429,India
883291,2024-01-10,708,sketchpen,15,40,25,1,00429,India
883291,2024-01-10,710,geometry box,100,150,50,1,00429,India
383808,2024-01-10,709,notebook,30,60,30,1,00014,India
383808,2024-01-10,702,pencil,2,5,3,1,00014,India
383808,2024-01-10,711,TD kit,150,300,150,1,00014,India
383808,2024-01-10,707,marker,20,40,20,1,00014,India
710485,2024-01-10,707,marker,20,40,20,1,00036,India
837376,2024-01-10,713,ball pen,5,10,5,1,00492,India
837376,2024-01-10,704,scale,5,10,5,1,00492,India
837376,2024-01-10,708,sketchpen,15,40,25,1,00492,India
288284,2024-01-10,708,sketchpen,15,40,25,1,00360,India
288284,2024-01-10,707,marker,20,40,20,1,00360,India
288284,2024-01-10,705,stencil,10,20,10,1,00360,India
910101,2024-01-10,704,scale,5,10,5,1,00029,India
910101,2024-01-10,702,pencil,2,5,3,1,00029,India
424238,2024-01-10,703,eraser,1,3,2,1,00016,India
424238,2024-01-10,717,spiral bound book,50,100,50,1,00016,India
424238,2024-01-10,707,marker,20,40,20,1,00016,India
424238,2024-01-10,705,stencil,10,20,10,1,00016,India
914909,2024-01-10,710,geometry box,100,150,50,1,00402,India
958246,2024-01-10,713,ball pen,5,10,5,1,00390,India
958246,2024-01-10,702,pencil,2,5,3,1,00390,India
787692,2024-01-10,712,graph paper,20,40,20,1,00441,India
474237,2024-01-10,708,sketchpen,15,40,25,1,00042,India
474237,2024-01-10,709,notebook,30,60,30,1,00042,India
474237,2024-01-10,705,stencil,10,20,10,1,00042,India
762373,2024-01-10,716,printing paper,200,400,200,1,00183,India
762373,2024-01-10,706,sharpener,3,8,5,1,00183,India
152947,2024-01-10,706,sharpener,3,8,5,1,00416,India
577995,2024-01-10,711,TD kit,150,300,150,1,00344,India
577995,2024-01-10,705,stencil,10,20,10,1,00344,India
203700,2024-01-10,717,spiral bound book,50,100,50,1,00138,India
334393,2024-01-10,712,graph paper,20,40,20,1,00138,India
334393,2024-01-10,716,printing paper,200,400,200,1,00138,India
835145,2024-01-10,715,folder,5,15,10,1,00145,India
835145,2024-01-10,707,marker,20,40,20,1,00145,India
835145,2024-01-10,703,eraser,1,3,2,1,00145,India
835145,2024-01-10,713,ball pen,5,10,5,1,00145,India
835145,2024-01-10,716,printing paper,200,400,200,1,00145,India
848660,2024-01-10,701,gel pen,5,10,5,1,00383,India
848660,2024-01-10,704,scale,5,10,5,1,00383,India
411499,2024-01-10,704,scale,5,10,5,1,00270,India
411499,2024-01-10,705,stencil,10,20,10,1,00270,India
380151,2024-01-10,706,sharpener,3,8,5,1,00031,India
400613,2024-01-10,703,eraser,1,3,2,1,00390,India
714648,2024-01-10,710,geometry box,100,150,50,1,00278,India
714648,2024-01-10,704,scale,5,10,5,1,00278,India
714648,2024-01-10,712,graph paper,20,40,20,1,00278,India
714648,2024-01-10,705,stencil,10,20,10,1,00278,India
714648,2024-01-10,703,eraser,1,3,2,1,00278,India
208234,2024-01-10,706,sharpener,3,8,5,1,00448,India
944777,2024-01-10,702,pencil,2,5,3,1,00431,India
944777,2024-01-10,701,gel pen,5,10,5,1,00431,India
944777,2024-01-10,709,notebook,30,60,30,1,00431,India
818820,2024-01-10,714,carbon paper,15,30,15,1,00272,India
818820,2024-01-10,704,scale,5,10,5,1,00272,India
532862,2024-01-10,708,sketchpen,15,40,25,1,00409,India
632528,2024-01-10,717,spiral bound book,50,100,50,1,00129,India
632528,2024-01-10,701,gel pen,5,10,5,1,00129,India
593642,2024-01-10,705,stencil,10,20,10,1,00205,India
112015,2024-01-10,715,folder,5,15,10,1,00044,India
112015,2024-01-10,710,geometry box,100,150,50,1,00044,India
112015,2024-01-10,705,stencil,10,20,10,1,00044,India
112015,2024-01-10,717,spiral bound book,50,100,50,1,00044,India
610366,2024-01-11,710,geometry box,100,150,50,1,00394,India
700289,2024-01-11,703,eraser,1,3,2,1,00328,India
413002,2024-01-11,707,marker,20,40,20,1,00110,India
413002,2024-01-11,713,ball pen,5,10,5,1,00110,India
413002,2024-01-11,701,gel pen,5,10,5,1,00110,India
413002,2024-01-11,711,TD kit,150,300,150,1,00110,India
566446,2024-01-11,710,geometry box,100,150,50,1,00466,India
237640,2024-01-11,710,geometry box,100,150,50,1,00135,India
237640,2024-01-11,708,sketchpen,15,40,25,1,00135,India
214704,2024-01-11,712,graph paper,20,40,20,1,00427,India
214704,2024-01-11,710,geometry box,100,150,50,1,00427,India
689411,2024-01-11,714,carbon paper,15,30,15,1,00325,India
689411,2024-01-11,711,TD kit,150,300,150,1,00325,India
833890,2024-01-11,707,marker,20,40,20,1,00289,India
630203,2024-01-11,710,geometry box,100,150,50,1,00177,India
912712,2024-01-11,711,TD kit,150,300,150,1,00220,India
912712,2024-01-11,705,stencil,10,20,10,1,00220,India
912712,2024-01-11,707,marker,20,40,20,1,00220,India
940132,2024-01-11,701,gel pen,5,10,5,1,00415,India
876843,2024-01-11,701,gel pen,5,10,5,1,00174,India
876843,2024-01-11,710,geometry box,100,150,50,1,00174,India
876843,2024-01-11,708,sketchpen,15,40,25,1,00174,India
876843,2024-01-11,707,marker,20,40,20,1,00174,India
722115,2024-01-11,706,sharpener,3,8,5,1,00136,India
722115,2024-01-11,702,pencil,2,5,3,1,00136,India
240355,2024-01-11,708,sketchpen,15,40,25,1,00089,India
910056,2024-01-11,712,graph paper,20,40,20,1,00259,India
910056,2024-01-11,713,ball pen,5,10,5,1,00259,India
905146,2024-01-11,708,sketchpen,15,40,25,1,00441,India
905146,2024-01-11,711,TD kit,150,300,150,1,00441,India
905146,2024-01-11,709,notebook,30,60,30,1,00441,India
126016,2024-01-11,706,sharpener,3,8,5,1,00135,India
813234,2024-01-11,707,marker,20,40,20,1,00336,India
233211,2024-01-11,702,pencil,2,5,3,1,00442,India
233211,2024-01-11,715,folder,5,15,10,1,00442,India
233211,2024-01-11,706,sharpener,3,8,5,1,00442,India
589192,2024-01-11,710,geometry box,100,150,50,1,00357,India
589192,2024-01-11,712,graph paper,20,40,20,1,00357,India
589192,2024-01-11,701,gel pen,5,10,5,1,00357,India
589192,2024-01-11,711,TD kit,150,300,150,1,00357,India
589192,2024-01-11,716,printing paper,200,400,200,1,00357,India
774852,2024-01-11,715,folder,5,15,10,1,00306,India
774852,2024-01-11,711,TD kit,150,300,150,1,00306,India
774852,2024-01-11,702,pencil,2,5,3,1,00306,India
774852,2024-01-11,712,graph paper,20,40,20,1,00306,India
205755,2024-01-11,711,TD kit,150,300,150,1,00125,India
205755,2024-01-11,706,sharpener,3,8,5,1,00125,India
205755,2024-01-11,702,pencil,2,5,3,1,00125,India
359407,2024-01-11,711,TD kit,150,300,150,1,00134,India
408438,2024-01-11,714,carbon paper,15,30,15,1,00233,India
408438,2024-01-11,715,folder,5,15,10,1,00233,India
165925,2024-01-11,716,printing paper,200,400,200,1,00446,India
395640,2024-01-11,711,TD kit,150,300,150,1,00238,India
395640,2024-01-11,716,printing paper,200,400,200,1,00238,India
395640,2024-01-11,712,graph paper,20,40,20,1,00238,India
395640,2024-01-11,710,geometry box,100,150,50,1,00238,India
395640,2024-01-11,705,stencil,10,20,10,1,00238,India
350825,2024-01-11,703,eraser,1,3,2,1,00061,India
350825,2024-01-11,706,sharpener,3,8,5,1,00061,India
512133,2024-01-11,706,sharpener,3,8,5,1,00031,India
370254,2024-01-11,703,eraser,1,3,2,1,00303,India
370254,2024-01-11,715,folder,5,15,10,1,00303,India
370254,2024-01-11,710,geometry box,100,150,50,1,00303,India
370254,2024-01-11,716,printing paper,200,400,200,1,00303,India
605893,2024-01-11,708,sketchpen,15,40,25,1,00498,India
605893,2024-01-11,706,sharpener,3,8,5,1,00498,India
605893,2024-01-11,704,scale,5,10,5,1,00498,India
605893,2024-01-11,712,graph paper,20,40,20,1,00498,India
574650,2024-01-11,713,ball pen,5,10,5,1,00111,India
574650,2024-01-11,705,stencil,10,20,10,1,00111,India
945550,2024-01-11,701,gel pen,5,10,5,1,00471,India
945550,2024-01-11,713,ball pen,5,10,5,1,00471,India
945550,2024-01-11,702,pencil,2,5,3,1,00471,India
561854,2024-01-11,710,geometry box,100,150,50,1,00159,India
561854,2024-01-11,704,scale,5,10,5,1,00159,India
274804,2024-01-11,710,geometry box,100,150,50,1,00322,India
844040,2024-01-11,711,TD kit,150,300,150,1,00422,India
844040,2024-01-11,701,gel pen,5,10,5,1,00422,India
844040,2024-01-11,715,folder,5,15,10,1,00422,India
844040,2024-01-11,703,eraser,1,3,2,1,00422,India
844040,2024-01-11,702,pencil,2,5,3,1,00422,India
763265,2024-01-11,708,sketchpen,15,40,25,1,00023,India
449309,2024-01-11,714,carbon paper,15,30,15,1,00240,India
449309,2024-01-11,709,notebook,30,60,30,1,00240,India
449309,2024-01-11,708,sketchpen,15,40,25,1,00240,India
180581,2024-01-12,716,printing paper,200,400,200,1,00276,India
180581,2024-01-12,702,pencil,2,5,3,1,00276,India
180581,2024-01-12,701,gel pen,5,10,5,1,00276,India
481362,2024-01-12,705,stencil,10,20,10,1,00232,India
481362,2024-01-12,703,eraser,1,3,2,1,00232,India
481362,2024-01-12,707,marker,20,40,20,1,00232,India
481362,2024-01-12,710,geometry box,100,150,50,1,00232,India
170087,2024-01-12,715,folder,5,15,10,1,00489,India
170087,2024-01-12,716,printing paper,200,400,200,1,00489,India
170087,2024-01-12,702,pencil,2,5,3,1,00489,India
170087,2024-01-12,709,notebook,30,60,30,1,00489,India
239334,2024-01-12,716,printing paper,200,400,200,1,00293,India
239334,2024-01-12,709,notebook,30,60,30,1,00293,India
183521,2024-01-12,704,scale,5,10,5,1,00127,India
183521,2024-01-12,705,stencil,10,20,10,1,00127,India
183521,2024-01-12,717,spiral bound book,50,100,50,1,00127,India
183521,2024-01-12,715,folder,5,15,10,1,00127,India
605613,2024-01-12,703,eraser,1,3,2,1,00001,India
605613,2024-01-12,705,stencil,10,20,10,1,00001,India
605613,2024-01-12,717,spiral bound book,50,100,50,1,00001,India
605613,2024-01-12,702,pencil,2,5,3,1,00001,India
626094,2024-01-12,717,spiral bound book,50,100,50,1,00055,India
715100,2024-01-12,707,marker,20,40,20,1,00299,India
497002,2024-01-12,702,pencil,2,5,3,1,00481,India
497002,2024-01-12,709,notebook,30,60,30,1,00481,India
234610,2024-01-12,709,notebook,30,60,30,1,00426,India
234610,2024-01-12,703,eraser,1,3,2,1,00426,India
234610,2024-01-12,710,geometry box,100,150,50,1,00426,India
234610,2024-01-12,717,spiral bound book,50,100,50,1,00426,India
780853,2024-01-12,704,scale,5,10,5,1,00336,India
873392,2024-01-12,704,scale,5,10,5,1,00202,India
873392,2024-01-12,707,marker,20,40,20,1,00202,India
323252,2024-01-12,708,sketchpen,15,40,25,1,00168,India
323252,2024-01-12,713,ball pen,5,10,5,1,00168,India
323252,2024-01-12,711,TD kit,150,300,150,1,00168,India
323252,2024-01-12,703,eraser,1,3,2,1,00168,India
919375,2024-01-12,702,pencil,2,5,3,1,00387,India
919375,2024-01-12,704,scale,5,10,5,1,00387,India
124225,2024-01-12,713,ball pen,5,10,5,1,00116,India
366188,2024-01-12,714,carbon paper,15,30,15,1,00082,India
366188,2024-01-12,705,stencil,10,20,10,1,00082,India
366188,2024-01-12,704,scale,5,10,5,1,00082,India
366188,2024-01-12,712,graph paper,20,40,20,1,00082,India
366188,2024-01-12,702,pencil,2,5,3,1,00082,India
750408,2024-01-12,704,scale,5,10,5,1,00377,India
750408,2024-01-12,715,folder,5,15,10,1,00377,India
750408,2024-01-12,703,eraser,1,3,2,1,00377,India
750408,2024-01-12,701,gel pen,5,10,5,1,00377,India
368713,2024-01-12,701,gel pen,5,10,5,1,00350,India
539536,2024-01-12,710,geometry box,100,150,50,1,00025,India
539536,2024-01-12,711,TD kit,150,300,150,1,00025,India
539536,2024-01-12,713,ball pen,5,10,5,1,00025,India
309342,2024-01-12,706,sharpener,3,8,5,1,00499,India
309342,2024-01-12,713,ball pen,5,10,5,1,00499,India
309342,2024-01-12,715,folder,5,15,10,1,00499,India
109072,2024-01-12,713,ball pen,5,10,5,1,00431,India
109072,2024-01-12,705,stencil,10,20,10,1,00431,India
622520,2024-01-12,705,stencil,10,20,10,1,00010,India
989135,2024-01-12,716,printing paper,200,400,200,1,00130,India
344343,2024-01-12,715,folder,5,15,10,1,00284,India
546122,2024-01-12,701,gel pen,5,10,5,1,00010,India
546122,2024-01-12,704,scale,5,10,5,1,00010,India
546122,2024-01-12,715,folder,5,15,10,1,00010,India
546122,2024-01-12,712,graph paper,20,40,20,1,00010,India
546122,2024-01-12,706,sharpener,3,8,5,1,00010,India
827018,2024-01-12,715,folder,5,15,10,1,00458,India
827018,2024-01-12,714,carbon paper,15,30,15,1,00458,India
827018,2024-01-12,713,ball pen,5,10,5,1,00458,India
428327,2024-01-12,706,sharpener,3,8,5,1,00203,India
329172,2024-01-12,705,stencil,10,20,10,1,00011,India
329172,2024-01-12,712,graph paper,20,40,20,1,00011,India
329172,2024-01-12,709,notebook,30,60,30,1,00011,India
329172,2024-01-12,710,geometry box,100,150,50,1,00011,India
329172,2024-01-12,703,eraser,1,3,2,1,00011,India
102243,2024-01-12,712,graph paper,20,40,20,1,00115,India
102243,2024-01-12,716,printing paper,200,400,200,1,00115,India
102243,2024-01-12,707,marker,20,40,20,1,00115,India
351841,2024-01-12,709,notebook,30,60,30,1,00320,India
353966,2024-01-12,711,TD kit,150,300,150,1,00389,India
353966,2024-01-12,707,marker,20,40,20,1,00389,India
353966,2024-01-12,714,carbon paper,15,30,15,1,00389,India
353966,2024-01-12,706,sharpener,3,8,5,1,00389,India
654173,2024-01-12,702,pencil,2,5,3,1,00080,India
654173,2024-01-12,706,sharpener,3,8,5,1,00080,India
654173,2024-01-12,705,stencil,10,20,10,1,00080,India
654173,2024-01-12,714,carbon paper,15,30,15,1,00080,India
654173,2024-01-12,710,geometry box,100,150,50,1,00080,India
574489,2024-01-12,717,spiral bound book,50,100,50,1,00027,India
574489,2024-01-12,707,marker,20,40,20,1,00027,India
502427,2024-01-12,709,notebook,30,60,30,1,00289,India
502427,2024-01-12,707,marker,20,40,20,1,00289,India
502427,2024-01-12,715,folder,5,15,10,1,00289,India
464009,2024-01-12,701,gel pen,5,10,5,1,00124,India
464009,2024-01-12,714,carbon paper,15,30,15,1,00124,India
464009,2024-01-12,717,spiral bound book,50,100,50,1,00124,India
464009,2024-01-12,708,sketchpen,15,40,25,1,00124,India
283877,2024-01-12,705,stencil,10,20,10,1,00182,India
283877,2024-01-12,713,ball pen,5,10,5,1,00182,India
184649,2024-01-12,713,ball pen,5,10,5,1,00210,India
184649,2024-01-12,715,folder,5,15,10,1,00210,India
187159,2024-01-12,717,spiral bound book,50,100,50,1,00053,India
187159,2024-01-12,701,gel pen,5,10,5,1,00053,India
187159,2024-01-12,710,geometry box,100,150,50,1,00053,India
713113,2024-01-12,714,carbon paper,15,30,15,1,00202,India
713113,2024-01-12,715,folder,5,15,10,1,00202,India
897006,2024-01-12,709,notebook,30,60,30,1,00495,India
897006,2024-01-12,716,printing paper,200,400,200,1,00495,India
897006,2024-01-12,705,stencil,10,20,10,1,00495,India
897006,2024-01-12,710,geometry box,100,150,50,1,00495,India
105887,2024-01-12,709,notebook,30,60,30,1,00407,India
105887,2024-01-12,714,carbon paper,15,30,15,1,00407,India
105887,2024-01-12,717,spiral bound book,50,100,50,1,00407,India
105887,2024-01-12,703,eraser,1,3,2,1,00407,India
423572,2024-01-12,703,eraser,1,3,2,1,00389,India
423572,2024-01-12,712,graph paper,20,40,20,1,00389,India
423572,2024-01-12,711,TD kit,150,300,150,1,00389,India
423572,2024-01-12,709,notebook,30,60,30,1,00389,India
963087,2024-01-12,710,geometry box,100,150,50,1,00081,India
348676,2024-01-12,716,printing paper,200,400,200,1,00171,India
348676,2024-01-12,705,stencil,10,20,10,1,00171,India
348676,2024-01-12,717,spiral bound book,50,100,50,1,00171,India
462162,2024-01-12,708,sketchpen,15,40,25,1,00352,India
462162,2024-01-12,707,marker,20,40,20,1,00352,India
161604,2024-01-12,714,carbon paper,15,30,15,1,00342,India
257071,2024-01-12,715,folder,5,15,10,1,00394,India
257071,2024-01-12,708,sketchpen,15,40,25,1,00394,India
257071,2024-01-12,701,gel pen,5,10,5,1,00394,India
441442,2024-01-12,717,spiral bound book,50,100,50,1,00437,India
441442,2024-01-12,713,ball pen,5,10,5,1,00437,India
441442,2024-01-12,710,geometry box,100,150,50,1,00437,India
828020,2024-01-13,711,TD kit,150,300,150,1,00181,India
414128,2024-01-13,714,carbon paper,15,30,15,1,00212,India
414128,2024-01-13,710,geometry box,100,150,50,1,00212,India
414128,2024-01-13,712,graph paper,20,40,20,1,00212,India
414128,2024-01-13,701,gel pen,5,10,5,1,00212,India
516406,2024-01-13,715,folder,5,15,10,1,00362,India
350015,2024-01-13,711,TD kit,150,300,150,1,00324,India
350015,2024-01-13,707,marker,20,40,20,1,00324,India
350015,2024-01-13,701,gel pen,5,10,5,1,00324,India
236913,2024-01-13,706,sharpener,3,8,5,1,00389,India
236913,2024-01-13,713,ball pen,5,10,5,1,00389,India
236913,2024-01-13,704,scale,5,10,5,1,00389,India
236913,2024-01-13,716,printing paper,200,400,200,1,00389,India
593811,2024-01-13,706,sharpener,3,8,5,1,00128,India
656695,2024-01-13,714,carbon paper,15,30,15,1,00159,India
656695,2024-01-13,717,spiral bound book,50,100,50,1,00159,India
590861,2024-01-13,709,notebook,30,60,30,1,00114,India
590861,2024-01-13,708,sketchpen,15,40,25,1,00114,India
590861,2024-01-13,714,carbon paper,15,30,15,1,00114,India
590861,2024-01-13,704,scale,5,10,5,1,00114,India
590861,2024-01-13,713,ball pen,5,10,5,1,00114,India
876564,2024-01-13,701,gel pen,5,10,5,1,00407,India
876564,2024-01-13,708,sketchpen,15,40,25,1,00407,India
876564,2024-01-13,704,scale,5,10,5,1,00407,India
876564,2024-01-13,716,printing paper,200,400,200,1,00407,India
286552,2024-01-13,714,carbon paper,15,30,15,1,00365,India
286552,2024-01-13,707,marker,20,40,20,1,00365,India
469242,2024-01-13,716,printing paper,200,400,200,1,00352,India
469242,2024-01-13,712,graph paper,20,40,20,1,00352,India
469242,2024-01-13,714,carbon paper,15,30,15,1,00352,India
496069,2024-01-13,716,printing paper,200,400,200,1,00252,India
496069,2024-01-13,701,gel pen,5,10,5,1,00252,India
496069,2024-01-13,708,sketchpen,15,40,25,1,00252,India
496069,2024-01-13,709,notebook,30,60,30,1,00252,India
601265,2024-01-13,703,eraser,1,3,2,1,00058,India
601265,2024-01-13,704,scale,5,10,5,1,00058,India
601265,2024-01-13,708,sketchpen,15,40,25,1,00058,India
601265,2024-01-13,713,ball pen,5,10,5,1,00058,India
240718,2024-01-13,708,sketchpen,15,40,25,1,00368,India
240718,2024-01-13,713,ball pen,5,10,5,1,00368,India
825519,2024-01-13,710,geometry box,100,150,50,1,00067,India
825519,2024-01-13,701,gel pen,5,10,5,1,00067,India
460176,2024-01-13,709,notebook,30,60,30,1,00343,India
463645,2024-01-13,715,folder,5,15,10,1,00434,India
510728,2024-01-13,705,stencil,10,20,10,1,00313,India
510728,2024-01-13,713,ball pen,5,10,5,1,00313,India
714328,2024-01-13,712,graph paper,20,40,20,1,00219,India
714328,2024-01-13,702,pencil,2,5,3,1,00219,India
809957,2024-01-13,708,sketchpen,15,40,25,1,00495,India
809957,2024-01-13,702,pencil,2,5,3,1,00495,India
965406,2024-01-13,705,stencil,10,20,10,1,00394,India
965406,2024-01-13,714,carbon paper,15,30,15,1,00394,India
965406,2024-01-13,712,graph paper,20,40,20,1,00394,India
965406,2024-01-13,713,ball pen,5,10,5,1,00394,India
213573,2024-01-13,717,spiral bound book,50,100,50,1,00347,India
213573,2024-01-13,713,ball pen,5,10,5,1,00347,India
213573,2024-01-13,702,pencil,2,5,3,1,00347,India
893600,2024-01-13,712,graph paper,20,40,20,1,00437,India
335622,2024-01-13,704,scale,5,10,5,1,00484,India
335622,2024-01-13,717,spiral bound book,50,100,50,1,00484,India
335622,2024-01-13,705,stencil,10,20,10,1,00484,India
249247,2024-01-13,705,stencil,10,20,10,1,00136,India
358196,2024-01-13,703,eraser,1,3,2,1,00093,India
792030,2024-01-13,712,graph paper,20,40,20,1,00209,India
792030,2024-01-13,714,carbon paper,15,30,15,1,00209,India
792030,2024-01-13,707,marker,20,40,20,1,00209,India
792030,2024-01-13,710,geometry box,100,150,50,1,00209,India
842436,2024-01-13,717,spiral bound book,50,100,50,1,00283,India
842436,2024-01-13,712,graph paper,20,40,20,1,00283,India
842436,2024-01-13,714,carbon paper,15,30,15,1,00283,India
842436,2024-01-13,713,ball pen,5,10,5,1,00283,India
931059,2024-01-13,702,pencil,2,5,3,1,00349,India
931059,2024-01-13,708,sketchpen,15,40,25,1,00349,India
931059,2024-01-13,714,carbon paper,15,30,15,1,00349,India
488288,2024-01-13,715,folder,5,15,10,1,00272,India
488288,2024-01-13,714,carbon paper,15,30,15,1,00272,India
488288,2024-01-13,708,sketchpen,15,40,25,1,00272,India
488288,2024-01-13,704,scale,5,10,5,1,00272,India
737324,2024-01-13,702,pencil,2,5,3,1,00295,India
737324,2024-01-13,708,sketchpen,15,40,25,1,00295,India
343403,2024-01-14,706,sharpener,3,8,5,1,00243,India
908152,2024-01-14,703,eraser,1,3,2,1,00277,India
908152,2024-01-14,701,gel pen,5,10,5,1,00277,India
899588,2024-01-14,708,sketchpen,15,40,25,1,00169,India
476106,2024-01-14,712,graph paper,20,40,20,1,00412,India
476106,2024-01-14,704,scale,5,10,5,1,00412,India
555617,2024-01-14,715,folder,5,15,10,1,00097,India
437331,2024-01-14,701,gel pen,5,10,5,1,00212,India
437331,2024-01-14,714,carbon paper,15,30,15,1,00212,India
437331,2024-01-14,703,eraser,1,3,2,1,00212,India
437331,2024-01-14,715,folder,5,15,10,1,00212,India
437331,2024-01-14,710,geometry box,100,150,50,1,00212,India
262374,2024-01-14,707,marker,20,40,20,1,00411,India
262374,2024-01-14,714,carbon paper,15,30,15,1,00411,India
933021,2024-01-14,716,printing paper,200,400,200,1,00304,India
933021,2024-01-14,712,graph paper,20,40,20,1,00304,India
933021,2024-01-14,713,ball pen,5,10,5,1,00304,India
933021,2024-01-14,710,geometry box,100,150,50,1,00304,India
933021,2024-01-14,709,notebook,30,60,30,1,00304,India
929627,2024-01-14,703,eraser,1,3,2,1,00115,India
929627,2024-01-14,707,marker,20,40,20,1,00115,India
929627,2024-01-14,716,printing paper,200,400,200,1,00115,India
558224,2024-01-14,706,sharpener,3,8,5,1,00356,India
558224,2024-01-14,708,sketchpen,15,40,25,1,00356,India
558224,2024-01-14,714,carbon paper,15,30,15,1,00356,India
333387,2024-01-14,701,gel pen,5,10,5,1,00231,India
333387,2024-01-14,717,spiral bound book,50,100,50,1,00231,India
333387,2024-01-14,709,notebook,30,60,30,1,00231,India
530349,2024-01-14,706,sharpener,3,8,5,1,00446,India
530349,2024-01-14,701,gel pen,5,10,5,1,00446,India
920806,2024-01-14,702,pencil,2,5,3,1,00438,India
920806,2024-01-14,703,eraser,1,3,2,1,00438,India
652896,2024-01-14,705,stencil,10,20,10,1,00331,India
652896,2024-01-14,709,notebook,30,60,30,1,00331,India
466065,2024-01-14,708,sketchpen,15,40,25,1,00402,India
466065,2024-01-14,707,marker,20,40,20,1,00402,India
466065,2024-01-14,711,TD kit,150,300,150,1,00402,India
466065,2024-01-14,704,scale,5,10,5,1,00402,India
513261,2024-01-14,707,marker,20,40,20,1,00031,India
513261,2024-01-14,712,graph paper,20,40,20,1,00031,India
513261,2024-01-14,713,ball pen,5,10,5,1,00031,India
639047,2024-01-14,705,stencil,10,20,10,1,00349,India
153859,2024-01-14,708,sketchpen,15,40,25,1,00244,India
757686,2024-01-14,705,stencil,10,20,10,1,00173,India
757686,2024-01-14,716,printing paper,200,400,200,1,00173,India
757686,2024-01-14,709,notebook,30,60,30,1,00173,India
771295,2024-01-14,703,eraser,1,3,2,1,00123,India
771295,2024-01-14,715,folder,5,15,10,1,00123,India
771295,2024-01-14,704,scale,5,10,5,1,00123,India
823363,2024-01-14,705,stencil,10,20,10,1,00123,India
912074,2024-01-14,716,printing paper,200,400,200,1,00295,India
272750,2024-01-14,707,marker,20,40,20,1,00321,India
272750,2024-01-14,705,stencil,10,20,10,1,00321,India
272750,2024-01-14,713,ball pen,5,10,5,1,00321,India
656694,2024-01-14,707,marker,20,40,20,1,00064,India
656694,2024-01-14,717,spiral bound book,50,100,50,1,00064,India
656694,2024-01-14,702,pencil,2,5,3,1,00064,India
438915,2024-01-14,702,pencil,2,5,3,1,00449,India
813911,2024-01-14,707,marker,20,40,20,1,00314,India
813911,2024-01-14,702,pencil,2,5,3,1,00314,India
183733,2024-01-14,701,gel pen,5,10,5,1,00061,India
183733,2024-01-14,716,printing paper,200,400,200,1,00061,India
514908,2024-01-14,710,geometry box,100,150,50,1,00437,India
514908,2024-01-14,702,pencil,2,5,3,1,00437,India
667453,2024-01-14,711,TD kit,150,300,150,1,00393,India
667453,2024-01-14,708,sketchpen,15,40,25,1,00393,India
667453,2024-01-14,701,gel pen,5,10,5,1,00393,India
667453,2024-01-14,714,carbon paper,15,30,15,1,00393,India
204056,2024-01-14,706,sharpener,3,8,5,1,00106,India
712126,2024-01-14,714,carbon paper,15,30,15,1,00042,India
309104,2024-01-14,715,folder,5,15,10,1,00313,India
309104,2024-01-14,706,sharpener,3,8,5,1,00313,India
309104,2024-01-14,717,spiral bound book,50,100,50,1,00313,India
309104,2024-01-14,709,notebook,30,60,30,1,00313,India
436400,2024-01-14,705,stencil,10,20,10,1,00134,India
436400,2024-01-14,701,gel pen,5,10,5,1,00134,India
436400,2024-01-14,714,carbon paper,15,30,15,1,00134,India
436400,2024-01-14,715,folder,5,15,10,1,00134,India
436400,2024-01-14,704,scale,5,10,5,1,00134,India
870265,2024-01-14,716,printing paper,200,400,200,1,00163,India
870265,2024-01-14,707,marker,20,40,20,1,00163,India
456586,2024-01-14,715,folder,5,15,10,1,00372,India
368124,2024-01-14,715,folder,5,15,10,1,00200,India
368124,2024-01-14,713,ball pen,5,10,5,1,00200,India
368124,2024-01-14,717,spiral bound book,50,100,50,1,00200,India
368124,2024-01-14,704,scale,5,10,5,1,00200,India
368124,2024-01-14,707,marker,20,40,20,1,00200,India
435946,2024-01-14,709,notebook,30,60,30,1,00352,India
435946,2024-01-14,701,gel pen,5,10,5,1,00352,India
435946,2024-01-14,712,graph paper,20,40,20,1,00352,India
672680,2024-01-14,715,folder,5,15,10,1,00145,India
672680,2024-01-14,716,printing paper,200,400,200,1,00145,India
672680,2024-01-14,703,eraser,1,3,2,1,00145,India
764522,2024-01-14,701,gel pen,5,10,5,1,00256,India
764522,2024-01-14,713,ball pen,5,10,5,1,00256,India
318810,2024-01-14,711,TD kit,150,300,150,1,00299,India
318810,2024-01-14,716,printing paper,200,400,200,1,00299,India
318810,2024-01-14,707,marker,20,40,20,1,00299,India
318810,2024-01-14,709,notebook,30,60,30,1,00299,India
277464,2024-01-14,710,geometry box,100,150,50,1,00275,India
449348,2024-01-14,703,eraser,1,3,2,1,00257,India
449348,2024-01-14,717,spiral bound book,50,100,50,1,00257,India
449348,2024-01-14,710,geometry box,100,150,50,1,00257,India
449348,2024-01-14,715,folder,5,15,10,1,00257,India
449348,2024-01-14,709,notebook,30,60,30,1,00257,India
819372,2024-01-14,705,stencil,10,20,10,1,00470,India
819372,2024-01-14,709,notebook,30,60,30,1,00470,India
230373,2024-01-15,715,folder,5,15,10,1,00075,India
230373,2024-01-15,708,sketchpen,15,40,25,1,00075,India
230373,2024-01-15,714,carbon paper,15,30,15,1,00075,India
230373,2024-01-15,701,gel pen,5,10,5,1,00075,India
230373,2024-01-15,711,TD kit,150,300,150,1,00075,India
616513,2024-01-15,703,eraser,1,3,2,1,00314,India
327718,2024-01-15,712,graph paper,20,40,20,1,00117,India
327718,2024-01-15,713,ball pen,5,10,5,1,00117,India
327718,2024-01-15,705,stencil,10,20,10,1,00117,India
342621,2024-01-15,708,sketchpen,15,40,25,1,00033,India
342621,2024-01-15,709,notebook,30,60,30,1,00033,India
342621,2024-01-15,717,spiral bound book,50,100,50,1,00033,India
854130,2024-01-15,704,scale,5,10,5,1,00269,India
854130,2024-01-15,703,eraser,1,3,2,1,00269,India
854130,2024-01-15,707,marker,20,40,20,1,00269,India
854130,2024-01-15,717,spiral bound book,50,100,50,1,00269,India
141711,2024-01-15,703,eraser,1,3,2,1,00343,India
141711,2024-01-15,705,stencil,10,20,10,1,00343,India
498722,2024-01-15,703,eraser,1,3,2,1,00115,India
498722,2024-01-15,706,sharpener,3,8,5,1,00115,India
498722,2024-01-15,709,notebook,30,60,30,1,00115,India
498722,2024-01-15,716,printing paper,200,400,200,1,00115,India
373748,2024-01-15,715,folder,5,15,10,1,00178,India
373748,2024-01-15,707,marker,20,40,20,1,00178,India
373748,2024-01-15,703,eraser,1,3,2,1,00178,India
373748,2024-01-15,708,sketchpen,15,40,25,1,00178,India
851237,2024-01-15,712,graph paper,20,40,20,1,00407,India
851237,2024-01-15,710,geometry box,100,150,50,1,00407,India
851237,2024-01-15,706,sharpener,3,8,5,1,00407,India
851237,2024-01-15,705,stencil,10,20,10,1,00407,India
388428,2024-01-15,714,carbon paper,15,30,15,1,00013,India
388428,2024-01-15,710,geometry box,100,150,50,1,00013,India
388428,2024-01-15,707,marker,20,40,20,1,00013,India
388428,2024-01-15,701,gel pen,5,10,5,1,00013,India
388428,2024-01-15,704,scale,5,10,5,1,00013,India
645562,2024-01-15,710,geometry box,100,150,50,1,00024,India
645562,2024-01-15,714,carbon paper,15,30,15,1,00024,India
645562,2024-01-15,715,folder,5,15,10,1,00024,India
287255,2024-01-15,711,TD kit,150,300,150,1,00359,India
287255,2024-01-15,708,sketchpen,15,40,25,1,00359,India
547825,2024-01-15,713,ball pen,5,10,5,1,00154,India
547825,2024-01-15,715,folder,5,15,10,1,00154,India
547825,2024-01-15,709,notebook,30,60,30,1,00154,India
547825,2024-01-15,704,scale,5,10,5,1,00154,India
547825,2024-01-15,716,printing paper,200,400,200,1,00154,India
673805,2024-01-15,710,geometry box,100,150,50,1,00193,India
673805,2024-01-15,705,stencil,10,20,10,1,00193,India
673805,2024-01-15,716,printing paper,200,400,200,1,00193,India
673805,2024-01-15,702,pencil,2,5,3,1,00193,India
673805,2024-01-15,712,graph paper,20,40,20,1,00193,India
485168,2024-01-15,712,graph paper,20,40,20,1,00246,India
485168,2024-01-15,715,folder,5,15,10,1,00246,India
485168,2024-01-15,710,geometry box,100,150,50,1,00246,India
485168,2024-01-15,713,ball pen,5,10,5,1,00246,India
909562,2024-01-15,714,carbon paper,15,30,15,1,00309,India
909562,2024-01-15,701,gel pen,5,10,5,1,00309,India
909562,2024-01-15,717,spiral bound book,50,100,50,1,00309,India
909562,2024-01-15,702,pencil,2,5,3,1,00309,India
259566,2024-01-15,712,graph paper,20,40,20,1,00139,India
795918,2024-01-15,713,ball pen,5,10,5,1,00146,India
120825,2024-01-15,713,ball pen,5,10,5,1,00180,India
120825,2024-01-15,705,stencil,10,20,10,1,00180,India
120825,2024-01-15,701,gel pen,5,10,5,1,00180,India
120825,2024-01-15,710,geometry box,100,150,50,1,00180,India
627808,2024-01-15,702,pencil,2,5,3,1,00210,India
627808,2024-01-15,706,sharpener,3,8,5,1,00210,India
630646,2024-01-15,710,geometry box,100,150,50,1,00451,India
630646,2024-01-15,712,graph paper,20,40,20,1,00451,India
630646,2024-01-15,706,sharpener,3,8,5,1,00451,India
630646,2024-01-15,716,printing paper,200,400,200,1,00451,India
573287,2024-01-15,716,printing paper,200,400,200,1,00151,India
685932,2024-01-15,714,carbon paper,15,30,15,1,00309,India
685932,2024-01-15,701,gel pen,5,10,5,1,00309,India
685932,2024-01-15,709,notebook,30,60,30,1,00309,India
685932,2024-01-15,712,graph paper,20,40,20,1,00309,India
956466,2024-01-15,711,TD kit,150,300,150,1,00157,India
956466,2024-01-15,709,notebook,30,60,30,1,00157,India
956466,2024-01-15,708,sketchpen,15,40,25,1,00157,India
956466,2024-01-15,707,marker,20,40,20,1,00157,India
377597,2024-01-15,709,notebook,30,60,30,1,00481,India
377597,2024-01-15,717,spiral bound book,50,100,50,1,00481,India
377597,2024-01-15,712,graph paper,20,40,20,1,00481,India
980686,2024-01-15,708,sketchpen,15,40,25,1,00340,India
875498,2024-01-15,711,TD kit,150,300,150,1,00050,India
141685,2024-01-15,709,notebook,30,60,30,1,00311,India
614526,2024-01-15,715,folder,5,15,10,1,00350,India
965165,2024-01-15,711,TD kit,150,300,150,1,00483,India
965165,2024-01-15,708,sketchpen,15,40,25,1,00483,India
965165,2024-01-15,706,sharpener,3,8,5,1,00483,India
965165,2024-01-15,707,marker,20,40,20,1,00483,India
965165,2024-01-15,709,notebook,30,60,30,1,00483,India
594595,2024-01-15,708,sketchpen,15,40,25,1,00337,India
594595,2024-01-15,703,eraser,1,3,2,1,00337,India
268541,2024-01-15,703,eraser,1,3,2,1,00227,India
268541,2024-01-15,717,spiral bound book,50,100,50,1,00227,India
377215,2024-01-15,702,pencil,2,5,3,1,00227,India
295516,2024-01-15,705,stencil,10,20,10,1,00499,India
295516,2024-01-15,716,printing paper,200,400,200,1,00499,India
790153,2024-01-15,712,graph paper,20,40,20,1,00068,India
790153,2024-01-15,710,geometry box,100,150,50,1,00068,India
790153,2024-01-15,705,stencil,10,20,10,1,00068,India
475110,2024-01-15,711,TD kit,150,300,150,1,00130,India
475110,2024-01-15,708,sketchpen,15,40,25,1,00130,India
475110,2024-01-15,717,spiral bound book,50,100,50,1,00130,India
313324,2024-01-15,716,printing paper,200,400,200,1,00380,India
313324,2024-01-15,702,pencil,2,5,3,1,00380,India
259785,2024-01-15,712,graph paper,20,40,20,1,00476,India
723798,2024-01-16,705,stencil,10,20,10,1,00483,India
239599,2024-01-16,710,geometry box,100,150,50,1,00057,India
239599,2024-01-16,711,TD kit,150,300,150,1,00057,India
239599,2024-01-16,701,gel pen,5,10,5,1,00057,India
239599,2024-01-16,709,notebook,30,60,30,1,00057,India
239599,2024-01-16,714,carbon paper,15,30,15,1,00057,India
905507,2024-01-16,709,notebook,30,60,30,1,00244,India
649376,2024-01-16,712,graph paper,20,40,20,1,00192,India
649376,2024-01-16,702,pencil,2,5,3,1,00192,India
649376,2024-01-16,709,notebook,30,60,30,1,00192,India
649376,2024-01-16,711,TD kit,150,300,150,1,00192,India
820238,2024-01-16,706,sharpener,3,8,5,1,00466,India
820238,2024-01-16,703,eraser,1,3,2,1,00466,India
938288,2024-01-16,712,graph paper,20,40,20,1,00180,India
326434,2024-01-16,710,geometry box,100,150,50,1,00064,India
296015,2024-01-16,716,printing paper,200,400,200,1,00499,India
296015,2024-01-16,714,carbon paper,15,30,15,1,00499,India
296015,2024-01-16,702,pencil,2,5,3,1,00499,India
296015,2024-01-16,710,geometry box,100,150,50,1,00499,India
122401,2024-01-16,713,ball pen,5,10,5,1,00134,India
122401,2024-01-16,709,notebook,30,60,30,1,00134,India
122401,2024-01-16,714,carbon paper,15,30,15,1,00134,India
454323,2024-01-16,707,marker,20,40,20,1,00130,India
414836,2024-01-16,709,notebook,30,60,30,1,00449,India
414836,2024-01-16,706,sharpener,3,8,5,1,00449,India
414836,2024-01-16,705,stencil,10,20,10,1,00449,India
414836,2024-01-16,715,folder,5,15,10,1,00449,India
414836,2024-01-16,704,scale,5,10,5,1,00449,India
425873,2024-01-16,705,stencil,10,20,10,1,00256,India
425873,2024-01-16,713,ball pen,5,10,5,1,00256,India
425873,2024-01-16,703,eraser,1,3,2,1,00256,India
425873,2024-01-16,707,marker,20,40,20,1,00256,India
652856,2024-01-16,704,scale,5,10,5,1,00494,India
327326,2024-01-16,715,folder,5,15,10,1,00050,India
327326,2024-01-16,713,ball pen,5,10,5,1,00050,India
327326,2024-01-16,709,notebook,30,60,30,1,00050,India
250464,2024-01-16,702,pencil,2,5,3,1,00047,India
250464,2024-01-16,706,sharpener,3,8,5,1,00047,India
250464,2024-01-16,713,ball pen,5,10,5,1,00047,India
408188,2024-01-16,706,sharpener,3,8,5,1,00192,India
408188,2024-01-16,702,pencil,2,5,3,1,00192,India
408188,2024-01-16,716,printing paper,200,400,200,1,00192,India
408188,2024-01-16,712,graph paper,20,40,20,1,00192,India
317640,2024-01-16,707,marker,20,40,20,1,00358,India
317640,2024-01-16,711,TD kit,150,300,150,1,00358,India
706890,2024-01-16,717,spiral bound book,50,100,50,1,00166,India
706890,2024-01-16,715,folder,5,15,10,1,00166,India
386661,2024-01-16,703,eraser,1,3,2,1,00428,India
386661,2024-01-16,705,stencil,10,20,10,1,00428,India
335775,2024-01-16,707,marker,20,40,20,1,00127,India
335775,2024-01-16,710,geometry box,100,150,50,1,00127,India
335775,2024-01-16,712,graph paper,20,40,20,1,00127,India
641751,2024-01-16,710,geometry box,100,150,50,1,00495,India
641751,2024-01-16,709,notebook,30,60,30,1,00495,India
392842,2024-01-16,707,marker,20,40,20,1,00184,India
392842,2024-01-16,701,gel pen,5,10,5,1,00184,India
392842,2024-01-16,704,scale,5,10,5,1,00184,India
564746,2024-01-16,702,pencil,2,5,3,1,00363,India
564746,2024-01-16,713,ball pen,5,10,5,1,00363,India
564746,2024-01-16,717,spiral bound book,50,100,50,1,00363,India
564746,2024-01-16,705,stencil,10,20,10,1,00363,India
312227,2024-01-16,705,stencil,10,20,10,1,00180,India
312227,2024-01-16,716,printing paper,200,400,200,1,00180,India
312227,2024-01-16,711,TD kit,150,300,150,1,00180,India
312227,2024-01-16,701,gel pen,5,10,5,1,00180,India
277097,2024-01-16,706,sharpener,3,8,5,1,00209,India
277097,2024-01-16,707,marker,20,40,20,1,00209,India
277097,2024-01-16,717,spiral bound book,50,100,50,1,00209,India
277097,2024-01-16,714,carbon paper,15,30,15,1,00209,India
296835,2024-01-16,701,gel pen,5,10,5,1,00413,India
296835,2024-01-16,716,printing paper,200,400,200,1,00413,India
296835,2024-01-16,715,folder,5,15,10,1,00413,India
817592,2024-01-16,701,gel pen,5,10,5,1,00245,India
817592,2024-01-16,710,geometry box,100,150,50,1,00245,India
817592,2024-01-16,708,sketchpen,15,40,25,1,00245,India
234039,2024-01-16,706,sharpener,3,8,5,1,00425,India
234039,2024-01-16,709,notebook,30,60,30,1,00425,India
678755,2024-01-16,703,eraser,1,3,2,1,00491,India
678755,2024-01-16,716,printing paper,200,400,200,1,00491,India
679880,2024-01-16,705,stencil,10,20,10,1,00109,India
679880,2024-01-16,703,eraser,1,3,2,1,00109,India
486358,2024-01-16,710,geometry box,100,150,50,1,00355,India
960474,2024-01-16,712,graph paper,20,40,20,1,00428,India
960474,2024-01-16,701,gel pen,5,10,5,1,00428,India
960474,2024-01-16,709,notebook,30,60,30,1,00428,India
471791,2024-01-16,705,stencil,10,20,10,1,00049,India
103578,2024-01-16,703,eraser,1,3,2,1,00006,India
103578,2024-01-16,712,graph paper,20,40,20,1,00006,India
103578,2024-01-16,714,carbon paper,15,30,15,1,00006,India
103578,2024-01-16,710,geometry box,100,150,50,1,00006,India
103578,2024-01-16,717,spiral bound book,50,100,50,1,00006,India
339833,2024-01-16,717,spiral bound book,50,100,50,1,00425,India
339833,2024-01-16,705,stencil,10,20,10,1,00425,India
339833,2024-01-16,713,ball pen,5,10,5,1,00425,India
339833,2024-01-16,704,scale,5,10,5,1,00425,India
549305,2024-01-16,708,sketchpen,15,40,25,1,00309,India
549305,2024-01-16,702,pencil,2,5,3,1,00309,India
549305,2024-01-16,716,printing paper,200,400,200,1,00309,India
435145,2024-01-16,717,spiral bound book,50,100,50,1,00318,India
797295,2024-01-16,710,geometry box,100,150,50,1,00342,India
797295,2024-01-16,702,pencil,2,5,3,1,00342,India
797295,2024-01-16,708,sketchpen,15,40,25,1,00342,India
341131,2024-01-16,713,ball pen,5,10,5,1,00256,India
341131,2024-01-16,708,sketchpen,15,40,25,1,00256,India
341131,2024-01-16,715,folder,5,15,10,1,00256,India
498972,2024-01-16,710,geometry box,100,150,50,1,00393,India
498972,2024-01-16,711,TD kit,150,300,150,1,00393,India
498972,2024-01-16,714,carbon paper,15,30,15,1,00393,India
498972,2024-01-16,715,folder,5,15,10,1,00393,India
127352,2024-01-16,709,notebook,30,60,30,1,00192,India
127352,2024-01-16,717,spiral bound book,50,100,50,1,00192,India
127352,2024-01-16,707,marker,20,40,20,1,00192,India
602805,2024-01-16,714,carbon paper,15,30,15,1,00368,India
602805,2024-01-16,716,printing paper,200,400,200,1,00368,India
602805,2024-01-16,701,gel pen,5,10,5,1,00368,India
589807,2024-01-16,707,marker,20,40,20,1,00417,India
149062,2024-01-16,712,graph paper,20,40,20,1,00375,India
149062,2024-01-16,703,eraser,1,3,2,1,00375,India
784779,2024-01-16,701,gel pen,5,10,5,1,00394,India
784779,2024-01-16,712,graph paper,20,40,20,1,00394,India
784779,2024-01-16,713,ball pen,5,10,5,1,00394,India
784779,2024-01-16,711,TD kit,150,300,150,1,00394,India
904238,2024-01-16,716,printing paper,200,400,200,1,00249,India
703972,2024-01-16,704,scale,5,10,5,1,00456,India
703972,2024-01-16,702,pencil,2,5,3,1,00456,India
261931,2024-01-16,705,stencil,10,20,10,1,00444,India
261931,2024-01-16,715,folder,5,15,10,1,00444,India
261931,2024-01-16,717,spiral bound book,50,100,50,1,00444,India
261931,2024-01-16,712,graph paper,20,40,20,1,00444,India
511065,2024-01-17,717,spiral bound book,50,100,50,1,00216,India
511065,2024-01-17,707,marker,20,40,20,1,00216,India
511065,2024-01-17,710,geometry box,100,150,50,1,00216,India
511065,2024-01-17,708,sketchpen,15,40,25,1,00216,India
613116,2024-01-17,701,gel pen,5,10,5,1,00136,India
613116,2024-01-17,711,TD kit,150,300,150,1,00136,India
589772,2024-01-17,706,sharpener,3,8,5,1,00307,India
589772,2024-01-17,709,notebook,30,60,30,1,00307,India
589772,2024-01-17,717,spiral bound book,50,100,50,1,00307,India
480162,2024-01-17,714,carbon paper,15,30,15,1,00474,India
480162,2024-01-17,713,ball pen,5,10,5,1,00474,India
818016,2024-01-17,706,sharpener,3,8,5,1,00061,India
818016,2024-01-17,703,eraser,1,3,2,1,00061,India
818016,2024-01-17,713,ball pen,5,10,5,1,00061,India
818016,2024-01-17,708,sketchpen,15,40,25,1,00061,India
804595,2024-01-17,705,stencil,10,20,10,1,00175,India
804595,2024-01-17,716,printing paper,200,400,200,1,00175,India
804595,2024-01-17,715,folder,5,15,10,1,00175,India
804595,2024-01-17,717,spiral bound book,50,100,50,1,00175,India
804595,2024-01-17,706,sharpener,3,8,5,1,00175,India
305363,2024-01-17,716,printing paper,200,400,200,1,00074,India
305363,2024-01-17,715,folder,5,15,10,1,00074,India
305363,2024-01-17,701,gel pen,5,10,5,1,00074,India
305363,2024-01-17,714,carbon paper,15,30,15,1,00074,India
547049,2024-01-17,717,spiral bound book,50,100,50,1,00362,India
547049,2024-01-17,715,folder,5,15,10,1,00362,India
547049,2024-01-17,711,TD kit,150,300,150,1,00362,India
396687,2024-01-17,705,stencil,10,20,10,1,00212,India
396687,2024-01-17,701,gel pen,5,10,5,1,00212,India
396687,2024-01-17,708,sketchpen,15,40,25,1,00212,India
396687,2024-01-17,711,TD kit,150,300,150,1,00212,India
318815,2024-01-17,707,marker,20,40,20,1,00376,India
318815,2024-01-17,711,TD kit,150,300,150,1,00376,India
154015,2024-01-17,712,graph paper,20,40,20,1,00406,India
154015,2024-01-17,715,folder,5,15,10,1,00406,India
154015,2024-01-17,713,ball pen,5,10,5,1,00406,India
152238,2024-01-17,709,notebook,30,60,30,1,00269,India
152238,2024-01-17,702,pencil,2,5,3,1,00269,India
951848,2024-01-17,716,printing paper,200,400,200,1,00314,India
951848,2024-01-17,705,stencil,10,20,10,1,00314,India
951848,2024-01-17,706,sharpener,3,8,5,1,00314,India
158477,2024-01-17,716,printing paper,200,400,200,1,00137,India
148328,2024-01-17,703,eraser,1,3,2,1,00158,India
148328,2024-01-17,714,carbon paper,15,30,15,1,00158,India
747419,2024-01-17,716,printing paper,200,400,200,1,00028,India
747419,2024-01-17,711,TD kit,150,300,150,1,00028,India
747419,2024-01-17,709,notebook,30,60,30,1,00028,India
490201,2024-01-17,711,TD kit,150,300,150,1,00353,India
490201,2024-01-17,703,eraser,1,3,2,1,00353,India
490201,2024-01-17,702,pencil,2,5,3,1,00353,India
490201,2024-01-17,713,ball pen,5,10,5,1,00353,India
490201,2024-01-17,716,printing paper,200,400,200,1,00353,India
734066,2024-01-17,713,ball pen,5,10,5,1,00031,India
734066,2024-01-17,701,gel pen,5,10,5,1,00031,India
734066,2024-01-17,703,eraser,1,3,2,1,00031,India
734066,2024-01-17,711,TD kit,150,300,150,1,00031,India
119622,2024-01-17,713,ball pen,5,10,5,1,00407,India
119622,2024-01-17,714,carbon paper,15,30,15,1,00407,India
119622,2024-01-17,715,folder,5,15,10,1,00407,India
119622,2024-01-17,706,sharpener,3,8,5,1,00407,India
967239,2024-01-17,705,stencil,10,20,10,1,00365,India
967239,2024-01-17,713,ball pen,5,10,5,1,00365,India
967239,2024-01-17,714,carbon paper,15,30,15,1,00365,India
839337,2024-01-17,706,sharpener,3,8,5,1,00301,India
839337,2024-01-17,702,pencil,2,5,3,1,00301,India
839337,2024-01-17,701,gel pen,5,10,5,1,00301,India
391758,2024-01-17,717,spiral bound book,50,100,50,1,00198,India
929911,2024-01-17,711,TD kit,150,300,150,1,00045,India
107216,2024-01-17,707,marker,20,40,20,1,00006,India
107216,2024-01-17,708,sketchpen,15,40,25,1,00006,India
107216,2024-01-17,714,carbon paper,15,30,15,1,00006,India
107216,2024-01-17,712,graph paper,20,40,20,1,00006,India
651567,2024-01-17,706,sharpener,3,8,5,1,00295,India
651567,2024-01-17,708,sketchpen,15,40,25,1,00295,India
651567,2024-01-17,701,gel pen,5,10,5,1,00295,India
651567,2024-01-17,703,eraser,1,3,2,1,00295,India
651567,2024-01-17,714,carbon paper,15,30,15,1,00295,India
105901,2024-01-17,703,eraser,1,3,2,1,00069,India
105901,2024-01-17,704,scale,5,10,5,1,00069,India
105901,2024-01-17,717,spiral bound book,50,100,50,1,00069,India
105901,2024-01-17,716,printing paper,200,400,200,1,00069,India
422337,2024-01-17,710,geometry box,100,150,50,1,00448,India
422337,2024-01-17,708,sketchpen,15,40,25,1,00448,India
422337,2024-01-17,716,printing paper,200,400,200,1,00448,India
422337,2024-01-17,712,graph paper,20,40,20,1,00448,India
422337,2024-01-17,715,folder,5,15,10,1,00448,India
160450,2024-01-17,710,geometry box,100,150,50,1,00318,India
160450,2024-01-17,701,gel pen,5,10,5,1,00318,India
160450,2024-01-17,708,sketchpen,15,40,25,1,00318,India
160450,2024-01-17,702,pencil,2,5,3,1,00318,India
230792,2024-01-17,708,sketchpen,15,40,25,1,00494,India
139773,2024-01-17,713,ball pen,5,10,5,1,00400,India
139773,2024-01-17,717,spiral bound book,50,100,50,1,00400,India
139773,2024-01-17,707,marker,20,40,20,1,00400,India
139773,2024-01-17,704,scale,5,10,5,1,00400,India
649364,2024-01-17,710,geometry box,100,150,50,1,00124,India
218828,2024-01-17,709,notebook,30,60,30,1,00287,India
218828,2024-01-17,714,carbon paper,15,30,15,1,00287,India
218828,2024-01-17,707,marker,20,40,20,1,00287,India
218828,2024-01-17,717,spiral bound book,50,100,50,1,00287,India
969892,2024-01-17,707,marker,20,40,20,1,00352,India
969892,2024-01-17,713,ball pen,5,10,5,1,00352,India
969892,2024-01-17,709,notebook,30,60,30,1,00352,India
886121,2024-01-17,703,eraser,1,3,2,1,00305,India
886121,2024-01-17,714,carbon paper,15,30,15,1,00305,India
886121,2024-01-17,711,TD kit,150,300,150,1,00305,India
886121,2024-01-17,712,graph paper,20,40,20,1,00305,India
901772,2024-01-17,709,notebook,30,60,30,1,00300,India
901772,2024-01-17,701,gel pen,5,10,5,1,00300,India
901772,2024-01-17,711,TD kit,150,300,150,1,00300,India
264572,2024-01-17,705,stencil,10,20,10,1,00056,India
264572,2024-01-17,702,pencil,2,5,3,1,00056,India
264572,2024-01-17,701,gel pen,5,10,5,1,00056,India
264572,2024-01-17,703,eraser,1,3,2,1,00056,India
234500,2024-01-17,707,marker,20,40,20,1,00493,India
234500,2024-01-17,711,TD kit,150,300,150,1,00493,India
366800,2024-01-17,701,gel pen,5,10,5,1,00300,India
366800,2024-01-17,706,sharpener,3,8,5,1,00300,India
366800,2024-01-17,709,notebook,30,60,30,1,00300,India
366800,2024-01-17,703,eraser,1,3,2,1,00300,India
366800,2024-01-17,716,printing paper,200,400,200,1,00300,India
989454,2024-01-17,714,carbon paper,15,30,15,1,00365,India
989454,2024-01-17,701,gel pen,5,10,5,1,00365,India
989454,2024-01-17,715,folder,5,15,10,1,00365,India
989454,2024-01-17,704,scale,5,10,5,1,00365,India
211946,2024-01-17,714,carbon paper,15,30,15,1,00242,India
189249,2024-01-17,714,carbon paper,15,30,15,1,00059,India
189249,2024-01-17,703,eraser,1,3,2,1,00059,India
333504,2024-01-17,703,eraser,1,3,2,1,00387,India
333504,2024-01-17,710,geometry box,100,150,50,1,00387,India
333504,2024-01-17,715,folder,5,15,10,1,00387,India
333504,2024-01-17,708,sketchpen,15,40,25,1,00387,India
333504,2024-01-17,716,printing paper,200,400,200,1,00387,India
444636,2024-01-17,705,stencil,10,20,10,1,00130,India
444636,2024-01-17,706,sharpener,3,8,5,1,00130,India
444636,2024-01-17,701,gel pen,5,10,5,1,00130,India
444636,2024-01-17,714,carbon paper,15,30,15,1,00130,India
577738,2024-01-17,713,ball pen,5,10,5,1,00020,India
839673,2024-01-17,714,carbon paper,15,30,15,1,00395,India
839673,2024-01-17,705,stencil,10,20,10,1,00395,India
978559,2024-01-18,716,printing paper,200,400,200,1,00333,India
978559,2024-01-18,705,stencil,10,20,10,1,00333,India
978559,2024-01-18,704,scale,5,10,5,1,00333,India
978559,2024-01-18,707,marker,20,40,20,1,00333,India
827062,2024-01-18,705,stencil,10,20,10,1,00065,India
827062,2024-01-18,703,eraser,1,3,2,1,00065,India
827062,2024-01-18,701,gel pen,5,10,5,1,00065,India
827062,2024-01-18,702,pencil,2,5,3,1,00065,India
869825,2024-01-18,712,graph paper,20,40,20,1,00165,India
869825,2024-01-18,704,scale,5,10,5,1,00165,India
869825,2024-01-18,706,sharpener,3,8,5,1,00165,India
290718,2024-01-18,707,marker,20,40,20,1,00092,India
290718,2024-01-18,709,notebook,30,60,30,1,00092,India
290718,2024-01-18,716,printing paper,200,400,200,1,00092,India
290718,2024-01-18,717,spiral bound book,50,100,50,1,00092,India
290718,2024-01-18,711,TD kit,150,300,150,1,00092,India
230376,2024-01-18,703,eraser,1,3,2,1,00484,India
230376,2024-01-18,712,graph paper,20,40,20,1,00484,India
239686,2024-01-18,708,sketchpen,15,40,25,1,00245,India
239686,2024-01-18,707,marker,20,40,20,1,00245,India
239686,2024-01-18,705,stencil,10,20,10,1,00245,India
333962,2024-01-18,701,gel pen,5,10,5,1,00141,India
333962,2024-01-18,702,pencil,2,5,3,1,00141,India
826166,2024-01-18,710,geometry box,100,150,50,1,00096,India
826166,2024-01-18,715,folder,5,15,10,1,00096,India
826166,2024-01-18,714,carbon paper,15,30,15,1,00096,India
826166,2024-01-18,708,sketchpen,15,40,25,1,00096,India
826166,2024-01-18,706,sharpener,3,8,5,1,00096,India
992482,2024-01-18,715,folder,5,15,10,1,00203,India
992482,2024-01-18,716,printing paper,200,400,200,1,00203,India
992482,2024-01-18,705,stencil,10,20,10,1,00203,India
138624,2024-01-18,706,sharpener,3,8,5,1,00178,India
138624,2024-01-18,710,geometry box,100,150,50,1,00178,India
592926,2024-01-18,714,carbon paper,15,30,15,1,00456,India
592926,2024-01-18,708,sketchpen,15,40,25,1,00456,India
532660,2024-01-18,707,marker,20,40,20,1,00480,India
532660,2024-01-18,702,pencil,2,5,3,1,00480,India
532660,2024-01-18,709,notebook,30,60,30,1,00480,India
532660,2024-01-18,701,gel pen,5,10,5,1,00480,India
414306,2024-01-18,703,eraser,1,3,2,1,00005,India
414306,2024-01-18,717,spiral bound book,50,100,50,1,00005,India
906798,2024-01-18,708,sketchpen,15,40,25,1,00165,India
483005,2024-01-18,701,gel pen,5,10,5,1,00305,India
483005,2024-01-18,704,scale,5,10,5,1,00305,India
483005,2024-01-18,702,pencil,2,5,3,1,00305,India
483005,2024-01-18,714,carbon paper,15,30,15,1,00305,India
483005,2024-01-18,709,notebook,30,60,30,1,00305,India
903591,2024-01-18,714,carbon paper,15,30,15,1,00150,India
903591,2024-01-18,701,gel pen,5,10,5,1,00150,India
626199,2024-01-18,710,geometry box,100,150,50,1,00190,India
626199,2024-01-18,705,stencil,10,20,10,1,00190,India
626199,2024-01-18,716,printing paper,200,400,200,1,00190,India
392868,2024-01-18,707,marker,20,40,20,1,00133,India
392868,2024-01-18,708,sketchpen,15,40,25,1,00133,India
392868,2024-01-18,717,spiral bound book,50,100,50,1,00133,India
392868,2024-01-18,703,eraser,1,3,2,1,00133,India
927543,2024-01-18,704,scale,5,10,5,1,00295,India
927543,2024-01-18,702,pencil,2,5,3,1,00295,India
927543,2024-01-18,706,sharpener,3,8,5,1,00295,India
415506,2024-01-18,704,scale,5,10,5,1,00302,India
415506,2024-01-18,713,ball pen,5,10,5,1,00302,India
175759,2024-01-18,709,notebook,30,60,30,1,00383,India
175759,2024-01-18,701,gel pen,5,10,5,1,00383,India
175759,2024-01-18,714,carbon paper,15,30,15,1,00383,India
175759,2024-01-18,713,ball pen,5,10,5,1,00383,India
709722,2024-01-18,714,carbon paper,15,30,15,1,00026,India
878206,2024-01-18,713,ball pen,5,10,5,1,00120,India
878206,2024-01-18,703,eraser,1,3,2,1,00120,India
878206,2024-01-18,702,pencil,2,5,3,1,00120,India
878206,2024-01-18,704,scale,5,10,5,1,00120,India
888124,2024-01-18,709,notebook,30,60,30,1,00500,India
888124,2024-01-18,702,pencil,2,5,3,1,00500,India
888124,2024-01-18,705,stencil,10,20,10,1,00500,India
896120,2024-01-18,713,ball pen,5,10,5,1,00293,India
170753,2024-01-18,709,notebook,30,60,30,1,00405,India
170753,2024-01-18,706,sharpener,3,8,5,1,00405,India
170753,2024-01-18,707,marker,20,40,20,1,00405,India
170753,2024-01-18,715,folder,5,15,10,1,00405,India
574495,2024-01-18,706,sharpener,3,8,5,1,00436,India
574495,2024-01-18,707,marker,20,40,20,1,00436,India
398774,2024-01-18,716,printing paper,200,400,200,1,00001,India
398774,2024-01-18,710,geometry box,100,150,50,1,00001,India
528863,2024-01-18,717,spiral bound book,50,100,50,1,00464,India
580061,2024-01-18,712,graph paper,20,40,20,1,00427,India
580061,2024-01-18,706,sharpener,3,8,5,1,00427,India
580061,2024-01-18,707,marker,20,40,20,1,00427,India
486026,2024-01-18,712,graph paper,20,40,20,1,00477,India
486026,2024-01-18,711,TD kit,150,300,150,1,00477,India
454297,2024-01-18,717,spiral bound book,50,100,50,1,00009,India
454297,2024-01-18,713,ball pen,5,10,5,1,00009,India
454297,2024-01-18,704,scale,5,10,5,1,00009,India
454297,2024-01-18,711,TD kit,150,300,150,1,00009,India
435936,2024-01-18,713,ball pen,5,10,5,1,00185,India
435936,2024-01-18,702,pencil,2,5,3,1,00185,India
435936,2024-01-18,716,printing paper,200,400,200,1,00185,India
435936,2024-01-18,709,notebook,30,60,30,1,00185,India
107372,2024-01-18,711,TD kit,150,300,150,1,00471,India
107372,2024-01-18,715,folder,5,15,10,1,00471,India
107372,2024-01-18,707,marker,20,40,20,1,00471,India
107372,2024-01-18,701,gel pen,5,10,5,1,00471,India
354611,2024-01-18,708,sketchpen,15,40,25,1,00349,India
341990,2024-01-18,716,printing paper,200,400,200,1,00381,India
341990,2024-01-18,702,pencil,2,5,3,1,00381,India
843782,2024-01-18,707,marker,20,40,20,1,00098,India
843782,2024-01-18,708,sketchpen,15,40,25,1,00098,India
417034,2024-01-18,707,marker,20,40,20,1,00344,India
417034,2024-01-18,701,gel pen,5,10,5,1,00344,India
417034,2024-01-18,703,eraser,1,3,2,1,00344,India
417034,2024-01-18,710,geometry box,100,150,50,1,00344,India
785441,2024-01-18,717,spiral bound book,50,100,50,1,00123,India
785441,2024-01-18,710,geometry box,100,150,50,1,00123,India
785441,2024-01-18,703,eraser,1,3,2,1,00123,India
785441,2024-01-18,711,TD kit,150,300,150,1,00123,India
693843,2024-01-18,706,sharpener,3,8,5,1,00129,India
129544,2024-01-18,704,scale,5,10,5,1,00402,India
129544,2024-01-18,702,pencil,2,5,3,1,00402,India
129544,2024-01-18,707,marker,20,40,20,1,00402,India
359376,2024-01-18,705,stencil,10,20,10,1,00488,India
359376,2024-01-18,703,eraser,1,3,2,1,00488,India
359376,2024-01-18,707,marker,20,40,20,1,00488,India
359376,2024-01-18,715,folder,5,15,10,1,00488,India
678513,2024-01-18,710,geometry box,100,150,50,1,00288,India
678513,2024-01-18,709,notebook,30,60,30,1,00288,India
678513,2024-01-18,705,stencil,10,20,10,1,00288,India
250768,2024-01-18,702,pencil,2,5,3,1,00266,India
250768,2024-01-18,701,gel pen,5,10,5,1,00266,India
250768,2024-01-18,704,scale,5,10,5,1,00266,India
250768,2024-01-18,703,eraser,1,3,2,1,00266,India
250768,2024-01-18,705,stencil,10,20,10,1,00266,India
512378,2024-01-18,715,folder,5,15,10,1,00244,India
512378,2024-01-18,705,stencil,10,20,10,1,00244,India
386602,2024-01-18,710,geometry box,100,150,50,1,00129,India
441303,2024-01-18,704,scale,5,10,5,1,00256,India
441303,2024-01-18,706,sharpener,3,8,5,1,00256,India
441303,2024-01-18,709,notebook,30,60,30,1,00256,India
441303,2024-01-18,717,spiral bound book,50,100,50,1,00256,India
441303,2024-01-18,714,carbon paper,15,30,15,1,00256,India
845844,2024-01-18,703,eraser,1,3,2,1,00062,India
845844,2024-01-18,711,TD kit,150,300,150,1,00062,India
845844,2024-01-18,714,carbon paper,15,30,15,1,00062,India
845844,2024-01-18,701,gel pen,5,10,5,1,00062,India
845844,2024-01-18,712,graph paper,20,40,20,1,00062,India
400040,2024-01-18,701,gel pen,5,10,5,1,00483,India
851530,2024-01-19,717,spiral bound book,50,100,50,1,00496,India
851530,2024-01-19,715,folder,5,15,10,1,00496,India
407172,2024-01-19,703,eraser,1,3,2,1,00057,India
407172,2024-01-19,715,folder,5,15,10,1,00057,India
628177,2024-01-19,711,TD kit,150,300,150,1,00008,India
379246,2024-01-19,712,graph paper,20,40,20,1,00210,India
379246,2024-01-19,714,carbon paper,15,30,15,1,00210,India
379246,2024-01-19,711,TD kit,150,300,150,1,00210,India
260910,2024-01-19,716,printing paper,200,400,200,1,00032,India
260910,2024-01-19,711,TD kit,150,300,150,1,00032,India
384239,2024-01-19,714,carbon paper,15,30,15,1,00058,India
384239,2024-01-19,715,folder,5,15,10,1,00058,India
384239,2024-01-19,709,notebook,30,60,30,1,00058,India
384239,2024-01-19,705,stencil,10,20,10,1,00058,India
384239,2024-01-19,711,TD kit,150,300,150,1,00058,India
620575,2024-01-19,710,geometry box,100,150,50,1,00178,India
620575,2024-01-19,713,ball pen,5,10,5,1,00178,India
620575,2024-01-19,712,graph paper,20,40,20,1,00178,India
620575,2024-01-19,709,notebook,30,60,30,1,00178,India
620575,2024-01-19,714,carbon paper,15,30,15,1,00178,India
836214,2024-01-19,702,pencil,2,5,3,1,00356,India
836214,2024-01-19,713,ball pen,5,10,5,1,00356,India
305900,2024-01-19,703,eraser,1,3,2,1,00030,India
305900,2024-01-19,711,TD kit,150,300,150,1,00030,India
305900,2024-01-19,713,ball pen,5,10,5,1,00030,India
471374,2024-01-19,704,scale,5,10,5,1,00497,India
471374,2024-01-19,710,geometry box,100,150,50,1,00497,India
552595,2024-01-19,717,spiral bound book,50,100,50,1,00453,India
552595,2024-01-19,702,pencil,2,5,3,1,00453,India
552595,2024-01-19,713,ball pen,5,10,5,1,00453,India
552595,2024-01-19,709,notebook,30,60,30,1,00453,India
552595,2024-01-19,704,scale,5,10,5,1,00453,India
269732,2024-01-19,706,sharpener,3,8,5,1,00322,India
269732,2024-01-19,712,graph paper,20,40,20,1,00322,India
269732,2024-01-19,702,pencil,2,5,3,1,00322,India
838018,2024-01-19,717,spiral bound book,50,100,50,1,00471,India
838018,2024-01-19,712,graph paper,20,40,20,1,00471,India
838018,2024-01-19,711,TD kit,150,300,150,1,00471,India
838018,2024-01-19,705,stencil,10,20,10,1,00471,India
567217,2024-01-19,701,gel pen,5,10,5,1,00262,India
567217,2024-01-19,711,TD kit,150,300,150,1,00262,India
567217,2024-01-19,704,scale,5,10,5,1,00262,India
567217,2024-01-19,714,carbon paper,15,30,15,1,00262,India
696096,2024-01-19,706,sharpener,3,8,5,1,00209,India
696096,2024-01-19,702,pencil,2,5,3,1,00209,India
696096,2024-01-19,707,marker,20,40,20,1,00209,India
929330,2024-01-19,709,notebook,30,60,30,1,00134,India
929330,2024-01-19,717,spiral bound book,50,100,50,1,00134,India
929330,2024-01-19,707,marker,20,40,20,1,00134,India
929330,2024-01-19,715,folder,5,15,10,1,00134,India
929330,2024-01-19,706,sharpener,3,8,5,1,00134,India
448534,2024-01-19,717,spiral bound book,50,100,50,1,00499,India
584659,2024-01-19,705,stencil,10,20,10,1,00415,India
101871,2024-01-19,708,sketchpen,15,40,25,1,00059,India
798957,2024-01-19,704,scale,5,10,5,1,00169,India
845277,2024-01-19,714,carbon paper,15,30,15,1,00087,India
845277,2024-01-19,707,marker,20,40,20,1,00087,India
768054,2024-01-19,705,stencil,10,20,10,1,00016,India
768054,2024-01-19,715,folder,5,15,10,1,00016,India
768054,2024-01-19,711,TD kit,150,300,150,1,00016,India
290065,2024-01-19,716,printing paper,200,400,200,1,00301,India
290065,2024-01-19,705,stencil,10,20,10,1,00301,India
532410,2024-01-19,716,printing paper,200,400,200,1,00378,India
532410,2024-01-19,704,scale,5,10,5,1,00378,India
532410,2024-01-19,709,notebook,30,60,30,1,00378,India
958589,2024-01-19,717,spiral bound book,50,100,50,1,00424,India
958589,2024-01-19,715,folder,5,15,10,1,00424,India
958589,2024-01-19,709,notebook,30,60,30,1,00424,India
958589,2024-01-19,711,TD kit,150,300,150,1,00424,India
958589,2024-01-19,706,sharpener,3,8,5,1,00424,India
376788,2024-01-19,717,spiral bound book,50,100,50,1,00069,India
420394,2024-01-19,706,sharpener,3,8,5,1,00235,India
420394,2024-01-19,717,spiral bound book,50,100,50,1,00235,India
420394,2024-01-19,701,gel pen,5,10,5,1,00235,India
420394,2024-01-19,711,TD kit,150,300,150,1,00235,India
241556,2024-01-19,703,eraser,1,3,2,1,00033,India
241556,2024-01-19,712,graph paper,20,40,20,1,00033,India
897425,2024-01-19,707,marker,20,40,20,1,00157,India
897425,2024-01-19,702,pencil,2,5,3,1,00157,India
897425,2024-01-19,708,sketchpen,15,40,25,1,00157,India
566981,2024-01-19,705,stencil,10,20,10,1,00033,India
566981,2024-01-19,717,spiral bound book,50,100,50,1,00033,India
566981,2024-01-19,716,printing paper,200,400,200,1,00033,India
486653,2024-01-19,706,sharpener,3,8,5,1,00422,India
486653,2024-01-19,713,ball pen,5,10,5,1,00422,India
486653,2024-01-19,710,geometry box,100,150,50,1,00422,India
486653,2024-01-19,701,gel pen,5,10,5,1,00422,India
315728,2024-01-19,713,ball pen,5,10,5,1,00163,India
315728,2024-01-19,707,marker,20,40,20,1,00163,India
315728,2024-01-19,702,pencil,2,5,3,1,00163,India
315728,2024-01-19,717,spiral bound book,50,100,50,1,00163,India
315728,2024-01-19,710,geometry box,100,150,50,1,00163,India
152323,2024-01-19,710,geometry box,100,150,50,1,00108,India
584502,2024-01-19,709,notebook,30,60,30,1,00476,India
584502,2024-01-19,706,sharpener,3,8,5,1,00476,India
166025,2024-01-19,701,gel pen,5,10,5,1,00019,India
166025,2024-01-19,717,spiral bound book,50,100,50,1,00019,India
166025,2024-01-19,714,carbon paper,15,30,15,1,00019,India
166025,2024-01-19,713,ball pen,5,10,5,1,00019,India
978184,2024-01-19,703,eraser,1,3,2,1,00116,India
978184,2024-01-19,704,scale,5,10,5,1,00116,India
978184,2024-01-19,709,notebook,30,60,30,1,00116,India
848829,2024-01-19,713,ball pen,5,10,5,1,00057,India
811313,2024-01-19,705,stencil,10,20,10,1,00349,India
811313,2024-01-19,715,folder,5,15,10,1,00349,India
811313,2024-01-19,717,spiral bound book,50,100,50,1,00349,India
811313,2024-01-19,701,gel pen,5,10,5,1,00349,India
811313,2024-01-19,703,eraser,1,3,2,1,00349,India
940153,2024-01-20,711,TD kit,150,300,150,1,00290,India
940153,2024-01-20,704,scale,5,10,5,1,00290,India
940153,2024-01-20,708,sketchpen,15,40,25,1,00290,India
406938,2024-01-20,716,printing paper,200,400,200,1,00435,India
406938,2024-01-20,705,stencil,10,20,10,1,00435,India
406938,2024-01-20,709,notebook,30,60,30,1,00435,India
204852,2024-01-20,707,marker,20,40,20,1,00471,India
204852,2024-01-20,701,gel pen,5,10,5,1,00471,India
204852,2024-01-20,715,folder,5,15,10,1,00471,India
575408,2024-01-20,701,gel pen,5,10,5,1,00433,India
575408,2024-01-20,706,sharpener,3,8,5,1,00433,India
375665,2024-01-20,712,graph paper,20,40,20,1,00225,India
375665,2024-01-20,714,carbon paper,15,30,15,1,00225,India
375665,2024-01-20,716,printing paper,200,400,200,1,00225,India
108084,2024-01-20,716,printing paper,200,400,200,1,00273,India
768051,2024-01-20,713,ball pen,5,10,5,1,00464,India
768051,2024-01-20,714,carbon paper,15,30,15,1,00464,India
768051,2024-01-20,704,scale,5,10,5,1,00464,India
768051,2024-01-20,701,gel pen,5,10,5,1,00464,India
454316,2024-01-20,717,spiral bound book,50,100,50,1,00018,India
454316,2024-01-20,704,scale,5,10,5,1,00018,India
167724,2024-01-20,717,spiral bound book,50,100,50,1,00158,India
144554,2024-01-20,710,geometry box,100,150,50,1,00171,India
144554,2024-01-20,709,notebook,30,60,30,1,00171,India
144554,2024-01-20,715,folder,5,15,10,1,00171,India
144554,2024-01-20,703,eraser,1,3,2,1,00171,India
144554,2024-01-20,708,sketchpen,15,40,25,1,00171,India
825483,2024-01-20,712,graph paper,20,40,20,1,00418,India
209316,2024-01-20,701,gel pen,5,10,5,1,00006,India
721497,2024-01-20,715,folder,5,15,10,1,00491,India
721497,2024-01-20,705,stencil,10,20,10,1,00491,India
721497,2024-01-20,716,printing paper,200,400,200,1,00491,India
349725,2024-01-20,711,TD kit,150,300,150,1,00107,India
349725,2024-01-20,714,carbon paper,15,30,15,1,00107,India
349725,2024-01-20,710,geometry box,100,150,50,1,00107,India
349725,2024-01-20,709,notebook,30,60,30,1,00107,India
778353,2024-01-20,708,sketchpen,15,40,25,1,00240,India
778353,2024-01-20,711,TD kit,150,300,150,1,00240,India
778353,2024-01-20,706,sharpener,3,8,5,1,00240,India
385228,2024-01-20,713,ball pen,5,10,5,1,00452,India
718287,2024-01-20,717,spiral bound book,50,100,50,1,00410,India
718287,2024-01-20,710,geometry box,100,150,50,1,00410,India
718287,2024-01-20,714,carbon paper,15,30,15,1,00410,India
718287,2024-01-20,708,sketchpen,15,40,25,1,00410,India
718287,2024-01-20,706,sharpener,3,8,5,1,00410,India
605042,2024-01-20,713,ball pen,5,10,5,1,00436,India
605042,2024-01-20,711,TD kit,150,300,150,1,00436,India
605042,2024-01-20,712,graph paper,20,40,20,1,00436,India
605042,2024-01-20,705,stencil,10,20,10,1,00436,India
349855,2024-01-20,709,notebook,30,60,30,1,00126,India
349855,2024-01-20,710,geometry box,100,150,50,1,00126,India
376521,2024-01-20,710,geometry box,100,150,50,1,00248,India
376521,2024-01-20,715,folder,5,15,10,1,00248,India
376521,2024-01-20,705,stencil,10,20,10,1,00248,India
376521,2024-01-20,717,spiral bound book,50,100,50,1,00248,India
156449,2024-01-20,701,gel pen,5,10,5,1,00497,India
156449,2024-01-20,714,carbon paper,15,30,15,1,00497,India
156449,2024-01-20,703,eraser,1,3,2,1,00497,India
156449,2024-01-20,709,notebook,30,60,30,1,00497,India
305771,2024-01-20,701,gel pen,5,10,5,1,00146,India
305771,2024-01-20,704,scale,5,10,5,1,00146,India
305771,2024-01-20,708,sketchpen,15,40,25,1,00146,India
451998,2024-01-20,710,geometry box,100,150,50,1,00251,India
982872,2024-01-20,713,ball pen,5,10,5,1,00424,India
982872,2024-01-20,711,TD kit,150,300,150,1,00424,India
982872,2024-01-20,716,printing paper,200,400,200,1,00424,India
757103,2024-01-20,706,sharpener,3,8,5,1,00484,India
757103,2024-01-20,712,graph paper,20,40,20,1,00484,India
303620,2024-01-20,713,ball pen,5,10,5,1,00261,India
303620,2024-01-20,705,stencil,10,20,10,1,00261,India
303620,2024-01-20,709,notebook,30,60,30,1,00261,India
150087,2024-01-20,712,graph paper,20,40,20,1,00500,India
150087,2024-01-20,710,geometry box,100,150,50,1,00500,India
150087,2024-01-20,713,ball pen,5,10,5,1,00500,India
150087,2024-01-20,717,spiral bound book,50,100,50,1,00500,India
839655,2024-01-20,702,pencil,2,5,3,1,00301,India
839655,2024-01-20,707,marker,20,40,20,1,00301,India
839655,2024-01-20,717,spiral bound book,50,100,50,1,00301,India
839655,2024-01-20,703,eraser,1,3,2,1,00301,India
913488,2024-01-20,707,marker,20,40,20,1,00033,India
913488,2024-01-20,703,eraser,1,3,2,1,00033,India
913488,2024-01-20,708,sketchpen,15,40,25,1,00033,India
913488,2024-01-20,711,TD kit,150,300,150,1,00033,India
519450,2024-01-20,703,eraser,1,3,2,1,00058,India
987892,2024-01-20,702,pencil,2,5,3,1,00230,India
723920,2024-01-20,703,eraser,1,3,2,1,00160,India
723920,2024-01-20,705,stencil,10,20,10,1,00160,India
723920,2024-01-20,709,notebook,30,60,30,1,00160,India
723920,2024-01-20,701,gel pen,5,10,5,1,00160,India
340760,2024-01-20,713,ball pen,5,10,5,1,00491,India
340760,2024-01-20,701,gel pen,5,10,5,1,00491,India
340760,2024-01-20,710,geometry box,100,150,50,1,00491,India
764703,2024-01-20,703,eraser,1,3,2,1,00399,India
764703,2024-01-20,706,sharpener,3,8,5,1,00399,India
764703,2024-01-20,709,notebook,30,60,30,1,00399,India
395584,2024-01-20,714,carbon paper,15,30,15,1,00194,India
395584,2024-01-20,702,pencil,2,5,3,1,00194,India
863449,2024-01-20,714,carbon paper,15,30,15,1,00056,India
863449,2024-01-20,713,ball pen,5,10,5,1,00056,India
863449,2024-01-20,715,folder,5,15,10,1,00056,India
833471,2024-01-20,703,eraser,1,3,2,1,00259,India
833471,2024-01-20,708,sketchpen,15,40,25,1,00259,India
833471,2024-01-20,717,spiral bound book,50,100,50,1,00259,India
833471,2024-01-20,713,ball pen,5,10,5,1,00259,India
695724,2024-01-20,703,eraser,1,3,2,1,00224,India
695724,2024-01-20,708,sketchpen,15,40,25,1,00224,India
695724,2024-01-20,702,pencil,2,5,3,1,00224,India
695724,2024-01-20,717,spiral bound book,50,100,50,1,00224,India
106273,2024-01-20,714,carbon paper,15,30,15,1,00489,India
106273,2024-01-20,716,printing paper,200,400,200,1,00489,India
106273,2024-01-20,702,pencil,2,5,3,1,00489,India
355071,2024-01-20,705,stencil,10,20,10,1,00208,India
355071,2024-01-20,709,notebook,30,60,30,1,00208,India
355071,2024-01-20,711,TD kit,150,300,150,1,00208,India
359997,2024-01-20,714,carbon paper,15,30,15,1,00141,India
359997,2024-01-20,709,notebook,30,60,30,1,00141,India
359997,2024-01-20,703,eraser,1,3,2,1,00141,India
610605,2024-01-20,703,eraser,1,3,2,1,00212,India
610605,2024-01-20,711,TD kit,150,300,150,1,00212,India
610605,2024-01-20,702,pencil,2,5,3,1,00212,India
610605,2024-01-20,701,gel pen,5,10,5,1,00212,India
807263,2024-01-20,710,geometry box,100,150,50,1,00436,India
807263,2024-01-20,706,sharpener,3,8,5,1,00436,India
807263,2024-01-20,707,marker,20,40,20,1,00436,India
807263,2024-01-20,708,sketchpen,15,40,25,1,00436,India
451609,2024-01-20,717,spiral bound book,50,100,50,1,00444,India
451609,2024-01-20,707,marker,20,40,20,1,00444,India
451609,2024-01-20,711,TD kit,150,300,150,1,00444,India
451609,2024-01-20,716,printing paper,200,400,200,1,00444,India
241131,2024-01-20,717,spiral bound book,50,100,50,1,00321,India
241131,2024-01-20,715,folder,5,15,10,1,00321,India
241131,2024-01-20,709,notebook,30,60,30,1,00321,India
241131,2024-01-20,704,scale,5,10,5,1,00321,India
453548,2024-01-21,701,gel pen,5,10,5,1,00453,India
672198,2024-01-21,713,ball pen,5,10,5,1,00248,India
672198,2024-01-21,704,scale,5,10,5,1,00248,India
672198,2024-01-21,711,TD kit,150,300,150,1,00248,India
611365,2024-01-21,702,pencil,2,5,3,1,00387,India
611365,2024-01-21,706,sharpener,3,8,5,1,00387,India
472538,2024-01-21,711,TD kit,150,300,150,1,00343,India
704424,2024-01-21,709,notebook,30,60,30,1,00232,India
704424,2024-01-21,710,geometry box,100,150,50,1,00232,India
704424,2024-01-21,715,folder,5,15,10,1,00232,India
704424,2024-01-21,704,scale,5,10,5,1,00232,India
697877,2024-01-21,711,TD kit,150,300,150,1,00091,India
697877,2024-01-21,701,gel pen,5,10,5,1,00091,India
321104,2024-01-21,711,TD kit,150,300,150,1,00105,India
880683,2024-01-21,712,graph paper,20,40,20,1,00256,India
880683,2024-01-21,708,sketchpen,15,40,25,1,00256,India
547639,2024-01-21,712,graph paper,20,40,20,1,00285,India
547639,2024-01-21,713,ball pen,5,10,5,1,00285,India
547639,2024-01-21,701,gel pen,5,10,5,1,00285,India
547639,2024-01-21,716,printing paper,200,400,200,1,00285,India
698607,2024-01-21,702,pencil,2,5,3,1,00149,India
698607,2024-01-21,708,sketchpen,15,40,25,1,00149,India
602065,2024-01-21,703,eraser,1,3,2,1,00017,India
602065,2024-01-21,711,TD kit,150,300,150,1,00017,India
602065,2024-01-21,713,ball pen,5,10,5,1,00017,India
602065,2024-01-21,709,notebook,30,60,30,1,00017,India
602065,2024-01-21,717,spiral bound book,50,100,50,1,00017,India
629991,2024-01-21,714,carbon paper,15,30,15,1,00081,India
629991,2024-01-21,717,spiral bound book,50,100,50,1,00081,India
629991,2024-01-21,712,graph paper,20,40,20,1,00081,India
488671,2024-01-21,702,pencil,2,5,3,1,00156,India
488671,2024-01-21,714,carbon paper,15,30,15,1,00156,India
488671,2024-01-21,704,scale,5,10,5,1,00156,India
259546,2024-01-21,708,sketchpen,15,40,25,1,00207,India
259546,2024-01-21,717,spiral bound book,50,100,50,1,00207,India
259546,2024-01-21,716,printing paper,200,400,200,1,00207,India
299043,2024-01-21,701,gel pen,5,10,5,1,00269,India
299043,2024-01-21,716,printing paper,200,400,200,1,00269,India
299043,2024-01-21,714,carbon paper,15,30,15,1,00269,India
299043,2024-01-21,712,graph paper,20,40,20,1,00269,India
830208,2024-01-21,702,pencil,2,5,3,1,00480,India
830208,2024-01-21,704,scale,5,10,5,1,00480,India
830208,2024-01-21,713,ball pen,5,10,5,1,00480,India
830208,2024-01-21,707,marker,20,40,20,1,00480,India
643428,2024-01-21,712,graph paper,20,40,20,1,00267,India
643428,2024-01-21,707,marker,20,40,20,1,00267,India
131998,2024-01-21,710,geometry box,100,150,50,1,00154,India
131998,2024-01-21,701,gel pen,5,10,5,1,00154,India
131998,2024-01-21,715,folder,5,15,10,1,00154,India
557610,2024-01-21,705,stencil,10,20,10,1,00395,India
557610,2024-01-21,708,sketchpen,15,40,25,1,00395,India
557610,2024-01-21,716,printing paper,200,400,200,1,00395,India
557610,2024-01-21,710,geometry box,100,150,50,1,00395,India
548442,2024-01-21,710,geometry box,100,150,50,1,00200,India
548442,2024-01-21,703,eraser,1,3,2,1,00200,India
113911,2024-01-21,708,sketchpen,15,40,25,1,00125,India
113911,2024-01-21,707,marker,20,40,20,1,00125,India
113911,2024-01-21,713,ball pen,5,10,5,1,00125,India
113911,2024-01-21,704,scale,5,10,5,1,00125,India
113911,2024-01-21,706,sharpener,3,8,5,1,00125,India
241684,2024-01-21,707,marker,20,40,20,1,00439,India
241684,2024-01-21,704,scale,5,10,5,1,00439,India
241684,2024-01-21,709,notebook,30,60,30,1,00439,India
241684,2024-01-21,708,sketchpen,15,40,25,1,00439,India
794031,2024-01-21,714,carbon paper,15,30,15,1,00425,India
794031,2024-01-21,703,eraser,1,3,2,1,00425,India
804420,2024-01-21,711,TD kit,150,300,150,1,00037,India
804420,2024-01-21,708,sketchpen,15,40,25,1,00037,India
804420,2024-01-21,703,eraser,1,3,2,1,00037,India
804420,2024-01-21,710,geometry box,100,150,50,1,00037,India
804420,2024-01-21,702,pencil,2,5,3,1,00037,India
700911,2024-01-21,709,notebook,30,60,30,1,00360,India
700911,2024-01-21,707,marker,20,40,20,1,00360,India
700911,2024-01-21,717,spiral bound book,50,100,50,1,00360,India
559950,2024-01-21,709,notebook,30,60,30,1,00227,India
559950,2024-01-21,702,pencil,2,5,3,1,00227,India
902462,2024-01-21,712,graph paper,20,40,20,1,00009,India
902462,2024-01-21,707,marker,20,40,20,1,00009,India
902462,2024-01-21,702,pencil,2,5,3,1,00009,India
902462,2024-01-21,714,carbon paper,15,30,15,1,00009,India
550962,2024-01-21,707,marker,20,40,20,1,00111,India
550962,2024-01-21,712,graph paper,20,40,20,1,00111,India
954555,2024-01-21,715,folder,5,15,10,1,00099,India
954555,2024-01-21,701,gel pen,5,10,5,1,00099,India
954555,2024-01-21,702,pencil,2,5,3,1,00099,India
195179,2024-01-21,704,scale,5,10,5,1,00394,India
195179,2024-01-21,712,graph paper,20,40,20,1,00394,India
313369,2024-01-21,711,TD kit,150,300,150,1,00131,India
270464,2024-01-21,714,carbon paper,15,30,15,1,00036,India
270464,2024-01-21,703,eraser,1,3,2,1,00036,India
270464,2024-01-21,706,sharpener,3,8,5,1,00036,India
270464,2024-01-21,702,pencil,2,5,3,1,00036,India
848353,2024-01-21,705,stencil,10,20,10,1,00356,India
848353,2024-01-21,713,ball pen,5,10,5,1,00356,India
848353,2024-01-21,706,sharpener,3,8,5,1,00356,India
848353,2024-01-21,709,notebook,30,60,30,1,00356,India
848353,2024-01-21,714,carbon paper,15,30,15,1,00356,India
156859,2024-01-21,713,ball pen,5,10,5,1,00347,India
114114,2024-01-21,714,carbon paper,15,30,15,1,00296,India
796382,2024-01-21,714,carbon paper,15,30,15,1,00235,India
796382,2024-01-21,708,sketchpen,15,40,25,1,00235,India
796382,2024-01-21,701,gel pen,5,10,5,1,00235,India
796382,2024-01-21,707,marker,20,40,20,1,00235,India
796382,2024-01-21,710,geometry box,100,150,50,1,00235,India
103479,2024-01-21,707,marker,20,40,20,1,00154,India
103479,2024-01-21,713,ball pen,5,10,5,1,00154,India
466337,2024-01-21,703,eraser,1,3,2,1,00384,India
466337,2024-01-21,705,stencil,10,20,10,1,00384,India
768654,2024-01-21,710,geometry box,100,150,50,1,00491,India
768654,2024-01-21,708,sketchpen,15,40,25,1,00491,India
768654,2024-01-21,707,marker,20,40,20,1,00491,India
768654,2024-01-21,717,spiral bound book,50,100,50,1,00491,India
464265,2024-01-21,715,folder,5,15,10,1,00314,India
112474,2024-01-21,701,gel pen,5,10,5,1,00194,India
112474,2024-01-21,703,eraser,1,3,2,1,00194,India
112474,2024-01-21,716,printing paper,200,400,200,1,00194,India
112474,2024-01-21,702,pencil,2,5,3,1,00194,India
858217,2024-01-22,710,geometry box,100,150,50,1,00442,India
937496,2024-01-22,705,stencil,10,20,10,1,00218,India
937496,2024-01-22,716,printing paper,200,400,200,1,00218,India
937496,2024-01-22,714,carbon paper,15,30,15,1,00218,India
921392,2024-01-22,709,notebook,30,60,30,1,00125,India
921392,2024-01-22,715,folder,5,15,10,1,00125,India
921392,2024-01-22,701,gel pen,5,10,5,1,00125,India
921392,2024-01-22,716,printing paper,200,400,200,1,00125,India
921392,2024-01-22,712,graph paper,20,40,20,1,00125,India
960578,2024-01-22,717,spiral bound book,50,100,50,1,00279,India
960578,2024-01-22,705,stencil,10,20,10,1,00279,India
960578,2024-01-22,710,geometry box,100,150,50,1,00279,India
960578,2024-01-22,716,printing paper,200,400,200,1,00279,India
268791,2024-01-22,715,folder,5,15,10,1,00237,India
268791,2024-01-22,711,TD kit,150,300,150,1,00237,India
268791,2024-01-22,707,marker,20,40,20,1,00237,India
313882,2024-01-22,716,printing paper,200,400,200,1,00428,India
313882,2024-01-22,703,eraser,1,3,2,1,00428,India
313882,2024-01-22,713,ball pen,5,10,5,1,00428,India
313882,2024-01-22,706,sharpener,3,8,5,1,00428,India
946113,2024-01-22,710,geometry box,100,150,50,1,00144,India
946113,2024-01-22,711,TD kit,150,300,150,1,00144,India
946113,2024-01-22,709,notebook,30,60,30,1,00144,India
946113,2024-01-22,702,pencil,2,5,3,1,00144,India
456384,2024-01-22,717,spiral bound book,50,100,50,1,00220,India
456384,2024-01-22,704,scale,5,10,5,1,00220,India
456384,2024-01-22,703,eraser,1,3,2,1,00220,India
456384,2024-01-22,707,marker,20,40,20,1,00220,India
456384,2024-01-22,716,printing paper,200,400,200,1,00220,India
806374,2024-01-22,704,scale,5,10,5,1,00017,India
806374,2024-01-22,708,sketchpen,15,40,25,1,00017,India
806374,2024-01-22,705,stencil,10,20,10,1,00017,India
806374,2024-01-22,714,carbon paper,15,30,15,1,00017,India
806374,2024-01-22,711,TD kit,150,300,150,1,00017,India
137414,2024-01-22,711,TD kit,150,300,150,1,00346,India
583126,2024-01-22,714,carbon paper,15,30,15,1,00258,India
214114,2024-01-22,714,carbon paper,15,30,15,1,00423,India
214114,2024-01-22,710,geometry box,100,150,50,1,00423,India
214114,2024-01-22,716,printing paper,200,400,200,1,00423,India
786378,2024-01-22,705,stencil,10,20,10,1,00068,India
786378,2024-01-22,711,TD kit,150,300,150,1,00068,India
270054,2024-01-22,709,notebook,30,60,30,1,00177,India
270054,2024-01-22,711,TD kit,150,300,150,1,00177,India
388803,2024-01-22,709,notebook,30,60,30,1,00394,India
388803,2024-01-22,706,sharpener,3,8,5,1,00394,India
388803,2024-01-22,713,ball pen,5,10,5,1,00394,India
388803,2024-01-22,716,printing paper,200,400,200,1,00394,India
383579,2024-01-22,711,TD kit,150,300,150,1,00018,India
467476,2024-01-22,712,graph paper,20,40,20,1,00376,India
467476,2024-01-22,717,spiral bound book,50,100,50,1,00376,India
467476,2024-01-22,714,carbon paper,15,30,15,1,00376,India
587502,2024-01-22,703,eraser,1,3,2,1,00312,India
587502,2024-01-22,714,carbon paper,15,30,15,1,00312,India
981295,2024-01-22,709,notebook,30,60,30,1,00153,India
738391,2024-01-22,704,scale,5,10,5,1,00441,India
738391,2024-01-22,713,ball pen,5,10,5,1,00441,India
738391,2024-01-22,701,gel pen,5,10,5,1,00441,India
738391,2024-01-22,714,carbon paper,15,30,15,1,00441,India
738391,2024-01-22,705,stencil,10,20,10,1,00441,India
835964,2024-01-22,702,pencil,2,5,3,1,00165,India
835964,2024-01-22,713,ball pen,5,10,5,1,00165,India
907693,2024-01-22,703,eraser,1,3,2,1,00174,India
907693,2024-01-22,715,folder,5,15,10,1,00174,India
907693,2024-01-22,707,marker,20,40,20,1,00174,India
907693,2024-01-22,711,TD kit,150,300,150,1,00174,India
907693,2024-01-22,702,pencil,2,5,3,1,00174,India
318116,2024-01-22,717,spiral bound book,50,100,50,1,00278,India
318116,2024-01-22,714,carbon paper,15,30,15,1,00278,India
318116,2024-01-22,710,geometry box,100,150,50,1,00278,India
318116,2024-01-22,712,graph paper,20,40,20,1,00278,India
318116,2024-01-22,701,gel pen,5,10,5,1,00278,India
136692,2024-01-22,705,stencil,10,20,10,1,00201,India
136692,2024-01-22,706,sharpener,3,8,5,1,00201,India
329233,2024-01-22,713,ball pen,5,10,5,1,00068,India
329233,2024-01-22,714,carbon paper,15,30,15,1,00068,India
329233,2024-01-22,709,notebook,30,60,30,1,00068,India
329233,2024-01-22,715,folder,5,15,10,1,00068,India
862323,2024-01-22,711,TD kit,150,300,150,1,00350,India
862323,2024-01-22,715,folder,5,15,10,1,00350,India
862323,2024-01-22,709,notebook,30,60,30,1,00350,India
551433,2024-01-22,711,TD kit,150,300,150,1,00040,India
551433,2024-01-22,714,carbon paper,15,30,15,1,00040,India
551433,2024-01-22,705,stencil,10,20,10,1,00040,India
551433,2024-01-22,708,sketchpen,15,40,25,1,00040,India
345781,2024-01-22,717,spiral bound book,50,100,50,1,00216,India
345781,2024-01-22,709,notebook,30,60,30,1,00216,India
345781,2024-01-22,713,ball pen,5,10,5,1,00216,India
345781,2024-01-22,701,gel pen,5,10,5,1,00216,India
260094,2024-01-22,716,printing paper,200,400,200,1,00084,India
260094,2024-01-22,714,carbon paper,15,30,15,1,00084,India
260094,2024-01-22,710,geometry box,100,150,50,1,00084,India
260094,2024-01-22,705,stencil,10,20,10,1,00084,India
928833,2024-01-22,717,spiral bound book,50,100,50,1,00419,India
928833,2024-01-22,713,ball pen,5,10,5,1,00419,India
928833,2024-01-22,711,TD kit,150,300,150,1,00419,India
948438,2024-01-22,716,printing paper,200,400,200,1,00019,India
948438,2024-01-22,708,sketchpen,15,40,25,1,00019,India
948438,2024-01-22,713,ball pen,5,10,5,1,00019,India
846898,2024-01-22,708,sketchpen,15,40,25,1,00202,India
846898,2024-01-22,714,carbon paper,15,30,15,1,00202,India
846898,2024-01-22,710,geometry box,100,150,50,1,00202,India
808621,2024-01-22,701,gel pen,5,10,5,1,00264,India
808621,2024-01-22,717,spiral bound book,50,100,50,1,00264,India
808621,2024-01-22,704,scale,5,10,5,1,00264,India
428700,2024-01-22,709,notebook,30,60,30,1,00056,India
428700,2024-01-22,701,gel pen,5,10,5,1,00056,India
428700,2024-01-22,713,ball pen,5,10,5,1,00056,India
905928,2024-01-22,703,eraser,1,3,2,1,00171,India
905928,2024-01-22,717,spiral bound book,50,100,50,1,00171,India
905928,2024-01-22,716,printing paper,200,400,200,1,00171,India
769432,2024-01-22,711,TD kit,150,300,150,1,00139,India
769432,2024-01-22,716,printing paper,200,400,200,1,00139,India
505923,2024-01-22,709,notebook,30,60,30,1,00286,India
505923,2024-01-22,707,marker,20,40,20,1,00286,India
505923,2024-01-22,712,graph paper,20,40,20,1,00286,India
995098,2024-01-22,704,scale,5,10,5,1,00159,India
995098,2024-01-22,705,stencil,10,20,10,1,00159,India
995098,2024-01-22,714,carbon paper,15,30,15,1,00159,India
549189,2024-01-22,702,pencil,2,5,3,1,00144,India
822810,2024-01-22,717,spiral bound book,50,100,50,1,00010,India
822810,2024-01-22,709,notebook,30,60,30,1,00010,India
651409,2024-01-22,715,folder,5,15,10,1,00100,India
651409,2024-01-22,710,geometry box,100,150,50,1,00100,India
651409,2024-01-22,704,scale,5,10,5,1,00100,India
971412,2024-01-22,706,sharpener,3,8,5,1,00162,India
971412,2024-01-22,710,geometry box,100,150,50,1,00162,India
971412,2024-01-22,701,gel pen,5,10,5,1,00162,India
884750,2024-01-22,717,spiral bound book,50,100,50,1,00457,India
884750,2024-01-22,708,sketchpen,15,40,25,1,00457,India
796733,2024-01-22,712,graph paper,20,40,20,1,00343,India
599712,2024-01-22,714,carbon paper,15,30,15,1,00338,India
599712,2024-01-22,717,spiral bound book,50,100,50,1,00338,India
599712,2024-01-22,704,scale,5,10,5,1,00338,India
107069,2024-01-22,711,TD kit,150,300,150,1,00120,India
107069,2024-01-22,709,notebook,30,60,30,1,00120,India
107069,2024-01-22,706,sharpener,3,8,5,1,00120,India
107069,2024-01-22,714,carbon paper,15,30,15,1,00120,India
885479,2024-01-22,715,folder,5,15,10,1,00473,India
885479,2024-01-22,702,pencil,2,5,3,1,00473,India
333757,2024-01-22,717,spiral bound book,50,100,50,1,00437,India
333757,2024-01-22,713,ball pen,5,10,5,1,00437,India
333757,2024-01-22,707,marker,20,40,20,1,00437,India
333757,2024-01-22,710,geometry box,100,150,50,1,00437,India
580538,2024-01-22,711,TD kit,150,300,150,1,00452,India
580538,2024-01-22,710,geometry box,100,150,50,1,00452,India
580538,2024-01-22,714,carbon paper,15,30,15,1,00452,India
658402,2024-01-22,713,ball pen,5,10,5,1,00335,India
658402,2024-01-22,711,TD kit,150,300,150,1,00335,India
432994,2024-01-23,715,folder,5,15,10,1,00450,India
432994,2024-01-23,706,sharpener,3,8,5,1,00450,India
998192,2024-01-23,703,eraser,1,3,2,1,00257,India
998192,2024-01-23,702,pencil,2,5,3,1,00257,India
998192,2024-01-23,710,geometry box,100,150,50,1,00257,India
998192,2024-01-23,701,gel pen,5,10,5,1,00257,India
924929,2024-01-23,702,pencil,2,5,3,1,00034,India
924929,2024-01-23,715,folder,5,15,10,1,00034,India
924929,2024-01-23,716,printing paper,200,400,200,1,00034,India
245920,2024-01-23,701,gel pen,5,10,5,1,00359,India
245920,2024-01-23,715,folder,5,15,10,1,00359,India
245920,2024-01-23,705,stencil,10,20,10,1,00359,India
245920,2024-01-23,716,printing paper,200,400,200,1,00359,India
264700,2024-01-23,717,spiral bound book,50,100,50,1,00364,India
853922,2024-01-23,715,folder,5,15,10,1,00114,India
853922,2024-01-23,713,ball pen,5,10,5,1,00114,India
853922,2024-01-23,711,TD kit,150,300,150,1,00114,India
351086,2024-01-23,709,notebook,30,60,30,1,00007,India
351086,2024-01-23,703,eraser,1,3,2,1,00007,India
983153,2024-01-23,710,geometry box,100,150,50,1,00246,India
331687,2024-01-23,716,printing paper,200,400,200,1,00255,India
331687,2024-01-23,711,TD kit,150,300,150,1,00255,India
331687,2024-01-23,709,notebook,30,60,30,1,00255,India
739232,2024-01-23,710,geometry box,100,150,50,1,00150,India
739232,2024-01-23,713,ball pen,5,10,5,1,00150,India
739232,2024-01-23,715,folder,5,15,10,1,00150,India
739232,2024-01-23,714,carbon paper,15,30,15,1,00150,India
226443,2024-01-23,713,ball pen,5,10,5,1,00500,India
226443,2024-01-23,708,sketchpen,15,40,25,1,00500,India
287574,2024-01-23,709,notebook,30,60,30,1,00475,India
287574,2024-01-23,712,graph paper,20,40,20,1,00475,India
287574,2024-01-23,710,geometry box,100,150,50,1,00475,India
287574,2024-01-23,713,ball pen,5,10,5,1,00475,India
762968,2024-01-23,707,marker,20,40,20,1,00145,India
640833,2024-01-23,716,printing paper,200,400,200,1,00186,India
640833,2024-01-23,702,pencil,2,5,3,1,00186,India
640833,2024-01-23,706,sharpener,3,8,5,1,00186,India
640833,2024-01-23,701,gel pen,5,10,5,1,00186,India
738830,2024-01-23,711,TD kit,150,300,150,1,00292,India
738830,2024-01-23,708,sketchpen,15,40,25,1,00292,India
974809,2024-01-23,707,marker,20,40,20,1,00211,India
974809,2024-01-23,702,pencil,2,5,3,1,00211,India
974809,2024-01-23,709,notebook,30,60,30,1,00211,India
762603,2024-01-23,714,carbon paper,15,30,15,1,00175,India
762603,2024-01-23,709,notebook,30,60,30,1,00175,India
762603,2024-01-23,710,geometry box,100,150,50,1,00175,India
762603,2024-01-23,712,graph paper,20,40,20,1,00175,India
762603,2024-01-23,711,TD kit,150,300,150,1,00175,India
610938,2024-01-23,704,scale,5,10,5,1,00146,India
610938,2024-01-23,716,printing paper,200,400,200,1,00146,India
610938,2024-01-23,712,graph paper,20,40,20,1,00146,India
610938,2024-01-23,714,carbon paper,15,30,15,1,00146,India
380055,2024-01-23,702,pencil,2,5,3,1,00291,India
380055,2024-01-23,714,carbon paper,15,30,15,1,00291,India
380055,2024-01-23,710,geometry box,100,150,50,1,00291,India
380055,2024-01-23,704,scale,5,10,5,1,00291,India
380055,2024-01-23,717,spiral bound book,50,100,50,1,00291,India
870010,2024-01-23,705,stencil,10,20,10,1,00089,India
870010,2024-01-23,711,TD kit,150,300,150,1,00089,India
923018,2024-01-23,711,TD kit,150,300,150,1,00293,India
923018,2024-01-23,701,gel pen,5,10,5,1,00293,India
923018,2024-01-23,705,stencil,10,20,10,1,00293,India
497365,2024-01-23,716,printing paper,200,400,200,1,00076,India
405385,2024-01-23,705,stencil,10,20,10,1,00250,India
405385,2024-01-23,713,ball pen,5,10,5,1,00250,India
405385,2024-01-23,706,sharpener,3,8,5,1,00250,India
451076,2024-01-23,717,spiral bound book,50,100,50,1,00494,India
451076,2024-01-23,708,sketchpen,15,40,25,1,00494,India
801801,2024-01-23,711,TD kit,150,300,150,1,00289,India
801801,2024-01-23,716,printing paper,200,400,200,1,00289,India
801801,2024-01-23,701,gel pen,5,10,5,1,00289,India
269884,2024-01-23,708,sketchpen,15,40,25,1,00031,India
269884,2024-01-23,711,TD kit,150,300,150,1,00031,India
513234,2024-01-23,710,geometry box,100,150,50,1,00271,India
513234,2024-01-23,709,notebook,30,60,30,1,00271,India
513234,2024-01-23,712,graph paper,20,40,20,1,00271,India
513234,2024-01-23,705,stencil,10,20,10,1,00271,India
449804,2024-01-23,702,pencil,2,5,3,1,00064,India
449804,2024-01-23,717,spiral bound book,50,100,50,1,00064,India
449804,2024-01-23,701,gel pen,5,10,5,1,00064,India
449804,2024-01-23,716,printing paper,200,400,200,1,00064,India
304712,2024-01-23,712,graph paper,20,40,20,1,00500,India
304712,2024-01-23,701,gel pen,5,10,5,1,00500,India
304712,2024-01-23,703,eraser,1,3,2,1,00500,India
304712,2024-01-23,715,folder,5,15,10,1,00500,India
939747,2024-01-23,707,marker,20,40,20,1,00219,India
939747,2024-01-23,702,pencil,2,5,3,1,00219,India
939747,2024-01-23,715,folder,5,15,10,1,00219,India
939747,2024-01-23,712,graph paper,20,40,20,1,00219,India
582686,2024-01-23,714,carbon paper,15,30,15,1,00464,India
238838,2024-01-23,702,pencil,2,5,3,1,00452,India
238838,2024-01-23,705,stencil,10,20,10,1,00452,India
238838,2024-01-23,701,gel pen,5,10,5,1,00452,India
238838,2024-01-23,717,spiral bound book,50,100,50,1,00452,India
472581,2024-01-24,705,stencil,10,20,10,1,00427,India
472581,2024-01-24,714,carbon paper,15,30,15,1,00427,India
472581,2024-01-24,711,TD kit,150,300,150,1,00427,India
472581,2024-01-24,716,printing paper,200,400,200,1,00427,India
562611,2024-01-24,707,marker,20,40,20,1,00333,India
562611,2024-01-24,701,gel pen,5,10,5,1,00333,India
562611,2024-01-24,709,notebook,30,60,30,1,00333,India
673690,2024-01-24,713,ball pen,5,10,5,1,00306,India
673690,2024-01-24,702,pencil,2,5,3,1,00306,India
673690,2024-01-24,701,gel pen,5,10,5,1,00306,India
673690,2024-01-24,714,carbon paper,15,30,15,1,00306,India
674699,2024-01-24,709,notebook,30,60,30,1,00025,India
674699,2024-01-24,703,eraser,1,3,2,1,00025,India
674699,2024-01-24,708,sketchpen,15,40,25,1,00025,India
291829,2024-01-24,706,sharpener,3,8,5,1,00418,India
291829,2024-01-24,701,gel pen,5,10,5,1,00418,India
291829,2024-01-24,703,eraser,1,3,2,1,00418,India
291829,2024-01-24,712,graph paper,20,40,20,1,00418,India
291829,2024-01-24,716,printing paper,200,400,200,1,00418,India
529138,2024-01-24,702,pencil,2,5,3,1,00416,India
785766,2024-01-24,702,pencil,2,5,3,1,00186,India
785766,2024-01-24,703,eraser,1,3,2,1,00186,India
747670,2024-01-24,717,spiral bound book,50,100,50,1,00443,India
747670,2024-01-24,715,folder,5,15,10,1,00443,India
747670,2024-01-24,714,carbon paper,15,30,15,1,00443,India
832267,2024-01-24,716,printing paper,200,400,200,1,00201,India
949856,2024-01-24,709,notebook,30,60,30,1,00368,India
949856,2024-01-24,714,carbon paper,15,30,15,1,00368,India
949856,2024-01-24,705,stencil,10,20,10,1,00368,India
949856,2024-01-24,712,graph paper,20,40,20,1,00368,India
377749,2024-01-24,708,sketchpen,15,40,25,1,00440,India
377749,2024-01-24,710,geometry box,100,150,50,1,00440,India
377749,2024-01-24,715,folder,5,15,10,1,00440,India
731183,2024-01-24,717,spiral bound book,50,100,50,1,00156,India
454688,2024-01-24,706,sharpener,3,8,5,1,00127,India
454688,2024-01-24,708,sketchpen,15,40,25,1,00127,India
706828,2024-01-24,704,scale,5,10,5,1,00166,India
706828,2024-01-24,710,geometry box,100,150,50,1,00166,India
706828,2024-01-24,706,sharpener,3,8,5,1,00166,India
706828,2024-01-24,703,eraser,1,3,2,1,00166,India
498619,2024-01-24,717,spiral bound book,50,100,50,1,00381,India
193561,2024-01-24,701,gel pen,5,10,5,1,00156,India
193561,2024-01-24,702,pencil,2,5,3,1,00156,India
193561,2024-01-24,711,TD kit,150,300,150,1,00156,India
193561,2024-01-24,704,scale,5,10,5,1,00156,India
960513,2024-01-24,703,eraser,1,3,2,1,00265,India
707575,2024-01-24,714,carbon paper,15,30,15,1,00357,India
707575,2024-01-24,715,folder,5,15,10,1,00357,India
707575,2024-01-24,710,geometry box,100,150,50,1,00357,India
237088,2024-01-24,709,notebook,30,60,30,1,00060,India
237088,2024-01-24,703,eraser,1,3,2,1,00060,India
754957,2024-01-24,713,ball pen,5,10,5,1,00228,India
142390,2024-01-24,715,folder,5,15,10,1,00174,India
119073,2024-01-24,713,ball pen,5,10,5,1,00069,India
860966,2024-01-24,716,printing paper,200,400,200,1,00337,India
141899,2024-01-24,702,pencil,2,5,3,1,00430,India
141899,2024-01-24,709,notebook,30,60,30,1,00430,India
141899,2024-01-24,708,sketchpen,15,40,25,1,00430,India
141899,2024-01-24,710,geometry box,100,150,50,1,00430,India
595302,2024-01-24,701,gel pen,5,10,5,1,00080,India
595302,2024-01-24,715,folder,5,15,10,1,00080,India
595302,2024-01-24,702,pencil,2,5,3,1,00080,India
595302,2024-01-24,708,sketchpen,15,40,25,1,00080,India
595302,2024-01-24,706,sharpener,3,8,5,1,00080,India
424670,2024-01-24,701,gel pen,5,10,5,1,00462,India
424670,2024-01-24,711,TD kit,150,300,150,1,00462,India
424670,2024-01-24,717,spiral bound book,50,100,50,1,00462,India
364094,2024-01-24,708,sketchpen,15,40,25,1,00358,India
364094,2024-01-24,707,marker,20,40,20,1,00358,India
364094,2024-01-24,704,scale,5,10,5,1,00358,India
732269,2024-01-24,714,carbon paper,15,30,15,1,00045,India
314618,2024-01-24,714,carbon paper,15,30,15,1,00071,India
314618,2024-01-24,703,eraser,1,3,2,1,00071,India
314618,2024-01-24,710,geometry box,100,150,50,1,00071,India
743687,2024-01-24,717,spiral bound book,50,100,50,1,00493,India
743687,2024-01-24,711,TD kit,150,300,150,1,00493,India
743687,2024-01-24,707,marker,20,40,20,1,00493,India
964904,2024-01-24,716,printing paper,200,400,200,1,00472,India
609578,2024-01-24,711,TD kit,150,300,150,1,00122,India
609578,2024-01-24,715,folder,5,15,10,1,00122,India
851310,2024-01-24,702,pencil,2,5,3,1,00044,India
851310,2024-01-24,716,printing paper,200,400,200,1,00044,India
191327,2024-01-24,713,ball pen,5,10,5,1,00445,India
191327,2024-01-24,712,graph paper,20,40,20,1,00445,India
631287,2024-01-24,707,marker,20,40,20,1,00027,India
631287,2024-01-24,701,gel pen,5,10,5,1,00027,India
631287,2024-01-24,715,folder,5,15,10,1,00027,India
631287,2024-01-24,709,notebook,30,60,30,1,00027,India
382978,2024-01-24,712,graph paper,20,40,20,1,00313,India
382978,2024-01-24,710,geometry box,100,150,50,1,00313,India
382978,2024-01-24,714,carbon paper,15,30,15,1,00313,India
887576,2024-01-24,713,ball pen,5,10,5,1,00289,India
887576,2024-01-24,705,stencil,10,20,10,1,00289,India
887576,2024-01-24,714,carbon paper,15,30,15,1,00289,India
887576,2024-01-24,715,folder,5,15,10,1,00289,India
339145,2024-01-24,704,scale,5,10,5,1,00432,India
339145,2024-01-24,706,sharpener,3,8,5,1,00432,India
339145,2024-01-24,714,carbon paper,15,30,15,1,00432,India
993101,2024-01-24,717,spiral bound book,50,100,50,1,00085,India
993101,2024-01-24,701,gel pen,5,10,5,1,00085,India
993101,2024-01-24,703,eraser,1,3,2,1,00085,India
815763,2024-01-24,708,sketchpen,15,40,25,1,00110,India
815763,2024-01-24,717,spiral bound book,50,100,50,1,00110,India
261913,2024-01-24,705,stencil,10,20,10,1,00072,India
261913,2024-01-24,712,graph paper,20,40,20,1,00072,India
398031,2024-01-24,710,geometry box,100,150,50,1,00459,India
398031,2024-01-24,701,gel pen,5,10,5,1,00459,India
398031,2024-01-24,706,sharpener,3,8,5,1,00459,India
962614,2024-01-24,704,scale,5,10,5,1,00030,India
962614,2024-01-24,707,marker,20,40,20,1,00030,India
962614,2024-01-24,708,sketchpen,15,40,25,1,00030,India
962614,2024-01-24,716,printing paper,200,400,200,1,00030,India
356575,2024-01-24,714,carbon paper,15,30,15,1,00351,India
243288,2024-01-24,712,graph paper,20,40,20,1,00361,India
243288,2024-01-24,703,eraser,1,3,2,1,00361,India
243288,2024-01-24,717,spiral bound book,50,100,50,1,00361,India
188642,2024-01-24,709,notebook,30,60,30,1,00198,India
188642,2024-01-24,710,geometry box,100,150,50,1,00198,India
633581,2024-01-24,717,spiral bound book,50,100,50,1,00469,India
633581,2024-01-24,709,notebook,30,60,30,1,00469,India
795144,2024-01-24,701,gel pen,5,10,5,1,00122,India
550481,2024-01-25,715,folder,5,15,10,1,00472,India
550481,2024-01-25,704,scale,5,10,5,1,00472,India
647069,2024-01-25,715,folder,5,15,10,1,00185,India
647069,2024-01-25,704,scale,5,10,5,1,00185,India
647069,2024-01-25,705,stencil,10,20,10,1,00185,India
652166,2024-01-25,702,pencil,2,5,3,1,00333,India
652166,2024-01-25,701,gel pen,5,10,5,1,00333,India
920550,2024-01-25,716,printing paper,200,400,200,1,00251,India
920550,2024-01-25,715,folder,5,15,10,1,00251,India
920550,2024-01-25,701,gel pen,5,10,5,1,00251,India
616701,2024-01-25,717,spiral bound book,50,100,50,1,00265,India
616701,2024-01-25,707,marker,20,40,20,1,00265,India
915337,2024-01-25,710,geometry box,100,150,50,1,00082,India
915337,2024-01-25,717,spiral bound book,50,100,50,1,00082,India
915337,2024-01-25,712,graph paper,20,40,20,1,00082,India
819033,2024-01-25,701,gel pen,5,10,5,1,00309,India
819033,2024-01-25,712,graph paper,20,40,20,1,00309,India
199238,2024-01-25,711,TD kit,150,300,150,1,00367,India
199238,2024-01-25,703,eraser,1,3,2,1,00367,India
199238,2024-01-25,709,notebook,30,60,30,1,00367,India
199238,2024-01-25,710,geometry box,100,150,50,1,00367,India
163939,2024-01-25,701,gel pen,5,10,5,1,00326,India
988863,2024-01-25,708,sketchpen,15,40,25,1,00044,India
988863,2024-01-25,715,folder,5,15,10,1,00044,India
988863,2024-01-25,717,spiral bound book,50,100,50,1,00044,India
988863,2024-01-25,710,geometry box,100,150,50,1,00044,India
988863,2024-01-25,705,stencil,10,20,10,1,00044,India
555539,2024-01-25,716,printing paper,200,400,200,1,00009,India
555539,2024-01-25,702,pencil,2,5,3,1,00009,India
271253,2024-01-25,712,graph paper,20,40,20,1,00104,India
271253,2024-01-25,716,printing paper,200,400,200,1,00104,India
271253,2024-01-25,706,sharpener,3,8,5,1,00104,India
271253,2024-01-25,705,stencil,10,20,10,1,00104,India
319340,2024-01-25,713,ball pen,5,10,5,1,00343,India
319340,2024-01-25,702,pencil,2,5,3,1,00343,India
762569,2024-01-25,706,sharpener,3,8,5,1,00464,India
762569,2024-01-25,715,folder,5,15,10,1,00464,India
762569,2024-01-25,704,scale,5,10,5,1,00464,India
897980,2024-01-25,705,stencil,10,20,10,1,00034,India
897980,2024-01-25,703,eraser,1,3,2,1,00034,India
897980,2024-01-25,701,gel pen,5,10,5,1,00034,India
897980,2024-01-25,714,carbon paper,15,30,15,1,00034,India
419116,2024-01-25,710,geometry box,100,150,50,1,00017,India
419116,2024-01-25,711,TD kit,150,300,150,1,00017,India
419116,2024-01-25,715,folder,5,15,10,1,00017,India
419116,2024-01-25,716,printing paper,200,400,200,1,00017,India
958312,2024-01-25,701,gel pen,5,10,5,1,00188,India
780296,2024-01-25,702,pencil,2,5,3,1,00493,India
780296,2024-01-25,712,graph paper,20,40,20,1,00493,India
780296,2024-01-25,716,printing paper,200,400,200,1,00493,India
277794,2024-01-25,713,ball pen,5,10,5,1,00222,India
745479,2024-01-25,704,scale,5,10,5,1,00233,India
745479,2024-01-25,708,sketchpen,15,40,25,1,00233,India
272748,2024-01-25,703,eraser,1,3,2,1,00165,India
272748,2024-01-25,713,ball pen,5,10,5,1,00165,India
272748,2024-01-25,717,spiral bound book,50,100,50,1,00165,India
685631,2024-01-25,701,gel pen,5,10,5,1,00487,India
685631,2024-01-25,705,stencil,10,20,10,1,00487,India
598376,2024-01-25,709,notebook,30,60,30,1,00022,India
559596,2024-01-25,711,TD kit,150,300,150,1,00276,India
101333,2024-01-25,706,sharpener,3,8,5,1,00180,India
101333,2024-01-25,703,eraser,1,3,2,1,00180,India
101333,2024-01-25,711,TD kit,150,300,150,1,00180,India
902700,2024-01-25,706,sharpener,3,8,5,1,00456,India
902700,2024-01-25,702,pencil,2,5,3,1,00456,India
902700,2024-01-25,716,printing paper,200,400,200,1,00456,India
373708,2024-01-25,706,sharpener,3,8,5,1,00229,India
373708,2024-01-25,713,ball pen,5,10,5,1,00229,India
373708,2024-01-25,715,folder,5,15,10,1,00229,India
373708,2024-01-25,702,pencil,2,5,3,1,00229,India
465702,2024-01-25,703,eraser,1,3,2,1,00343,India
384212,2024-01-25,716,printing paper,200,400,200,1,00406,India
384212,2024-01-25,711,TD kit,150,300,150,1,00406,India
384212,2024-01-25,701,gel pen,5,10,5,1,00406,India
874743,2024-01-25,715,folder,5,15,10,1,00085,India
874743,2024-01-25,708,sketchpen,15,40,25,1,00085,India
874743,2024-01-25,702,pencil,2,5,3,1,00085,India
874743,2024-01-25,717,spiral bound book,50,100,50,1,00085,India
471309,2024-01-25,704,scale,5,10,5,1,00285,India
471309,2024-01-25,714,carbon paper,15,30,15,1,00285,India
471309,2024-01-25,717,spiral bound book,50,100,50,1,00285,India
471309,2024-01-25,703,eraser,1,3,2,1,00285,India
156904,2024-01-25,702,pencil,2,5,3,1,00387,India
156904,2024-01-25,712,graph paper,20,40,20,1,00387,India
156904,2024-01-25,716,printing paper,200,400,200,1,00387,India
156904,2024-01-25,714,carbon paper,15,30,15,1,00387,India
156904,2024-01-25,701,gel pen,5,10,5,1,00387,India
252882,2024-01-25,713,ball pen,5,10,5,1,00243,India
252882,2024-01-25,703,eraser,1,3,2,1,00243,India
252882,2024-01-25,706,sharpener,3,8,5,1,00243,India
538403,2024-01-25,703,eraser,1,3,2,1,00018,India
410829,2024-01-26,701,gel pen,5,10,5,1,00481,India
341615,2024-01-26,708,sketchpen,15,40,25,1,00159,India
341615,2024-01-26,717,spiral bound book,50,100,50,1,00159,India
341615,2024-01-26,702,pencil,2,5,3,1,00159,India
181880,2024-01-26,710,geometry box,100,150,50,1,00421,India
181880,2024-01-26,709,notebook,30,60,30,1,00421,India
181880,2024-01-26,711,TD kit,150,300,150,1,00421,India
181880,2024-01-26,713,ball pen,5,10,5,1,00421,India
776904,2024-01-26,710,geometry box,100,150,50,1,00412,India
182466,2024-01-26,717,spiral bound book,50,100,50,1,00410,India
182466,2024-01-26,711,TD kit,150,300,150,1,00410,India
182466,2024-01-26,706,sharpener,3,8,5,1,00410,India
481428,2024-01-26,713,ball pen,5,10,5,1,00163,India
481428,2024-01-26,706,sharpener,3,8,5,1,00163,India
481428,2024-01-26,715,folder,5,15,10,1,00163,India
481428,2024-01-26,717,spiral bound book,50,100,50,1,00163,India
481428,2024-01-26,707,marker,20,40,20,1,00163,India
573712,2024-01-26,704,scale,5,10,5,1,00003,India
573712,2024-01-26,711,TD kit,150,300,150,1,00003,India
648130,2024-01-26,711,TD kit,150,300,150,1,00039,India
648130,2024-01-26,712,graph paper,20,40,20,1,00039,India
648130,2024-01-26,709,notebook,30,60,30,1,00039,India
400518,2024-01-26,709,notebook,30,60,30,1,00357,India
400518,2024-01-26,703,eraser,1,3,2,1,00357,India
434539,2024-01-26,717,spiral bound book,50,100,50,1,00078,India
434539,2024-01-26,701,gel pen,5,10,5,1,00078,India
434539,2024-01-26,712,graph paper,20,40,20,1,00078,India
434539,2024-01-26,705,stencil,10,20,10,1,00078,India
932833,2024-01-26,706,sharpener,3,8,5,1,00470,India
887628,2024-01-26,715,folder,5,15,10,1,00072,India
887628,2024-01-26,712,graph paper,20,40,20,1,00072,India
887628,2024-01-26,701,gel pen,5,10,5,1,00072,India
887628,2024-01-26,716,printing paper,200,400,200,1,00072,India
887628,2024-01-26,705,stencil,10,20,10,1,00072,India
429400,2024-01-26,710,geometry box,100,150,50,1,00379,India
429400,2024-01-26,704,scale,5,10,5,1,00379,India
429400,2024-01-26,716,printing paper,200,400,200,1,00379,India
429400,2024-01-26,709,notebook,30,60,30,1,00379,India
706828,2024-01-26,704,scale,5,10,5,1,00166,India
706828,2024-01-26,708,sketchpen,15,40,25,1,00166,India
706828,2024-01-26,701,gel pen,5,10,5,1,00166,India
706828,2024-01-26,710,geometry box,100,150,50,1,00166,India
706828,2024-01-26,712,graph paper,20,40,20,1,00166,India
856185,2024-01-26,705,stencil,10,20,10,1,00473,India
687782,2024-01-26,717,spiral bound book,50,100,50,1,00487,India
687782,2024-01-26,702,pencil,2,5,3,1,00487,India
687782,2024-01-26,715,folder,5,15,10,1,00487,India
687782,2024-01-26,710,geometry box,100,150,50,1,00487,India
687782,2024-01-26,713,ball pen,5,10,5,1,00487,India
376257,2024-01-26,702,pencil,2,5,3,1,00056,India
839150,2024-01-26,711,TD kit,150,300,150,1,00327,India
839150,2024-01-26,706,sharpener,3,8,5,1,00327,India
839150,2024-01-26,717,spiral bound book,50,100,50,1,00327,India
191185,2024-01-26,701,gel pen,5,10,5,1,00455,India
191185,2024-01-26,713,ball pen,5,10,5,1,00455,India
191185,2024-01-26,714,carbon paper,15,30,15,1,00455,India
191185,2024-01-26,715,folder,5,15,10,1,00455,India
191185,2024-01-26,711,TD kit,150,300,150,1,00455,India
115869,2024-01-26,706,sharpener,3,8,5,1,00316,India
115869,2024-01-26,709,notebook,30,60,30,1,00316,India
115869,2024-01-26,708,sketchpen,15,40,25,1,00316,India
607510,2024-01-26,701,gel pen,5,10,5,1,00096,India
607510,2024-01-26,711,TD kit,150,300,150,1,00096,India
607510,2024-01-26,714,carbon paper,15,30,15,1,00096,India
825394,2024-01-26,711,TD kit,150,300,150,1,00046,India
825394,2024-01-26,709,notebook,30,60,30,1,00046,India
825394,2024-01-26,708,sketchpen,15,40,25,1,00046,India
825394,2024-01-26,714,carbon paper,15,30,15,1,00046,India
468626,2024-01-26,716,printing paper,200,400,200,1,00132,India
468626,2024-01-26,709,notebook,30,60,30,1,00132,India
203541,2024-01-26,709,notebook,30,60,30,1,00239,India
203541,2024-01-26,711,TD kit,150,300,150,1,00239,India
203541,2024-01-26,706,sharpener,3,8,5,1,00239,India
780081,2024-01-26,711,TD kit,150,300,150,1,00180,India
780081,2024-01-26,712,graph paper,20,40,20,1,00180,India
780081,2024-01-26,704,scale,5,10,5,1,00180,India
765544,2024-01-26,713,ball pen,5,10,5,1,00093,India
765544,2024-01-26,702,pencil,2,5,3,1,00093,India
792257,2024-01-26,701,gel pen,5,10,5,1,00288,India
792257,2024-01-26,716,printing paper,200,400,200,1,00288,India
792257,2024-01-26,709,notebook,30,60,30,1,00288,India
792257,2024-01-26,702,pencil,2,5,3,1,00288,India
742666,2024-01-26,711,TD kit,150,300,150,1,00448,India
351004,2024-01-26,714,carbon paper,15,30,15,1,00287,India
351004,2024-01-26,702,pencil,2,5,3,1,00287,India
233552,2024-01-26,715,folder,5,15,10,1,00392,India
148797,2024-01-26,717,spiral bound book,50,100,50,1,00186,India
148797,2024-01-26,706,sharpener,3,8,5,1,00186,India
148797,2024-01-26,712,graph paper,20,40,20,1,00186,India
148797,2024-01-26,716,printing paper,200,400,200,1,00186,India
822835,2024-01-26,705,stencil,10,20,10,1,00224,India
822835,2024-01-26,715,folder,5,15,10,1,00224,India
864786,2024-01-26,716,printing paper,200,400,200,1,00078,India
864786,2024-01-26,710,geometry box,100,150,50,1,00078,India
864786,2024-01-26,705,stencil,10,20,10,1,00078,India
864786,2024-01-26,714,carbon paper,15,30,15,1,00078,India
737801,2024-01-26,703,eraser,1,3,2,1,00376,India
737801,2024-01-26,709,notebook,30,60,30,1,00376,India
760358,2024-01-27,708,sketchpen,15,40,25,1,00451,India
760358,2024-01-27,701,gel pen,5,10,5,1,00451,India
465918,2024-01-27,709,notebook,30,60,30,1,00425,India
834104,2024-01-27,708,sketchpen,15,40,25,1,00500,India
834104,2024-01-27,713,ball pen,5,10,5,1,00500,India
834104,2024-01-27,701,gel pen,5,10,5,1,00500,India
240275,2024-01-27,715,folder,5,15,10,1,00249,India
240275,2024-01-27,701,gel pen,5,10,5,1,00249,India
240275,2024-01-27,717,spiral bound book,50,100,50,1,00249,India
752560,2024-01-27,710,geometry box,100,150,50,1,00278,India
752560,2024-01-27,707,marker,20,40,20,1,00278,India
182540,2024-01-27,701,gel pen,5,10,5,1,00011,India
182540,2024-01-27,711,TD kit,150,300,150,1,00011,India
182540,2024-01-27,713,ball pen,5,10,5,1,00011,India
182540,2024-01-27,707,marker,20,40,20,1,00011,India
941801,2024-01-27,717,spiral bound book,50,100,50,1,00188,India
941801,2024-01-27,706,sharpener,3,8,5,1,00188,India
941801,2024-01-27,702,pencil,2,5,3,1,00188,India
941801,2024-01-27,707,marker,20,40,20,1,00188,India
941801,2024-01-27,703,eraser,1,3,2,1,00188,India
745348,2024-01-27,712,graph paper,20,40,20,1,00419,India
745348,2024-01-27,702,pencil,2,5,3,1,00419,India
745348,2024-01-27,708,sketchpen,15,40,25,1,00419,India
758368,2024-01-27,703,eraser,1,3,2,1,00224,India
758368,2024-01-27,707,marker,20,40,20,1,00224,India
758368,2024-01-27,708,sketchpen,15,40,25,1,00224,India
155015,2024-01-27,708,sketchpen,15,40,25,1,00161,India
155015,2024-01-27,712,graph paper,20,40,20,1,00161,India
536631,2024-01-27,704,scale,5,10,5,1,00364,India
536631,2024-01-27,708,sketchpen,15,40,25,1,00364,India
536631,2024-01-27,702,pencil,2,5,3,1,00364,India
536631,2024-01-27,717,spiral bound book,50,100,50,1,00364,India
745479,2024-01-27,711,TD kit,150,300,150,1,00233,India
745479,2024-01-27,712,graph paper,20,40,20,1,00233,India
745479,2024-01-27,713,ball pen,5,10,5,1,00233,India
850270,2024-01-27,706,sharpener,3,8,5,1,00463,India
109657,2024-01-27,713,ball pen,5,10,5,1,00328,India
109657,2024-01-27,706,sharpener,3,8,5,1,00328,India
109657,2024-01-27,704,scale,5,10,5,1,00328,India
109657,2024-01-27,707,marker,20,40,20,1,00328,India
630980,2024-01-27,713,ball pen,5,10,5,1,00015,India
978295,2024-01-27,709,notebook,30,60,30,1,00113,India
978295,2024-01-27,707,marker,20,40,20,1,00113,India
685458,2024-01-27,704,scale,5,10,5,1,00404,India
685458,2024-01-27,712,graph paper,20,40,20,1,00404,India
685458,2024-01-27,710,geometry box,100,150,50,1,00404,India
685458,2024-01-27,709,notebook,30,60,30,1,00404,India
649593,2024-01-27,710,geometry box,100,150,50,1,00041,India
649593,2024-01-27,712,graph paper,20,40,20,1,00041,India
649593,2024-01-27,702,pencil,2,5,3,1,00041,India
649593,2024-01-27,713,ball pen,5,10,5,1,00041,India
649593,2024-01-27,703,eraser,1,3,2,1,00041,India
151803,2024-01-27,710,geometry box,100,150,50,1,00103,India
151803,2024-01-27,707,marker,20,40,20,1,00103,India
151803,2024-01-27,711,TD kit,150,300,150,1,00103,India
151803,2024-01-27,712,graph paper,20,40,20,1,00103,India
880325,2024-01-27,712,graph paper,20,40,20,1,00075,India
880325,2024-01-27,707,marker,20,40,20,1,00075,India
695685,2024-01-27,712,graph paper,20,40,20,1,00489,India
695685,2024-01-27,706,sharpener,3,8,5,1,00489,India
695685,2024-01-27,705,stencil,10,20,10,1,00489,India
249171,2024-01-27,703,eraser,1,3,2,1,00023,India
249171,2024-01-27,701,gel pen,5,10,5,1,00023,India
249171,2024-01-27,705,stencil,10,20,10,1,00023,India
249171,2024-01-27,710,geometry box,100,150,50,1,00023,India
516908,2024-01-27,716,printing paper,200,400,200,1,00338,India
516908,2024-01-27,714,carbon paper,15,30,15,1,00338,India
516908,2024-01-27,705,stencil,10,20,10,1,00338,India
516908,2024-01-27,701,gel pen,5,10,5,1,00338,India
516908,2024-01-27,709,notebook,30,60,30,1,00338,India
820962,2024-01-27,714,carbon paper,15,30,15,1,00361,India
820962,2024-01-27,708,sketchpen,15,40,25,1,00361,India
820962,2024-01-27,702,pencil,2,5,3,1,00361,India
820962,2024-01-27,707,marker,20,40,20,1,00361,India
820962,2024-01-27,713,ball pen,5,10,5,1,00361,India
371577,2024-01-27,702,pencil,2,5,3,1,00329,India
996279,2024-01-27,713,ball pen,5,10,5,1,00153,India
602341,2024-01-27,715,folder,5,15,10,1,00421,India
602341,2024-01-27,711,TD kit,150,300,150,1,00421,India
602341,2024-01-27,704,scale,5,10,5,1,00421,India
622819,2024-01-27,708,sketchpen,15,40,25,1,00295,India
622819,2024-01-27,710,geometry box,100,150,50,1,00295,India
868155,2024-01-27,710,geometry box,100,150,50,1,00002,India
868155,2024-01-27,707,marker,20,40,20,1,00002,India
319812,2024-01-27,709,notebook,30,60,30,1,00413,India
819033,2024-01-27,709,notebook,30,60,30,1,00309,India
819033,2024-01-27,707,marker,20,40,20,1,00309,India
819033,2024-01-27,703,eraser,1,3,2,1,00309,India
870853,2024-01-27,701,gel pen,5,10,5,1,00472,India
870853,2024-01-27,705,stencil,10,20,10,1,00472,India
870853,2024-01-27,706,sharpener,3,8,5,1,00472,India
722287,2024-01-27,711,TD kit,150,300,150,1,00446,India
722287,2024-01-27,713,ball pen,5,10,5,1,00446,India
908235,2024-01-27,710,geometry box,100,150,50,1,00210,India
908235,2024-01-27,703,eraser,1,3,2,1,00210,India
947006,2024-01-27,708,sketchpen,15,40,25,1,00490,India
947006,2024-01-27,703,eraser,1,3,2,1,00490,India
947006,2024-01-27,712,graph paper,20,40,20,1,00490,India
947006,2024-01-27,701,gel pen,5,10,5,1,00490,India
133159,2024-01-27,712,graph paper,20,40,20,1,00318,India
133159,2024-01-27,713,ball pen,5,10,5,1,00318,India
133159,2024-01-27,703,eraser,1,3,2,1,00318,India
133159,2024-01-27,702,pencil,2,5,3,1,00318,India
331703,2024-01-27,715,folder,5,15,10,1,00422,India
331703,2024-01-27,710,geometry box,100,150,50,1,00422,India
205241,2024-01-27,712,graph paper,20,40,20,1,00016,India
205241,2024-01-27,717,spiral bound book,50,100,50,1,00016,India
205241,2024-01-27,710,geometry box,100,150,50,1,00016,India
205241,2024-01-27,703,eraser,1,3,2,1,00016,India
750477,2024-01-27,717,spiral bound book,50,100,50,1,00009,India
750477,2024-01-27,716,printing paper,200,400,200,1,00009,India
750477,2024-01-27,706,sharpener,3,8,5,1,00009,India
750477,2024-01-27,713,ball pen,5,10,5,1,00009,India
834460,2024-01-27,702,pencil,2,5,3,1,00368,India
834460,2024-01-27,706,sharpener,3,8,5,1,00368,India
770251,2024-01-27,711,TD kit,150,300,150,1,00083,India
770251,2024-01-27,716,printing paper,200,400,200,1,00083,India
770251,2024-01-27,706,sharpener,3,8,5,1,00083,India
770251,2024-01-27,715,folder,5,15,10,1,00083,India
391535,2024-01-27,712,graph paper,20,40,20,1,00486,India
146161,2024-01-28,705,stencil,10,20,10,1,00081,India
146161,2024-01-28,702,pencil,2,5,3,1,00081,India
146161,2024-01-28,704,scale,5,10,5,1,00081,India
146161,2024-01-28,716,printing paper,200,400,200,1,00081,India
146161,2024-01-28,715,folder,5,15,10,1,00081,India
771096,2024-01-28,713,ball pen,5,10,5,1,00112,India
771096,2024-01-28,711,TD kit,150,300,150,1,00112,India
727301,2024-01-28,711,TD kit,150,300,150,1,00280,India
727301,2024-01-28,706,sharpener,3,8,5,1,00280,India
727301,2024-01-28,713,ball pen,5,10,5,1,00280,India
712398,2024-01-28,717,spiral bound book,50,100,50,1,00497,India
712398,2024-01-28,714,carbon paper,15,30,15,1,00497,India
712398,2024-01-28,708,sketchpen,15,40,25,1,00497,India
558716,2024-01-28,708,sketchpen,15,40,25,1,00109,India
558716,2024-01-28,711,TD kit,150,300,150,1,00109,India
558716,2024-01-28,704,scale,5,10,5,1,00109,India
801542,2024-01-28,711,TD kit,150,300,150,1,00053,India
801542,2024-01-28,707,marker,20,40,20,1,00053,India
493572,2024-01-28,716,printing paper,200,400,200,1,00056,India
493572,2024-01-28,704,scale,5,10,5,1,00056,India
493572,2024-01-28,706,sharpener,3,8,5,1,00056,India
493572,2024-01-28,711,TD kit,150,300,150,1,00056,India
835838,2024-01-28,710,geometry box,100,150,50,1,00120,India
835838,2024-01-28,704,scale,5,10,5,1,00120,India
835838,2024-01-28,706,sharpener,3,8,5,1,00120,India
835838,2024-01-28,709,notebook,30,60,30,1,00120,India
764958,2024-01-28,701,gel pen,5,10,5,1,00130,India
764958,2024-01-28,707,marker,20,40,20,1,00130,India
764958,2024-01-28,704,scale,5,10,5,1,00130,India
764958,2024-01-28,715,folder,5,15,10,1,00130,India
281481,2024-01-28,702,pencil,2,5,3,1,00122,India
281481,2024-01-28,714,carbon paper,15,30,15,1,00122,India
281481,2024-01-28,710,geometry box,100,150,50,1,00122,India
281481,2024-01-28,704,scale,5,10,5,1,00122,India
873951,2024-01-28,704,scale,5,10,5,1,00443,India
873951,2024-01-28,703,eraser,1,3,2,1,00443,India
668946,2024-01-28,706,sharpener,3,8,5,1,00273,India
668946,2024-01-28,712,graph paper,20,40,20,1,00273,India
668946,2024-01-28,717,spiral bound book,50,100,50,1,00273,India
668946,2024-01-28,708,sketchpen,15,40,25,1,00273,India
668946,2024-01-28,705,stencil,10,20,10,1,00273,India
324064,2024-01-28,712,graph paper,20,40,20,1,00291,India
324064,2024-01-28,717,spiral bound book,50,100,50,1,00291,India
386922,2024-01-28,714,carbon paper,15,30,15,1,00453,India
386922,2024-01-28,705,stencil,10,20,10,1,00453,India
120752,2024-01-28,704,scale,5,10,5,1,00167,India
120752,2024-01-28,701,gel pen,5,10,5,1,00167,India
120752,2024-01-28,713,ball pen,5,10,5,1,00167,India
120752,2024-01-28,703,eraser,1,3,2,1,00167,India
748027,2024-01-28,707,marker,20,40,20,1,00424,India
748027,2024-01-28,701,gel pen,5,10,5,1,00424,India
748027,2024-01-28,712,graph paper,20,40,20,1,00424,India
748027,2024-01-28,709,notebook,30,60,30,1,00424,India
966198,2024-01-28,715,folder,5,15,10,1,00420,India
966198,2024-01-28,709,notebook,30,60,30,1,00420,India
127360,2024-01-28,711,TD kit,150,300,150,1,00411,India
127360,2024-01-28,708,sketchpen,15,40,25,1,00411,India
127360,2024-01-28,717,spiral bound book,50,100,50,1,00411,India
127360,2024-01-28,704,scale,5,10,5,1,00411,India
127360,2024-01-28,714,carbon paper,15,30,15,1,00411,India
917662,2024-01-28,709,notebook,30,60,30,1,00320,India
696299,2024-01-28,704,scale,5,10,5,1,00490,India
711349,2024-01-28,714,carbon paper,15,30,15,1,00263,India
711349,2024-01-28,711,TD kit,150,300,150,1,00263,India
711349,2024-01-28,707,marker,20,40,20,1,00263,India
711349,2024-01-28,717,spiral bound book,50,100,50,1,00263,India
711349,2024-01-28,703,eraser,1,3,2,1,00263,India
497018,2024-01-28,704,scale,5,10,5,1,00050,India
497018,2024-01-28,707,marker,20,40,20,1,00050,India
497018,2024-01-28,708,sketchpen,15,40,25,1,00050,India
497018,2024-01-28,712,graph paper,20,40,20,1,00050,India
497018,2024-01-28,702,pencil,2,5,3,1,00050,India
663816,2024-01-28,717,spiral bound book,50,100,50,1,00205,India
467512,2024-01-28,714,carbon paper,15,30,15,1,00185,India
467512,2024-01-28,711,TD kit,150,300,150,1,00185,India
467512,2024-01-28,706,sharpener,3,8,5,1,00185,India
111431,2024-01-28,714,carbon paper,15,30,15,1,00133,India
111431,2024-01-28,704,scale,5,10,5,1,00133,India
111431,2024-01-28,711,TD kit,150,300,150,1,00133,India
111431,2024-01-28,705,stencil,10,20,10,1,00133,India
431873,2024-01-28,701,gel pen,5,10,5,1,00497,India
431873,2024-01-28,704,scale,5,10,5,1,00497,India
431873,2024-01-28,707,marker,20,40,20,1,00497,India
431873,2024-01-28,712,graph paper,20,40,20,1,00497,India
304151,2024-01-28,711,TD kit,150,300,150,1,00165,India
304151,2024-01-28,705,stencil,10,20,10,1,00165,India
304151,2024-01-28,702,pencil,2,5,3,1,00165,India
304151,2024-01-28,717,spiral bound book,50,100,50,1,00165,India
402567,2024-01-28,702,pencil,2,5,3,1,00037,India
402567,2024-01-28,706,sharpener,3,8,5,1,00037,India
402567,2024-01-28,707,marker,20,40,20,1,00037,India
402567,2024-01-28,708,sketchpen,15,40,25,1,00037,India
402567,2024-01-28,710,geometry box,100,150,50,1,00037,India
502763,2024-01-28,704,scale,5,10,5,1,00163,India
502763,2024-01-28,710,geometry box,100,150,50,1,00163,India
502763,2024-01-28,717,spiral bound book,50,100,50,1,00163,India
502763,2024-01-28,705,stencil,10,20,10,1,00163,India
523534,2024-01-28,716,printing paper,200,400,200,1,00062,India
523534,2024-01-28,713,ball pen,5,10,5,1,00062,India
523534,2024-01-28,706,sharpener,3,8,5,1,00062,India
523534,2024-01-28,711,TD kit,150,300,150,1,00062,India
523534,2024-01-28,709,notebook,30,60,30,1,00062,India
725454,2024-01-28,702,pencil,2,5,3,1,00073,India
725454,2024-01-28,713,ball pen,5,10,5,1,00073,India
725454,2024-01-28,703,eraser,1,3,2,1,00073,India
725454,2024-01-28,716,printing paper,200,400,200,1,00073,India
434025,2024-01-28,714,carbon paper,15,30,15,1,00161,India
434025,2024-01-28,701,gel pen,5,10,5,1,00161,India
434025,2024-01-28,702,pencil,2,5,3,1,00161,India
268063,2024-01-28,703,eraser,1,3,2,1,00221,India
818911,2024-01-28,717,spiral bound book,50,100,50,1,00210,India
818911,2024-01-28,706,sharpener,3,8,5,1,00210,India
818911,2024-01-28,708,sketchpen,15,40,25,1,00210,India
772726,2024-01-28,707,marker,20,40,20,1,00226,India
772726,2024-01-28,703,eraser,1,3,2,1,00226,India
772726,2024-01-28,717,spiral bound book,50,100,50,1,00226,India
772726,2024-01-28,716,printing paper,200,400,200,1,00226,India
876176,2024-01-28,701,gel pen,5,10,5,1,00411,India
876176,2024-01-28,717,spiral bound book,50,100,50,1,00411,India
876176,2024-01-28,716,printing paper,200,400,200,1,00411,India
876176,2024-01-28,713,ball pen,5,10,5,1,00411,India
245720,2024-01-28,712,graph paper,20,40,20,1,00432,India
245720,2024-01-28,702,pencil,2,5,3,1,00432,India
245720,2024-01-28,717,spiral bound book,50,100,50,1,00432,India
245720,2024-01-28,709,notebook,30,60,30,1,00432,India
863558,2024-01-28,713,ball pen,5,10,5,1,00389,India
863558,2024-01-28,716,printing paper,200,400,200,1,00389,India
863558,2024-01-28,705,stencil,10,20,10,1,00389,India
863558,2024-01-28,707,marker,20,40,20,1,00389,India
905957,2024-01-29,701,gel pen,5,10,5,1,00054,India
905957,2024-01-29,714,carbon paper,15,30,15,1,00054,India
905957,2024-01-29,704,scale,5,10,5,1,00054,India
905957,2024-01-29,717,spiral bound book,50,100,50,1,00054,India
586485,2024-01-29,706,sharpener,3,8,5,1,00405,India
586485,2024-01-29,711,TD kit,150,300,150,1,00405,India
586485,2024-01-29,717,spiral bound book,50,100,50,1,00405,India
586485,2024-01-29,715,folder,5,15,10,1,00405,India
249297,2024-01-29,712,graph paper,20,40,20,1,00452,India
249297,2024-01-29,713,ball pen,5,10,5,1,00452,India
249297,2024-01-29,701,gel pen,5,10,5,1,00452,India
249297,2024-01-29,707,marker,20,40,20,1,00452,India
249297,2024-01-29,706,sharpener,3,8,5,1,00452,India
194277,2024-01-29,703,eraser,1,3,2,1,00362,India
660096,2024-01-29,705,stencil,10,20,10,1,00420,India
733955,2024-01-29,703,eraser,1,3,2,1,00401,India
733955,2024-01-29,705,stencil,10,20,10,1,00401,India
880014,2024-01-29,709,notebook,30,60,30,1,00374,India
296073,2024-01-29,717,spiral bound book,50,100,50,1,00087,India
296073,2024-01-29,704,scale,5,10,5,1,00087,India
296073,2024-01-29,706,sharpener,3,8,5,1,00087,India
296073,2024-01-29,701,gel pen,5,10,5,1,00087,India
905492,2024-01-29,708,sketchpen,15,40,25,1,00006,India
905492,2024-01-29,704,scale,5,10,5,1,00006,India
905492,2024-01-29,712,graph paper,20,40,20,1,00006,India
905492,2024-01-29,714,carbon paper,15,30,15,1,00006,India
905492,2024-01-29,713,ball pen,5,10,5,1,00006,India
713636,2024-01-29,702,pencil,2,5,3,1,00259,India
713636,2024-01-29,715,folder,5,15,10,1,00259,India
713636,2024-01-29,710,geometry box,100,150,50,1,00259,India
713636,2024-01-29,713,ball pen,5,10,5,1,00259,India
471257,2024-01-29,712,graph paper,20,40,20,1,00214,India
471257,2024-01-29,706,sharpener,3,8,5,1,00214,India
471257,2024-01-29,710,geometry box,100,150,50,1,00214,India
344216,2024-01-29,703,eraser,1,3,2,1,00132,India
760348,2024-01-29,708,sketchpen,15,40,25,1,00217,India
760348,2024-01-29,705,stencil,10,20,10,1,00217,India
760348,2024-01-29,703,eraser,1,3,2,1,00217,India
871812,2024-01-29,708,sketchpen,15,40,25,1,00244,India
871812,2024-01-29,712,graph paper,20,40,20,1,00244,India
871812,2024-01-29,710,geometry box,100,150,50,1,00244,India
871812,2024-01-29,709,notebook,30,60,30,1,00244,India
123012,2024-01-29,715,folder,5,15,10,1,00464,India
123012,2024-01-29,709,notebook,30,60,30,1,00464,India
123012,2024-01-29,717,spiral bound book,50,100,50,1,00464,India
123012,2024-01-29,711,TD kit,150,300,150,1,00464,India
764032,2024-01-29,713,ball pen,5,10,5,1,00466,India
764032,2024-01-29,712,graph paper,20,40,20,1,00466,India
818182,2024-01-29,701,gel pen,5,10,5,1,00038,India
818182,2024-01-29,703,eraser,1,3,2,1,00038,India
818182,2024-01-29,702,pencil,2,5,3,1,00038,India
877067,2024-01-29,716,printing paper,200,400,200,1,00044,India
943972,2024-01-29,709,notebook,30,60,30,1,00091,India
144997,2024-01-29,712,graph paper,20,40,20,1,00487,India
144997,2024-01-29,710,geometry box,100,150,50,1,00487,India
144997,2024-01-29,717,spiral bound book,50,100,50,1,00487,India
144997,2024-01-29,716,printing paper,200,400,200,1,00487,India
203121,2024-01-29,703,eraser,1,3,2,1,00324,India
203121,2024-01-29,707,marker,20,40,20,1,00324,India
203121,2024-01-29,709,notebook,30,60,30,1,00324,India
727787,2024-01-29,708,sketchpen,15,40,25,1,00334,India
727787,2024-01-29,713,ball pen,5,10,5,1,00334,India
852564,2024-01-29,709,notebook,30,60,30,1,00442,India
314675,2024-01-29,713,ball pen,5,10,5,1,00294,India
314675,2024-01-29,709,notebook,30,60,30,1,00294,India
641221,2024-01-29,704,scale,5,10,5,1,00080,India
641221,2024-01-29,701,gel pen,5,10,5,1,00080,India
641221,2024-01-29,711,TD kit,150,300,150,1,00080,India
249824,2024-01-29,701,gel pen,5,10,5,1,00098,India
249824,2024-01-29,705,stencil,10,20,10,1,00098,India
313324,2024-01-29,701,gel pen,5,10,5,1,00380,India
313324,2024-01-29,706,sharpener,3,8,5,1,00380,India
313324,2024-01-29,705,stencil,10,20,10,1,00380,India
313324,2024-01-29,707,marker,20,40,20,1,00380,India
237516,2024-01-29,714,carbon paper,15,30,15,1,00280,India
237516,2024-01-29,711,TD kit,150,300,150,1,00280,India
297676,2024-01-29,716,printing paper,200,400,200,1,00220,India
297676,2024-01-29,713,ball pen,5,10,5,1,00220,India
297676,2024-01-29,710,geometry box,100,150,50,1,00220,India
393142,2024-01-29,717,spiral bound book,50,100,50,1,00110,India
393142,2024-01-29,710,geometry box,100,150,50,1,00110,India
393142,2024-01-29,714,carbon paper,15,30,15,1,00110,India
393142,2024-01-29,716,printing paper,200,400,200,1,00110,India
858865,2024-01-29,711,TD kit,150,300,150,1,00010,India
175221,2024-01-29,701,gel pen,5,10,5,1,00346,India
189949,2024-01-29,705,stencil,10,20,10,1,00081,India
189949,2024-01-29,710,geometry box,100,150,50,1,00081,India
189949,2024-01-29,715,folder,5,15,10,1,00081,India
189949,2024-01-29,711,TD kit,150,300,150,1,00081,India
189949,2024-01-29,714,carbon paper,15,30,15,1,00081,India
574311,2024-01-29,714,carbon paper,15,30,15,1,00070,India
574311,2024-01-29,715,folder,5,15,10,1,00070,India
574311,2024-01-29,713,ball pen,5,10,5,1,00070,India
574311,2024-01-29,705,stencil,10,20,10,1,00070,India
574311,2024-01-29,710,geometry box,100,150,50,1,00070,India
412959,2024-01-29,715,folder,5,15,10,1,00491,India
412959,2024-01-29,712,graph paper,20,40,20,1,00491,India
412959,2024-01-29,702,pencil,2,5,3,1,00491,India
412959,2024-01-29,704,scale,5,10,5,1,00491,India
806629,2024-01-29,706,sharpener,3,8,5,1,00252,India
806629,2024-01-29,717,spiral bound book,50,100,50,1,00252,India
806629,2024-01-29,705,stencil,10,20,10,1,00252,India
806629,2024-01-29,714,carbon paper,15,30,15,1,00252,India
765910,2024-01-29,706,sharpener,3,8,5,1,00497,India
765910,2024-01-29,711,TD kit,150,300,150,1,00497,India
765910,2024-01-29,703,eraser,1,3,2,1,00497,India
818715,2024-01-29,702,pencil,2,5,3,1,00008,India
156055,2024-01-29,710,geometry box,100,150,50,1,00021,India
156055,2024-01-29,704,scale,5,10,5,1,00021,India
156055,2024-01-29,703,eraser,1,3,2,1,00021,India
156055,2024-01-29,709,notebook,30,60,30,1,00021,India
434793,2024-01-30,702,pencil,2,5,3,1,00109,India
434793,2024-01-30,711,TD kit,150,300,150,1,00109,India
448487,2024-01-30,716,printing paper,200,400,200,1,00375,India
178736,2024-01-30,715,folder,5,15,10,1,00149,India
178736,2024-01-30,707,marker,20,40,20,1,00149,India
789429,2024-01-30,717,spiral bound book,50,100,50,1,00224,India
789429,2024-01-30,711,TD kit,150,300,150,1,00224,India
789429,2024-01-30,707,marker,20,40,20,1,00224,India
254009,2024-01-30,712,graph paper,20,40,20,1,00007,India
254009,2024-01-30,702,pencil,2,5,3,1,00007,India
254009,2024-01-30,708,sketchpen,15,40,25,1,00007,India
499443,2024-01-30,706,sharpener,3,8,5,1,00037,India
499443,2024-01-30,707,marker,20,40,20,1,00037,India
324364,2024-01-30,702,pencil,2,5,3,1,00057,India
324364,2024-01-30,703,eraser,1,3,2,1,00057,India
324364,2024-01-30,707,marker,20,40,20,1,00057,India
324364,2024-01-30,708,sketchpen,15,40,25,1,00057,India
484534,2024-01-30,708,sketchpen,15,40,25,1,00082,India
484534,2024-01-30,701,gel pen,5,10,5,1,00082,India
484534,2024-01-30,713,ball pen,5,10,5,1,00082,India
983773,2024-01-30,705,stencil,10,20,10,1,00081,India
983773,2024-01-30,703,eraser,1,3,2,1,00081,India
938177,2024-01-30,709,notebook,30,60,30,1,00383,India
938177,2024-01-30,704,scale,5,10,5,1,00383,India
938177,2024-01-30,715,folder,5,15,10,1,00383,India
893714,2024-01-30,706,sharpener,3,8,5,1,00132,India
620590,2024-01-30,711,TD kit,150,300,150,1,00161,India
620590,2024-01-30,703,eraser,1,3,2,1,00161,India
620590,2024-01-30,708,sketchpen,15,40,25,1,00161,India
651916,2024-01-30,704,scale,5,10,5,1,00393,India
651916,2024-01-30,713,ball pen,5,10,5,1,00393,India
494346,2024-01-30,717,spiral bound book,50,100,50,1,00041,India
494346,2024-01-30,701,gel pen,5,10,5,1,00041,India
494346,2024-01-30,709,notebook,30,60,30,1,00041,India
494346,2024-01-30,702,pencil,2,5,3,1,00041,India
427832,2024-01-30,708,sketchpen,15,40,25,1,00435,India
427832,2024-01-30,716,printing paper,200,400,200,1,00435,India
348033,2024-01-30,714,carbon paper,15,30,15,1,00216,India
348033,2024-01-30,713,ball pen,5,10,5,1,00216,India
348033,2024-01-30,702,pencil,2,5,3,1,00216,India
348033,2024-01-30,707,marker,20,40,20,1,00216,India
502480,2024-01-30,702,pencil,2,5,3,1,00266,India
502480,2024-01-30,707,marker,20,40,20,1,00266,India
502480,2024-01-30,715,folder,5,15,10,1,00266,India
502480,2024-01-30,706,sharpener,3,8,5,1,00266,India
825283,2024-01-30,707,marker,20,40,20,1,00248,India
825283,2024-01-30,717,spiral bound book,50,100,50,1,00248,India
825283,2024-01-30,702,pencil,2,5,3,1,00248,India
825283,2024-01-30,709,notebook,30,60,30,1,00248,India
174814,2024-01-30,702,pencil,2,5,3,1,00071,India
174814,2024-01-30,703,eraser,1,3,2,1,00071,India
766942,2024-01-30,706,sharpener,3,8,5,1,00087,India
766942,2024-01-30,705,stencil,10,20,10,1,00087,India
174363,2024-01-30,717,spiral bound book,50,100,50,1,00452,India
440990,2024-01-30,708,sketchpen,15,40,25,1,00192,India
883064,2024-01-30,708,sketchpen,15,40,25,1,00378,India
883064,2024-01-30,703,eraser,1,3,2,1,00378,India
883064,2024-01-30,711,TD kit,150,300,150,1,00378,India
304723,2024-01-30,702,pencil,2,5,3,1,00371,India
304723,2024-01-30,712,graph paper,20,40,20,1,00371,India
304723,2024-01-30,715,folder,5,15,10,1,00371,India
164384,2024-01-30,703,eraser,1,3,2,1,00147,India
705495,2024-01-30,715,folder,5,15,10,1,00488,India
705495,2024-01-30,714,carbon paper,15,30,15,1,00488,India
705495,2024-01-30,713,ball pen,5,10,5,1,00488,India
689149,2024-01-30,707,marker,20,40,20,1,00411,India
689149,2024-01-30,711,TD kit,150,300,150,1,00411,India
689149,2024-01-30,712,graph paper,20,40,20,1,00411,India
689149,2024-01-30,715,folder,5,15,10,1,00411,India
197823,2024-01-30,715,folder,5,15,10,1,00252,India
197823,2024-01-30,712,graph paper,20,40,20,1,00252,India
674399,2024-01-30,707,marker,20,40,20,1,00435,India
674399,2024-01-30,708,sketchpen,15,40,25,1,00435,India
859280,2024-01-30,713,ball pen,5,10,5,1,00426,India
859280,2024-01-30,712,graph paper,20,40,20,1,00426,India
859280,2024-01-30,702,pencil,2,5,3,1,00426,India
588364,2024-01-30,717,spiral bound book,50,100,50,1,00499,India
588364,2024-01-30,707,marker,20,40,20,1,00499,India
795937,2024-01-30,717,spiral bound book,50,100,50,1,00430,India
795937,2024-01-30,711,TD kit,150,300,150,1,00430,India
795937,2024-01-30,713,ball pen,5,10,5,1,00430,India
596942,2024-01-30,702,pencil,2,5,3,1,00457,India
250385,2024-01-30,701,gel pen,5,10,5,1,00014,India
250385,2024-01-30,705,stencil,10,20,10,1,00014,India
736860,2024-01-30,708,sketchpen,15,40,25,1,00348,India
241042,2024-01-30,706,sharpener,3,8,5,1,00303,India
241042,2024-01-30,707,marker,20,40,20,1,00303,India
241042,2024-01-30,716,printing paper,200,400,200,1,00303,India
870711,2024-01-30,713,ball pen,5,10,5,1,00052,India
870711,2024-01-30,716,printing paper,200,400,200,1,00052,India
870711,2024-01-30,704,scale,5,10,5,1,00052,India
952540,2024-01-30,704,scale,5,10,5,1,00277,India
952540,2024-01-30,712,graph paper,20,40,20,1,00277,India
952540,2024-01-30,717,spiral bound book,50,100,50,1,00277,India
952540,2024-01-30,703,eraser,1,3,2,1,00277,India
610588,2024-01-30,703,eraser,1,3,2,1,00009,India
610588,2024-01-30,709,notebook,30,60,30,1,00009,India
610588,2024-01-30,715,folder,5,15,10,1,00009,India
610588,2024-01-30,714,carbon paper,15,30,15,1,00009,India
610588,2024-01-30,706,sharpener,3,8,5,1,00009,India
918398,2024-01-30,709,notebook,30,60,30,1,00070,India
781598,2024-01-30,715,folder,5,15,10,1,00338,India
781598,2024-01-30,703,eraser,1,3,2,1,00338,India
577759,2024-01-30,716,printing paper,200,400,200,1,00500,India
444505,2024-01-30,702,pencil,2,5,3,1,00019,India
444505,2024-01-30,708,sketchpen,15,40,25,1,00019,India
444505,2024-01-30,701,gel pen,5,10,5,1,00019,India
444505,2024-01-30,710,geometry box,100,150,50,1,00019,India
139206,2024-01-30,702,pencil,2,5,3,1,00206,India
139206,2024-01-30,710,geometry box,100,150,50,1,00206,India
139206,2024-01-30,704,scale,5,10,5,1,00206,India
139206,2024-01-30,708,sketchpen,15,40,25,1,00206,India
139206,2024-01-30,705,stencil,10,20,10,1,00206,India
112500,2024-01-31,705,stencil,10,20,10,1,00218,India
684290,2024-01-31,706,sharpener,3,8,5,1,00421,India
684290,2024-01-31,703,eraser,1,3,2,1,00421,India
684290,2024-01-31,715,folder,5,15,10,1,00421,India
216205,2024-01-31,709,notebook,30,60,30,1,00008,India
216205,2024-01-31,713,ball pen,5,10,5,1,00008,India
767189,2024-01-31,712,graph paper,20,40,20,1,00012,India
767189,2024-01-31,709,notebook,30,60,30,1,00012,India
562401,2024-01-31,712,graph paper,20,40,20,1,00201,India
562401,2024-01-31,709,notebook,30,60,30,1,00201,India
562401,2024-01-31,716,printing paper,200,400,200,1,00201,India
770788,2024-01-31,705,stencil,10,20,10,1,00094,India
184465,2024-01-31,706,sharpener,3,8,5,1,00203,India
924716,2024-01-31,714,carbon paper,15,30,15,1,00108,India
924716,2024-01-31,709,notebook,30,60,30,1,00108,India
957614,2024-01-31,716,printing paper,200,400,200,1,00464,India
957614,2024-01-31,715,folder,5,15,10,1,00464,India
957614,2024-01-31,701,gel pen,5,10,5,1,00464,India
957614,2024-01-31,708,sketchpen,15,40,25,1,00464,India
957614,2024-01-31,702,pencil,2,5,3,1,00464,India
976805,2024-01-31,714,carbon paper,15,30,15,1,00400,India
976805,2024-01-31,707,marker,20,40,20,1,00400,India
976805,2024-01-31,701,gel pen,5,10,5,1,00400,India
976805,2024-01-31,702,pencil,2,5,3,1,00400,India
976805,2024-01-31,716,printing paper,200,400,200,1,00400,India
852905,2024-01-31,708,sketchpen,15,40,25,1,00164,India
290939,2024-01-31,703,eraser,1,3,2,1,00014,India
826299,2024-01-31,707,marker,20,40,20,1,00009,India
826299,2024-01-31,713,ball pen,5,10,5,1,00009,India
826299,2024-01-31,703,eraser,1,3,2,1,00009,India
826299,2024-01-31,702,pencil,2,5,3,1,00009,India
673307,2024-01-31,704,scale,5,10,5,1,00203,India
673307,2024-01-31,709,notebook,30,60,30,1,00203,India
673307,2024-01-31,705,stencil,10,20,10,1,00203,India
673307,2024-01-31,711,TD kit,150,300,150,1,00203,India
819341,2024-01-31,715,folder,5,15,10,1,00285,India
819341,2024-01-31,710,geometry box,100,150,50,1,00285,India
819341,2024-01-31,709,notebook,30,60,30,1,00285,India
348669,2024-01-31,717,spiral bound book,50,100,50,1,00212,India
348669,2024-01-31,714,carbon paper,15,30,15,1,00212,India
805837,2024-01-31,706,sharpener,3,8,5,1,00223,India
660894,2024-01-31,710,geometry box,100,150,50,1,00475,India
859184,2024-01-31,706,sharpener,3,8,5,1,00445,India
136810,2024-01-31,702,pencil,2,5,3,1,00034,India
255901,2024-01-31,712,graph paper,20,40,20,1,00486,India
255901,2024-01-31,702,pencil,2,5,3,1,00486,India
255901,2024-01-31,707,marker,20,40,20,1,00486,India
255901,2024-01-31,713,ball pen,5,10,5,1,00486,India
255901,2024-01-31,717,spiral bound book,50,100,50,1,00486,India
672003,2024-01-31,705,stencil,10,20,10,1,00380,India
672003,2024-01-31,714,carbon paper,15,30,15,1,00380,India
672003,2024-01-31,709,notebook,30,60,30,1,00380,India
672003,2024-01-31,713,ball pen,5,10,5,1,00380,India
439033,2024-01-31,706,sharpener,3,8,5,1,00257,India
448922,2024-01-31,704,scale,5,10,5,1,00308,India
614078,2024-01-31,710,geometry box,100,150,50,1,00314,India
614078,2024-01-31,701,gel pen,5,10,5,1,00314,India
614078,2024-01-31,703,eraser,1,3,2,1,00314,India
339679,2024-01-31,707,marker,20,40,20,1,00087,India
339679,2024-01-31,717,spiral bound book,50,100,50,1,00087,India
339679,2024-01-31,712,graph paper,20,40,20,1,00087,India
345029,2024-01-31,711,TD kit,150,300,150,1,00102,India
345029,2024-01-31,704,scale,5,10,5,1,00102,India
345029,2024-01-31,710,geometry box,100,150,50,1,00102,India
345029,2024-01-31,701,gel pen,5,10,5,1,00102,India
766238,2024-01-31,710,geometry box,100,150,50,1,00049,India
766238,2024-01-31,708,sketchpen,15,40,25,1,00049,India
766238,2024-01-31,706,sharpener,3,8,5,1,00049,India
766238,2024-01-31,705,stencil,10,20,10,1,00049,India
902275,2024-01-31,703,eraser,1,3,2,1,00457,India
902275,2024-01-31,708,sketchpen,15,40,25,1,00457,India
902275,2024-01-31,706,sharpener,3,8,5,1,00457,India
902275,2024-01-31,716,printing paper,200,400,200,1,00457,India
902975,2024-01-31,706,sharpener,3,8,5,1,00496,India
902975,2024-01-31,714,carbon paper,15,30,15,1,00496,India
966959,2024-01-31,702,pencil,2,5,3,1,00149,India
964674,2024-01-31,703,eraser,1,3,2,1,00303,India
723656,2024-01-31,716,printing paper,200,400,200,1,00113,India
723656,2024-01-31,714,carbon paper,15,30,15,1,00113,India
723656,2024-01-31,708,sketchpen,15,40,25,1,00113,India
723656,2024-01-31,704,scale,5,10,5,1,00113,India
211636,2024-01-31,716,printing paper,200,400,200,1,00201,India
211636,2024-01-31,715,folder,5,15,10,1,00201,India
550636,2024-01-31,701,gel pen,5,10,5,1,00018,India
529383,2024-01-31,709,notebook,30,60,30,1,00089,India
529383,2024-01-31,703,eraser,1,3,2,1,00089,India
529383,2024-01-31,705,stencil,10,20,10,1,00089,India
529383,2024-01-31,712,graph paper,20,40,20,1,00089,India
690508,2024-01-31,709,notebook,30,60,30,1,00413,India
690508,2024-01-31,710,geometry box,100,150,50,1,00413,India
965507,2024-01-31,706,sharpener,3,8,5,1,00181,India
965507,2024-01-31,710,geometry box,100,150,50,1,00181,India
965507,2024-01-31,705,stencil,10,20,10,1,00181,India
965507,2024-01-31,715,folder,5,15,10,1,00181,India
965507,2024-01-31,716,printing paper,200,400,200,1,00181,India
977929,2024-01-31,704,scale,5,10,5,1,00326,India
977929,2024-01-31,716,printing paper,200,400,200,1,00326,India
977929,2024-01-31,708,sketchpen,15,40,25,1,00326,India
116966,2024-01-31,714,carbon paper,15,30,15,1,00009,India
116966,2024-01-31,711,TD kit,150,300,150,1,00009,India
377576,2024-01-31,702,pencil,2,5,3,1,00494,India
377576,2024-01-31,717,spiral bound book,50,100,50,1,00494,India
377576,2024-01-31,715,folder,5,15,10,1,00494,India
377576,2024-01-31,711,TD kit,150,300,150,1,00494,India
324051,2024-01-31,714,carbon paper,15,30,15,1,00227,India
324051,2024-01-31,709,notebook,30,60,30,1,00227,India
324051,2024-01-31,707,marker,20,40,20,1,00227,India
108861,2024-01-31,716,printing paper,200,400,200,1,00391,India
108861,2024-01-31,717,spiral bound book,50,100,50,1,00391,India
511393,2024-01-31,705,stencil,10,20,10,1,00131,India
511393,2024-01-31,716,printing paper,200,400,200,1,00131,India
511393,2024-01-31,711,TD kit,150,300,150,1,00131,India
981717,2024-01-31,711,TD kit,150,300,150,1,00381,India
981717,2024-01-31,712,graph paper,20,40,20,1,00381,India
981717,2024-01-31,708,sketchpen,15,40,25,1,00381,India
981717,2024-01-31,705,stencil,10,20,10,1,00381,India
780528,2024-01-31,717,spiral bound book,50,100,50,1,00275,India
581191,2024-02-01,703,eraser,1,3,2,1,00473,India
581191,2024-02-01,708,sketchpen,15,40,25,1,00473,India
581191,2024-02-01,711,TD kit,150,300,150,1,00473,India
629209,2024-02-01,705,stencil,10,20,10,1,00302,India
629209,2024-02-01,701,gel pen,5,10,5,1,00302,India
470566,2024-02-01,715,folder,5,15,10,1,00126,India
470566,2024-02-01,707,marker,20,40,20,1,00126,India
523026,2024-02-01,716,printing paper,200,400,200,1,00331,India
919111,2024-02-01,714,carbon paper,15,30,15,1,00487,India
919111,2024-02-01,707,marker,20,40,20,1,00487,India
919111,2024-02-01,708,sketchpen,15,40,25,1,00487,India
107323,2024-02-01,711,TD kit,150,300,150,1,00457,India
107323,2024-02-01,712,graph paper,20,40,20,1,00457,India
107323,2024-02-01,701,gel pen,5,10,5,1,00457,India
107323,2024-02-01,710,geometry box,100,150,50,1,00457,India
181333,2024-02-01,716,printing paper,200,400,200,1,00014,India
181333,2024-02-01,709,notebook,30,60,30,1,00014,India
337490,2024-02-01,712,graph paper,20,40,20,1,00450,India
337490,2024-02-01,703,eraser,1,3,2,1,00450,India
337490,2024-02-01,714,carbon paper,15,30,15,1,00450,India
337490,2024-02-01,702,pencil,2,5,3,1,00450,India
470876,2024-02-01,701,gel pen,5,10,5,1,00426,India
470876,2024-02-01,707,marker,20,40,20,1,00426,India
221513,2024-02-01,701,gel pen,5,10,5,1,00276,India
221513,2024-02-01,711,TD kit,150,300,150,1,00276,India
221513,2024-02-01,714,carbon paper,15,30,15,1,00276,India
221513,2024-02-01,704,scale,5,10,5,1,00276,India
477980,2024-02-01,708,sketchpen,15,40,25,1,00154,India
614416,2024-02-01,708,sketchpen,15,40,25,1,00324,India
614416,2024-02-01,713,ball pen,5,10,5,1,00324,India
614416,2024-02-01,714,carbon paper,15,30,15,1,00324,India
698430,2024-02-01,702,pencil,2,5,3,1,00486,India
344321,2024-02-01,717,spiral bound book,50,100,50,1,00216,India
344321,2024-02-01,701,gel pen,5,10,5,1,00216,India
344321,2024-02-01,706,sharpener,3,8,5,1,00216,India
344321,2024-02-01,711,TD kit,150,300,150,1,00216,India
344321,2024-02-01,710,geometry box,100,150,50,1,00216,India
457749,2024-02-01,702,pencil,2,5,3,1,00322,India
457749,2024-02-01,708,sketchpen,15,40,25,1,00322,India
837690,2024-02-01,705,stencil,10,20,10,1,00341,India
837690,2024-02-01,708,sketchpen,15,40,25,1,00341,India
837690,2024-02-01,713,ball pen,5,10,5,1,00341,India
837690,2024-02-01,704,scale,5,10,5,1,00341,India
161119,2024-02-01,704,scale,5,10,5,1,00276,India
161119,2024-02-01,715,folder,5,15,10,1,00276,India
161119,2024-02-01,707,marker,20,40,20,1,00276,India
161119,2024-02-01,703,eraser,1,3,2,1,00276,India
161119,2024-02-01,712,graph paper,20,40,20,1,00276,India
836227,2024-02-01,715,folder,5,15,10,1,00008,India
836227,2024-02-01,702,pencil,2,5,3,1,00008,India
836227,2024-02-01,707,marker,20,40,20,1,00008,India
227491,2024-02-01,701,gel pen,5,10,5,1,00349,India
227491,2024-02-01,716,printing paper,200,400,200,1,00349,India
227491,2024-02-01,714,carbon paper,15,30,15,1,00349,India
227491,2024-02-01,710,geometry box,100,150,50,1,00349,India
104860,2024-02-01,701,gel pen,5,10,5,1,00168,India
104860,2024-02-01,714,carbon paper,15,30,15,1,00168,India
104860,2024-02-01,713,ball pen,5,10,5,1,00168,India
792895,2024-02-01,715,folder,5,15,10,1,00226,India
801384,2024-02-01,716,printing paper,200,400,200,1,00378,India
801384,2024-02-01,703,eraser,1,3,2,1,00378,India
801384,2024-02-01,708,sketchpen,15,40,25,1,00378,India
801384,2024-02-01,712,graph paper,20,40,20,1,00378,India
629569,2024-02-01,716,printing paper,200,400,200,1,00145,India
365101,2024-02-01,706,sharpener,3,8,5,1,00435,India
365101,2024-02-01,709,notebook,30,60,30,1,00435,India
387594,2024-02-01,707,marker,20,40,20,1,00012,India
387594,2024-02-01,717,spiral bound book,50,100,50,1,00012,India
387594,2024-02-01,713,ball pen,5,10,5,1,00012,India
387594,2024-02-01,714,carbon paper,15,30,15,1,00012,India
822686,2024-02-01,708,sketchpen,15,40,25,1,00218,India
148962,2024-02-01,711,TD kit,150,300,150,1,00441,India
148962,2024-02-01,714,carbon paper,15,30,15,1,00441,India
148962,2024-02-01,710,geometry box,100,150,50,1,00441,India
148962,2024-02-01,702,pencil,2,5,3,1,00441,India
339774,2024-02-01,714,carbon paper,15,30,15,1,00411,India
339774,2024-02-01,709,notebook,30,60,30,1,00411,India
339774,2024-02-01,716,printing paper,200,400,200,1,00411,India
339774,2024-02-01,711,TD kit,150,300,150,1,00411,India
519997,2024-02-01,703,eraser,1,3,2,1,00467,India
519997,2024-02-01,717,spiral bound book,50,100,50,1,00467,India
519997,2024-02-01,710,geometry box,100,150,50,1,00467,India
519997,2024-02-01,709,notebook,30,60,30,1,00467,India
166646,2024-02-01,711,TD kit,150,300,150,1,00128,India
300779,2024-02-01,702,pencil,2,5,3,1,00208,India
300779,2024-02-01,701,gel pen,5,10,5,1,00208,India
300779,2024-02-01,715,folder,5,15,10,1,00208,India
300779,2024-02-01,713,ball pen,5,10,5,1,00208,India
516017,2024-02-01,702,pencil,2,5,3,1,00251,India
516017,2024-02-01,703,eraser,1,3,2,1,00251,India
516017,2024-02-01,707,marker,20,40,20,1,00251,India
516017,2024-02-01,714,carbon paper,15,30,15,1,00251,India
112518,2024-02-01,706,sharpener,3,8,5,1,00134,India
112518,2024-02-01,716,printing paper,200,400,200,1,00134,India
112518,2024-02-01,704,scale,5,10,5,1,00134,India
615008,2024-02-01,716,printing paper,200,400,200,1,00293,India
615008,2024-02-01,715,folder,5,15,10,1,00293,India
615008,2024-02-01,713,ball pen,5,10,5,1,00293,India
892314,2024-02-01,707,marker,20,40,20,1,00333,India
892314,2024-02-01,706,sharpener,3,8,5,1,00333,India
165895,2024-02-01,712,graph paper,20,40,20,1,00065,India
165895,2024-02-01,717,spiral bound book,50,100,50,1,00065,India
165895,2024-02-01,704,scale,5,10,5,1,00065,India
250998,2024-02-01,706,sharpener,3,8,5,1,00499,India
250998,2024-02-01,714,carbon paper,15,30,15,1,00499,India
250998,2024-02-01,707,marker,20,40,20,1,00499,India
610283,2024-02-01,711,TD kit,150,300,150,1,00087,India
610283,2024-02-01,704,scale,5,10,5,1,00087,India
352797,2024-02-02,704,scale,5,10,5,1,00211,India
352797,2024-02-02,715,folder,5,15,10,1,00211,India
635579,2024-02-02,703,eraser,1,3,2,1,00434,India
677433,2024-02-02,711,TD kit,150,300,150,1,00383,India
677433,2024-02-02,716,printing paper,200,400,200,1,00383,India
677433,2024-02-02,702,pencil,2,5,3,1,00383,India
710412,2024-02-02,701,gel pen,5,10,5,1,00261,India
710412,2024-02-02,702,pencil,2,5,3,1,00261,India
710412,2024-02-02,713,ball pen,5,10,5,1,00261,India
710412,2024-02-02,716,printing paper,200,400,200,1,00261,India
710412,2024-02-02,708,sketchpen,15,40,25,1,00261,India
984693,2024-02-02,706,sharpener,3,8,5,1,00037,India
984693,2024-02-02,704,scale,5,10,5,1,00037,India
984693,2024-02-02,709,notebook,30,60,30,1,00037,India
721307,2024-02-02,701,gel pen,5,10,5,1,00225,India
721307,2024-02-02,714,carbon paper,15,30,15,1,00225,India
721307,2024-02-02,709,notebook,30,60,30,1,00225,India
721307,2024-02-02,717,spiral bound book,50,100,50,1,00225,India
721307,2024-02-02,711,TD kit,150,300,150,1,00225,India
636837,2024-02-02,712,graph paper,20,40,20,1,00064,India
136641,2024-02-02,708,sketchpen,15,40,25,1,00379,India
136641,2024-02-02,704,scale,5,10,5,1,00379,India
136641,2024-02-02,702,pencil,2,5,3,1,00379,India
136641,2024-02-02,714,carbon paper,15,30,15,1,00379,India
136641,2024-02-02,713,ball pen,5,10,5,1,00379,India
250924,2024-02-02,713,ball pen,5,10,5,1,00355,India
250924,2024-02-02,708,sketchpen,15,40,25,1,00355,India
250924,2024-02-02,715,folder,5,15,10,1,00355,India
250924,2024-02-02,701,gel pen,5,10,5,1,00355,India
153527,2024-02-02,715,folder,5,15,10,1,00232,India
153527,2024-02-02,703,eraser,1,3,2,1,00232,India
153527,2024-02-02,711,TD kit,150,300,150,1,00232,India
153527,2024-02-02,705,stencil,10,20,10,1,00232,India
966634,2024-02-02,707,marker,20,40,20,1,00168,India
966634,2024-02-02,716,printing paper,200,400,200,1,00168,India
966634,2024-02-02,712,graph paper,20,40,20,1,00168,India
966634,2024-02-02,704,scale,5,10,5,1,00168,India
966634,2024-02-02,705,stencil,10,20,10,1,00168,India
695693,2024-02-02,717,spiral bound book,50,100,50,1,00288,India
695693,2024-02-02,715,folder,5,15,10,1,00288,India
695693,2024-02-02,708,sketchpen,15,40,25,1,00288,India
750491,2024-02-02,709,notebook,30,60,30,1,00078,India
750491,2024-02-02,716,printing paper,200,400,200,1,00078,India
750491,2024-02-02,707,marker,20,40,20,1,00078,India
440379,2024-02-02,708,sketchpen,15,40,25,1,00268,India
440379,2024-02-02,712,graph paper,20,40,20,1,00268,India
440379,2024-02-02,710,geometry box,100,150,50,1,00268,India
440379,2024-02-02,711,TD kit,150,300,150,1,00268,India
440379,2024-02-02,707,marker,20,40,20,1,00268,India
804111,2024-02-02,710,geometry box,100,150,50,1,00136,India
804111,2024-02-02,708,sketchpen,15,40,25,1,00136,India
804111,2024-02-02,712,graph paper,20,40,20,1,00136,India
297110,2024-02-02,713,ball pen,5,10,5,1,00430,India
297110,2024-02-02,714,carbon paper,15,30,15,1,00430,India
297110,2024-02-02,709,notebook,30,60,30,1,00430,India
297110,2024-02-02,717,spiral bound book,50,100,50,1,00430,India
297110,2024-02-02,712,graph paper,20,40,20,1,00430,India
178098,2024-02-02,703,eraser,1,3,2,1,00241,India
178098,2024-02-02,717,spiral bound book,50,100,50,1,00241,India
178098,2024-02-02,706,sharpener,3,8,5,1,00241,India
412870,2024-02-02,715,folder,5,15,10,1,00495,India
412870,2024-02-02,713,ball pen,5,10,5,1,00495,India
578234,2024-02-02,706,sharpener,3,8,5,1,00090,India
517097,2024-02-02,701,gel pen,5,10,5,1,00119,India
517097,2024-02-02,713,ball pen,5,10,5,1,00119,India
589337,2024-02-02,706,sharpener,3,8,5,1,00076,India
589337,2024-02-02,710,geometry box,100,150,50,1,00076,India
589337,2024-02-02,712,graph paper,20,40,20,1,00076,India
589337,2024-02-02,709,notebook,30,60,30,1,00076,India
281607,2024-02-02,707,marker,20,40,20,1,00469,India
165054,2024-02-02,716,printing paper,200,400,200,1,00345,India
731914,2024-02-02,702,pencil,2,5,3,1,00008,India
928760,2024-02-02,716,printing paper,200,400,200,1,00247,India
906717,2024-02-02,702,pencil,2,5,3,1,00135,India
906717,2024-02-02,713,ball pen,5,10,5,1,00135,India
906717,2024-02-02,701,gel pen,5,10,5,1,00135,India
667415,2024-02-02,709,notebook,30,60,30,1,00055,India
667415,2024-02-02,713,ball pen,5,10,5,1,00055,India
619046,2024-02-02,717,spiral bound book,50,100,50,1,00047,India
619046,2024-02-02,715,folder,5,15,10,1,00047,India
695956,2024-02-02,712,graph paper,20,40,20,1,00174,India
709388,2024-02-02,711,TD kit,150,300,150,1,00007,India
417352,2024-02-02,714,carbon paper,15,30,15,1,00235,India
417352,2024-02-02,717,spiral bound book,50,100,50,1,00235,India
417352,2024-02-02,715,folder,5,15,10,1,00235,India
333703,2024-02-02,706,sharpener,3,8,5,1,00412,India
333703,2024-02-02,712,graph paper,20,40,20,1,00412,India
333703,2024-02-02,715,folder,5,15,10,1,00412,India
679176,2024-02-02,704,scale,5,10,5,1,00453,India
365058,2024-02-02,702,pencil,2,5,3,1,00446,India
227779,2024-02-02,701,gel pen,5,10,5,1,00092,India
227779,2024-02-02,714,carbon paper,15,30,15,1,00092,India
227779,2024-02-02,716,printing paper,200,400,200,1,00092,India
356390,2024-02-02,705,stencil,10,20,10,1,00357,India
356390,2024-02-02,717,spiral bound book,50,100,50,1,00357,India
591827,2024-02-02,713,ball pen,5,10,5,1,00271,India
223037,2024-02-02,706,sharpener,3,8,5,1,00029,India
223037,2024-02-02,711,TD kit,150,300,150,1,00029,India
223037,2024-02-02,704,scale,5,10,5,1,00029,India
223037,2024-02-02,708,sketchpen,15,40,25,1,00029,India
184780,2024-02-03,704,scale,5,10,5,1,00359,India
184780,2024-02-03,706,sharpener,3,8,5,1,00359,India
183162,2024-02-03,702,pencil,2,5,3,1,00171,India
183162,2024-02-03,707,marker,20,40,20,1,00171,India
183162,2024-02-03,712,graph paper,20,40,20,1,00171,India
659680,2024-02-03,701,gel pen,5,10,5,1,00013,India
659680,2024-02-03,711,TD kit,150,300,150,1,00013,India
218552,2024-02-03,711,TD kit,150,300,150,1,00091,India
218552,2024-02-03,702,pencil,2,5,3,1,00091,India
561275,2024-02-03,703,eraser,1,3,2,1,00237,India
561275,2024-02-03,711,TD kit,150,300,150,1,00237,India
561275,2024-02-03,714,carbon paper,15,30,15,1,00237,India
561275,2024-02-03,715,folder,5,15,10,1,00237,India
177206,2024-02-03,705,stencil,10,20,10,1,00021,India
177206,2024-02-03,704,scale,5,10,5,1,00021,India
177206,2024-02-03,702,pencil,2,5,3,1,00021,India
177206,2024-02-03,709,notebook,30,60,30,1,00021,India
385751,2024-02-03,714,carbon paper,15,30,15,1,00390,India
385751,2024-02-03,704,scale,5,10,5,1,00390,India
385751,2024-02-03,702,pencil,2,5,3,1,00390,India
385751,2024-02-03,715,folder,5,15,10,1,00390,India
995049,2024-02-03,710,geometry box,100,150,50,1,00395,India
995049,2024-02-03,705,stencil,10,20,10,1,00395,India
995049,2024-02-03,708,sketchpen,15,40,25,1,00395,India
995049,2024-02-03,706,sharpener,3,8,5,1,00395,India
974900,2024-02-03,701,gel pen,5,10,5,1,00295,India
974900,2024-02-03,710,geometry box,100,150,50,1,00295,India
974900,2024-02-03,708,sketchpen,15,40,25,1,00295,India
974900,2024-02-03,705,stencil,10,20,10,1,00295,India
981595,2024-02-03,705,stencil,10,20,10,1,00207,India
981595,2024-02-03,701,gel pen,5,10,5,1,00207,India
750159,2024-02-03,710,geometry box,100,150,50,1,00217,India
750159,2024-02-03,703,eraser,1,3,2,1,00217,India
750159,2024-02-03,708,sketchpen,15,40,25,1,00217,India
750159,2024-02-03,715,folder,5,15,10,1,00217,India
750159,2024-02-03,704,scale,5,10,5,1,00217,India
674337,2024-02-03,709,notebook,30,60,30,1,00158,India
674337,2024-02-03,713,ball pen,5,10,5,1,00158,India
674337,2024-02-03,701,gel pen,5,10,5,1,00158,India
772768,2024-02-03,707,marker,20,40,20,1,00153,India
772768,2024-02-03,701,gel pen,5,10,5,1,00153,India
772768,2024-02-03,711,TD kit,150,300,150,1,00153,India
743265,2024-02-03,706,sharpener,3,8,5,1,00292,India
743265,2024-02-03,705,stencil,10,20,10,1,00292,India
562127,2024-02-03,707,marker,20,40,20,1,00135,India
562127,2024-02-03,706,sharpener,3,8,5,1,00135,India
562127,2024-02-03,704,scale,5,10,5,1,00135,India
562127,2024-02-03,702,pencil,2,5,3,1,00135,India
562127,2024-02-03,717,spiral bound book,50,100,50,1,00135,India
520849,2024-02-03,704,scale,5,10,5,1,00239,India
520849,2024-02-03,708,sketchpen,15,40,25,1,00239,India
520849,2024-02-03,709,notebook,30,60,30,1,00239,India
498364,2024-02-03,705,stencil,10,20,10,1,00254,India
498364,2024-02-03,715,folder,5,15,10,1,00254,India
498364,2024-02-03,708,sketchpen,15,40,25,1,00254,India
498364,2024-02-03,717,spiral bound book,50,100,50,1,00254,India
394489,2024-02-03,705,stencil,10,20,10,1,00049,India
394489,2024-02-03,711,TD kit,150,300,150,1,00049,India
394489,2024-02-03,702,pencil,2,5,3,1,00049,India
394489,2024-02-03,712,graph paper,20,40,20,1,00049,India
394489,2024-02-03,708,sketchpen,15,40,25,1,00049,India
873351,2024-02-03,701,gel pen,5,10,5,1,00052,India
873351,2024-02-03,702,pencil,2,5,3,1,00052,India
873351,2024-02-03,714,carbon paper,15,30,15,1,00052,India
873351,2024-02-03,712,graph paper,20,40,20,1,00052,India
870323,2024-02-03,706,sharpener,3,8,5,1,00170,India
557101,2024-02-03,707,marker,20,40,20,1,00019,India
557101,2024-02-03,701,gel pen,5,10,5,1,00019,India
812578,2024-02-03,714,carbon paper,15,30,15,1,00053,India
812578,2024-02-03,701,gel pen,5,10,5,1,00053,India
812578,2024-02-03,713,ball pen,5,10,5,1,00053,India
895180,2024-02-03,708,sketchpen,15,40,25,1,00323,India
895180,2024-02-03,703,eraser,1,3,2,1,00323,India
895180,2024-02-03,712,graph paper,20,40,20,1,00323,India
451633,2024-02-03,711,TD kit,150,300,150,1,00067,India
451633,2024-02-03,713,ball pen,5,10,5,1,00067,India
451633,2024-02-03,716,printing paper,200,400,200,1,00067,India
451633,2024-02-03,708,sketchpen,15,40,25,1,00067,India
473474,2024-02-03,702,pencil,2,5,3,1,00354,India
889209,2024-02-03,702,pencil,2,5,3,1,00236,India
980290,2024-02-03,715,folder,5,15,10,1,00407,India
980290,2024-02-03,707,marker,20,40,20,1,00407,India
980290,2024-02-03,708,sketchpen,15,40,25,1,00407,India
980290,2024-02-03,716,printing paper,200,400,200,1,00407,India
141242,2024-02-03,707,marker,20,40,20,1,00031,India
141242,2024-02-03,715,folder,5,15,10,1,00031,India
915784,2024-02-03,710,geometry box,100,150,50,1,00449,India
831827,2024-02-03,704,scale,5,10,5,1,00202,India
831827,2024-02-03,706,sharpener,3,8,5,1,00202,India
831827,2024-02-03,712,graph paper,20,40,20,1,00202,India
831827,2024-02-03,705,stencil,10,20,10,1,00202,India
359615,2024-02-04,711,TD kit,150,300,150,1,00483,India
359615,2024-02-04,717,spiral bound book,50,100,50,1,00483,India
359615,2024-02-04,715,folder,5,15,10,1,00483,India
742097,2024-02-04,703,eraser,1,3,2,1,00404,India
742097,2024-02-04,710,geometry box,100,150,50,1,00404,India
244799,2024-02-04,713,ball pen,5,10,5,1,00251,India
244799,2024-02-04,717,spiral bound book,50,100,50,1,00251,India
244799,2024-02-04,708,sketchpen,15,40,25,1,00251,India
244799,2024-02-04,711,TD kit,150,300,150,1,00251,India
111862,2024-02-04,713,ball pen,5,10,5,1,00013,India
111862,2024-02-04,706,sharpener,3,8,5,1,00013,India
111862,2024-02-04,708,sketchpen,15,40,25,1,00013,India
111862,2024-02-04,710,geometry box,100,150,50,1,00013,India
770203,2024-02-04,703,eraser,1,3,2,1,00290,India
770203,2024-02-04,716,printing paper,200,400,200,1,00290,India
770203,2024-02-04,707,marker,20,40,20,1,00290,India
770203,2024-02-04,705,stencil,10,20,10,1,00290,India
913096,2024-02-04,708,sketchpen,15,40,25,1,00181,India
913096,2024-02-04,710,geometry box,100,150,50,1,00181,India
913096,2024-02-04,715,folder,5,15,10,1,00181,India
913096,2024-02-04,702,pencil,2,5,3,1,00181,India
671930,2024-02-04,709,notebook,30,60,30,1,00348,India
671930,2024-02-04,706,sharpener,3,8,5,1,00348,India
671930,2024-02-04,708,sketchpen,15,40,25,1,00348,India
671930,2024-02-04,717,spiral bound book,50,100,50,1,00348,India
149655,2024-02-04,716,printing paper,200,400,200,1,00146,India
149655,2024-02-04,701,gel pen,5,10,5,1,00146,India
149655,2024-02-04,717,spiral bound book,50,100,50,1,00146,India
149655,2024-02-04,710,geometry box,100,150,50,1,00146,India
950695,2024-02-04,709,notebook,30,60,30,1,00382,India
950695,2024-02-04,717,spiral bound book,50,100,50,1,00382,India
950695,2024-02-04,715,folder,5,15,10,1,00382,India
950695,2024-02-04,702,pencil,2,5,3,1,00382,India
950695,2024-02-04,710,geometry box,100,150,50,1,00382,India
881388,2024-02-04,709,notebook,30,60,30,1,00271,India
881388,2024-02-04,716,printing paper,200,400,200,1,00271,India
881388,2024-02-04,715,folder,5,15,10,1,00271,India
881388,2024-02-04,717,spiral bound book,50,100,50,1,00271,India
982649,2024-02-04,705,stencil,10,20,10,1,00223,India
982649,2024-02-04,707,marker,20,40,20,1,00223,India
325866,2024-02-04,711,TD kit,150,300,150,1,00057,India
325866,2024-02-04,712,graph paper,20,40,20,1,00057,India
325866,2024-02-04,713,ball pen,5,10,5,1,00057,India
960730,2024-02-04,713,ball pen,5,10,5,1,00222,India
960730,2024-02-04,704,scale,5,10,5,1,00222,India
965256,2024-02-04,712,graph paper,20,40,20,1,00435,India
965256,2024-02-04,704,scale,5,10,5,1,00435,India
393483,2024-02-04,708,sketchpen,15,40,25,1,00028,India
393483,2024-02-04,713,ball pen,5,10,5,1,00028,India
393483,2024-02-04,717,spiral bound book,50,100,50,1,00028,India
393483,2024-02-04,707,marker,20,40,20,1,00028,India
855425,2024-02-04,710,geometry box,100,150,50,1,00182,India
376852,2024-02-04,716,printing paper,200,400,200,1,00473,India
376852,2024-02-04,704,scale,5,10,5,1,00473,India
376852,2024-02-04,715,folder,5,15,10,1,00473,India
105276,2024-02-04,704,scale,5,10,5,1,00422,India
105276,2024-02-04,713,ball pen,5,10,5,1,00422,India
105276,2024-02-04,710,geometry box,100,150,50,1,00422,India
105276,2024-02-04,707,marker,20,40,20,1,00422,India
859724,2024-02-04,712,graph paper,20,40,20,1,00244,India
859724,2024-02-04,707,marker,20,40,20,1,00244,India
859724,2024-02-04,710,geometry box,100,150,50,1,00244,India
859724,2024-02-04,713,ball pen,5,10,5,1,00244,India
125258,2024-02-04,710,geometry box,100,150,50,1,00415,India
125258,2024-02-04,708,sketchpen,15,40,25,1,00415,India
125258,2024-02-04,709,notebook,30,60,30,1,00415,India
125258,2024-02-04,712,graph paper,20,40,20,1,00415,India
817390,2024-02-04,713,ball pen,5,10,5,1,00431,India
817390,2024-02-04,704,scale,5,10,5,1,00431,India
817390,2024-02-04,709,notebook,30,60,30,1,00431,India
745661,2024-02-04,713,ball pen,5,10,5,1,00108,India
745661,2024-02-04,716,printing paper,200,400,200,1,00108,India
745661,2024-02-04,702,pencil,2,5,3,1,00108,India
294028,2024-02-04,715,folder,5,15,10,1,00391,India
294028,2024-02-04,708,sketchpen,15,40,25,1,00391,India
174488,2024-02-04,716,printing paper,200,400,200,1,00252,India
174488,2024-02-04,705,stencil,10,20,10,1,00252,India
174488,2024-02-04,710,geometry box,100,150,50,1,00252,India
593336,2024-02-04,704,scale,5,10,5,1,00428,India
593336,2024-02-04,710,geometry box,100,150,50,1,00428,India
593336,2024-02-04,702,pencil,2,5,3,1,00428,India
593336,2024-02-04,701,gel pen,5,10,5,1,00428,India
590603,2024-02-04,712,graph paper,20,40,20,1,00390,India
590603,2024-02-04,706,sharpener,3,8,5,1,00390,India
590603,2024-02-04,707,marker,20,40,20,1,00390,India
558471,2024-02-04,713,ball pen,5,10,5,1,00285,India
558471,2024-02-04,702,pencil,2,5,3,1,00285,India
558471,2024-02-04,714,carbon paper,15,30,15,1,00285,India
558471,2024-02-04,711,TD kit,150,300,150,1,00285,India
112405,2024-02-04,705,stencil,10,20,10,1,00207,India
345445,2024-02-04,712,graph paper,20,40,20,1,00466,India
345445,2024-02-04,717,spiral bound book,50,100,50,1,00466,India
545677,2024-02-04,701,gel pen,5,10,5,1,00202,India
400773,2024-02-04,712,graph paper,20,40,20,1,00172,India
400773,2024-02-04,709,notebook,30,60,30,1,00172,India
400773,2024-02-04,701,gel pen,5,10,5,1,00172,India
400773,2024-02-04,706,sharpener,3,8,5,1,00172,India
794157,2024-02-04,711,TD kit,150,300,150,1,00129,India
794157,2024-02-04,707,marker,20,40,20,1,00129,India
794157,2024-02-04,712,graph paper,20,40,20,1,00129,India
794157,2024-02-04,710,geometry box,100,150,50,1,00129,India
433462,2024-02-04,706,sharpener,3,8,5,1,00453,India
433462,2024-02-04,711,TD kit,150,300,150,1,00453,India
433462,2024-02-04,714,carbon paper,15,30,15,1,00453,India
433462,2024-02-04,704,scale,5,10,5,1,00453,India
757564,2024-02-04,709,notebook,30,60,30,1,00485,India
757564,2024-02-04,712,graph paper,20,40,20,1,00485,India
757564,2024-02-04,716,printing paper,200,400,200,1,00485,India
757564,2024-02-04,711,TD kit,150,300,150,1,00485,India
757564,2024-02-04,713,ball pen,5,10,5,1,00485,India
229626,2024-02-04,702,pencil,2,5,3,1,00075,India
229626,2024-02-04,708,sketchpen,15,40,25,1,00075,India
229626,2024-02-04,710,geometry box,100,150,50,1,00075,India
229626,2024-02-04,715,folder,5,15,10,1,00075,India
229626,2024-02-04,704,scale,5,10,5,1,00075,India
356106,2024-02-04,715,folder,5,15,10,1,00441,India
225377,2024-02-04,701,gel pen,5,10,5,1,00222,India
944501,2024-02-04,714,carbon paper,15,30,15,1,00105,India
944501,2024-02-04,717,spiral bound book,50,100,50,1,00105,India
517639,2024-02-04,717,spiral bound book,50,100,50,1,00494,India
517639,2024-02-04,705,stencil,10,20,10,1,00494,India
748529,2024-02-04,702,pencil,2,5,3,1,00389,India
748529,2024-02-04,712,graph paper,20,40,20,1,00389,India
748529,2024-02-04,708,sketchpen,15,40,25,1,00389,India
725844,2024-02-04,708,sketchpen,15,40,25,1,00101,India
755112,2024-02-04,710,geometry box,100,150,50,1,00003,India
755112,2024-02-04,716,printing paper,200,400,200,1,00003,India
755112,2024-02-04,712,graph paper,20,40,20,1,00003,India
516861,2024-02-04,701,gel pen,5,10,5,1,00096,India
516861,2024-02-04,717,spiral bound book,50,100,50,1,00096,India
788690,2024-02-04,702,pencil,2,5,3,1,00021,India
757231,2024-02-04,717,spiral bound book,50,100,50,1,00329,India
757231,2024-02-04,713,ball pen,5,10,5,1,00329,India
757231,2024-02-04,708,sketchpen,15,40,25,1,00329,India
757231,2024-02-04,712,graph paper,20,40,20,1,00329,India
526983,2024-02-04,707,marker,20,40,20,1,00166,India
526983,2024-02-04,702,pencil,2,5,3,1,00166,India
526983,2024-02-04,710,geometry box,100,150,50,1,00166,India
729346,2024-02-04,708,sketchpen,15,40,25,1,00123,India
729346,2024-02-04,702,pencil,2,5,3,1,00123,India
729346,2024-02-04,712,graph paper,20,40,20,1,00123,India
270915,2024-02-04,703,eraser,1,3,2,1,00024,India
270915,2024-02-04,710,geometry box,100,150,50,1,00024,India
270915,2024-02-04,712,graph paper,20,40,20,1,00024,India
261101,2024-02-04,707,marker,20,40,20,1,00429,India
669848,2024-02-04,714,carbon paper,15,30,15,1,00161,India
669848,2024-02-04,706,sharpener,3,8,5,1,00161,India
669848,2024-02-04,704,scale,5,10,5,1,00161,India
948933,2024-02-05,704,scale,5,10,5,1,00491,India
948933,2024-02-05,707,marker,20,40,20,1,00491,India
216214,2024-02-05,714,carbon paper,15,30,15,1,00196,India
216214,2024-02-05,716,printing paper,200,400,200,1,00196,India
404245,2024-02-05,703,eraser,1,3,2,1,00029,India
404245,2024-02-05,704,scale,5,10,5,1,00029,India
404245,2024-02-05,706,sharpener,3,8,5,1,00029,India
404245,2024-02-05,708,sketchpen,15,40,25,1,00029,India
320068,2024-02-05,701,gel pen,5,10,5,1,00130,India
320068,2024-02-05,714,carbon paper,15,30,15,1,00130,India
320068,2024-02-05,713,ball pen,5,10,5,1,00130,India
320068,2024-02-05,711,TD kit,150,300,150,1,00130,India
320068,2024-02-05,717,spiral bound book,50,100,50,1,00130,India
265518,2024-02-05,703,eraser,1,3,2,1,00083,India
265518,2024-02-05,714,carbon paper,15,30,15,1,00083,India
873571,2024-02-05,706,sharpener,3,8,5,1,00111,India
873571,2024-02-05,704,scale,5,10,5,1,00111,India
934831,2024-02-05,717,spiral bound book,50,100,50,1,00030,India
155020,2024-02-05,701,gel pen,5,10,5,1,00137,India
155020,2024-02-05,713,ball pen,5,10,5,1,00137,India
155020,2024-02-05,715,folder,5,15,10,1,00137,India
155020,2024-02-05,716,printing paper,200,400,200,1,00137,India
155020,2024-02-05,710,geometry box,100,150,50,1,00137,India
266776,2024-02-05,709,notebook,30,60,30,1,00150,India
266776,2024-02-05,714,carbon paper,15,30,15,1,00150,India
266776,2024-02-05,708,sketchpen,15,40,25,1,00150,India
266776,2024-02-05,702,pencil,2,5,3,1,00150,India
139553,2024-02-05,717,spiral bound book,50,100,50,1,00058,India
139553,2024-02-05,708,sketchpen,15,40,25,1,00058,India
386159,2024-02-05,707,marker,20,40,20,1,00139,India
386159,2024-02-05,710,geometry box,100,150,50,1,00139,India
386159,2024-02-05,705,stencil,10,20,10,1,00139,India
386159,2024-02-05,708,sketchpen,15,40,25,1,00139,India
765042,2024-02-05,709,notebook,30,60,30,1,00170,India
765042,2024-02-05,705,stencil,10,20,10,1,00170,India
765042,2024-02-05,711,TD kit,150,300,150,1,00170,India
765042,2024-02-05,715,folder,5,15,10,1,00170,India
232677,2024-02-05,709,notebook,30,60,30,1,00209,India
232677,2024-02-05,701,gel pen,5,10,5,1,00209,India
232677,2024-02-05,716,printing paper,200,400,200,1,00209,India
232677,2024-02-05,710,geometry box,100,150,50,1,00209,India
605052,2024-02-05,711,TD kit,150,300,150,1,00438,India
605052,2024-02-05,705,stencil,10,20,10,1,00438,India
779121,2024-02-05,715,folder,5,15,10,1,00264,India
779121,2024-02-05,713,ball pen,5,10,5,1,00264,India
779121,2024-02-05,701,gel pen,5,10,5,1,00264,India
779121,2024-02-05,709,notebook,30,60,30,1,00264,India
876045,2024-02-05,716,printing paper,200,400,200,1,00120,India
876045,2024-02-05,706,sharpener,3,8,5,1,00120,India
876045,2024-02-05,710,geometry box,100,150,50,1,00120,India
876045,2024-02-05,715,folder,5,15,10,1,00120,India
948254,2024-02-05,715,folder,5,15,10,1,00255,India
948254,2024-02-05,712,graph paper,20,40,20,1,00255,India
948254,2024-02-05,707,marker,20,40,20,1,00255,India
948254,2024-02-05,713,ball pen,5,10,5,1,00255,India
775142,2024-02-05,708,sketchpen,15,40,25,1,00257,India
775142,2024-02-05,704,scale,5,10,5,1,00257,India
775142,2024-02-05,711,TD kit,150,300,150,1,00257,India
775142,2024-02-05,717,spiral bound book,50,100,50,1,00257,India
775142,2024-02-05,702,pencil,2,5,3,1,00257,India
611809,2024-02-05,713,ball pen,5,10,5,1,00385,India
611809,2024-02-05,702,pencil,2,5,3,1,00385,India
611809,2024-02-05,703,eraser,1,3,2,1,00385,India
611809,2024-02-05,709,notebook,30,60,30,1,00385,India
676714,2024-02-05,708,sketchpen,15,40,25,1,00170,India
676714,2024-02-05,709,notebook,30,60,30,1,00170,India
199711,2024-02-05,704,scale,5,10,5,1,00052,India
199711,2024-02-05,702,pencil,2,5,3,1,00052,India
507681,2024-02-05,717,spiral bound book,50,100,50,1,00355,India
288611,2024-02-05,709,notebook,30,60,30,1,00413,India
946116,2024-02-05,707,marker,20,40,20,1,00222,India
367885,2024-02-05,712,graph paper,20,40,20,1,00455,India
367885,2024-02-05,715,folder,5,15,10,1,00455,India
367885,2024-02-05,709,notebook,30,60,30,1,00455,India
367885,2024-02-05,708,sketchpen,15,40,25,1,00455,India
414589,2024-02-05,703,eraser,1,3,2,1,00310,India
414589,2024-02-05,707,marker,20,40,20,1,00310,India
414589,2024-02-05,717,spiral bound book,50,100,50,1,00310,India
381426,2024-02-05,716,printing paper,200,400,200,1,00385,India
381426,2024-02-05,712,graph paper,20,40,20,1,00385,India
275262,2024-02-05,701,gel pen,5,10,5,1,00385,India
275262,2024-02-05,712,graph paper,20,40,20,1,00385,India
275262,2024-02-05,704,scale,5,10,5,1,00385,India
275262,2024-02-05,702,pencil,2,5,3,1,00385,India
275262,2024-02-05,708,sketchpen,15,40,25,1,00385,India
176538,2024-02-05,708,sketchpen,15,40,25,1,00452,India
182097,2024-02-05,712,graph paper,20,40,20,1,00306,India
182097,2024-02-05,701,gel pen,5,10,5,1,00306,India
282326,2024-02-05,709,notebook,30,60,30,1,00022,India
282326,2024-02-05,714,carbon paper,15,30,15,1,00022,India
282326,2024-02-05,704,scale,5,10,5,1,00022,India
282326,2024-02-05,703,eraser,1,3,2,1,00022,India
477131,2024-02-05,714,carbon paper,15,30,15,1,00047,India
477131,2024-02-05,705,stencil,10,20,10,1,00047,India
477131,2024-02-05,702,pencil,2,5,3,1,00047,India
950633,2024-02-05,717,spiral bound book,50,100,50,1,00238,India
950633,2024-02-05,708,sketchpen,15,40,25,1,00238,India
773467,2024-02-05,716,printing paper,200,400,200,1,00185,India
773467,2024-02-05,705,stencil,10,20,10,1,00185,India
454443,2024-02-05,704,scale,5,10,5,1,00258,India
454443,2024-02-05,708,sketchpen,15,40,25,1,00258,India
454443,2024-02-05,707,marker,20,40,20,1,00258,India
713401,2024-02-05,712,graph paper,20,40,20,1,00355,India
713401,2024-02-05,707,marker,20,40,20,1,00355,India
713401,2024-02-05,710,geometry box,100,150,50,1,00355,India
713401,2024-02-05,708,sketchpen,15,40,25,1,00355,India
713401,2024-02-05,706,sharpener,3,8,5,1,00355,India
207568,2024-02-05,702,pencil,2,5,3,1,00266,India
207568,2024-02-05,716,printing paper,200,400,200,1,00266,India
207568,2024-02-05,705,stencil,10,20,10,1,00266,India
640857,2024-02-05,701,gel pen,5,10,5,1,00447,India
640857,2024-02-05,717,spiral bound book,50,100,50,1,00447,India
779940,2024-02-05,706,sharpener,3,8,5,1,00281,India
779940,2024-02-05,703,eraser,1,3,2,1,00281,India
779940,2024-02-05,708,sketchpen,15,40,25,1,00281,India
779940,2024-02-05,712,graph paper,20,40,20,1,00281,India
170201,2024-02-05,702,pencil,2,5,3,1,00051,India
170201,2024-02-05,701,gel pen,5,10,5,1,00051,India
170201,2024-02-05,705,stencil,10,20,10,1,00051,India
170201,2024-02-05,709,notebook,30,60,30,1,00051,India
170201,2024-02-05,711,TD kit,150,300,150,1,00051,India
364681,2024-02-05,703,eraser,1,3,2,1,00035,India
763041,2024-02-05,715,folder,5,15,10,1,00077,India
763041,2024-02-05,714,carbon paper,15,30,15,1,00077,India
763041,2024-02-05,704,scale,5,10,5,1,00077,India
483400,2024-02-05,702,pencil,2,5,3,1,00346,India
483400,2024-02-05,711,TD kit,150,300,150,1,00346,India
483400,2024-02-05,712,graph paper,20,40,20,1,00346,India
483400,2024-02-05,716,printing paper,200,400,200,1,00346,India
483400,2024-02-05,710,geometry box,100,150,50,1,00346,India
491620,2024-02-05,702,pencil,2,5,3,1,00430,India
491620,2024-02-05,701,gel pen,5,10,5,1,00430,India
491620,2024-02-05,706,sharpener,3,8,5,1,00430,India
316937,2024-02-06,711,TD kit,150,300,150,1,00077,India
316937,2024-02-06,704,scale,5,10,5,1,00077,India
732655,2024-02-06,713,ball pen,5,10,5,1,00466,India
215820,2024-02-06,708,sketchpen,15,40,25,1,00211,India
913799,2024-02-06,702,pencil,2,5,3,1,00255,India
913799,2024-02-06,706,sharpener,3,8,5,1,00255,India
913799,2024-02-06,711,TD kit,150,300,150,1,00255,India
913799,2024-02-06,710,geometry box,100,150,50,1,00255,India
913799,2024-02-06,704,scale,5,10,5,1,00255,India
727827,2024-02-06,716,printing paper,200,400,200,1,00341,India
727827,2024-02-06,702,pencil,2,5,3,1,00341,India
727827,2024-02-06,715,folder,5,15,10,1,00341,India
727827,2024-02-06,713,ball pen,5,10,5,1,00341,India
223942,2024-02-06,708,sketchpen,15,40,25,1,00029,India
223942,2024-02-06,711,TD kit,150,300,150,1,00029,India
223942,2024-02-06,701,gel pen,5,10,5,1,00029,India
223942,2024-02-06,713,ball pen,5,10,5,1,00029,India
223942,2024-02-06,712,graph paper,20,40,20,1,00029,India
918730,2024-02-06,714,carbon paper,15,30,15,1,00304,India
918730,2024-02-06,706,sharpener,3,8,5,1,00304,India
918730,2024-02-06,712,graph paper,20,40,20,1,00304,India
887924,2024-02-06,713,ball pen,5,10,5,1,00398,India
665959,2024-02-06,710,geometry box,100,150,50,1,00418,India
665959,2024-02-06,717,spiral bound book,50,100,50,1,00418,India
665959,2024-02-06,706,sharpener,3,8,5,1,00418,India
445555,2024-02-06,701,gel pen,5,10,5,1,00436,India
445555,2024-02-06,702,pencil,2,5,3,1,00436,India
445555,2024-02-06,710,geometry box,100,150,50,1,00436,India
445555,2024-02-06,704,scale,5,10,5,1,00436,India
445555,2024-02-06,708,sketchpen,15,40,25,1,00436,India
674579,2024-02-06,701,gel pen,5,10,5,1,00449,India
674579,2024-02-06,717,spiral bound book,50,100,50,1,00449,India
674579,2024-02-06,715,folder,5,15,10,1,00449,India
674579,2024-02-06,709,notebook,30,60,30,1,00449,India
885338,2024-02-06,703,eraser,1,3,2,1,00264,India
885338,2024-02-06,704,scale,5,10,5,1,00264,India
885338,2024-02-06,714,carbon paper,15,30,15,1,00264,India
885338,2024-02-06,712,graph paper,20,40,20,1,00264,India
782037,2024-02-06,703,eraser,1,3,2,1,00427,India
782037,2024-02-06,709,notebook,30,60,30,1,00427,India
782037,2024-02-06,702,pencil,2,5,3,1,00427,India
755376,2024-02-06,714,carbon paper,15,30,15,1,00419,India
755376,2024-02-06,713,ball pen,5,10,5,1,00419,India
755376,2024-02-06,706,sharpener,3,8,5,1,00419,India
510206,2024-02-06,705,stencil,10,20,10,1,00339,India
510206,2024-02-06,709,notebook,30,60,30,1,00339,India
680511,2024-02-06,705,stencil,10,20,10,1,00461,India
680511,2024-02-06,707,marker,20,40,20,1,00461,India
680511,2024-02-06,710,geometry box,100,150,50,1,00461,India
680511,2024-02-06,711,TD kit,150,300,150,1,00461,India
680511,2024-02-06,704,scale,5,10,5,1,00461,India
580785,2024-02-06,717,spiral bound book,50,100,50,1,00059,India
580785,2024-02-06,712,graph paper,20,40,20,1,00059,India
863279,2024-02-06,714,carbon paper,15,30,15,1,00107,India
382970,2024-02-06,712,graph paper,20,40,20,1,00329,India
382970,2024-02-06,704,scale,5,10,5,1,00329,India
382970,2024-02-06,715,folder,5,15,10,1,00329,India
382970,2024-02-06,716,printing paper,200,400,200,1,00329,India
679299,2024-02-06,702,pencil,2,5,3,1,00012,India
679299,2024-02-06,714,carbon paper,15,30,15,1,00012,India
679299,2024-02-06,715,folder,5,15,10,1,00012,India
679299,2024-02-06,706,sharpener,3,8,5,1,00012,India
926010,2024-02-06,716,printing paper,200,400,200,1,00163,India
926010,2024-02-06,701,gel pen,5,10,5,1,00163,India
692169,2024-02-06,715,folder,5,15,10,1,00469,India
692169,2024-02-06,706,sharpener,3,8,5,1,00469,India
931137,2024-02-06,714,carbon paper,15,30,15,1,00065,India
931137,2024-02-06,705,stencil,10,20,10,1,00065,India
931137,2024-02-06,715,folder,5,15,10,1,00065,India
931137,2024-02-06,704,scale,5,10,5,1,00065,India
931137,2024-02-06,717,spiral bound book,50,100,50,1,00065,India
571969,2024-02-06,717,spiral bound book,50,100,50,1,00063,India
571969,2024-02-06,715,folder,5,15,10,1,00063,India
325472,2024-02-06,710,geometry box,100,150,50,1,00331,India
268795,2024-02-06,701,gel pen,5,10,5,1,00349,India
268795,2024-02-06,706,sharpener,3,8,5,1,00349,India
616867,2024-02-06,711,TD kit,150,300,150,1,00089,India
616867,2024-02-06,701,gel pen,5,10,5,1,00089,India
616867,2024-02-06,715,folder,5,15,10,1,00089,India
616867,2024-02-06,710,geometry box,100,150,50,1,00089,India
936384,2024-02-06,702,pencil,2,5,3,1,00044,India
936384,2024-02-06,713,ball pen,5,10,5,1,00044,India
936384,2024-02-06,709,notebook,30,60,30,1,00044,India
460946,2024-02-06,709,notebook,30,60,30,1,00200,India
460946,2024-02-06,716,printing paper,200,400,200,1,00200,India
460946,2024-02-06,707,marker,20,40,20,1,00200,India
460946,2024-02-06,712,graph paper,20,40,20,1,00200,India
310302,2024-02-06,713,ball pen,5,10,5,1,00392,India
310302,2024-02-06,702,pencil,2,5,3,1,00392,India
310302,2024-02-06,714,carbon paper,15,30,15,1,00392,India
399263,2024-02-06,701,gel pen,5,10,5,1,00007,India
399263,2024-02-06,705,stencil,10,20,10,1,00007,India
121515,2024-02-07,707,marker,20,40,20,1,00333,India
121515,2024-02-07,715,folder,5,15,10,1,00333,India
121515,2024-02-07,714,carbon paper,15,30,15,1,00333,India
350734,2024-02-07,715,folder,5,15,10,1,00287,India
350734,2024-02-07,717,spiral bound book,50,100,50,1,00287,India
350734,2024-02-07,716,printing paper,200,400,200,1,00287,India
615555,2024-02-07,711,TD kit,150,300,150,1,00389,India
615555,2024-02-07,717,spiral bound book,50,100,50,1,00389,India
615555,2024-02-07,703,eraser,1,3,2,1,00389,India
615555,2024-02-07,712,graph paper,20,40,20,1,00389,India
509876,2024-02-07,705,stencil,10,20,10,1,00138,India
374442,2024-02-07,713,ball pen,5,10,5,1,00483,India
374442,2024-02-07,705,stencil,10,20,10,1,00483,India
374442,2024-02-07,714,carbon paper,15,30,15,1,00483,India
374442,2024-02-07,709,notebook,30,60,30,1,00483,India
648374,2024-02-07,710,geometry box,100,150,50,1,00410,India
736451,2024-02-07,712,graph paper,20,40,20,1,00256,India
375478,2024-02-07,717,spiral bound book,50,100,50,1,00497,India
375478,2024-02-07,707,marker,20,40,20,1,00497,India
375478,2024-02-07,706,sharpener,3,8,5,1,00497,India
375478,2024-02-07,712,graph paper,20,40,20,1,00497,India
851640,2024-02-07,702,pencil,2,5,3,1,00435,India
851640,2024-02-07,710,geometry box,100,150,50,1,00435,India
851640,2024-02-07,703,eraser,1,3,2,1,00435,India
372219,2024-02-07,713,ball pen,5,10,5,1,00154,India
372219,2024-02-07,709,notebook,30,60,30,1,00154,India
858628,2024-02-07,705,stencil,10,20,10,1,00455,India
453456,2024-02-07,709,notebook,30,60,30,1,00173,India
453456,2024-02-07,701,gel pen,5,10,5,1,00173,India
453456,2024-02-07,717,spiral bound book,50,100,50,1,00173,India
128259,2024-02-07,710,geometry box,100,150,50,1,00001,India
128259,2024-02-07,716,printing paper,200,400,200,1,00001,India
128259,2024-02-07,701,gel pen,5,10,5,1,00001,India
791111,2024-02-07,715,folder,5,15,10,1,00410,India
791111,2024-02-07,708,sketchpen,15,40,25,1,00410,India
682069,2024-02-07,703,eraser,1,3,2,1,00152,India
682069,2024-02-07,702,pencil,2,5,3,1,00152,India
682069,2024-02-07,701,gel pen,5,10,5,1,00152,India
392632,2024-02-07,715,folder,5,15,10,1,00054,India
392632,2024-02-07,712,graph paper,20,40,20,1,00054,India
914723,2024-02-07,709,notebook,30,60,30,1,00314,India
914723,2024-02-07,707,marker,20,40,20,1,00314,India
914723,2024-02-07,705,stencil,10,20,10,1,00314,India
914723,2024-02-07,716,printing paper,200,400,200,1,00314,India
914723,2024-02-07,701,gel pen,5,10,5,1,00314,India
952469,2024-02-07,707,marker,20,40,20,1,00073,India
952469,2024-02-07,713,ball pen,5,10,5,1,00073,India
952469,2024-02-07,716,printing paper,200,400,200,1,00073,India
982209,2024-02-07,702,pencil,2,5,3,1,00488,India
982209,2024-02-07,712,graph paper,20,40,20,1,00488,India
248497,2024-02-07,701,gel pen,5,10,5,1,00174,India
248497,2024-02-07,710,geometry box,100,150,50,1,00174,India
496256,2024-02-07,715,folder,5,15,10,1,00348,India
112518,2024-02-07,712,graph paper,20,40,20,1,00134,India
929437,2024-02-07,716,printing paper,200,400,200,1,00345,India
584988,2024-02-07,705,stencil,10,20,10,1,00428,India
584988,2024-02-07,710,geometry box,100,150,50,1,00428,India
407784,2024-02-07,716,printing paper,200,400,200,1,00428,India
407784,2024-02-07,707,marker,20,40,20,1,00428,India
407784,2024-02-07,711,TD kit,150,300,150,1,00428,India
254535,2024-02-07,702,pencil,2,5,3,1,00180,India
254535,2024-02-07,707,marker,20,40,20,1,00180,India
448960,2024-02-07,710,geometry box,100,150,50,1,00119,India
448960,2024-02-07,708,sketchpen,15,40,25,1,00119,India
664798,2024-02-07,716,printing paper,200,400,200,1,00214,India
544375,2024-02-07,707,marker,20,40,20,1,00402,India
544375,2024-02-07,713,ball pen,5,10,5,1,00402,India
544375,2024-02-07,710,geometry box,100,150,50,1,00402,India
841180,2024-02-07,701,gel pen,5,10,5,1,00180,India
336823,2024-02-07,710,geometry box,100,150,50,1,00204,India
336823,2024-02-07,704,scale,5,10,5,1,00204,India
336823,2024-02-07,709,notebook,30,60,30,1,00204,India
227629,2024-02-07,711,TD kit,150,300,150,1,00106,India
932796,2024-02-07,705,stencil,10,20,10,1,00393,India
932796,2024-02-07,707,marker,20,40,20,1,00393,India
932796,2024-02-07,715,folder,5,15,10,1,00393,India
199009,2024-02-07,712,graph paper,20,40,20,1,00433,India
199009,2024-02-07,711,TD kit,150,300,150,1,00433,India
199009,2024-02-07,707,marker,20,40,20,1,00433,India
199009,2024-02-07,709,notebook,30,60,30,1,00433,India
320044,2024-02-07,705,stencil,10,20,10,1,00245,India
320044,2024-02-07,703,eraser,1,3,2,1,00245,India
320044,2024-02-07,710,geometry box,100,150,50,1,00245,India
502104,2024-02-07,706,sharpener,3,8,5,1,00050,India
502104,2024-02-07,714,carbon paper,15,30,15,1,00050,India
334339,2024-02-07,708,sketchpen,15,40,25,1,00244,India
334339,2024-02-07,713,ball pen,5,10,5,1,00244,India
334339,2024-02-07,707,marker,20,40,20,1,00244,India
334339,2024-02-07,704,scale,5,10,5,1,00244,India
142600,2024-02-07,708,sketchpen,15,40,25,1,00238,India
142600,2024-02-07,707,marker,20,40,20,1,00238,India
142600,2024-02-07,710,geometry box,100,150,50,1,00238,India
142600,2024-02-07,703,eraser,1,3,2,1,00238,India
142600,2024-02-07,712,graph paper,20,40,20,1,00238,India
792322,2024-02-07,714,carbon paper,15,30,15,1,00048,India
792322,2024-02-07,716,printing paper,200,400,200,1,00048,India
792322,2024-02-07,713,ball pen,5,10,5,1,00048,India
792322,2024-02-07,710,geometry box,100,150,50,1,00048,India
211703,2024-02-07,711,TD kit,150,300,150,1,00221,India
211703,2024-02-07,705,stencil,10,20,10,1,00221,India
211703,2024-02-07,710,geometry box,100,150,50,1,00221,India
211703,2024-02-07,714,carbon paper,15,30,15,1,00221,India
800259,2024-02-07,717,spiral bound book,50,100,50,1,00449,India
800259,2024-02-07,704,scale,5,10,5,1,00449,India
800259,2024-02-07,715,folder,5,15,10,1,00449,India
800259,2024-02-07,705,stencil,10,20,10,1,00449,India
594500,2024-02-07,715,folder,5,15,10,1,00249,India
534734,2024-02-07,709,notebook,30,60,30,1,00168,India
534734,2024-02-07,705,stencil,10,20,10,1,00168,India
424482,2024-02-07,702,pencil,2,5,3,1,00183,India
479565,2024-02-07,713,ball pen,5,10,5,1,00462,India
145371,2024-02-07,717,spiral bound book,50,100,50,1,00202,India
145371,2024-02-07,701,gel pen,5,10,5,1,00202,India
177822,2024-02-07,707,marker,20,40,20,1,00233,India
177822,2024-02-07,714,carbon paper,15,30,15,1,00233,India
177822,2024-02-07,710,geometry box,100,150,50,1,00233,India
192911,2024-02-07,717,spiral bound book,50,100,50,1,00259,India
192911,2024-02-07,702,pencil,2,5,3,1,00259,India
192911,2024-02-07,704,scale,5,10,5,1,00259,India
600967,2024-02-07,709,notebook,30,60,30,1,00126,India
600967,2024-02-07,712,graph paper,20,40,20,1,00126,India
600967,2024-02-07,706,sharpener,3,8,5,1,00126,India
580193,2024-02-07,714,carbon paper,15,30,15,1,00480,India
580193,2024-02-07,711,TD kit,150,300,150,1,00480,India
948262,2024-02-08,717,spiral bound book,50,100,50,1,00319,India
989306,2024-02-08,716,printing paper,200,400,200,1,00147,India
989306,2024-02-08,706,sharpener,3,8,5,1,00147,India
989306,2024-02-08,713,ball pen,5,10,5,1,00147,India
989306,2024-02-08,704,scale,5,10,5,1,00147,India
937695,2024-02-08,703,eraser,1,3,2,1,00030,India
937695,2024-02-08,713,ball pen,5,10,5,1,00030,India
937695,2024-02-08,711,TD kit,150,300,150,1,00030,India
937695,2024-02-08,709,notebook,30,60,30,1,00030,India
882549,2024-02-08,715,folder,5,15,10,1,00297,India
882549,2024-02-08,703,eraser,1,3,2,1,00297,India
882549,2024-02-08,717,spiral bound book,50,100,50,1,00297,India
882549,2024-02-08,716,printing paper,200,400,200,1,00297,India
151452,2024-02-08,713,ball pen,5,10,5,1,00248,India
151452,2024-02-08,706,sharpener,3,8,5,1,00248,India
151452,2024-02-08,716,printing paper,200,400,200,1,00248,India
151452,2024-02-08,712,graph paper,20,40,20,1,00248,India
653864,2024-02-08,716,printing paper,200,400,200,1,00081,India
653864,2024-02-08,703,eraser,1,3,2,1,00081,India
103462,2024-02-08,704,scale,5,10,5,1,00266,India
103462,2024-02-08,714,carbon paper,15,30,15,1,00266,India
103462,2024-02-08,705,stencil,10,20,10,1,00266,India
103462,2024-02-08,706,sharpener,3,8,5,1,00266,India
931597,2024-02-08,704,scale,5,10,5,1,00466,India
931597,2024-02-08,713,ball pen,5,10,5,1,00466,India
931597,2024-02-08,715,folder,5,15,10,1,00466,India
633783,2024-02-08,711,TD kit,150,300,150,1,00172,India
633783,2024-02-08,713,ball pen,5,10,5,1,00172,India
278507,2024-02-08,703,eraser,1,3,2,1,00211,India
293380,2024-02-08,701,gel pen,5,10,5,1,00021,India
293380,2024-02-08,711,TD kit,150,300,150,1,00021,India
510737,2024-02-08,711,TD kit,150,300,150,1,00041,India
510737,2024-02-08,712,graph paper,20,40,20,1,00041,India
510737,2024-02-08,704,scale,5,10,5,1,00041,India
510737,2024-02-08,713,ball pen,5,10,5,1,00041,India
510737,2024-02-08,715,folder,5,15,10,1,00041,India
810943,2024-02-08,708,sketchpen,15,40,25,1,00240,India
810943,2024-02-08,703,eraser,1,3,2,1,00240,India
810943,2024-02-08,705,stencil,10,20,10,1,00240,India
810943,2024-02-08,701,gel pen,5,10,5,1,00240,India
408444,2024-02-08,717,spiral bound book,50,100,50,1,00154,India
776363,2024-02-08,714,carbon paper,15,30,15,1,00170,India
776363,2024-02-08,716,printing paper,200,400,200,1,00170,India
250625,2024-02-08,706,sharpener,3,8,5,1,00107,India
215817,2024-02-08,715,folder,5,15,10,1,00157,India
215817,2024-02-08,702,pencil,2,5,3,1,00157,India
215817,2024-02-08,710,geometry box,100,150,50,1,00157,India
215817,2024-02-08,711,TD kit,150,300,150,1,00157,India
657001,2024-02-08,705,stencil,10,20,10,1,00238,India
657001,2024-02-08,707,marker,20,40,20,1,00238,India
638849,2024-02-08,707,marker,20,40,20,1,00059,India
638849,2024-02-08,706,sharpener,3,8,5,1,00059,India
910062,2024-02-08,715,folder,5,15,10,1,00295,India
267342,2024-02-08,711,TD kit,150,300,150,1,00033,India
267342,2024-02-08,716,printing paper,200,400,200,1,00033,India
267342,2024-02-08,712,graph paper,20,40,20,1,00033,India
267342,2024-02-08,709,notebook,30,60,30,1,00033,India
267342,2024-02-08,704,scale,5,10,5,1,00033,India
990729,2024-02-08,708,sketchpen,15,40,25,1,00346,India
990729,2024-02-08,717,spiral bound book,50,100,50,1,00346,India
990729,2024-02-08,702,pencil,2,5,3,1,00346,India
603423,2024-02-08,704,scale,5,10,5,1,00177,India
603423,2024-02-08,703,eraser,1,3,2,1,00177,India
603423,2024-02-08,709,notebook,30,60,30,1,00177,India
763695,2024-02-08,708,sketchpen,15,40,25,1,00432,India
763695,2024-02-08,707,marker,20,40,20,1,00432,India
763695,2024-02-08,713,ball pen,5,10,5,1,00432,India
763695,2024-02-08,714,carbon paper,15,30,15,1,00432,India
411317,2024-02-08,705,stencil,10,20,10,1,00078,India
411317,2024-02-08,703,eraser,1,3,2,1,00078,India
411317,2024-02-08,714,carbon paper,15,30,15,1,00078,India
411317,2024-02-08,716,printing paper,200,400,200,1,00078,India
729207,2024-02-08,707,marker,20,40,20,1,00370,India
729207,2024-02-08,708,sketchpen,15,40,25,1,00370,India
729207,2024-02-08,713,ball pen,5,10,5,1,00370,India
887397,2024-02-08,703,eraser,1,3,2,1,00221,India
827483,2024-02-08,711,TD kit,150,300,150,1,00126,India
827483,2024-02-08,708,sketchpen,15,40,25,1,00126,India
827483,2024-02-08,709,notebook,30,60,30,1,00126,India
827483,2024-02-08,716,printing paper,200,400,200,1,00126,India
627837,2024-02-08,709,notebook,30,60,30,1,00395,India
627837,2024-02-08,715,folder,5,15,10,1,00395,India
231834,2024-02-08,706,sharpener,3,8,5,1,00052,India
231834,2024-02-08,702,pencil,2,5,3,1,00052,India
231834,2024-02-08,705,stencil,10,20,10,1,00052,India
231834,2024-02-08,715,folder,5,15,10,1,00052,India
231834,2024-02-08,704,scale,5,10,5,1,00052,India
355943,2024-02-08,701,gel pen,5,10,5,1,00176,India
355943,2024-02-08,710,geometry box,100,150,50,1,00176,India
355943,2024-02-08,709,notebook,30,60,30,1,00176,India
355943,2024-02-08,714,carbon paper,15,30,15,1,00176,India
554697,2024-02-08,706,sharpener,3,8,5,1,00120,India
270244,2024-02-08,714,carbon paper,15,30,15,1,00061,India
270244,2024-02-08,711,TD kit,150,300,150,1,00061,India
270244,2024-02-08,713,ball pen,5,10,5,1,00061,India
793388,2024-02-09,713,ball pen,5,10,5,1,00224,India
793388,2024-02-09,714,carbon paper,15,30,15,1,00224,India
793388,2024-02-09,715,folder,5,15,10,1,00224,India
828490,2024-02-09,716,printing paper,200,400,200,1,00475,India
828490,2024-02-09,717,spiral bound book,50,100,50,1,00475,India
243249,2024-02-09,711,TD kit,150,300,150,1,00017,India
243249,2024-02-09,716,printing paper,200,400,200,1,00017,India
243249,2024-02-09,702,pencil,2,5,3,1,00017,India
458928,2024-02-09,704,scale,5,10,5,1,00466,India
458928,2024-02-09,707,marker,20,40,20,1,00466,India
458928,2024-02-09,712,graph paper,20,40,20,1,00466,India
458928,2024-02-09,710,geometry box,100,150,50,1,00466,India
294761,2024-02-09,704,scale,5,10,5,1,00430,India
294761,2024-02-09,713,ball pen,5,10,5,1,00430,India
897197,2024-02-09,706,sharpener,3,8,5,1,00003,India
859336,2024-02-09,711,TD kit,150,300,150,1,00469,India
859336,2024-02-09,708,sketchpen,15,40,25,1,00469,India
767887,2024-02-09,713,ball pen,5,10,5,1,00251,India
767887,2024-02-09,707,marker,20,40,20,1,00251,India
767887,2024-02-09,714,carbon paper,15,30,15,1,00251,India
313509,2024-02-09,703,eraser,1,3,2,1,00123,India
313509,2024-02-09,712,graph paper,20,40,20,1,00123,India
683404,2024-02-09,712,graph paper,20,40,20,1,00252,India
683404,2024-02-09,715,folder,5,15,10,1,00252,India
774157,2024-02-09,709,notebook,30,60,30,1,00145,India
982168,2024-02-09,705,stencil,10,20,10,1,00064,India
982168,2024-02-09,706,sharpener,3,8,5,1,00064,India
982168,2024-02-09,713,ball pen,5,10,5,1,00064,India
994781,2024-02-09,708,sketchpen,15,40,25,1,00352,India
525450,2024-02-09,702,pencil,2,5,3,1,00379,India
634543,2024-02-09,703,eraser,1,3,2,1,00032,India
634543,2024-02-09,705,stencil,10,20,10,1,00032,India
634543,2024-02-09,712,graph paper,20,40,20,1,00032,India
634543,2024-02-09,704,scale,5,10,5,1,00032,India
634543,2024-02-09,715,folder,5,15,10,1,00032,India
751723,2024-02-09,702,pencil,2,5,3,1,00083,India
751723,2024-02-09,707,marker,20,40,20,1,00083,India
751723,2024-02-09,705,stencil,10,20,10,1,00083,India
751723,2024-02-09,703,eraser,1,3,2,1,00083,India
751723,2024-02-09,706,sharpener,3,8,5,1,00083,India
455225,2024-02-09,715,folder,5,15,10,1,00084,India
793919,2024-02-09,710,geometry box,100,150,50,1,00254,India
793919,2024-02-09,701,gel pen,5,10,5,1,00254,India
793919,2024-02-09,705,stencil,10,20,10,1,00254,India
724159,2024-02-09,715,folder,5,15,10,1,00026,India
934220,2024-02-09,713,ball pen,5,10,5,1,00330,India
934220,2024-02-09,717,spiral bound book,50,100,50,1,00330,India
934220,2024-02-09,706,sharpener,3,8,5,1,00330,India
829413,2024-02-09,705,stencil,10,20,10,1,00487,India
659835,2024-02-09,707,marker,20,40,20,1,00480,India
659835,2024-02-09,716,printing paper,200,400,200,1,00480,India
659835,2024-02-09,711,TD kit,150,300,150,1,00480,India
659835,2024-02-09,701,gel pen,5,10,5,1,00480,India
856726,2024-02-09,709,notebook,30,60,30,1,00314,India
856726,2024-02-09,705,stencil,10,20,10,1,00314,India
856726,2024-02-09,715,folder,5,15,10,1,00314,India
943611,2024-02-09,712,graph paper,20,40,20,1,00402,India
943611,2024-02-09,702,pencil,2,5,3,1,00402,India
943611,2024-02-09,707,marker,20,40,20,1,00402,India
604064,2024-02-09,702,pencil,2,5,3,1,00054,India
604064,2024-02-09,706,sharpener,3,8,5,1,00054,India
604064,2024-02-09,713,ball pen,5,10,5,1,00054,India
745570,2024-02-09,712,graph paper,20,40,20,1,00093,India
745570,2024-02-09,703,eraser,1,3,2,1,00093,India
834430,2024-02-09,716,printing paper,200,400,200,1,00391,India
401714,2024-02-09,713,ball pen,5,10,5,1,00459,India
401714,2024-02-09,704,scale,5,10,5,1,00459,India
401714,2024-02-09,707,marker,20,40,20,1,00459,India
401714,2024-02-09,702,pencil,2,5,3,1,00459,India
255166,2024-02-09,708,sketchpen,15,40,25,1,00062,India
255166,2024-02-09,710,geometry box,100,150,50,1,00062,India
255166,2024-02-09,701,gel pen,5,10,5,1,00062,India
255166,2024-02-09,703,eraser,1,3,2,1,00062,India
157429,2024-02-09,716,printing paper,200,400,200,1,00115,India
704392,2024-02-09,711,TD kit,150,300,150,1,00157,India
704392,2024-02-09,704,scale,5,10,5,1,00157,India
484174,2024-02-09,703,eraser,1,3,2,1,00296,India
484174,2024-02-09,704,scale,5,10,5,1,00296,India
484174,2024-02-09,711,TD kit,150,300,150,1,00296,India
404866,2024-02-09,707,marker,20,40,20,1,00282,India
404866,2024-02-09,703,eraser,1,3,2,1,00282,India
404866,2024-02-09,717,spiral bound book,50,100,50,1,00282,India
362899,2024-02-09,707,marker,20,40,20,1,00195,India
362899,2024-02-09,716,printing paper,200,400,200,1,00195,India
362899,2024-02-09,701,gel pen,5,10,5,1,00195,India
564026,2024-02-09,705,stencil,10,20,10,1,00038,India
564026,2024-02-09,702,pencil,2,5,3,1,00038,India
564026,2024-02-09,703,eraser,1,3,2,1,00038,India
564026,2024-02-09,717,spiral bound book,50,100,50,1,00038,India
380356,2024-02-09,707,marker,20,40,20,1,00166,India
380356,2024-02-09,717,spiral bound book,50,100,50,1,00166,India
200628,2024-02-09,704,scale,5,10,5,1,00382,India
200628,2024-02-09,711,TD kit,150,300,150,1,00382,India
200628,2024-02-09,701,gel pen,5,10,5,1,00382,India
475503,2024-02-09,717,spiral bound book,50,100,50,1,00135,India
475503,2024-02-09,716,printing paper,200,400,200,1,00135,India
475503,2024-02-09,714,carbon paper,15,30,15,1,00135,India
475503,2024-02-09,709,notebook,30,60,30,1,00135,India
964957,2024-02-09,705,stencil,10,20,10,1,00296,India
232568,2024-02-09,707,marker,20,40,20,1,00212,India
719350,2024-02-09,703,eraser,1,3,2,1,00157,India
719350,2024-02-09,713,ball pen,5,10,5,1,00157,India
719350,2024-02-09,705,stencil,10,20,10,1,00157,India
719350,2024-02-09,716,printing paper,200,400,200,1,00157,India
867430,2024-02-09,703,eraser,1,3,2,1,00473,India
867430,2024-02-09,716,printing paper,200,400,200,1,00473,India
867430,2024-02-09,705,stencil,10,20,10,1,00473,India
867430,2024-02-09,713,ball pen,5,10,5,1,00473,India
867430,2024-02-09,710,geometry box,100,150,50,1,00473,India
134458,2024-02-10,715,folder,5,15,10,1,00301,India
134458,2024-02-10,717,spiral bound book,50,100,50,1,00301,India
244393,2024-02-10,709,notebook,30,60,30,1,00366,India
118800,2024-02-10,707,marker,20,40,20,1,00437,India
878089,2024-02-10,716,printing paper,200,400,200,1,00370,India
457287,2024-02-10,713,ball pen,5,10,5,1,00348,India
264725,2024-02-10,710,geometry box,100,150,50,1,00104,India
264725,2024-02-10,701,gel pen,5,10,5,1,00104,India
264725,2024-02-10,717,spiral bound book,50,100,50,1,00104,India
210225,2024-02-10,711,TD kit,150,300,150,1,00186,India
120362,2024-02-10,704,scale,5,10,5,1,00038,India
120362,2024-02-10,713,ball pen,5,10,5,1,00038,India
122354,2024-02-10,705,stencil,10,20,10,1,00494,India
122354,2024-02-10,708,sketchpen,15,40,25,1,00494,India
122354,2024-02-10,710,geometry box,100,150,50,1,00494,India
122354,2024-02-10,713,ball pen,5,10,5,1,00494,India
122354,2024-02-10,714,carbon paper,15,30,15,1,00494,India
327841,2024-02-10,706,sharpener,3,8,5,1,00094,India
327841,2024-02-10,714,carbon paper,15,30,15,1,00094,India
327841,2024-02-10,703,eraser,1,3,2,1,00094,India
327841,2024-02-10,705,stencil,10,20,10,1,00094,India
879613,2024-02-10,707,marker,20,40,20,1,00116,India
879613,2024-02-10,706,sharpener,3,8,5,1,00116,India
651752,2024-02-10,704,scale,5,10,5,1,00451,India
651752,2024-02-10,709,notebook,30,60,30,1,00451,India
651752,2024-02-10,714,carbon paper,15,30,15,1,00451,India
651752,2024-02-10,702,pencil,2,5,3,1,00451,India
513874,2024-02-10,710,geometry box,100,150,50,1,00024,India
513874,2024-02-10,705,stencil,10,20,10,1,00024,India
513874,2024-02-10,701,gel pen,5,10,5,1,00024,India
375110,2024-02-10,702,pencil,2,5,3,1,00121,India
375110,2024-02-10,706,sharpener,3,8,5,1,00121,India
375110,2024-02-10,707,marker,20,40,20,1,00121,India
336666,2024-02-10,703,eraser,1,3,2,1,00473,India
336666,2024-02-10,713,ball pen,5,10,5,1,00473,India
770265,2024-02-10,712,graph paper,20,40,20,1,00157,India
770265,2024-02-10,717,spiral bound book,50,100,50,1,00157,India
770265,2024-02-10,704,scale,5,10,5,1,00157,India
862606,2024-02-10,704,scale,5,10,5,1,00396,India
862606,2024-02-10,715,folder,5,15,10,1,00396,India
862606,2024-02-10,710,geometry box,100,150,50,1,00396,India
865374,2024-02-10,710,geometry box,100,150,50,1,00118,India
865374,2024-02-10,708,sketchpen,15,40,25,1,00118,India
865374,2024-02-10,701,gel pen,5,10,5,1,00118,India
865374,2024-02-10,713,ball pen,5,10,5,1,00118,India
865374,2024-02-10,706,sharpener,3,8,5,1,00118,India
600567,2024-02-10,709,notebook,30,60,30,1,00490,India
600567,2024-02-10,716,printing paper,200,400,200,1,00490,India
600567,2024-02-10,711,TD kit,150,300,150,1,00490,India
600567,2024-02-10,712,graph paper,20,40,20,1,00490,India
600567,2024-02-10,702,pencil,2,5,3,1,00490,India
589422,2024-02-10,711,TD kit,150,300,150,1,00498,India
589422,2024-02-10,702,pencil,2,5,3,1,00498,India
589422,2024-02-10,716,printing paper,200,400,200,1,00498,India
589422,2024-02-10,715,folder,5,15,10,1,00498,India
589422,2024-02-10,708,sketchpen,15,40,25,1,00498,India
119459,2024-02-10,702,pencil,2,5,3,1,00449,India
119459,2024-02-10,715,folder,5,15,10,1,00449,India
666355,2024-02-10,707,marker,20,40,20,1,00186,India
666355,2024-02-10,706,sharpener,3,8,5,1,00186,India
666355,2024-02-10,714,carbon paper,15,30,15,1,00186,India
666355,2024-02-10,708,sketchpen,15,40,25,1,00186,India
914377,2024-02-10,703,eraser,1,3,2,1,00419,India
914377,2024-02-10,707,marker,20,40,20,1,00419,India
914377,2024-02-10,713,ball pen,5,10,5,1,00419,India
914377,2024-02-10,702,pencil,2,5,3,1,00419,India
914377,2024-02-10,714,carbon paper,15,30,15,1,00419,India
118838,2024-02-10,706,sharpener,3,8,5,1,00341,India
118838,2024-02-10,701,gel pen,5,10,5,1,00341,India
118838,2024-02-10,704,scale,5,10,5,1,00341,India
121450,2024-02-10,704,scale,5,10,5,1,00096,India
121450,2024-02-10,708,sketchpen,15,40,25,1,00096,India
338297,2024-02-10,714,carbon paper,15,30,15,1,00100,India
338297,2024-02-10,704,scale,5,10,5,1,00100,India
338297,2024-02-10,706,sharpener,3,8,5,1,00100,India
338297,2024-02-10,712,graph paper,20,40,20,1,00100,India
520150,2024-02-10,711,TD kit,150,300,150,1,00436,India
313817,2024-02-10,702,pencil,2,5,3,1,00163,India
313817,2024-02-10,717,spiral bound book,50,100,50,1,00163,India
313817,2024-02-10,716,printing paper,200,400,200,1,00163,India
313817,2024-02-10,705,stencil,10,20,10,1,00163,India
857917,2024-02-10,707,marker,20,40,20,1,00435,India
567546,2024-02-10,703,eraser,1,3,2,1,00445,India
881127,2024-02-10,709,notebook,30,60,30,1,00131,India
110139,2024-02-10,716,printing paper,200,400,200,1,00338,India
233166,2024-02-11,712,graph paper,20,40,20,1,00258,India
186518,2024-02-11,711,TD kit,150,300,150,1,00395,India
186518,2024-02-11,714,carbon paper,15,30,15,1,00395,India
706342,2024-02-11,710,geometry box,100,150,50,1,00479,India
119030,2024-02-11,715,folder,5,15,10,1,00322,India
926806,2024-02-11,709,notebook,30,60,30,1,00328,India
926806,2024-02-11,708,sketchpen,15,40,25,1,00328,India
106619,2024-02-11,706,sharpener,3,8,5,1,00402,India
106619,2024-02-11,710,geometry box,100,150,50,1,00402,India
106619,2024-02-11,702,pencil,2,5,3,1,00402,India
106619,2024-02-11,701,gel pen,5,10,5,1,00402,India
106619,2024-02-11,705,stencil,10,20,10,1,00402,India
619557,2024-02-11,712,graph paper,20,40,20,1,00367,India
619557,2024-02-11,707,marker,20,40,20,1,00367,India
619557,2024-02-11,711,TD kit,150,300,150,1,00367,India
391887,2024-02-11,701,gel pen,5,10,5,1,00081,India
391887,2024-02-11,708,sketchpen,15,40,25,1,00081,India
391887,2024-02-11,706,sharpener,3,8,5,1,00081,India
391887,2024-02-11,705,stencil,10,20,10,1,00081,India
391887,2024-02-11,713,ball pen,5,10,5,1,00081,India
741129,2024-02-11,707,marker,20,40,20,1,00074,India
741129,2024-02-11,714,carbon paper,15,30,15,1,00074,India
455975,2024-02-11,701,gel pen,5,10,5,1,00276,India
455975,2024-02-11,706,sharpener,3,8,5,1,00276,India
505404,2024-02-11,709,notebook,30,60,30,1,00468,India
505404,2024-02-11,704,scale,5,10,5,1,00468,India
505404,2024-02-11,706,sharpener,3,8,5,1,00468,India
505404,2024-02-11,715,folder,5,15,10,1,00468,India
377792,2024-02-11,711,TD kit,150,300,150,1,00398,India
776241,2024-02-11,708,sketchpen,15,40,25,1,00393,India
776241,2024-02-11,713,ball pen,5,10,5,1,00393,India
776241,2024-02-11,715,folder,5,15,10,1,00393,India
201170,2024-02-11,702,pencil,2,5,3,1,00384,India
201170,2024-02-11,708,sketchpen,15,40,25,1,00384,India
201170,2024-02-11,712,graph paper,20,40,20,1,00384,India
201170,2024-02-11,703,eraser,1,3,2,1,00384,India
201170,2024-02-11,717,spiral bound book,50,100,50,1,00384,India
771611,2024-02-11,703,eraser,1,3,2,1,00449,India
985645,2024-02-11,715,folder,5,15,10,1,00375,India
985645,2024-02-11,711,TD kit,150,300,150,1,00375,India
262103,2024-02-11,711,TD kit,150,300,150,1,00012,India
262103,2024-02-11,706,sharpener,3,8,5,1,00012,India
262103,2024-02-11,707,marker,20,40,20,1,00012,India
692377,2024-02-11,701,gel pen,5,10,5,1,00138,India
964077,2024-02-11,717,spiral bound book,50,100,50,1,00412,India
343662,2024-02-11,706,sharpener,3,8,5,1,00141,India
343662,2024-02-11,717,spiral bound book,50,100,50,1,00141,India
884619,2024-02-11,704,scale,5,10,5,1,00179,India
884619,2024-02-11,710,geometry box,100,150,50,1,00179,India
884619,2024-02-11,711,TD kit,150,300,150,1,00179,India
884619,2024-02-11,701,gel pen,5,10,5,1,00179,India
884619,2024-02-11,717,spiral bound book,50,100,50,1,00179,India
428383,2024-02-11,708,sketchpen,15,40,25,1,00152,India
428383,2024-02-11,713,ball pen,5,10,5,1,00152,India
428383,2024-02-11,709,notebook,30,60,30,1,00152,India
172797,2024-02-11,715,folder,5,15,10,1,00189,India
172797,2024-02-11,709,notebook,30,60,30,1,00189,India
172797,2024-02-11,705,stencil,10,20,10,1,00189,India
172797,2024-02-11,717,spiral bound book,50,100,50,1,00189,India
411683,2024-02-11,706,sharpener,3,8,5,1,00424,India
411683,2024-02-11,701,gel pen,5,10,5,1,00424,India
411683,2024-02-11,709,notebook,30,60,30,1,00424,India
411683,2024-02-11,705,stencil,10,20,10,1,00424,India
796838,2024-02-11,706,sharpener,3,8,5,1,00418,India
903577,2024-02-11,714,carbon paper,15,30,15,1,00469,India
903577,2024-02-11,706,sharpener,3,8,5,1,00469,India
903577,2024-02-11,708,sketchpen,15,40,25,1,00469,India
488696,2024-02-11,711,TD kit,150,300,150,1,00119,India
488696,2024-02-11,714,carbon paper,15,30,15,1,00119,India
488696,2024-02-11,710,geometry box,100,150,50,1,00119,India
268615,2024-02-11,712,graph paper,20,40,20,1,00274,India
125917,2024-02-11,714,carbon paper,15,30,15,1,00372,India
125917,2024-02-11,701,gel pen,5,10,5,1,00372,India
125917,2024-02-11,715,folder,5,15,10,1,00372,India
125917,2024-02-11,705,stencil,10,20,10,1,00372,India
234124,2024-02-11,715,folder,5,15,10,1,00183,India
685306,2024-02-11,703,eraser,1,3,2,1,00461,India
685306,2024-02-11,715,folder,5,15,10,1,00461,India
685306,2024-02-11,705,stencil,10,20,10,1,00461,India
685306,2024-02-11,709,notebook,30,60,30,1,00461,India
713936,2024-02-11,701,gel pen,5,10,5,1,00433,India
713936,2024-02-11,706,sharpener,3,8,5,1,00433,India
713936,2024-02-11,716,printing paper,200,400,200,1,00433,India
713936,2024-02-11,717,spiral bound book,50,100,50,1,00433,India
713936,2024-02-11,702,pencil,2,5,3,1,00433,India
266059,2024-02-11,704,scale,5,10,5,1,00134,India
266059,2024-02-11,702,pencil,2,5,3,1,00134,India
266059,2024-02-11,707,marker,20,40,20,1,00134,India
266059,2024-02-11,708,sketchpen,15,40,25,1,00134,India
225065,2024-02-11,706,sharpener,3,8,5,1,00472,India
225065,2024-02-11,714,carbon paper,15,30,15,1,00472,India
225065,2024-02-11,705,stencil,10,20,10,1,00472,India
225065,2024-02-11,716,printing paper,200,400,200,1,00472,India
650994,2024-02-11,705,stencil,10,20,10,1,00307,India
650994,2024-02-11,716,printing paper,200,400,200,1,00307,India
650994,2024-02-11,717,spiral bound book,50,100,50,1,00307,India
575141,2024-02-11,714,carbon paper,15,30,15,1,00361,India
875729,2024-02-11,714,carbon paper,15,30,15,1,00356,India
875729,2024-02-11,704,scale,5,10,5,1,00356,India
875729,2024-02-11,710,geometry box,100,150,50,1,00356,India
875729,2024-02-11,705,stencil,10,20,10,1,00356,India
875729,2024-02-11,701,gel pen,5,10,5,1,00356,India
764358,2024-02-11,704,scale,5,10,5,1,00363,India
691066,2024-02-11,709,notebook,30,60,30,1,00019,India
691066,2024-02-11,701,gel pen,5,10,5,1,00019,India
691066,2024-02-11,715,folder,5,15,10,1,00019,India
691066,2024-02-11,712,graph paper,20,40,20,1,00019,India
691066,2024-02-11,703,eraser,1,3,2,1,00019,India
522636,2024-02-11,716,printing paper,200,400,200,1,00438,India
522636,2024-02-11,712,graph paper,20,40,20,1,00438,India
522636,2024-02-11,703,eraser,1,3,2,1,00438,India
522636,2024-02-11,709,notebook,30,60,30,1,00438,India
522636,2024-02-11,713,ball pen,5,10,5,1,00438,India
132155,2024-02-11,701,gel pen,5,10,5,1,00088,India
132155,2024-02-11,704,scale,5,10,5,1,00088,India
132155,2024-02-11,716,printing paper,200,400,200,1,00088,India
132155,2024-02-11,713,ball pen,5,10,5,1,00088,India
209897,2024-02-11,703,eraser,1,3,2,1,00128,India
209897,2024-02-11,702,pencil,2,5,3,1,00128,India
209897,2024-02-11,706,sharpener,3,8,5,1,00128,India
209897,2024-02-11,709,notebook,30,60,30,1,00128,India
434682,2024-02-11,716,printing paper,200,400,200,1,00461,India
466111,2024-02-11,713,ball pen,5,10,5,1,00227,India
466111,2024-02-11,702,pencil,2,5,3,1,00227,India
466111,2024-02-11,703,eraser,1,3,2,1,00227,India
899185,2024-02-12,707,marker,20,40,20,1,00073,India
899185,2024-02-12,708,sketchpen,15,40,25,1,00073,India
899185,2024-02-12,703,eraser,1,3,2,1,00073,India
965306,2024-02-12,701,gel pen,5,10,5,1,00406,India
583708,2024-02-12,716,printing paper,200,400,200,1,00229,India
583708,2024-02-12,713,ball pen,5,10,5,1,00229,India
397172,2024-02-12,701,gel pen,5,10,5,1,00329,India
397172,2024-02-12,705,stencil,10,20,10,1,00329,India
397172,2024-02-12,707,marker,20,40,20,1,00329,India
855333,2024-02-12,708,sketchpen,15,40,25,1,00438,India
855333,2024-02-12,701,gel pen,5,10,5,1,00438,India
442916,2024-02-12,717,spiral bound book,50,100,50,1,00042,India
442916,2024-02-12,704,scale,5,10,5,1,00042,India
442916,2024-02-12,701,gel pen,5,10,5,1,00042,India
442916,2024-02-12,705,stencil,10,20,10,1,00042,India
847403,2024-02-12,713,ball pen,5,10,5,1,00401,India
599672,2024-02-12,706,sharpener,3,8,5,1,00254,India
599672,2024-02-12,704,scale,5,10,5,1,00254,India
392293,2024-02-12,703,eraser,1,3,2,1,00109,India
392293,2024-02-12,704,scale,5,10,5,1,00109,India
392293,2024-02-12,712,graph paper,20,40,20,1,00109,India
506057,2024-02-12,707,marker,20,40,20,1,00486,India
506057,2024-02-12,706,sharpener,3,8,5,1,00486,India
506057,2024-02-12,717,spiral bound book,50,100,50,1,00486,India
506057,2024-02-12,703,eraser,1,3,2,1,00486,India
897844,2024-02-12,716,printing paper,200,400,200,1,00010,India
897844,2024-02-12,712,graph paper,20,40,20,1,00010,India
260067,2024-02-12,715,folder,5,15,10,1,00246,India
908207,2024-02-12,704,scale,5,10,5,1,00329,India
908207,2024-02-12,716,printing paper,200,400,200,1,00329,India
908207,2024-02-12,712,graph paper,20,40,20,1,00329,India
908207,2024-02-12,714,carbon paper,15,30,15,1,00329,India
908207,2024-02-12,707,marker,20,40,20,1,00329,India
887759,2024-02-12,706,sharpener,3,8,5,1,00192,India
887759,2024-02-12,717,spiral bound book,50,100,50,1,00192,India
887759,2024-02-12,701,gel pen,5,10,5,1,00192,India
887759,2024-02-12,716,printing paper,200,400,200,1,00192,India
773936,2024-02-12,717,spiral bound book,50,100,50,1,00262,India
773936,2024-02-12,715,folder,5,15,10,1,00262,India
773936,2024-02-12,709,notebook,30,60,30,1,00262,India
773936,2024-02-12,714,carbon paper,15,30,15,1,00262,India
479926,2024-02-12,707,marker,20,40,20,1,00037,India
479926,2024-02-12,701,gel pen,5,10,5,1,00037,India
479926,2024-02-12,715,folder,5,15,10,1,00037,India
403086,2024-02-12,711,TD kit,150,300,150,1,00352,India
403086,2024-02-12,712,graph paper,20,40,20,1,00352,India
403086,2024-02-12,708,sketchpen,15,40,25,1,00352,India
604610,2024-02-12,714,carbon paper,15,30,15,1,00035,India
604610,2024-02-12,703,eraser,1,3,2,1,00035,India
604610,2024-02-12,712,graph paper,20,40,20,1,00035,India
604610,2024-02-12,706,sharpener,3,8,5,1,00035,India
817728,2024-02-12,716,printing paper,200,400,200,1,00027,India
392379,2024-02-12,717,spiral bound book,50,100,50,1,00159,India
392379,2024-02-12,711,TD kit,150,300,150,1,00159,India
392379,2024-02-12,706,sharpener,3,8,5,1,00159,India
392379,2024-02-12,708,sketchpen,15,40,25,1,00159,India
392379,2024-02-12,707,marker,20,40,20,1,00159,India
375099,2024-02-12,704,scale,5,10,5,1,00360,India
375099,2024-02-12,702,pencil,2,5,3,1,00360,India
375099,2024-02-12,713,ball pen,5,10,5,1,00360,India
134014,2024-02-12,713,ball pen,5,10,5,1,00360,India
134014,2024-02-12,711,TD kit,150,300,150,1,00360,India
134014,2024-02-12,704,scale,5,10,5,1,00360,India
134014,2024-02-12,716,printing paper,200,400,200,1,00360,India
134014,2024-02-12,712,graph paper,20,40,20,1,00360,India
565731,2024-02-12,707,marker,20,40,20,1,00375,India
565731,2024-02-12,716,printing paper,200,400,200,1,00375,India
565731,2024-02-12,715,folder,5,15,10,1,00375,India
565731,2024-02-12,710,geometry box,100,150,50,1,00375,India
220944,2024-02-12,715,folder,5,15,10,1,00252,India
220944,2024-02-12,711,TD kit,150,300,150,1,00252,India
220944,2024-02-12,716,printing paper,200,400,200,1,00252,India
388376,2024-02-12,705,stencil,10,20,10,1,00166,India
388376,2024-02-12,706,sharpener,3,8,5,1,00166,India
388376,2024-02-12,704,scale,5,10,5,1,00166,India
388376,2024-02-12,715,folder,5,15,10,1,00166,India
757131,2024-02-12,702,pencil,2,5,3,1,00261,India
757131,2024-02-12,706,sharpener,3,8,5,1,00261,India
993072,2024-02-12,708,sketchpen,15,40,25,1,00458,India
993072,2024-02-12,717,spiral bound book,50,100,50,1,00458,India
993072,2024-02-12,705,stencil,10,20,10,1,00458,India
993072,2024-02-12,710,geometry box,100,150,50,1,00458,India
993072,2024-02-12,707,marker,20,40,20,1,00458,India
709628,2024-02-12,706,sharpener,3,8,5,1,00463,India
709628,2024-02-12,714,carbon paper,15,30,15,1,00463,India
674633,2024-02-12,710,geometry box,100,150,50,1,00486,India
674633,2024-02-12,715,folder,5,15,10,1,00486,India
674633,2024-02-12,713,ball pen,5,10,5,1,00486,India
674633,2024-02-12,704,scale,5,10,5,1,00486,India
885171,2024-02-12,705,stencil,10,20,10,1,00280,India
885171,2024-02-12,717,spiral bound book,50,100,50,1,00280,India
885171,2024-02-12,707,marker,20,40,20,1,00280,India
668441,2024-02-12,713,ball pen,5,10,5,1,00436,India
668441,2024-02-12,716,printing paper,200,400,200,1,00436,India
668441,2024-02-12,712,graph paper,20,40,20,1,00436,India
849185,2024-02-12,705,stencil,10,20,10,1,00066,India
849185,2024-02-12,716,printing paper,200,400,200,1,00066,India
849185,2024-02-12,707,marker,20,40,20,1,00066,India
849185,2024-02-12,701,gel pen,5,10,5,1,00066,India
361396,2024-02-12,706,sharpener,3,8,5,1,00444,India
361396,2024-02-12,716,printing paper,200,400,200,1,00444,India
361396,2024-02-12,713,ball pen,5,10,5,1,00444,India
873142,2024-02-13,717,spiral bound book,50,100,50,1,00251,India
873142,2024-02-13,702,pencil,2,5,3,1,00251,India
873142,2024-02-13,708,sketchpen,15,40,25,1,00251,India
806850,2024-02-13,706,sharpener,3,8,5,1,00101,India
806850,2024-02-13,713,ball pen,5,10,5,1,00101,India
806850,2024-02-13,709,notebook,30,60,30,1,00101,India
353122,2024-02-13,716,printing paper,200,400,200,1,00285,India
353122,2024-02-13,717,spiral bound book,50,100,50,1,00285,India
353122,2024-02-13,706,sharpener,3,8,5,1,00285,India
259291,2024-02-13,715,folder,5,15,10,1,00115,India
259291,2024-02-13,702,pencil,2,5,3,1,00115,India
259291,2024-02-13,705,stencil,10,20,10,1,00115,India
809541,2024-02-13,709,notebook,30,60,30,1,00181,India
542549,2024-02-13,708,sketchpen,15,40,25,1,00269,India
542549,2024-02-13,714,carbon paper,15,30,15,1,00269,India
739287,2024-02-13,713,ball pen,5,10,5,1,00450,India
599236,2024-02-13,710,geometry box,100,150,50,1,00298,India
599236,2024-02-13,709,notebook,30,60,30,1,00298,India
599236,2024-02-13,714,carbon paper,15,30,15,1,00298,India
599236,2024-02-13,705,stencil,10,20,10,1,00298,India
599236,2024-02-13,707,marker,20,40,20,1,00298,India
459143,2024-02-13,708,sketchpen,15,40,25,1,00145,India
459143,2024-02-13,716,printing paper,200,400,200,1,00145,India
459143,2024-02-13,713,ball pen,5,10,5,1,00145,India
535492,2024-02-13,711,TD kit,150,300,150,1,00445,India
396068,2024-02-13,716,printing paper,200,400,200,1,00377,India
396068,2024-02-13,703,eraser,1,3,2,1,00377,India
396068,2024-02-13,710,geometry box,100,150,50,1,00377,India
421879,2024-02-13,711,TD kit,150,300,150,1,00258,India
421879,2024-02-13,707,marker,20,40,20,1,00258,India
421879,2024-02-13,703,eraser,1,3,2,1,00258,India
957397,2024-02-13,713,ball pen,5,10,5,1,00491,India
957397,2024-02-13,702,pencil,2,5,3,1,00491,India
957397,2024-02-13,706,sharpener,3,8,5,1,00491,India
449112,2024-02-13,710,geometry box,100,150,50,1,00404,India
449112,2024-02-13,701,gel pen,5,10,5,1,00404,India
449112,2024-02-13,709,notebook,30,60,30,1,00404,India
449112,2024-02-13,704,scale,5,10,5,1,00404,India
449112,2024-02-13,707,marker,20,40,20,1,00404,India
341402,2024-02-13,701,gel pen,5,10,5,1,00358,India
105626,2024-02-13,709,notebook,30,60,30,1,00316,India
105626,2024-02-13,707,marker,20,40,20,1,00316,India
105626,2024-02-13,712,graph paper,20,40,20,1,00316,India
105626,2024-02-13,708,sketchpen,15,40,25,1,00316,India
105626,2024-02-13,701,gel pen,5,10,5,1,00316,India
136620,2024-02-13,701,gel pen,5,10,5,1,00121,India
136620,2024-02-13,714,carbon paper,15,30,15,1,00121,India
136620,2024-02-13,716,printing paper,200,400,200,1,00121,India
136620,2024-02-13,717,spiral bound book,50,100,50,1,00121,India
125241,2024-02-13,705,stencil,10,20,10,1,00311,India
560396,2024-02-13,702,pencil,2,5,3,1,00085,India
560396,2024-02-13,710,geometry box,100,150,50,1,00085,India
560396,2024-02-13,703,eraser,1,3,2,1,00085,India
560396,2024-02-13,705,stencil,10,20,10,1,00085,India
560396,2024-02-13,714,carbon paper,15,30,15,1,00085,India
365804,2024-02-13,714,carbon paper,15,30,15,1,00250,India
365804,2024-02-13,705,stencil,10,20,10,1,00250,India
365804,2024-02-13,702,pencil,2,5,3,1,00250,India
365804,2024-02-13,701,gel pen,5,10,5,1,00250,India
374426,2024-02-13,707,marker,20,40,20,1,00040,India
374426,2024-02-13,714,carbon paper,15,30,15,1,00040,India
374426,2024-02-13,716,printing paper,200,400,200,1,00040,India
689106,2024-02-13,708,sketchpen,15,40,25,1,00213,India
689106,2024-02-13,717,spiral bound book,50,100,50,1,00213,India
689106,2024-02-13,709,notebook,30,60,30,1,00213,India
580059,2024-02-13,703,eraser,1,3,2,1,00393,India
580059,2024-02-13,702,pencil,2,5,3,1,00393,India
580059,2024-02-13,713,ball pen,5,10,5,1,00393,India
580059,2024-02-13,710,geometry box,100,150,50,1,00393,India
580059,2024-02-13,708,sketchpen,15,40,25,1,00393,India
268118,2024-02-13,707,marker,20,40,20,1,00410,India
268118,2024-02-13,716,printing paper,200,400,200,1,00410,India
268118,2024-02-13,703,eraser,1,3,2,1,00410,India
969777,2024-02-13,710,geometry box,100,150,50,1,00380,India
969777,2024-02-13,703,eraser,1,3,2,1,00380,India
969777,2024-02-13,717,spiral bound book,50,100,50,1,00380,India
969777,2024-02-13,711,TD kit,150,300,150,1,00380,India
997426,2024-02-13,706,sharpener,3,8,5,1,00290,India
259657,2024-02-13,716,printing paper,200,400,200,1,00321,India
380254,2024-02-13,701,gel pen,5,10,5,1,00362,India
380254,2024-02-13,708,sketchpen,15,40,25,1,00362,India
380254,2024-02-13,705,stencil,10,20,10,1,00362,India
380254,2024-02-13,717,spiral bound book,50,100,50,1,00362,India
380254,2024-02-13,714,carbon paper,15,30,15,1,00362,India
871572,2024-02-13,710,geometry box,100,150,50,1,00280,India
800378,2024-02-13,715,folder,5,15,10,1,00379,India
800378,2024-02-13,712,graph paper,20,40,20,1,00379,India
800378,2024-02-13,717,spiral bound book,50,100,50,1,00379,India
800378,2024-02-13,709,notebook,30,60,30,1,00379,India
326733,2024-02-13,711,TD kit,150,300,150,1,00301,India
326733,2024-02-13,714,carbon paper,15,30,15,1,00301,India
326733,2024-02-13,712,graph paper,20,40,20,1,00301,India
660478,2024-02-13,702,pencil,2,5,3,1,00089,India
660478,2024-02-13,705,stencil,10,20,10,1,00089,India
660478,2024-02-13,711,TD kit,150,300,150,1,00089,India
462048,2024-02-13,704,scale,5,10,5,1,00079,India
462048,2024-02-13,716,printing paper,200,400,200,1,00079,India
269122,2024-02-13,708,sketchpen,15,40,25,1,00334,India
269122,2024-02-13,706,sharpener,3,8,5,1,00334,India
626929,2024-02-13,717,spiral bound book,50,100,50,1,00490,India
626929,2024-02-13,703,eraser,1,3,2,1,00490,India
626929,2024-02-13,702,pencil,2,5,3,1,00490,India
626929,2024-02-13,714,carbon paper,15,30,15,1,00490,India
487611,2024-02-13,717,spiral bound book,50,100,50,1,00094,India
487611,2024-02-13,710,geometry box,100,150,50,1,00094,India
487611,2024-02-13,711,TD kit,150,300,150,1,00094,India
487611,2024-02-13,704,scale,5,10,5,1,00094,India
448206,2024-02-13,702,pencil,2,5,3,1,00039,India
245404,2024-02-13,701,gel pen,5,10,5,1,00311,India
245404,2024-02-13,708,sketchpen,15,40,25,1,00311,India
344845,2024-02-13,712,graph paper,20,40,20,1,00439,India
344845,2024-02-13,703,eraser,1,3,2,1,00439,India
344845,2024-02-13,702,pencil,2,5,3,1,00439,India
344845,2024-02-13,713,ball pen,5,10,5,1,00439,India
574076,2024-02-13,715,folder,5,15,10,1,00091,India
574076,2024-02-13,717,spiral bound book,50,100,50,1,00091,India
574076,2024-02-13,709,notebook,30,60,30,1,00091,India
574076,2024-02-13,711,TD kit,150,300,150,1,00091,India
199491,2024-02-13,714,carbon paper,15,30,15,1,00479,India
199491,2024-02-13,702,pencil,2,5,3,1,00479,India
199491,2024-02-13,707,marker,20,40,20,1,00479,India
199491,2024-02-13,713,ball pen,5,10,5,1,00479,India
571894,2024-02-13,708,sketchpen,15,40,25,1,00402,India
571894,2024-02-13,711,TD kit,150,300,150,1,00402,India
571894,2024-02-13,713,ball pen,5,10,5,1,00402,India
462756,2024-02-13,705,stencil,10,20,10,1,00081,India
462756,2024-02-13,704,scale,5,10,5,1,00081,India
462756,2024-02-13,707,marker,20,40,20,1,00081,India
462756,2024-02-13,716,printing paper,200,400,200,1,00081,India
194878,2024-02-13,703,eraser,1,3,2,1,00398,India
194878,2024-02-13,709,notebook,30,60,30,1,00398,India
846078,2024-02-14,710,geometry box,100,150,50,1,00399,India
846078,2024-02-14,701,gel pen,5,10,5,1,00399,India
846078,2024-02-14,707,marker,20,40,20,1,00399,India
985816,2024-02-14,707,marker,20,40,20,1,00085,India
985816,2024-02-14,712,graph paper,20,40,20,1,00085,India
985816,2024-02-14,710,geometry box,100,150,50,1,00085,India
682217,2024-02-14,705,stencil,10,20,10,1,00304,India
173252,2024-02-14,706,sharpener,3,8,5,1,00214,India
173252,2024-02-14,702,pencil,2,5,3,1,00214,India
974203,2024-02-14,710,geometry box,100,150,50,1,00328,India
974203,2024-02-14,701,gel pen,5,10,5,1,00328,India
126745,2024-02-14,714,carbon paper,15,30,15,1,00092,India
126745,2024-02-14,709,notebook,30,60,30,1,00092,India
126745,2024-02-14,716,printing paper,200,400,200,1,00092,India
412412,2024-02-14,716,printing paper,200,400,200,1,00415,India
412412,2024-02-14,708,sketchpen,15,40,25,1,00415,India
412412,2024-02-14,714,carbon paper,15,30,15,1,00415,India
265276,2024-02-14,702,pencil,2,5,3,1,00468,India
265276,2024-02-14,707,marker,20,40,20,1,00468,India
265276,2024-02-14,714,carbon paper,15,30,15,1,00468,India
265276,2024-02-14,716,printing paper,200,400,200,1,00468,India
997502,2024-02-14,711,TD kit,150,300,150,1,00222,India
997502,2024-02-14,705,stencil,10,20,10,1,00222,India
997502,2024-02-14,712,graph paper,20,40,20,1,00222,India
997502,2024-02-14,713,ball pen,5,10,5,1,00222,India
997502,2024-02-14,710,geometry box,100,150,50,1,00222,India
570452,2024-02-14,705,stencil,10,20,10,1,00240,India
570452,2024-02-14,713,ball pen,5,10,5,1,00240,India
570452,2024-02-14,717,spiral bound book,50,100,50,1,00240,India
227200,2024-02-14,711,TD kit,150,300,150,1,00234,India
227200,2024-02-14,701,gel pen,5,10,5,1,00234,India
227200,2024-02-14,716,printing paper,200,400,200,1,00234,India
227200,2024-02-14,709,notebook,30,60,30,1,00234,India
835854,2024-02-14,708,sketchpen,15,40,25,1,00498,India
539544,2024-02-14,716,printing paper,200,400,200,1,00391,India
320195,2024-02-14,702,pencil,2,5,3,1,00375,India
411310,2024-02-14,701,gel pen,5,10,5,1,00388,India
411310,2024-02-14,707,marker,20,40,20,1,00388,India
411310,2024-02-14,713,ball pen,5,10,5,1,00388,India
877220,2024-02-14,705,stencil,10,20,10,1,00026,India
877220,2024-02-14,712,graph paper,20,40,20,1,00026,India
877220,2024-02-14,717,spiral bound book,50,100,50,1,00026,India
877220,2024-02-14,708,sketchpen,15,40,25,1,00026,India
877220,2024-02-14,710,geometry box,100,150,50,1,00026,India
790425,2024-02-14,713,ball pen,5,10,5,1,00057,India
790425,2024-02-14,707,marker,20,40,20,1,00057,India
702096,2024-02-14,710,geometry box,100,150,50,1,00060,India
142881,2024-02-14,702,pencil,2,5,3,1,00321,India
142881,2024-02-14,712,graph paper,20,40,20,1,00321,India
142881,2024-02-14,705,stencil,10,20,10,1,00321,India
142881,2024-02-14,704,scale,5,10,5,1,00321,India
754921,2024-02-14,708,sketchpen,15,40,25,1,00370,India
754921,2024-02-14,706,sharpener,3,8,5,1,00370,India
637592,2024-02-14,714,carbon paper,15,30,15,1,00072,India
637592,2024-02-14,704,scale,5,10,5,1,00072,India
209908,2024-02-14,712,graph paper,20,40,20,1,00475,India
209908,2024-02-14,716,printing paper,200,400,200,1,00475,India
209908,2024-02-14,714,carbon paper,15,30,15,1,00475,India
931529,2024-02-14,709,notebook,30,60,30,1,00223,India
931529,2024-02-14,702,pencil,2,5,3,1,00223,India
784771,2024-02-14,708,sketchpen,15,40,25,1,00346,India
784771,2024-02-14,707,marker,20,40,20,1,00346,India
784771,2024-02-14,702,pencil,2,5,3,1,00346,India
910129,2024-02-14,715,folder,5,15,10,1,00019,India
684058,2024-02-14,709,notebook,30,60,30,1,00437,India
684058,2024-02-14,715,folder,5,15,10,1,00437,India
438004,2024-02-14,702,pencil,2,5,3,1,00372,India
438004,2024-02-14,709,notebook,30,60,30,1,00372,India
672455,2024-02-14,716,printing paper,200,400,200,1,00392,India
206431,2024-02-14,710,geometry box,100,150,50,1,00257,India
206431,2024-02-14,704,scale,5,10,5,1,00257,India
727875,2024-02-14,708,sketchpen,15,40,25,1,00001,India
866312,2024-02-14,713,ball pen,5,10,5,1,00465,India
446384,2024-02-14,712,graph paper,20,40,20,1,00248,India
446384,2024-02-14,701,gel pen,5,10,5,1,00248,India
384177,2024-02-14,717,spiral bound book,50,100,50,1,00375,India
214773,2024-02-14,711,TD kit,150,300,150,1,00179,India
214773,2024-02-14,717,spiral bound book,50,100,50,1,00179,India
214773,2024-02-14,713,ball pen,5,10,5,1,00179,India
118245,2024-02-14,705,stencil,10,20,10,1,00334,India
118245,2024-02-14,701,gel pen,5,10,5,1,00334,India
118245,2024-02-14,703,eraser,1,3,2,1,00334,India
118245,2024-02-14,702,pencil,2,5,3,1,00334,India
218132,2024-02-14,708,sketchpen,15,40,25,1,00141,India
218132,2024-02-14,704,scale,5,10,5,1,00141,India
946478,2024-02-14,713,ball pen,5,10,5,1,00184,India
946478,2024-02-14,714,carbon paper,15,30,15,1,00184,India
946478,2024-02-14,715,folder,5,15,10,1,00184,India
946478,2024-02-14,712,graph paper,20,40,20,1,00184,India
141556,2024-02-14,713,ball pen,5,10,5,1,00017,India
141556,2024-02-14,716,printing paper,200,400,200,1,00017,India
141556,2024-02-14,701,gel pen,5,10,5,1,00017,India
141556,2024-02-14,708,sketchpen,15,40,25,1,00017,India
696763,2024-02-14,702,pencil,2,5,3,1,00091,India
696763,2024-02-14,710,geometry box,100,150,50,1,00091,India
696763,2024-02-14,709,notebook,30,60,30,1,00091,India
294591,2024-02-14,702,pencil,2,5,3,1,00408,India
893687,2024-02-14,712,graph paper,20,40,20,1,00339,India
893687,2024-02-14,707,marker,20,40,20,1,00339,India
556820,2024-02-14,710,geometry box,100,150,50,1,00005,India
491797,2024-02-14,705,stencil,10,20,10,1,00392,India
491797,2024-02-14,710,geometry box,100,150,50,1,00392,India
491797,2024-02-14,716,printing paper,200,400,200,1,00392,India
491797,2024-02-14,717,spiral bound book,50,100,50,1,00392,India
287625,2024-02-14,703,eraser,1,3,2,1,00168,India
287625,2024-02-14,714,carbon paper,15,30,15,1,00168,India
287625,2024-02-14,713,ball pen,5,10,5,1,00168,India
287625,2024-02-14,701,gel pen,5,10,5,1,00168,India
127607,2024-02-14,712,graph paper,20,40,20,1,00385,India
376575,2024-02-14,704,scale,5,10,5,1,00473,India
376575,2024-02-14,707,marker,20,40,20,1,00473,India
376575,2024-02-14,716,printing paper,200,400,200,1,00473,India
376575,2024-02-14,713,ball pen,5,10,5,1,00473,India
908118,2024-02-14,708,sketchpen,15,40,25,1,00122,India
908118,2024-02-14,711,TD kit,150,300,150,1,00122,India
991204,2024-02-15,717,spiral bound book,50,100,50,1,00134,India
991204,2024-02-15,706,sharpener,3,8,5,1,00134,India
991204,2024-02-15,710,geometry box,100,150,50,1,00134,India
991204,2024-02-15,709,notebook,30,60,30,1,00134,India
991204,2024-02-15,707,marker,20,40,20,1,00134,India
958298,2024-02-15,711,TD kit,150,300,150,1,00047,India
958298,2024-02-15,707,marker,20,40,20,1,00047,India
919967,2024-02-15,712,graph paper,20,40,20,1,00387,India
919967,2024-02-15,705,stencil,10,20,10,1,00387,India
919967,2024-02-15,714,carbon paper,15,30,15,1,00387,India
651748,2024-02-15,703,eraser,1,3,2,1,00077,India
651748,2024-02-15,708,sketchpen,15,40,25,1,00077,India
179333,2024-02-15,707,marker,20,40,20,1,00193,India
179333,2024-02-15,703,eraser,1,3,2,1,00193,India
753905,2024-02-15,705,stencil,10,20,10,1,00330,India
753905,2024-02-15,709,notebook,30,60,30,1,00330,India
840287,2024-02-15,714,carbon paper,15,30,15,1,00480,India
840287,2024-02-15,705,stencil,10,20,10,1,00480,India
244360,2024-02-15,711,TD kit,150,300,150,1,00445,India
244360,2024-02-15,713,ball pen,5,10,5,1,00445,India
244360,2024-02-15,706,sharpener,3,8,5,1,00445,India
244360,2024-02-15,702,pencil,2,5,3,1,00445,India
147173,2024-02-15,707,marker,20,40,20,1,00404,India
147173,2024-02-15,701,gel pen,5,10,5,1,00404,India
502045,2024-02-15,707,marker,20,40,20,1,00305,India
567957,2024-02-15,704,scale,5,10,5,1,00051,India
567957,2024-02-15,708,sketchpen,15,40,25,1,00051,India
639434,2024-02-15,706,sharpener,3,8,5,1,00446,India
639434,2024-02-15,711,TD kit,150,300,150,1,00446,India
639434,2024-02-15,707,marker,20,40,20,1,00446,India
264752,2024-02-15,715,folder,5,15,10,1,00409,India
221771,2024-02-15,711,TD kit,150,300,150,1,00141,India
221771,2024-02-15,710,geometry box,100,150,50,1,00141,India
221771,2024-02-15,707,marker,20,40,20,1,00141,India
221771,2024-02-15,717,spiral bound book,50,100,50,1,00141,India
399664,2024-02-15,705,stencil,10,20,10,1,00295,India
399664,2024-02-15,711,TD kit,150,300,150,1,00295,India
399664,2024-02-15,712,graph paper,20,40,20,1,00295,India
961231,2024-02-15,706,sharpener,3,8,5,1,00009,India
961231,2024-02-15,710,geometry box,100,150,50,1,00009,India
536824,2024-02-15,703,eraser,1,3,2,1,00243,India
536824,2024-02-15,701,gel pen,5,10,5,1,00243,India
536824,2024-02-15,711,TD kit,150,300,150,1,00243,India
402209,2024-02-15,703,eraser,1,3,2,1,00314,India
402209,2024-02-15,711,TD kit,150,300,150,1,00314,India
402209,2024-02-15,707,marker,20,40,20,1,00314,India
402209,2024-02-15,714,carbon paper,15,30,15,1,00314,India
416295,2024-02-15,714,carbon paper,15,30,15,1,00412,India
416295,2024-02-15,710,geometry box,100,150,50,1,00412,India
416295,2024-02-15,713,ball pen,5,10,5,1,00412,India
890591,2024-02-15,701,gel pen,5,10,5,1,00190,India
890591,2024-02-15,704,scale,5,10,5,1,00190,India
890591,2024-02-15,714,carbon paper,15,30,15,1,00190,India
890591,2024-02-15,708,sketchpen,15,40,25,1,00190,India
890591,2024-02-15,711,TD kit,150,300,150,1,00190,India
898527,2024-02-15,709,notebook,30,60,30,1,00483,India
136682,2024-02-15,709,notebook,30,60,30,1,00272,India
136682,2024-02-15,713,ball pen,5,10,5,1,00272,India
364721,2024-02-15,704,scale,5,10,5,1,00150,India
364721,2024-02-15,714,carbon paper,15,30,15,1,00150,India
377498,2024-02-15,714,carbon paper,15,30,15,1,00112,India
577956,2024-02-15,717,spiral bound book,50,100,50,1,00321,India
577956,2024-02-15,709,notebook,30,60,30,1,00321,India
577956,2024-02-15,712,graph paper,20,40,20,1,00321,India
577956,2024-02-15,705,stencil,10,20,10,1,00321,India
283522,2024-02-15,708,sketchpen,15,40,25,1,00483,India
283522,2024-02-15,710,geometry box,100,150,50,1,00483,India
397021,2024-02-15,717,spiral bound book,50,100,50,1,00230,India
397021,2024-02-15,714,carbon paper,15,30,15,1,00230,India
397021,2024-02-15,708,sketchpen,15,40,25,1,00230,India
397021,2024-02-15,707,marker,20,40,20,1,00230,India
397021,2024-02-15,706,sharpener,3,8,5,1,00230,India
373740,2024-02-15,706,sharpener,3,8,5,1,00127,India
373740,2024-02-15,707,marker,20,40,20,1,00127,India
373740,2024-02-15,702,pencil,2,5,3,1,00127,India
175032,2024-02-15,705,stencil,10,20,10,1,00488,India
175032,2024-02-15,715,folder,5,15,10,1,00488,India
175032,2024-02-15,710,geometry box,100,150,50,1,00488,India
243455,2024-02-15,704,scale,5,10,5,1,00437,India
243455,2024-02-15,705,stencil,10,20,10,1,00437,India
243455,2024-02-15,708,sketchpen,15,40,25,1,00437,India
151653,2024-02-15,717,spiral bound book,50,100,50,1,00309,India
151653,2024-02-15,706,sharpener,3,8,5,1,00309,India
112861,2024-02-15,705,stencil,10,20,10,1,00313,India
112861,2024-02-15,704,scale,5,10,5,1,00313,India
112861,2024-02-15,709,notebook,30,60,30,1,00313,India
112861,2024-02-15,701,gel pen,5,10,5,1,00313,India
429038,2024-02-15,701,gel pen,5,10,5,1,00055,India
429038,2024-02-15,717,spiral bound book,50,100,50,1,00055,India
191388,2024-02-15,702,pencil,2,5,3,1,00074,India
191388,2024-02-15,703,eraser,1,3,2,1,00074,India
191388,2024-02-15,710,geometry box,100,150,50,1,00074,India
796949,2024-02-15,702,pencil,2,5,3,1,00121,India
796949,2024-02-15,716,printing paper,200,400,200,1,00121,India
369772,2024-02-15,715,folder,5,15,10,1,00370,India
369772,2024-02-15,703,eraser,1,3,2,1,00370,India
369772,2024-02-15,706,sharpener,3,8,5,1,00370,India
958234,2024-02-15,701,gel pen,5,10,5,1,00014,India
958234,2024-02-15,704,scale,5,10,5,1,00014,India
795055,2024-02-15,710,geometry box,100,150,50,1,00179,India
427296,2024-02-15,703,eraser,1,3,2,1,00105,India
427296,2024-02-15,713,ball pen,5,10,5,1,00105,India
258548,2024-02-15,709,notebook,30,60,30,1,00355,India
258548,2024-02-15,701,gel pen,5,10,5,1,00355,India
258548,2024-02-15,706,sharpener,3,8,5,1,00355,India
258548,2024-02-15,714,carbon paper,15,30,15,1,00355,India
258548,2024-02-15,713,ball pen,5,10,5,1,00355,India
148836,2024-02-15,713,ball pen,5,10,5,1,00367,India
148836,2024-02-15,709,notebook,30,60,30,1,00367,India
148836,2024-02-15,704,scale,5,10,5,1,00367,India
148836,2024-02-15,708,sketchpen,15,40,25,1,00367,India
148836,2024-02-15,705,stencil,10,20,10,1,00367,India
519921,2024-02-15,702,pencil,2,5,3,1,00278,India
519921,2024-02-15,712,graph paper,20,40,20,1,00278,India
519921,2024-02-15,708,sketchpen,15,40,25,1,00278,India
847015,2024-02-16,708,sketchpen,15,40,25,1,00420,India
847015,2024-02-16,702,pencil,2,5,3,1,00420,India
410306,2024-02-16,703,eraser,1,3,2,1,00362,India
410306,2024-02-16,710,geometry box,100,150,50,1,00362,India
410306,2024-02-16,716,printing paper,200,400,200,1,00362,India
563961,2024-02-16,711,TD kit,150,300,150,1,00087,India
563961,2024-02-16,709,notebook,30,60,30,1,00087,India
143328,2024-02-16,705,stencil,10,20,10,1,00112,India
143328,2024-02-16,712,graph paper,20,40,20,1,00112,India
143328,2024-02-16,708,sketchpen,15,40,25,1,00112,India
312161,2024-02-16,713,ball pen,5,10,5,1,00197,India
312161,2024-02-16,704,scale,5,10,5,1,00197,India
312161,2024-02-16,706,sharpener,3,8,5,1,00197,India
472465,2024-02-16,701,gel pen,5,10,5,1,00383,India
472465,2024-02-16,702,pencil,2,5,3,1,00383,India
472465,2024-02-16,713,ball pen,5,10,5,1,00383,India
472465,2024-02-16,709,notebook,30,60,30,1,00383,India
472465,2024-02-16,704,scale,5,10,5,1,00383,India
934995,2024-02-16,714,carbon paper,15,30,15,1,00478,India
934995,2024-02-16,706,sharpener,3,8,5,1,00478,India
934995,2024-02-16,712,graph paper,20,40,20,1,00478,India
469395,2024-02-16,705,stencil,10,20,10,1,00163,India
469395,2024-02-16,717,spiral bound book,50,100,50,1,00163,India
469395,2024-02-16,703,eraser,1,3,2,1,00163,India
577986,2024-02-16,716,printing paper,200,400,200,1,00339,India
577986,2024-02-16,705,stencil,10,20,10,1,00339,India
577986,2024-02-16,712,graph paper,20,40,20,1,00339,India
339044,2024-02-16,702,pencil,2,5,3,1,00303,India
339044,2024-02-16,701,gel pen,5,10,5,1,00303,India
339044,2024-02-16,710,geometry box,100,150,50,1,00303,India
339044,2024-02-16,708,sketchpen,15,40,25,1,00303,India
248584,2024-02-16,708,sketchpen,15,40,25,1,00362,India
248584,2024-02-16,703,eraser,1,3,2,1,00362,India
248584,2024-02-16,702,pencil,2,5,3,1,00362,India
815983,2024-02-16,702,pencil,2,5,3,1,00228,India
458171,2024-02-16,701,gel pen,5,10,5,1,00310,India
458171,2024-02-16,703,eraser,1,3,2,1,00310,India
458171,2024-02-16,708,sketchpen,15,40,25,1,00310,India
278961,2024-02-16,707,marker,20,40,20,1,00351,India
278961,2024-02-16,704,scale,5,10,5,1,00351,India
278961,2024-02-16,715,folder,5,15,10,1,00351,India
278961,2024-02-16,706,sharpener,3,8,5,1,00351,India
470668,2024-02-16,704,scale,5,10,5,1,00424,India
470668,2024-02-16,717,spiral bound book,50,100,50,1,00424,India
651834,2024-02-16,708,sketchpen,15,40,25,1,00266,India
651834,2024-02-16,711,TD kit,150,300,150,1,00266,India
651834,2024-02-16,705,stencil,10,20,10,1,00266,India
958937,2024-02-16,712,graph paper,20,40,20,1,00093,India
958937,2024-02-16,707,marker,20,40,20,1,00093,India
958937,2024-02-16,709,notebook,30,60,30,1,00093,India
958937,2024-02-16,705,stencil,10,20,10,1,00093,India
468813,2024-02-16,717,spiral bound book,50,100,50,1,00185,India
468813,2024-02-16,707,marker,20,40,20,1,00185,India
468813,2024-02-16,708,sketchpen,15,40,25,1,00185,India
468813,2024-02-16,715,folder,5,15,10,1,00185,India
468813,2024-02-16,709,notebook,30,60,30,1,00185,India
106405,2024-02-16,711,TD kit,150,300,150,1,00463,India
650126,2024-02-16,704,scale,5,10,5,1,00357,India
650126,2024-02-16,717,spiral bound book,50,100,50,1,00357,India
281507,2024-02-16,703,eraser,1,3,2,1,00076,India
281507,2024-02-16,710,geometry box,100,150,50,1,00076,India
281507,2024-02-16,708,sketchpen,15,40,25,1,00076,India
281507,2024-02-16,717,spiral bound book,50,100,50,1,00076,India
165923,2024-02-16,709,notebook,30,60,30,1,00335,India
144036,2024-02-16,703,eraser,1,3,2,1,00158,India
144036,2024-02-16,716,printing paper,200,400,200,1,00158,India
144036,2024-02-16,712,graph paper,20,40,20,1,00158,India
144036,2024-02-16,711,TD kit,150,300,150,1,00158,India
144036,2024-02-16,702,pencil,2,5,3,1,00158,India
363052,2024-02-16,709,notebook,30,60,30,1,00463,India
363052,2024-02-16,708,sketchpen,15,40,25,1,00463,India
363052,2024-02-16,714,carbon paper,15,30,15,1,00463,India
363052,2024-02-16,712,graph paper,20,40,20,1,00463,India
181521,2024-02-16,702,pencil,2,5,3,1,00092,India
181521,2024-02-16,704,scale,5,10,5,1,00092,India
181521,2024-02-16,705,stencil,10,20,10,1,00092,India
181521,2024-02-16,701,gel pen,5,10,5,1,00092,India
415742,2024-02-16,708,sketchpen,15,40,25,1,00262,India
415742,2024-02-16,703,eraser,1,3,2,1,00262,India
415742,2024-02-16,713,ball pen,5,10,5,1,00262,India
415742,2024-02-16,710,geometry box,100,150,50,1,00262,India
940043,2024-02-16,707,marker,20,40,20,1,00480,India
940043,2024-02-16,714,carbon paper,15,30,15,1,00480,India
940043,2024-02-16,712,graph paper,20,40,20,1,00480,India
940043,2024-02-16,716,printing paper,200,400,200,1,00480,India
136015,2024-02-16,702,pencil,2,5,3,1,00498,India
136015,2024-02-16,709,notebook,30,60,30,1,00498,India
136015,2024-02-16,706,sharpener,3,8,5,1,00498,India
136015,2024-02-16,716,printing paper,200,400,200,1,00498,India
783790,2024-02-16,706,sharpener,3,8,5,1,00409,India
783790,2024-02-16,701,gel pen,5,10,5,1,00409,India
783790,2024-02-16,714,carbon paper,15,30,15,1,00409,India
783790,2024-02-16,715,folder,5,15,10,1,00409,India
783790,2024-02-16,703,eraser,1,3,2,1,00409,India
181599,2024-02-16,715,folder,5,15,10,1,00257,India
181599,2024-02-16,701,gel pen,5,10,5,1,00257,India
181599,2024-02-16,705,stencil,10,20,10,1,00257,India
791589,2024-02-16,703,eraser,1,3,2,1,00389,India
791589,2024-02-16,717,spiral bound book,50,100,50,1,00389,India
836363,2024-02-16,717,spiral bound book,50,100,50,1,00030,India
105664,2024-02-16,710,geometry box,100,150,50,1,00424,India
105664,2024-02-16,707,marker,20,40,20,1,00424,India
105664,2024-02-16,706,sharpener,3,8,5,1,00424,India
664414,2024-02-16,711,TD kit,150,300,150,1,00014,India
452421,2024-02-16,707,marker,20,40,20,1,00277,India
452421,2024-02-16,709,notebook,30,60,30,1,00277,India
452421,2024-02-16,703,eraser,1,3,2,1,00277,India
550270,2024-02-16,702,pencil,2,5,3,1,00036,India
550270,2024-02-16,713,ball pen,5,10,5,1,00036,India
550270,2024-02-16,709,notebook,30,60,30,1,00036,India
550270,2024-02-16,704,scale,5,10,5,1,00036,India
126799,2024-02-16,701,gel pen,5,10,5,1,00452,India
126799,2024-02-16,707,marker,20,40,20,1,00452,India
126799,2024-02-16,710,geometry box,100,150,50,1,00452,India
511948,2024-02-16,715,folder,5,15,10,1,00353,India
511948,2024-02-16,709,notebook,30,60,30,1,00353,India
511948,2024-02-16,716,printing paper,200,400,200,1,00353,India
511948,2024-02-16,704,scale,5,10,5,1,00353,India
900884,2024-02-16,711,TD kit,150,300,150,1,00431,India
900884,2024-02-16,716,printing paper,200,400,200,1,00431,India
900884,2024-02-16,710,geometry box,100,150,50,1,00431,India
107887,2024-02-16,706,sharpener,3,8,5,1,00304,India
107887,2024-02-16,705,stencil,10,20,10,1,00304,India
107887,2024-02-16,704,scale,5,10,5,1,00304,India
107887,2024-02-16,716,printing paper,200,400,200,1,00304,India
467826,2024-02-17,716,printing paper,200,400,200,1,00407,India
801161,2024-02-17,704,scale,5,10,5,1,00105,India
801161,2024-02-17,713,ball pen,5,10,5,1,00105,India
801161,2024-02-17,717,spiral bound book,50,100,50,1,00105,India
183969,2024-02-17,709,notebook,30,60,30,1,00354,India
183969,2024-02-17,708,sketchpen,15,40,25,1,00354,India
183969,2024-02-17,706,sharpener,3,8,5,1,00354,India
183969,2024-02-17,715,folder,5,15,10,1,00354,India
757183,2024-02-17,709,notebook,30,60,30,1,00386,India
529502,2024-02-17,703,eraser,1,3,2,1,00479,India
425959,2024-02-17,713,ball pen,5,10,5,1,00168,India
971493,2024-02-17,712,graph paper,20,40,20,1,00416,India
730510,2024-02-17,703,eraser,1,3,2,1,00480,India
730510,2024-02-17,713,ball pen,5,10,5,1,00480,India
730510,2024-02-17,706,sharpener,3,8,5,1,00480,India
730510,2024-02-17,705,stencil,10,20,10,1,00480,India
690675,2024-02-17,703,eraser,1,3,2,1,00453,India
690675,2024-02-17,706,sharpener,3,8,5,1,00453,India
690675,2024-02-17,708,sketchpen,15,40,25,1,00453,India
690675,2024-02-17,711,TD kit,150,300,150,1,00453,India
477978,2024-02-17,708,sketchpen,15,40,25,1,00463,India
453361,2024-02-17,703,eraser,1,3,2,1,00160,India
453361,2024-02-17,716,printing paper,200,400,200,1,00160,India
453361,2024-02-17,702,pencil,2,5,3,1,00160,India
453361,2024-02-17,708,sketchpen,15,40,25,1,00160,India
151291,2024-02-17,705,stencil,10,20,10,1,00213,India
151291,2024-02-17,701,gel pen,5,10,5,1,00213,India
151291,2024-02-17,710,geometry box,100,150,50,1,00213,India
151291,2024-02-17,716,printing paper,200,400,200,1,00213,India
436817,2024-02-17,714,carbon paper,15,30,15,1,00023,India
138138,2024-02-17,717,spiral bound book,50,100,50,1,00014,India
138138,2024-02-17,702,pencil,2,5,3,1,00014,India
138138,2024-02-17,704,scale,5,10,5,1,00014,India
138138,2024-02-17,710,geometry box,100,150,50,1,00014,India
813535,2024-02-17,714,carbon paper,15,30,15,1,00111,India
813535,2024-02-17,703,eraser,1,3,2,1,00111,India
357978,2024-02-17,702,pencil,2,5,3,1,00088,India
357978,2024-02-17,707,marker,20,40,20,1,00088,India
936588,2024-02-17,701,gel pen,5,10,5,1,00038,India
936588,2024-02-17,712,graph paper,20,40,20,1,00038,India
936588,2024-02-17,704,scale,5,10,5,1,00038,India
936588,2024-02-17,716,printing paper,200,400,200,1,00038,India
936588,2024-02-17,708,sketchpen,15,40,25,1,00038,India
101747,2024-02-17,703,eraser,1,3,2,1,00494,India
101747,2024-02-17,702,pencil,2,5,3,1,00494,India
101747,2024-02-17,704,scale,5,10,5,1,00494,India
101747,2024-02-17,710,geometry box,100,150,50,1,00494,India
101747,2024-02-17,708,sketchpen,15,40,25,1,00494,India
299311,2024-02-17,705,stencil,10,20,10,1,00135,India
376327,2024-02-17,703,eraser,1,3,2,1,00132,India
174945,2024-02-17,706,sharpener,3,8,5,1,00364,India
174945,2024-02-17,709,notebook,30,60,30,1,00364,India
174945,2024-02-17,715,folder,5,15,10,1,00364,India
174945,2024-02-17,711,TD kit,150,300,150,1,00364,India
501792,2024-02-17,701,gel pen,5,10,5,1,00200,India
501792,2024-02-17,712,graph paper,20,40,20,1,00200,India
501792,2024-02-17,708,sketchpen,15,40,25,1,00200,India
726182,2024-02-17,701,gel pen,5,10,5,1,00241,India
726182,2024-02-17,702,pencil,2,5,3,1,00241,India
726182,2024-02-17,707,marker,20,40,20,1,00241,India
726182,2024-02-17,714,carbon paper,15,30,15,1,00241,India
726182,2024-02-17,706,sharpener,3,8,5,1,00241,India
733909,2024-02-17,713,ball pen,5,10,5,1,00341,India
254192,2024-02-17,709,notebook,30,60,30,1,00381,India
504122,2024-02-17,714,carbon paper,15,30,15,1,00398,India
290264,2024-02-17,712,graph paper,20,40,20,1,00403,India
290264,2024-02-17,706,sharpener,3,8,5,1,00403,India
290264,2024-02-17,711,TD kit,150,300,150,1,00403,India
290264,2024-02-17,710,geometry box,100,150,50,1,00403,India
316271,2024-02-17,709,notebook,30,60,30,1,00475,India
316271,2024-02-17,702,pencil,2,5,3,1,00475,India
316271,2024-02-17,708,sketchpen,15,40,25,1,00475,India
316271,2024-02-17,705,stencil,10,20,10,1,00475,India
713697,2024-02-17,709,notebook,30,60,30,1,00041,India
619972,2024-02-17,701,gel pen,5,10,5,1,00287,India
855473,2024-02-17,704,scale,5,10,5,1,00377,India
855473,2024-02-17,706,sharpener,3,8,5,1,00377,India
855473,2024-02-17,716,printing paper,200,400,200,1,00377,India
855473,2024-02-17,707,marker,20,40,20,1,00377,India
855473,2024-02-17,705,stencil,10,20,10,1,00377,India
964630,2024-02-17,713,ball pen,5,10,5,1,00157,India
964630,2024-02-17,714,carbon paper,15,30,15,1,00157,India
964630,2024-02-17,707,marker,20,40,20,1,00157,India
963940,2024-02-18,716,printing paper,200,400,200,1,00420,India
444075,2024-02-18,710,geometry box,100,150,50,1,00313,India
444075,2024-02-18,711,TD kit,150,300,150,1,00313,India
444075,2024-02-18,716,printing paper,200,400,200,1,00313,India
444075,2024-02-18,707,marker,20,40,20,1,00313,India
189348,2024-02-18,712,graph paper,20,40,20,1,00189,India
305344,2024-02-18,701,gel pen,5,10,5,1,00401,India
305344,2024-02-18,707,marker,20,40,20,1,00401,India
305344,2024-02-18,711,TD kit,150,300,150,1,00401,India
814057,2024-02-18,715,folder,5,15,10,1,00491,India
244126,2024-02-18,710,geometry box,100,150,50,1,00449,India
244126,2024-02-18,712,graph paper,20,40,20,1,00449,India
244126,2024-02-18,717,spiral bound book,50,100,50,1,00449,India
244126,2024-02-18,709,notebook,30,60,30,1,00449,India
557114,2024-02-18,711,TD kit,150,300,150,1,00465,India
557114,2024-02-18,713,ball pen,5,10,5,1,00465,India
557114,2024-02-18,717,spiral bound book,50,100,50,1,00465,India
376123,2024-02-18,708,sketchpen,15,40,25,1,00358,India
376123,2024-02-18,704,scale,5,10,5,1,00358,India
914882,2024-02-18,714,carbon paper,15,30,15,1,00321,India
620756,2024-02-18,711,TD kit,150,300,150,1,00187,India
620756,2024-02-18,708,sketchpen,15,40,25,1,00187,India
620756,2024-02-18,701,gel pen,5,10,5,1,00187,India
620756,2024-02-18,714,carbon paper,15,30,15,1,00187,India
588859,2024-02-18,711,TD kit,150,300,150,1,00297,India
588859,2024-02-18,714,carbon paper,15,30,15,1,00297,India
588859,2024-02-18,716,printing paper,200,400,200,1,00297,India
603265,2024-02-18,717,spiral bound book,50,100,50,1,00358,India
603265,2024-02-18,703,eraser,1,3,2,1,00358,India
603265,2024-02-18,707,marker,20,40,20,1,00358,India
603265,2024-02-18,702,pencil,2,5,3,1,00358,India
603265,2024-02-18,708,sketchpen,15,40,25,1,00358,India
495242,2024-02-18,704,scale,5,10,5,1,00346,India
495242,2024-02-18,705,stencil,10,20,10,1,00346,India
495242,2024-02-18,710,geometry box,100,150,50,1,00346,India
495242,2024-02-18,706,sharpener,3,8,5,1,00346,India
133998,2024-02-18,707,marker,20,40,20,1,00483,India
133998,2024-02-18,713,ball pen,5,10,5,1,00483,India
133998,2024-02-18,704,scale,5,10,5,1,00483,India
535576,2024-02-18,708,sketchpen,15,40,25,1,00208,India
535576,2024-02-18,703,eraser,1,3,2,1,00208,India
535576,2024-02-18,706,sharpener,3,8,5,1,00208,India
172218,2024-02-18,714,carbon paper,15,30,15,1,00395,India
172218,2024-02-18,702,pencil,2,5,3,1,00395,India
172218,2024-02-18,704,scale,5,10,5,1,00395,India
780969,2024-02-18,711,TD kit,150,300,150,1,00064,India
647451,2024-02-18,715,folder,5,15,10,1,00190,India
647451,2024-02-18,701,gel pen,5,10,5,1,00190,India
860287,2024-02-18,712,graph paper,20,40,20,1,00127,India
860287,2024-02-18,716,printing paper,200,400,200,1,00127,India
860287,2024-02-18,707,marker,20,40,20,1,00127,India
860287,2024-02-18,711,TD kit,150,300,150,1,00127,India
860287,2024-02-18,705,stencil,10,20,10,1,00127,India
311203,2024-02-18,708,sketchpen,15,40,25,1,00497,India
567827,2024-02-18,708,sketchpen,15,40,25,1,00367,India
567827,2024-02-18,703,eraser,1,3,2,1,00367,India
921931,2024-02-18,706,sharpener,3,8,5,1,00131,India
921931,2024-02-18,716,printing paper,200,400,200,1,00131,India
921931,2024-02-18,701,gel pen,5,10,5,1,00131,India
921931,2024-02-18,705,stencil,10,20,10,1,00131,India
883688,2024-02-18,711,TD kit,150,300,150,1,00071,India
128835,2024-02-18,715,folder,5,15,10,1,00399,India
128835,2024-02-18,714,carbon paper,15,30,15,1,00399,India
773872,2024-02-18,717,spiral bound book,50,100,50,1,00170,India
529095,2024-02-18,703,eraser,1,3,2,1,00257,India
707477,2024-02-18,711,TD kit,150,300,150,1,00117,India
707477,2024-02-18,714,carbon paper,15,30,15,1,00117,India
707477,2024-02-18,712,graph paper,20,40,20,1,00117,India
590494,2024-02-18,717,spiral bound book,50,100,50,1,00489,India
590494,2024-02-18,711,TD kit,150,300,150,1,00489,India
590494,2024-02-18,712,graph paper,20,40,20,1,00489,India
411064,2024-02-18,701,gel pen,5,10,5,1,00144,India
411064,2024-02-18,705,stencil,10,20,10,1,00144,India
411064,2024-02-18,706,sharpener,3,8,5,1,00144,India
449027,2024-02-18,708,sketchpen,15,40,25,1,00154,India
449027,2024-02-18,706,sharpener,3,8,5,1,00154,India
449027,2024-02-18,707,marker,20,40,20,1,00154,India
399517,2024-02-18,714,carbon paper,15,30,15,1,00120,India
399517,2024-02-18,706,sharpener,3,8,5,1,00120,India
399517,2024-02-18,713,ball pen,5,10,5,1,00120,India
399517,2024-02-18,705,stencil,10,20,10,1,00120,India
802526,2024-02-18,710,geometry box,100,150,50,1,00081,India
802526,2024-02-18,709,notebook,30,60,30,1,00081,India
802526,2024-02-18,715,folder,5,15,10,1,00081,India
802526,2024-02-18,707,marker,20,40,20,1,00081,India
802526,2024-02-18,705,stencil,10,20,10,1,00081,India
528008,2024-02-18,715,folder,5,15,10,1,00267,India
528008,2024-02-18,716,printing paper,200,400,200,1,00267,India
528008,2024-02-18,711,TD kit,150,300,150,1,00267,India
528008,2024-02-18,705,stencil,10,20,10,1,00267,India
528008,2024-02-18,708,sketchpen,15,40,25,1,00267,India
943695,2024-02-18,701,gel pen,5,10,5,1,00017,India
943695,2024-02-18,707,marker,20,40,20,1,00017,India
943695,2024-02-18,708,sketchpen,15,40,25,1,00017,India
943695,2024-02-18,706,sharpener,3,8,5,1,00017,India
405821,2024-02-18,707,marker,20,40,20,1,00345,India
405821,2024-02-18,714,carbon paper,15,30,15,1,00345,India
405821,2024-02-18,710,geometry box,100,150,50,1,00345,India
405821,2024-02-18,709,notebook,30,60,30,1,00345,India
405821,2024-02-18,701,gel pen,5,10,5,1,00345,India
633958,2024-02-18,706,sharpener,3,8,5,1,00249,India
633958,2024-02-18,716,printing paper,200,400,200,1,00249,India
633958,2024-02-18,715,folder,5,15,10,1,00249,India
633958,2024-02-18,711,TD kit,150,300,150,1,00249,India
930119,2024-02-18,716,printing paper,200,400,200,1,00460,India
930119,2024-02-18,715,folder,5,15,10,1,00460,India
777406,2024-02-18,710,geometry box,100,150,50,1,00186,India
777406,2024-02-18,711,TD kit,150,300,150,1,00186,India
777406,2024-02-18,715,folder,5,15,10,1,00186,India
725266,2024-02-18,715,folder,5,15,10,1,00248,India
725266,2024-02-18,709,notebook,30,60,30,1,00248,India
725266,2024-02-18,707,marker,20,40,20,1,00248,India
809211,2024-02-18,716,printing paper,200,400,200,1,00125,India
809211,2024-02-18,715,folder,5,15,10,1,00125,India
809211,2024-02-18,706,sharpener,3,8,5,1,00125,India
555585,2024-02-18,707,marker,20,40,20,1,00236,India
555585,2024-02-18,709,notebook,30,60,30,1,00236,India
555585,2024-02-18,703,eraser,1,3,2,1,00236,India
596683,2024-02-18,713,ball pen,5,10,5,1,00061,India
596683,2024-02-18,711,TD kit,150,300,150,1,00061,India
596683,2024-02-18,710,geometry box,100,150,50,1,00061,India
349393,2024-02-19,701,gel pen,5,10,5,1,00377,India
313719,2024-02-19,710,geometry box,100,150,50,1,00042,India
541242,2024-02-19,702,pencil,2,5,3,1,00390,India
891709,2024-02-19,704,scale,5,10,5,1,00303,India
891709,2024-02-19,713,ball pen,5,10,5,1,00303,India
627138,2024-02-19,709,notebook,30,60,30,1,00432,India
627138,2024-02-19,712,graph paper,20,40,20,1,00432,India
627138,2024-02-19,713,ball pen,5,10,5,1,00432,India
627138,2024-02-19,706,sharpener,3,8,5,1,00432,India
627138,2024-02-19,708,sketchpen,15,40,25,1,00432,India
144179,2024-02-19,708,sketchpen,15,40,25,1,00227,India
107751,2024-02-19,705,stencil,10,20,10,1,00220,India
107751,2024-02-19,701,gel pen,5,10,5,1,00220,India
773093,2024-02-19,712,graph paper,20,40,20,1,00283,India
773093,2024-02-19,701,gel pen,5,10,5,1,00283,India
773093,2024-02-19,704,scale,5,10,5,1,00283,India
298210,2024-02-19,704,scale,5,10,5,1,00097,India
298210,2024-02-19,717,spiral bound book,50,100,50,1,00097,India
197175,2024-02-19,703,eraser,1,3,2,1,00156,India
371834,2024-02-19,709,notebook,30,60,30,1,00420,India
444691,2024-02-19,706,sharpener,3,8,5,1,00036,India
444691,2024-02-19,708,sketchpen,15,40,25,1,00036,India
444691,2024-02-19,701,gel pen,5,10,5,1,00036,India
444691,2024-02-19,710,geometry box,100,150,50,1,00036,India
444691,2024-02-19,703,eraser,1,3,2,1,00036,India
931603,2024-02-19,714,carbon paper,15,30,15,1,00147,India
324637,2024-02-19,716,printing paper,200,400,200,1,00025,India
324637,2024-02-19,704,scale,5,10,5,1,00025,India
324637,2024-02-19,706,sharpener,3,8,5,1,00025,India
867401,2024-02-19,714,carbon paper,15,30,15,1,00281,India
867401,2024-02-19,706,sharpener,3,8,5,1,00281,India
867401,2024-02-19,711,TD kit,150,300,150,1,00281,India
781254,2024-02-19,712,graph paper,20,40,20,1,00036,India
781254,2024-02-19,714,carbon paper,15,30,15,1,00036,India
781254,2024-02-19,706,sharpener,3,8,5,1,00036,India
781254,2024-02-19,711,TD kit,150,300,150,1,00036,India
781254,2024-02-19,707,marker,20,40,20,1,00036,India
838499,2024-02-19,715,folder,5,15,10,1,00164,India
838499,2024-02-19,716,printing paper,200,400,200,1,00164,India
606935,2024-02-19,716,printing paper,200,400,200,1,00242,India
606935,2024-02-19,710,geometry box,100,150,50,1,00242,India
606935,2024-02-19,709,notebook,30,60,30,1,00242,India
606935,2024-02-19,715,folder,5,15,10,1,00242,India
606935,2024-02-19,703,eraser,1,3,2,1,00242,India
289140,2024-02-19,715,folder,5,15,10,1,00334,India
289140,2024-02-19,710,geometry box,100,150,50,1,00334,India
289140,2024-02-19,702,pencil,2,5,3,1,00334,India
289140,2024-02-19,707,marker,20,40,20,1,00334,India
570468,2024-02-19,715,folder,5,15,10,1,00429,India
929260,2024-02-19,704,scale,5,10,5,1,00154,India
929260,2024-02-19,717,spiral bound book,50,100,50,1,00154,India
853442,2024-02-19,706,sharpener,3,8,5,1,00074,India
853442,2024-02-19,703,eraser,1,3,2,1,00074,India
853442,2024-02-19,710,geometry box,100,150,50,1,00074,India
853442,2024-02-19,711,TD kit,150,300,150,1,00074,India
853442,2024-02-19,702,pencil,2,5,3,1,00074,India
796176,2024-02-19,713,ball pen,5,10,5,1,00045,India
796176,2024-02-19,706,sharpener,3,8,5,1,00045,India
796176,2024-02-19,711,TD kit,150,300,150,1,00045,India
852332,2024-02-19,714,carbon paper,15,30,15,1,00420,India
852332,2024-02-19,702,pencil,2,5,3,1,00420,India
852332,2024-02-19,713,ball pen,5,10,5,1,00420,India
376255,2024-02-19,714,carbon paper,15,30,15,1,00132,India
376255,2024-02-19,707,marker,20,40,20,1,00132,India
376255,2024-02-19,708,sketchpen,15,40,25,1,00132,India
913355,2024-02-19,709,notebook,30,60,30,1,00065,India
490732,2024-02-19,716,printing paper,200,400,200,1,00449,India
490732,2024-02-19,715,folder,5,15,10,1,00449,India
784367,2024-02-19,712,graph paper,20,40,20,1,00025,India
784367,2024-02-19,708,sketchpen,15,40,25,1,00025,India
784367,2024-02-19,706,sharpener,3,8,5,1,00025,India
763308,2024-02-19,701,gel pen,5,10,5,1,00036,India
763308,2024-02-19,708,sketchpen,15,40,25,1,00036,India
763308,2024-02-19,707,marker,20,40,20,1,00036,India
763308,2024-02-19,709,notebook,30,60,30,1,00036,India
399623,2024-02-19,716,printing paper,200,400,200,1,00135,India
399623,2024-02-19,709,notebook,30,60,30,1,00135,India
399623,2024-02-19,701,gel pen,5,10,5,1,00135,India
399623,2024-02-19,711,TD kit,150,300,150,1,00135,India
302837,2024-02-20,703,eraser,1,3,2,1,00358,India
969557,2024-02-20,706,sharpener,3,8,5,1,00330,India
889256,2024-02-20,715,folder,5,15,10,1,00059,India
817261,2024-02-20,717,spiral bound book,50,100,50,1,00034,India
817261,2024-02-20,707,marker,20,40,20,1,00034,India
817261,2024-02-20,712,graph paper,20,40,20,1,00034,India
817261,2024-02-20,706,sharpener,3,8,5,1,00034,India
539091,2024-02-20,706,sharpener,3,8,5,1,00194,India
539091,2024-02-20,716,printing paper,200,400,200,1,00194,India
539091,2024-02-20,701,gel pen,5,10,5,1,00194,India
776232,2024-02-20,710,geometry box,100,150,50,1,00004,India
776232,2024-02-20,714,carbon paper,15,30,15,1,00004,India
776232,2024-02-20,701,gel pen,5,10,5,1,00004,India
776232,2024-02-20,708,sketchpen,15,40,25,1,00004,India
776232,2024-02-20,707,marker,20,40,20,1,00004,India
378266,2024-02-20,702,pencil,2,5,3,1,00431,India
378266,2024-02-20,717,spiral bound book,50,100,50,1,00431,India
378266,2024-02-20,710,geometry box,100,150,50,1,00431,India
378266,2024-02-20,707,marker,20,40,20,1,00431,India
378266,2024-02-20,716,printing paper,200,400,200,1,00431,India
130812,2024-02-20,708,sketchpen,15,40,25,1,00329,India
130812,2024-02-20,701,gel pen,5,10,5,1,00329,India
130812,2024-02-20,705,stencil,10,20,10,1,00329,India
966281,2024-02-20,709,notebook,30,60,30,1,00369,India
966281,2024-02-20,713,ball pen,5,10,5,1,00369,India
966281,2024-02-20,701,gel pen,5,10,5,1,00369,India
717448,2024-02-20,708,sketchpen,15,40,25,1,00062,India
717448,2024-02-20,715,folder,5,15,10,1,00062,India
767798,2024-02-20,701,gel pen,5,10,5,1,00267,India
767798,2024-02-20,707,marker,20,40,20,1,00267,India
328902,2024-02-20,706,sharpener,3,8,5,1,00181,India
328902,2024-02-20,712,graph paper,20,40,20,1,00181,India
328902,2024-02-20,709,notebook,30,60,30,1,00181,India
328902,2024-02-20,707,marker,20,40,20,1,00181,India
328902,2024-02-20,713,ball pen,5,10,5,1,00181,India
524057,2024-02-20,715,folder,5,15,10,1,00173,India
524057,2024-02-20,707,marker,20,40,20,1,00173,India
524057,2024-02-20,706,sharpener,3,8,5,1,00173,India
482492,2024-02-20,711,TD kit,150,300,150,1,00094,India
482492,2024-02-20,707,marker,20,40,20,1,00094,India
482492,2024-02-20,709,notebook,30,60,30,1,00094,India
482492,2024-02-20,706,sharpener,3,8,5,1,00094,India
412371,2024-02-20,712,graph paper,20,40,20,1,00282,India
412371,2024-02-20,711,TD kit,150,300,150,1,00282,India
412371,2024-02-20,716,printing paper,200,400,200,1,00282,India
412371,2024-02-20,710,geometry box,100,150,50,1,00282,India
361460,2024-02-20,711,TD kit,150,300,150,1,00434,India
361460,2024-02-20,702,pencil,2,5,3,1,00434,India
361460,2024-02-20,701,gel pen,5,10,5,1,00434,India
361460,2024-02-20,708,sketchpen,15,40,25,1,00434,India
741012,2024-02-20,710,geometry box,100,150,50,1,00187,India
741012,2024-02-20,701,gel pen,5,10,5,1,00187,India
741012,2024-02-20,703,eraser,1,3,2,1,00187,India
994060,2024-02-20,703,eraser,1,3,2,1,00200,India
996847,2024-02-20,711,TD kit,150,300,150,1,00404,India
996847,2024-02-20,704,scale,5,10,5,1,00404,India
996847,2024-02-20,715,folder,5,15,10,1,00404,India
752724,2024-02-20,710,geometry box,100,150,50,1,00426,India
752724,2024-02-20,708,sketchpen,15,40,25,1,00426,India
752724,2024-02-20,713,ball pen,5,10,5,1,00426,India
101820,2024-02-20,716,printing paper,200,400,200,1,00253,India
485972,2024-02-20,708,sketchpen,15,40,25,1,00013,India
485972,2024-02-20,711,TD kit,150,300,150,1,00013,India
485972,2024-02-20,704,scale,5,10,5,1,00013,India
485972,2024-02-20,710,geometry box,100,150,50,1,00013,India
485972,2024-02-20,713,ball pen,5,10,5,1,00013,India
843532,2024-02-20,710,geometry box,100,150,50,1,00059,India
971501,2024-02-20,717,spiral bound book,50,100,50,1,00225,India
971501,2024-02-20,705,stencil,10,20,10,1,00225,India
971501,2024-02-20,712,graph paper,20,40,20,1,00225,India
971501,2024-02-20,714,carbon paper,15,30,15,1,00225,India
727190,2024-02-20,713,ball pen,5,10,5,1,00413,India
727190,2024-02-20,709,notebook,30,60,30,1,00413,India
727190,2024-02-20,707,marker,20,40,20,1,00413,India
913014,2024-02-20,704,scale,5,10,5,1,00045,India
913014,2024-02-20,710,geometry box,100,150,50,1,00045,India
376147,2024-02-20,709,notebook,30,60,30,1,00144,India
376147,2024-02-20,716,printing paper,200,400,200,1,00144,India
376147,2024-02-20,702,pencil,2,5,3,1,00144,India
261715,2024-02-20,708,sketchpen,15,40,25,1,00175,India
261715,2024-02-20,702,pencil,2,5,3,1,00175,India
261715,2024-02-20,715,folder,5,15,10,1,00175,India
261715,2024-02-20,701,gel pen,5,10,5,1,00175,India
474148,2024-02-20,714,carbon paper,15,30,15,1,00498,India
474148,2024-02-20,702,pencil,2,5,3,1,00498,India
474148,2024-02-20,709,notebook,30,60,30,1,00498,India
474148,2024-02-20,701,gel pen,5,10,5,1,00498,India
890554,2024-02-20,708,sketchpen,15,40,25,1,00365,India
890554,2024-02-20,709,notebook,30,60,30,1,00365,India
890554,2024-02-20,710,geometry box,100,150,50,1,00365,India
890554,2024-02-20,715,folder,5,15,10,1,00365,India
922992,2024-02-20,708,sketchpen,15,40,25,1,00198,India
922992,2024-02-20,712,graph paper,20,40,20,1,00198,India
922992,2024-02-20,716,printing paper,200,400,200,1,00198,India
922992,2024-02-20,713,ball pen,5,10,5,1,00198,India
210945,2024-02-20,705,stencil,10,20,10,1,00157,India
210945,2024-02-20,714,carbon paper,15,30,15,1,00157,India
210945,2024-02-20,716,printing paper,200,400,200,1,00157,India
210945,2024-02-20,708,sketchpen,15,40,25,1,00157,India
830299,2024-02-20,702,pencil,2,5,3,1,00276,India
830299,2024-02-20,714,carbon paper,15,30,15,1,00276,India
830299,2024-02-20,710,geometry box,100,150,50,1,00276,India
830299,2024-02-20,705,stencil,10,20,10,1,00276,India
161389,2024-02-20,707,marker,20,40,20,1,00274,India
161389,2024-02-20,716,printing paper,200,400,200,1,00274,India
161389,2024-02-20,708,sketchpen,15,40,25,1,00274,India
161389,2024-02-20,701,gel pen,5,10,5,1,00274,India
281472,2024-02-20,705,stencil,10,20,10,1,00158,India
281472,2024-02-20,708,sketchpen,15,40,25,1,00158,India
281472,2024-02-20,702,pencil,2,5,3,1,00158,India
281472,2024-02-20,714,carbon paper,15,30,15,1,00158,India
437248,2024-02-20,711,TD kit,150,300,150,1,00154,India
289731,2024-02-20,707,marker,20,40,20,1,00221,India
289731,2024-02-20,714,carbon paper,15,30,15,1,00221,India
651253,2024-02-20,707,marker,20,40,20,1,00415,India
651253,2024-02-20,706,sharpener,3,8,5,1,00415,India
651253,2024-02-20,708,sketchpen,15,40,25,1,00415,India
435192,2024-02-20,701,gel pen,5,10,5,1,00145,India
435192,2024-02-20,711,TD kit,150,300,150,1,00145,India
435192,2024-02-20,706,sharpener,3,8,5,1,00145,India
973102,2024-02-20,715,folder,5,15,10,1,00193,India
973102,2024-02-20,716,printing paper,200,400,200,1,00193,India
973102,2024-02-20,713,ball pen,5,10,5,1,00193,India
452100,2024-02-20,708,sketchpen,15,40,25,1,00476,India
452100,2024-02-20,701,gel pen,5,10,5,1,00476,India
452100,2024-02-20,712,graph paper,20,40,20,1,00476,India
566460,2024-02-20,710,geometry box,100,150,50,1,00289,India
566460,2024-02-20,715,folder,5,15,10,1,00289,India
566460,2024-02-20,707,marker,20,40,20,1,00289,India
566460,2024-02-20,702,pencil,2,5,3,1,00289,India
298803,2024-02-20,716,printing paper,200,400,200,1,00400,India
298803,2024-02-20,701,gel pen,5,10,5,1,00400,India
298803,2024-02-20,708,sketchpen,15,40,25,1,00400,India
298803,2024-02-20,709,notebook,30,60,30,1,00400,India
298803,2024-02-20,703,eraser,1,3,2,1,00400,India
462576,2024-02-20,712,graph paper,20,40,20,1,00180,India
462576,2024-02-20,708,sketchpen,15,40,25,1,00180,India
462576,2024-02-20,711,TD kit,150,300,150,1,00180,India
776952,2024-02-20,706,sharpener,3,8,5,1,00063,India
776952,2024-02-20,701,gel pen,5,10,5,1,00063,India
776952,2024-02-20,717,spiral bound book,50,100,50,1,00063,India
776952,2024-02-20,709,notebook,30,60,30,1,00063,India
776952,2024-02-20,714,carbon paper,15,30,15,1,00063,India
132955,2024-02-20,702,pencil,2,5,3,1,00066,India
132955,2024-02-20,714,carbon paper,15,30,15,1,00066,India
929279,2024-02-20,710,geometry box,100,150,50,1,00055,India
831739,2024-02-20,711,TD kit,150,300,150,1,00082,India
831739,2024-02-20,712,graph paper,20,40,20,1,00082,India
831739,2024-02-20,717,spiral bound book,50,100,50,1,00082,India